"date","geography","geography code","Household composition: Total; measures: Value","Household composition: One person household; measures: Value","Household composition: One person household: Aged 66 years and over; measures: Value","Household composition: One person household: Other; measures: Value","Household composition: Single family household; measures: Value","Household composition: Single family household: All aged 66 years and over; measures: Value","Household composition: Single family household: Married or civil partnership couple; measures: Value","Household composition: Single family household: Married or civil partnership couple: No children; measures: Value","Household composition: Single family household: Married or civil partnership couple: Dependent children; measures: Value","Household composition: Single family household: Married or civil partnership couple: All children non-dependent; measures: Value","Household composition: Single family household: Cohabiting couple family; measures: Value","Household composition: Single family household: Cohabiting couple family: No children; measures: Value","Household composition: Single family household: Cohabiting couple family: With dependent children; measures: Value","Household composition: Single family household: Cohabiting couple family: All children non-dependent; measures: Value","Household composition: Single family household: Lone parent family; measures: Value","Household composition: Single family household: Lone parent family: With dependent children; measures: Value","Household composition: Single family household: Lone parent family: All children non-dependent; measures: Value","Household composition: Single family household: Other single family household; measures: Value","Household composition: Single family household: Other single family household: Other family composition; measures: Value","Household composition: Other household types; measures: Value","Household composition: Other household types: With dependent children; measures: Value","Household composition: Other household types: Other, including all full-time students and all aged 66 years and over; measures: Value"
"2021","Darlington","E06000005",48915,16714,6851,9863,30395,4604,13879,5643,5802,2434,5907,3092,2451,364,5757,3901,1856,248,248,1806,790,1016
"2021","County Durham","E06000047",234761,79529,34150,45379,146599,23721,66560,27844,25415,13301,27230,13657,11701,1872,27992,18904,9088,1096,1096,8633,3168,5465
"2021","Hartlepool","E06000001",40930,13616,5647,7969,25845,3669,11290,4501,4275,2514,5067,2236,2432,399,5628,3886,1742,191,191,1469,687,782
"2021","Middlesbrough","E06000002",60261,19964,7739,12225,36756,4496,15641,5343,7052,3246,6837,3073,3197,567,9166,6236,2930,616,616,3541,1549,1992
"2021","Northumberland","E06000057",146922,48149,22951,25198,94740,18716,45170,19891,16759,8520,15437,8041,6377,1019,14850,9513,5337,567,567,4033,1763,2270
"2021","Redcar and Cleveland","E06000003",61640,20663,9739,10924,39003,6861,16823,6862,6252,3709,7239,3224,3403,612,7803,5170,2633,277,277,1974,965,1009
"2021","Stockton-on-Tees","E06000004",83756,25980,10812,15168,54449,7855,25861,9359,11570,4932,10203,4959,4570,674,10107,6697,3410,423,423,3327,1656,1671
"2021","Gateshead","E08000037",88998,30807,12734,18073,54804,8105,24298,9065,10307,4926,10993,6217,3975,801,10842,6697,4145,566,566,3387,1340,2047
"2021","Newcastle upon Tyne","E08000021",122798,42031,14915,27116,69671,8122,31769,10514,15536,5719,14384,8660,4887,837,14226,9142,5084,1170,1170,11096,2426,8670
"2021","North Tyneside","E08000022",96233,33554,14272,19282,59785,8832,27784,10478,12261,5045,11577,6343,4550,684,11144,7366,3778,448,448,2894,1250,1644
"2021","South Tyneside","E08000023",68285,24550,10484,14066,41694,5980,18102,6876,7191,4035,7594,3648,3331,615,9660,6370,3290,358,358,2041,935,1106
"2021","Sunderland","E08000024",122178,40369,17539,22830,77376,11435,34151,13131,13205,7815,14832,6902,6666,1264,16240,10431,5809,718,718,4433,2158,2275
"2021","Blackburn with Darwen","E06000008",58767,17578,6674,10904,37055,3943,18688,5252,9908,3528,6149,2666,2987,496,7826,5137,2689,449,449,4134,2548,1586
"2021","Blackpool","E06000009",64789,24588,9798,14790,36337,4969,14102,5915,5266,2921,7876,3805,3485,586,8885,5799,3086,505,505,3864,1523,2341
"2021","Cheshire East","E06000049",174857,53137,24817,28320,115112,20739,57228,21429,25816,9983,20642,11492,8079,1071,15655,9708,5947,848,848,6608,2553,4055
"2021","Cheshire West and Chester","E06000050",155156,46889,21284,25605,101371,16807,49139,18200,21615,9324,18970,10308,7489,1173,15643,9590,6053,812,812,6896,2324,4572
"2021","Halton","E06000006",55949,17702,7155,10547,35989,4776,15944,5777,6560,3607,7049,3266,3223,560,7863,5147,2716,357,357,2258,1083,1175
"2021","Warrington","E06000007",90538,27364,11444,15920,59467,8742,29538,10366,13494,5678,11000,5695,4612,693,9677,6154,3523,510,510,3707,1523,2184
"2021","Cumbria","E10000006",228956,77432,35691,41741,143700,27489,68896,29619,26025,13252,25601,13586,10553,1462,20823,12878,7945,891,891,7824,2977,4847
"2021","Bolton","E08000001",118790,36521,15389,21132,75404,10058,36432,11114,18079,7239,13121,5927,6194,1000,14984,9492,5492,809,809,6865,3988,2877
"2021","Bury","E08000002",80697,24880,10646,14234,51769,7288,24861,7946,12192,4723,9493,4803,4001,689,9626,6057,3569,501,501,4048,1997,2051
"2021","Manchester","E08000003",214734,71577,18712,52865,115845,6339,48691,13055,28116,7520,26033,16569,8075,1389,30969,20225,10744,3813,3813,27312,8270,19042
"2021","Oldham","E08000004",93140,27397,11748,15649,59577,7361,28091,8251,14386,5454,10048,4296,4885,867,13381,8716,4665,696,696,6166,3856,2310
"2021","Rochdale","E08000005",90223,27641,11285,16356,57288,6855,26169,8169,12797,5203,10481,4677,4932,872,13052,8761,4291,731,731,5294,3119,2175
"2021","Salford","E08000006",115116,39141,12380,26761,66173,6293,26973,8749,13197,5027,16726,10038,5711,977,14717,9794,4923,1464,1464,9802,2732,7070
"2021","Stockport","E08000007",126648,39439,17805,21634,81576,12336,39505,12472,19338,7695,15111,8102,6071,938,13922,8684,5238,702,702,5633,2526,3107
"2021","Tameside","E08000008",99527,32374,13013,19361,62359,7645,26957,9321,11912,5724,13323,6215,6055,1053,13782,9030,4752,652,652,4794,2496,2298
"2021","Trafford","E08000009",96269,28369,12764,15605,63004,8205,33446,8869,18808,5769,10308,5722,3939,647,10459,6339,4120,586,586,4896,2248,2648
"2021","Wigan","E08000010",143102,43950,18692,25258,93548,13595,42255,15164,18150,8941,19897,9350,9126,1421,17050,10503,6547,751,751,5604,2688,2916
"2021","Lancashire","E10000017",525246,165178,74119,91059,333235,54916,158144,59566,68843,29735,61013,30740,26236,4037,56228,35979,20249,2934,2934,26833,11376,15457
"2021","Knowsley","E08000011",66072,20645,8184,12461,42190,4424,17070,5553,6815,4702,8421,3657,3955,809,11704,7307,4397,571,571,3237,1710,1527
"2021","Liverpool","E08000012",207491,76340,25627,50713,115071,11377,46296,14138,21030,11128,23527,12968,8775,1784,31304,18917,12387,2567,2567,16080,4903,11177
"2021","Sefton","E08000014",123072,41520,19873,21647,75742,12775,34010,11612,13935,8463,12900,6130,5748,1022,15301,8700,6601,756,756,5810,2556,3254
"2021","St. Helens","E08000013",81010,25561,11243,14318,52331,7909,23101,8283,9523,5295,10316,5073,4438,805,10491,6478,4013,514,514,3118,1457,1661
"2021","Wirral","E08000015",143255,49689,22478,27211,87738,13828,38951,13475,16789,8687,14998,7323,6603,1072,19152,12082,7070,809,809,5828,2635,3193
"2021","East Riding of Yorkshire","E06000011",152063,45678,24320,21358,101052,21531,48983,21298,19102,8583,17249,9152,7073,1024,12765,7934,4831,524,524,5333,2292,3041
"2021","Kingston upon Hull, City of","E06000010",115472,39446,13982,25464,69264,7294,27650,10551,11915,5184,17924,8421,8224,1279,15491,10460,5031,905,905,6762,2529,4233
"2021","North East Lincolnshire","E06000012",69826,22718,10030,12688,44064,6979,18959,8112,7128,3719,9080,4129,4326,625,8638,6016,2622,408,408,3044,1342,1702
"2021","North Lincolnshire","E06000013",73173,21366,10309,11057,48217,8263,22583,9650,8756,4177,9530,4569,4296,665,7438,4758,2680,403,403,3590,1602,1988
"2021","York","E06000014",85458,26640,11607,15033,52338,8619,25219,9659,11646,3914,10650,6786,3355,509,7340,4538,2802,510,510,6480,1115,5365
"2021","North Yorkshire","E10000023",274381,84891,42400,42491,179676,35971,90201,38706,36409,15086,29859,17041,11170,1648,22561,14058,8503,1084,1084,9814,3719,6095
"2021","Barnsley","E08000016",108054,33289,14170,19119,70441,10252,31194,12838,12076,6280,15721,7631,6999,1091,12693,8400,4293,581,581,4324,2037,2287
"2021","Doncaster","E08000017",133478,41667,18042,23625,85499,12699,38226,15233,15393,7600,17656,8365,8103,1188,16043,10512,5531,875,875,6312,2896,3416
"2021","Rotherham","E08000018",113925,34225,15175,19050,75069,11604,34018,12960,14150,6908,15449,7078,7151,1220,13408,8613,4795,590,590,4631,2401,2230
"2021","Sheffield","E08000019",231951,75759,29871,45888,140739,19630,64582,22418,30742,11422,29242,16643,10756,1843,25650,16618,9032,1635,1635,15453,4662,10791
"2021","Bradford","E08000032",209865,64596,24902,39694,130426,15224,64874,19782,34178,10914,21288,10575,9253,1460,27395,18865,8530,1645,1645,14843,9231,5612
"2021","Calderdale","E08000033",90475,30308,12289,18019,56148,8020,25747,9765,11404,4578,11203,5805,4645,753,10771,7481,3290,407,407,4019,2033,1986
"2021","Kirklees","E08000034",177992,55177,22474,32703,113432,15946,55340,18867,26692,9781,20825,10555,8871,1399,20306,13445,6861,1015,1015,9383,4931,4452
"2021","Leeds","E08000035",341467,111381,40266,71115,204885,25549,93636,31454,46677,15505,44061,26072,15685,2304,38748,25870,12878,2891,2891,25201,7717,17484
"2021","Wakefield","E08000036",153075,46419,19886,26533,100085,14196,46026,18050,19325,8651,21794,10886,9426,1482,17209,11120,6089,860,860,6571,3051,3520
"2021","Derby","E06000015",105653,33054,13019,20035,64890,8427,30480,9917,14882,5681,12472,6544,5148,780,12460,7850,4610,1051,1051,7709,3435,4274
"2021","Leicester","E06000016",127388,35173,11871,23302,75604,6093,39969,9143,22376,8450,11372,5707,4753,912,16447,9828,6619,1723,1723,16611,8446,8165
"2021","Nottingham","E06000018",124745,41971,13512,28459,68295,6104,28615,9457,14308,4850,14906,8448,5502,956,17045,11449,5596,1625,1625,14479,3997,10482
"2021","Rutland","E06000017",16696,4786,2589,2197,11320,2654,5854,2350,2585,919,1600,950,560,90,1169,712,457,43,43,590,223,367
"2021","Derbyshire","E10000007",354213,109710,50053,59657,232200,39910,109805,44740,44455,20610,46961,25117,18931,2913,34165,21291,12874,1359,1359,12303,5128,7175
"2021","Leicestershire","E10000018",296408,81648,39061,42587,199617,34259,99940,36209,44785,18946,36663,19432,14941,2290,27433,16802,10631,1322,1322,15143,5908,9235
"2021","Lincolnshire","E10000019",333552,97972,48155,49817,217613,41938,101853,44450,40116,17287,41065,22123,16614,2328,31028,20191,10837,1729,1729,17967,6737,11230
"2021","Nottinghamshire","E10000024",357119,105674,49179,56495,235445,39712,111647,43503,47700,20444,46673,24567,19129,2977,35657,22533,13124,1756,1756,16000,6283,9717
"2021","North Northamptonshire","E06000061",148922,40715,17680,23035,99038,14343,47182,17220,21671,8291,20219,10068,8901,1250,16303,10468,5835,991,991,9169,4114,5055
"2021","West Northamptonshire","E06000062",172643,46474,19511,26963,113940,15948,57154,19721,27652,9781,21857,11652,8876,1329,17572,11313,6259,1409,1409,12229,5272,6957
"2021","Herefordshire, County of","E06000019",82824,25434,12919,12515,53433,11052,25781,10769,10250,4762,8902,4850,3478,574,7318,4361,2957,380,380,3957,1531,2426
"2021","Shropshire","E06000051",139576,41428,21475,19953,91505,18946,44065,18297,17242,8526,16266,8844,6302,1120,11675,6880,4795,553,553,6643,2845,3798
"2021","Stoke-on-Trent","E06000021",110400,36179,14225,21954,68454,8647,29954,11087,13363,5504,14757,7144,6717,896,14209,9522,4687,887,887,5767,2475,3292
"2021","Telford and Wrekin","E06000020",76510,21205,9048,12157,50746,6968,23741,8824,10524,4393,10409,5164,4572,673,9136,5973,3163,492,492,4559,1910,2649
"2021","Staffordshire","E10000028",375223,108215,52421,55794,251182,44853,121541,46819,50395,24327,47235,24269,19891,3075,35843,21925,13918,1710,1710,15826,6891,8935
"2021","Warwickshire","E10000031",253264,73066,33561,39505,166299,27452,82776,29527,38093,15156,30285,16922,11649,1714,24391,15236,9155,1395,1395,13899,5196,8703
"2021","Birmingham","E08000025",423456,133224,47070,86154,248201,23052,118572,29197,66750,22625,37183,19429,14908,2846,64230,40869,23361,5164,5164,42031,21367,20664
"2021","Coventry","E08000026",134138,40777,15600,25177,80627,9155,38495,10998,19947,7550,13784,6810,5986,988,17587,11101,6486,1606,1606,12734,4906,7828
"2021","Dudley","E08000027",137069,41709,19079,22630,89286,14221,41300,13850,18029,9421,16416,7777,7451,1188,16622,10327,6295,727,727,6074,3227,2847
"2021","Sandwell","E08000028",130246,38042,15025,23017,81336,8223,38838,10429,19633,8776,13598,5596,6851,1151,19456,12228,7228,1221,1221,10868,6759,4109
"2021","Solihull","E08000029",89486,25855,13023,12832,59409,10110,30058,8860,14699,6499,8468,4124,3658,686,10383,6438,3945,390,390,4222,2110,2112
"2021","Walsall","E08000030",112228,32129,14516,17613,73084,9546,34024,10121,16197,7706,12898,5352,6456,1090,15698,10026,5672,918,918,7015,4211,2804
"2021","Wolverhampton","E08000031",105141,32468,13054,19414,64872,7375,29818,8531,14347,6940,11048,4631,5517,900,15637,9728,5909,994,994,7801,4384,3417
"2021","Worcestershire","E10000034",259933,76079,37092,38987,171433,31616,82451,31196,35787,15468,31173,16845,12332,1996,25020,15425,9595,1173,1173,12421,4895,7526
"2021","Bedford","E06000055",74948,21448,8608,12840,48493,6416,24275,7533,12476,4266,8741,4766,3479,496,8463,5279,3184,598,598,5007,2365,2642
"2021","Central Bedfordshire","E06000056",120756,31172,13916,17256,83756,12089,43040,14526,20897,7617,16101,8471,6645,985,11891,7306,4585,635,635,5828,2536,3292
"2021","Luton","E06000032",78940,21068,7300,13768,48499,4158,25979,5948,15322,4709,6663,3258,2873,532,10511,6490,4021,1188,1188,9373,5428,3945
"2021","Peterborough","E06000031",84533,23516,8919,14597,53359,6002,25488,8246,13337,3905,10319,5192,4533,594,10672,7368,3304,878,878,7658,4025,3633
"2021","Southend-on-Sea","E06000033",78344,26102,10922,15180,48025,6716,21735,6981,10543,4211,9644,4988,3978,678,9456,5901,3555,474,474,4217,1712,2505
"2021","Thurrock","E06000034",66375,16180,6801,9379,44594,4556,22046,5863,11604,4579,8421,3405,4270,746,8991,5906,3085,580,580,5601,3067,2534
"2021","Cambridgeshire","E10000003",277635,78876,34147,44729,180746,28724,92662,33482,44738,14442,33656,19760,12146,1750,24127,15100,9027,1577,1577,18013,5507,12506
"2021","Essex","E10000012",626472,177924,87055,90869,415169,68372,203712,66843,96146,40723,74024,37708,31060,5256,65805,39995,25810,3256,3256,33379,14002,19377
"2021","Hertfordshire","E10000015",482894,134069,59025,75044,319923,42231,170361,47715,91254,31392,52664,28565,20657,3442,51583,31464,20119,3084,3084,28902,12026,16876
"2021","Norfolk","E10000020",404341,125512,61251,64261,257185,51547,116780,49406,46884,20490,50173,27401,19705,3067,36681,22961,13720,2004,2004,21644,7214,14430
"2021","Suffolk","E10000029",333542,103942,49382,54560,214729,41700,102172,40830,43325,18017,39148,20792,15907,2449,30256,18880,11376,1453,1453,14871,5797,9074
"2021","Camden","E09000007",92758,35931,9718,26213,45716,3004,20511,6724,11082,2705,9986,7897,1767,322,10559,5945,4614,1656,1656,11111,2273,8838
"2021","City of London","E09000001",4916,2506,494,2012,1983,201,846,523,253,70,665,598,57,10,175,90,85,96,96,427,31,396
"2021","Hackney","E09000012",106080,34928,7489,27439,54971,1785,21060,5852,12287,2921,13669,10182,3046,441,16400,9944,6456,2057,2057,16181,3519,12662
"2021","Hammersmith and Fulham","E09000013",81244,29324,7351,21973,40567,2033,18050,5919,9731,2400,8869,7151,1406,312,9683,5354,4329,1932,1932,11353,2042,9311
"2021","Haringey","E09000014",105092,32293,8958,23335,58393,3139,25443,6838,14343,4262,11772,7874,3326,572,15855,9079,6776,2184,2184,14406,4536,9870
"2021","Islington","E09000019",96497,34795,7636,27159,48738,2168,18118,6689,8898,2531,13546,10707,2430,409,13071,7823,5248,1835,1835,12964,2067,10897
"2021","Kensington and Chelsea","E09000020",66885,29233,7750,21483,30872,2390,15104,5416,7276,2412,5316,4253,878,185,6674,3407,3267,1388,1388,6780,2063,4717
"2021","Lambeth","E09000022",134686,43154,9531,33623,67458,2524,24606,8158,12677,3771,17736,13667,3411,658,19228,11320,7908,3364,3364,24074,4434,19640
"2021","Lewisham","E09000023",122390,37147,9365,27782,70358,3280,28896,8506,15646,4744,16225,10765,4627,833,19920,12195,7725,2037,2037,14885,4912,9973
"2021","Newham","E09000025",115507,27037,6377,20660,65603,2022,33238,7091,20395,5752,10384,6662,3095,627,16971,9866,7105,2988,2988,22867,11006,11861
"2021","Southwark","E09000028",130818,43348,9507,33841,67691,2526,24878,8406,12877,3595,17301,12924,3718,659,19847,12110,7737,3139,3139,19779,4232,15547
"2021","Tower Hamlets","E09000030",120538,38530,5786,32744,61312,1340,28878,8674,17254,2950,15199,12355,2499,345,12853,7961,4892,3042,3042,20696,4952,15744
"2021","Wandsworth","E09000032",137393,41132,10880,30252,74344,3838,34574,10696,19467,4411,19118,15627,3079,412,14041,8277,5764,2773,2773,21917,3437,18480
"2021","Westminster","E09000033",94817,40443,9498,30945,43262,2772,19673,7479,9419,2775,8563,7003,1258,302,9698,5015,4683,2556,2556,11112,2388,8724
"2021","Barking and Dagenham","E09000002",73904,17503,5991,11512,46471,2268,22869,4224,14417,4228,6016,2005,3401,610,14116,9427,4689,1202,1202,9930,6330,3600
"2021","Barnet","E09000003",148919,41658,15208,26450,91234,9264,50725,11929,29036,9760,10924,6717,3565,642,18103,10476,7627,2218,2218,16027,6468,9559
"2021","Bexley","E09000004",95300,24753,11968,12785,62904,7730,31802,8115,16368,7319,9899,4450,4564,885,12681,7665,5016,792,792,7643,3929,3714
"2021","Brent","E09000005",118612,31985,9712,22273,66305,4302,33864,7464,18539,7861,8055,5092,2446,517,17678,9830,7848,2406,2406,20322,9295,11027
"2021","Bromley","E09000006",135828,38668,17443,21225,88907,11684,46328,12702,24997,8629,14462,8081,5431,950,15447,9298,6149,986,986,8253,3548,4705
"2021","Croydon","E09000008",152947,43091,14652,28439,94644,8471,44664,11821,23600,9243,14817,8027,5690,1100,24543,15169,9374,2149,2149,15212,7250,7962
"2021","Ealing","E09000009",133659,35662,11837,23825,78735,5423,42798,9773,24366,8659,10978,7037,3322,619,17248,9558,7690,2288,2288,19262,8420,10842
"2021","Enfield","E09000010",120929,31159,12251,18908,76894,6921,37245,8001,20268,8976,8662,3937,3937,788,22424,14274,8150,1642,1642,12876,6924,5952
"2021","Greenwich","E09000011",114052,34048,9581,24467,67236,4097,30668,9347,16178,5143,13634,8547,4387,700,17095,10898,6197,1742,1742,12768,5377,7391
"2021","Harrow","E09000015",89642,19852,9050,10802,57026,6491,35202,7406,19162,8634,4341,2499,1444,398,9738,4883,4855,1254,1254,12764,6834,5930
"2021","Havering","E09000016",101277,26129,12838,13291,67212,9063,33811,8799,16837,8175,10398,4585,4791,1022,13138,7821,5317,802,802,7936,4268,3668
"2021","Hillingdon","E09000017",109227,26634,11143,15491,69899,6521,39538,9193,22168,8177,8650,4481,3390,779,13863,7944,5919,1327,1327,12694,6664,6030
"2021","Hounslow","E09000018",102961,26209,9176,17033,61825,4381,34354,7844,19741,6769,8242,4685,3013,544,13347,7598,5749,1501,1501,14927,7389,7538
"2021","Kingston upon Thames","E09000021",65626,17716,6894,10822,41929,4274,23700,5954,13632,4114,6904,4415,2155,334,6336,3747,2589,715,715,5981,2094,3887
"2021","Merton","E09000024",81729,20464,7507,12957,50849,4087,27505,7001,15684,4820,8927,5895,2586,446,9146,5064,4082,1184,1184,10416,4094,6322
"2021","Redbridge","E09000026",103714,23886,9669,14217,65084,5306,39537,7279,23701,8557,6445,3341,2557,547,12487,7155,5332,1309,1309,14744,8666,6078
"2021","Richmond upon Thames","E09000027",80704,23871,10039,13832,51666,5744,29730,8002,17536,4192,8539,5597,2572,370,7078,4224,2854,575,575,5167,1884,3283
"2021","Sutton","E09000029",82349,22200,9497,12703,54170,5613,29782,7343,16864,5575,8309,4390,3300,619,9796,5900,3896,670,670,5979,2959,3020
"2021","Waltham Forest","E09000031",102899,26696,8254,18442,62016,3547,29167,7372,16400,5395,12875,7893,4341,641,14705,8536,6169,1722,1722,14187,6385,7802
"2021","Bracknell Forest","E06000036",50244,13462,5195,8267,33651,3877,18084,5814,9251,3019,6482,3713,2440,329,4932,3062,1870,276,276,3131,1258,1873
"2021","Brighton and Hove","E06000043",121401,42101,13875,28226,65648,6247,29009,10309,14204,4496,17509,11692,5088,729,11637,7229,4408,1246,1246,13652,2166,11486
"2021","Isle of Wight","E06000046",64778,22484,11669,10815,39086,8925,17032,7790,6012,3230,6702,3543,2703,456,6227,3893,2334,200,200,3208,1240,1968
"2021","Medway","E06000035",111459,30462,13132,17330,73294,9113,35051,10985,16923,7143,14489,6699,6655,1135,13930,8657,5273,711,711,7703,3721,3982
"2021","Milton Keynes","E06000042",113102,29795,10980,18815,74485,7842,38321,11704,20448,6169,13250,7059,5382,809,14109,9519,4590,963,963,8822,4026,4796
"2021","Portsmouth","E06000044",86155,27607,10673,16934,50067,5437,22594,7893,10731,3970,11115,6218,4241,656,10030,6513,3517,891,891,8481,2221,6260
"2021","Reading","E06000038",67683,19262,6230,13032,40381,3643,20242,6024,11045,3173,8297,5371,2501,425,7361,4624,2737,838,838,8040,2570,5470
"2021","Slough","E06000039",52421,11948,3838,8110,33308,1819,19807,3775,12606,3426,3885,1752,1823,310,7156,4429,2727,641,641,7165,4298,2867
"2021","Southampton","E06000045",102291,33711,11453,22258,58597,6180,26737,9179,13259,4299,13337,8068,4604,665,11270,7366,3904,1073,1073,9983,2661,7322
"2021","West Berkshire","E06000037",66658,18008,8321,9687,45249,7183,24582,8439,11836,4307,7436,4261,2804,371,5720,3498,2222,328,328,3401,1232,2169
"2021","Windsor and Maidenhead","E06000040",60933,16715,7610,9105,40088,5821,22591,6670,12012,3909,5963,3552,2034,377,5345,3057,2288,368,368,4130,1723,2407
"2021","Wokingham","E06000041",69164,16265,7644,8621,49188,7081,28973,8144,16326,4503,7246,4320,2543,383,5551,3385,2166,337,337,3711,1549,2162
"2021","Buckinghamshire","E06000060",220329,57889,27090,30799,149363,22853,82484,24980,43427,14077,22824,12793,8692,1339,19904,11950,7954,1298,1298,13077,5821,7256
"2021","East Sussex","E10000011",240122,76643,41304,35339,150000,30821,68878,27220,28874,12784,25754,13635,10388,1731,23485,14343,9142,1062,1062,13479,5084,8395
"2021","Hampshire","E10000014",587693,161702,81035,80667,395080,69881,204053,74063,94132,35858,66054,37008,25199,3847,52449,31788,20661,2643,2643,30911,11561,19350
"2021","Kent","E10000016",648393,183814,88583,95231,424313,68839,206230,70051,97919,38260,77383,39074,32973,5336,68351,42626,25725,3510,3510,40266,17028,23238
"2021","Oxfordshire","E10000025",288108,78183,35052,43131,188565,28324,98723,33875,48778,16070,34090,20299,12001,1790,25461,15511,9950,1967,1967,21360,6411,14949
"2021","Surrey","E10000030",481817,130426,62879,67547,321202,48594,177876,52136,95361,30379,49512,28571,18046,2895,42562,25206,17356,2658,2658,30189,11051,19138
"2021","West Sussex","E10000032",375216,111259,57408,53851,242134,44505,119115,41925,56157,21033,42124,23200,16454,2470,34360,20505,13855,2030,2030,21823,7871,13952
"2021","Bath and North East Somerset","E06000022",79250,23077,10781,12296,49584,8279,24740,8502,11872,4366,9278,5599,3214,465,6763,4088,2675,524,524,6589,1231,5358
"2021","Bristol, City of","E06000023",191638,57862,19697,38165,110132,10952,48404,15274,25372,7758,28890,19251,8445,1194,19819,12683,7136,2067,2067,23644,4608,19036
"2021","Cornwall","E06000052",250534,76862,39567,37295,158979,31464,73914,31653,29102,13159,29226,15581,11940,1705,23276,14263,9013,1099,1099,14693,4938,9755
"2021","Isles of Scilly","E06000053",942,307,162,145,563,132,275,147,110,18,101,77,21,3,53,32,21,2,2,72,20,52
"2021","North Somerset","E06000024",94648,29089,14451,14638,61026,11995,29709,10802,13892,5015,10513,5770,4162,581,8426,5468,2958,383,383,4533,1727,2806
"2021","Plymouth","E06000026",114560,37337,15083,22254,69889,9997,31422,12129,13830,5463,15119,8234,6043,842,12706,8153,4553,645,645,7334,2059,5275
"2021","Bournemouth, Christchurch and Poole","E06000058",173842,56531,26581,29950,103961,18113,48783,17892,22724,8167,19512,11692,6834,986,16306,9964,6342,1247,1247,13350,3754,9596
"2021","South Gloucestershire","E06000025",118101,30747,14375,16372,80156,12635,40524,13233,19480,7811,15239,8633,5712,894,11102,6955,4147,656,656,7198,2368,4830
"2021","Swindon","E06000030",95861,27218,10546,16672,62195,7777,32304,10851,15932,5521,11736,6378,4679,679,9700,6273,3427,678,678,6448,3089,3359
"2021","Torbay","E06000027",62997,21884,11086,10798,37376,7636,16284,6956,6270,3058,6725,3531,2757,437,6417,3971,2446,314,314,3737,1426,2311
"2021","Wiltshire","E06000054",215081,60574,29804,30770,144557,25704,75587,28617,34340,12630,23637,13168,9077,1392,18794,11460,7334,835,835,9950,3682,6268
"2021","Devon","E10000008",352620,107229,56485,50744,225274,47961,107225,44965,44066,18194,39199,22013,14986,2200,29510,17825,11685,1379,1379,20117,6231,13886
"2021","Dorset","E06000059",169261,51741,29714,22027,109832,27077,51800,22359,20023,9418,16641,9235,6412,994,13734,8173,5561,580,580,7688,2721,4967
"2021","Gloucestershire","E10000013",279429,84836,39197,45639,180868,31624,89412,34109,40188,15115,33493,19263,12366,1864,25040,15309,9731,1299,1299,13725,4572,9153
"2021","Somerset","E10000027",250123,76028,38800,37228,161924,32777,76652,31471,31680,13501,29196,15532,11871,1793,22187,13838,8349,1112,1112,12171,4486,7685
"2021","Isle of Anglesey","W06000001",30823,10189,5223,4966,19438,3901,8642,3604,3175,1863,3296,1460,1627,209,3466,2087,1379,133,133,1196,512,684
"2021","Gwynedd","W06000002",51107,17664,8472,9192,30661,5354,13494,5437,5162,2895,6192,2922,2900,370,5348,3202,2146,273,273,2782,846,1936
"2021","Conwy","W06000003",52237,17909,9318,8591,32089,6674,14067,5945,5231,2891,5433,2715,2348,370,5698,3504,2194,217,217,2239,927,1312
"2021","Denbighshire","W06000004",42389,14107,6982,7125,26437,5027,11500,4627,4486,2387,4586,2136,2104,346,5124,3235,1889,200,200,1845,840,1005
"2021","Flintshire","W06000005",66911,19471,9639,9832,44660,7314,21092,7771,8850,4471,8158,4126,3494,538,7718,4706,3012,378,378,2780,1256,1524
"2021","Wrexham","W06000006",57914,17662,8042,9620,37799,5723,17048,6354,7039,3655,7265,3343,3431,491,7405,4887,2518,358,358,2453,1075,1378
"2021","Powys","W06000023",60182,19841,10468,9373,37836,8223,17750,7725,6516,3509,6644,3373,2857,414,4962,2843,2119,257,257,2505,958,1547
"2021","Ceredigion","W06000008",30895,10202,5102,5100,18649,3956,8475,3784,3034,1657,3381,1864,1346,171,2674,1525,1149,163,163,2044,519,1525
"2021","Pembrokeshire","W06000009",55488,18507,9289,9218,34588,6977,15683,6703,5839,3141,5720,2815,2536,369,5966,3855,2111,242,242,2393,1022,1371
"2021","Carmarthenshire","W06000010",81763,25350,12569,12781,52512,9525,24720,9851,9692,5177,8874,4218,4088,568,8986,5374,3612,407,407,3901,1684,2217
"2021","Swansea","W06000011",104961,36154,15259,20895,62927,10017,28088,9823,12309,5956,10904,5656,4540,708,13217,8371,4846,701,701,5880,1731,4149
"2021","Neath Port Talbot","W06000012",62374,20368,9034,11334,39549,6145,17666,6516,6960,4190,6731,3084,3116,531,8651,5429,3222,356,356,2457,1151,1306
"2021","Bridgend","W06000013",62360,18664,8535,10129,41059,6504,18986,7043,7800,4143,7487,3586,3378,523,7754,4766,2988,328,328,2637,1206,1431
"2021","Vale of Glamorgan","W06000014",57450,17841,8491,9350,37148,6151,17926,6460,8012,3454,6247,3129,2708,410,6582,4270,2312,242,242,2461,1090,1371
"2021","Cardiff","W06000015",147334,47463,16526,30937,86631,9890,39597,12263,20101,7233,17536,10999,5615,922,18168,12157,6011,1440,1440,13240,3363,9877
"2021","Rhondda Cynon Taff","W06000016",103340,32170,14049,18121,66700,9551,29263,10733,11799,6731,13273,5869,6349,1055,14028,9103,4925,585,585,4470,1971,2499
"2021","Merthyr Tydfil","W06000024",25781,8258,3464,4794,16477,2138,7150,2635,2730,1785,3082,1257,1572,253,3851,2548,1303,256,256,1046,560,486
"2021","Caerphilly","W06000018",76258,22966,10510,12456,50282,7422,22569,8302,9070,5197,9592,4213,4602,777,10333,6513,3820,366,366,3010,1479,1531
"2021","Blaenau Gwent","W06000019",30341,10175,4361,5814,19113,2612,8082,3130,2888,2064,3868,1642,1875,351,4372,2715,1657,179,179,1053,518,535
"2021","Torfaen","W06000020",40241,12316,5694,6622,26294,4003,11734,4384,4683,2667,5057,2311,2366,380,5307,3456,1851,193,193,1631,750,881
"2021","Monmouthshire","W06000021",40922,12287,6534,5753,26996,5583,13363,5309,5379,2675,4126,2235,1654,237,3771,2281,1490,153,153,1639,689,950
"2021","Newport","W06000022",66054,19997,8495,11502,42263,5325,19807,6611,9265,3931,8198,4147,3433,618,8455,5447,3008,478,478,3794,1930,1864
