"date","geography","geography code","Household composition: Total; measures: Value","Household composition: One person household; measures: Value","Household composition: One person household: Aged 66 years and over; measures: Value","Household composition: One person household: Other; measures: Value","Household composition: Single family household; measures: Value","Household composition: Single family household: All aged 66 years and over; measures: Value","Household composition: Single family household: Married or civil partnership couple; measures: Value","Household composition: Single family household: Married or civil partnership couple: No children; measures: Value","Household composition: Single family household: Married or civil partnership couple: Dependent children; measures: Value","Household composition: Single family household: Married or civil partnership couple: All children non-dependent; measures: Value","Household composition: Single family household: Cohabiting couple family; measures: Value","Household composition: Single family household: Cohabiting couple family: No children; measures: Value","Household composition: Single family household: Cohabiting couple family: With dependent children; measures: Value","Household composition: Single family household: Cohabiting couple family: All children non-dependent; measures: Value","Household composition: Single family household: Lone parent family; measures: Value","Household composition: Single family household: Lone parent family: With dependent children; measures: Value","Household composition: Single family household: Lone parent family: All children non-dependent; measures: Value","Household composition: Single family household: Other single family household; measures: Value","Household composition: Single family household: Other single family household: Other family composition; measures: Value","Household composition: Other household types; measures: Value","Household composition: Other household types: With dependent children; measures: Value","Household composition: Other household types: Other, including all full-time students and all aged 66 years and over; measures: Value"
"2021","Hartlepool 001A","E01011954",965,266,103,163,671,69,260,100,100,60,152,50,89,13,188,135,53,2,2,28,13,15
"2021","Hartlepool 001B","E01011969",599,157,92,65,431,116,189,78,61,50,70,27,36,7,56,33,23,0,0,11,7,4
"2021","Hartlepool 001C","E01011970",488,122,65,57,349,83,174,79,44,51,50,24,23,3,39,25,14,3,3,17,9,8
"2021","Hartlepool 001D","E01011971",521,104,32,72,406,42,235,77,102,56,68,33,30,5,61,37,24,0,0,11,6,5
"2021","Hartlepool 001F","E01033465",741,151,42,109,566,46,317,87,175,55,126,59,63,4,73,59,14,4,4,24,9,15
"2021","Hartlepool 001G","E01033467",1021,383,234,149,622,56,288,78,165,45,183,81,93,9,93,66,27,2,2,16,9,7
"2021","Hartlepool 002A","E01011952",669,225,108,117,422,34,165,75,60,30,72,28,38,6,147,109,38,4,4,22,7,15
"2021","Hartlepool 002B","E01011953",826,265,91,174,527,37,169,70,62,37,106,30,63,13,205,164,41,10,10,34,17,17
"2021","Hartlepool 002C","E01011991",754,271,123,148,448,71,195,88,55,52,96,49,37,10,79,52,27,7,7,35,15,20
"2021","Hartlepool 002D","E01011992",850,273,75,198,556,35,213,102,81,30,146,72,63,11,159,122,37,3,3,21,9,12
"2021","Hartlepool 002E","E01011993",852,368,130,238,456,57,171,61,56,54,92,47,38,7,133,84,49,3,3,28,13,15
"2021","Hartlepool 002F","E01011994",646,253,85,168,374,24,144,66,55,23,82,29,46,7,117,80,37,7,7,19,7,12
"2021","Hartlepool 003A","E01011955",582,220,73,147,338,30,115,46,43,26,80,33,41,6,110,77,33,3,3,24,16,8
"2021","Hartlepool 003C","E01011957",542,164,63,101,361,47,137,55,50,32,84,34,43,7,89,65,24,4,4,17,12,5
"2021","Hartlepool 003G","E01032540",452,143,60,83,297,35,152,78,54,20,42,20,18,4,65,46,19,3,3,12,7,5
"2021","Hartlepool 003H","E01032541",976,370,200,170,576,69,225,73,74,78,102,41,48,13,173,113,60,7,7,30,12,18
"2021","Hartlepool 003I","E01033466",984,304,120,184,643,44,209,73,82,54,136,56,69,11,247,197,50,7,7,37,17,20
"2021","Hartlepool 007A","E01011951",638,323,78,245,294,20,106,44,34,28,59,32,24,3,99,66,33,10,10,21,10,11
"2021","Hartlepool 007B","E01011964",496,166,59,107,282,45,150,52,67,31,42,17,21,4,43,22,21,2,2,48,27,21
"2021","Hartlepool 007C","E01011967",527,111,46,65,386,43,195,65,88,42,74,24,47,3,74,47,27,0,0,30,17,13
"2021","Hartlepool 007D","E01011999",858,423,126,297,380,37,133,64,46,23,76,34,38,4,126,80,46,8,8,55,20,35
"2021","Hartlepool 007E","E01012000",720,436,134,302,261,32,90,43,31,16,54,22,27,5,82,55,27,3,3,23,8,15
"2021","Hartlepool 008A","E01011950",554,290,66,224,240,22,75,36,23,16,57,39,16,2,82,54,28,4,4,24,10,14
"2021","Hartlepool 008B","E01011986",535,129,63,66,386,64,174,81,37,56,78,33,39,6,69,42,27,1,1,20,12,8
"2021","Hartlepool 008C","E01011987",607,204,69,135,379,48,152,57,64,31,77,35,35,7,97,72,25,5,5,24,12,12
"2021","Hartlepool 008D","E01012001",952,327,118,209,574,56,198,77,85,36,132,37,81,14,183,127,56,5,5,51,15,36
"2021","Hartlepool 009A","E01011949",758,221,100,121,500,52,223,87,89,47,86,31,46,9,133,93,40,6,6,37,18,19
"2021","Hartlepool 009B","E01011980",778,334,137,197,419,44,151,51,63,37,103,40,58,5,113,74,39,8,8,25,16,9
"2021","Hartlepool 009C","E01011981",701,219,92,127,451,40,147,50,64,33,89,18,60,11,173,129,44,2,2,31,21,10
"2021","Hartlepool 009D","E01011984",584,192,131,61,366,103,181,78,48,55,53,27,21,5,29,16,13,0,0,26,11,15
"2021","Hartlepool 010A","E01011985",575,181,83,98,385,84,168,78,47,43,69,37,29,3,64,40,24,0,0,9,3,6
"2021","Hartlepool 010B","E01011988",831,312,129,183,500,71,216,86,74,56,117,58,47,12,92,65,27,4,4,19,10,9
"2021","Hartlepool 010C","E01011989",819,287,125,162,497,50,207,79,81,47,117,42,66,9,121,84,37,2,2,35,20,15
"2021","Hartlepool 010D","E01011990",751,187,82,105,533,58,232,95,101,36,115,52,52,11,127,85,42,1,1,31,16,15
"2021","Hartlepool 011A","E01011995",577,142,99,43,415,109,196,74,57,65,57,26,25,6,52,25,27,1,1,20,9,11
"2021","Hartlepool 011B","E01011996",635,224,106,118,391,91,166,76,50,40,68,38,27,3,66,35,31,0,0,20,8,12
"2021","Hartlepool 011C","E01011997",819,192,108,84,606,120,320,133,129,58,94,49,40,5,71,36,35,1,1,21,8,13
"2021","Hartlepool 011D","E01011998",931,270,147,123,640,102,325,125,140,60,138,51,78,9,73,54,19,2,2,21,15,6
"2021","Hartlepool 012A","E01011961",617,184,87,97,412,60,186,81,69,36,63,22,36,5,97,74,23,6,6,21,7,14
"2021","Hartlepool 012B","E01011962",612,184,77,107,413,52,148,59,50,39,74,30,37,7,139,112,27,0,0,15,9,6
"2021","Hartlepool 012C","E01011977",743,218,78,140,488,34,148,58,47,43,105,36,58,11,197,156,41,4,4,37,17,20
"2021","Hartlepool 012D","E01011978",803,370,118,252,411,24,107,43,42,22,100,42,46,12,178,141,37,2,2,22,10,12
"2021","Hartlepool 012E","E01011979",624,173,67,106,426,30,109,48,28,33,104,36,63,5,179,131,48,4,4,25,17,8
"2021","Hartlepool 014A","E01011959",1134,235,120,115,849,130,489,179,228,82,153,84,58,11,73,42,31,4,4,50,19,31
"2021","Hartlepool 014B","E01011960",613,180,136,44,424,149,185,87,50,48,61,28,29,4,29,16,13,0,0,9,4,5
"2021","Hartlepool 014C","E01011963",664,205,111,94,447,116,216,105,59,52,68,34,27,7,47,27,20,0,0,12,2,10
"2021","Hartlepool 014D","E01011968",950,348,190,158,576,130,289,139,74,76,79,44,30,5,71,39,32,7,7,26,12,14
"2021","Hartlepool 014E","E01011982",678,118,74,44,544,124,317,122,141,54,78,36,33,9,25,14,11,0,0,16,7,9
"2021","Hartlepool 014F","E01012003",755,219,133,86,514,124,264,110,95,59,80,40,33,7,45,29,16,1,1,22,11,11
"2021","Hartlepool 014G","E01012005",720,109,47,62,589,68,349,118,140,91,105,47,49,9,66,43,23,1,1,22,10,12
"2021","Hartlepool 015G","E01011965",654,142,88,54,481,99,262,98,108,56,72,36,27,9,48,27,21,0,0,31,14,17
"2021","Hartlepool 015E","E01011966",610,214,85,129,370,64,170,68,67,35,76,42,31,3,58,34,24,2,2,26,19,7
"2021","Hartlepool 015B","E01011974",899,535,101,434,328,28,124,81,32,11,96,69,24,3,71,41,30,9,9,36,11,25
"2021","Hartlepool 015D","E01011975",562,244,67,177,303,31,127,56,46,25,61,29,28,4,78,53,25,6,6,15,4,11
"2021","Hartlepool 015F","E01011983",650,117,82,35,504,96,312,108,140,64,56,30,21,5,39,18,21,1,1,29,11,18
"2021","Hartlepool 015A","E01012002",629,222,87,135,387,73,167,57,67,43,74,32,35,7,69,42,27,4,4,20,8,12
"2021","Hartlepool 015C","E01035188",937,399,110,289,476,47,164,75,58,31,124,62,50,12,133,89,44,8,8,62,29,33
"2021","Middlesbrough 001A","E01012068",698,341,35,306,200,4,84,28,49,7,44,31,12,1,51,30,21,17,17,157,17,140
"2021","Middlesbrough 001D","E01012092",630,272,96,176,239,16,103,20,67,16,25,9,16,0,65,42,23,30,30,119,27,92
"2021","Middlesbrough 001E","E01012093",693,200,27,173,361,4,190,37,133,20,45,29,13,3,76,53,23,46,46,132,35,97
"2021","Middlesbrough 001H","E01035189",675,493,119,374,148,5,56,30,22,4,40,35,3,2,37,23,14,10,10,34,0,34
"2021","Middlesbrough 001I","E01035190",650,264,60,204,298,6,146,26,104,16,31,16,14,1,99,53,46,16,16,88,29,59
"2021","Middlesbrough 001J","E01035191",695,240,37,203,402,21,197,56,112,29,64,29,31,4,103,67,36,17,17,53,30,23
"2021","Middlesbrough 001K","E01035192",424,155,31,124,197,3,97,19,66,12,40,22,15,3,52,29,23,5,5,72,25,47
"2021","Middlesbrough 002A","E01012058",773,326,64,262,371,24,122,40,63,19,85,48,31,6,121,95,26,19,19,76,27,49
"2021","Middlesbrough 002B","E01012059",777,368,117,251,355,24,122,51,46,25,80,44,29,7,116,86,30,13,13,54,23,31
"2021","Middlesbrough 002C","E01012060",690,235,84,151,424,22,110,39,47,24,88,28,54,6,193,145,48,11,11,31,17,14
"2021","Middlesbrough 002D","E01012061",501,138,54,84,344,15,106,50,34,22,74,25,43,6,142,118,24,7,7,19,7,12
"2021","Middlesbrough 003A","E01012036",622,194,42,152,290,13,91,20,57,14,59,45,12,2,102,70,32,25,25,138,31,107
"2021","Middlesbrough 003B","E01012037",650,252,45,207,329,15,110,31,70,9,66,28,34,4,117,87,30,21,21,69,18,51
"2021","Middlesbrough 003C","E01012038",601,210,47,163,331,25,116,32,63,21,62,30,27,5,118,82,36,10,10,60,32,28
"2021","Middlesbrough 003D","E01012039",585,217,37,180,203,10,72,21,48,3,34,25,9,0,67,48,19,20,20,165,23,142
"2021","Middlesbrough 003E","E01012040",571,204,38,166,286,8,115,28,74,13,54,35,19,0,88,60,28,21,21,81,25,56
"2021","Middlesbrough 003F","E01012041",611,363,135,228,217,16,75,31,32,12,33,23,8,2,87,52,35,6,6,31,12,19
"2021","Middlesbrough 004A","E01012074",627,179,71,108,427,26,158,52,60,46,88,25,52,11,149,106,43,6,6,21,14,7
"2021","Middlesbrough 004B","E01012075",623,188,56,132,407,11,113,34,54,25,78,25,46,7,198,136,62,7,7,28,20,8
"2021","Middlesbrough 004C","E01012076",512,114,35,79,363,18,85,23,41,21,74,14,53,7,181,134,47,5,5,35,22,13
"2021","Middlesbrough 004D","E01012077",651,229,119,110,397,48,149,61,44,44,57,18,35,4,136,94,42,7,7,25,14,11
"2021","Middlesbrough 004E","E01012088",656,179,50,129,443,21,154,48,67,39,115,48,57,10,146,103,43,7,7,34,17,17
"2021","Middlesbrough 005A","E01012078",629,246,46,200,320,23,117,36,69,12,54,28,19,7,113,79,34,13,13,63,23,40
"2021","Middlesbrough 005B","E01012079",536,117,49,68,376,42,192,61,94,37,61,38,18,5,70,39,31,11,11,43,22,21
"2021","Middlesbrough 005C","E01012080",502,174,73,101,301,37,145,52,62,31,46,17,17,12,66,43,23,7,7,27,12,15
"2021","Middlesbrough 005D","E01012081",664,233,84,149,373,44,177,47,101,29,68,31,32,5,82,41,41,2,2,58,37,21
"2021","Middlesbrough 006A","E01012026",819,235,78,157,539,45,280,79,143,58,104,46,47,11,106,63,43,4,4,45,23,22
"2021","Middlesbrough 006B","E01012027",882,374,132,242,473,23,184,66,87,31,106,50,50,6,150,107,43,10,10,35,15,20
"2021","Middlesbrough 006E","E01033469",903,261,95,166,597,48,213,64,110,39,94,39,49,6,233,177,56,9,9,45,32,13
"2021","Middlesbrough 007A","E01012015",730,357,154,203,348,44,105,41,37,27,67,32,25,10,124,74,50,8,8,25,18,7
"2021","Middlesbrough 007B","E01012016",835,368,125,243,437,26,139,50,51,38,90,39,47,4,175,148,27,7,7,30,11,19
"2021","Middlesbrough 007C","E01012017",727,257,128,129,449,98,190,90,42,58,77,32,37,8,77,39,38,7,7,21,9,12
"2021","Middlesbrough 007D","E01012089",660,245,108,137,375,18,113,36,42,35,67,23,36,8,163,134,29,14,14,40,23,17
"2021","Middlesbrough 007E","E01012090",687,290,88,202,368,31,105,40,37,28,72,28,33,11,152,108,44,8,8,29,15,14
"2021","Middlesbrough 007F","E01012091",712,158,65,93,520,22,173,50,85,38,121,33,78,10,196,149,47,8,8,34,17,17
"2021","Middlesbrough 008A","E01012011",857,290,105,185,538,32,162,47,81,34,101,43,47,11,236,165,71,7,7,29,20,9
"2021","Middlesbrough 008B","E01012012",639,127,60,67,467,56,239,73,103,63,95,32,54,9,74,46,28,3,3,45,30,15
"2021","Middlesbrough 008C","E01012013",614,191,71,120,394,16,168,58,65,45,82,23,44,15,121,86,35,7,7,29,18,11
"2021","Middlesbrough 008D","E01012014",627,168,58,110,416,24,130,47,64,19,96,35,51,10,160,123,37,6,6,43,24,19
"2021","Middlesbrough 009A","E01012053",637,153,76,77,433,68,243,72,122,49,59,24,29,6,61,31,30,2,2,51,32,19
"2021","Middlesbrough 009B","E01012054",637,166,83,83,426,49,235,64,119,52,65,32,27,6,73,41,32,4,4,45,26,19
"2021","Middlesbrough 009C","E01012055",763,230,106,124,485,75,258,78,111,69,82,46,30,6,66,36,30,4,4,48,35,13
"2021","Middlesbrough 009D","E01012056",993,352,70,282,586,27,252,68,140,44,146,80,59,7,157,111,46,4,4,55,29,26
"2021","Middlesbrough 009E","E01012057",749,245,83,162,450,50,224,73,109,42,81,41,32,8,90,59,31,5,5,54,31,23
"2021","Middlesbrough 010A","E01012082",642,185,69,116,433,39,122,45,36,41,78,22,40,16,191,132,59,3,3,24,15,9
"2021","Middlesbrough 010B","E01012083",639,163,56,107,448,21,134,39,62,33,89,29,56,4,195,145,50,9,9,28,15,13
"2021","Middlesbrough 010C","E01012084",725,249,104,145,442,30,113,42,39,32,90,29,44,17,204,153,51,5,5,34,13,21
"2021","Middlesbrough 010D","E01012085",636,171,48,123,436,28,119,41,44,34,92,23,56,13,193,146,47,4,4,29,18,11
"2021","Middlesbrough 011A","E01012018",643,330,91,239,285,23,139,48,64,27,53,27,23,3,66,45,21,4,4,28,6,22
"2021","Middlesbrough 011B","E01012019",558,227,82,145,317,28,71,23,27,21,58,21,33,4,158,116,42,2,2,14,9,5
"2021","Middlesbrough 011C","E01012020",597,179,72,107,384,36,147,46,65,36,81,25,45,11,114,80,34,6,6,34,16,18
"2021","Middlesbrough 011D","E01012021",526,152,60,92,343,19,97,32,43,22,60,12,34,14,166,115,51,1,1,31,19,12
"2021","Middlesbrough 012A","E01012007",649,227,137,90,392,96,177,66,76,35,58,26,25,7,55,30,25,6,6,30,18,12
"2021","Middlesbrough 012B","E01012008",536,124,64,60,387,46,205,58,93,54,61,23,30,8,74,41,33,1,1,25,13,12
"2021","Middlesbrough 012C","E01012009",820,248,86,162,546,73,274,92,134,48,108,49,54,5,91,65,26,0,0,26,13,13
"2021","Middlesbrough 012D","E01012010",549,117,73,44,410,75,222,66,110,46,61,25,31,5,49,24,25,3,3,22,12,10
"2021","Middlesbrough 013A","E01012046",943,346,188,158,564,124,253,102,95,56,96,54,37,5,85,44,41,6,6,33,18,15
"2021","Middlesbrough 013B","E01012047",582,132,83,49,416,54,235,59,120,56,59,23,33,3,65,31,34,3,3,34,25,9
"2021","Middlesbrough 013C","E01012048",751,216,148,68,501,103,256,86,109,61,75,38,25,12,64,34,30,3,3,34,19,15
"2021","Middlesbrough 014A","E01012049",609,221,87,134,367,80,166,86,44,36,74,41,29,4,46,20,26,1,1,21,13,8
"2021","Middlesbrough 014B","E01012050",607,207,96,111,372,19,113,36,54,23,79,32,43,4,157,117,40,4,4,28,15,13
"2021","Middlesbrough 014C","E01012051",499,136,48,88,329,19,132,56,45,31,62,23,31,8,108,69,39,8,8,34,24,10
"2021","Middlesbrough 014D","E01012052",527,150,78,72,363,74,153,66,46,41,67,34,25,8,66,39,27,3,3,14,7,7
"2021","Middlesbrough 015A","E01012022",1158,251,86,165,882,94,423,123,221,79,247,133,105,9,115,86,29,3,3,25,15,10
"2021","Middlesbrough 015B","E01012023",746,274,200,74,452,169,192,98,51,43,55,31,18,6,34,14,20,2,2,20,8,12
"2021","Middlesbrough 015C","E01012024",687,190,111,79,478,98,212,81,83,48,91,36,48,7,74,45,29,3,3,19,11,8
"2021","Middlesbrough 015D","E01012025",522,135,92,43,376,92,180,69,64,47,51,17,29,5,52,24,28,1,1,11,6,5
"2021","Middlesbrough 017A","E01012065",838,221,134,87,592,155,296,115,120,61,77,43,31,3,64,38,26,0,0,25,17,8
"2021","Middlesbrough 017B","E01012066",730,138,43,95,569,71,329,104,146,79,108,53,49,6,60,35,25,1,1,23,15,8
"2021","Middlesbrough 017C","E01012067",738,243,166,77,478,156,216,87,82,47,66,31,33,2,36,15,21,4,4,17,9,8
"2021","Middlesbrough 018A","E01012042",718,365,146,219,337,47,136,57,51,28,74,29,39,6,78,48,30,2,2,16,5,11
"2021","Middlesbrough 018B","E01012043",610,193,106,87,396,119,156,71,48,37,63,24,31,8,53,29,24,5,5,21,11,10
"2021","Middlesbrough 018C","E01012044",653,237,75,162,397,30,128,44,64,20,85,21,58,6,148,116,32,6,6,19,8,11
"2021","Middlesbrough 018D","E01012045",611,210,95,115,377,26,116,40,50,26,63,24,38,1,163,126,37,9,9,24,17,7
"2021","Middlesbrough 018G","E01032552",668,202,68,134,442,44,192,74,69,49,98,33,55,10,103,63,40,5,5,24,14,10
"2021","Middlesbrough 018I","E01035193",695,145,82,63,524,116,247,111,92,44,118,77,38,3,38,17,21,5,5,26,11,15
"2021","Middlesbrough 018J","E01035194",574,176,40,136,376,29,136,59,59,18,176,116,58,2,34,23,11,1,1,22,8,14
"2021","Middlesbrough 019A","E01012030",633,226,136,90,391,65,221,100,77,44,56,27,25,4,48,37,11,1,1,16,8,8
"2021","Middlesbrough 019B","E01012031",750,342,140,202,383,59,155,74,51,30,76,33,35,8,90,58,32,3,3,25,10,15
"2021","Middlesbrough 019C","E01012032",619,90,29,61,501,68,296,97,143,56,83,35,37,11,54,39,15,0,0,28,16,12
"2021","Middlesbrough 019D","E01012033",624,339,127,212,269,33,108,48,36,24,51,33,16,2,76,45,31,1,1,16,6,10
"2021","Middlesbrough 019E","E01012034",554,122,59,63,408,44,229,89,89,51,52,22,27,3,82,53,29,1,1,24,12,12
"2021","Middlesbrough 019F","E01012035",607,263,136,127,320,49,112,45,37,30,72,34,31,7,83,55,28,4,4,24,6,18
"2021","Middlesbrough 020A","E01012062",765,199,109,90,547,113,284,81,139,64,92,47,40,5,58,29,29,0,0,19,11,8
"2021","Middlesbrough 020B","E01012063",647,220,151,69,407,95,183,72,74,37,65,34,27,4,62,37,25,2,2,20,8,12
"2021","Middlesbrough 020D","E01012071",571,125,102,23,428,140,228,72,110,46,38,18,19,1,22,9,13,0,0,18,10,8
"2021","Middlesbrough 020E","E01012073",588,152,88,64,415,107,210,77,95,38,53,28,21,4,45,28,17,0,0,21,12,9
"2021","Middlesbrough 020F","E01032593",942,174,105,69,735,130,471,146,236,89,84,35,45,4,49,28,21,1,1,33,19,14
"2021","Middlesbrough 020G","E01035195",627,136,20,116,456,30,253,66,148,39,104,52,50,2,64,50,14,5,5,35,11,24
"2021","Middlesbrough 020H","E01035196",580,213,80,133,342,71,168,73,71,24,55,28,23,4,47,29,18,1,1,25,7,18
"2021","Redcar and Cleveland 001A","E01012100",845,508,108,400,296,25,106,46,42,18,56,40,16,0,99,52,47,10,10,41,11,30
"2021","Redcar and Cleveland 001B","E01012101",688,334,145,189,314,57,133,48,53,32,57,30,24,3,65,42,23,2,2,40,16,24
"2021","Redcar and Cleveland 001C","E01012102",978,409,109,300,526,37,179,67,74,38,129,59,65,5,167,121,46,14,14,43,16,27
"2021","Redcar and Cleveland 001D","E01012184",614,203,91,112,392,47,167,69,57,41,79,27,45,7,98,57,41,1,1,19,10,9
"2021","Redcar and Cleveland 002A","E01012105",591,179,96,83,394,48,194,78,72,44,82,25,44,13,70,44,26,0,0,18,10,8
"2021","Redcar and Cleveland 002B","E01012142",710,227,132,95,457,65,202,80,68,54,88,30,46,12,100,65,35,2,2,26,12,14
"2021","Redcar and Cleveland 002C","E01012143",646,196,68,128,427,39,122,38,62,22,106,42,57,7,156,124,32,4,4,23,12,11
"2021","Redcar and Cleveland 002D","E01012144",612,188,92,96,397,65,176,68,69,39,75,36,35,4,78,44,34,3,3,27,11,16
"2021","Redcar and Cleveland 003C","E01012106",590,186,104,82,383,62,187,86,61,40,80,30,43,7,54,35,19,0,0,21,8,13
"2021","Redcar and Cleveland 003D","E01012107",653,279,132,147,347,37,125,57,44,24,73,27,37,9,108,70,38,4,4,27,15,12
"2021","Redcar and Cleveland 003E","E01032560",511,154,89,65,333,65,167,68,54,45,57,28,22,7,41,20,21,3,3,24,14,10
"2021","Redcar and Cleveland 003F","E01032561",630,197,62,135,402,19,129,38,63,28,89,30,52,7,161,115,46,4,4,31,18,13
"2021","Redcar and Cleveland 004A","E01012176",673,225,150,75,426,94,207,92,68,47,76,39,30,7,44,21,23,5,5,22,10,12
"2021","Redcar and Cleveland 004B","E01012177",607,184,90,94,410,74,224,94,85,45,63,29,30,4,45,24,21,4,4,13,8,5
"2021","Redcar and Cleveland 004C","E01012178",601,163,79,84,421,88,208,73,78,57,67,38,26,3,57,27,30,1,1,17,9,8
"2021","Redcar and Cleveland 004D","E01012179",908,239,117,122,653,105,333,112,152,69,152,78,70,4,61,44,17,2,2,16,4,12
"2021","Redcar and Cleveland 004E","E01012180",605,113,42,71,472,57,309,91,142,76,69,25,41,3,36,20,16,1,1,20,8,12
"2021","Redcar and Cleveland 004F","E01012185",618,199,99,100,405,45,185,80,67,38,86,37,44,5,88,58,30,1,1,14,6,8
"2021","Redcar and Cleveland 004G","E01012186",748,229,139,90,495,98,241,118,79,44,85,47,30,8,70,33,37,1,1,24,8,16
"2021","Redcar and Cleveland 005A","E01012127",517,247,99,148,252,19,80,24,36,20,61,24,35,2,84,62,22,8,8,18,12,6
"2021","Redcar and Cleveland 005B","E01012128",636,264,131,133,351,33,126,45,50,31,65,23,32,10,126,93,33,1,1,21,9,12
"2021","Redcar and Cleveland 005C","E01012129",1011,301,172,129,667,113,320,123,152,45,121,52,60,9,113,70,43,0,0,43,24,19
"2021","Redcar and Cleveland 005D","E01012130",587,206,109,97,367,96,166,76,50,40,56,31,22,3,47,25,22,2,2,14,5,9
"2021","Redcar and Cleveland 005E","E01012131",644,283,161,122,345,60,104,36,45,23,65,14,43,8,113,79,34,3,3,16,7,9
"2021","Redcar and Cleveland 006A","E01012138",1171,242,115,127,907,129,502,160,246,96,162,75,75,12,113,81,32,1,1,22,11,11
"2021","Redcar and Cleveland 006B","E01012139",774,186,115,71,562,140,294,129,97,68,78,43,29,6,50,30,20,0,0,26,12,14
"2021","Redcar and Cleveland 006C","E01012140",602,220,109,111,373,80,133,53,47,33,73,35,30,8,85,57,28,2,2,9,5,4
"2021","Redcar and Cleveland 006D","E01012141",488,141,99,42,341,97,156,68,50,38,44,22,18,4,43,16,27,1,1,6,6,0
"2021","Redcar and Cleveland 006E","E01012154",591,227,171,56,357,135,138,60,39,39,40,25,12,3,43,20,23,1,1,7,2,5
"2021","Redcar and Cleveland 006F","E01012155",874,358,163,195,499,89,202,68,102,32,93,43,43,7,110,68,42,5,5,17,6,11
"2021","Redcar and Cleveland 006G","E01012156",722,214,147,67,477,125,212,74,81,57,72,36,32,4,61,28,33,7,7,31,16,15
"2021","Redcar and Cleveland 006H","E01012157",739,283,152,131,432,97,183,68,70,45,80,35,36,9,71,39,32,1,1,24,12,12
"2021","Redcar and Cleveland 007A","E01012158",647,184,133,51,450,134,227,93,87,47,39,23,15,1,49,26,23,1,1,13,8,5
"2021","Redcar and Cleveland 007B","E01012159",820,477,184,293,320,60,108,58,36,14,85,64,14,7,63,40,23,4,4,23,6,17
"2021","Redcar and Cleveland 007C","E01012160",731,244,153,91,457,102,206,106,66,34,72,33,32,7,73,51,22,4,4,30,16,14
"2021","Redcar and Cleveland 007D","E01012161",671,270,114,156,374,65,166,66,75,25,69,31,36,2,68,43,25,6,6,27,5,22
"2021","Redcar and Cleveland 009A","E01012113",540,143,47,96,380,15,111,34,48,29,89,23,54,12,161,123,38,4,4,17,10,7
"2021","Redcar and Cleveland 009B","E01012114",640,272,56,216,337,17,74,26,31,17,98,32,60,6,140,113,27,8,8,31,17,14
"2021","Redcar and Cleveland 009E","E01012175",652,256,106,150,378,40,106,39,30,37,77,26,42,9,152,120,32,3,3,18,10,8
"2021","Redcar and Cleveland 009F","E01033471",841,233,88,145,573,35,192,68,77,47,123,38,77,8,214,161,53,9,9,35,19,16
"2021","Redcar and Cleveland 010A","E01012095",528,118,72,46,396,106,194,87,65,42,63,29,26,8,33,17,16,0,0,14,5,9
"2021","Redcar and Cleveland 010B","E01012097",508,137,86,51,359,116,152,71,44,37,47,26,15,6,43,29,14,1,1,12,4,8
"2021","Redcar and Cleveland 010C","E01012098",681,176,82,94,487,85,227,97,85,45,88,35,47,6,80,55,25,7,7,18,8,10
"2021","Redcar and Cleveland 010D","E01012099",663,246,77,169,391,26,135,55,48,32,104,37,63,4,119,88,31,7,7,26,11,15
"2021","Redcar and Cleveland 011A","E01012108",609,183,79,104,408,45,137,59,47,31,80,32,33,15,141,95,46,5,5,18,11,7
"2021","Redcar and Cleveland 011B","E01012109",615,224,64,160,367,45,165,75,55,35,80,61,16,3,72,35,37,5,5,24,10,14
"2021","Redcar and Cleveland 011C","E01012110",611,219,66,153,369,46,177,80,55,42,73,37,30,6,67,46,21,6,6,23,9,14
"2021","Redcar and Cleveland 011D","E01012111",624,286,159,127,313,47,130,50,43,37,53,23,26,4,79,53,26,4,4,25,15,10
"2021","Redcar and Cleveland 011E","E01012171",723,299,187,112,404,79,143,70,28,45,63,24,27,12,116,76,40,3,3,20,11,9
"2021","Redcar and Cleveland 011F","E01012172",615,203,108,95,391,91,162,78,44,40,68,38,20,10,70,44,26,0,0,21,10,11
"2021","Redcar and Cleveland 012A","E01012162",620,215,82,133,391,62,186,79,64,43,72,37,32,3,69,41,28,2,2,14,5,9
"2021","Redcar and Cleveland 012B","E01012163",962,194,119,75,737,142,418,147,185,86,115,44,65,6,57,37,20,5,5,31,18,13
"2021","Redcar and Cleveland 012C","E01012164",740,242,124,118,482,98,224,120,63,41,87,44,33,10,73,40,33,0,0,16,6,10
"2021","Redcar and Cleveland 012D","E01012165",1063,351,143,208,676,76,241,100,101,40,160,56,89,15,195,128,67,4,4,36,19,17
"2021","Redcar and Cleveland 013A","E01012096",673,260,103,157,397,51,148,62,49,37,84,39,39,6,112,75,37,2,2,16,7,9
"2021","Redcar and Cleveland 013D","E01012136",639,247,88,159,367,56,161,82,51,28,75,36,35,4,73,45,28,2,2,25,14,11
"2021","Redcar and Cleveland 013E","E01033473",913,294,148,146,581,73,222,92,87,43,137,27,103,7,147,99,48,2,2,38,25,13
"2021","Redcar and Cleveland 015A","E01012112",711,343,94,249,341,32,77,36,21,20,62,29,30,3,168,144,24,2,2,27,13,14
"2021","Redcar and Cleveland 015B","E01012145",665,224,91,133,424,45,196,66,66,64,82,42,29,11,98,64,34,3,3,17,7,10
"2021","Redcar and Cleveland 015C","E01012147",741,184,101,83,536,118,281,95,111,75,95,42,46,7,41,25,16,1,1,21,9,12
"2021","Redcar and Cleveland 015D","E01012149",499,118,85,33,372,104,191,82,59,50,49,23,21,5,27,16,11,1,1,9,3,6
"2021","Redcar and Cleveland 016A","E01012132",886,305,130,175,552,121,225,96,65,64,89,43,40,6,116,71,45,1,1,29,15,14
"2021","Redcar and Cleveland 016B","E01012134",701,269,151,118,417,97,180,106,42,32,84,51,27,6,50,25,25,6,6,15,4,11
"2021","Redcar and Cleveland 016C","E01012137",592,154,75,79,420,101,182,83,59,40,79,32,40,7,57,41,16,1,1,18,9,9
"2021","Redcar and Cleveland 016D","E01012181",716,230,100,130,457,55,197,101,60,36,107,38,58,11,95,70,25,3,3,29,15,14
"2021","Redcar and Cleveland 018A","E01012117",1054,481,234,247,554,102,196,88,84,24,118,68,44,6,130,88,42,8,8,19,10,9
"2021","Redcar and Cleveland 018B","E01012118",655,268,106,162,379,74,142,63,47,32,71,34,30,7,87,63,24,5,5,8,2,6
"2021","Redcar and Cleveland 018C","E01012119",891,258,113,145,605,72,293,128,109,56,109,53,48,8,128,98,30,3,3,28,16,12
"2021","Redcar and Cleveland 018D","E01012121",633,293,109,184,319,22,125,59,39,27,70,21,39,10,99,64,35,3,3,21,12,9
"2021","Redcar and Cleveland 019E","E01032548",724,176,132,44,530,195,253,98,99,56,48,29,17,2,32,16,16,2,2,18,11,7
"2021","Redcar and Cleveland 019F","E01032549",1071,246,112,134,811,183,385,157,161,67,139,72,57,10,100,72,28,4,4,14,10,4
"2021","Redcar and Cleveland 019G","E01033472",1054,317,141,176,707,101,324,135,129,60,113,50,52,11,166,115,51,3,3,30,19,11
"2021","Redcar and Cleveland 020A","E01012120",590,195,130,65,379,130,172,83,46,43,45,26,18,1,31,19,12,1,1,16,8,8
"2021","Redcar and Cleveland 020B","E01012124",689,155,103,52,519,175,250,97,111,42,58,27,28,3,34,14,20,2,2,15,9,6
"2021","Redcar and Cleveland 020C","E01012182",599,161,110,51,429,151,198,91,67,40,49,24,22,3,29,13,16,2,2,9,2,7
"2021","Redcar and Cleveland 020D","E01012183",621,136,75,61,468,98,245,107,89,49,77,37,35,5,48,23,25,0,0,17,7,10
"2021","Redcar and Cleveland 021A","E01012148",651,269,81,188,358,42,105,34,48,23,65,19,34,12,139,95,44,7,7,24,13,11
"2021","Redcar and Cleveland 021B","E01012150",724,281,106,175,416,52,105,47,41,17,86,28,42,16,170,130,40,3,3,27,19,8
"2021","Redcar and Cleveland 021C","E01012151",640,186,128,58,420,104,185,80,52,53,75,32,29,14,52,23,29,4,4,34,13,21
"2021","Redcar and Cleveland 021D","E01012152",759,198,99,99,534,109,249,89,101,59,111,65,38,8,64,29,35,1,1,27,13,14
"2021","Redcar and Cleveland 021E","E01032594",676,234,166,68,426,106,214,96,75,43,55,20,34,1,50,30,20,1,1,16,10,6
"2021","Redcar and Cleveland 022A","E01012146",525,136,84,52,378,115,172,74,50,48,49,28,20,1,41,22,19,1,1,11,5,6
"2021","Redcar and Cleveland 022B","E01012167",822,180,67,113,609,49,262,82,117,63,155,60,82,13,141,93,48,2,2,33,17,16
"2021","Redcar and Cleveland 022C","E01012168",851,269,96,173,536,35,209,73,87,49,141,46,84,11,145,97,48,6,6,46,23,23
"2021","Redcar and Cleveland 022D","E01012170",551,202,76,126,326,22,105,48,32,25,52,20,27,5,140,115,25,7,7,23,14,9
"2021","Redcar and Cleveland 022E","E01012173",525,172,90,82,340,84,147,65,41,41,61,36,19,6,47,23,24,1,1,13,6,7
"2021","Redcar and Cleveland 022F","E01012174",479,121,77,44,349,78,167,61,63,43,68,27,31,10,36,24,12,0,0,9,3,6
"2021","Redcar and Cleveland 022G","E01033470",829,341,112,229,428,38,160,60,60,40,90,51,31,8,132,92,40,8,8,60,35,25
"2021","Stockton-on-Tees 001A","E01012242",621,162,99,63,440,95,216,92,84,40,67,36,28,3,58,25,33,4,4,19,11,8
"2021","Stockton-on-Tees 001B","E01012243",648,202,82,120,442,68,237,80,107,50,67,37,26,4,69,45,24,1,1,4,3,1
"2021","Stockton-on-Tees 001C","E01012244",621,195,87,108,411,72,225,95,70,60,69,36,30,3,44,29,15,1,1,15,7,8
"2021","Stockton-on-Tees 001D","E01012246",572,150,55,95,406,72,225,113,71,41,66,37,23,6,41,23,18,2,2,16,10,6
"2021","Stockton-on-Tees 001E","E01012296",594,245,121,124,331,72,165,91,53,21,53,29,22,2,41,25,16,0,0,18,5,13
"2021","Stockton-on-Tees 001F","E01012297",986,195,90,105,745,102,465,178,186,101,106,64,36,6,70,39,31,2,2,46,26,20
"2021","Stockton-on-Tees 002A","E01012197",789,258,81,177,499,52,200,81,83,36,101,41,53,7,139,89,50,7,7,32,14,18
"2021","Stockton-on-Tees 002B","E01012256",608,211,148,63,388,128,173,92,45,36,42,22,17,3,43,18,25,2,2,9,4,5
"2021","Stockton-on-Tees 002C","E01012257",621,182,115,67,431,84,236,97,90,49,63,29,31,3,46,27,19,2,2,8,4,4
"2021","Stockton-on-Tees 002D","E01012275",629,188,87,101,402,41,179,65,71,43,86,34,45,7,94,57,37,2,2,39,25,14
"2021","Stockton-on-Tees 002E","E01012276",921,464,176,288,438,59,186,74,77,35,100,52,41,7,89,58,31,4,4,19,7,12
"2021","Stockton-on-Tees 002F","E01012277",691,180,79,101,470,44,188,85,73,30,94,42,46,6,140,101,39,4,4,41,23,18
"2021","Stockton-on-Tees 003A","E01012196",671,208,96,112,441,51,193,73,64,56,97,46,44,7,94,58,36,6,6,22,13,9
"2021","Stockton-on-Tees 003B","E01012198",595,198,55,143,364,32,132,56,55,21,88,38,40,10,104,69,35,8,8,33,12,21
"2021","Stockton-on-Tees 003C","E01012214",620,157,84,73,423,34,171,61,77,33,86,38,44,4,123,88,35,9,9,40,25,15
"2021","Stockton-on-Tees 003D","E01012215",507,181,48,133,302,23,109,33,50,26,76,31,33,12,90,62,28,4,4,24,11,13
"2021","Stockton-on-Tees 003E","E01012216",510,162,71,91,328,19,127,47,50,30,68,27,37,4,111,84,27,3,3,20,12,8
"2021","Stockton-on-Tees 003F","E01012245",706,278,105,173,398,44,132,52,60,20,85,30,49,6,132,92,40,5,5,30,6,24
"2021","Stockton-on-Tees 004A","E01012278",494,147,66,81,326,25,137,56,54,27,74,40,26,8,89,55,34,1,1,21,10,11
"2021","Stockton-on-Tees 004B","E01012279",633,132,61,71,474,39,235,87,94,54,103,51,46,6,94,59,35,3,3,27,14,13
"2021","Stockton-on-Tees 004C","E01012280",687,190,114,76,470,124,197,83,76,38,70,37,30,3,76,38,38,3,3,27,14,13
"2021","Stockton-on-Tees 004D","E01012281",633,289,137,152,330,40,134,58,48,28,71,29,35,7,81,58,23,4,4,14,6,8
"2021","Stockton-on-Tees 005A","E01012255",639,213,172,41,414,154,200,89,70,41,30,24,4,2,29,13,16,1,1,12,5,7
"2021","Stockton-on-Tees 005B","E01012269",660,160,85,75,482,122,266,104,111,51,53,30,15,8,40,14,26,1,1,18,12,6
"2021","Stockton-on-Tees 005D","E01012294",555,112,58,54,419,80,239,106,83,50,74,42,30,2,25,16,9,1,1,24,9,15
"2021","Stockton-on-Tees 005E","E01012295",563,141,52,89,404,43,207,71,97,39,73,37,33,3,81,63,18,0,0,18,9,9
"2021","Stockton-on-Tees 005F","E01033476",729,113,41,72,576,87,392,154,185,53,65,35,30,0,30,18,12,2,2,40,16,24
"2021","Stockton-on-Tees 005G","E01033480",1145,176,75,101,931,140,546,208,263,75,175,95,77,3,67,45,22,3,3,38,17,21
"2021","Stockton-on-Tees 006A","E01012210",636,150,86,64,470,107,243,94,103,46,76,41,29,6,43,31,12,1,1,16,9,7
"2021","Stockton-on-Tees 006B","E01012211",758,188,100,88,553,88,307,99,148,60,99,60,35,4,58,36,22,1,1,17,6,11
"2021","Stockton-on-Tees 006C","E01012212",730,240,139,101,472,120,226,111,70,45,81,50,29,2,42,31,11,3,3,18,4,14
"2021","Stockton-on-Tees 006D","E01012213",709,312,227,85,384,142,148,76,37,35,58,31,21,6,35,18,17,1,1,13,5,8
"2021","Stockton-on-Tees 007A","E01012192",751,314,120,194,398,74,142,58,50,34,96,54,33,9,82,45,37,4,4,39,9,30
"2021","Stockton-on-Tees 007B","E01012193",608,166,58,108,413,31,154,52,67,35,109,41,60,8,115,80,35,4,4,29,12,17
"2021","Stockton-on-Tees 007C","E01012260",830,368,181,187,426,92,186,83,71,32,94,65,28,1,50,31,19,4,4,36,16,20
"2021","Stockton-on-Tees 007D","E01012261",686,270,92,178,405,53,172,69,63,40,107,68,34,5,68,43,25,5,5,11,4,7
"2021","Stockton-on-Tees 008A","E01012247",493,160,57,103,313,20,115,42,43,30,71,24,35,12,101,63,38,6,6,20,12,8
"2021","Stockton-on-Tees 008B","E01012249",636,179,85,94,426,28,175,62,71,42,81,35,42,4,138,83,55,4,4,31,10,21
"2021","Stockton-on-Tees 008C","E01012271",592,193,64,129,369,31,121,38,57,26,67,24,36,7,146,97,49,4,4,30,17,13
"2021","Stockton-on-Tees 008D","E01012272",492,159,106,53,309,93,116,43,43,30,62,35,21,6,37,14,23,1,1,24,11,13
"2021","Stockton-on-Tees 008E","E01012273",635,171,55,116,441,27,129,45,57,27,95,27,54,14,183,111,72,7,7,23,13,10
"2021","Stockton-on-Tees 008F","E01012274",515,143,63,80,346,20,126,34,53,39,101,25,37,39,95,61,34,4,4,26,15,11
"2021","Stockton-on-Tees 009D","E01012248",619,236,102,134,361,64,143,60,41,42,56,35,19,2,95,53,42,3,3,22,5,17
"2021","Stockton-on-Tees 009E","E01012250",865,311,114,197,525,31,177,63,78,36,121,48,67,6,186,129,57,10,10,29,14,15
"2021","Stockton-on-Tees 009F","E01032542",703,176,64,112,484,15,217,52,118,47,108,33,68,7,138,111,27,6,6,43,23,20
"2021","Stockton-on-Tees 009G","E01032543",872,260,104,156,574,41,169,63,64,42,137,35,92,10,222,168,54,5,5,38,19,19
"2021","Stockton-on-Tees 009H","E01032544",792,202,54,148,557,20,296,92,158,46,95,47,42,6,144,86,58,2,2,33,24,9
"2021","Stockton-on-Tees 010A","E01012194",656,242,65,177,387,37,130,48,54,28,98,55,39,4,116,91,25,6,6,27,14,13
"2021","Stockton-on-Tees 010B","E01012195",666,231,71,160,418,20,149,37,58,54,99,41,51,7,146,113,33,4,4,17,10,7
"2021","Stockton-on-Tees 010C","E01012258",509,231,87,144,257,34,98,48,33,17,52,21,28,3,69,47,22,4,4,21,13,8
"2021","Stockton-on-Tees 010D","E01012259",758,271,116,155,462,74,209,95,71,43,96,53,39,4,80,48,32,3,3,25,10,15
"2021","Stockton-on-Tees 010E","E01012268",977,377,88,289,539,39,152,77,52,23,201,120,71,10,132,95,37,15,15,61,45,16
"2021","Stockton-on-Tees 011A","E01012187",527,132,67,65,376,60,176,72,62,42,78,36,41,1,62,33,29,0,0,19,9,10
"2021","Stockton-on-Tees 011B","E01012188",488,126,62,64,345,72,177,77,61,39,59,28,29,2,37,21,16,0,0,17,8,9
"2021","Stockton-on-Tees 011C","E01012189",619,200,138,62,399,104,180,82,52,46,63,33,24,6,50,17,33,2,2,20,8,12
"2021","Stockton-on-Tees 011D","E01012205",636,213,111,102,410,95,189,66,84,39,66,35,25,6,59,33,26,1,1,13,10,3
"2021","Stockton-on-Tees 012A","E01012219",692,158,67,91,500,58,252,88,110,54,99,37,55,7,86,42,44,5,5,34,20,14
"2021","Stockton-on-Tees 012B","E01012251",625,168,43,125,389,30,160,68,48,44,77,29,42,6,117,77,40,5,5,68,19,49
"2021","Stockton-on-Tees 012C","E01012252",641,211,54,157,405,13,146,37,93,16,68,26,36,6,173,137,36,5,5,25,14,11
"2021","Stockton-on-Tees 012D","E01012253",469,136,65,71,305,30,136,42,57,37,59,22,33,4,78,51,27,2,2,28,12,16
"2021","Stockton-on-Tees 012E","E01012254",630,279,71,208,288,12,95,28,38,29,64,44,18,2,113,75,38,4,4,63,23,40
"2021","Stockton-on-Tees 013A","E01012204",647,197,134,63,436,170,167,94,33,40,67,17,48,2,29,15,14,3,3,14,7,7
"2021","Stockton-on-Tees 013B","E01012206",702,320,190,130,373,99,171,81,53,37,36,22,14,0,67,39,28,0,0,9,2,7
"2021","Stockton-on-Tees 013C","E01012207",781,206,130,76,541,94,295,114,128,53,78,27,41,10,70,46,24,4,4,34,21,13
"2021","Stockton-on-Tees 013D","E01012208",638,135,81,54,481,78,273,106,110,57,73,38,31,4,55,26,29,2,2,22,13,9
"2021","Stockton-on-Tees 015A","E01012190",627,187,88,99,424,77,212,87,75,50,71,33,30,8,63,40,23,1,1,16,11,5
"2021","Stockton-on-Tees 015B","E01012191",699,252,139,113,430,98,186,71,70,45,65,27,34,4,81,47,34,0,0,17,9,8
"2021","Stockton-on-Tees 015C","E01012224",746,209,134,75,518,130,242,91,105,46,86,46,36,4,59,29,30,1,1,19,10,9
"2021","Stockton-on-Tees 015D","E01012225",635,162,99,63,435,127,198,67,77,54,67,36,27,4,40,25,15,3,3,38,16,22
"2021","Stockton-on-Tees 015E","E01012226",605,159,112,47,434,132,206,79,82,45,45,22,20,3,49,23,26,2,2,12,6,6
"2021","Stockton-on-Tees 016A","E01012209",678,176,94,82,476,73,252,79,120,53,90,46,35,9,57,38,19,4,4,26,12,14
"2021","Stockton-on-Tees 016B","E01012217",663,306,79,227,326,23,121,43,51,27,88,61,24,3,89,61,28,5,5,31,13,18
"2021","Stockton-on-Tees 016C","E01012218",614,155,88,67,422,71,217,76,97,44,76,34,38,4,57,36,21,1,1,37,17,20
"2021","Stockton-on-Tees 016D","E01012223",625,145,100,45,458,104,254,95,108,51,55,28,22,5,43,17,26,2,2,22,10,12
"2021","Stockton-on-Tees 017A","E01012286",540,252,54,198,259,16,74,28,31,15,64,28,33,3,102,79,23,3,3,29,15,14
"2021","Stockton-on-Tees 017B","E01012287",1039,620,117,503,372,21,108,49,45,14,112,71,36,5,115,92,23,16,16,47,8,39
"2021","Stockton-on-Tees 017C","E01012288",548,229,73,156,292,23,105,25,46,34,53,21,31,1,101,75,26,10,10,27,7,20
"2021","Stockton-on-Tees 017D","E01012289",499,164,58,106,302,36,149,53,56,40,47,20,23,4,67,43,24,3,3,33,18,15
"2021","Stockton-on-Tees 018A","E01012238",721,294,81,213,394,32,123,48,55,20,80,31,38,11,151,108,43,8,8,33,14,19
"2021","Stockton-on-Tees 018B","E01012239",935,241,63,178,650,29,284,74,178,32,168,67,87,14,165,128,37,4,4,44,23,21
"2021","Stockton-on-Tees 018C","E01012240",740,235,118,117,478,66,227,90,86,51,100,45,41,14,82,51,31,3,3,27,15,12
"2021","Stockton-on-Tees 018D","E01012241",607,134,74,60,454,110,218,101,58,59,72,25,41,6,51,28,23,3,3,19,5,14
"2021","Stockton-on-Tees 019A","E01012290",883,290,184,106,561,143,233,105,85,43,122,44,72,6,63,20,43,0,0,32,9,23
"2021","Stockton-on-Tees 019B","E01012291",741,224,90,134,487,42,224,83,89,52,108,36,65,7,110,79,31,3,3,30,18,12
"2021","Stockton-on-Tees 019C","E01012292",865,311,114,197,521,47,253,81,124,48,113,51,57,5,105,85,20,3,3,33,20,13
"2021","Stockton-on-Tees 020A","E01012282",492,152,68,84,321,51,120,43,43,34,75,31,33,11,75,46,29,0,0,19,10,9
"2021","Stockton-on-Tees 020B","E01012283",530,171,71,100,341,33,126,49,56,21,85,45,32,8,95,67,28,2,2,18,14,4
"2021","Stockton-on-Tees 020C","E01012284",643,248,133,115,375,62,125,58,35,32,57,27,26,4,125,84,41,6,6,20,13,7
"2021","Stockton-on-Tees 020D","E01012285",629,245,128,117,365,87,145,65,47,33,69,42,21,6,63,42,21,1,1,19,11,8
"2021","Stockton-on-Tees 021A","E01012199",601,165,100,65,424,125,218,96,79,43,38,17,18,3,43,21,22,0,0,12,6,6
"2021","Stockton-on-Tees 021B","E01012200",920,315,167,148,579,129,281,101,132,48,101,52,44,5,63,44,19,5,5,26,13,13
"2021","Stockton-on-Tees 021C","E01012201",886,210,130,80,663,138,315,107,156,52,109,47,54,8,100,70,30,1,1,13,8,5
"2021","Stockton-on-Tees 021D","E01012202",646,223,98,125,396,64,226,64,121,41,56,34,21,1,49,34,15,1,1,27,18,9
"2021","Stockton-on-Tees 021E","E01012203",747,162,74,88,562,66,314,94,177,43,103,57,38,8,77,56,21,2,2,23,9,14
"2021","Stockton-on-Tees 021F","E01012270",588,186,99,87,380,57,189,57,94,38,56,32,21,3,77,44,33,1,1,22,14,8
"2021","Stockton-on-Tees 022A","E01012228",532,114,49,65,403,43,241,80,106,55,55,28,22,5,64,37,27,0,0,15,5,10
"2021","Stockton-on-Tees 022B","E01012230",611,124,41,83,440,58,241,77,111,53,73,32,39,2,66,40,26,2,2,47,17,30
"2021","Stockton-on-Tees 022C","E01012233",693,126,71,55,545,94,341,127,165,49,74,33,40,1,36,26,10,0,0,22,13,9
"2021","Stockton-on-Tees 022D","E01012236",541,146,58,88,370,82,198,77,71,50,49,30,17,2,39,30,9,2,2,25,16,9
"2021","Stockton-on-Tees 022E","E01012237",507,88,55,33,388,76,225,99,76,50,54,21,28,5,30,12,18,3,3,31,20,11
"2021","Stockton-on-Tees 024A","E01012235",920,182,73,109,713,133,348,109,193,46,146,84,57,5,85,61,24,1,1,25,7,18
"2021","Stockton-on-Tees 024B","E01012298",558,103,68,35,444,125,270,115,113,42,30,16,11,3,19,9,10,0,0,11,7,4
"2021","Stockton-on-Tees 024C","E01012299",697,348,136,212,332,68,168,68,78,22,60,49,9,2,33,22,11,3,3,17,7,10
"2021","Stockton-on-Tees 024D","E01012300",726,309,168,141,393,82,156,57,71,28,60,44,15,1,90,62,28,5,5,24,14,10
"2021","Stockton-on-Tees 024E","E01012301",555,153,77,76,395,97,216,76,89,51,45,28,16,1,36,20,16,1,1,7,4,3
"2021","Stockton-on-Tees 024F","E01012302",501,119,53,66,371,93,195,68,94,33,41,22,18,1,41,24,17,1,1,11,3,8
"2021","Stockton-on-Tees 024G","E01012303",926,234,90,144,677,105,364,141,172,51,127,75,46,6,81,53,28,0,0,15,4,11
"2021","Stockton-on-Tees 025C","E01012267",838,438,138,300,330,27,146,38,86,22,52,28,20,4,89,57,32,16,16,70,27,43
"2021","Stockton-on-Tees 025A","E01035197",680,332,81,251,309,23,111,33,63,15,69,23,42,4,105,80,25,1,1,39,9,30
"2021","Stockton-on-Tees 025B","E01035198",683,216,23,193,445,9,212,64,127,21,153,88,60,5,66,46,20,5,5,22,11,11
"2021","Stockton-on-Tees 025D","E01035199",661,400,87,313,244,14,108,30,73,5,47,21,23,3,67,47,20,8,8,17,7,10
"2021","Stockton-on-Tees 026B","E01012262",956,354,82,272,539,19,232,45,160,27,112,57,44,11,164,118,46,12,12,63,40,23
"2021","Stockton-on-Tees 026A","E01035200",702,351,40,311,245,16,115,28,70,17,35,15,19,1,73,50,23,6,6,106,79,27
"2021","Stockton-on-Tees 026C","E01035201",713,189,47,142,495,26,256,91,132,33,128,75,43,10,80,43,37,5,5,29,12,17
"2021","Stockton-on-Tees 026D","E01035202",825,265,53,212,516,21,212,75,114,23,156,88,64,4,120,85,35,7,7,44,32,12
"2021","Stockton-on-Tees 027D","E01012227",586,150,37,113,419,14,229,76,116,37,89,59,29,1,82,62,20,5,5,17,7,10
"2021","Stockton-on-Tees 027C","E01033474",998,231,35,196,744,26,398,75,297,26,185,96,84,5,132,109,23,3,3,23,13,10
"2021","Stockton-on-Tees 027A","E01033479",620,88,35,53,499,42,309,78,189,42,72,31,35,6,75,52,23,1,1,33,16,17
"2021","Stockton-on-Tees 027B","E01035203",603,111,12,99,469,7,280,57,204,19,108,49,56,3,71,59,12,3,3,23,12,11
"2021","Stockton-on-Tees 028C","E01012231",679,118,35,83,529,27,329,97,169,63,94,48,39,7,78,65,13,1,1,32,18,14
"2021","Stockton-on-Tees 028D","E01012232",541,125,37,88,400,43,232,84,104,44,66,30,33,3,56,38,18,3,3,16,8,8
"2021","Stockton-on-Tees 028E","E01012234",599,98,38,60,483,67,307,112,123,72,65,29,31,5,40,26,14,4,4,18,15,3
"2021","Stockton-on-Tees 028A","E01033475",590,56,7,49,505,16,352,58,256,38,77,31,42,4,58,46,12,2,2,29,18,11
"2021","Stockton-on-Tees 028B","E01035204",775,62,10,52,685,33,511,98,343,70,95,28,64,3,46,32,14,0,0,28,22,6
"2021","Darlington 001B","E01012334",1080,220,118,102,818,120,452,154,217,81,153,81,61,11,88,61,27,5,5,42,15,27
"2021","Darlington 001C","E01012335",694,189,121,68,487,118,247,96,117,34,72,41,25,6,50,35,15,0,0,18,8,10
"2021","Darlington 001D","E01012366",887,236,114,122,614,150,317,155,110,52,81,57,17,7,62,35,27,4,4,37,24,13
"2021","Darlington 001E","E01033481",750,218,59,159,507,49,252,94,140,18,139,75,60,4,66,49,17,1,1,25,9,16
"2021","Darlington 001F","E01033482",712,188,55,133,502,47,272,101,122,49,111,64,43,4,71,47,24,1,1,22,8,14
"2021","Darlington 002C","E01012323",658,204,67,137,434,57,183,70,61,52,89,46,35,8,103,77,26,2,2,20,10,10
"2021","Darlington 002D","E01012324",639,225,91,134,402,74,168,71,64,33,71,36,32,3,88,66,22,1,1,12,6,6
"2021","Darlington 002E","E01032545",676,167,61,106,488,32,202,54,105,43,109,45,54,10,140,105,35,5,5,21,9,12
"2021","Darlington 002F","E01032546",705,147,84,63,536,116,291,112,126,53,78,43,31,4,46,28,18,5,5,22,15,7
"2021","Darlington 003A","E01012328",751,308,102,206,429,67,174,86,57,31,89,45,40,4,96,62,34,3,3,14,10,4
"2021","Darlington 003B","E01012329",773,201,131,70,545,147,273,130,94,49,77,41,28,8,44,26,18,4,4,27,11,16
"2021","Darlington 003C","E01012330",447,91,56,35,343,72,191,87,65,39,44,26,16,2,34,15,19,2,2,13,9,4
"2021","Darlington 003D","E01012331",503,130,54,76,363,66,175,81,56,38,66,27,35,4,54,31,23,2,2,10,6,4
"2021","Darlington 004A","E01012349",786,444,127,317,303,15,80,35,32,13,82,47,33,2,120,87,33,6,6,39,11,28
"2021","Darlington 004B","E01012350",747,360,132,228,367,35,151,74,54,23,99,60,35,4,82,56,26,0,0,20,7,13
"2021","Darlington 004C","E01012351",554,130,53,77,402,47,233,109,82,42,64,26,34,4,56,37,19,2,2,22,10,12
"2021","Darlington 004D","E01012352",761,392,104,288,337,29,125,53,51,21,80,45,29,6,97,74,23,6,6,32,7,25
"2021","Darlington 005A","E01012325",655,205,88,117,427,102,192,101,51,40,82,46,32,4,49,29,20,2,2,23,8,15
"2021","Darlington 005B","E01012326",492,149,90,59,322,44,141,68,51,22,65,33,26,6,70,47,23,2,2,21,12,9
"2021","Darlington 005C","E01012332",610,210,118,92,380,57,137,59,50,28,74,27,37,10,104,71,33,8,8,20,11,9
"2021","Darlington 005D","E01012333",708,217,121,96,467,75,207,95,69,43,100,46,50,4,80,59,21,5,5,24,8,16
"2021","Darlington 006A","E01012309",848,235,98,137,587,70,327,137,130,60,104,54,41,9,80,52,28,6,6,26,11,15
"2021","Darlington 006B","E01012310",984,315,152,163,641,95,300,134,103,63,139,69,60,10,103,64,39,4,4,28,15,13
"2021","Darlington 006C","E01012311",628,204,100,104,400,40,188,73,71,44,73,24,40,9,98,57,41,1,1,24,12,12
"2021","Darlington 006D","E01012312",612,235,113,122,354,35,129,40,61,28,60,18,40,2,123,86,37,7,7,23,10,13
"2021","Darlington 006E","E01012313",656,253,113,140,373,46,152,61,72,19,78,33,35,10,94,57,37,3,3,30,11,19
"2021","Darlington 006F","E01012314",623,209,90,119,382,48,118,50,45,23,72,20,48,4,141,106,35,3,3,32,16,16
"2021","Darlington 009A","E01012307",1038,399,122,277,604,67,194,77,74,43,139,68,63,8,196,148,48,8,8,35,18,17
"2021","Darlington 009B","E01012327",676,214,90,124,432,34,129,45,60,24,101,38,57,6,163,121,42,5,5,30,18,12
"2021","Darlington 009C","E01012342",1177,364,154,210,765,69,278,111,134,33,195,92,94,9,217,159,58,6,6,48,22,26
"2021","Darlington 009E","E01035183",604,133,33,100,436,26,212,76,105,31,121,65,52,4,77,57,20,0,0,35,15,20
"2021","Darlington 009F","E01035184",616,210,132,78,377,73,182,77,64,41,71,42,25,4,47,24,23,4,4,29,18,11
"2021","Darlington 010A","E01012315",714,185,117,68,511,124,268,109,123,36,61,29,26,6,54,30,24,4,4,18,7,11
"2021","Darlington 010C","E01012360",793,268,185,83,508,132,281,104,134,43,55,31,23,1,38,25,13,2,2,17,4,13
"2021","Darlington 010D","E01035185",647,186,83,103,436,73,267,88,145,34,59,34,22,3,36,21,15,1,1,25,12,13
"2021","Darlington 010E","E01035186",565,279,102,177,271,42,136,61,58,17,56,43,13,0,32,18,14,5,5,15,4,11
"2021","Darlington 011A","E01012336",749,241,198,43,497,158,279,117,104,58,38,18,16,4,22,12,10,0,0,11,3,8
"2021","Darlington 011B","E01012337",751,179,120,59,557,129,314,115,144,55,60,25,28,7,53,31,22,1,1,15,9,6
"2021","Darlington 011C","E01012347",781,237,151,86,524,137,264,106,107,51,71,43,23,5,50,24,26,2,2,20,10,10
"2021","Darlington 011D","E01012348",983,321,240,81,647,183,323,115,155,53,93,46,43,4,47,24,23,1,1,15,10,5
"2021","Darlington 011E","E01012361",796,187,133,54,580,142,323,120,156,47,64,36,24,4,48,23,25,3,3,29,15,14
"2021","Darlington 012A","E01012304",631,387,107,280,209,12,68,42,16,10,51,28,20,3,76,53,23,2,2,35,9,26
"2021","Darlington 012B","E01012305",583,291,78,213,264,33,80,42,22,16,70,34,28,8,75,51,24,6,6,28,10,18
"2021","Darlington 012C","E01012306",592,190,67,123,381,54,164,79,49,36,83,39,36,8,76,47,29,4,4,21,13,8
"2021","Darlington 012D","E01012340",1032,365,126,239,620,63,272,125,91,56,141,79,54,8,141,91,50,3,3,47,19,28
"2021","Darlington 012E","E01012341",761,289,135,154,442,47,143,50,62,31,85,34,41,10,163,113,50,4,4,30,16,14
"2021","Darlington 013A","E01012317",637,216,102,114,402,77,178,92,50,36,78,44,31,3,67,39,28,2,2,19,6,13
"2021","Darlington 013B","E01012318",978,320,105,215,616,37,224,74,111,39,156,69,81,6,191,149,42,8,8,42,18,24
"2021","Darlington 013C","E01012319",1089,258,108,150,772,82,341,120,161,60,165,63,92,10,175,123,52,9,9,59,27,32
"2021","Darlington 014A","E01012356",789,335,89,246,409,38,190,77,85,28,98,65,25,8,72,46,26,11,11,45,13,32
"2021","Darlington 014B","E01012357",605,219,64,155,339,35,124,48,52,24,78,41,29,8,101,62,39,1,1,47,15,32
"2021","Darlington 014C","E01012358",716,233,88,145,454,65,206,75,84,47,78,37,34,7,98,67,31,7,7,29,12,17
"2021","Darlington 014D","E01012359",688,203,73,130,444,13,155,36,93,26,92,28,58,6,180,128,52,4,4,41,28,13
"2021","Darlington 015A","E01012338",924,250,127,123,635,150,284,105,127,52,101,55,40,6,97,72,25,3,3,39,24,15
"2021","Darlington 015B","E01012339",828,222,145,77,586,133,325,116,150,59,75,38,34,3,53,26,27,0,0,20,9,11
"2021","Darlington 015C","E01012344",654,211,104,107,425,48,215,84,90,41,78,52,26,0,82,62,20,2,2,18,11,7
"2021","Darlington 015D","E01012345",644,162,115,47,459,132,234,107,89,38,51,35,14,2,41,23,18,1,1,23,8,15
"2021","Darlington 015E","E01012346",921,184,61,123,719,73,429,170,200,59,142,79,54,9,74,49,25,1,1,18,8,10
"2021","Darlington 016E","E01012353",758,334,60,274,387,23,125,64,46,15,116,74,38,4,119,92,27,4,4,37,12,25
"2021","Darlington 016F","E01012354",689,326,48,278,312,15,148,48,77,23,72,40,31,1,66,44,22,11,11,51,23,28
"2021","Darlington 016G","E01012355",694,337,93,244,308,33,153,56,76,21,62,41,18,3,56,35,21,4,4,49,18,31
"2021","Darlington 016A","E01012362",649,306,63,243,314,20,109,53,42,14,88,56,26,6,91,67,24,6,6,29,5,24
"2021","Darlington 016B","E01012363",676,309,71,238,350,31,120,54,47,19,93,67,23,3,101,69,32,5,5,17,6,11
"2021","Darlington 016D","E01012364",705,314,83,231,361,34,141,75,43,23,99,67,28,4,80,51,29,7,7,30,11,19
"2021","Darlington 016C","E01012365",538,158,70,88,369,71,166,81,53,32,72,33,33,6,60,37,23,0,0,11,8,3
"2021","Darlington 016H","E01035187",1277,804,196,608,431,26,139,62,58,19,149,110,31,8,105,66,39,12,12,42,12,30
"2021","County Durham 002A","E01020613",554,114,77,37,428,108,230,77,95,58,53,28,22,3,36,19,17,1,1,12,5,7
"2021","County Durham 002B","E01020614",685,267,141,126,404,100,170,54,73,43,61,35,21,5,72,45,27,1,1,14,4,10
"2021","County Durham 002C","E01020622",679,159,69,90,503,88,266,120,94,52,92,53,32,7,55,31,24,2,2,17,7,10
"2021","County Durham 002D","E01020623",670,197,58,139,458,73,261,120,88,53,76,45,27,4,46,26,20,2,2,15,7,8
"2021","County Durham 005A","E01020606",694,299,112,187,371,51,160,89,38,33,73,41,28,4,84,58,26,3,3,24,9,15
"2021","County Durham 005B","E01020615",748,257,126,131,467,53,201,74,74,53,81,26,43,12,131,94,37,1,1,24,10,14
"2021","County Durham 005C","E01020616",787,291,78,213,476,50,195,83,72,40,114,61,47,6,114,82,32,3,3,20,5,15
"2021","County Durham 005D","E01020617",1129,338,135,203,772,107,373,150,161,62,183,101,72,10,107,64,43,2,2,19,8,11
"2021","County Durham 007A","E01020596",745,269,124,145,438,47,164,67,59,38,93,48,39,6,128,92,36,6,6,38,20,18
"2021","County Durham 007B","E01020597",661,209,120,89,440,133,194,76,78,40,58,29,24,5,55,29,26,0,0,12,6,6
"2021","County Durham 007C","E01020598",822,323,165,158,482,110,219,89,84,46,85,55,25,5,64,34,30,4,4,17,5,12
"2021","County Durham 007D","E01020611",785,168,94,74,586,111,285,122,110,53,123,79,41,3,65,43,22,2,2,31,12,19
"2021","County Durham 007E","E01020612",665,157,114,43,490,150,247,103,98,46,59,30,27,2,33,14,19,1,1,18,9,9
"2021","County Durham 011A","E01020592",624,194,63,131,398,23,126,41,62,23,89,28,52,9,152,120,32,8,8,32,20,12
"2021","County Durham 011B","E01020593",668,331,85,246,318,36,113,49,36,28,76,54,18,4,87,61,26,6,6,19,7,12
"2021","County Durham 011C","E01020599",891,452,172,280,415,47,164,55,68,41,80,30,43,7,116,82,34,8,8,24,11,13
"2021","County Durham 011D","E01020601",635,202,98,104,430,58,242,99,91,52,69,39,23,7,61,40,21,0,0,3,0,3
"2021","County Durham 011E","E01020602",905,388,191,197,497,93,188,82,73,33,88,51,32,5,128,84,44,0,0,20,6,14
"2021","County Durham 011F","E01020618",898,345,107,238,530,56,231,84,100,47,132,64,57,11,108,71,37,3,3,23,12,11
"2021","County Durham 013A","E01020594",778,304,101,203,455,66,198,94,74,30,91,65,24,2,92,55,37,8,8,19,6,13
"2021","County Durham 013B","E01020595",778,259,154,105,502,123,251,111,100,40,80,50,27,3,48,27,21,0,0,17,7,10
"2021","County Durham 013C","E01020600",631,178,123,55,441,119,243,93,110,40,44,22,16,6,33,14,19,2,2,12,7,5
"2021","County Durham 013D","E01020603",669,121,74,47,540,106,365,126,150,89,42,25,15,2,26,12,14,1,1,8,4,4
"2021","County Durham 013E","E01020605",796,272,118,154,516,92,297,135,110,52,69,46,20,3,58,39,19,0,0,8,2,6
"2021","County Durham 015A","E01020590",582,155,73,82,416,83,191,85,64,42,49,29,20,0,93,61,32,0,0,11,2,9
"2021","County Durham 015B","E01020591",657,214,110,104,427,78,165,77,52,36,63,33,26,4,120,77,43,1,1,16,11,5
"2021","County Durham 015C","E01020608",836,246,123,123,570,74,300,111,124,65,108,59,39,10,87,55,32,1,1,20,10,10
"2021","County Durham 015D","E01020609",593,179,114,65,401,104,173,66,80,27,53,27,19,7,69,40,29,2,2,13,6,7
"2021","County Durham 015E","E01020610",619,160,87,73,445,85,247,103,93,51,60,34,21,5,49,31,18,4,4,14,6,8
"2021","County Durham 019A","E01020604",648,207,71,136,419,77,195,93,65,37,60,32,23,5,83,49,34,4,4,22,10,12
"2021","County Durham 019B","E01020607",819,253,118,135,533,71,219,96,81,42,127,73,42,12,113,76,37,3,3,33,13,20
"2021","County Durham 019C","E01020619",725,220,86,134,483,85,217,94,76,47,85,35,46,4,94,62,32,2,2,22,8,14
"2021","County Durham 019D","E01020620",697,237,85,152,436,60,199,72,83,44,93,46,40,7,83,48,35,1,1,24,11,13
"2021","County Durham 019E","E01020621",945,357,139,218,554,66,224,82,94,48,134,63,63,8,127,89,38,3,3,34,22,12
"2021","County Durham 001A","E01020634",693,198,98,100,477,93,253,92,111,50,73,44,23,6,56,31,25,2,2,18,6,12
"2021","County Durham 001B","E01020635",617,208,85,123,397,77,202,94,83,25,74,41,28,5,43,20,23,1,1,12,6,6
"2021","County Durham 001C","E01020636",807,275,128,147,511,80,187,77,71,39,104,50,45,9,137,100,37,3,3,21,9,12
"2021","County Durham 001D","E01020654",805,234,103,131,543,84,273,111,114,48,123,60,56,7,62,39,23,1,1,28,13,15
"2021","County Durham 001E","E01020676",685,220,90,130,441,74,219,100,80,39,87,45,36,6,59,30,29,2,2,24,9,15
"2021","County Durham 003A","E01020627",704,221,91,130,460,75,222,98,84,40,74,40,29,5,89,68,21,0,0,23,11,12
"2021","County Durham 003B","E01020628",816,239,135,104,556,139,291,120,127,44,74,42,28,4,50,30,20,2,2,21,11,10
"2021","County Durham 003C","E01020629",773,197,90,107,552,73,275,96,119,60,95,51,40,4,104,71,33,5,5,24,14,10
"2021","County Durham 003D","E01020655",870,238,114,124,601,139,294,129,101,64,97,57,34,6,68,43,25,3,3,31,14,17
"2021","County Durham 003E","E01020656",679,243,133,110,421,82,191,93,60,38,77,43,32,2,69,37,32,2,2,15,7,8
"2021","County Durham 003F","E01020657",619,142,74,68,457,82,240,96,82,62,75,37,33,5,59,37,22,1,1,20,9,11
"2021","County Durham 004A","E01020661",802,301,96,205,473,64,206,75,94,37,100,46,39,15,101,65,36,2,2,28,14,14
"2021","County Durham 004B","E01020662",785,254,130,124,511,72,231,100,85,46,108,53,45,10,97,56,41,3,3,20,8,12
"2021","County Durham 004C","E01020663",856,287,139,148,548,125,245,109,89,47,110,67,34,9,68,40,28,0,0,21,12,9
"2021","County Durham 004D","E01020674",733,264,138,126,461,85,211,100,76,35,83,36,38,9,79,60,19,3,3,8,4,4
"2021","County Durham 004E","E01020678",570,158,73,85,401,69,196,92,59,45,74,29,35,10,61,44,17,1,1,11,5,6
"2021","County Durham 006A","E01020626",762,345,147,198,397,78,139,56,48,35,57,16,35,6,115,74,41,8,8,20,6,14
"2021","County Durham 006B","E01020638",706,202,95,107,476,96,195,81,61,53,95,47,40,8,86,45,41,4,4,28,11,17
"2021","County Durham 006C","E01020639",762,267,112,155,475,36,193,68,83,42,112,59,51,2,129,88,41,5,5,20,12,8
"2021","County Durham 006D","E01020653",688,259,116,143,411,69,181,69,67,45,83,41,35,7,76,50,26,2,2,18,8,10
"2021","County Durham 006E","E01020677",701,260,122,138,409,68,190,89,59,42,65,28,27,10,81,59,22,5,5,32,14,18
"2021","County Durham 008A","E01020647",826,221,83,138,578,34,232,77,115,40,121,52,56,13,189,157,32,2,2,27,10,17
"2021","County Durham 008B","E01020648",1097,306,86,220,755,48,315,108,151,56,223,107,104,12,160,108,52,9,9,36,14,22
"2021","County Durham 008C","E01020649",742,249,95,154,471,61,186,75,82,29,111,50,53,8,109,76,33,4,4,22,10,12
"2021","County Durham 008D","E01020673",777,355,151,204,404,50,149,56,62,31,86,47,27,12,112,70,42,7,7,18,9,9
"2021","County Durham 008E","E01020675",842,333,131,202,489,84,187,82,70,35,88,40,38,10,125,80,45,5,5,20,11,9
"2021","County Durham 009A","E01020624",840,327,87,240,487,39,206,95,77,34,109,56,50,3,131,99,32,2,2,26,11,15
"2021","County Durham 009B","E01020625",738,254,105,149,445,72,176,72,61,43,104,47,41,16,92,60,32,1,1,39,18,21
"2021","County Durham 009C","E01020670",759,284,145,139,455,91,159,74,51,34,87,48,31,8,115,72,43,3,3,20,8,12
"2021","County Durham 009D","E01020671",636,291,66,225,328,30,112,62,30,20,72,32,36,4,109,84,25,5,5,17,6,11
"2021","County Durham 009E","E01020672",816,317,82,235,466,66,202,90,61,51,78,34,37,7,113,72,41,7,7,33,21,12
"2021","County Durham 010A","E01020632",816,309,92,217,483,79,250,104,81,65,86,52,28,6,64,38,26,4,4,24,10,14
"2021","County Durham 010B","E01020640",993,301,98,203,659,74,320,119,134,67,141,80,54,7,115,77,38,9,9,33,12,21
"2021","County Durham 010C","E01020641",1046,452,185,267,562,86,258,106,102,50,93,43,41,9,118,71,47,7,7,32,14,18
"2021","County Durham 010D","E01020642",629,226,94,132,388,61,189,73,69,47,67,37,25,5,69,42,27,2,2,15,7,8
"2021","County Durham 010E","E01020643",1047,476,168,308,542,52,216,88,87,41,143,78,55,10,126,83,43,5,5,29,11,18
"2021","County Durham 010F","E01020667",832,363,157,206,439,98,173,86,59,28,101,67,29,5,64,39,25,3,3,30,11,19
"2021","County Durham 012A","E01020650",994,261,104,157,698,84,328,106,151,71,129,53,64,12,154,114,40,3,3,35,17,18
"2021","County Durham 012B","E01020651",797,292,142,150,488,102,218,102,76,40,78,34,40,4,85,50,35,5,5,17,8,9
"2021","County Durham 012C","E01020652",853,266,143,123,551,49,257,87,122,48,117,49,58,10,123,85,38,5,5,36,15,21
"2021","County Durham 012D","E01020668",660,236,85,151,400,45,163,68,64,31,81,31,43,7,104,69,35,7,7,24,12,12
"2021","County Durham 012E","E01020669",622,178,65,113,420,55,201,91,67,43,65,34,27,4,93,65,28,6,6,24,11,13
"2021","County Durham 014A","E01020630",577,158,67,91,411,71,175,74,54,47,71,33,37,1,90,68,22,4,4,8,5,3
"2021","County Durham 014B","E01020631",769,309,137,172,447,64,182,66,78,38,90,43,42,5,105,74,31,6,6,13,5,8
"2021","County Durham 014C","E01020637",733,194,107,87,518,117,250,107,91,52,87,49,33,5,58,34,24,6,6,21,8,13
"2021","County Durham 014E","E01020645",678,248,130,118,407,20,157,53,62,42,96,31,57,8,127,96,31,7,7,23,13,10
"2021","County Durham 014F","E01034489",529,149,53,96,364,31,160,57,78,25,95,48,45,2,73,64,9,5,5,16,6,10
"2021","County Durham 014G","E01034490",633,145,25,120,472,27,264,88,156,20,121,71,46,4,59,51,8,1,1,16,9,7
"2021","County Durham 014H","E01034491",539,141,44,97,367,32,137,41,66,30,81,40,34,7,116,93,23,1,1,31,12,19
"2021","County Durham 020A","E01020633",721,226,107,119,462,70,209,100,70,39,99,48,47,4,78,52,26,6,6,33,21,12
"2021","County Durham 020B","E01020664",752,250,160,90,483,110,256,117,105,34,67,45,19,3,49,26,23,1,1,19,8,11
"2021","County Durham 020C","E01020665",665,236,130,106,413,96,165,66,68,31,60,25,31,4,90,66,24,2,2,16,6,10
"2021","County Durham 020D","E01020666",623,171,113,58,441,113,233,93,97,43,49,30,17,2,45,25,20,1,1,11,5,6
"2021","County Durham 024A","E01020646",710,205,89,116,473,70,253,112,89,52,74,37,31,6,71,53,18,5,5,32,19,13
"2021","County Durham 024B","E01020658",881,354,137,217,493,42,208,91,81,36,123,65,51,7,117,75,42,3,3,34,12,22
"2021","County Durham 024C","E01020659",637,191,87,104,426,62,241,114,72,55,64,33,26,5,58,33,25,1,1,20,7,13
"2021","County Durham 024D","E01020660",693,187,92,95,487,90,238,97,95,46,76,38,36,2,80,55,25,3,3,19,8,11
"2021","County Durham 022A","E01020709",692,162,69,93,505,69,304,136,124,44,72,45,22,5,56,36,20,4,4,25,13,12
"2021","County Durham 022B","E01020717",741,250,162,88,472,170,227,98,85,44,39,19,16,4,34,16,18,2,2,19,8,11
"2021","County Durham 022C","E01020718",595,217,117,100,368,89,195,74,80,41,42,21,17,4,41,24,17,1,1,10,4,6
"2021","County Durham 022D","E01020719",525,150,64,86,365,97,189,60,97,32,43,19,18,6,36,16,20,0,0,10,2,8
"2021","County Durham 022E","E01020721",475,119,50,69,345,80,192,77,84,31,40,22,15,3,32,18,14,1,1,11,5,6
"2021","County Durham 023A","E01020708",583,224,90,134,342,67,193,70,97,26,52,38,14,0,28,21,7,2,2,17,6,11
"2021","County Durham 023B","E01020710",786,258,88,170,502,87,238,102,99,37,91,53,32,6,81,56,25,5,5,26,8,18
"2021","County Durham 023C","E01020711",887,377,152,225,471,62,228,77,116,35,82,46,26,10,95,56,39,4,4,39,20,19
"2021","County Durham 023D","E01020720",700,311,163,148,383,65,187,68,92,27,66,34,28,4,65,47,18,0,0,6,0,6
"2021","County Durham 026A","E01020679",724,283,114,169,421,59,160,64,60,36,101,52,41,8,100,68,32,1,1,20,8,12
"2021","County Durham 026B","E01020680",719,194,85,109,496,97,280,106,124,50,67,37,27,3,52,35,17,0,0,29,14,15
"2021","County Durham 026C","E01020681",693,254,114,140,432,71,170,59,64,47,96,36,56,4,93,60,33,2,2,7,4,3
"2021","County Durham 026D","E01020714",702,219,91,128,462,102,216,113,57,46,92,53,36,3,50,34,16,2,2,21,7,14
"2021","County Durham 026E","E01020716",740,259,108,151,462,38,180,72,67,41,97,42,49,6,142,105,37,5,5,19,12,7
"2021","County Durham 027A","E01020725",673,178,83,95,482,103,239,96,91,52,84,45,30,9,55,35,20,1,1,13,6,7
"2021","County Durham 027B","E01020726",527,135,64,71,370,87,171,89,50,32,61,40,17,4,50,28,22,1,1,22,8,14
"2021","County Durham 027C","E01020727",579,254,118,136,307,41,127,65,43,19,65,31,33,1,71,44,27,3,3,18,10,8
"2021","County Durham 027D","E01020729",1019,313,93,220,673,83,298,131,106,61,156,90,58,8,132,96,36,4,4,33,18,15
"2021","County Durham 027E","E01020730",789,320,164,156,446,63,202,78,77,47,89,36,48,5,85,58,27,7,7,23,14,9
"2021","County Durham 027F","E01020731",663,195,94,101,461,83,230,100,88,42,84,46,33,5,62,39,23,2,2,7,1,6
"2021","County Durham 028A","E01020682",826,226,152,74,585,202,285,107,122,56,55,32,17,6,41,19,22,2,2,15,8,7
"2021","County Durham 028B","E01020683",681,188,82,106,471,123,224,83,104,37,70,32,36,2,53,32,21,1,1,22,10,12
"2021","County Durham 028C","E01020690",637,237,135,102,384,113,167,73,70,24,63,47,14,2,41,21,20,0,0,16,8,8
"2021","County Durham 028D","E01020691",640,255,123,132,362,46,169,62,71,36,86,44,41,1,56,39,17,5,5,23,7,16
"2021","County Durham 028E","E01020692",717,265,129,136,429,140,197,70,86,41,59,37,19,3,31,12,19,2,2,23,9,14
"2021","County Durham 029A","E01020693",623,257,87,170,317,48,136,55,55,26,65,43,18,4,63,36,27,5,5,49,9,40
"2021","County Durham 029B","E01020722",917,332,111,221,432,51,170,76,55,39,87,59,22,6,101,59,42,23,23,153,15,138
"2021","County Durham 029C","E01020723",727,263,82,181,274,53,100,42,26,32,70,57,13,0,47,28,19,4,4,190,6,184
"2021","County Durham 029D","E01020724",701,200,60,140,446,19,131,45,57,29,100,34,54,12,190,140,50,6,6,55,15,40
"2021","County Durham 030A","E01020703",729,227,73,154,131,35,55,25,25,5,19,14,5,0,15,8,7,7,7,371,5,366
"2021","County Durham 030E","E01033195",413,134,55,79,171,46,88,44,34,10,28,20,7,1,7,4,3,2,2,108,5,103
"2021","County Durham 030F","E01033197",447,147,62,85,100,19,35,16,11,8,21,20,1,0,19,14,5,6,6,200,8,192
"2021","County Durham 030H","E01034493",787,334,119,215,167,41,63,27,25,11,32,29,2,1,21,11,10,10,10,286,7,279
"2021","County Durham 033B","E01020702",1019,285,81,204,625,101,389,148,203,38,94,62,29,3,39,28,11,2,2,109,13,96
"2021","County Durham 033C","E01020704",543,115,64,51,248,59,139,43,78,18,23,14,8,1,23,4,19,4,4,180,8,172
"2021","County Durham 033D","E01020712",681,170,83,87,416,68,251,77,144,30,62,40,20,2,32,15,17,3,3,95,8,87
"2021","County Durham 033F","E01034496",537,108,46,62,351,51,201,57,119,25,56,29,21,6,42,32,10,1,1,78,11,67
"2021","County Durham 033G","E01034497",681,211,72,139,442,49,248,77,117,54,74,45,22,7,69,43,26,2,2,28,10,18
"2021","County Durham 033H","E01034498",482,83,36,47,386,63,256,57,161,38,47,22,22,3,19,14,5,1,1,13,6,7
"2021","County Durham 033I","E01034499",792,260,39,221,490,27,212,68,124,20,149,85,62,2,97,73,24,5,5,42,14,28
"2021","County Durham 031A","E01020705",784,288,132,156,473,65,197,86,78,33,93,40,47,6,113,86,27,5,5,23,14,9
"2021","County Durham 031B","E01020706",900,360,161,199,518,108,259,124,85,50,79,43,27,9,69,46,23,3,3,22,11,11
"2021","County Durham 031D","E01034494",691,243,59,184,427,25,228,86,110,32,97,60,35,2,75,56,19,2,2,21,7,14
"2021","County Durham 031E","E01034495",661,229,65,164,404,47,172,76,62,34,97,49,44,4,80,60,20,8,8,28,13,15
"2021","County Durham 038A","E01020685",718,188,119,69,506,98,287,123,104,60,66,40,21,5,51,25,26,4,4,24,12,12
"2021","County Durham 038B","E01020686",781,403,157,246,357,60,122,56,40,26,73,27,38,8,98,66,32,4,4,21,13,8
"2021","County Durham 038C","E01020687",677,302,149,153,362,78,188,96,58,34,53,23,26,4,42,30,12,1,1,13,7,6
"2021","County Durham 038D","E01020688",674,244,79,165,407,65,164,71,54,39,82,29,43,10,90,52,38,6,6,23,12,11
"2021","County Durham 038E","E01020689",698,256,100,156,420,48,169,72,63,34,76,35,39,2,123,95,28,4,4,22,12,10
"2021","County Durham 041A","E01020694",711,292,110,182,403,39,162,71,58,33,91,34,50,7,107,63,44,4,4,16,6,10
"2021","County Durham 041B","E01020696",606,232,91,141,356,65,168,79,57,32,68,39,23,6,49,33,16,6,6,18,6,12
"2021","County Durham 041C","E01020697",688,217,54,163,436,51,213,89,81,43,79,56,21,2,88,58,30,5,5,35,7,28
"2021","County Durham 041D","E01020732",1048,294,144,150,726,146,395,162,168,65,118,73,42,3,66,40,26,1,1,28,9,19
"2021","County Durham 044A","E01020695",993,316,117,199,660,97,280,119,128,33,187,107,71,9,96,70,26,0,0,17,7,10
"2021","County Durham 044B","E01020698",671,169,64,105,485,65,262,96,115,51,101,64,33,4,55,33,22,2,2,17,10,7
"2021","County Durham 044C","E01020699",643,204,70,134,419,46,179,67,83,29,81,45,33,3,111,88,23,2,2,20,8,12
"2021","County Durham 044D","E01020700",709,255,116,139,432,71,186,80,60,46,87,37,45,5,88,66,22,0,0,22,11,11
"2021","County Durham 044E","E01020701",645,233,114,119,403,64,233,101,88,44,60,42,15,3,46,28,18,0,0,9,4,5
"2021","County Durham 016A","E01020750",516,147,87,60,359,87,204,110,47,47,38,22,13,3,28,18,10,2,2,10,4,6
"2021","County Durham 016D","E01020786",663,144,75,69,499,131,267,121,79,67,54,25,21,8,47,25,22,0,0,20,13,7
"2021","County Durham 016E","E01020787",797,283,122,161,478,47,206,86,77,43,97,32,52,13,124,75,49,4,4,36,25,11
"2021","County Durham 016F","E01033163",817,199,77,122,605,70,376,115,214,47,103,56,43,4,56,41,15,0,0,13,4,9
"2021","County Durham 016H","E01034492",989,342,164,178,614,78,283,111,107,65,113,51,54,8,136,92,44,4,4,33,19,14
"2021","County Durham 017A","E01020740",564,155,88,67,389,41,202,68,89,45,73,31,34,8,72,45,27,1,1,20,11,9
"2021","County Durham 017B","E01020741",510,185,38,147,298,32,116,39,42,35,63,28,28,7,83,52,31,4,4,27,9,18
"2021","County Durham 017C","E01020742",706,244,85,159,427,31,203,86,79,38,85,37,40,8,104,75,29,4,4,35,16,19
"2021","County Durham 017D","E01020782",551,184,83,101,354,67,179,78,61,40,54,34,18,2,52,29,23,2,2,13,8,5
"2021","County Durham 017E","E01020783",582,227,114,113,342,44,157,72,58,27,68,29,33,6,71,49,22,2,2,13,4,9
"2021","County Durham 017F","E01020784",745,350,150,200,371,39,156,68,52,36,73,35,32,6,99,67,32,4,4,24,9,15
"2021","County Durham 018A","E01020743",702,171,61,110,500,34,190,50,114,26,130,63,65,2,141,104,37,5,5,31,21,10
"2021","County Durham 018B","E01020747",468,113,41,72,335,36,103,35,32,36,67,17,47,3,126,86,40,3,3,20,8,12
"2021","County Durham 018C","E01020748",487,138,51,87,324,20,139,49,58,32,65,20,36,9,97,73,24,3,3,25,15,10
"2021","County Durham 018D","E01020749",736,315,188,127,400,104,134,75,31,28,58,34,18,6,100,49,51,4,4,21,10,11
"2021","County Durham 018E","E01020773",709,245,114,131,445,80,183,79,59,45,74,35,33,6,106,68,38,2,2,19,12,7
"2021","County Durham 018F","E01020775",769,274,117,157,479,54,148,63,53,32,98,48,41,9,174,140,34,5,5,16,12,4
"2021","County Durham 021C","E01020776",802,257,147,110,527,95,269,127,78,64,77,42,30,5,84,54,30,2,2,18,11,7
"2021","County Durham 021D","E01033161",647,216,63,153,417,37,229,75,106,48,91,45,38,8,58,39,19,2,2,14,5,9
"2021","County Durham 021E","E01033198",636,249,60,189,368,43,129,67,46,16,90,44,44,2,103,74,29,3,3,19,7,12
"2021","County Durham 021F","E01033205",607,164,69,95,405,60,209,100,69,40,76,35,36,5,56,40,16,4,4,38,17,21
"2021","County Durham 021G","E01033206",662,256,100,156,387,31,161,53,68,40,86,24,50,12,105,73,32,4,4,19,8,11
"2021","County Durham 025A","E01020751",765,277,83,194,469,62,202,82,77,43,94,40,47,7,106,64,42,5,5,19,9,10
"2021","County Durham 025B","E01020752",565,246,72,174,298,36,84,39,22,23,63,29,30,4,106,76,30,9,9,21,12,9
"2021","County Durham 025C","E01020754",660,252,133,119,388,87,177,71,71,35,65,26,32,7,55,30,25,4,4,20,11,9
"2021","County Durham 025D","E01020756",700,166,61,105,516,103,248,99,98,51,102,48,49,5,60,37,23,3,3,18,10,8
"2021","County Durham 032A","E01020745",609,235,93,142,359,41,113,51,35,27,64,30,24,10,135,93,42,6,6,15,4,11
"2021","County Durham 032B","E01020753",887,398,195,203,470,56,212,87,81,44,87,43,38,6,108,76,32,7,7,19,12,7
"2021","County Durham 032C","E01020757",521,168,46,122,332,24,101,47,33,21,82,32,41,9,121,89,32,4,4,21,12,9
"2021","County Durham 032D","E01020758",636,219,76,143,379,19,122,42,52,28,93,41,48,4,141,96,45,4,4,38,19,19
"2021","County Durham 032E","E01020759",656,189,51,138,440,22,146,55,63,28,114,50,61,3,153,115,38,5,5,27,16,11
"2021","County Durham 032F","E01020765",762,243,80,163,497,39,166,70,49,47,105,45,50,10,124,84,40,63,63,22,10,12
"2021","County Durham 034A","E01020760",869,280,132,148,560,76,295,108,113,74,107,47,51,9,80,49,31,2,2,29,15,14
"2021","County Durham 034B","E01020761",688,224,64,160,441,39,166,72,61,33,95,31,57,7,135,98,37,6,6,23,14,9
"2021","County Durham 034C","E01020762",645,250,93,157,369,37,124,46,44,34,78,42,31,5,128,93,35,2,2,26,10,16
"2021","County Durham 034D","E01020763",832,288,115,173,511,72,233,107,76,50,102,52,44,6,101,69,32,3,3,33,17,16
"2021","County Durham 036A","E01020764",600,284,103,181,289,52,80,42,16,22,62,28,28,6,90,56,34,5,5,27,11,16
"2021","County Durham 036B","E01020766",702,293,163,130,399,86,165,85,48,32,65,31,32,2,78,58,20,5,5,10,5,5
"2021","County Durham 036C","E01020767",813,364,121,243,423,54,139,63,36,40,76,32,38,6,148,106,42,6,6,26,8,18
"2021","County Durham 036D","E01020768",657,214,102,112,426,54,199,83,63,53,68,27,37,4,104,75,29,1,1,17,9,8
"2021","County Durham 035A","E01020733",491,128,50,78,349,39,132,58,46,28,68,29,30,9,107,78,29,3,3,14,7,7
"2021","County Durham 035B","E01020734",522,158,59,99,341,41,104,33,48,23,73,29,38,6,118,71,47,5,5,23,16,7
"2021","County Durham 035C","E01020735",672,233,111,122,428,47,174,52,83,39,110,58,43,9,94,66,28,3,3,11,4,7
"2021","County Durham 035D","E01020770",491,152,61,91,320,43,136,53,51,32,45,16,23,6,93,63,30,3,3,19,12,7
"2021","County Durham 035E","E01020771",452,165,66,99,274,27,107,39,40,28,55,14,34,7,81,58,23,4,4,13,7,6
"2021","County Durham 035F","E01020780",563,170,68,102,379,55,138,50,63,25,75,26,41,8,105,75,30,6,6,14,8,6
"2021","County Durham 037A","E01020746",482,166,89,77,304,56,155,65,48,42,44,23,18,3,46,25,21,3,3,12,4,8
"2021","County Durham 037B","E01020769",471,110,49,61,331,48,146,54,49,43,55,17,32,6,80,56,24,2,2,30,20,10
"2021","County Durham 037C","E01020777",714,284,107,177,406,41,134,57,45,32,83,31,40,12,143,94,49,5,5,24,10,14
"2021","County Durham 037D","E01020778",537,142,68,74,383,98,184,96,51,37,51,19,28,4,49,31,18,1,1,12,9,3
"2021","County Durham 037E","E01020779",666,136,69,67,516,126,295,122,98,75,58,34,20,4,37,21,16,0,0,14,7,7
"2021","County Durham 039B","E01020737",606,187,81,106,405,75,187,86,61,40,65,22,34,9,77,46,31,1,1,14,7,7
"2021","County Durham 039D","E01020739",673,379,148,231,281,55,99,47,29,23,35,17,16,2,88,57,31,4,4,13,7,6
"2021","County Durham 039E","E01020744",537,174,71,103,345,61,135,56,39,40,68,30,34,4,79,61,18,2,2,18,9,9
"2021","County Durham 039F","E01034500",1085,404,191,213,649,117,273,146,61,66,119,53,58,8,138,85,53,2,2,32,16,16
"2021","County Durham 040A","E01020788",624,220,99,121,391,55,189,73,50,66,67,29,32,6,78,50,28,2,2,13,5,8
"2021","County Durham 040B","E01020789",764,238,93,145,508,79,234,112,80,42,111,57,46,8,79,52,27,5,5,18,6,12
"2021","County Durham 040C","E01020790",642,220,86,134,404,59,151,56,58,37,113,56,51,6,76,53,23,5,5,18,7,11
"2021","County Durham 040D","E01020791",579,191,83,108,372,59,155,68,54,33,72,26,40,6,83,56,27,3,3,16,9,7
"2021","County Durham 040E","E01020792",647,203,85,118,422,52,182,68,54,60,85,42,39,4,100,73,27,3,3,22,10,12
"2021","County Durham 043A","E01020772",873,235,123,112,600,91,332,143,120,69,96,47,43,6,79,53,26,2,2,38,24,14
"2021","County Durham 043B","E01020793",744,253,96,157,476,54,183,77,73,33,96,37,49,10,137,98,39,6,6,15,7,8
"2021","County Durham 043C","E01020794",838,212,93,119,595,72,293,118,100,75,126,65,54,7,102,69,33,2,2,31,17,14
"2021","County Durham 043D","E01020795",808,291,77,214,490,63,196,80,80,36,108,59,40,9,116,82,34,7,7,27,12,15
"2021","County Durham 047A","E01020817",538,128,63,65,399,101,217,106,70,41,50,16,33,1,31,19,12,0,0,11,4,7
"2021","County Durham 047B","E01020818",692,275,138,137,401,91,162,68,59,35,63,29,29,5,85,57,28,0,0,16,8,8
"2021","County Durham 047C","E01020819",464,162,86,76,291,30,91,37,31,23,63,24,33,6,104,69,35,3,3,11,7,4
"2021","County Durham 047D","E01020837",745,224,123,101,512,138,237,115,65,57,82,43,31,8,53,24,29,2,2,9,5,4
"2021","County Durham 047E","E01020843",728,232,110,122,479,110,232,101,85,46,77,42,30,5,59,35,24,1,1,17,10,7
"2021","County Durham 048A","E01020809",619,201,87,114,400,46,172,70,69,33,76,28,43,5,103,68,35,3,3,18,10,8
"2021","County Durham 048B","E01020810",541,177,74,103,349,52,173,77,61,35,73,36,35,2,49,30,19,2,2,15,3,12
"2021","County Durham 048C","E01020811",562,209,98,111,342,44,161,71,60,30,62,27,29,6,74,52,22,1,1,11,7,4
"2021","County Durham 048D","E01020812",668,227,123,104,424,66,205,82,81,42,77,34,37,6,73,42,31,3,3,17,2,15
"2021","County Durham 048E","E01020827",796,271,114,157,503,69,224,107,61,56,102,40,53,9,105,68,37,3,3,22,13,9
"2021","County Durham 049A","E01020806",633,209,102,107,407,89,156,73,42,41,69,30,35,4,89,66,23,4,4,17,12,5
"2021","County Durham 049B","E01020807",672,337,87,250,304,29,91,45,20,26,66,38,22,6,112,76,36,6,6,31,8,23
"2021","County Durham 049C","E01020820",938,352,147,205,564,63,207,86,92,29,141,76,57,8,142,100,42,11,11,22,11,11
"2021","County Durham 049E","E01034501",886,322,98,224,539,68,187,66,72,49,103,47,49,7,179,138,41,2,2,25,9,16
"2021","County Durham 049F","E01034502",541,81,11,70,439,14,237,77,146,14,150,88,60,2,36,29,7,2,2,21,11,10
"2021","County Durham 050A","E01020797",1189,473,196,277,691,122,290,139,91,60,134,72,55,7,140,82,58,5,5,25,12,13
"2021","County Durham 050B","E01020798",753,315,197,118,426,82,167,83,50,34,81,36,41,4,94,61,33,2,2,12,6,6
"2021","County Durham 050C","E01020799",712,268,98,170,423,65,178,72,54,52,86,44,35,7,89,61,28,5,5,21,11,10
"2021","County Durham 050D","E01020808",657,258,122,136,388,77,176,82,55,39,70,38,28,4,65,40,25,0,0,11,3,8
"2021","County Durham 052A","E01020821",884,199,79,120,652,108,348,131,146,71,121,62,56,3,68,47,21,7,7,33,14,19
"2021","County Durham 052B","E01020822",946,260,118,142,661,116,333,154,114,65,132,75,52,5,80,55,25,0,0,25,6,19
"2021","County Durham 052C","E01020823",922,411,171,240,490,73,173,81,55,37,111,49,51,11,127,90,37,6,6,21,6,15
"2021","County Durham 052D","E01020835",696,268,88,180,407,46,194,87,58,49,67,31,30,6,94,67,27,6,6,21,10,11
"2021","County Durham 052F","E01034503",722,286,100,186,419,23,236,66,136,34,90,46,37,7,67,47,20,3,3,17,7,10
"2021","County Durham 052G","E01034504",627,199,82,117,416,49,184,63,89,32,97,51,42,4,86,65,21,0,0,12,5,7
"2021","County Durham 053D","E01020805",923,393,168,225,499,82,190,90,69,31,99,51,40,8,122,95,27,6,6,31,14,17
"2021","County Durham 053F","E01034505",732,273,94,179,446,82,205,93,70,42,64,27,31,6,94,62,32,1,1,13,5,8
"2021","County Durham 053G","E01034506",585,253,72,181,312,30,129,63,41,25,70,38,27,5,79,56,23,4,4,20,6,14
"2021","County Durham 053H","E01034507",586,200,55,145,364,49,170,76,59,35,97,53,40,4,45,32,13,3,3,22,5,17
"2021","County Durham 053I","E01034508",679,166,63,103,498,62,248,98,104,46,121,76,40,5,64,31,33,3,3,15,4,11
"2021","County Durham 054A","E01020796",554,151,83,68,382,69,201,86,76,39,63,30,26,7,48,29,19,1,1,21,5,16
"2021","County Durham 054B","E01020828",669,144,81,63,500,140,271,113,101,57,51,29,19,3,38,23,15,0,0,25,12,13
"2021","County Durham 054C","E01020829",1043,336,138,198,690,151,369,112,193,64,84,46,33,5,84,64,20,2,2,17,6,11
"2021","County Durham 054D","E01020830",882,324,182,142,532,113,239,89,111,39,104,55,45,4,75,51,24,1,1,26,14,12
"2021","County Durham 059A","E01020801",680,258,86,172,402,64,184,83,51,50,87,53,32,2,65,39,26,2,2,20,7,13
"2021","County Durham 059B","E01020802",903,407,155,252,460,67,204,98,71,35,100,49,42,9,86,63,23,3,3,36,11,25
"2021","County Durham 059C","E01020838",821,330,119,211,465,66,198,88,80,30,97,48,38,11,100,69,31,4,4,26,11,15
"2021","County Durham 059D","E01020839",761,341,179,162,409,61,151,65,53,33,96,42,44,10,98,67,31,3,3,11,4,7
"2021","County Durham 059E","E01020840",949,301,110,191,622,83,259,97,116,46,145,70,62,13,132,93,39,3,3,26,7,19
"2021","County Durham 059F","E01020841",824,318,145,173,476,46,164,79,53,32,101,36,55,10,161,119,42,4,4,30,14,16
"2021","County Durham 060A","E01020813",513,97,60,37,407,117,198,75,87,36,62,40,20,2,30,20,10,0,0,9,4,5
"2021","County Durham 060B","E01020814",590,184,84,100,390,49,219,93,80,46,67,37,23,7,54,38,16,1,1,16,8,8
"2021","County Durham 060C","E01020815",574,153,66,87,402,85,179,87,63,29,70,37,30,3,65,47,18,3,3,19,11,8
"2021","County Durham 060D","E01020848",565,210,87,123,342,66,157,78,53,26,66,37,24,5,51,35,16,2,2,13,4,9
"2021","County Durham 060E","E01020850",981,188,63,125,759,89,433,167,182,84,160,88,63,9,74,52,22,3,3,34,21,13
"2021","County Durham 060F","E01020851",630,177,100,77,434,100,235,130,59,46,60,42,17,1,38,22,16,1,1,19,7,12
"2021","County Durham 061A","E01020816",579,214,93,121,339,30,97,38,39,20,72,26,41,5,139,102,37,1,1,26,11,15
"2021","County Durham 061B","E01020844",696,238,98,140,429,51,133,40,64,29,86,34,49,3,156,112,44,3,3,29,14,15
"2021","County Durham 061C","E01020847",606,180,52,128,388,30,132,49,56,27,76,30,40,6,146,108,38,4,4,38,18,20
"2021","County Durham 061D","E01020849",526,186,68,118,327,23,133,49,55,29,67,26,37,4,102,73,29,2,2,13,2,11
"2021","County Durham 062A","E01020825",789,282,128,154,482,67,206,82,83,41,107,57,46,4,98,63,35,4,4,25,7,18
"2021","County Durham 062B","E01020831",650,260,121,139,369,65,153,72,54,27,54,31,20,3,91,71,20,6,6,21,7,14
"2021","County Durham 062C","E01020833",503,140,65,75,349,66,176,65,73,38,47,16,30,1,58,36,22,2,2,14,6,8
"2021","County Durham 062D","E01020834",619,239,99,140,363,49,150,69,52,29,70,36,26,8,92,67,25,2,2,17,7,10
"2021","County Durham 063A","E01020824",760,329,159,170,413,60,167,81,51,35,89,44,36,9,96,58,38,1,1,18,7,11
"2021","County Durham 063B","E01020826",668,207,106,101,433,73,187,82,57,48,72,29,31,12,95,58,37,6,6,28,12,16
"2021","County Durham 063C","E01020832",644,209,115,94,416,79,201,87,82,32,59,21,33,5,71,50,21,6,6,19,9,10
"2021","County Durham 063D","E01020845",634,242,132,110,379,54,139,64,45,30,83,30,48,5,96,68,28,7,7,13,11,2
"2021","County Durham 063E","E01020846",533,136,75,61,373,100,170,79,55,36,52,22,26,4,48,32,16,3,3,24,7,17
"2021","County Durham 064A","E01020856",740,276,147,129,445,96,190,88,63,39,78,40,32,6,76,47,29,5,5,19,9,10
"2021","County Durham 064B","E01020858",485,147,80,67,329,59,164,82,59,23,59,33,21,5,45,31,14,2,2,9,3,6
"2021","County Durham 064C","E01020859",544,166,90,76,355,70,188,89,58,41,66,39,22,5,31,18,13,0,0,23,12,11
"2021","County Durham 064D","E01020860",480,177,61,116,291,37,119,55,42,22,65,28,30,7,67,45,22,3,3,12,4,8
"2021","County Durham 064E","E01020861",547,189,87,102,342,73,150,67,56,27,67,40,21,6,51,24,27,1,1,16,9,7
"2021","County Durham 064F","E01020862",1096,328,188,140,729,192,355,161,133,61,90,57,30,3,86,50,36,6,6,39,16,23
"2021","County Durham 064G","E01020864",955,282,143,139,638,127,330,153,118,59,102,51,45,6,76,42,34,3,3,35,14,21
"2021","County Durham 064H","E01020867",997,321,186,135,647,132,333,151,111,71,93,56,31,6,86,45,41,3,3,29,18,11
"2021","County Durham 042A","E01020889",714,213,107,106,476,97,236,138,52,46,74,51,16,7,64,52,12,5,5,25,9,16
"2021","County Durham 042B","E01020890",798,283,144,139,497,114,212,108,53,51,96,51,39,6,72,47,25,3,3,18,8,10
"2021","County Durham 042C","E01020891",783,276,140,136,488,131,226,121,64,41,78,42,32,4,51,31,20,2,2,19,7,12
"2021","County Durham 042D","E01020905",702,241,139,102,450,104,207,88,82,37,71,35,33,3,67,36,31,1,1,11,3,8
"2021","County Durham 042E","E01020906",751,215,112,103,505,135,254,104,112,38,60,37,19,4,52,34,18,4,4,31,14,17
"2021","County Durham 045A","E01020876",804,304,146,158,477,69,215,86,90,39,94,40,50,4,99,66,33,0,0,23,9,14
"2021","County Durham 045B","E01020878",755,214,86,128,513,53,225,77,86,62,101,39,52,10,131,93,38,3,3,28,15,13
"2021","County Durham 045C","E01020887",882,261,106,155,588,94,280,98,119,63,111,57,49,5,100,65,35,3,3,33,12,21
"2021","County Durham 045D","E01020892",496,177,83,94,300,42,145,69,41,35,53,25,22,6,55,35,20,5,5,19,9,10
"2021","County Durham 045E","E01020894",495,141,62,79,326,40,119,38,50,31,74,28,36,10,90,59,31,3,3,28,9,19
"2021","County Durham 045F","E01020898",740,294,125,169,418,45,121,45,48,28,93,33,56,4,153,114,39,6,6,28,18,10
"2021","County Durham 046A","E01020877",723,290,106,184,417,78,181,96,62,23,75,34,35,6,80,48,32,3,3,16,6,10
"2021","County Durham 046B","E01020879",1002,313,150,163,666,139,320,145,129,46,122,52,63,7,83,56,27,2,2,23,13,10
"2021","County Durham 046C","E01020893",866,285,92,193,552,79,234,107,90,37,115,69,41,5,123,82,41,1,1,29,13,16
"2021","County Durham 046D","E01020899",675,267,123,144,384,72,172,86,52,34,73,34,34,5,63,45,18,4,4,24,10,14
"2021","County Durham 046E","E01020903",507,164,75,89,324,48,175,89,50,36,56,26,26,4,44,29,15,1,1,19,9,10
"2021","County Durham 046F","E01020904",781,251,86,165,512,102,240,90,100,50,100,58,38,4,69,55,14,1,1,18,14,4
"2021","County Durham 051A","E01020873",666,283,107,176,368,53,129,57,39,33,73,29,38,6,112,80,32,1,1,15,5,10
"2021","County Durham 051B","E01020875",607,176,79,97,404,59,208,102,60,46,77,39,31,7,57,39,18,3,3,27,12,15
"2021","County Durham 051C","E01020900",704,169,76,93,508,91,256,114,100,42,75,29,42,4,84,62,22,2,2,27,17,10
"2021","County Durham 051D","E01020901",629,283,117,166,322,47,110,46,41,23,70,36,30,4,92,71,21,3,3,24,12,12
"2021","County Durham 051E","E01020902",647,223,90,133,400,46,139,64,44,31,77,29,43,5,133,88,45,5,5,24,8,16
"2021","County Durham 055A","E01020868",1061,440,181,259,585,78,269,112,114,43,132,75,52,5,102,63,39,4,4,36,13,23
"2021","County Durham 055B","E01020869",649,254,77,177,374,27,157,67,55,35,68,33,31,4,116,90,26,6,6,21,8,13
"2021","County Durham 055C","E01020874",744,277,102,175,447,59,177,72,63,42,85,40,37,8,120,97,23,6,6,20,10,10
"2021","County Durham 055D","E01020880",747,329,89,240,390,45,171,62,71,38,73,33,37,3,93,69,24,8,8,28,13,15
"2021","County Durham 055E","E01020881",693,235,89,146,440,75,190,92,53,45,81,42,32,7,90,69,21,4,4,18,8,10
"2021","County Durham 056A","E01020870",602,169,129,40,422,136,218,85,83,50,44,19,17,8,23,11,12,1,1,11,5,6
"2021","County Durham 056B","E01020871",626,204,97,107,396,64,151,59,61,31,73,35,32,6,106,75,31,2,2,26,13,13
"2021","County Durham 056C","E01020872",822,346,154,192,451,76,214,96,79,39,71,35,30,6,87,59,28,3,3,25,8,17
"2021","County Durham 056D","E01020883",696,168,97,71,508,89,306,132,101,73,71,32,32,7,42,18,24,0,0,20,7,13
"2021","County Durham 056E","E01020886",556,223,77,146,319,49,139,56,48,35,59,29,27,3,69,51,18,3,3,14,7,7
"2021","County Durham 057A","E01020882",632,176,80,96,431,73,211,99,61,51,74,38,31,5,73,47,26,0,0,25,8,17
"2021","County Durham 057B","E01020888",833,227,85,142,578,85,326,133,129,64,100,56,37,7,66,40,26,1,1,28,13,15
"2021","County Durham 057C","E01020895",711,269,93,176,411,48,145,62,52,31,87,43,36,8,129,98,31,2,2,31,12,19
"2021","County Durham 057D","E01020896",613,174,102,72,424,101,176,81,59,36,77,38,33,6,68,47,21,2,2,15,8,7
"2021","County Durham 057F","E01034509",714,196,61,135,495,48,230,82,107,41,120,53,61,6,95,74,21,2,2,23,12,11
"2021","County Durham 057G","E01034510",513,171,86,85,323,31,110,36,56,18,78,38,37,3,101,85,16,3,3,19,8,11
"2021","County Durham 058A","E01020884",600,222,114,108,362,69,158,68,62,28,60,29,26,5,72,54,18,3,3,16,6,10
"2021","County Durham 058B","E01020885",586,243,119,124,321,54,137,65,45,27,53,23,26,4,77,48,29,0,0,22,10,12
"2021","County Durham 058C","E01020907",686,224,86,138,443,66,165,59,59,47,83,32,46,5,124,83,41,5,5,19,9,10
"2021","County Durham 058D","E01020908",599,167,56,111,405,43,156,71,52,33,80,39,36,5,122,93,29,4,4,27,13,14
"2021","County Durham 058E","E01020909",732,260,77,183,456,25,137,52,57,28,84,28,52,4,203,158,45,7,7,16,9,7
"2021","County Durham 067E","E01020852",854,395,213,182,448,108,170,83,64,23,79,50,26,3,90,66,24,1,1,11,5,6
"2021","County Durham 067D","E01020853",771,254,150,104,494,85,247,96,103,48,89,47,37,5,70,43,27,3,3,23,6,17
"2021","County Durham 067F","E01020854",1113,403,161,242,683,160,330,164,126,40,107,63,37,7,85,59,26,1,1,27,11,16
"2021","County Durham 067C","E01020855",555,178,102,76,362,106,181,87,55,39,36,23,10,3,38,19,19,1,1,15,7,8
"2021","County Durham 067B","E01020857",648,181,105,76,440,100,246,120,85,41,50,23,20,7,41,25,16,3,3,27,15,12
"2021","County Durham 067G","E01020863",599,147,68,79,423,98,238,134,66,38,55,38,15,2,31,20,11,1,1,29,11,18
"2021","County Durham 067A","E01034511",1067,368,215,153,672,154,367,202,110,55,84,45,37,2,65,36,29,2,2,27,12,15
"2021","Northumberland 004A","E01027356",1033,305,180,125,712,188,365,174,140,51,87,51,33,3,68,42,26,4,4,16,6,10
"2021","Northumberland 004B","E01027357",542,134,93,41,395,129,213,86,82,45,23,14,8,1,29,17,12,1,1,13,6,7
"2021","Northumberland 004C","E01027366",727,209,100,109,497,150,245,146,59,40,63,43,17,3,36,19,17,3,3,21,10,11
"2021","Northumberland 004D","E01027367",662,153,73,80,497,85,294,133,122,39,72,42,27,3,43,30,13,3,3,12,3,9
"2021","Northumberland 005A","E01027358",1021,449,251,198,560,114,245,128,69,48,110,54,48,8,88,50,38,3,3,12,5,7
"2021","Northumberland 005B","E01027359",1039,404,159,245,613,90,247,90,97,60,142,63,66,13,130,87,43,4,4,22,13,9
"2021","Northumberland 005D","E01033715",665,411,169,242,244,63,93,43,33,17,48,26,19,3,38,22,16,2,2,10,4,6
"2021","Northumberland 005E","E01033717",734,244,81,163,479,101,256,115,87,54,76,45,27,4,45,20,25,1,1,11,4,7
"2021","Northumberland 006A","E01027361",826,320,170,150,490,119,225,117,60,48,73,36,29,8,72,36,36,1,1,16,11,5
"2021","Northumberland 006B","E01027362",828,255,116,139,550,75,277,145,95,37,113,55,48,10,83,59,24,2,2,23,12,11
"2021","Northumberland 006C","E01027363",555,175,85,90,357,48,137,68,43,26,75,21,39,15,96,66,30,1,1,23,13,10
"2021","Northumberland 006D","E01027364",852,273,148,125,560,139,273,136,70,67,81,45,29,7,63,32,31,4,4,19,3,16
"2021","Northumberland 006E","E01027370",926,201,119,82,702,189,393,212,116,65,71,40,28,3,45,25,20,4,4,23,5,18
"2021","Northumberland 006F","E01027371",788,238,121,117,530,75,278,110,119,49,86,42,38,6,84,50,34,7,7,20,8,12
"2021","Northumberland 006G","E01027372",1131,319,198,121,790,243,400,245,106,49,93,59,22,12,52,22,30,2,2,22,6,16
"2021","Northumberland 007A","E01027365",1101,284,167,117,780,194,426,207,143,76,95,65,26,4,60,33,27,5,5,37,16,21
"2021","Northumberland 007B","E01027368",791,272,157,115,501,120,269,129,102,38,63,34,24,5,47,24,23,2,2,18,10,8
"2021","Northumberland 007C","E01027369",732,223,154,69,495,173,231,127,75,29,55,37,15,3,34,14,20,2,2,14,3,11
"2021","Northumberland 007D","E01027373",958,289,157,132,646,155,352,209,98,45,76,51,24,1,61,38,23,2,2,23,10,13
"2021","Northumberland 001A","E01027376",752,248,117,131,493,71,202,82,74,46,103,40,58,5,110,75,35,7,7,11,6,5
"2021","Northumberland 001B","E01027377",935,496,244,252,410,112,163,104,34,25,59,47,11,1,66,44,22,10,10,29,6,23
"2021","Northumberland 001C","E01027385",490,139,53,86,331,29,133,50,57,26,67,15,50,2,101,69,32,1,1,20,8,12
"2021","Northumberland 001D","E01027387",876,397,181,216,451,89,190,83,72,35,76,52,21,3,89,57,32,7,7,28,11,17
"2021","Northumberland 001E","E01027388",617,175,79,96,420,44,159,63,61,35,95,42,43,10,120,92,28,2,2,22,15,7
"2021","Northumberland 001F","E01027389",708,256,116,140,423,82,186,79,65,42,71,28,38,5,83,59,24,1,1,29,18,11
"2021","Northumberland 002A","E01027378",511,135,84,51,368,99,196,100,58,38,45,22,19,4,25,13,12,3,3,8,6,2
"2021","Northumberland 002B","E01027379",715,174,112,62,523,158,249,108,86,55,64,30,30,4,50,25,25,2,2,18,9,9
"2021","Northumberland 002C","E01027380",623,199,116,83,398,101,198,110,56,32,57,34,21,2,41,22,19,1,1,26,6,20
"2021","Northumberland 002D","E01027382",810,285,154,131,506,150,238,128,59,51,70,43,24,3,47,23,24,1,1,19,6,13
"2021","Northumberland 002E","E01027386",604,179,104,75,403,91,183,80,66,37,80,31,44,5,48,23,25,1,1,22,10,12
"2021","Northumberland 003A","E01027374",943,301,183,118,607,160,290,166,81,43,94,53,35,6,61,33,28,2,2,35,9,26
"2021","Northumberland 003B","E01027375",865,256,114,142,577,141,299,170,82,47,88,60,25,3,45,26,19,4,4,32,10,22
"2021","Northumberland 003C","E01027381",876,252,133,119,598,152,307,172,87,48,85,51,32,2,50,29,21,4,4,26,11,15
"2021","Northumberland 003D","E01027383",594,247,145,102,327,92,145,81,36,28,50,28,18,4,36,18,18,4,4,20,8,12
"2021","Northumberland 003E","E01027384",654,219,129,90,414,134,192,121,42,29,53,34,17,2,31,23,8,4,4,21,10,11
"2021","Northumberland 003F","E01027390",1018,412,243,169,580,171,256,157,60,39,74,44,25,5,75,44,31,4,4,26,6,20
"2021","Northumberland 022A","E01027392",931,448,150,298,453,48,160,69,55,36,129,60,60,9,113,71,42,3,3,30,10,20
"2021","Northumberland 022B","E01027393",604,174,67,107,412,33,141,42,59,40,83,13,53,17,149,113,36,6,6,18,10,8
"2021","Northumberland 022C","E01027416",752,326,101,225,390,22,118,66,37,15,86,28,57,1,155,119,36,9,9,36,20,16
"2021","Northumberland 022D","E01027424",793,276,74,202,489,58,178,70,74,34,103,46,45,12,144,100,44,6,6,28,13,15
"2021","Northumberland 023A","E01027414",641,248,68,180,366,55,162,72,56,34,82,51,27,4,64,46,18,3,3,27,13,14
"2021","Northumberland 023B","E01027415",754,355,115,240,373,42,138,60,47,31,91,50,38,3,93,54,39,9,9,26,10,16
"2021","Northumberland 023C","E01027431",847,425,115,310,402,45,144,63,50,31,93,59,31,3,112,79,33,8,8,20,6,14
"2021","Northumberland 023E","E01027442",792,406,171,235,367,66,181,92,51,38,66,35,22,9,53,28,25,1,1,19,9,10
"2021","Northumberland 023F","E01035631",740,266,123,143,459,75,177,68,72,37,95,43,40,12,111,67,44,1,1,15,6,9
"2021","Northumberland 023G","E01035632",736,221,78,143,503,34,279,80,170,29,126,62,59,5,61,42,19,3,3,12,4,8
"2021","Northumberland 024A","E01027391",603,149,69,80,429,54,178,72,62,44,91,31,53,7,100,76,24,6,6,25,14,11
"2021","Northumberland 024B","E01027422",812,332,137,195,460,72,183,82,58,43,88,34,46,8,111,67,44,6,6,20,8,12
"2021","Northumberland 024C","E01027423",625,197,120,77,405,69,141,58,52,31,69,26,41,2,123,80,43,3,3,23,11,12
"2021","Northumberland 024D","E01027429",856,321,144,177,517,69,176,81,58,37,109,50,50,9,153,101,52,10,10,18,10,8
"2021","Northumberland 024E","E01027430",700,229,134,95,449,85,181,72,66,43,55,18,31,6,123,93,30,5,5,22,8,14
"2021","Northumberland 025B","E01027426",800,172,37,135,598,28,225,74,118,33,157,76,78,3,182,142,40,6,6,30,21,9
"2021","Northumberland 025C","E01027427",944,414,140,274,504,72,180,81,52,47,91,38,48,5,152,117,35,9,9,26,11,15
"2021","Northumberland 025D","E01027428",624,171,83,88,429,96,227,89,84,54,58,34,19,5,48,30,18,0,0,24,9,15
"2021","Northumberland 025E","E01035633",609,173,91,82,416,74,205,85,61,59,72,36,33,3,61,42,19,4,4,20,9,11
"2021","Northumberland 025F","E01035634",402,57,13,44,326,32,200,81,83,36,63,40,17,6,31,16,15,0,0,19,7,12
"2021","Northumberland 025G","E01035635",641,141,8,133,483,11,247,78,152,17,168,103,64,1,56,47,9,1,1,17,12,5
"2021","Northumberland 026A","E01027437",755,210,132,78,536,137,294,149,89,56,55,37,13,5,50,30,20,0,0,9,4,5
"2021","Northumberland 026B","E01027438",616,176,96,80,422,86,195,89,65,41,77,43,28,6,61,44,17,3,3,18,10,8
"2021","Northumberland 026C","E01027439",765,160,80,80,586,113,362,143,155,64,65,34,29,2,46,33,13,0,0,19,9,10
"2021","Northumberland 026D","E01027440",626,140,93,47,473,111,231,90,84,57,76,41,32,3,54,27,27,1,1,13,8,5
"2021","Northumberland 029A","E01027398",876,233,74,159,596,37,246,89,94,63,120,49,63,8,189,134,55,4,4,47,28,19
"2021","Northumberland 029B","E01027409",744,307,157,150,417,108,160,71,48,41,73,40,26,7,73,46,27,3,3,20,4,16
"2021","Northumberland 029C","E01027411",624,246,136,110,363,69,158,62,67,29,45,20,19,6,91,62,29,0,0,15,11,4
"2021","Northumberland 029D","E01027412",908,287,78,209,575,38,182,79,72,31,199,109,78,12,151,100,51,5,5,46,20,26
"2021","Northumberland 029E","E01027413",941,291,115,176,630,89,286,110,117,59,123,53,63,7,128,80,48,4,4,20,12,8
"2021","Northumberland 030A","E01027417",686,187,123,64,483,152,232,114,71,47,45,18,24,3,53,26,27,1,1,16,9,7
"2021","Northumberland 030B","E01027418",780,214,103,111,548,101,286,113,123,50,86,50,33,3,73,53,20,2,2,18,8,10
"2021","Northumberland 030C","E01027419",756,315,186,129,423,90,188,84,56,48,68,37,30,1,73,33,40,4,4,18,6,12
"2021","Northumberland 030D","E01027420",597,162,100,62,424,111,196,80,73,43,50,30,18,2,63,25,38,4,4,11,5,6
"2021","Northumberland 030E","E01027421",731,321,150,171,397,76,169,90,56,23,65,42,19,4,84,46,38,3,3,13,4,9
"2021","Northumberland 031A","E01027394",532,209,105,104,315,77,130,65,35,30,49,25,21,3,56,34,22,3,3,8,2,6
"2021","Northumberland 031B","E01027406",610,221,141,80,376,141,166,73,50,43,33,19,12,2,34,13,21,2,2,13,4,9
"2021","Northumberland 031C","E01027407",618,239,120,119,363,109,159,80,50,29,54,30,19,5,41,24,17,0,0,16,8,8
"2021","Northumberland 031D","E01027408",685,291,145,146,378,87,139,49,64,26,68,38,27,3,83,55,28,1,1,16,8,8
"2021","Northumberland 031E","E01027410",654,154,102,52,489,152,261,97,107,57,49,21,24,4,27,12,15,0,0,11,4,7
"2021","Northumberland 032A","E01027432",821,403,133,270,402,58,162,68,68,26,96,64,24,8,80,52,28,6,6,16,8,8
"2021","Northumberland 032B","E01027433",1198,391,127,264,789,82,367,130,185,52,178,113,57,8,159,108,51,3,3,18,9,9
"2021","Northumberland 032C","E01027434",631,225,113,112,394,89,174,70,51,53,59,33,20,6,72,43,29,0,0,12,5,7
"2021","Northumberland 032D","E01027435",703,304,94,210,387,89,168,75,55,38,68,44,23,1,62,40,22,0,0,12,4,8
"2021","Northumberland 032E","E01027436",697,236,109,127,448,86,208,97,70,41,73,37,31,5,75,47,28,6,6,13,5,8
"2021","Northumberland 008A","E01027443",755,261,101,160,473,55,210,113,65,32,109,44,57,8,95,56,39,4,4,21,9,12
"2021","Northumberland 008B","E01027444",591,154,78,76,420,81,208,101,63,44,83,40,35,8,47,25,22,1,1,17,2,15
"2021","Northumberland 008C","E01027445",771,240,113,127,505,100,230,123,64,43,95,57,32,6,79,52,27,1,1,26,13,13
"2021","Northumberland 008D","E01027446",606,147,97,50,444,106,238,129,53,56,53,32,17,4,46,26,20,1,1,15,10,5
"2021","Northumberland 008E","E01027451",823,332,133,199,468,68,182,86,59,37,89,41,44,4,127,76,51,2,2,23,11,12
"2021","Northumberland 008F","E01027474",851,296,116,180,525,86,218,92,89,37,127,55,63,9,94,45,49,0,0,30,15,15
"2021","Northumberland 008G","E01027475",665,197,113,84,445,133,215,125,54,36,61,36,22,3,32,15,17,4,4,23,11,12
"2021","Northumberland 011A","E01027457",720,207,104,103,490,96,289,106,137,46,40,21,13,6,64,46,18,1,1,23,8,15
"2021","Northumberland 011B","E01027462",937,368,180,188,547,60,223,91,83,49,108,52,47,9,155,116,39,1,1,22,12,10
"2021","Northumberland 011C","E01027463",820,241,104,137,564,98,307,159,98,50,101,62,36,3,58,34,24,0,0,15,7,8
"2021","Northumberland 015A","E01027447",785,202,100,102,558,116,303,157,86,60,90,59,28,3,49,34,15,0,0,25,5,20
"2021","Northumberland 015C","E01027450",766,187,114,73,555,113,338,177,109,52,57,37,16,4,45,28,17,2,2,24,13,11
"2021","Northumberland 015D","E01027473",1142,261,110,151,855,143,515,222,213,80,135,84,45,6,61,38,23,1,1,26,11,15
"2021","Northumberland 015E","E01035629",671,120,49,71,529,84,284,117,131,36,98,55,41,2,62,46,16,1,1,22,15,7
"2021","Northumberland 015F","E01035630",686,150,63,87,517,92,267,101,124,42,88,62,24,2,69,53,16,1,1,19,10,9
"2021","Northumberland 016A","E01027452",639,228,108,120,395,87,181,89,56,36,55,40,10,5,66,38,28,6,6,16,6,10
"2021","Northumberland 016B","E01027453",883,483,296,187,381,105,156,74,47,35,58,45,11,2,58,33,25,4,4,19,4,15
"2021","Northumberland 016E","E01027461",610,220,113,107,374,62,145,62,55,28,72,27,40,5,91,62,29,4,4,16,3,13
"2021","Northumberland 016F","E01033718",978,407,224,183,556,84,254,101,111,42,96,51,39,6,119,81,38,3,3,15,6,9
"2021","Northumberland 018A","E01027455",621,143,105,38,464,150,235,89,105,41,44,20,21,3,34,19,15,1,1,14,8,6
"2021","Northumberland 018B","E01027456",515,102,73,29,404,147,212,78,88,46,21,7,11,3,24,13,11,0,0,9,6,3
"2021","Northumberland 018C","E01027458",986,226,130,96,737,161,427,162,201,64,77,43,31,3,71,43,28,1,1,23,12,11
"2021","Northumberland 018D","E01027460",731,221,132,89,499,118,263,99,121,43,52,29,22,1,65,38,27,1,1,11,3,8
"2021","Northumberland 033A","E01027464",621,225,153,72,377,130,188,66,79,43,32,18,14,0,26,15,11,1,1,19,10,9
"2021","Northumberland 033B","E01027465",646,178,111,67,451,106,241,98,88,55,42,19,19,4,58,33,25,4,4,17,6,11
"2021","Northumberland 033C","E01027466",605,251,171,80,334,67,155,50,71,34,41,21,19,1,64,42,22,7,7,20,12,8
"2021","Northumberland 033F","E01033714",1180,262,157,105,864,215,466,153,219,94,103,48,45,10,80,48,32,0,0,54,27,27
"2021","Northumberland 034A","E01027449",691,192,141,51,481,129,259,115,83,61,53,29,19,5,38,18,20,2,2,18,11,7
"2021","Northumberland 034B","E01027468",523,87,73,14,421,146,228,76,114,38,35,20,12,3,12,4,8,0,0,15,8,7
"2021","Northumberland 034C","E01027469",530,101,72,29,405,120,237,77,114,46,26,9,13,4,21,12,9,1,1,24,10,14
"2021","Northumberland 034D","E01027471",756,125,88,37,590,155,356,105,194,57,49,18,28,3,30,16,14,0,0,41,18,23
"2021","Northumberland 034E","E01027472",633,159,69,90,456,77,268,113,115,40,63,35,22,6,48,32,16,0,0,18,9,9
"2021","Northumberland 019A","E01027479",1007,312,167,145,667,145,339,171,110,58,103,54,47,2,79,48,31,1,1,28,12,16
"2021","Northumberland 019B","E01027480",555,152,78,74,388,68,228,115,84,29,57,35,18,4,32,15,17,3,3,15,7,8
"2021","Northumberland 019C","E01027503",739,215,118,97,494,119,267,158,74,35,63,35,25,3,43,18,25,2,2,30,9,21
"2021","Northumberland 019D","E01027511",498,140,71,69,340,81,177,93,57,27,53,32,20,1,26,13,13,3,3,18,5,13
"2021","Northumberland 037A","E01027484",944,251,151,100,667,165,348,194,87,67,95,51,44,0,57,23,34,2,2,26,9,17
"2021","Northumberland 037B","E01027485",697,254,123,131,427,97,164,69,61,34,83,37,42,4,82,55,27,1,1,16,5,11
"2021","Northumberland 037C","E01027486",513,190,102,88,309,55,131,52,52,27,66,32,27,7,54,30,24,3,3,14,4,10
"2021","Northumberland 037D","E01027487",547,201,109,92,337,81,143,64,44,35,56,26,24,6,55,29,26,2,2,9,6,3
"2021","Northumberland 037E","E01027512",458,144,70,74,291,65,156,77,46,33,46,27,18,1,22,12,10,2,2,23,11,12
"2021","Northumberland 036A","E01027483",564,163,80,83,383,87,211,87,80,44,42,26,16,0,39,21,18,4,4,18,10,8
"2021","Northumberland 036B","E01027496",546,184,99,85,350,72,173,71,69,33,48,29,19,0,56,34,22,1,1,12,3,9
"2021","Northumberland 036C","E01027508",507,171,76,95,320,52,171,72,62,37,55,33,18,4,42,27,15,0,0,16,8,8
"2021","Northumberland 036D","E01027513",881,259,147,112,605,155,339,126,158,55,66,35,27,4,43,23,20,2,2,17,10,7
"2021","Northumberland 035A","E01027476",1199,548,260,288,630,133,283,121,113,49,116,69,45,2,98,60,38,0,0,21,7,14
"2021","Northumberland 035B","E01027489",664,183,86,97,455,108,223,91,90,42,65,40,19,6,54,28,26,5,5,26,7,19
"2021","Northumberland 035C","E01027490",829,329,152,177,472,80,204,88,79,37,82,40,31,11,100,68,32,6,6,28,13,15
"2021","Northumberland 035D","E01027491",645,159,113,46,467,150,258,129,92,37,32,15,13,4,27,10,17,0,0,19,8,11
"2021","Northumberland 035E","E01027492",773,242,138,104,514,112,276,106,126,44,62,37,20,5,61,34,27,3,3,17,4,13
"2021","Northumberland 035F","E01027493",691,260,135,125,407,50,147,60,58,29,79,35,41,3,123,84,39,8,8,24,8,16
"2021","Northumberland 035G","E01027494",1178,419,239,180,725,183,349,156,139,54,97,49,40,8,91,56,35,5,5,34,11,23
"2021","Northumberland 038A","E01027497",1020,231,94,137,758,96,430,154,196,80,98,42,48,8,132,91,41,2,2,31,11,20
"2021","Northumberland 038B","E01027498",1193,445,195,250,725,75,344,119,162,63,140,53,76,11,162,100,62,4,4,23,11,12
"2021","Northumberland 038C","E01027499",807,202,120,82,588,125,296,107,145,44,102,56,39,7,65,35,30,0,0,17,8,9
"2021","Northumberland 038D","E01027500",787,329,149,180,428,83,169,63,73,33,75,42,27,6,98,52,46,3,3,30,16,14
"2021","Northumberland 038G","E01035636",965,293,135,158,648,119,331,149,117,65,95,57,33,5,100,57,43,3,3,24,8,16
"2021","Northumberland 040A","E01027477",534,152,79,73,365,86,199,101,62,36,62,39,17,6,18,6,12,0,0,17,5,12
"2021","Northumberland 040B","E01027478",516,188,124,64,313,72,162,76,56,30,42,25,17,0,34,21,13,3,3,15,8,7
"2021","Northumberland 040C","E01027488",1047,302,147,155,713,127,336,148,123,65,148,83,59,6,96,55,41,6,6,32,16,16
"2021","Northumberland 040D","E01027495",523,144,83,61,366,107,179,96,58,25,38,22,14,2,41,32,9,1,1,13,6,7
"2021","Northumberland 040E","E01027505",582,129,83,46,436,111,251,121,88,42,54,33,18,3,19,11,8,1,1,17,10,7
"2021","Northumberland 040F","E01027510",528,158,77,81,364,74,199,94,73,32,57,31,26,0,32,20,12,2,2,6,2,4
"2021","Northumberland 009A","E01027541",832,321,157,164,483,106,183,104,41,38,86,45,34,7,101,64,37,7,7,28,10,18
"2021","Northumberland 009B","E01027542",842,336,166,170,461,67,177,92,54,31,74,38,35,1,136,93,43,7,7,45,33,12
"2021","Northumberland 009C","E01027543",561,168,80,88,375,46,141,54,51,36,69,16,42,11,115,83,32,4,4,18,6,12
"2021","Northumberland 009D","E01027544",641,261,122,139,358,73,149,88,31,30,70,39,25,6,64,32,32,2,2,22,9,13
"2021","Northumberland 010A","E01027528",690,318,124,194,361,56,128,53,42,33,68,28,37,3,108,79,29,1,1,11,7,4
"2021","Northumberland 010B","E01027529",476,146,54,92,312,37,145,62,54,29,63,28,32,3,64,41,23,3,3,18,11,7
"2021","Northumberland 010C","E01027539",738,320,82,238,397,39,133,53,54,26,84,33,42,9,136,107,29,5,5,21,7,14
"2021","Northumberland 010D","E01027545",841,355,81,274,455,41,141,50,55,36,95,47,43,5,168,131,37,10,10,31,10,21
"2021","Northumberland 010E","E01027546",745,320,74,246,405,43,123,56,45,22,84,43,37,4,151,106,45,4,4,20,7,13
"2021","Northumberland 013A","E01027533",952,522,132,390,409,59,130,56,45,29,83,49,30,4,129,95,34,8,8,21,11,10
"2021","Northumberland 013B","E01027540",823,288,107,181,497,56,194,84,79,31,100,33,52,15,140,101,39,7,7,38,18,20
"2021","Northumberland 013E","E01027549",1099,203,46,157,855,91,489,164,255,70,184,87,87,10,90,65,25,1,1,41,23,18
"2021","Northumberland 013F","E01033716",1055,380,164,216,652,153,230,93,88,49,104,41,56,7,165,118,47,0,0,23,13,10
"2021","Northumberland 017A","E01027530",617,190,76,114,405,44,169,77,59,33,86,37,43,6,103,74,29,3,3,22,10,12
"2021","Northumberland 017B","E01027531",721,211,89,122,489,65,241,102,93,46,84,50,30,4,92,66,26,7,7,21,11,10
"2021","Northumberland 017C","E01027534",860,322,121,201,519,81,194,83,69,42,97,40,48,9,144,88,56,3,3,19,9,10
"2021","Northumberland 017D","E01027535",644,202,141,61,430,126,225,106,63,56,48,28,16,4,30,15,15,1,1,12,4,8
"2021","Northumberland 017E","E01027553",753,259,122,137,470,77,207,95,63,49,94,50,33,11,89,52,37,3,3,24,9,15
"2021","Northumberland 017F","E01027554",621,187,107,80,416,132,176,79,50,47,59,35,19,5,47,26,21,2,2,18,9,9
"2021","Northumberland 020A","E01027515",718,271,102,169,431,62,195,96,65,34,96,56,34,6,77,46,31,1,1,16,7,9
"2021","Northumberland 020B","E01027517",878,352,111,241,504,88,234,91,93,50,99,59,34,6,78,52,26,5,5,22,6,16
"2021","Northumberland 020C","E01027518",631,212,106,106,388,48,153,76,53,24,78,23,48,7,106,70,36,3,3,31,14,17
"2021","Northumberland 020D","E01027519",602,208,60,148,370,41,126,52,45,29,80,27,43,10,121,94,27,2,2,24,3,21
"2021","Northumberland 020E","E01027550",608,231,96,135,367,58,174,73,51,50,59,22,32,5,72,47,25,4,4,10,6,4
"2021","Northumberland 020F","E01027551",685,262,90,172,397,46,147,58,55,34,84,30,48,6,118,87,31,2,2,26,15,11
"2021","Northumberland 020G","E01027552",605,241,88,153,347,50,149,69,47,33,84,45,29,10,62,40,22,2,2,17,7,10
"2021","Northumberland 021A","E01027514",753,210,126,84,522,121,255,132,77,46,73,43,27,3,68,44,24,5,5,21,5,16
"2021","Northumberland 021B","E01027516",500,182,114,68,309,84,158,79,42,37,39,20,16,3,25,12,13,3,3,9,3,6
"2021","Northumberland 021C","E01027520",624,152,76,76,453,98,267,121,101,45,54,20,31,3,34,20,14,0,0,19,10,9
"2021","Northumberland 021D","E01027521",753,124,39,85,612,87,381,152,164,65,94,59,30,5,50,29,21,0,0,17,9,8
"2021","Northumberland 021E","E01027522",627,233,89,144,379,39,135,57,47,31,67,29,34,4,137,103,34,1,1,15,7,8
"2021","Northumberland 021F","E01027523",531,206,95,111,310,61,126,47,47,32,57,21,29,7,64,39,25,2,2,15,8,7
"2021","Northumberland 041B","E01027524",882,276,92,184,592,54,270,95,137,38,150,83,57,10,115,76,39,3,3,14,6,8
"2021","Northumberland 041A","E01027525",897,424,181,243,458,71,242,103,89,50,73,42,26,5,71,52,19,1,1,15,10,5
"2021","Northumberland 041D","E01027526",518,124,81,43,376,100,217,105,62,50,31,24,4,3,27,13,14,1,1,18,7,11
"2021","Northumberland 041C","E01027527",593,202,78,124,367,40,119,61,36,22,68,17,42,9,132,88,44,8,8,24,15,9
"2021","Northumberland 041H","E01027532",984,310,104,206,650,110,274,136,66,72,141,79,55,7,115,80,35,10,10,24,6,18
"2021","Northumberland 041E","E01027536",574,158,77,81,409,72,223,110,63,50,52,21,24,7,62,38,24,0,0,7,5,2
"2021","Northumberland 041F","E01027537",602,197,106,91,393,72,140,51,57,32,76,37,33,6,103,74,29,2,2,12,8,4
"2021","Northumberland 041G","E01027538",701,155,82,73,524,113,293,119,90,84,71,41,25,5,46,26,20,1,1,22,7,15
"2021","Northumberland 042J","E01027395",900,339,98,241,539,45,246,96,106,44,154,93,55,6,88,60,28,6,6,22,2,20
"2021","Northumberland 042H","E01027396",551,167,78,89,363,34,153,63,65,25,72,36,25,11,98,66,32,6,6,21,8,13
"2021","Northumberland 042I","E01027397",618,209,109,100,394,51,158,68,54,36,82,28,43,11,98,62,36,5,5,15,6,9
"2021","Northumberland 042E","E01027399",595,147,49,98,429,66,257,107,108,42,66,37,29,0,40,23,17,0,0,19,9,10
"2021","Northumberland 042A","E01027400",483,83,31,52,394,36,264,64,153,47,53,27,20,6,41,21,20,0,0,6,4,2
"2021","Northumberland 042C","E01027401",534,82,51,31,440,90,278,83,132,63,36,20,16,0,33,17,16,3,3,12,8,4
"2021","Northumberland 042B","E01027402",491,74,40,34,410,78,260,90,109,61,44,18,20,6,28,20,8,0,0,7,4,3
"2021","Northumberland 042D","E01027403",482,116,66,50,354,89,199,76,89,34,29,20,6,3,36,19,17,1,1,12,7,5
"2021","Northumberland 042F","E01027404",926,217,71,146,690,84,347,103,183,61,175,110,60,5,81,52,29,3,3,19,6,13
"2021","Northumberland 042G","E01027405",630,180,100,80,432,134,212,86,75,51,54,28,23,3,32,15,17,0,0,18,5,13
"2021","Northumberland 043A","E01027481",811,348,206,142,450,145,202,92,67,43,53,32,18,3,49,30,19,1,1,13,3,10
"2021","Northumberland 043B","E01027482",731,239,170,69,474,129,235,107,89,39,58,31,23,4,52,31,21,0,0,18,5,13
"2021","Northumberland 043C","E01027504",796,215,124,91,560,166,303,126,126,51,56,34,20,2,34,19,15,1,1,21,7,14
"2021","Northumberland 043E","E01027507",568,94,66,28,461,116,264,108,109,47,41,25,13,3,39,25,14,1,1,13,4,9
"2021","Northumberland 043D","E01027509",618,212,151,61,397,97,208,92,88,28,44,24,17,3,46,28,18,2,2,9,6,3
"2021","Northumberland 043F","E01035637",455,97,48,49,337,68,195,88,70,37,48,35,13,0,22,12,10,4,4,21,11,10
"2021","Newcastle upon Tyne 002A","E01008309",727,177,128,49,533,133,310,97,165,48,54,31,19,4,35,14,21,1,1,17,9,8
"2021","Newcastle upon Tyne 002C","E01008352",617,199,90,109,382,49,195,55,107,33,71,49,19,3,62,36,26,5,5,36,10,26
"2021","Newcastle upon Tyne 002D","E01008357",678,201,131,70,441,138,251,93,108,50,29,20,5,4,21,13,8,2,2,36,17,19
"2021","Newcastle upon Tyne 002E","E01008358",907,366,124,242,500,69,191,85,93,13,166,147,18,1,69,41,28,5,5,41,2,39
"2021","Newcastle upon Tyne 002F","E01033550",706,108,55,53,570,50,397,94,245,58,67,28,38,1,55,38,17,1,1,28,12,16
"2021","Newcastle upon Tyne 002G","E01033551",771,196,108,88,550,115,328,128,153,47,81,56,23,2,25,12,13,1,1,25,12,13
"2021","Newcastle upon Tyne 003A","E01008336",661,299,108,191,334,36,133,50,57,26,51,31,17,3,104,64,40,10,10,28,9,19
"2021","Newcastle upon Tyne 003B","E01008337",551,169,76,93,359,36,144,65,55,24,51,27,17,7,125,82,43,3,3,23,7,16
"2021","Newcastle upon Tyne 003C","E01008338",494,156,52,104,308,28,135,57,54,24,66,35,26,5,70,40,30,9,9,30,9,21
"2021","Newcastle upon Tyne 003D","E01008339",776,256,103,153,465,23,209,69,90,50,99,57,36,6,125,80,45,9,9,55,16,39
"2021","Newcastle upon Tyne 003E","E01008340",723,257,63,194,432,20,181,30,114,37,83,29,45,9,134,97,37,14,14,34,15,19
"2021","Newcastle upon Tyne 003F","E01008341",655,260,97,163,371,31,146,62,58,26,81,34,38,9,107,66,41,6,6,24,12,12
"2021","Newcastle upon Tyne 003G","E01008342",696,299,144,155,387,88,180,88,48,44,62,31,26,5,51,25,26,6,6,10,3,7
"2021","Newcastle upon Tyne 004A","E01008293",641,231,80,151,393,69,204,84,76,44,62,36,23,3,54,28,26,4,4,17,5,12
"2021","Newcastle upon Tyne 004B","E01008456",662,218,92,126,417,29,148,49,65,34,80,29,40,11,155,98,57,5,5,27,12,15
"2021","Newcastle upon Tyne 004C","E01008457",798,384,138,246,384,31,139,56,48,35,86,40,39,7,123,93,30,5,5,30,12,18
"2021","Newcastle upon Tyne 004D","E01008458",923,247,117,130,643,113,343,125,153,65,124,87,31,6,61,29,32,2,2,33,17,16
"2021","Newcastle upon Tyne 004E","E01008459",706,191,57,134,466,19,132,23,77,32,121,36,74,11,187,129,58,7,7,49,28,21
"2021","Newcastle upon Tyne 004F","E01008460",595,189,86,103,375,43,139,41,48,50,79,36,34,9,112,73,39,2,2,31,16,15
"2021","Newcastle upon Tyne 005A","E01008351",615,175,94,81,412,91,204,69,102,33,68,48,19,1,46,25,21,3,3,28,10,18
"2021","Newcastle upon Tyne 005B","E01008354",760,294,95,199,439,39,226,79,124,23,98,68,27,3,69,39,30,7,7,27,3,24
"2021","Newcastle upon Tyne 005C","E01008418",866,275,136,139,550,109,330,105,189,36,77,61,12,4,31,15,16,3,3,41,9,32
"2021","Newcastle upon Tyne 005D","E01008420",556,164,90,74,366,77,217,77,116,24,46,32,12,2,25,11,14,1,1,26,6,20
"2021","Newcastle upon Tyne 005E","E01008422",642,183,74,109,381,57,206,56,121,29,81,61,20,0,30,19,11,7,7,78,5,73
"2021","Newcastle upon Tyne 005F","E01008424",716,324,89,235,343,20,118,43,64,11,136,117,18,1,61,37,24,8,8,49,5,44
"2021","Newcastle upon Tyne 006A","E01008353",709,247,101,146,437,67,183,52,94,37,82,49,30,3,101,69,32,4,4,25,8,17
"2021","Newcastle upon Tyne 006B","E01008355",752,316,175,141,402,51,222,85,120,17,85,62,21,2,41,23,18,3,3,34,6,28
"2021","Newcastle upon Tyne 006C","E01008356",589,200,69,131,363,59,204,75,94,35,52,38,13,1,46,27,19,2,2,26,9,17
"2021","Newcastle upon Tyne 006D","E01008378",521,99,62,37,397,76,244,63,139,42,47,29,17,1,28,17,11,2,2,25,14,11
"2021","Newcastle upon Tyne 006E","E01008419",630,200,68,132,405,52,222,70,121,31,95,71,21,3,29,19,10,7,7,25,4,21
"2021","Newcastle upon Tyne 006F","E01008421",666,207,71,136,429,65,235,73,137,25,85,70,14,1,41,27,14,3,3,30,11,19
"2021","Newcastle upon Tyne 006G","E01008423",514,120,76,44,371,93,243,71,130,42,14,6,7,1,20,5,15,1,1,23,9,14
"2021","Newcastle upon Tyne 007A","E01008317",535,113,73,40,397,53,260,66,146,48,51,29,21,1,31,16,15,2,2,25,13,12
"2021","Newcastle upon Tyne 007B","E01008319",691,138,59,79,520,81,343,99,175,69,49,28,17,4,41,20,21,6,6,33,15,18
"2021","Newcastle upon Tyne 007C","E01008320",667,171,82,89,470,65,257,91,125,41,72,42,23,7,69,35,34,7,7,26,12,14
"2021","Newcastle upon Tyne 007D","E01008321",736,223,92,131,483,80,274,99,139,36,78,57,17,4,46,24,22,5,5,30,10,20
"2021","Newcastle upon Tyne 007E","E01008322",584,118,67,51,430,58,273,72,157,44,55,31,18,6,42,18,24,2,2,36,16,20
"2021","Newcastle upon Tyne 007F","E01008323",760,244,77,167,470,42,224,64,125,35,139,96,38,5,57,34,23,8,8,46,11,35
"2021","Newcastle upon Tyne 008A","E01008295",643,148,61,87,432,33,160,33,86,41,78,33,34,11,157,112,45,4,4,63,33,30
"2021","Newcastle upon Tyne 008B","E01008374",630,178,93,85,423,53,240,81,121,38,73,41,27,5,54,28,26,3,3,29,12,17
"2021","Newcastle upon Tyne 008C","E01008375",736,325,126,199,396,23,173,73,73,27,76,42,27,7,118,85,33,6,6,15,4,11
"2021","Newcastle upon Tyne 008D","E01008376",454,93,59,34,340,51,214,68,102,44,50,31,12,7,24,15,9,1,1,21,9,12
"2021","Newcastle upon Tyne 008E","E01008377",851,234,47,187,564,10,243,67,145,31,120,49,58,13,188,132,56,3,3,53,27,26
"2021","Newcastle upon Tyne 008F","E01008379",809,302,158,144,479,96,173,67,85,21,59,20,28,11,145,118,27,6,6,28,13,15
"2021","Newcastle upon Tyne 008G","E01008380",782,301,70,231,438,15,183,38,129,16,80,27,48,5,153,116,37,7,7,43,22,21
"2021","Newcastle upon Tyne 011A","E01008296",701,288,128,160,404,77,138,62,44,32,79,43,30,6,106,67,39,4,4,9,1,8
"2021","Newcastle upon Tyne 011B","E01008297",878,350,108,242,485,29,188,68,81,39,126,70,49,7,130,82,48,12,12,43,25,18
"2021","Newcastle upon Tyne 011C","E01008298",822,236,100,136,558,47,264,69,152,43,135,65,61,9,109,58,51,3,3,28,11,17
"2021","Newcastle upon Tyne 011D","E01008299",555,176,83,93,355,28,151,48,70,33,65,23,34,8,108,68,40,3,3,24,13,11
"2021","Newcastle upon Tyne 012A","E01008314",474,129,50,79,309,41,153,52,72,29,75,46,24,5,39,19,20,1,1,36,10,26
"2021","Newcastle upon Tyne 012B","E01008315",630,151,59,92,440,49,213,79,95,39,97,50,43,4,77,38,39,4,4,39,17,22
"2021","Newcastle upon Tyne 012C","E01008316",657,172,62,110,461,75,254,100,104,50,86,53,26,7,44,22,22,2,2,24,9,15
"2021","Newcastle upon Tyne 012D","E01008318",604,221,122,99,354,39,152,57,68,27,64,34,20,10,92,56,36,7,7,29,9,20
"2021","Newcastle upon Tyne 012E","E01008363",836,330,137,193,442,85,163,80,59,24,127,111,15,1,48,20,28,19,19,64,4,60
"2021","Newcastle upon Tyne 012F","E01008365",576,96,47,49,418,61,262,76,139,47,64,30,27,7,29,14,15,2,2,62,10,52
"2021","Newcastle upon Tyne 013A","E01008366",657,130,36,94,225,31,95,36,44,15,74,59,12,3,19,11,8,6,6,302,4,298
"2021","Newcastle upon Tyne 013B","E01008369",678,182,44,138,214,26,98,41,44,13,72,64,7,1,13,7,6,5,5,282,3,279
"2021","Newcastle upon Tyne 013C","E01008371",630,191,120,71,394,91,230,105,87,38,50,32,15,3,21,12,9,2,2,45,9,36
"2021","Newcastle upon Tyne 013D","E01008372",682,219,54,165,147,11,52,20,21,11,63,60,3,0,8,4,4,13,13,316,4,312
"2021","Newcastle upon Tyne 013E","E01008373",687,114,25,89,130,3,31,12,13,6,68,66,2,0,11,3,8,17,17,443,3,440
"2021","Newcastle upon Tyne 014A","E01008400",885,411,169,242,446,56,168,61,82,25,90,48,40,2,131,82,49,1,1,28,13,15
"2021","Newcastle upon Tyne 014B","E01008401",592,174,92,82,385,57,146,46,66,34,65,23,37,5,113,76,37,4,4,33,16,17
"2021","Newcastle upon Tyne 014C","E01008402",654,202,87,115,424,68,168,55,70,43,87,51,33,3,99,67,32,2,2,28,16,12
"2021","Newcastle upon Tyne 014D","E01008403",715,205,104,101,490,106,221,89,75,57,113,58,47,8,50,28,22,0,0,20,7,13
"2021","Newcastle upon Tyne 014E","E01008404",809,359,78,281,423,40,163,83,48,32,108,62,39,7,109,64,45,3,3,27,11,16
"2021","Newcastle upon Tyne 014F","E01008405",681,198,77,121,457,45,168,71,66,31,80,37,39,4,158,123,35,6,6,26,9,17
"2021","Newcastle upon Tyne 014G","E01008443",611,158,91,67,436,88,263,117,93,53,53,26,19,8,32,16,16,0,0,17,5,12
"2021","Newcastle upon Tyne 015A","E01008324",541,184,93,91,330,39,121,47,47,27,58,20,30,8,107,79,28,5,5,27,10,17
"2021","Newcastle upon Tyne 015B","E01008325",625,248,129,119,349,47,144,36,68,40,56,17,35,4,100,60,40,2,2,28,11,17
"2021","Newcastle upon Tyne 015C","E01008326",581,159,87,72,401,53,221,86,89,46,63,29,27,7,62,32,30,2,2,21,12,9
"2021","Newcastle upon Tyne 015D","E01008327",558,227,103,124,308,28,96,41,39,16,77,41,30,6,105,72,33,2,2,23,9,14
"2021","Newcastle upon Tyne 015E","E01008328",558,178,129,49,369,117,170,54,67,49,44,26,16,2,37,18,19,1,1,11,3,8
"2021","Newcastle upon Tyne 015F","E01008329",619,165,68,97,423,58,179,75,68,36,95,41,46,8,88,57,31,3,3,31,13,18
"2021","Newcastle upon Tyne 015G","E01008330",652,222,70,152,413,39,130,49,51,30,102,44,50,8,136,106,30,6,6,17,7,10
"2021","Newcastle upon Tyne 016A","E01008300",821,244,90,154,516,27,229,61,133,35,119,65,48,6,132,91,41,9,9,61,35,26
"2021","Newcastle upon Tyne 016B","E01008450",637,141,62,79,455,24,218,46,137,35,68,22,35,11,141,93,48,4,4,41,26,15
"2021","Newcastle upon Tyne 016C","E01008451",877,324,89,235,503,37,208,64,116,28,87,57,28,2,162,125,37,9,9,50,20,30
"2021","Newcastle upon Tyne 016D","E01008452",501,106,62,44,341,53,206,52,102,52,36,20,16,0,43,19,24,3,3,54,27,27
"2021","Newcastle upon Tyne 017A","E01008367",784,262,59,203,236,30,97,49,37,11,98,88,10,0,5,2,3,6,6,286,5,281
"2021","Newcastle upon Tyne 017B","E01008368",532,112,28,84,174,32,73,29,35,9,55,46,8,1,8,5,3,6,6,246,7,239
"2021","Newcastle upon Tyne 017C","E01008370",832,350,138,212,313,57,127,54,48,25,103,97,5,1,17,10,7,9,9,169,5,164
"2021","Newcastle upon Tyne 017D","E01008409",688,249,104,145,274,24,108,48,48,12,115,97,18,0,20,9,11,7,7,165,1,164
"2021","Newcastle upon Tyne 017E","E01008411",719,261,66,195,186,14,50,22,24,4,91,88,3,0,22,7,15,9,9,272,4,268
"2021","Newcastle upon Tyne 018A","E01008303",992,583,185,398,323,26,98,39,36,23,84,59,23,2,104,60,44,11,11,86,10,76
"2021","Newcastle upon Tyne 018B","E01008359",561,162,27,135,224,6,90,36,38,16,78,67,10,1,40,25,15,10,10,175,11,164
"2021","Newcastle upon Tyne 018C","E01008360",774,288,37,251,337,14,90,46,37,7,185,167,17,1,35,24,11,13,13,149,6,143
"2021","Newcastle upon Tyne 018D","E01008361",675,201,24,177,324,11,108,48,48,12,145,133,10,2,52,33,19,8,8,150,10,140
"2021","Newcastle upon Tyne 018E","E01008362",686,236,49,187,239,6,61,27,24,10,110,97,12,1,48,31,17,14,14,211,1,210
"2021","Newcastle upon Tyne 018F","E01008364",685,229,42,187,294,14,97,35,52,10,142,120,21,1,29,17,12,12,12,162,8,154
"2021","Newcastle upon Tyne 019A","E01008343",629,159,88,71,437,59,231,64,118,49,64,19,37,8,80,50,30,3,3,33,14,19
"2021","Newcastle upon Tyne 019B","E01008344",695,273,120,153,392,52,178,62,77,39,75,36,32,7,85,50,35,2,2,30,15,15
"2021","Newcastle upon Tyne 019C","E01008345",822,386,153,233,408,44,122,51,37,34,88,47,34,7,148,103,45,6,6,28,7,21
"2021","Newcastle upon Tyne 019D","E01008346",467,176,59,117,268,14,126,46,56,24,55,32,18,5,72,40,32,1,1,23,12,11
"2021","Newcastle upon Tyne 019E","E01008347",541,141,65,76,360,44,214,52,106,56,53,27,22,4,46,20,26,3,3,40,19,21
"2021","Newcastle upon Tyne 019F","E01008348",416,93,46,47,294,22,144,30,78,36,41,9,25,7,83,48,35,4,4,29,14,15
"2021","Newcastle upon Tyne 019G","E01008349",469,71,31,40,326,21,229,21,162,46,23,8,12,3,50,31,19,3,3,72,49,23
"2021","Newcastle upon Tyne 019H","E01008350",716,206,93,113,485,32,216,77,96,43,100,59,33,8,132,73,59,5,5,25,12,13
"2021","Newcastle upon Tyne 020A","E01008430",607,227,62,165,361,43,161,68,55,38,74,49,20,5,81,53,28,2,2,19,8,11
"2021","Newcastle upon Tyne 020B","E01008431",719,276,82,194,418,64,197,70,73,54,95,43,45,7,58,32,26,4,4,25,11,14
"2021","Newcastle upon Tyne 020C","E01008433",631,203,143,60,405,95,213,91,65,57,56,28,23,5,39,25,14,2,2,23,8,15
"2021","Newcastle upon Tyne 020D","E01008434",595,160,105,55,410,80,236,86,79,71,49,17,27,5,43,24,19,2,2,25,10,15
"2021","Newcastle upon Tyne 020E","E01008435",691,175,62,113,488,49,162,60,54,48,88,34,42,12,186,142,44,3,3,28,16,12
"2021","Newcastle upon Tyne 020F","E01008436",784,355,104,251,387,63,142,59,54,29,82,42,33,7,96,58,38,4,4,42,14,28
"2021","Newcastle upon Tyne 021A","E01008381",702,262,85,177,425,78,216,93,95,28,81,50,27,4,49,35,14,1,1,15,6,9
"2021","Newcastle upon Tyne 021B","E01008382",495,132,59,73,341,35,127,36,63,28,60,21,32,7,116,80,36,3,3,22,8,14
"2021","Newcastle upon Tyne 021C","E01008383",652,230,79,151,408,50,120,38,52,30,98,41,50,7,135,95,40,5,5,14,11,3
"2021","Newcastle upon Tyne 021D","E01008384",589,179,81,98,387,68,163,57,66,40,67,28,34,5,82,53,29,7,7,23,14,9
"2021","Newcastle upon Tyne 021E","E01008385",680,281,100,181,376,33,135,51,53,31,85,54,30,1,115,81,34,8,8,23,9,14
"2021","Newcastle upon Tyne 021F","E01008386",564,147,81,66,401,82,177,66,75,36,64,32,27,5,77,44,33,1,1,16,7,9
"2021","Newcastle upon Tyne 021G","E01008387",601,201,87,114,382,79,173,73,63,37,77,44,28,5,52,31,21,1,1,18,5,13
"2021","Newcastle upon Tyne 022B","E01008396",638,187,27,160,346,3,172,32,128,12,61,31,27,3,97,40,57,13,13,105,38,67
"2021","Newcastle upon Tyne 022C","E01008398",831,380,55,325,379,8,183,47,112,24,64,26,36,2,101,66,35,23,23,72,21,51
"2021","Newcastle upon Tyne 022D","E01008449",614,165,18,147,304,3,170,25,136,9,48,39,8,1,57,27,30,26,26,145,22,123
"2021","Newcastle upon Tyne 022E","E01008453",609,128,65,63,403,40,258,68,153,37,62,38,18,6,36,18,18,7,7,78,51,27
"2021","Newcastle upon Tyne 022G","E01008455",513,133,45,88,281,9,188,23,136,29,27,15,11,1,45,34,11,12,12,99,59,40
"2021","Newcastle upon Tyne 022H","E01033556",883,294,72,222,343,18,170,53,104,13,94,75,14,5,45,28,17,16,16,246,47,199
"2021","Newcastle upon Tyne 025B","E01008415",556,194,61,133,338,30,144,48,71,25,70,32,31,7,91,65,26,3,3,24,12,12
"2021","Newcastle upon Tyne 025C","E01008416",732,207,83,124,492,69,245,88,112,45,108,43,43,22,65,34,31,5,5,33,15,18
"2021","Newcastle upon Tyne 025E","E01033547",1166,422,168,254,675,47,262,100,127,35,172,94,70,8,190,141,49,4,4,69,34,35
"2021","Newcastle upon Tyne 027A","E01008288",627,231,95,136,367,34,182,79,70,33,64,39,21,4,78,53,25,9,9,29,12,17
"2021","Newcastle upon Tyne 027B","E01008289",646,181,88,93,413,49,155,48,77,30,57,18,32,7,147,110,37,5,5,52,25,27
"2021","Newcastle upon Tyne 027C","E01008290",703,225,52,173,429,26,194,42,115,37,91,45,41,5,111,74,37,7,7,49,22,27
"2021","Newcastle upon Tyne 027D","E01008291",886,355,107,248,476,15,177,32,123,22,62,20,39,3,207,162,45,15,15,55,35,20
"2021","Newcastle upon Tyne 027E","E01008292",550,161,77,84,370,58,193,82,62,49,70,42,24,4,47,28,19,2,2,19,7,12
"2021","Newcastle upon Tyne 028A","E01008388",804,275,95,180,502,19,154,37,69,48,120,50,50,20,198,141,57,11,11,27,12,15
"2021","Newcastle upon Tyne 028B","E01008389",785,302,100,202,448,27,165,63,62,40,64,25,34,5,186,142,44,6,6,35,21,14
"2021","Newcastle upon Tyne 028C","E01008426",642,178,69,109,431,31,138,40,53,45,71,11,43,17,180,121,59,11,11,33,16,17
"2021","Newcastle upon Tyne 028D","E01008429",656,248,106,142,382,45,122,30,53,39,70,25,39,6,138,95,43,7,7,26,10,16
"2021","Newcastle upon Tyne 030A","E01008390",830,295,82,213,492,30,157,42,87,28,88,24,48,16,214,158,56,3,3,43,23,20
"2021","Newcastle upon Tyne 030B","E01008425",757,406,151,255,320,40,111,41,42,28,66,33,21,12,94,55,39,9,9,31,8,23
"2021","Newcastle upon Tyne 030C","E01008427",620,256,71,185,325,18,94,28,37,29,66,25,33,8,139,100,39,8,8,39,15,24
"2021","Newcastle upon Tyne 030D","E01008428",661,249,113,136,386,51,150,44,62,44,52,23,22,7,129,93,36,4,4,26,13,13
"2021","Newcastle upon Tyne 031A","E01008441",838,285,146,139,526,52,185,72,67,46,155,60,87,8,129,74,55,5,5,27,12,15
"2021","Newcastle upon Tyne 031B","E01008442",606,191,134,57,404,123,192,71,79,42,42,25,16,1,45,25,20,2,2,11,6,5
"2021","Newcastle upon Tyne 031C","E01008444",720,199,112,87,508,134,231,78,87,66,83,42,38,3,58,31,27,2,2,13,4,9
"2021","Newcastle upon Tyne 031D","E01008445",871,257,107,150,576,73,266,87,114,65,126,49,69,8,107,55,52,4,4,38,14,24
"2021","Newcastle upon Tyne 031E","E01008446",636,187,149,38,431,133,217,91,78,48,46,27,14,5,32,11,21,3,3,18,5,13
"2021","Newcastle upon Tyne 031F","E01008447",634,232,171,61,388,120,194,65,74,55,31,16,12,3,41,18,23,2,2,14,5,9
"2021","Newcastle upon Tyne 031G","E01008448",629,169,94,75,448,147,241,98,88,55,39,25,13,1,21,7,14,0,0,12,7,5
"2021","Newcastle upon Tyne 032A","E01008306",1062,307,157,150,713,130,326,115,145,66,148,90,54,4,105,65,40,4,4,42,13,29
"2021","Newcastle upon Tyne 032B","E01008307",643,259,106,153,370,26,150,54,68,28,116,87,22,7,78,52,26,0,0,14,5,9
"2021","Newcastle upon Tyne 032C","E01035613",645,226,86,140,394,28,201,56,114,31,91,60,29,2,68,36,32,6,6,25,10,15
"2021","Newcastle upon Tyne 032D","E01035614",607,95,10,85,476,10,315,60,234,21,107,69,37,1,42,38,4,2,2,36,21,15
"2021","Newcastle upon Tyne 032E","E01035615",580,123,5,118,430,7,249,56,182,11,124,79,43,2,47,43,4,3,3,27,12,15
"2021","Newcastle upon Tyne 032F","E01035616",594,147,33,114,427,4,244,52,177,15,114,79,35,0,62,57,5,3,3,20,8,12
"2021","Newcastle upon Tyne 033D","E01008294",607,204,90,114,383,55,202,80,78,44,80,50,21,9,42,27,15,4,4,20,7,13
"2021","Newcastle upon Tyne 033A","E01008311",874,196,74,122,637,76,392,124,214,54,96,58,31,7,70,39,31,3,3,41,21,20
"2021","Newcastle upon Tyne 033B","E01008312",495,128,53,75,349,58,185,63,86,36,57,33,22,2,47,23,24,2,2,18,8,10
"2021","Newcastle upon Tyne 033C","E01008313",470,99,42,57,347,60,180,53,82,45,60,38,20,2,46,24,22,1,1,24,8,16
"2021","Newcastle upon Tyne 034D","E01008407",837,312,64,248,234,16,77,30,34,13,70,64,6,0,48,26,22,23,23,291,5,286
"2021","Newcastle upon Tyne 034B","E01008410",686,250,96,154,247,27,83,37,35,11,90,71,17,2,37,28,9,10,10,189,8,181
"2021","Newcastle upon Tyne 034A","E01008412",619,171,39,132,286,17,110,39,64,7,125,101,23,1,32,17,15,2,2,162,4,158
"2021","Newcastle upon Tyne 034C","E01008413",606,228,41,187,203,6,59,26,28,5,86,71,12,3,41,28,13,11,11,175,7,168
"2021","Newcastle upon Tyne 035D","E01008302",742,334,88,246,349,41,116,40,54,22,68,32,28,8,116,75,41,8,8,59,21,38
"2021","Newcastle upon Tyne 035C","E01008391",610,154,47,107,417,29,132,51,53,28,78,13,56,9,171,107,64,7,7,39,18,21
"2021","Newcastle upon Tyne 035A","E01008392",966,469,127,342,441,36,151,65,57,29,119,74,38,7,120,81,39,15,15,56,12,44
"2021","Newcastle upon Tyne 035B","E01008432",681,246,103,143,394,66,167,67,55,45,96,51,37,8,60,36,24,5,5,41,11,30
"2021","Newcastle upon Tyne 036B","E01008397",584,306,25,281,126,3,42,22,16,4,58,58,0,0,8,4,4,15,15,152,3,149
"2021","Newcastle upon Tyne 036C","E01033543",836,500,9,491,211,2,65,49,16,0,113,111,2,0,8,6,2,23,23,125,0,125
"2021","Newcastle upon Tyne 036D","E01033545",955,472,30,442,335,3,138,106,32,0,149,148,1,0,20,12,8,25,25,148,2,146
"2021","Newcastle upon Tyne 036A","E01035617",895,480,175,305,328,35,118,49,56,13,79,72,7,0,75,31,44,21,21,87,7,80
"2021","Newcastle upon Tyne 037A","E01008406",729,378,100,278,244,18,82,29,39,14,71,62,8,1,62,36,26,11,11,107,7,100
"2021","Newcastle upon Tyne 037C","E01033548",660,329,58,271,280,23,90,47,34,9,103,94,8,1,49,29,20,15,15,51,5,46
"2021","Newcastle upon Tyne 037B","E01033553",639,348,33,315,141,2,38,22,15,1,72,69,3,0,18,9,9,11,11,150,1,149
"2021","Newcastle upon Tyne 038E","E01008333",540,123,32,91,326,14,218,27,166,25,30,16,11,3,55,29,26,9,9,91,47,44
"2021","Newcastle upon Tyne 038A","E01008334",865,280,66,214,506,31,268,65,175,28,64,30,33,1,127,92,35,16,16,79,50,29
"2021","Newcastle upon Tyne 038D","E01008335",693,177,36,141,428,19,275,47,193,35,45,15,30,0,75,44,31,14,14,88,42,46
"2021","Newcastle upon Tyne 038B","E01035618",448,104,9,95,286,3,141,19,107,15,71,12,57,2,63,50,13,8,8,58,41,17
"2021","Newcastle upon Tyne 038C","E01035619",601,233,65,168,330,9,146,24,109,13,69,16,52,1,97,70,27,9,9,38,23,15
"2021","Newcastle upon Tyne 039A","E01008399",787,308,115,193,416,13,214,26,129,59,56,27,24,5,117,69,48,16,16,63,30,33
"2021","Newcastle upon Tyne 039D","E01008439",760,369,94,275,338,20,138,34,90,14,49,24,22,3,107,70,37,24,24,53,30,23
"2021","Newcastle upon Tyne 039B","E01035620",461,251,21,230,97,1,24,11,8,5,60,60,0,0,4,4,0,8,8,113,3,110
"2021","Newcastle upon Tyne 039C","E01035621",490,221,53,168,175,13,67,34,23,10,68,55,12,1,15,6,9,12,12,94,1,93
"2021","Newcastle upon Tyne 040D","E01008301",883,396,78,318,425,28,151,87,34,30,141,100,36,5,99,66,33,6,6,62,12,50
"2021","Newcastle upon Tyne 040C","E01008305",945,341,92,249,530,29,156,31,100,25,125,46,75,4,205,144,61,15,15,74,35,39
"2021","Newcastle upon Tyne 040A","E01035622",655,357,80,277,223,10,62,27,26,9,46,27,17,2,99,74,25,6,6,75,4,71
"2021","Newcastle upon Tyne 040B","E01035623",565,273,50,223,249,8,66,32,25,9,84,60,21,3,82,60,22,9,9,43,8,35
"2021","Newcastle upon Tyne 041A","E01008331",594,137,25,112,353,6,190,25,120,45,37,22,12,3,109,69,40,11,11,104,45,59
"2021","Newcastle upon Tyne 041C","E01008437",624,264,74,190,327,13,149,23,107,19,48,18,22,8,112,83,29,5,5,33,16,17
"2021","Newcastle upon Tyne 041B","E01008438",950,491,112,379,389,18,174,58,89,27,65,40,19,6,124,58,66,8,8,70,19,51
"2021","North Tyneside 001A","E01008547",599,157,110,47,428,143,211,54,110,47,38,15,18,5,36,19,17,0,0,14,9,5
"2021","North Tyneside 001B","E01008548",716,133,90,43,563,152,343,115,176,52,40,13,23,4,28,12,16,0,0,20,6,14
"2021","North Tyneside 001C","E01008549",679,214,155,59,453,121,238,68,136,34,45,20,22,3,48,30,18,1,1,12,6,6
"2021","North Tyneside 001D","E01008551",612,158,124,34,440,147,237,70,118,49,33,12,16,5,23,8,15,0,0,14,7,7
"2021","North Tyneside 002A","E01008478",770,347,135,212,410,53,169,76,52,41,80,41,33,6,106,69,37,2,2,13,4,9
"2021","North Tyneside 002B","E01008480",730,302,143,159,406,67,175,85,61,29,72,36,35,1,85,53,32,7,7,22,12,10
"2021","North Tyneside 002C","E01008504",679,174,101,73,490,128,261,107,87,67,53,26,23,4,47,18,29,1,1,15,7,8
"2021","North Tyneside 002D","E01008578",609,203,81,122,392,73,185,67,64,54,62,31,25,6,65,40,25,7,7,14,7,7
"2021","North Tyneside 002E","E01008583",649,208,77,131,422,32,200,83,69,48,97,40,53,4,89,69,20,4,4,19,8,11
"2021","North Tyneside 003A","E01008520",594,188,113,75,385,69,231,74,122,35,46,16,25,5,36,23,13,3,3,21,12,9
"2021","North Tyneside 003B","E01008523",486,77,52,25,398,83,256,69,144,43,29,11,17,1,30,14,16,0,0,11,7,4
"2021","North Tyneside 003C","E01008546",606,110,87,23,480,106,302,87,178,37,47,18,26,3,25,13,12,0,0,16,11,5
"2021","North Tyneside 003D","E01008550",615,139,75,64,455,66,276,69,172,35,64,29,33,2,49,28,21,0,0,21,4,17
"2021","North Tyneside 004A","E01008577",899,309,145,164,580,92,259,91,130,38,125,73,49,3,99,64,35,5,5,10,7,3
"2021","North Tyneside 004B","E01008579",716,284,210,74,425,137,196,92,70,34,46,25,18,3,45,21,24,1,1,7,3,4
"2021","North Tyneside 004C","E01008580",596,191,102,89,383,75,195,82,77,36,72,42,28,2,40,21,19,1,1,22,7,15
"2021","North Tyneside 004D","E01008581",885,318,216,102,551,147,271,106,121,44,84,53,30,1,49,27,22,0,0,16,7,9
"2021","North Tyneside 004E","E01008582",659,261,109,152,383,48,167,66,64,37,76,41,33,2,89,60,29,3,3,15,11,4
"2021","North Tyneside 005A","E01008517",607,110,74,36,481,91,290,77,170,43,48,25,20,3,52,28,24,0,0,16,7,9
"2021","North Tyneside 005B","E01008519",651,281,137,144,364,80,170,80,54,36,49,33,12,4,65,43,22,0,0,6,4,2
"2021","North Tyneside 005C","E01008521",680,244,149,95,423,93,202,79,80,43,70,45,24,1,56,28,28,2,2,13,4,9
"2021","North Tyneside 005D","E01008522",668,174,100,74,483,97,273,99,122,52,59,31,22,6,54,32,22,0,0,11,5,6
"2021","North Tyneside 006A","E01008584",721,286,69,217,392,27,178,64,89,25,104,65,32,7,80,51,29,3,3,43,12,31
"2021","North Tyneside 006B","E01008585",634,193,74,119,420,48,224,60,127,37,75,43,28,4,73,48,25,0,0,21,8,13
"2021","North Tyneside 006C","E01008587",636,270,131,139,343,44,173,65,86,22,69,44,23,2,53,29,24,4,4,23,11,12
"2021","North Tyneside 006D","E01008588",699,264,84,180,402,38,206,61,119,26,93,59,29,5,63,34,29,2,2,33,13,20
"2021","North Tyneside 006E","E01008589",588,120,79,41,453,80,302,91,147,64,44,26,16,2,27,14,13,0,0,15,5,10
"2021","North Tyneside 007A","E01008518",754,291,129,162,443,80,230,92,103,35,79,49,30,0,51,25,26,3,3,20,7,13
"2021","North Tyneside 007B","E01008564",658,195,121,74,450,74,239,103,95,41,84,52,26,6,53,30,23,0,0,13,3,10
"2021","North Tyneside 007D","E01008567",679,232,81,151,422,33,162,59,69,34,91,39,45,7,133,91,42,3,3,25,11,14
"2021","North Tyneside 007E","E01035625",773,185,63,122,566,45,252,110,114,28,145,86,51,8,123,94,29,1,1,22,9,13
"2021","North Tyneside 007F","E01035626",819,257,66,191,546,33,275,83,164,28,154,95,52,7,84,64,20,0,0,16,11,5
"2021","North Tyneside 008A","E01008475",686,167,69,98,507,71,262,96,116,50,99,58,36,5,73,51,22,2,2,12,6,6
"2021","North Tyneside 008B","E01008476",853,322,149,173,511,53,170,74,60,36,124,66,49,9,159,106,53,5,5,20,9,11
"2021","North Tyneside 008C","E01008477",767,234,103,131,502,37,187,64,79,44,122,58,58,6,154,124,30,2,2,31,14,17
"2021","North Tyneside 008D","E01008479",734,255,112,143,463,93,237,100,99,38,78,49,25,4,54,30,24,1,1,16,6,10
"2021","North Tyneside 009A","E01008552",742,228,110,118,490,105,232,88,98,46,84,49,28,7,63,34,29,6,6,24,7,17
"2021","North Tyneside 009B","E01008553",842,338,179,159,487,70,232,89,109,34,104,58,41,5,81,48,33,0,0,17,3,14
"2021","North Tyneside 009C","E01008554",679,181,75,106,469,59,231,77,105,49,72,33,32,7,102,60,42,5,5,29,15,14
"2021","North Tyneside 009D","E01008555",695,194,104,90,471,48,215,64,106,45,85,36,44,5,118,86,32,5,5,30,20,10
"2021","North Tyneside 009E","E01008586",668,244,142,102,404,52,221,70,126,25,69,35,34,0,62,37,25,0,0,20,8,12
"2021","North Tyneside 010A","E01008495",735,184,125,59,532,125,312,96,159,57,50,27,22,1,45,18,27,0,0,19,9,10
"2021","North Tyneside 010B","E01008496",775,369,184,185,379,55,172,65,89,18,85,53,30,2,63,31,32,4,4,27,12,15
"2021","North Tyneside 010C","E01008497",650,175,128,47,463,113,263,90,120,53,64,30,30,4,23,9,14,0,0,12,1,11
"2021","North Tyneside 010D","E01008498",734,254,197,57,457,147,220,96,82,42,56,29,24,3,34,12,22,0,0,23,13,10
"2021","North Tyneside 011B","E01008568",675,202,124,78,454,94,172,72,56,44,91,36,48,7,93,48,45,4,4,19,7,12
"2021","North Tyneside 011C","E01008569",684,249,123,126,418,56,173,71,75,27,78,33,35,10,109,66,43,2,2,17,9,8
"2021","North Tyneside 011D","E01008570",608,209,68,141,386,42,200,82,89,29,82,51,31,0,62,46,16,0,0,13,4,9
"2021","North Tyneside 011E","E01032647",1085,170,24,146,883,37,537,159,330,48,205,119,78,8,99,79,20,5,5,32,21,11
"2021","North Tyneside 011F","E01032648",665,226,81,145,416,19,184,57,102,25,84,49,30,5,129,90,39,0,0,23,10,13
"2021","North Tyneside 012A","E01008500",722,250,124,126,453,77,227,99,82,46,87,60,21,6,58,38,20,4,4,19,7,12
"2021","North Tyneside 012B","E01008505",883,377,145,232,484,96,233,89,113,31,94,48,42,4,58,43,15,3,3,22,10,12
"2021","North Tyneside 012C","E01008506",609,193,115,78,400,73,152,53,65,34,75,23,44,8,97,67,30,3,3,16,10,6
"2021","North Tyneside 012D","E01008507",739,193,95,98,529,87,300,124,111,65,80,40,38,2,61,35,26,1,1,17,9,8
"2021","North Tyneside 013A","E01008493",620,138,89,49,464,102,233,64,125,44,75,34,38,3,52,29,23,2,2,18,9,9
"2021","North Tyneside 013B","E01008494",751,268,135,133,460,92,198,67,98,33,83,44,32,7,85,47,38,2,2,23,11,12
"2021","North Tyneside 013C","E01008556",853,253,168,85,573,107,295,101,140,54,90,37,45,8,81,41,40,0,0,27,13,14
"2021","North Tyneside 013D","E01008557",654,124,83,41,498,106,302,116,114,72,58,29,23,6,32,19,13,0,0,32,18,14
"2021","North Tyneside 014A","E01008470",710,271,110,161,416,63,147,63,49,35,93,63,29,1,110,70,40,3,3,23,10,13
"2021","North Tyneside 014B","E01008499",737,221,108,113,492,53,214,78,88,48,105,57,40,8,115,68,47,5,5,24,5,19
"2021","North Tyneside 014C","E01008502",705,221,108,113,460,49,187,85,72,30,99,48,47,4,123,80,43,2,2,24,10,14
"2021","North Tyneside 014D","E01008516",859,220,111,109,621,97,349,112,186,51,125,71,50,4,47,26,21,3,3,18,8,10
"2021","North Tyneside 015A","E01008488",670,223,104,119,424,60,151,56,58,37,70,35,25,10,140,105,35,3,3,23,10,13
"2021","North Tyneside 015B","E01008489",784,249,130,119,500,41,185,54,94,37,90,28,56,6,179,139,40,5,5,35,17,18
"2021","North Tyneside 015C","E01008490",779,322,130,192,441,86,198,74,77,47,86,51,28,7,69,44,25,2,2,16,9,7
"2021","North Tyneside 015D","E01008491",619,167,66,101,420,43,153,49,68,36,72,19,47,6,148,112,36,4,4,32,21,11
"2021","North Tyneside 016A","E01008558",814,400,192,208,401,79,184,90,75,19,74,61,10,3,64,40,24,0,0,13,1,12
"2021","North Tyneside 016B","E01008560",816,334,123,211,459,84,226,95,108,23,104,75,23,6,44,23,21,1,1,23,5,18
"2021","North Tyneside 016C","E01008561",906,430,161,269,456,70,166,81,67,18,114,76,32,6,98,59,39,8,8,20,8,12
"2021","North Tyneside 016D","E01008562",628,191,97,94,416,90,228,65,118,45,47,32,13,2,50,27,23,1,1,21,12,9
"2021","North Tyneside 017A","E01008525",726,282,155,127,430,88,204,83,85,36,84,56,20,8,54,33,21,0,0,14,3,11
"2021","North Tyneside 017B","E01008527",717,294,93,201,411,67,198,89,71,38,87,60,24,3,56,38,18,3,3,12,4,8
"2021","North Tyneside 017C","E01008559",761,316,97,219,422,37,184,82,77,25,131,90,37,4,65,46,19,5,5,23,7,16
"2021","North Tyneside 017D","E01008563",583,117,82,35,458,124,277,112,126,39,33,17,13,3,24,11,13,0,0,8,3,5
"2021","North Tyneside 018A","E01008469",923,357,130,227,542,95,267,109,113,45,93,60,29,4,85,47,38,2,2,24,10,14
"2021","North Tyneside 018B","E01008472",665,205,142,63,442,103,234,98,100,36,60,29,25,6,42,23,19,3,3,18,5,13
"2021","North Tyneside 018C","E01008473",529,151,74,77,357,72,195,77,83,35,63,41,19,3,27,14,13,0,0,21,11,10
"2021","North Tyneside 018E","E01008503",926,346,145,201,551,66,230,98,98,34,122,70,43,9,128,90,38,5,5,29,13,16
"2021","North Tyneside 018F","E01035627",645,129,45,84,493,37,303,105,148,50,96,48,40,8,56,33,23,1,1,23,12,11
"2021","North Tyneside 018G","E01035628",616,83,15,68,516,18,302,78,197,27,143,85,57,1,51,42,9,2,2,17,10,7
"2021","North Tyneside 019A","E01008471",655,189,100,89,445,50,211,72,92,47,86,41,37,8,90,64,26,8,8,21,8,13
"2021","North Tyneside 019B","E01008474",628,173,61,112,415,31,164,59,73,32,102,45,50,7,112,67,45,6,6,40,22,18
"2021","North Tyneside 019C","E01008513",1091,419,159,260,636,41,262,105,125,32,200,144,49,7,123,82,41,10,10,36,11,25
"2021","North Tyneside 019D","E01008514",820,268,119,149,527,54,240,86,115,39,112,65,37,10,118,71,47,3,3,25,10,15
"2021","North Tyneside 019F","E01032649",610,291,78,213,300,19,109,57,44,8,98,72,26,0,64,47,17,10,10,19,3,16
"2021","North Tyneside 019G","E01032650",568,265,58,207,290,16,98,42,38,18,87,54,29,4,82,55,27,7,7,13,3,10
"2021","North Tyneside 020A","E01008486",669,242,120,122,409,53,154,75,45,34,83,38,39,6,114,75,39,5,5,18,5,13
"2021","North Tyneside 020B","E01008487",678,230,83,147,426,70,176,71,63,42,75,35,34,6,102,67,35,3,3,22,8,14
"2021","North Tyneside 020C","E01008526",632,149,72,77,464,106,259,106,102,51,57,37,14,6,40,22,18,2,2,19,11,8
"2021","North Tyneside 020D","E01008530",772,290,167,123,456,93,219,103,73,43,71,36,31,4,69,35,34,4,4,26,11,15
"2021","North Tyneside 021A","E01008461",620,205,83,122,397,76,143,45,64,34,68,22,42,4,107,89,18,3,3,18,9,9
"2021","North Tyneside 021B","E01008466",608,153,82,71,439,105,262,108,94,60,44,24,18,2,28,17,11,0,0,16,6,10
"2021","North Tyneside 021C","E01008467",636,221,89,132,400,53,217,92,87,38,70,29,38,3,57,34,23,3,3,15,7,8
"2021","North Tyneside 021D","E01008468",685,246,90,156,425,32,191,62,86,43,75,35,34,6,124,80,44,3,3,14,7,7
"2021","North Tyneside 022A","E01008483",737,319,69,250,389,36,152,63,65,24,108,67,36,5,90,59,31,3,3,29,10,19
"2021","North Tyneside 022B","E01008524",1231,806,270,536,392,66,140,78,42,20,95,78,14,3,78,46,32,13,13,33,7,26
"2021","North Tyneside 022C","E01008528",648,241,67,174,386,41,178,69,74,35,101,65,34,2,62,37,25,4,4,21,3,18
"2021","North Tyneside 022D","E01008529",733,280,118,162,435,71,204,85,95,24,99,73,22,4,57,34,23,4,4,18,4,14
"2021","North Tyneside 023A","E01008481",619,193,67,126,398,41,153,54,55,44,70,28,33,9,131,87,44,3,3,28,11,17
"2021","North Tyneside 023B","E01008482",808,364,105,259,417,35,134,59,49,26,108,55,46,7,137,100,37,3,3,27,10,17
"2021","North Tyneside 023C","E01008484",673,240,64,176,401,26,121,44,52,25,98,48,44,6,146,108,38,10,10,32,19,13
"2021","North Tyneside 023D","E01008485",626,231,54,177,365,9,102,39,47,16,66,14,42,10,184,155,29,4,4,30,15,15
"2021","North Tyneside 023E","E01008492",748,255,99,156,465,36,173,68,62,43,102,47,44,11,148,108,40,6,6,28,18,10
"2021","North Tyneside 024A","E01008462",706,282,139,143,394,47,161,53,79,29,79,36,36,7,103,74,29,4,4,30,15,15
"2021","North Tyneside 024B","E01008463",587,189,80,109,373,61,164,69,55,40,59,27,25,7,88,56,32,1,1,25,15,10
"2021","North Tyneside 024C","E01008464",644,229,99,130,404,92,178,89,60,29,74,40,25,9,59,38,21,1,1,11,4,7
"2021","North Tyneside 024D","E01008465",649,193,107,86,443,103,180,74,62,44,82,47,27,8,73,45,28,5,5,13,4,9
"2021","North Tyneside 025A","E01008531",628,216,79,137,402,76,235,118,66,51,59,35,21,3,32,16,16,0,0,10,6,4
"2021","North Tyneside 025B","E01008532",769,246,112,134,499,45,192,75,76,41,121,69,47,5,137,98,39,4,4,24,13,11
"2021","North Tyneside 025C","E01008534",599,189,95,94,400,103,184,92,43,49,71,41,24,6,42,25,17,0,0,10,6,4
"2021","North Tyneside 025D","E01008538",1076,280,64,216,763,49,362,134,166,62,224,124,95,5,123,93,30,5,5,33,20,13
"2021","North Tyneside 026A","E01008508",634,159,83,76,451,48,188,62,79,47,97,32,50,15,115,75,40,3,3,24,13,11
"2021","North Tyneside 026B","E01008509",803,315,110,205,458,44,170,66,66,38,101,43,49,9,137,99,38,6,6,30,12,18
"2021","North Tyneside 026C","E01008510",759,296,118,178,442,68,167,65,53,49,101,57,41,3,97,61,36,9,9,21,10,11
"2021","North Tyneside 026D","E01008512",808,351,142,209,421,50,161,73,48,40,101,46,45,10,104,72,32,5,5,36,11,25
"2021","North Tyneside 027A","E01008539",802,332,88,244,453,66,213,108,64,41,109,78,22,9,63,40,23,2,2,17,5,12
"2021","North Tyneside 027B","E01008540",752,278,65,213,437,38,148,53,69,26,80,30,46,4,161,122,39,10,10,37,18,19
"2021","North Tyneside 027C","E01008541",783,371,151,220,387,42,154,74,50,30,80,39,35,6,105,69,36,6,6,25,14,11
"2021","North Tyneside 027D","E01008544",901,538,107,431,335,26,127,59,50,18,83,55,26,2,93,74,19,6,6,28,10,18
"2021","North Tyneside 027E","E01008545",625,315,80,235,284,30,103,44,40,19,63,38,18,7,85,63,22,3,3,26,8,18
"2021","North Tyneside 028A","E01008511",807,325,103,222,459,42,176,80,63,33,85,30,52,3,142,106,36,14,14,23,13,10
"2021","North Tyneside 028B","E01008542",768,267,126,141,478,34,157,66,68,23,97,36,55,6,185,147,38,5,5,23,13,10
"2021","North Tyneside 028C","E01008543",1060,346,69,277,651,19,286,99,138,49,178,93,71,14,156,121,35,12,12,63,20,43
"2021","North Tyneside 028D","E01008571",895,382,177,205,485,67,187,78,77,32,109,58,48,3,118,80,38,4,4,28,13,15
"2021","North Tyneside 029A","E01008572",903,489,91,398,389,27,120,51,50,19,125,84,37,4,102,71,31,15,15,25,6,19
"2021","North Tyneside 029B","E01008573",871,452,79,373,387,19,128,56,54,18,95,64,28,3,130,95,35,15,15,32,13,19
"2021","North Tyneside 029C","E01008574",844,240,104,136,586,90,290,92,139,59,134,70,56,8,70,43,27,2,2,18,5,13
"2021","North Tyneside 029D","E01008576",818,222,72,150,557,37,256,72,126,58,127,62,56,9,131,86,45,6,6,39,20,19
"2021","North Tyneside 030A","E01008533",644,197,111,86,416,44,165,54,66,45,93,46,40,7,110,71,39,4,4,31,16,15
"2021","North Tyneside 030B","E01008535",658,209,93,116,434,81,206,89,63,54,86,59,21,6,59,30,29,2,2,15,5,10
"2021","North Tyneside 030C","E01008536",725,325,80,245,371,29,148,53,70,25,107,64,38,5,82,55,27,5,5,29,10,19
"2021","North Tyneside 030D","E01008537",614,291,116,175,312,26,124,59,43,22,62,38,21,3,96,54,42,4,4,11,5,6
"2021","North Tyneside 030E","E01008575",713,353,108,245,329,18,112,45,43,24,86,60,23,3,104,78,26,9,9,31,11,20
"2021","South Tyneside 001A","E01008595",768,352,103,249,395,47,135,70,42,23,117,79,29,9,90,59,31,6,6,21,2,19
"2021","South Tyneside 001B","E01008596",511,193,76,117,280,11,162,25,111,26,29,15,12,2,74,42,32,4,4,38,27,11
"2021","South Tyneside 001C","E01008597",1072,390,114,276,650,85,343,137,147,59,115,75,28,12,101,61,40,6,6,32,13,19
"2021","South Tyneside 001D","E01008598",617,265,82,183,294,32,152,47,80,25,46,25,19,2,59,33,26,5,5,58,31,27
"2021","South Tyneside 001E","E01008599",713,343,147,196,344,52,159,59,75,25,49,30,14,5,81,44,37,3,3,26,15,11
"2021","South Tyneside 002A","E01008664",625,338,78,260,254,21,91,36,38,17,55,32,16,7,82,59,23,5,5,33,13,20
"2021","South Tyneside 002B","E01008665",699,373,65,308,311,39,129,58,46,25,55,35,15,5,85,54,31,3,3,15,3,12
"2021","South Tyneside 002C","E01008666",920,414,104,310,466,24,183,70,99,14,127,64,58,5,125,85,40,7,7,40,14,26
"2021","South Tyneside 002D","E01008667",970,520,174,346,427,58,161,83,48,30,82,58,20,4,121,77,44,5,5,23,11,12
"2021","South Tyneside 002E","E01008668",737,385,121,264,326,32,136,49,61,26,56,35,17,4,96,64,32,6,6,26,11,15
"2021","South Tyneside 003A","E01008673",511,161,71,90,333,54,184,62,75,47,61,37,21,3,33,17,16,1,1,17,6,11
"2021","South Tyneside 003B","E01008675",748,423,108,315,317,30,118,65,32,21,91,61,28,2,75,47,28,3,3,8,3,5
"2021","South Tyneside 003C","E01008676",523,204,62,142,295,35,151,66,53,32,52,23,27,2,55,34,21,2,2,24,13,11
"2021","South Tyneside 003D","E01008677",625,256,142,114,362,80,172,65,63,44,62,39,20,3,45,24,21,3,3,7,2,5
"2021","South Tyneside 003E","E01008678",569,266,84,182,284,36,110,58,28,24,61,36,21,4,76,49,27,1,1,19,6,13
"2021","South Tyneside 004A","E01008647",664,193,123,70,461,110,238,99,72,67,61,26,31,4,51,32,19,1,1,10,5,5
"2021","South Tyneside 004B","E01008648",666,257,152,105,399,104,207,97,72,38,41,17,21,3,44,20,24,3,3,10,4,6
"2021","South Tyneside 004C","E01008649",649,196,110,86,428,48,192,74,65,53,72,23,42,7,113,73,40,3,3,25,17,8
"2021","South Tyneside 004D","E01008651",795,263,104,159,505,37,159,63,55,41,79,23,53,3,226,180,46,4,4,27,12,15
"2021","South Tyneside 005A","E01008679",585,236,97,139,338,46,167,55,73,39,65,45,18,2,58,25,33,2,2,11,5,6
"2021","South Tyneside 005B","E01008680",642,186,126,60,442,109,232,89,92,51,54,24,28,2,46,24,22,1,1,14,8,6
"2021","South Tyneside 005C","E01008682",511,198,99,99,292,36,118,41,49,28,39,13,22,4,97,70,27,2,2,21,10,11
"2021","South Tyneside 005D","E01008683",664,331,76,255,314,34,106,51,35,20,92,57,26,9,78,48,30,4,4,19,7,12
"2021","South Tyneside 006A","E01008635",624,186,123,63,419,103,162,68,53,41,64,27,29,8,88,57,31,2,2,19,10,9
"2021","South Tyneside 006B","E01008650",591,154,90,64,429,87,215,83,73,59,72,38,30,4,53,30,23,2,2,8,3,5
"2021","South Tyneside 006C","E01008674",518,123,76,47,383,81,229,99,81,49,42,20,17,5,31,16,15,0,0,12,4,8
"2021","South Tyneside 006D","E01008681",631,183,123,60,432,123,231,89,91,51,42,18,20,4,34,17,17,2,2,16,6,10
"2021","South Tyneside 007A","E01008600",605,249,76,173,345,49,104,45,40,19,62,38,16,8,129,87,42,1,1,11,7,4
"2021","South Tyneside 007B","E01008604",808,413,139,274,367,28,120,47,46,27,80,40,34,6,133,95,38,6,6,28,10,18
"2021","South Tyneside 007C","E01008660",662,272,78,194,363,59,182,79,62,41,78,49,27,2,39,16,23,5,5,27,10,17
"2021","South Tyneside 007D","E01008661",452,138,46,92,297,58,109,38,34,37,56,21,30,5,70,47,23,4,4,17,13,4
"2021","South Tyneside 008A","E01008633",602,170,89,81,413,39,144,54,55,35,78,27,41,10,149,117,32,3,3,19,6,13
"2021","South Tyneside 008B","E01008634",596,243,155,88,343,44,120,48,40,32,52,22,24,6,126,83,43,1,1,10,4,6
"2021","South Tyneside 008C","E01008636",585,179,111,68,381,58,178,61,73,44,53,19,27,7,87,49,38,5,5,25,9,16
"2021","South Tyneside 008D","E01008637",620,205,99,106,398,56,188,59,78,51,63,23,34,6,85,47,38,6,6,17,9,8
"2021","South Tyneside 009A","E01008639",1049,324,90,234,684,44,277,94,137,46,164,84,71,9,195,137,58,4,4,41,13,28
"2021","South Tyneside 009B","E01008652",574,228,92,136,332,40,123,42,55,26,68,30,32,6,94,65,29,7,7,14,6,8
"2021","South Tyneside 009C","E01008653",531,136,59,77,378,41,133,50,51,32,65,18,37,10,138,100,38,1,1,17,8,9
"2021","South Tyneside 009D","E01008654",595,276,69,207,299,28,125,60,42,23,74,46,23,5,68,42,26,4,4,20,10,10
"2021","South Tyneside 009E","E01008655",793,245,94,151,521,47,175,68,80,27,163,87,63,13,128,90,38,8,8,27,14,13
"2021","South Tyneside 009F","E01008657",586,202,99,103,371,69,208,69,79,60,50,26,18,6,42,25,17,2,2,13,9,4
"2021","South Tyneside 010A","E01008638",586,206,34,172,367,31,208,81,74,53,78,49,22,7,49,29,20,1,1,13,4,9
"2021","South Tyneside 010B","E01008640",1145,379,122,257,737,67,329,112,158,59,192,109,71,12,135,94,41,14,14,29,12,17
"2021","South Tyneside 010C","E01008641",547,269,114,155,256,34,95,41,30,24,54,29,23,2,69,49,20,4,4,22,13,9
"2021","South Tyneside 010D","E01008642",764,176,83,93,563,95,292,113,122,57,135,79,52,4,41,23,18,0,0,25,9,16
"2021","South Tyneside 011A","E01008590",746,348,150,198,374,50,138,55,49,34,66,34,24,8,115,65,50,5,5,24,8,16
"2021","South Tyneside 011B","E01008591",700,385,77,308,284,25,91,43,29,19,66,36,24,6,95,64,31,7,7,31,13,18
"2021","South Tyneside 011C","E01008592",640,294,73,221,334,31,98,50,27,21,84,47,33,4,114,79,35,7,7,12,4,8
"2021","South Tyneside 011D","E01008594",772,263,116,147,483,57,207,75,77,55,102,45,51,6,115,84,31,2,2,26,13,13
"2021","South Tyneside 012A","E01008601",632,195,111,84,418,44,168,67,62,39,86,28,50,8,114,79,35,6,6,19,7,12
"2021","South Tyneside 012B","E01008669",691,281,116,165,378,37,141,66,54,21,87,46,34,7,105,74,31,8,8,32,14,18
"2021","South Tyneside 012C","E01008671",594,317,81,236,266,45,95,38,35,22,42,28,11,3,84,53,31,0,0,11,0,11
"2021","South Tyneside 012D","E01008672",608,188,89,99,408,68,180,78,57,45,67,35,22,10,90,51,39,3,3,12,4,8
"2021","South Tyneside 013A","E01008622",770,215,136,79,538,150,262,110,89,63,61,29,25,7,60,32,28,5,5,17,6,11
"2021","South Tyneside 013C","E01008625",684,299,146,153,371,54,130,47,48,35,59,20,35,4,127,96,31,1,1,14,5,9
"2021","South Tyneside 013F","E01034512",637,206,114,92,396,48,166,50,69,47,69,26,36,7,108,63,45,5,5,35,15,20
"2021","South Tyneside 013G","E01034513",595,126,51,75,448,31,217,57,132,28,90,48,42,0,108,78,30,2,2,21,9,12
"2021","South Tyneside 014A","E01008602",628,185,64,121,419,38,151,63,56,32,72,35,31,6,148,106,42,10,10,24,14,10
"2021","South Tyneside 014B","E01008603",673,300,93,207,350,33,131,52,49,30,74,31,40,3,105,78,27,7,7,23,14,9
"2021","South Tyneside 014C","E01008608",534,188,92,96,337,38,92,32,34,26,67,31,32,4,138,101,37,2,2,9,2,7
"2021","South Tyneside 014D","E01008670",724,293,128,165,419,34,153,68,56,29,95,38,50,7,132,95,37,5,5,12,4,8
"2021","South Tyneside 015A","E01008643",742,196,103,93,531,60,259,108,99,52,118,50,62,6,94,61,33,0,0,15,12,3
"2021","South Tyneside 015B","E01008644",786,350,157,193,406,45,138,60,47,31,90,41,40,9,127,90,37,6,6,30,15,15
"2021","South Tyneside 015C","E01008645",1113,300,110,190,784,36,386,103,231,52,204,90,103,11,148,101,47,10,10,29,16,13
"2021","South Tyneside 015D","E01008646",605,215,117,98,379,76,193,75,74,44,55,26,25,4,54,36,18,1,1,11,5,6
"2021","South Tyneside 015E","E01008656",646,230,141,89,397,57,162,51,59,52,83,37,43,3,91,54,37,4,4,19,7,12
"2021","South Tyneside 015F","E01008658",584,149,78,71,407,48,136,41,56,39,66,15,38,13,153,102,51,4,4,28,14,14
"2021","South Tyneside 016A","E01008593",607,192,59,133,387,30,121,39,47,35,62,21,32,9,173,132,41,1,1,28,15,13
"2021","South Tyneside 016B","E01008605",501,135,55,80,348,55,147,60,53,34,65,30,31,4,81,51,30,0,0,18,12,6
"2021","South Tyneside 016C","E01008606",774,267,102,165,479,37,183,54,97,32,112,39,60,13,147,109,38,0,0,28,15,13
"2021","South Tyneside 016D","E01008607",628,152,55,97,464,41,112,36,46,30,72,17,49,6,236,188,48,3,3,12,7,5
"2021","South Tyneside 016E","E01008609",644,177,82,95,451,34,149,58,57,34,89,26,54,9,175,135,40,4,4,16,7,9
"2021","South Tyneside 017A","E01008631",580,178,89,89,383,70,159,54,65,40,59,24,29,6,93,67,26,2,2,19,9,10
"2021","South Tyneside 017B","E01008632",552,209,96,113,323,27,136,52,48,36,53,20,28,5,105,59,46,2,2,20,11,9
"2021","South Tyneside 017C","E01008659",624,169,87,82,442,73,175,53,71,51,83,35,40,8,108,65,43,3,3,13,6,7
"2021","South Tyneside 017D","E01008662",509,151,82,69,330,30,139,48,45,46,60,23,28,9,93,61,32,8,8,28,13,15
"2021","South Tyneside 017E","E01008663",641,241,137,104,385,66,142,59,46,37,66,27,32,7,107,66,41,4,4,15,10,5
"2021","South Tyneside 018A","E01008624",568,173,89,84,386,58,200,68,83,49,54,24,28,2,72,52,20,2,2,9,4,5
"2021","South Tyneside 018B","E01008684",510,197,116,81,297,59,126,57,36,33,43,24,18,1,66,36,30,3,3,16,5,11
"2021","South Tyneside 018C","E01008685",838,269,145,124,544,97,277,119,105,53,71,39,23,9,97,68,29,2,2,25,14,11
"2021","South Tyneside 018D","E01008686",708,205,133,72,479,55,234,69,113,52,87,31,42,14,97,60,37,6,6,24,11,13
"2021","South Tyneside 018E","E01008687",909,368,233,135,525,139,233,89,78,66,68,36,28,4,82,39,43,3,3,16,5,11
"2021","South Tyneside 019A","E01008688",640,253,90,163,371,37,132,53,52,27,76,29,39,8,121,84,37,5,5,16,8,8
"2021","South Tyneside 019B","E01008689",725,304,142,162,400,58,150,69,39,42,66,28,31,7,119,74,45,7,7,21,10,11
"2021","South Tyneside 019C","E01008690",627,233,71,162,379,30,180,67,68,45,73,26,39,8,93,69,24,3,3,15,7,8
"2021","South Tyneside 019D","E01008691",495,116,59,57,371,78,202,89,50,63,55,21,31,3,36,18,18,0,0,8,2,6
"2021","South Tyneside 019E","E01008692",623,214,100,114,383,60,153,58,59,36,57,20,33,4,110,64,46,3,3,26,10,16
"2021","South Tyneside 020A","E01008627",588,197,95,102,384,126,169,62,71,36,44,33,10,1,44,25,19,1,1,7,4,3
"2021","South Tyneside 020B","E01008628",629,211,95,116,385,59,133,45,50,38,65,30,30,5,125,90,35,3,3,33,15,18
"2021","South Tyneside 020C","E01008629",586,161,94,67,409,95,193,83,66,44,44,15,17,12,75,38,37,2,2,16,7,9
"2021","South Tyneside 020D","E01008630",615,191,69,122,408,33,156,59,60,37,77,29,40,8,139,93,46,3,3,16,6,10
"2021","South Tyneside 021A","E01008610",657,222,110,112,413,51,137,52,54,31,93,34,53,6,131,95,36,1,1,22,9,13
"2021","South Tyneside 021B","E01008611",593,146,64,82,439,64,259,114,82,63,62,34,25,3,53,36,17,1,1,8,6,2
"2021","South Tyneside 021C","E01008612",648,173,68,105,463,95,243,102,84,57,71,45,22,4,53,27,26,1,1,12,5,7
"2021","South Tyneside 021D","E01008613",763,360,114,246,388,31,146,53,66,27,99,47,42,10,109,70,39,3,3,15,8,7
"2021","South Tyneside 022A","E01008616",639,176,90,86,454,80,244,82,111,51,76,44,30,2,52,27,25,2,2,9,6,3
"2021","South Tyneside 022B","E01008618",534,128,97,31,386,92,238,66,118,54,30,13,14,3,25,10,15,1,1,20,13,7
"2021","South Tyneside 022C","E01008619",724,219,161,58,490,139,256,101,101,54,49,23,22,4,43,30,13,3,3,15,6,9
"2021","South Tyneside 022D","E01008621",606,137,103,34,448,109,256,84,117,55,51,29,20,2,30,11,19,2,2,21,12,9
"2021","South Tyneside 023A","E01008614",677,171,91,80,486,53,227,58,121,48,105,43,51,11,97,61,36,4,4,20,12,8
"2021","South Tyneside 023B","E01008615",685,245,128,117,426,86,186,77,73,36,80,44,30,6,72,43,29,2,2,14,5,9
"2021","South Tyneside 023C","E01008617",625,190,128,62,423,93,231,99,89,43,61,24,26,11,37,18,19,1,1,12,4,8
"2021","South Tyneside 023D","E01008620",636,199,134,65,420,85,228,73,116,39,56,27,25,4,49,29,20,2,2,17,8,9
"2021","Sunderland 001A","E01008713",631,126,66,60,479,96,262,101,94,67,75,42,30,3,42,15,27,4,4,26,16,10
"2021","Sunderland 001B","E01008722",643,196,139,57,427,86,227,85,90,52,66,42,20,4,47,22,25,1,1,20,12,8
"2021","Sunderland 001C","E01008724",478,106,61,45,361,60,201,63,80,58,61,31,28,2,37,15,22,2,2,11,5,6
"2021","Sunderland 001D","E01008726",657,202,103,99,433,70,238,94,78,66,70,42,26,2,52,24,28,3,3,22,10,12
"2021","Sunderland 002A","E01008723",596,136,87,49,451,94,274,99,110,65,52,29,20,3,30,13,17,1,1,9,4,5
"2021","Sunderland 002B","E01008725",617,172,117,55,435,114,237,98,88,51,52,28,19,5,32,9,23,0,0,10,6,4
"2021","Sunderland 002C","E01008727",754,308,138,170,443,69,190,85,63,42,95,59,34,2,88,45,43,1,1,3,3,0
"2021","Sunderland 002D","E01008728",575,141,70,71,423,74,224,83,71,70,69,29,34,6,55,26,29,1,1,11,4,7
"2021","Sunderland 002E","E01008792",493,116,81,35,363,93,216,96,66,54,26,13,11,2,27,8,19,1,1,14,9,5
"2021","Sunderland 003A","E01008698",712,305,144,161,397,44,135,50,49,36,109,47,50,12,106,80,26,3,3,10,6,4
"2021","Sunderland 003B","E01008837",600,246,115,131,342,22,118,57,34,27,74,35,29,10,122,77,45,6,6,12,5,7
"2021","Sunderland 003C","E01008838",661,228,74,154,414,31,152,56,53,43,87,32,44,11,141,104,37,3,3,19,9,10
"2021","Sunderland 003D","E01008839",682,291,89,202,370,27,99,43,24,32,92,41,40,11,147,110,37,5,5,21,11,10
"2021","Sunderland 003E","E01008840",586,188,79,109,375,24,142,47,56,39,96,35,47,14,106,77,29,7,7,23,14,9
"2021","Sunderland 003F","E01008841",594,185,66,119,388,27,128,41,60,27,104,33,58,13,125,91,34,4,4,21,10,11
"2021","Sunderland 004A","E01008712",865,357,165,192,476,68,145,59,56,30,102,41,43,18,151,102,49,10,10,32,16,16
"2021","Sunderland 004B","E01008817",487,135,54,81,333,18,99,33,43,23,65,18,39,8,146,103,43,5,5,19,11,8
"2021","Sunderland 004C","E01008819",622,200,99,101,398,58,134,41,42,51,76,27,42,7,128,91,37,2,2,24,7,17
"2021","Sunderland 004D","E01008821",600,170,78,92,407,52,130,44,61,25,79,21,48,10,144,107,37,2,2,23,9,14
"2021","Sunderland 004E","E01008822",715,256,72,184,437,51,137,53,42,42,92,39,41,12,152,101,51,5,5,22,11,11
"2021","Sunderland 004F","E01008842",591,148,64,84,424,57,190,90,48,52,82,36,38,8,90,56,34,5,5,19,12,7
"2021","Sunderland 005A","E01008708",676,249,147,102,414,52,196,72,78,46,75,36,29,10,88,47,41,3,3,13,5,8
"2021","Sunderland 005B","E01008709",626,298,81,217,311,31,113,53,34,26,60,24,26,10,103,64,39,4,4,17,6,11
"2021","Sunderland 005D","E01008711",685,248,103,145,419,44,191,66,76,49,93,45,37,11,87,49,38,4,4,18,7,11
"2021","Sunderland 005H","E01034514",1545,653,240,413,842,121,281,110,108,63,192,76,104,12,238,156,82,10,10,50,26,24
"2021","Sunderland 006A","E01008786",643,190,100,90,434,97,188,70,75,43,75,34,36,5,73,42,31,1,1,19,9,10
"2021","Sunderland 006B","E01008787",674,269,93,176,385,58,157,72,40,45,82,44,33,5,83,44,39,5,5,20,7,13
"2021","Sunderland 006C","E01008788",732,292,129,163,418,76,147,76,44,27,96,53,39,4,97,56,41,2,2,22,8,14
"2021","Sunderland 006D","E01008789",638,237,98,139,384,74,189,93,60,36,67,43,18,6,51,23,28,3,3,17,7,10
"2021","Sunderland 006E","E01008790",648,244,89,155,380,43,197,76,67,54,71,32,31,8,62,30,32,7,7,24,9,15
"2021","Sunderland 006F","E01008791",904,543,241,302,311,55,116,51,46,19,61,47,6,8,74,30,44,5,5,50,14,36
"2021","Sunderland 007A","E01008855",609,216,41,175,378,30,203,64,88,51,84,39,36,9,59,42,17,2,2,15,5,10
"2021","Sunderland 007B","E01008856",616,195,131,64,403,110,196,90,60,46,55,29,23,3,42,11,31,0,0,18,7,11
"2021","Sunderland 007C","E01008876",626,93,62,31,508,130,263,86,114,63,75,38,34,3,39,22,17,1,1,25,14,11
"2021","Sunderland 007D","E01008877",724,232,112,120,478,87,241,87,104,50,89,51,35,3,59,34,25,2,2,14,8,6
"2021","Sunderland 008A","E01008693",613,199,65,134,391,48,158,68,53,37,90,36,47,7,88,69,19,7,7,23,10,13
"2021","Sunderland 008B","E01008694",633,209,91,118,405,52,158,65,60,33,81,29,47,5,110,78,32,4,4,19,8,11
"2021","Sunderland 008C","E01008695",595,153,58,95,416,25,168,68,58,42,78,33,41,4,140,96,44,5,5,26,15,11
"2021","Sunderland 008D","E01008696",484,89,34,55,377,46,229,94,81,54,63,28,23,12,38,25,13,1,1,18,11,7
"2021","Sunderland 008E","E01008697",617,200,107,93,397,76,150,58,54,38,73,30,31,12,96,61,35,2,2,20,10,10
"2021","Sunderland 008F","E01008699",606,188,89,99,393,42,139,53,54,32,81,31,37,13,129,88,41,2,2,25,12,13
"2021","Sunderland 009A","E01008853",679,266,120,146,390,45,104,42,45,17,89,46,39,4,149,105,44,3,3,23,11,12
"2021","Sunderland 009B","E01008854",637,329,87,242,287,22,103,48,33,22,72,40,30,2,79,47,32,11,11,21,9,12
"2021","Sunderland 009C","E01008857",615,200,89,111,389,47,139,66,47,26,83,34,39,10,116,87,29,4,4,26,9,17
"2021","Sunderland 009D","E01008858",597,195,57,138,389,21,101,46,30,25,94,40,44,10,171,135,36,2,2,13,5,8
"2021","Sunderland 009E","E01008859",517,135,46,89,347,24,135,47,65,23,65,13,47,5,114,85,29,9,9,35,23,12
"2021","Sunderland 009F","E01008860",585,191,87,104,372,50,152,68,53,31,72,31,33,8,93,56,37,5,5,22,11,11
"2021","Sunderland 009G","E01008878",626,165,97,68,441,60,198,67,63,68,79,28,44,7,98,66,32,6,6,20,11,9
"2021","Sunderland 010A","E01008873",535,141,74,67,379,97,175,72,62,41,56,33,19,4,50,20,30,1,1,15,10,5
"2021","Sunderland 010B","E01008874",671,166,89,77,478,58,174,60,74,40,94,28,50,16,152,107,45,0,0,27,14,13
"2021","Sunderland 010C","E01008875",663,215,81,134,429,56,191,75,83,33,100,54,36,10,82,58,24,0,0,19,10,9
"2021","Sunderland 010D","E01008879",620,238,99,139,372,64,167,71,48,48,64,27,34,3,72,34,38,5,5,10,1,9
"2021","Sunderland 010E","E01008880",494,165,83,82,305,65,142,60,47,35,53,26,22,5,45,24,21,0,0,24,17,7
"2021","Sunderland 011A","E01008701",615,229,57,172,364,31,151,45,71,35,69,30,32,7,105,62,43,8,8,22,16,6
"2021","Sunderland 011B","E01008704",618,243,83,160,341,39,179,69,68,42,49,31,16,2,67,39,28,7,7,34,21,13
"2021","Sunderland 011C","E01008706",627,229,82,147,357,23,169,52,78,39,70,46,19,5,87,51,36,8,8,41,18,23
"2021","Sunderland 011D","E01008707",503,159,45,114,298,17,140,45,80,15,53,27,22,4,74,49,25,14,14,46,21,25
"2021","Sunderland 012A","E01008756",635,217,103,114,380,32,166,55,71,40,74,22,44,8,97,60,37,11,11,38,20,18
"2021","Sunderland 012B","E01008762",781,312,179,133,438,58,143,54,45,44,84,25,47,12,144,99,45,9,9,31,15,16
"2021","Sunderland 012C","E01008812",752,210,64,146,519,43,153,55,59,39,125,49,67,9,194,153,41,4,4,23,15,8
"2021","Sunderland 012F","E01033076",980,241,86,155,684,41,232,74,106,52,201,84,103,14,202,145,57,8,8,55,34,21
"2021","Sunderland 013A","E01008700",683,234,74,160,423,27,204,76,100,28,110,60,44,6,73,42,31,9,9,26,12,14
"2021","Sunderland 013B","E01008703",1092,706,179,527,325,33,100,63,27,10,102,94,7,1,67,20,47,23,23,61,13,48
"2021","Sunderland 013C","E01008705",464,169,52,117,254,24,108,42,45,21,51,33,14,4,64,36,28,7,7,41,11,30
"2021","Sunderland 013D","E01008831",839,431,122,309,314,28,143,40,83,20,70,57,12,1,53,34,19,20,20,94,20,74
"2021","Sunderland 013E","E01008834",796,428,82,346,311,22,127,54,60,13,103,77,23,3,52,29,23,7,7,57,13,44
"2021","Sunderland 014A","E01008810",691,215,64,151,449,38,157,57,64,36,100,34,49,17,143,105,38,11,11,27,21,6
"2021","Sunderland 014B","E01008811",672,187,104,83,471,67,222,80,85,57,82,45,29,8,98,57,41,2,2,14,6,8
"2021","Sunderland 014C","E01008813",709,250,110,140,432,46,168,68,55,45,90,35,40,15,125,68,57,3,3,27,15,12
"2021","Sunderland 014D","E01008814",664,207,87,120,430,89,199,90,63,46,67,29,33,5,75,46,29,0,0,27,17,10
"2021","Sunderland 015A","E01008757",635,241,93,148,369,56,145,55,52,38,68,36,19,13,96,57,39,4,4,25,7,18
"2021","Sunderland 015B","E01008758",596,147,89,58,424,75,189,70,68,51,87,40,37,10,68,36,32,5,5,25,17,8
"2021","Sunderland 015C","E01008759",643,218,111,107,389,66,192,72,67,53,65,36,24,5,58,30,28,8,8,36,13,23
"2021","Sunderland 015D","E01008761",585,144,105,39,417,107,216,89,70,57,51,22,26,3,36,16,20,7,7,24,14,10
"2021","Sunderland 016A","E01008702",646,360,179,181,266,30,66,31,19,16,55,20,33,2,107,69,38,8,8,20,11,9
"2021","Sunderland 016B","E01008735",944,497,163,334,398,47,165,61,81,23,102,69,29,4,76,46,30,8,8,49,18,31
"2021","Sunderland 016C","E01008736",506,242,65,177,242,11,71,32,21,18,57,27,26,4,99,68,31,4,4,22,9,13
"2021","Sunderland 016D","E01008737",536,200,41,159,298,25,134,49,59,26,66,39,24,3,70,48,22,3,3,38,21,17
"2021","Sunderland 016E","E01008738",512,208,59,149,277,35,94,37,30,27,63,32,23,8,80,61,19,5,5,27,12,15
"2021","Sunderland 016F","E01008836",671,389,99,290,236,17,110,29,56,25,44,25,17,2,56,26,30,9,9,46,25,21
"2021","Sunderland 017A","E01008845",658,238,94,144,403,117,203,83,74,46,50,27,21,2,33,20,13,0,0,17,6,11
"2021","Sunderland 017B","E01008846",465,124,63,61,326,40,111,41,48,22,61,7,50,4,111,79,32,3,3,15,8,7
"2021","Sunderland 017C","E01008847",504,113,59,54,364,36,152,40,77,35,60,18,35,7,113,75,38,3,3,27,14,13
"2021","Sunderland 017E","E01008851",753,310,110,200,431,46,182,72,75,35,103,47,45,11,97,60,37,3,3,12,6,6
"2021","Sunderland 017F","E01034515",600,108,41,67,470,62,269,103,116,50,87,46,35,6,50,30,20,2,2,22,10,12
"2021","Sunderland 017G","E01034516",586,92,10,82,474,19,297,72,194,31,107,51,55,1,50,43,7,1,1,20,10,10
"2021","Sunderland 018A","E01008760",616,181,74,107,402,62,200,69,76,55,72,32,32,8,68,40,28,0,0,33,17,16
"2021","Sunderland 018B","E01008830",497,150,36,114,280,25,155,41,89,25,39,19,17,3,50,26,24,11,11,67,25,42
"2021","Sunderland 018C","E01008832",592,200,85,115,346,37,172,40,102,30,61,34,24,3,70,48,22,6,6,46,25,21
"2021","Sunderland 018D","E01008833",596,232,122,110,333,53,163,57,75,31,58,40,16,2,57,24,33,2,2,31,14,17
"2021","Sunderland 019A","E01008843",542,152,79,73,376,92,176,66,58,52,58,25,29,4,49,28,21,1,1,14,3,11
"2021","Sunderland 019B","E01008844",687,238,142,96,428,109,181,79,64,38,74,33,34,7,62,38,24,2,2,21,6,15
"2021","Sunderland 019C","E01008848",650,232,137,95,408,137,180,71,67,42,41,18,18,5,49,22,27,1,1,10,4,6
"2021","Sunderland 019D","E01008849",571,178,65,113,373,23,114,32,57,25,98,30,59,9,135,105,30,3,3,20,7,13
"2021","Sunderland 019E","E01008852",529,166,85,81,357,73,186,78,71,37,48,25,21,2,49,28,21,1,1,6,3,3
"2021","Sunderland 020A","E01008867",741,330,50,280,385,18,111,39,47,25,121,51,61,9,133,95,38,2,2,26,10,16
"2021","Sunderland 020B","E01008868",503,131,66,65,356,91,165,80,46,39,62,36,25,1,37,21,16,1,1,16,11,5
"2021","Sunderland 020C","E01008869",513,120,73,47,376,85,172,56,62,54,58,25,23,10,60,37,23,1,1,17,5,12
"2021","Sunderland 020D","E01008870",598,166,76,90,415,69,239,102,84,53,68,38,27,3,37,22,15,2,2,17,3,14
"2021","Sunderland 020E","E01008871",585,180,82,98,388,50,160,66,59,35,91,27,57,7,87,50,37,0,0,17,9,8
"2021","Sunderland 020F","E01008872",770,221,118,103,529,109,273,113,107,53,94,58,32,4,51,26,25,2,2,20,5,15
"2021","Sunderland 021B","E01008730",637,152,67,85,446,33,133,42,49,42,99,26,60,13,172,114,58,9,9,39,17,22
"2021","Sunderland 021D","E01008732",914,324,146,178,568,59,235,85,101,49,111,51,46,14,157,105,52,6,6,22,14,8
"2021","Sunderland 021E","E01008733",838,422,123,299,396,37,118,40,43,35,115,52,54,9,113,71,42,13,13,20,11,9
"2021","Sunderland 021F","E01008734",621,179,129,50,417,158,183,79,45,59,46,21,22,3,29,11,18,1,1,25,15,10
"2021","Sunderland 021G","E01034517",974,315,145,170,613,46,201,72,78,51,139,50,73,16,221,163,58,6,6,46,30,16
"2021","Sunderland 022A","E01008740",603,183,118,65,389,107,203,70,77,56,40,20,16,4,35,17,18,4,4,31,16,15
"2021","Sunderland 022B","E01008781",630,177,109,68,429,99,243,110,77,56,52,30,18,4,32,15,17,3,3,24,11,13
"2021","Sunderland 022C","E01008782",598,154,109,45,431,93,246,87,99,60,55,26,24,5,34,10,24,3,3,13,8,5
"2021","Sunderland 022D","E01008783",614,159,93,66,436,107,235,96,93,46,52,33,16,3,39,19,20,3,3,19,10,9
"2021","Sunderland 022E","E01008784",628,153,91,62,458,95,268,84,121,63,51,24,20,7,42,24,18,2,2,17,7,10
"2021","Sunderland 022F","E01008785",613,171,115,56,427,134,212,90,77,45,47,24,17,6,33,11,22,1,1,15,9,6
"2021","Sunderland 022G","E01008835",579,168,47,121,364,50,187,62,86,39,78,53,22,3,47,26,21,2,2,47,31,16
"2021","Sunderland 023A","E01008823",592,176,81,95,388,37,135,49,54,32,82,20,48,14,131,101,30,3,3,28,15,13
"2021","Sunderland 023B","E01008824",600,199,47,152,377,26,136,43,62,31,87,33,46,8,121,87,34,7,7,24,16,8
"2021","Sunderland 023C","E01008825",666,215,97,118,428,63,169,56,63,50,79,34,38,7,113,58,55,4,4,23,12,11
"2021","Sunderland 023D","E01008826",590,162,58,104,405,45,172,64,56,52,82,35,35,12,101,70,31,5,5,23,14,9
"2021","Sunderland 023E","E01008827",503,166,48,118,319,24,101,22,46,33,65,21,33,11,124,81,43,5,5,18,10,8
"2021","Sunderland 023F","E01008828",613,147,69,78,434,27,110,23,53,34,104,31,58,15,188,137,51,5,5,32,20,12
"2021","Sunderland 023G","E01008829",582,253,72,181,299,14,111,40,45,26,79,24,48,7,90,61,29,5,5,30,11,19
"2021","Sunderland 024A","E01008739",597,124,47,77,443,50,175,58,66,51,85,32,41,12,129,82,47,4,4,30,21,9
"2021","Sunderland 024B","E01008741",625,185,84,101,424,62,221,76,76,69,68,32,29,7,69,44,25,4,4,16,11,5
"2021","Sunderland 024C","E01008779",651,263,148,115,371,51,156,65,52,39,70,33,31,6,89,54,35,5,5,17,5,12
"2021","Sunderland 024D","E01008780",819,295,101,194,501,52,248,76,117,55,74,37,35,2,124,75,49,3,3,23,16,7
"2021","Sunderland 025A","E01008799",675,153,71,82,496,72,305,119,124,62,74,46,21,7,42,20,22,3,3,26,13,13
"2021","Sunderland 025B","E01008861",645,198,89,109,432,96,170,66,74,30,71,34,32,5,89,58,31,6,6,15,8,7
"2021","Sunderland 025C","E01008862",562,108,65,43,439,123,232,113,67,52,38,23,12,3,45,25,20,1,1,15,6,9
"2021","Sunderland 025D","E01008863",635,114,73,41,501,104,305,133,114,58,46,24,16,6,45,17,28,1,1,20,11,9
"2021","Sunderland 025E","E01008864",543,126,63,63,397,143,203,96,69,38,28,16,7,5,23,8,15,0,0,20,11,9
"2021","Sunderland 025F","E01008865",602,193,111,82,385,73,158,72,54,32,63,30,26,7,88,52,36,3,3,24,13,11
"2021","Sunderland 025G","E01008866",581,187,76,111,357,40,164,61,69,34,69,26,37,6,79,52,27,5,5,37,22,15
"2021","Sunderland 026A","E01008773",636,252,74,178,369,19,108,52,34,22,100,53,40,7,137,98,39,5,5,15,9,6
"2021","Sunderland 026B","E01008776",495,127,54,73,342,25,136,41,60,35,71,23,38,10,106,77,29,4,4,26,12,14
"2021","Sunderland 026C","E01008777",941,618,289,329,316,73,102,66,20,16,64,40,18,6,71,38,33,6,6,7,3,4
"2021","Sunderland 026D","E01008778",595,181,79,102,391,47,167,76,53,38,79,35,35,9,97,68,29,1,1,23,15,8
"2021","Sunderland 026E","E01008809",759,277,151,126,459,103,192,85,65,42,81,37,34,10,80,49,31,3,3,23,13,10
"2021","Sunderland 027A","E01008803",679,252,112,140,400,57,148,55,59,34,83,33,38,12,110,63,47,2,2,27,14,13
"2021","Sunderland 027B","E01008804",661,183,100,83,449,64,215,84,62,69,82,29,43,10,85,49,36,3,3,29,17,12
"2021","Sunderland 027C","E01008805",633,235,98,137,382,40,157,66,54,37,69,30,36,3,103,77,26,13,13,16,10,6
"2021","Sunderland 027F","E01033077",994,297,181,116,667,105,316,102,153,61,134,47,75,12,107,67,40,5,5,30,12,18
"2021","Sunderland 028A","E01008763",609,181,82,99,403,38,173,70,61,42,75,21,50,4,116,82,34,1,1,25,12,13
"2021","Sunderland 028B","E01008764",676,213,104,109,444,75,194,89,63,42,77,39,31,7,97,62,35,1,1,19,7,12
"2021","Sunderland 028C","E01008766",1194,322,140,182,831,57,412,107,232,73,216,96,104,16,141,101,40,5,5,41,18,23
"2021","Sunderland 028D","E01008768",805,204,86,118,567,73,273,98,123,52,106,49,54,3,110,77,33,5,5,34,20,14
"2021","Sunderland 028E","E01008769",775,280,92,188,459,59,181,65,75,41,85,45,36,4,131,92,39,3,3,36,13,23
"2021","Sunderland 029A","E01008772",591,152,115,37,420,104,251,90,93,68,39,20,16,3,26,12,14,0,0,19,10,9
"2021","Sunderland 029B","E01008774",596,176,115,61,403,89,160,61,59,40,81,32,42,7,72,37,35,1,1,17,7,10
"2021","Sunderland 029C","E01008775",599,146,107,39,438,115,234,83,87,64,49,28,17,4,39,17,22,1,1,15,9,6
"2021","Sunderland 029D","E01008802",633,194,126,68,413,121,186,84,47,55,61,33,22,6,42,22,20,3,3,26,11,15
"2021","Sunderland 029E","E01008808",698,205,73,132,476,85,240,97,88,55,79,47,29,3,67,43,24,5,5,17,10,7
"2021","Sunderland 030A","E01008793",788,347,152,195,425,38,132,53,50,29,92,37,47,8,162,127,35,1,1,16,8,8
"2021","Sunderland 030B","E01008795",715,153,70,83,542,78,290,120,110,60,93,40,47,6,78,42,36,3,3,20,11,9
"2021","Sunderland 030D","E01008800",599,153,64,89,423,26,147,46,65,36,104,28,61,15,143,87,56,3,3,23,12,11
"2021","Sunderland 030E","E01008801",669,158,88,70,494,94,279,115,99,65,79,49,26,4,41,26,15,1,1,17,6,11
"2021","Sunderland 030F","E01034518",728,168,114,54,546,114,295,107,136,52,66,26,37,3,69,38,31,2,2,14,5,9
"2021","Sunderland 030G","E01034519",604,98,30,68,492,31,257,83,152,22,164,96,66,2,40,34,6,0,0,14,11,3
"2021","Sunderland 031A","E01008765",623,133,76,57,472,78,265,104,89,72,77,43,31,3,52,35,17,0,0,18,13,5
"2021","Sunderland 031B","E01008767",626,195,103,92,409,61,188,74,75,39,81,40,34,7,76,39,37,3,3,22,10,12
"2021","Sunderland 031C","E01008770",555,163,59,104,376,60,220,91,72,57,56,24,29,3,39,25,14,1,1,16,6,10
"2021","Sunderland 031D","E01008771",608,157,71,86,429,50,229,78,81,70,74,32,39,3,74,42,32,2,2,22,13,9
"2021","Sunderland 032A","E01008720",607,199,95,104,385,61,163,67,49,47,82,36,40,6,72,45,27,7,7,23,12,11
"2021","Sunderland 032B","E01008721",616,125,53,72,471,74,257,82,126,49,84,42,35,7,55,38,17,1,1,20,11,9
"2021","Sunderland 032D","E01008796",769,207,78,129,529,38,315,121,136,58,113,67,39,7,62,44,18,1,1,33,17,16
"2021","Sunderland 032F","E01032483",727,217,100,117,481,59,241,98,73,70,89,49,30,10,88,61,27,4,4,29,9,20
"2021","Sunderland 032G","E01032484",583,194,75,119,368,62,173,85,51,37,62,26,28,8,68,39,29,3,3,21,7,14
"2021","Sunderland 033A","E01008750",859,221,96,125,624,87,323,137,122,64,116,57,52,7,96,66,30,2,2,14,3,11
"2021","Sunderland 033B","E01008751",631,164,77,87,448,49,188,73,88,27,127,61,58,8,83,50,33,1,1,19,14,5
"2021","Sunderland 033C","E01008752",826,248,92,156,547,29,252,70,135,47,133,58,66,9,132,97,35,1,1,31,15,16
"2021","Sunderland 033D","E01008753",598,196,84,112,381,53,140,53,46,41,84,42,37,5,100,67,33,4,4,21,15,6
"2021","Sunderland 033E","E01008755",604,229,86,143,360,65,146,69,45,32,65,30,33,2,81,51,30,3,3,15,6,9
"2021","Sunderland 034A","E01008714",643,187,94,93,433,38,146,53,70,23,102,36,55,11,141,108,33,6,6,23,13,10
"2021","Sunderland 034B","E01008715",604,223,105,118,363,41,174,57,79,38,74,30,38,6,69,46,23,5,5,18,8,10
"2021","Sunderland 034C","E01008716",646,150,106,44,481,121,260,119,90,51,60,33,19,8,38,21,17,2,2,15,7,8
"2021","Sunderland 034D","E01008717",705,223,101,122,461,63,195,72,87,36,80,27,44,9,120,82,38,3,3,21,6,15
"2021","Sunderland 034E","E01008749",629,218,150,68,399,133,181,92,44,45,44,23,19,2,40,26,14,1,1,12,3,9
"2021","Sunderland 034F","E01008754",672,293,130,163,359,58,131,51,48,32,78,38,29,11,90,53,37,2,2,20,10,10
"2021","Sunderland 035A","E01008718",801,245,101,144,535,75,218,99,67,52,149,70,69,10,84,58,26,9,9,21,14,7
"2021","Sunderland 035B","E01008719",533,231,99,132,291,39,118,45,35,38,57,24,27,6,75,53,22,2,2,11,4,7
"2021","Sunderland 035C","E01008742",731,290,139,151,425,58,190,88,59,43,87,47,33,7,87,62,25,3,3,16,8,8
"2021","Sunderland 035D","E01008747",779,220,109,111,539,106,251,107,84,60,91,55,32,4,88,63,25,3,3,20,10,10
"2021","Sunderland 035E","E01008748",710,230,144,86,462,117,190,86,55,49,83,52,21,10,72,28,44,0,0,18,9,9
"2021","Sunderland 036A","E01008743",687,214,86,128,452,49,153,62,56,35,86,33,48,5,162,114,48,2,2,21,8,13
"2021","Sunderland 036B","E01008744",909,313,99,214,569,44,244,92,102,50,159,71,79,9,118,88,30,4,4,27,16,11
"2021","Sunderland 036C","E01008745",753,220,127,93,516,144,218,98,83,37,81,29,46,6,70,35,35,3,3,17,12,5
"2021","Sunderland 036D","E01008746",911,279,92,187,594,39,268,112,112,44,129,51,73,5,155,112,43,3,3,38,25,13
"2021","Gateshead 001A","E01008246",621,197,91,106,401,55,176,57,75,44,77,42,33,2,91,61,30,2,2,23,9,14
"2021","Gateshead 001B","E01008247",728,277,133,144,429,92,177,68,72,37,77,31,40,6,80,50,30,3,3,22,9,13
"2021","Gateshead 001C","E01008248",1109,275,83,192,805,75,465,150,248,67,175,101,59,15,90,55,35,0,0,29,9,20
"2021","Gateshead 001D","E01008249",731,244,160,84,475,156,200,98,63,39,66,33,29,4,53,26,27,0,0,12,3,9
"2021","Gateshead 001E","E01008250",604,149,76,73,428,63,190,73,85,32,76,37,28,11,95,60,35,4,4,27,10,17
"2021","Gateshead 002A","E01008195",878,250,109,141,606,83,302,127,117,58,117,71,37,9,101,63,38,3,3,22,9,13
"2021","Gateshead 002B","E01008197",801,262,87,175,515,83,214,84,95,35,132,92,35,5,81,54,27,5,5,24,11,13
"2021","Gateshead 002C","E01008198",714,193,85,108,507,70,220,86,94,40,114,57,50,7,100,70,30,3,3,14,8,6
"2021","Gateshead 002D","E01008199",655,273,110,163,373,65,170,76,58,36,75,47,24,4,61,37,24,2,2,9,1,8
"2021","Gateshead 002E","E01008200",594,138,64,74,442,100,237,91,93,53,66,36,28,2,38,18,20,1,1,14,6,8
"2021","Gateshead 002F","E01008245",627,195,109,86,421,99,216,100,76,40,61,37,22,2,45,26,19,0,0,11,5,6
"2021","Gateshead 003A","E01008214",736,219,93,126,472,30,137,43,65,29,118,58,51,9,176,139,37,11,11,45,18,27
"2021","Gateshead 003B","E01008215",737,339,81,258,351,27,119,47,51,21,106,63,32,11,95,62,33,4,4,47,17,30
"2021","Gateshead 003C","E01008243",733,262,124,138,447,119,203,76,92,35,70,46,21,3,48,22,26,7,7,24,11,13
"2021","Gateshead 003D","E01008244",943,404,108,296,505,39,181,73,77,31,144,92,40,12,131,80,51,10,10,34,8,26
"2021","Gateshead 004A","E01008178",697,183,33,150,496,33,202,74,108,20,170,103,63,4,88,58,30,3,3,18,5,13
"2021","Gateshead 004B","E01008180",618,223,113,110,367,38,123,55,42,26,68,19,41,8,134,94,40,4,4,28,14,14
"2021","Gateshead 004C","E01008182",785,275,95,180,486,40,190,77,85,28,104,59,38,7,145,94,51,7,7,24,8,16
"2021","Gateshead 004D","E01008277",660,199,124,75,430,83,185,64,66,55,85,27,46,12,71,39,32,6,6,31,13,18
"2021","Gateshead 004E","E01008280",912,383,151,232,500,61,186,81,63,42,113,67,40,6,134,88,46,6,6,29,15,14
"2021","Gateshead 005A","E01008177",585,233,104,129,331,57,153,61,58,34,71,43,23,5,50,24,26,0,0,21,5,16
"2021","Gateshead 005B","E01008179",526,173,63,110,335,39,155,66,55,34,69,36,29,4,70,39,31,2,2,18,10,8
"2021","Gateshead 005C","E01008181",652,155,79,76,467,98,240,94,95,51,66,28,31,7,60,38,22,3,3,30,14,16
"2021","Gateshead 005D","E01008276",723,307,137,170,403,67,169,85,62,22,83,43,36,4,79,43,36,5,5,13,5,8
"2021","Gateshead 005E","E01008279",667,220,122,98,431,123,222,110,65,47,47,24,21,2,39,11,28,0,0,16,11,5
"2021","Gateshead 007A","E01008209",963,414,112,302,515,42,198,87,74,37,136,74,58,4,133,95,38,6,6,34,12,22
"2021","Gateshead 007B","E01008210",680,286,139,147,370,38,125,49,49,27,107,73,30,4,99,64,35,1,1,24,8,16
"2021","Gateshead 007C","E01008258",1153,494,79,415,586,26,223,85,103,35,224,179,36,9,108,74,34,5,5,73,20,53
"2021","Gateshead 007D","E01008259",1013,474,111,363,501,35,227,77,111,39,118,69,41,8,115,70,45,6,6,38,14,24
"2021","Gateshead 008A","E01008167",668,254,75,179,351,34,155,52,75,28,82,58,19,5,71,41,30,9,9,63,24,39
"2021","Gateshead 008C","E01008170",900,436,125,311,388,30,168,66,70,32,85,66,16,3,94,55,39,11,11,76,17,59
"2021","Gateshead 008E","E01008257",641,242,108,134,366,52,135,49,51,35,63,33,22,8,111,70,41,5,5,33,17,16
"2021","Gateshead 008F","E01035610",908,306,81,225,505,38,280,59,191,30,85,46,36,3,93,63,30,9,9,97,53,44
"2021","Gateshead 009A","E01008262",758,327,58,269,406,35,174,71,60,43,93,57,31,5,94,64,30,10,10,25,9,16
"2021","Gateshead 009B","E01008263",635,228,68,160,385,35,153,53,67,33,74,34,35,5,120,80,40,3,3,22,11,11
"2021","Gateshead 009C","E01008264",600,129,79,50,448,101,260,82,135,43,55,32,20,3,31,14,17,1,1,23,6,17
"2021","Gateshead 009D","E01008265",611,203,82,121,390,40,183,69,71,43,79,43,26,10,85,47,38,3,3,18,11,7
"2021","Gateshead 009E","E01008266",614,227,142,85,377,108,186,77,68,41,50,32,14,4,33,19,14,0,0,10,3,7
"2021","Gateshead 010A","E01008251",852,356,58,298,425,27,165,59,78,28,144,110,31,3,78,50,28,11,11,71,13,58
"2021","Gateshead 010B","E01008252",673,287,61,226,327,24,156,33,110,13,81,62,17,2,59,37,22,7,7,59,21,38
"2021","Gateshead 010C","E01008253",679,276,39,237,344,16,127,50,61,16,96,75,16,5,91,64,27,14,14,59,20,39
"2021","Gateshead 010D","E01008254",698,269,53,216,378,14,129,50,58,21,120,79,38,3,105,65,40,10,10,51,16,35
"2021","Gateshead 010E","E01008255",912,261,104,157,609,71,281,95,133,53,141,81,57,3,110,62,48,6,6,42,19,23
"2021","Gateshead 011A","E01008165",614,166,55,111,409,29,144,49,60,35,91,38,38,15,138,96,42,7,7,39,24,15
"2021","Gateshead 011B","E01008201",619,177,69,108,405,25,149,42,71,36,89,34,46,9,136,97,39,6,6,37,20,17
"2021","Gateshead 011C","E01008202",768,239,69,170,507,42,213,85,75,53,108,59,40,9,134,98,36,10,10,22,9,13
"2021","Gateshead 011D","E01008204",708,257,81,176,420,40,130,47,55,28,86,37,39,10,157,100,57,7,7,31,10,21
"2021","Gateshead 012A","E01008212",642,281,93,188,332,38,131,58,42,31,60,35,20,5,99,71,28,4,4,29,10,19
"2021","Gateshead 012B","E01008213",675,219,119,100,434,78,190,58,71,61,64,32,27,5,98,57,41,4,4,22,11,11
"2021","Gateshead 012C","E01008216",697,324,145,179,347,50,127,58,50,19,76,31,40,5,89,45,44,5,5,26,11,15
"2021","Gateshead 012D","E01008228",535,202,96,106,311,33,117,49,38,30,70,35,26,9,88,55,33,3,3,22,7,15
"2021","Gateshead 013A","E01008206",725,208,90,118,490,78,216,75,89,52,99,48,46,5,94,53,41,3,3,27,10,17
"2021","Gateshead 013B","E01008207",584,141,83,58,430,81,244,101,80,63,65,44,18,3,37,20,17,3,3,13,6,7
"2021","Gateshead 013C","E01008208",723,246,107,139,451,55,183,59,75,49,93,46,40,7,115,62,53,5,5,26,10,16
"2021","Gateshead 013D","E01008211",748,227,99,128,489,66,226,87,83,56,91,57,29,5,100,57,43,6,6,32,8,24
"2021","Gateshead 014A","E01008283",582,182,91,91,391,99,209,104,70,35,60,37,16,7,23,7,16,0,0,9,3,6
"2021","Gateshead 014B","E01008284",607,186,91,95,401,75,192,80,77,35,73,37,30,6,60,30,30,1,1,20,9,11
"2021","Gateshead 014C","E01008286",659,235,136,99,411,97,176,76,61,39,62,29,28,5,74,45,29,2,2,13,8,5
"2021","Gateshead 014D","E01008287",796,220,107,113,560,44,329,120,149,60,104,59,38,7,80,51,29,3,3,16,5,11
"2021","Gateshead 015A","E01008231",664,173,93,80,469,39,157,59,55,43,104,49,49,6,164,117,47,5,5,22,11,11
"2021","Gateshead 015B","E01008240",625,158,87,71,448,50,233,90,105,38,77,37,29,11,84,47,37,4,4,19,7,12
"2021","Gateshead 015C","E01008241",690,195,123,72,474,78,205,74,84,47,82,32,43,7,105,56,49,4,4,21,12,9
"2021","Gateshead 015D","E01008242",683,202,99,103,445,62,171,54,76,41,97,39,42,16,109,67,42,6,6,36,22,14
"2021","Gateshead 015E","E01008281",672,214,108,106,438,64,167,62,66,39,72,32,35,5,134,88,46,1,1,20,13,7
"2021","Gateshead 015F","E01008282",622,198,70,128,395,43,150,57,59,34,68,24,38,6,129,88,41,5,5,29,15,14
"2021","Gateshead 016A","E01008219",707,211,80,131,468,52,224,79,101,44,86,58,23,5,101,56,45,5,5,28,11,17
"2021","Gateshead 016B","E01008235",624,171,94,77,439,83,230,110,75,45,76,48,21,7,47,23,24,3,3,14,4,10
"2021","Gateshead 016C","E01008236",753,337,157,180,393,65,165,65,69,31,97,68,24,5,61,38,23,5,5,23,7,16
"2021","Gateshead 016D","E01008237",592,99,51,48,477,79,293,85,160,48,64,31,25,8,40,17,23,1,1,16,8,8
"2021","Gateshead 016E","E01008238",654,209,84,125,426,64,234,79,126,29,86,56,25,5,37,19,18,5,5,19,7,12
"2021","Gateshead 017A","E01008267",713,268,184,84,418,126,189,68,80,41,50,25,18,7,50,23,27,3,3,27,6,21
"2021","Gateshead 017B","E01008269",644,188,122,66,444,121,249,83,126,40,43,23,17,3,31,17,14,0,0,12,7,5
"2021","Gateshead 017C","E01008270",601,171,142,29,418,154,184,61,80,43,39,22,16,1,41,16,25,0,0,12,7,5
"2021","Gateshead 017D","E01008271",599,158,91,67,433,122,221,72,99,50,45,21,23,1,43,28,15,2,2,8,3,5
"2021","Gateshead 017E","E01008275",643,180,111,69,455,139,236,73,113,50,43,29,13,1,37,21,16,0,0,8,3,5
"2021","Gateshead 018A","E01008229",628,232,153,79,384,104,152,67,43,42,64,34,23,7,64,26,38,0,0,12,2,10
"2021","Gateshead 018B","E01008230",611,233,98,135,355,35,179,55,81,43,79,38,35,6,61,30,31,1,1,23,15,8
"2021","Gateshead 018C","E01008232",583,168,77,91,395,37,152,51,73,28,79,28,43,8,120,82,38,7,7,20,14,6
"2021","Gateshead 018D","E01008233",586,186,89,97,388,88,182,83,46,53,80,49,25,6,38,17,21,0,0,12,5,7
"2021","Gateshead 018E","E01008285",630,243,113,130,372,21,147,63,52,32,72,28,36,8,128,82,46,4,4,15,8,7
"2021","Gateshead 019A","E01008256",745,222,111,111,505,85,223,92,90,41,110,65,36,9,80,43,37,7,7,18,7,11
"2021","Gateshead 019B","E01008260",628,145,62,83,458,54,267,108,106,53,78,44,25,9,55,30,25,4,4,25,9,16
"2021","Gateshead 019C","E01008261",623,211,98,113,384,44,138,50,53,35,72,30,32,10,122,81,41,8,8,28,17,11
"2021","Gateshead 019D","E01008268",616,172,88,84,430,91,191,68,88,35,65,35,26,4,82,41,41,1,1,14,6,8
"2021","Gateshead 019E","E01008272",698,187,129,58,502,134,246,83,128,35,72,34,32,6,45,22,23,5,5,9,5,4
"2021","Gateshead 019F","E01008273",634,200,87,113,416,71,189,68,88,33,84,42,37,5,71,56,15,1,1,18,7,11
"2021","Gateshead 019G","E01008274",602,186,89,97,398,50,152,49,69,34,88,41,38,9,106,72,34,2,2,18,8,10
"2021","Gateshead 020A","E01008193",491,129,86,43,351,74,193,58,88,47,47,22,19,6,35,20,15,2,2,11,3,8
"2021","Gateshead 020B","E01008194",602,169,101,68,419,98,217,65,95,57,53,31,20,2,47,24,23,4,4,14,8,6
"2021","Gateshead 020C","E01008234",979,397,198,199,549,111,289,94,129,66,97,63,31,3,46,28,18,6,6,33,16,17
"2021","Gateshead 020D","E01008239",658,179,98,81,465,81,244,70,126,48,91,56,29,6,48,25,23,1,1,14,5,9
"2021","Gateshead 021A","E01008218",733,318,161,157,393,38,160,55,54,51,80,39,35,6,114,69,45,1,1,22,11,11
"2021","Gateshead 021B","E01008220",568,259,85,174,291,23,81,23,39,19,52,19,29,4,124,91,33,11,11,18,9,9
"2021","Gateshead 021C","E01008221",769,222,81,141,513,47,184,56,78,50,103,41,48,14,170,112,58,9,9,34,15,19
"2021","Gateshead 021D","E01008225",774,290,145,145,462,86,203,84,72,47,82,44,32,6,90,54,36,1,1,22,9,13
"2021","Gateshead 021E","E01008227",633,145,40,105,449,13,148,38,82,28,92,21,65,6,187,132,55,9,9,39,23,16
"2021","Gateshead 022A","E01008184",641,205,134,71,427,109,221,100,79,42,60,40,14,6,36,15,21,1,1,9,2,7
"2021","Gateshead 022B","E01008185",591,190,105,85,382,54,161,50,74,37,70,24,33,13,94,51,43,3,3,19,11,8
"2021","Gateshead 022C","E01008188",604,179,118,61,400,84,196,83,64,49,52,30,18,4,66,43,23,2,2,25,8,17
"2021","Gateshead 022D","E01008278",659,163,116,47,475,125,267,98,113,56,51,24,20,7,32,20,12,0,0,21,8,13
"2021","Gateshead 023A","E01008189",593,268,96,172,302,32,106,35,43,28,64,30,30,4,92,57,35,8,8,23,8,15
"2021","Gateshead 023B","E01008190",605,165,118,47,422,106,205,80,76,49,64,31,26,7,45,18,27,2,2,18,9,9
"2021","Gateshead 023C","E01008191",723,353,118,235,345,33,136,52,51,33,67,30,28,9,102,70,32,7,7,25,9,16
"2021","Gateshead 023D","E01008192",660,263,103,160,376,53,143,46,60,37,73,35,31,7,104,55,49,3,3,21,11,10
"2021","Gateshead 023E","E01008217",716,288,116,172,408,54,153,63,51,39,106,51,43,12,95,47,48,0,0,20,7,13
"2021","Gateshead 025A","E01008222",703,208,71,137,482,48,196,65,89,42,111,47,55,9,121,75,46,6,6,13,8,5
"2021","Gateshead 025B","E01008223",802,260,127,133,515,36,181,67,80,34,106,51,45,10,188,139,49,4,4,27,16,11
"2021","Gateshead 025C","E01008224",1100,240,133,107,827,122,449,157,216,76,151,91,49,11,99,53,46,6,6,33,13,20
"2021","Gateshead 025D","E01008226",768,238,118,120,504,75,258,102,119,37,90,41,37,12,80,57,23,1,1,26,12,14
"2021","Gateshead 026A","E01008172",827,287,182,105,521,131,204,83,81,40,98,58,28,12,86,45,41,2,2,19,13,6
"2021","Gateshead 026B","E01008173",602,172,70,102,394,34,156,54,53,49,89,34,43,12,110,75,35,5,5,36,21,15
"2021","Gateshead 026C","E01008174",950,317,166,151,607,91,303,100,138,65,109,57,43,9,104,59,45,0,0,26,11,15
"2021","Gateshead 026D","E01008175",669,271,76,195,369,53,141,52,64,25,81,57,21,3,86,39,47,8,8,29,12,17
"2021","Gateshead 026E","E01008176",638,150,86,64,476,112,233,88,88,57,58,27,27,4,70,48,22,3,3,12,6,6
"2021","Gateshead 027A","E01008162",1178,534,90,444,574,29,260,109,113,38,185,151,33,1,84,49,35,16,16,70,12,58
"2021","Gateshead 027B","E01008164",687,288,61,227,366,24,136,55,67,14,109,74,31,4,84,57,27,13,13,33,5,28
"2021","Gateshead 027C","E01008166",625,395,84,311,187,10,60,36,16,8,86,81,3,2,21,5,16,10,10,43,0,43
"2021","Gateshead 027E","E01035611",694,354,13,341,270,7,65,42,15,8,174,168,5,1,18,8,10,6,6,70,0,70
"2021","Gateshead 027F","E01035612",508,248,83,165,226,23,110,35,51,24,40,30,9,1,45,17,28,8,8,34,7,27
"2021","Gateshead 028A","E01008163",753,311,84,227,387,32,191,46,114,31,80,54,20,6,75,39,36,9,9,55,26,29
"2021","Gateshead 028B","E01008203",809,370,76,294,395,31,136,43,68,25,105,72,27,6,107,78,29,16,16,44,16,28
"2021","Gateshead 028C","E01008205",675,242,139,103,417,79,220,77,105,38,72,48,21,3,44,21,23,2,2,16,8,8
"2021","Gateshead 029B","E01008183",653,214,105,109,412,59,176,76,75,25,85,43,37,5,89,60,29,3,3,27,11,16
"2021","Gateshead 029C","E01008186",928,408,121,287,494,63,195,96,54,45,110,65,39,6,122,83,39,4,4,26,10,16
"2021","Gateshead 029A","E01008196",929,283,135,148,608,100,301,116,124,61,120,83,28,9,81,56,25,6,6,38,15,23
"2021","Gateshead 029D","E01035624",764,310,169,141,435,82,168,78,46,44,85,41,38,6,97,63,34,3,3,19,8,11
"2021","Halton 001A","E01012392",1162,245,78,167,889,80,531,180,248,103,183,99,74,10,92,65,27,3,3,28,12,16
"2021","Halton 001B","E01012393",1151,279,129,150,838,134,516,154,272,90,107,54,47,6,77,46,31,4,4,34,14,20
"2021","Halton 001C","E01012395",667,167,119,48,478,131,256,74,126,56,48,23,20,5,39,18,21,4,4,22,12,10
"2021","Halton 001D","E01012411",602,179,97,82,400,81,173,82,43,48,84,35,44,5,61,33,28,1,1,23,6,17
"2021","Halton 002A","E01012374",1091,265,102,163,795,124,469,129,249,91,114,63,44,7,88,61,27,0,0,31,19,12
"2021","Halton 002B","E01012375",565,88,56,32,450,109,279,88,129,62,36,10,22,4,26,11,15,0,0,27,15,12
"2021","Halton 002C","E01012376",991,136,43,93,816,39,546,152,280,114,128,67,54,7,100,55,45,3,3,39,21,18
"2021","Halton 002D","E01012421",528,131,67,64,379,77,217,101,52,64,50,28,16,6,34,15,19,1,1,18,6,12
"2021","Halton 002E","E01012423",631,248,110,138,371,76,178,76,66,36,64,39,21,4,49,23,26,4,4,12,4,8
"2021","Halton 003A","E01012368",912,344,154,190,539,68,231,86,98,47,135,69,60,6,99,54,45,6,6,29,17,12
"2021","Halton 003B","E01012410",512,168,84,84,332,63,176,74,46,56,58,29,26,3,33,18,15,2,2,12,4,8
"2021","Halton 003C","E01012412",829,368,92,276,438,30,154,58,60,36,135,75,57,3,117,82,35,2,2,23,14,9
"2021","Halton 003D","E01012413",658,274,122,152,359,29,138,51,51,36,80,29,38,13,108,83,25,4,4,25,12,13
"2021","Halton 003E","E01012414",493,129,74,55,348,68,159,67,59,33,64,28,32,4,52,27,25,5,5,16,12,4
"2021","Halton 004A","E01012377",747,233,122,111,486,58,200,71,82,47,84,29,42,13,138,97,41,6,6,28,14,14
"2021","Halton 004B","E01012390",662,206,102,104,427,75,183,64,81,38,87,37,40,10,76,44,32,6,6,29,18,11
"2021","Halton 004C","E01012419",484,148,63,85,314,30,95,35,37,23,59,26,24,9,127,91,36,3,3,22,11,11
"2021","Halton 004D","E01012420",709,289,98,191,400,48,96,32,46,18,68,25,36,7,183,130,53,5,5,20,10,10
"2021","Halton 004E","E01012422",635,212,66,146,401,34,133,38,60,35,71,28,37,6,161,118,43,2,2,22,12,10
"2021","Halton 005A","E01012369",739,228,104,124,469,40,228,74,103,51,109,48,52,9,87,53,34,5,5,42,23,19
"2021","Halton 005B","E01012394",837,286,147,139,512,46,232,65,117,50,122,67,49,6,105,59,46,7,7,39,19,20
"2021","Halton 005C","E01012425",669,219,89,130,415,43,163,45,65,53,86,41,39,6,118,70,48,5,5,35,15,20
"2021","Halton 005D","E01012426",566,154,86,68,395,72,220,70,92,58,58,31,21,6,42,21,21,3,3,17,7,10
"2021","Halton 005E","E01012427",685,160,57,103,491,34,252,70,134,48,95,44,44,7,107,71,36,3,3,34,21,13
"2021","Halton 006A","E01012378",669,201,115,86,450,81,231,88,79,64,66,29,33,4,70,40,30,2,2,18,13,5
"2021","Halton 006B","E01012379",766,271,120,151,456,54,203,84,71,48,110,58,46,6,81,56,25,8,8,39,24,15
"2021","Halton 006C","E01012380",615,218,85,133,376,25,130,49,49,32,74,26,39,9,144,97,47,3,3,21,8,13
"2021","Halton 006D","E01012388",725,184,64,120,505,40,190,79,69,42,111,43,58,10,158,99,59,6,6,36,22,14
"2021","Halton 006E","E01012442",604,191,81,110,379,31,132,45,57,30,66,25,32,9,142,109,33,8,8,34,20,14
"2021","Halton 007A","E01012367",904,414,115,299,449,35,151,61,59,31,118,58,53,7,138,100,38,7,7,41,17,24
"2021","Halton 007B","E01012370",898,378,95,283,487,27,173,65,73,35,130,75,49,6,147,96,51,10,10,33,15,18
"2021","Halton 007C","E01012424",755,245,76,169,468,31,171,56,76,39,108,30,62,16,152,101,51,6,6,42,24,18
"2021","Halton 007D","E01012441",1126,499,138,361,570,37,154,57,71,26,147,79,56,12,222,163,59,10,10,57,18,39
"2021","Halton 008A","E01012389",740,206,140,66,506,140,242,76,95,71,77,30,41,6,45,21,24,2,2,28,13,15
"2021","Halton 008B","E01012391",969,333,137,196,579,74,220,78,86,56,142,73,61,8,132,97,35,11,11,57,32,25
"2021","Halton 008C","E01012401",797,221,140,81,540,159,251,100,79,72,76,35,28,13,51,24,27,3,3,36,12,24
"2021","Halton 008D","E01012443",580,136,42,94,413,48,195,74,68,53,91,38,46,7,76,43,33,3,3,31,13,18
"2021","Halton 009A","E01012385",760,138,50,88,591,74,364,128,171,65,117,58,53,6,35,20,15,1,1,31,15,16
"2021","Halton 009B","E01012386",993,152,36,116,797,40,503,163,268,72,183,102,72,9,66,37,29,5,5,44,20,24
"2021","Halton 009C","E01012387",489,141,98,43,336,81,178,84,64,30,44,20,18,6,29,13,16,4,4,12,7,5
"2021","Halton 009D","E01012434",601,142,66,76,433,64,234,105,79,50,73,40,30,3,59,30,29,3,3,26,13,13
"2021","Halton 009E","E01012435",775,107,48,59,641,94,405,159,170,76,86,40,35,11,54,32,22,2,2,27,16,11
"2021","Halton 010A","E01012381",793,312,95,217,450,34,129,48,54,27,118,37,74,7,157,116,41,12,12,31,14,17
"2021","Halton 010B","E01012382",744,277,97,180,432,46,118,38,51,29,65,27,32,6,193,140,53,10,10,35,15,20
"2021","Halton 010C","E01012384",760,303,140,163,423,70,173,76,55,42,75,33,37,5,99,60,39,6,6,34,13,21
"2021","Halton 010D","E01012444",565,125,50,75,404,21,154,52,74,28,92,42,42,8,136,97,39,1,1,36,14,22
"2021","Halton 010E","E01012445",528,172,66,106,329,23,116,42,44,30,56,14,34,8,128,86,42,6,6,27,8,19
"2021","Halton 011A","E01012398",496,142,78,64,335,63,142,50,53,39,67,26,34,7,61,38,23,2,2,19,11,8
"2021","Halton 011B","E01012400",514,147,60,87,347,39,178,68,71,39,54,25,26,3,76,46,30,0,0,20,13,7
"2021","Halton 011C","E01012402",640,212,87,125,395,45,137,60,48,29,88,29,52,7,123,86,37,2,2,33,14,19
"2021","Halton 011D","E01012404",569,149,66,83,390,54,192,71,75,46,79,33,41,5,60,35,25,5,5,30,14,16
"2021","Halton 011E","E01012405",901,241,95,146,625,86,257,101,93,63,141,69,64,8,133,95,38,8,8,35,20,15
"2021","Halton 012A","E01012416",773,222,135,87,521,88,277,94,125,58,78,31,37,10,75,47,28,3,3,30,9,21
"2021","Halton 012B","E01012417",559,190,47,143,343,46,137,67,40,30,85,48,29,8,74,42,32,1,1,26,9,17
"2021","Halton 012D","E01012429",623,198,93,105,403,45,142,56,60,26,104,46,48,10,109,80,29,3,3,22,10,12
"2021","Halton 012E","E01012430",865,451,108,343,381,17,118,48,44,26,111,69,40,2,127,84,43,8,8,33,8,25
"2021","Halton 012F","E01012431",1123,506,67,439,584,53,196,89,67,40,177,109,61,7,141,102,39,17,17,33,12,21
"2021","Halton 012G","E01035382",638,273,45,228,345,6,103,37,50,16,149,100,48,1,82,60,22,5,5,20,7,13
"2021","Halton 012H","E01035383",627,246,119,127,364,54,171,68,60,43,79,47,28,4,53,32,21,7,7,17,6,11
"2021","Halton 013A","E01012383",704,245,116,129,432,76,168,74,58,36,77,34,33,10,104,59,45,7,7,27,10,17
"2021","Halton 013B","E01012396",591,200,97,103,357,38,132,45,44,43,75,29,38,8,106,65,41,6,6,34,19,15
"2021","Halton 013C","E01012397",722,248,80,168,442,32,121,42,54,25,93,27,57,9,189,141,48,7,7,32,13,19
"2021","Halton 013D","E01012399",625,244,97,147,363,36,131,44,53,34,85,34,43,8,108,69,39,3,3,18,7,11
"2021","Halton 013E","E01012403",727,186,74,112,506,41,177,50,86,41,104,33,55,16,174,122,52,10,10,35,19,16
"2021","Halton 013F","E01012408",709,207,77,130,443,38,147,63,43,41,77,23,41,13,177,110,67,4,4,59,33,26
"2021","Halton 014A","E01012432",633,227,77,150,390,52,152,71,54,27,102,65,29,8,80,52,28,4,4,16,6,10
"2021","Halton 014B","E01012433",720,241,83,158,444,51,151,69,47,35,79,35,36,8,159,123,36,4,4,35,13,22
"2021","Halton 014C","E01012436",499,135,63,72,351,28,100,25,47,28,72,23,38,11,149,108,41,2,2,13,12,1
"2021","Halton 014D","E01012438",499,187,82,105,284,30,95,33,39,23,60,24,32,4,95,66,29,4,4,28,13,15
"2021","Halton 014E","E01012440",512,135,75,60,354,80,167,54,59,54,57,24,27,6,47,22,25,3,3,23,10,13
"2021","Halton 015A","E01012406",617,190,93,97,401,62,164,67,54,43,65,24,37,4,103,66,37,7,7,26,14,12
"2021","Halton 015B","E01012407",893,473,99,374,386,39,136,48,49,39,95,44,48,3,111,69,42,5,5,34,13,21
"2021","Halton 015C","E01012409",608,260,108,152,330,54,131,57,44,30,50,23,23,4,90,54,36,5,5,18,8,10
"2021","Halton 015D","E01012437",528,135,53,82,368,53,111,37,44,30,58,17,31,10,141,100,41,5,5,25,15,10
"2021","Halton 015E","E01012439",611,186,99,87,395,57,151,62,51,38,68,19,45,4,115,78,37,4,4,30,15,15
"2021","Halton 016A","E01012371",526,152,64,88,355,64,186,71,69,46,71,27,42,2,31,20,11,3,3,19,12,7
"2021","Halton 016B","E01012372",509,144,81,63,349,84,169,73,59,37,60,34,22,4,36,20,16,0,0,16,7,9
"2021","Halton 016C","E01012373",534,134,90,44,381,118,191,76,73,42,36,15,18,3,34,15,19,2,2,19,9,10
"2021","Halton 016D","E01012415",534,107,66,41,411,100,229,78,97,54,52,23,27,2,30,12,18,0,0,16,8,8
"2021","Halton 016E","E01012418",627,159,114,45,450,127,239,90,92,57,42,18,17,7,41,9,32,1,1,18,11,7
"2021","Warrington 001A","E01012471",535,139,82,57,386,86,237,86,103,48,29,16,9,4,34,15,19,0,0,10,5,5
"2021","Warrington 001B","E01012472",756,173,107,66,568,115,324,108,152,64,66,33,30,3,62,34,28,1,1,15,5,10
"2021","Warrington 001C","E01012476",708,195,92,103,482,92,219,90,78,51,104,49,42,13,66,40,26,1,1,31,17,14
"2021","Warrington 001D","E01012477",644,137,76,61,491,83,318,105,152,61,51,28,20,3,39,24,15,0,0,16,6,10
"2021","Warrington 002A","E01012473",686,202,154,48,457,134,243,80,116,47,39,12,24,3,38,20,18,3,3,27,13,14
"2021","Warrington 002B","E01012474",629,235,132,103,372,49,186,72,88,26,59,20,36,3,74,45,29,4,4,22,12,10
"2021","Warrington 002C","E01012475",656,198,89,109,432,71,227,83,95,49,66,31,31,4,66,46,20,2,2,26,10,16
"2021","Warrington 002D","E01012554",883,240,126,114,605,115,316,148,109,59,99,56,35,8,72,39,33,3,3,38,14,24
"2021","Warrington 003A","E01012467",519,150,110,40,348,116,158,49,53,56,35,22,10,3,38,14,24,1,1,21,7,14
"2021","Warrington 003B","E01012468",942,229,125,104,677,104,412,133,202,77,100,48,46,6,60,29,31,1,1,36,16,20
"2021","Warrington 003C","E01012469",616,196,75,121,393,64,201,80,75,46,64,34,27,3,62,41,21,2,2,27,8,19
"2021","Warrington 003D","E01012470",499,152,75,77,329,44,143,50,54,39,59,21,34,4,80,48,32,3,3,18,8,10
"2021","Warrington 004A","E01012460",628,202,79,123,399,26,174,69,72,33,83,33,45,5,110,75,35,6,6,27,11,16
"2021","Warrington 004B","E01012462",639,282,116,166,341,34,167,75,71,21,76,49,22,5,61,32,29,3,3,16,3,13
"2021","Warrington 004C","E01012463",498,123,87,36,360,133,170,81,50,39,31,19,11,1,26,8,18,0,0,15,7,8
"2021","Warrington 004D","E01012464",599,184,76,108,389,68,176,71,76,29,74,32,41,1,68,47,21,3,3,26,14,12
"2021","Warrington 005A","E01012459",721,292,76,216,391,35,165,64,73,28,96,58,31,7,90,61,29,5,5,38,13,25
"2021","Warrington 005B","E01012461",541,136,78,58,388,63,220,87,91,42,61,37,20,4,44,23,21,0,0,17,5,12
"2021","Warrington 005C","E01012465",602,238,76,162,349,47,170,78,60,32,72,43,26,3,60,36,24,0,0,15,5,10
"2021","Warrington 005D","E01012466",736,299,88,211,405,24,139,63,57,19,104,54,42,8,130,105,25,8,8,32,15,17
"2021","Warrington 006A","E01012526",657,187,48,139,420,16,166,44,82,40,101,40,52,9,131,87,44,6,6,50,29,21
"2021","Warrington 006B","E01012534",641,216,64,152,394,26,149,49,64,36,92,38,47,7,123,93,30,4,4,31,12,19
"2021","Warrington 006C","E01012535",740,209,76,133,498,28,178,61,87,30,119,33,77,9,165,120,45,8,8,33,16,17
"2021","Warrington 006D","E01012537",726,280,98,182,423,29,157,50,74,33,103,42,50,11,130,89,41,4,4,23,9,14
"2021","Warrington 006E","E01012539",686,251,93,158,401,45,164,67,64,33,98,43,50,5,88,59,29,6,6,34,18,16
"2021","Warrington 007A","E01012538",616,169,61,108,428,79,214,96,73,45,83,57,25,1,49,25,24,3,3,19,6,13
"2021","Warrington 007B","E01012540",583,167,84,83,395,72,202,71,88,43,78,46,27,5,40,15,25,3,3,21,10,11
"2021","Warrington 007C","E01012541",505,136,55,81,340,59,166,64,64,38,54,27,21,6,59,32,27,2,2,29,13,16
"2021","Warrington 007D","E01012542",636,203,116,87,415,90,174,76,73,25,66,33,28,5,78,48,30,7,7,18,11,7
"2021","Warrington 007E","E01012543",589,176,98,78,394,98,201,94,63,44,53,31,15,7,40,23,17,2,2,19,6,13
"2021","Warrington 007F","E01012544",585,141,83,58,412,104,187,70,79,38,51,18,26,7,69,36,33,1,1,32,18,14
"2021","Warrington 008A","E01012521",660,173,98,75,459,97,185,63,73,49,79,28,45,6,93,53,40,5,5,28,14,14
"2021","Warrington 008B","E01012522",638,241,105,136,370,51,173,73,68,32,79,27,45,7,67,38,29,0,0,27,17,10
"2021","Warrington 008C","E01012533",556,126,40,86,383,26,117,33,64,20,74,16,48,10,162,107,55,4,4,47,21,26
"2021","Warrington 008D","E01012536",646,217,53,164,394,19,155,54,75,26,108,44,54,10,106,67,39,6,6,35,18,17
"2021","Warrington 008E","E01012545",685,242,116,126,413,40,150,50,69,31,87,26,48,13,132,97,35,4,4,30,18,12
"2021","Warrington 008F","E01012546",674,241,65,176,406,19,153,53,68,32,78,27,41,10,155,122,33,1,1,27,17,10
"2021","Warrington 009A","E01012561",669,235,93,142,418,46,237,97,84,56,79,46,31,2,54,32,22,2,2,16,10,6
"2021","Warrington 009B","E01012562",820,130,34,96,649,47,454,148,231,75,99,52,47,0,48,36,12,1,1,41,23,18
"2021","Warrington 009E","E01035384",496,102,27,75,379,13,226,69,119,38,75,49,23,3,64,40,24,1,1,15,6,9
"2021","Warrington 009F","E01035385",580,70,17,53,486,24,290,89,160,41,109,73,33,3,62,49,13,1,1,24,19,5
"2021","Warrington 009G","E01035386",554,70,20,50,462,29,298,80,166,52,106,63,42,1,28,12,16,1,1,22,12,10
"2021","Warrington 009H","E01035387",578,150,14,136,403,15,229,38,163,28,83,48,32,3,71,51,20,5,5,25,12,13
"2021","Warrington 009I","E01035388",564,94,26,68,446,33,285,69,164,52,77,42,34,1,49,33,16,2,2,24,14,10
"2021","Warrington 010A","E01012563",679,111,53,58,538,105,339,115,141,83,56,29,21,6,38,16,22,0,0,30,12,18
"2021","Warrington 010B","E01012564",522,123,51,72,367,44,223,95,70,58,61,37,16,8,37,17,20,2,2,32,9,23
"2021","Warrington 010D","E01012566",728,134,50,84,534,37,373,93,219,61,66,32,28,6,55,35,20,3,3,60,34,26
"2021","Warrington 010E","E01012569",711,154,60,94,531,70,316,107,153,56,86,42,38,6,57,36,21,2,2,26,13,13
"2021","Warrington 010F","E01012570",598,271,106,165,309,58,138,57,40,41,51,29,18,4,61,42,19,1,1,18,9,9
"2021","Warrington 010G","E01035389",598,156,62,94,411,49,243,70,114,59,53,28,24,1,62,35,27,4,4,31,17,14
"2021","Warrington 010H","E01035390",549,126,17,109,396,27,244,63,145,36,73,32,39,2,51,39,12,1,1,27,12,15
"2021","Warrington 011A","E01012481",714,239,71,168,445,24,171,70,78,23,113,55,47,11,125,80,45,12,12,30,13,17
"2021","Warrington 011B","E01012482",868,427,195,232,407,45,142,63,51,28,99,52,41,6,110,75,35,11,11,34,7,27
"2021","Warrington 011C","E01012520",650,215,81,134,396,34,157,55,66,36,78,29,39,10,120,76,44,7,7,39,22,17
"2021","Warrington 011D","E01012523",647,212,69,143,394,36,148,63,42,43,107,53,44,10,94,65,29,9,9,41,17,24
"2021","Warrington 011E","E01012524",635,156,94,62,454,77,221,81,79,61,96,42,45,9,58,28,30,2,2,25,9,16
"2021","Warrington 011F","E01012525",653,186,68,118,420,32,183,73,78,32,103,52,41,10,97,60,37,5,5,47,12,35
"2021","Warrington 012A","E01012478",940,280,101,179,619,44,282,91,135,56,155,66,82,7,131,93,38,7,7,41,12,29
"2021","Warrington 012B","E01012547",677,169,104,65,488,71,258,80,121,57,78,34,39,5,79,45,34,2,2,20,5,15
"2021","Warrington 012C","E01012548",735,171,93,78,530,92,306,106,127,73,79,40,31,8,51,28,23,2,2,34,6,28
"2021","Warrington 012D","E01012549",762,193,127,66,543,119,261,106,111,44,106,51,49,6,55,27,28,2,2,26,14,12
"2021","Warrington 012E","E01012550",731,185,109,76,527,117,253,107,95,51,95,45,42,8,61,33,28,1,1,19,9,10
"2021","Warrington 013A","E01012453",701,172,62,110,498,18,193,50,106,37,101,31,62,8,181,145,36,5,5,31,18,13
"2021","Warrington 013B","E01012454",1111,353,67,286,696,37,337,110,180,47,165,88,68,9,146,112,34,11,11,62,15,47
"2021","Warrington 013C","E01012455",880,308,105,203,527,26,199,70,100,29,118,55,58,5,168,126,42,16,16,45,22,23
"2021","Warrington 013D","E01012457",841,354,70,284,431,26,176,69,76,31,111,66,35,10,109,82,27,9,9,56,18,38
"2021","Warrington 014A","E01012551",605,115,65,50,466,81,272,92,107,73,60,22,32,6,52,28,24,1,1,24,17,7
"2021","Warrington 014B","E01012552",615,190,116,74,395,83,170,65,74,31,81,40,38,3,58,40,18,3,3,30,11,19
"2021","Warrington 014C","E01012553",500,79,44,35,408,94,235,95,78,62,47,21,21,5,31,15,16,1,1,13,8,5
"2021","Warrington 014D","E01012555",519,114,73,41,382,73,229,80,86,63,39,14,20,5,41,20,21,0,0,23,11,12
"2021","Warrington 014E","E01012556",628,172,117,55,433,100,229,89,82,58,48,20,25,3,54,21,33,2,2,23,6,17
"2021","Warrington 015A","E01012491",606,177,111,66,410,90,190,68,75,47,57,22,28,7,71,36,35,2,2,19,6,13
"2021","Warrington 015B","E01012492",603,132,93,39,452,122,227,89,87,51,63,33,27,3,38,23,15,2,2,19,10,9
"2021","Warrington 015C","E01012493",659,142,72,70,499,88,274,86,125,63,76,42,31,3,56,27,29,5,5,18,11,7
"2021","Warrington 015D","E01012494",782,162,67,95,601,58,348,120,165,63,139,90,47,2,54,31,23,2,2,19,10,9
"2021","Warrington 015E","E01012500",588,151,88,63,416,112,200,66,84,50,60,29,28,3,43,18,25,1,1,21,11,10
"2021","Warrington 016A","E01012495",643,152,42,110,460,48,270,89,122,59,80,39,36,5,59,34,25,3,3,31,11,20
"2021","Warrington 016B","E01012496",582,144,77,67,416,82,221,86,93,42,64,31,32,1,47,24,23,2,2,22,12,10
"2021","Warrington 016C","E01012497",513,162,84,78,322,47,149,52,62,35,47,15,24,8,75,43,32,4,4,29,19,10
"2021","Warrington 016D","E01012498",658,238,102,136,395,51,188,57,89,42,62,22,33,7,93,62,31,1,1,25,13,12
"2021","Warrington 016E","E01012499",738,174,78,96,528,76,266,83,137,46,98,41,49,8,86,53,33,2,2,36,17,19
"2021","Warrington 016F","E01012501",594,157,60,97,414,75,197,68,86,43,83,51,27,5,55,32,23,4,4,23,5,18
"2021","Warrington 017A","E01012479",803,355,99,256,399,31,131,48,57,26,102,54,45,3,125,81,44,10,10,49,21,28
"2021","Warrington 017B","E01012480",1089,459,79,380,566,28,232,97,112,23,178,124,46,8,107,71,36,21,21,64,16,48
"2021","Warrington 017D","E01012510",1082,495,135,360,535,41,242,88,113,41,140,87,48,5,100,65,35,12,12,52,17,35
"2021","Warrington 017E","E01012511",803,321,99,222,436,38,137,56,50,31,140,89,49,2,107,76,31,14,14,46,13,33
"2021","Warrington 017F","E01033299",1106,414,35,379,622,10,204,60,122,22,202,114,80,8,194,166,28,12,12,70,24,46
"2021","Warrington 017G","E01033303",591,270,53,217,285,20,110,54,42,14,91,59,29,3,57,36,21,7,7,36,8,28
"2021","Warrington 018B","E01012458",1146,344,94,250,746,34,298,95,155,48,203,103,92,8,190,120,70,21,21,56,14,42
"2021","Warrington 018C","E01012483",881,458,171,287,373,21,118,53,49,16,104,58,40,6,120,86,34,10,10,50,19,31
"2021","Warrington 018D","E01012509",1124,459,182,277,635,118,274,118,105,51,148,105,36,7,89,45,44,6,6,30,9,21
"2021","Warrington 018E","E01012512",730,237,142,95,465,118,188,86,70,32,92,49,35,8,62,18,44,5,5,28,7,21
"2021","Warrington 018F","E01033300",987,580,75,505,340,16,105,58,41,6,161,144,15,2,33,23,10,25,25,67,7,60
"2021","Warrington 018G","E01033302",777,322,66,256,395,18,169,62,89,18,114,78,31,5,87,59,28,7,7,60,15,45
"2021","Warrington 019A","E01012527",632,164,91,73,451,70,227,77,101,49,85,39,39,7,65,34,31,4,4,17,6,11
"2021","Warrington 019B","E01012528",499,130,101,29,354,111,173,53,71,49,35,17,15,3,33,15,18,2,2,15,5,10
"2021","Warrington 019C","E01012529",644,200,115,85,424,121,181,60,80,41,72,35,29,8,48,21,27,2,2,20,9,11
"2021","Warrington 019D","E01012530",528,111,59,52,404,78,254,84,108,62,44,25,18,1,25,8,17,3,3,13,5,8
"2021","Warrington 019E","E01012531",664,198,130,68,458,107,197,63,84,50,83,37,42,4,67,30,37,4,4,8,3,5
"2021","Warrington 019F","E01012532",599,178,124,54,403,128,187,68,68,51,48,17,25,6,37,16,21,3,3,18,4,14
"2021","Warrington 020B","E01012505",666,265,82,183,371,40,156,65,59,32,84,46,33,5,88,60,28,3,3,30,15,15
"2021","Warrington 020C","E01012506",664,226,56,170,399,21,168,44,84,40,110,47,50,13,100,67,33,0,0,39,15,24
"2021","Warrington 020D","E01012507",985,492,126,366,437,38,145,61,52,32,126,80,41,5,120,88,32,8,8,56,24,32
"2021","Warrington 020E","E01012508",772,315,94,221,419,26,166,59,80,27,106,54,44,8,116,77,39,5,5,38,21,17
"2021","Warrington 020F","E01035391",648,141,16,125,492,10,232,55,152,25,124,52,69,3,124,106,18,2,2,15,6,9
"2021","Warrington 020G","E01035392",658,237,64,173,397,24,147,51,62,34,128,77,46,5,90,67,23,8,8,24,9,15
"2021","Warrington 021A","E01012513",830,243,133,110,576,110,338,99,195,44,64,31,31,2,62,45,17,2,2,11,6,5
"2021","Warrington 021B","E01012514",758,197,107,90,541,108,331,92,188,51,47,23,19,5,54,37,17,1,1,20,10,10
"2021","Warrington 021C","E01012515",676,215,125,90,439,82,215,76,98,41,81,39,34,8,58,37,21,3,3,22,9,13
"2021","Warrington 021D","E01012516",583,198,110,88,367,84,198,70,101,27,46,33,10,3,38,21,17,1,1,18,8,10
"2021","Warrington 021E","E01012517",934,240,108,132,661,94,354,94,211,49,109,50,54,5,104,69,35,0,0,33,12,21
"2021","Warrington 021F","E01012518",898,245,108,137,619,103,333,100,184,49,89,55,31,3,91,67,24,3,3,34,14,20
"2021","Warrington 021G","E01012519",631,172,97,75,441,99,242,81,117,44,54,25,27,2,44,24,20,2,2,18,10,8
"2021","Warrington 022A","E01012485",670,196,83,113,460,75,241,72,117,52,73,36,32,5,70,48,22,1,1,14,7,7
"2021","Warrington 022B","E01012486",643,188,117,71,438,69,251,92,117,42,82,50,30,2,36,24,12,0,0,17,8,9
"2021","Warrington 022C","E01012487",636,174,103,71,443,67,252,83,126,43,84,38,41,5,39,21,18,1,1,19,7,12
"2021","Warrington 022D","E01012489",668,119,76,43,529,93,342,102,184,56,55,26,27,2,37,18,19,2,2,20,12,8
"2021","Warrington 022E","E01012490",639,180,121,59,440,110,231,82,99,50,63,34,23,6,35,9,26,1,1,19,4,15
"2021","Warrington 023A","E01012450",636,217,177,40,400,89,222,78,106,38,45,22,18,5,42,21,21,2,2,19,6,13
"2021","Warrington 023B","E01012451",618,189,110,79,412,35,212,73,102,37,68,29,38,1,96,57,39,1,1,17,5,12
"2021","Warrington 023C","E01012557",757,291,101,190,454,62,207,88,88,31,108,78,24,6,74,46,28,3,3,12,3,9
"2021","Warrington 023D","E01012558",753,221,88,133,507,65,272,93,124,55,108,69,33,6,60,40,20,2,2,25,7,18
"2021","Warrington 023E","E01012559",592,127,72,55,450,90,269,78,151,40,64,35,26,3,27,12,15,0,0,15,3,12
"2021","Warrington 023F","E01012560",635,197,102,95,424,88,222,64,120,38,54,23,27,4,60,32,28,0,0,14,10,4
"2021","Warrington 024A","E01012448",551,104,60,44,426,80,245,100,101,44,70,49,17,4,29,21,8,2,2,21,6,15
"2021","Warrington 024B","E01012488",738,163,105,58,543,142,303,105,153,45,52,30,20,2,44,21,23,2,2,32,11,21
"2021","Warrington 024C","E01012502",638,134,73,61,471,94,271,98,125,48,64,38,17,9,40,21,19,2,2,33,12,21
"2021","Warrington 024D","E01012503",709,121,45,76,572,62,329,110,155,64,123,75,44,4,58,40,18,0,0,16,4,12
"2021","Warrington 025A","E01012446",523,79,52,27,433,123,253,90,107,56,31,6,20,5,26,11,15,0,0,11,6,5
"2021","Warrington 025B","E01012447",492,47,27,20,427,71,300,104,139,57,33,13,16,4,22,11,11,1,1,18,5,13
"2021","Warrington 025C","E01012449",635,172,132,40,449,170,214,85,87,42,40,22,16,2,25,14,11,0,0,14,6,8
"2021","Warrington 025D","E01012452",727,167,111,56,543,130,339,121,167,51,41,23,16,2,30,13,17,3,3,17,6,11
"2021","Blackburn with Darwen 001A","E01012607",649,211,110,101,404,77,203,65,99,39,58,25,22,11,63,36,27,3,3,34,20,14
"2021","Blackburn with Darwen 001B","E01012608",811,246,76,170,518,21,277,61,189,27,89,33,52,4,127,81,46,4,4,47,30,17
"2021","Blackburn with Darwen 001C","E01012633",720,247,93,154,434,59,202,62,105,35,65,25,32,8,101,69,32,7,7,39,22,17
"2021","Blackburn with Darwen 001D","E01012634",612,164,60,104,414,37,235,70,131,34,64,26,33,5,75,56,19,3,3,34,28,6
"2021","Blackburn with Darwen 001E","E01012635",582,115,61,54,405,49,278,46,187,45,28,12,13,3,49,26,23,1,1,62,39,23
"2021","Blackburn with Darwen 001F","E01012636",751,221,134,87,507,120,222,67,109,46,90,37,45,8,70,36,34,5,5,23,17,6
"2021","Blackburn with Darwen 002A","E01012581",500,104,62,42,371,70,209,63,120,26,39,16,23,0,51,31,20,2,2,25,17,8
"2021","Blackburn with Darwen 002B","E01012582",511,75,43,32,387,65,269,55,161,53,17,5,7,5,35,18,17,1,1,49,26,23
"2021","Blackburn with Darwen 002C","E01012583",716,153,82,71,522,87,315,79,192,44,65,30,30,5,54,31,23,1,1,41,25,16
"2021","Blackburn with Darwen 002D","E01012587",662,142,44,98,445,26,309,40,227,42,41,17,22,2,63,38,25,6,6,75,50,25
"2021","Blackburn with Darwen 002E","E01012588",611,89,32,57,449,24,333,43,242,48,28,13,14,1,59,40,19,5,5,73,49,24
"2021","Blackburn with Darwen 003A","E01012574",545,203,92,111,306,32,180,30,115,35,31,9,20,2,58,39,19,5,5,36,22,14
"2021","Blackburn with Darwen 003B","E01012577",522,86,30,56,345,5,261,27,182,52,20,6,12,2,54,40,14,5,5,91,68,23
"2021","Blackburn with Darwen 003C","E01012578",563,87,26,61,403,17,267,43,167,57,18,8,10,0,92,61,31,9,9,73,54,19
"2021","Blackburn with Darwen 003D","E01012605",664,143,66,77,418,25,309,40,222,47,19,8,11,0,59,37,22,6,6,103,76,27
"2021","Blackburn with Darwen 003E","E01012606",473,80,21,59,334,18,230,31,158,41,26,7,17,2,48,32,16,12,12,59,48,11
"2021","Blackburn with Darwen 004A","E01012579",547,148,60,88,333,15,230,26,154,50,16,8,6,2,67,38,29,5,5,66,42,24
"2021","Blackburn with Darwen 004B","E01012580",551,53,26,27,393,27,293,46,179,68,15,3,12,0,53,18,35,5,5,105,84,21
"2021","Blackburn with Darwen 004C","E01012642",512,106,28,78,319,24,202,29,138,35,19,5,14,0,64,40,24,10,10,87,63,24
"2021","Blackburn with Darwen 004D","E01012645",592,94,35,59,430,22,336,53,213,70,24,2,19,3,44,30,14,4,4,68,40,28
"2021","Blackburn with Darwen 005A","E01012585",476,98,35,63,300,25,195,38,126,31,25,10,9,6,49,30,19,6,6,78,60,18
"2021","Blackburn with Darwen 005B","E01012586",499,165,25,140,240,9,168,23,118,27,23,14,9,0,34,16,18,6,6,94,69,25
"2021","Blackburn with Darwen 005C","E01012656",660,229,60,169,374,13,219,40,143,36,45,22,19,4,90,54,36,7,7,57,31,26
"2021","Blackburn with Darwen 005D","E01012657",672,184,50,134,411,18,236,35,162,39,35,10,23,2,115,87,28,7,7,77,54,23
"2021","Blackburn with Darwen 005E","E01012658",740,231,84,147,459,41,222,61,129,32,84,42,38,4,102,72,30,10,10,50,27,23
"2021","Blackburn with Darwen 006A","E01012629",509,178,40,138,303,7,154,41,92,21,58,26,26,6,81,61,20,3,3,28,20,8
"2021","Blackburn with Darwen 006B","E01012631",616,260,79,181,312,15,151,32,105,14,50,24,25,1,92,74,18,4,4,44,22,22
"2021","Blackburn with Darwen 006C","E01012643",600,244,76,168,292,22,181,22,113,46,11,11,0,0,73,39,34,5,5,64,43,21
"2021","Blackburn with Darwen 006D","E01012644",698,128,38,90,442,43,312,64,166,82,22,10,10,2,56,29,27,9,9,128,92,36
"2021","Blackburn with Darwen 006E","E01012655",999,566,177,389,378,21,138,33,90,15,52,28,20,4,159,111,48,8,8,55,29,26
"2021","Blackburn with Darwen 007A","E01012571",482,104,26,78,309,7,217,30,145,42,18,4,12,2,62,42,20,5,5,69,50,19
"2021","Blackburn with Darwen 007B","E01012572",486,146,49,97,289,22,166,37,98,31,12,3,5,4,84,52,32,5,5,51,38,13
"2021","Blackburn with Darwen 007C","E01012573",467,65,26,39,330,16,244,35,158,51,12,2,9,1,55,28,27,3,3,72,51,21
"2021","Blackburn with Darwen 007D","E01012575",511,230,104,126,236,24,143,35,83,25,18,7,11,0,48,29,19,3,3,45,32,13
"2021","Blackburn with Darwen 007E","E01012630",592,77,23,54,425,11,301,47,205,49,29,10,13,6,78,48,30,6,6,90,71,19
"2021","Blackburn with Darwen 008A","E01012576",586,210,101,109,319,26,197,36,122,39,23,9,12,2,69,46,23,4,4,57,29,28
"2021","Blackburn with Darwen 008B","E01012637",664,183,57,126,424,19,134,33,72,29,78,20,50,8,187,144,43,6,6,57,30,27
"2021","Blackburn with Darwen 008C","E01012638",678,232,66,166,410,23,144,38,72,34,94,28,57,9,144,106,38,5,5,36,22,14
"2021","Blackburn with Darwen 008D","E01012639",732,184,53,131,498,27,193,42,117,34,83,25,53,5,179,126,53,16,16,50,32,18
"2021","Blackburn with Darwen 008E","E01012640",751,232,68,164,463,43,233,53,138,42,72,32,34,6,108,76,32,7,7,56,39,17
"2021","Blackburn with Darwen 008F","E01012641",569,114,46,68,410,15,191,35,132,24,50,13,30,7,148,105,43,6,6,45,34,11
"2021","Blackburn with Darwen 009A","E01012595",969,362,120,242,562,22,183,65,86,32,160,66,84,10,188,135,53,9,9,45,24,21
"2021","Blackburn with Darwen 009B","E01012596",827,268,73,195,496,23,199,59,116,24,105,42,58,5,152,99,53,17,17,63,39,24
"2021","Blackburn with Darwen 009C","E01012622",727,328,97,231,345,15,130,40,71,19,60,24,33,3,123,96,27,17,17,54,26,28
"2021","Blackburn with Darwen 009D","E01012623",627,245,69,176,354,24,124,41,58,25,82,29,44,9,117,91,26,7,7,28,14,14
"2021","Blackburn with Darwen 009E","E01012624",697,289,116,173,383,40,115,48,43,24,89,33,47,9,134,97,37,5,5,25,10,15
"2021","Blackburn with Darwen 009F","E01012625",854,328,107,221,489,27,135,54,55,26,139,74,59,6,182,142,40,6,6,37,18,19
"2021","Blackburn with Darwen 010A","E01012584",545,153,92,61,341,58,224,48,130,46,34,19,12,3,22,13,9,3,3,51,35,16
"2021","Blackburn with Darwen 010B","E01012609",675,164,104,60,492,119,235,96,93,46,91,42,41,8,45,22,23,2,2,19,7,12
"2021","Blackburn with Darwen 010C","E01012610",525,133,69,64,371,65,196,73,78,45,50,17,26,7,60,30,30,0,0,21,14,7
"2021","Blackburn with Darwen 010D","E01012611",486,142,64,78,323,72,152,69,44,39,65,26,35,4,31,12,19,3,3,21,8,13
"2021","Blackburn with Darwen 010E","E01012612",616,164,109,55,434,129,183,78,60,45,70,32,33,5,51,20,31,1,1,18,5,13
"2021","Blackburn with Darwen 010F","E01012613",733,184,102,82,514,77,278,87,132,59,112,50,55,7,46,24,22,1,1,35,17,18
"2021","Blackburn with Darwen 011A","E01012600",625,239,110,129,356,48,115,40,55,20,61,28,29,4,127,83,44,5,5,30,13,17
"2021","Blackburn with Darwen 011B","E01012601",577,148,54,94,384,20,117,31,60,26,80,22,49,9,160,110,50,7,7,45,34,11
"2021","Blackburn with Darwen 011C","E01012602",658,160,57,103,464,35,248,107,94,47,119,56,54,9,60,39,21,2,2,34,19,15
"2021","Blackburn with Darwen 011D","E01012603",697,243,71,172,410,14,127,32,64,31,104,34,62,8,157,122,35,8,8,44,25,19
"2021","Blackburn with Darwen 011E","E01012604",614,143,51,92,421,39,221,65,113,43,85,33,47,5,76,43,33,0,0,50,30,20
"2021","Blackburn with Darwen 011F","E01012632",789,228,83,145,490,41,285,58,176,51,76,36,34,6,82,53,29,6,6,71,46,25
"2021","Blackburn with Darwen 012A","E01012594",619,235,80,155,355,32,107,47,33,27,79,25,44,10,134,99,35,3,3,29,21,8
"2021","Blackburn with Darwen 012B","E01012618",667,217,104,113,418,53,197,76,79,42,82,31,45,6,84,44,40,2,2,32,16,16
"2021","Blackburn with Darwen 012C","E01012619",540,170,76,94,326,32,108,32,38,38,61,16,36,9,120,79,41,5,5,44,24,20
"2021","Blackburn with Darwen 012D","E01012620",672,193,119,74,456,110,192,86,62,44,78,42,28,8,72,40,32,4,4,23,7,16
"2021","Blackburn with Darwen 012E","E01012621",644,226,64,162,388,25,160,67,53,40,100,36,51,13,99,57,42,4,4,30,21,9
"2021","Blackburn with Darwen 013A","E01012593",714,225,81,144,466,58,184,75,80,29,112,47,55,10,104,66,38,8,8,23,7,16
"2021","Blackburn with Darwen 013B","E01012597",665,149,63,86,491,60,282,99,129,54,77,28,40,9,72,43,29,0,0,25,17,8
"2021","Blackburn with Darwen 013C","E01012598",1024,123,37,86,847,47,548,173,297,78,169,76,84,9,76,51,25,7,7,54,27,27
"2021","Blackburn with Darwen 013D","E01012599",530,131,44,87,375,42,150,50,69,31,95,41,48,6,84,55,29,4,4,24,13,11
"2021","Blackburn with Darwen 014A","E01012589",641,256,65,191,359,30,113,47,42,24,96,56,36,4,115,79,36,5,5,26,11,15
"2021","Blackburn with Darwen 014B","E01012590",609,244,113,131,334,36,119,54,49,16,81,40,34,7,89,53,36,9,9,31,12,19
"2021","Blackburn with Darwen 014C","E01012591",694,286,96,190,373,50,163,53,72,38,57,30,22,5,99,60,39,4,4,35,17,18
"2021","Blackburn with Darwen 014D","E01012648",543,193,55,138,319,16,118,45,52,21,81,43,32,6,94,61,33,10,10,31,15,16
"2021","Blackburn with Darwen 014E","E01012652",631,171,97,74,440,85,222,93,78,51,92,49,35,8,40,16,24,1,1,20,10,10
"2021","Blackburn with Darwen 015A","E01012617",597,187,54,133,379,37,166,84,56,26,77,36,35,6,91,64,27,8,8,31,15,16
"2021","Blackburn with Darwen 015B","E01012646",733,258,89,169,436,39,134,54,58,22,114,59,49,6,144,94,50,5,5,39,21,18
"2021","Blackburn with Darwen 015C","E01012647",702,253,95,158,425,61,141,45,63,33,102,48,46,8,116,80,36,5,5,24,14,10
"2021","Blackburn with Darwen 015D","E01012650",605,210,63,147,356,26,133,44,69,20,83,40,38,5,108,75,33,6,6,39,25,14
"2021","Blackburn with Darwen 016A","E01012649",751,361,165,196,354,36,135,62,43,30,81,39,39,3,100,63,37,2,2,36,15,21
"2021","Blackburn with Darwen 016B","E01012651",669,200,68,132,433,47,177,74,66,37,109,55,51,3,96,69,27,4,4,36,12,24
"2021","Blackburn with Darwen 016C","E01012653",645,200,71,129,410,35,167,46,85,36,109,50,48,11,98,75,23,1,1,35,18,17
"2021","Blackburn with Darwen 016D","E01012654",838,371,125,246,424,51,162,66,65,31,98,46,48,4,108,73,35,5,5,43,19,24
"2021","Blackburn with Darwen 017A","E01012614",673,167,78,89,486,79,265,99,111,55,87,34,48,5,53,37,16,2,2,20,8,12
"2021","Blackburn with Darwen 017B","E01012615",713,322,136,186,362,74,125,57,35,33,73,35,28,10,87,56,31,3,3,29,16,13
"2021","Blackburn with Darwen 017C","E01012616",867,268,105,163,575,71,280,97,123,60,143,75,57,11,78,44,34,3,3,24,12,12
"2021","Blackburn with Darwen 017D","E01012659",575,167,58,109,390,62,179,62,67,50,87,37,42,8,59,34,25,3,3,18,6,12
"2021","Blackburn with Darwen 017E","E01012660",475,111,58,53,347,77,204,85,69,50,40,20,17,3,25,10,15,1,1,17,5,12
"2021","Blackburn with Darwen 017F","E01012661",721,274,100,174,421,48,139,57,57,25,115,54,56,5,111,69,42,8,8,26,11,15
"2021","Blackburn with Darwen 018A","E01012592",818,208,93,115,569,122,296,131,112,53,98,51,40,7,50,29,21,3,3,41,22,19
"2021","Blackburn with Darwen 018D","E01012628",498,109,57,52,375,76,208,101,66,41,58,33,18,7,31,18,13,2,2,14,6,8
"2021","Blackburn with Darwen 018E","E01032485",774,164,59,105,576,92,341,136,145,60,97,57,31,9,43,25,18,3,3,34,20,14
"2021","Blackburn with Darwen 018F","E01032486",604,174,99,75,412,103,205,85,76,44,65,31,29,5,38,23,15,1,1,18,14,4
"2021","Blackpool 001A","E01012663",745,307,183,124,396,88,152,52,62,38,74,41,26,7,76,47,29,6,6,42,20,22
"2021","Blackpool 001B","E01012664",712,236,125,111,463,62,210,74,79,57,79,39,36,4,107,69,38,5,5,13,6,7
"2021","Blackpool 001C","E01012665",869,341,228,113,494,154,190,111,54,25,71,39,26,6,79,39,40,0,0,34,11,23
"2021","Blackpool 001D","E01012716",629,212,122,90,388,74,187,84,61,42,66,40,22,4,57,34,23,4,4,29,11,18
"2021","Blackpool 001E","E01012719",622,177,111,66,406,95,168,74,71,23,73,24,45,4,67,32,35,3,3,39,15,24
"2021","Blackpool 002A","E01012662",827,416,245,171,390,140,132,67,34,31,52,35,14,3,64,41,23,2,2,21,6,15
"2021","Blackpool 002B","E01012703",697,242,155,87,429,103,176,73,54,49,67,38,25,4,81,36,45,2,2,26,17,9
"2021","Blackpool 002C","E01012704",1110,581,201,380,509,58,186,87,75,24,99,54,37,8,160,111,49,6,6,20,8,12
"2021","Blackpool 002D","E01012706",704,219,95,124,456,59,197,89,72,36,109,45,56,8,84,56,28,7,7,29,15,14
"2021","Blackpool 002E","E01012717",708,209,130,79,466,113,239,106,70,63,59,25,29,5,54,27,27,1,1,33,14,19
"2021","Blackpool 003A","E01012666",665,283,103,180,348,64,139,61,47,31,61,34,23,4,80,51,29,4,4,34,13,21
"2021","Blackpool 003B","E01012667",651,177,103,74,445,83,212,89,74,49,74,41,25,8,71,36,35,5,5,29,12,17
"2021","Blackpool 003C","E01012668",717,249,149,100,434,89,168,67,69,32,89,44,36,9,84,47,37,4,4,34,19,15
"2021","Blackpool 003D","E01012669",874,407,196,211,409,80,176,76,64,36,91,49,36,6,59,32,27,3,3,58,19,39
"2021","Blackpool 003E","E01012718",743,227,161,66,498,142,227,104,81,42,73,32,36,5,53,20,33,3,3,18,10,8
"2021","Blackpool 004A","E01012690",731,212,84,128,495,71,215,93,80,42,108,50,50,8,98,69,29,3,3,24,8,16
"2021","Blackpool 004B","E01012691",800,222,99,123,544,78,211,86,83,42,113,45,61,7,131,80,51,11,11,34,14,20
"2021","Blackpool 004C","E01012692",813,343,133,210,436,61,169,81,56,32,100,52,39,9,101,64,37,5,5,34,14,20
"2021","Blackpool 004D","E01012705",719,287,113,174,397,64,145,51,63,31,91,39,43,9,92,65,27,5,5,35,13,22
"2021","Blackpool 004E","E01012723",642,225,89,136,389,53,184,82,61,41,82,35,38,9,69,44,25,1,1,28,10,18
"2021","Blackpool 005A","E01012693",726,237,112,125,452,78,169,72,60,37,101,48,45,8,96,60,36,8,8,37,16,21
"2021","Blackpool 005B","E01012711",618,175,69,106,398,46,136,58,44,34,103,55,44,4,104,70,34,9,9,45,25,20
"2021","Blackpool 005C","E01012747",624,134,74,60,457,79,252,95,98,59,69,28,38,3,55,28,27,2,2,33,12,21
"2021","Blackpool 005D","E01012750",738,221,89,132,458,59,192,66,73,53,103,39,60,4,100,59,41,4,4,59,24,35
"2021","Blackpool 006A","E01012681",862,545,104,441,244,4,81,40,27,14,81,56,22,3,69,50,19,9,9,73,11,62
"2021","Blackpool 006B","E01012683",651,344,64,280,252,16,86,26,40,20,71,45,25,1,77,50,27,2,2,55,25,30
"2021","Blackpool 006C","E01012748",736,348,97,251,317,33,124,55,44,25,87,54,29,4,68,44,24,5,5,71,19,52
"2021","Blackpool 006D","E01012749",691,300,98,202,333,64,138,49,63,26,66,31,32,3,60,44,16,5,5,58,25,33
"2021","Blackpool 007A","E01012707",626,267,110,157,325,25,117,41,48,28,74,38,34,2,101,63,38,8,8,34,9,25
"2021","Blackpool 007B","E01012720",656,192,74,118,422,28,147,44,72,31,96,31,59,6,141,86,55,10,10,42,24,18
"2021","Blackpool 007C","E01012721",768,326,85,241,397,19,118,39,53,26,86,29,53,4,174,116,58,0,0,45,22,23
"2021","Blackpool 007D","E01012724",665,307,108,199,316,15,110,36,44,30,64,16,40,8,124,85,39,3,3,42,21,21
"2021","Blackpool 008A","E01012678",463,173,47,126,257,11,81,29,44,8,65,21,42,2,97,75,22,3,3,33,17,16
"2021","Blackpool 008B","E01012679",634,254,68,186,330,16,99,41,42,16,86,35,46,5,120,96,24,9,9,50,18,32
"2021","Blackpool 008C","E01012680",752,280,81,199,419,27,121,43,52,26,116,54,50,12,149,108,41,6,6,53,30,23
"2021","Blackpool 008D","E01012682",793,446,126,320,292,18,85,46,24,15,71,33,31,7,108,74,34,10,10,55,19,36
"2021","Blackpool 008E","E01012684",672,281,80,201,348,18,94,37,40,17,100,48,46,6,124,84,40,12,12,43,21,22
"2021","Blackpool 009A","E01012676",626,213,91,122,374,32,148,44,65,39,98,53,32,13,95,64,31,1,1,39,6,33
"2021","Blackpool 009B","E01012677",641,221,100,121,369,46,152,64,51,37,89,49,27,13,79,49,30,3,3,51,19,32
"2021","Blackpool 009C","E01012708",605,211,85,126,367,36,145,65,58,22,79,39,33,7,102,65,37,5,5,27,12,15
"2021","Blackpool 009D","E01012709",738,274,86,188,426,30,120,56,42,22,100,54,38,8,168,128,40,8,8,38,11,27
"2021","Blackpool 009E","E01012710",481,122,61,61,332,53,149,61,50,38,71,28,36,7,56,37,19,3,3,27,7,20
"2021","Blackpool 009F","E01012722",507,148,42,106,324,42,169,69,71,29,72,44,23,5,38,21,17,3,3,35,11,24
"2021","Blackpool 010A","E01012673",625,320,82,238,258,5,84,31,39,14,55,22,29,4,104,74,30,10,10,47,26,21
"2021","Blackpool 010B","E01012675",709,269,64,205,374,16,121,54,56,11,84,37,43,4,144,103,41,9,9,66,32,34
"2021","Blackpool 010C","E01012735",671,373,109,264,241,26,102,50,28,24,54,36,12,6,51,33,18,8,8,57,15,42
"2021","Blackpool 010D","E01012736",684,377,67,310,258,25,92,62,19,11,71,62,6,3,58,41,17,12,12,49,8,41
"2021","Blackpool 010E","E01012737",701,408,117,291,226,15,77,39,26,12,51,29,18,4,74,50,24,9,9,67,20,47
"2021","Blackpool 011A","E01012670",617,217,59,158,354,16,102,28,59,15,98,39,53,6,129,97,32,9,9,46,28,18
"2021","Blackpool 011B","E01012733",468,176,54,122,252,19,73,32,27,14,68,39,27,2,86,52,34,6,6,40,12,28
"2021","Blackpool 011C","E01012734",635,220,70,150,357,22,137,55,57,25,92,45,40,7,101,70,31,5,5,58,21,37
"2021","Blackpool 011D","E01012738",569,219,58,161,290,19,97,30,50,17,69,34,31,4,95,76,19,10,10,60,30,30
"2021","Blackpool 011E","E01012739",578,174,61,113,351,18,110,47,44,19,85,30,45,10,132,81,51,6,6,53,19,34
"2021","Blackpool 011F","E01012742",523,180,81,99,303,44,112,48,38,26,78,38,30,10,62,35,27,7,7,40,12,28
"2021","Blackpool 012A","E01012712",698,164,75,89,509,64,231,95,76,60,126,49,62,15,84,61,23,4,4,25,13,12
"2021","Blackpool 012B","E01012713",813,239,84,155,533,60,228,97,89,42,113,52,58,3,130,89,41,2,2,41,16,25
"2021","Blackpool 012C","E01012715",702,249,97,152,416,50,164,71,54,39,96,50,42,4,99,58,41,7,7,37,10,27
"2021","Blackpool 012D","E01012740",678,268,131,137,383,53,194,76,72,46,64,28,28,8,66,43,23,6,6,27,10,17
"2021","Blackpool 012E","E01012741",606,195,92,103,380,61,150,49,68,33,92,41,48,3,72,54,18,5,5,31,11,20
"2021","Blackpool 013A","E01012671",636,323,85,238,258,28,84,44,27,13,62,38,22,2,70,53,17,14,14,55,21,34
"2021","Blackpool 013B","E01012672",661,290,57,233,299,12,109,52,38,19,74,39,32,3,93,71,22,11,11,72,27,45
"2021","Blackpool 013C","E01012674",760,321,84,237,368,21,120,39,59,22,80,27,40,13,136,79,57,11,11,71,33,38
"2021","Blackpool 013D","E01012751",776,464,102,362,257,20,82,45,26,11,68,44,22,2,74,45,29,13,13,55,16,39
"2021","Blackpool 014A","E01012686",635,222,79,143,373,24,122,50,50,22,82,30,40,12,139,88,51,6,6,40,20,20
"2021","Blackpool 014B","E01012687",546,190,63,127,318,32,104,36,46,22,72,22,37,13,105,66,39,5,5,38,19,19
"2021","Blackpool 014C","E01012688",620,299,182,117,307,79,117,71,28,18,46,29,14,3,63,43,20,2,2,14,3,11
"2021","Blackpool 014D","E01012689",678,255,110,145,394,75,145,76,47,22,101,51,46,4,68,47,21,5,5,29,12,17
"2021","Blackpool 014E","E01012714",905,331,147,184,533,86,225,100,85,40,134,81,48,5,86,57,29,2,2,41,14,27
"2021","Blackpool 015A","E01012695",622,196,56,140,394,26,131,44,63,24,91,36,49,6,139,91,48,7,7,32,13,19
"2021","Blackpool 015B","E01012743",747,287,81,206,385,27,132,55,56,21,102,49,48,5,116,71,45,8,8,75,28,47
"2021","Blackpool 015C","E01012744",754,274,102,172,423,41,130,57,41,32,88,41,37,10,159,122,37,5,5,57,15,42
"2021","Blackpool 015D","E01012745",741,251,108,143,436,64,153,69,47,37,95,48,39,8,116,78,38,8,8,54,26,28
"2021","Blackpool 015E","E01012746",771,256,105,151,471,41,171,78,63,30,106,51,44,11,147,101,46,6,6,44,11,33
"2021","Blackpool 016A","E01012685",635,197,69,128,402,35,141,71,53,17,97,49,43,5,124,93,31,5,5,36,12,24
"2021","Blackpool 016B","E01012694",614,213,105,108,366,35,135,49,63,23,96,52,35,9,97,59,38,3,3,35,15,20
"2021","Blackpool 016C","E01012696",664,194,72,122,425,44,146,57,62,27,103,39,53,11,127,83,44,5,5,45,15,30
"2021","Blackpool 016D","E01012697",660,287,156,131,348,80,117,55,36,26,62,32,26,4,86,44,42,3,3,25,12,13
"2021","Blackpool 016E","E01012698",648,172,72,100,435,35,143,38,66,39,93,31,52,10,164,109,55,0,0,41,24,17
"2021","Blackpool 017A","E01012726",798,317,146,171,448,89,181,71,72,38,98,51,40,7,75,47,28,5,5,33,18,15
"2021","Blackpool 017B","E01012728",688,272,106,166,377,50,140,51,53,36,78,40,32,6,104,67,37,5,5,39,13,26
"2021","Blackpool 017C","E01012752",589,270,95,175,268,38,104,52,28,24,68,34,34,0,57,26,31,1,1,51,20,31
"2021","Blackpool 017D","E01012753",469,142,66,76,293,24,145,54,55,36,64,28,33,3,57,32,25,3,3,34,12,22
"2021","Blackpool 017E","E01012754",564,235,71,164,298,26,124,50,48,26,77,39,34,4,62,41,21,9,9,31,10,21
"2021","Blackpool 017F","E01012755",618,202,88,114,380,57,179,75,68,36,82,32,44,6,61,43,18,1,1,36,15,21
"2021","Blackpool 018A","E01012701",635,176,87,89,424,78,163,63,55,45,88,42,35,11,93,63,30,2,2,35,16,19
"2021","Blackpool 018B","E01012729",769,247,146,101,485,121,187,88,62,37,82,41,31,10,91,56,35,4,4,37,15,22
"2021","Blackpool 018C","E01012730",847,235,80,155,562,113,286,113,113,60,94,49,36,9,66,41,25,3,3,50,17,33
"2021","Blackpool 018D","E01012731",727,256,127,129,438,66,172,82,55,35,101,49,45,7,95,66,29,4,4,33,12,21
"2021","Blackpool 018E","E01012732",924,399,219,180,491,90,205,99,69,37,85,44,38,3,110,68,42,1,1,34,15,19
"2021","Blackpool 019A","E01012699",748,226,117,109,488,78,203,91,70,42,94,45,45,4,106,70,36,7,7,34,15,19
"2021","Blackpool 019B","E01012700",779,217,123,94,525,73,226,95,85,46,102,48,45,9,123,82,41,1,1,37,15,22
"2021","Blackpool 019C","E01012702",751,386,211,175,334,72,104,45,36,23,65,25,31,9,92,54,38,1,1,31,14,17
"2021","Blackpool 019D","E01012725",581,171,95,76,376,69,159,57,58,44,80,38,34,8,67,42,25,1,1,34,7,27
"2021","Blackpool 019E","E01012727",663,172,106,66,459,81,228,94,75,59,95,47,43,5,52,26,26,3,3,32,15,17
"2021","Cheshire East 022B","E01018411",989,206,140,66,747,200,428,167,194,67,69,36,25,8,47,23,24,3,3,36,19,17
"2021","Cheshire East 022C","E01018412",697,168,107,61,505,160,252,115,85,52,47,22,25,0,43,28,15,3,3,24,10,14
"2021","Cheshire East 022D","E01034663",877,183,62,121,660,83,339,107,180,52,155,87,63,5,81,63,18,2,2,34,13,21
"2021","Cheshire East 022E","E01034664",595,154,97,57,418,98,242,98,97,47,45,24,17,4,32,17,15,1,1,23,12,11
"2021","Cheshire East 023A","E01018413",615,121,65,56,478,82,262,74,136,52,82,45,36,1,52,33,19,0,0,16,7,9
"2021","Cheshire East 023B","E01018414",709,211,125,86,481,167,238,79,119,40,40,24,14,2,36,23,13,0,0,17,7,10
"2021","Cheshire East 023C","E01018415",818,295,204,91,500,110,217,74,110,33,101,60,40,1,69,43,26,3,3,23,8,15
"2021","Cheshire East 023D","E01018416",704,147,83,64,543,116,290,76,161,53,70,37,26,7,66,53,13,1,1,14,5,9
"2021","Cheshire East 024A","E01018424",775,247,103,144,504,94,277,129,97,51,89,52,33,4,41,19,22,3,3,24,7,17
"2021","Cheshire East 024B","E01018425",798,319,157,162,460,87,234,91,103,40,84,45,33,6,52,30,22,3,3,19,6,13
"2021","Cheshire East 024C","E01018426",712,239,141,98,448,92,215,84,63,68,72,36,28,8,65,32,33,4,4,25,9,16
"2021","Cheshire East 024D","E01018427",503,104,68,36,391,71,233,112,75,46,41,21,19,1,46,18,28,0,0,8,3,5
"2021","Cheshire East 025A","E01018419",950,199,60,139,719,54,384,143,183,58,165,86,76,3,114,77,37,2,2,32,15,17
"2021","Cheshire East 025B","E01018420",746,160,59,101,552,53,347,115,173,59,88,57,26,5,61,37,24,3,3,34,16,18
"2021","Cheshire East 025C","E01018421",556,172,50,122,374,32,204,76,88,40,92,53,36,3,44,30,14,2,2,10,6,4
"2021","Cheshire East 025D","E01018422",591,162,88,74,403,71,178,68,76,34,92,45,37,10,62,41,21,0,0,26,9,17
"2021","Cheshire East 025E","E01018423",638,201,96,105,408,60,172,58,79,35,90,43,37,10,81,51,30,5,5,29,7,22
"2021","Cheshire East 026A","E01018395",896,261,106,155,600,124,289,115,133,41,116,73,37,6,68,38,30,3,3,35,5,30
"2021","Cheshire East 026B","E01018396",611,174,97,77,417,84,183,66,80,37,68,24,39,5,81,57,24,1,1,20,6,14
"2021","Cheshire East 026C","E01018400",1140,455,99,356,641,46,251,90,120,41,161,73,81,7,177,135,42,6,6,44,20,24
"2021","Cheshire East 026D","E01018401",627,152,72,80,432,53,191,65,87,39,84,23,58,3,102,60,42,2,2,43,32,11
"2021","Cheshire East 027A","E01018398",740,314,136,178,409,68,132,55,51,26,114,68,38,8,84,52,32,11,11,17,5,12
"2021","Cheshire East 027B","E01018399",867,336,111,225,506,88,240,98,104,38,104,68,33,3,74,48,26,0,0,25,10,15
"2021","Cheshire East 027C","E01018402",1015,525,162,363,461,71,168,77,64,27,118,76,34,8,101,58,43,3,3,29,12,17
"2021","Cheshire East 027D","E01018403",1029,236,125,111,762,157,372,131,164,77,130,73,49,8,98,72,26,5,5,31,16,15
"2021","Cheshire East 028A","E01018397",825,193,91,102,594,92,325,116,160,49,107,53,49,5,68,38,30,2,2,38,19,19
"2021","Cheshire East 028B","E01018408",848,245,148,97,586,138,298,130,111,57,99,58,40,1,51,27,24,0,0,17,7,10
"2021","Cheshire East 028C","E01018409",946,363,231,132,550,131,254,102,105,47,83,44,34,5,80,43,37,2,2,33,7,26
"2021","Cheshire East 028D","E01018410",785,200,131,69,567,134,283,93,131,59,84,36,42,6,64,35,29,2,2,18,4,14
"2021","Cheshire East 029A","E01018404",620,148,90,58,462,119,258,107,107,44,55,31,19,5,29,15,14,1,1,10,4,6
"2021","Cheshire East 029B","E01018405",601,192,81,111,398,75,210,91,87,32,78,46,31,1,35,20,15,0,0,11,4,7
"2021","Cheshire East 029C","E01018406",614,160,97,63,441,123,240,79,110,51,50,30,18,2,28,13,15,0,0,13,3,10
"2021","Cheshire East 029D","E01018407",661,163,108,55,465,127,249,104,99,46,58,33,24,1,29,18,11,2,2,33,16,17
"2021","Cheshire East 030A","E01018436",717,197,119,78,510,136,266,98,118,50,60,34,25,1,46,34,12,2,2,10,3,7
"2021","Cheshire East 030B","E01018437",787,329,135,194,432,58,165,76,62,27,112,70,39,3,88,58,30,9,9,26,8,18
"2021","Cheshire East 030C","E01018438",615,182,135,47,422,139,196,86,68,42,56,34,17,5,29,14,15,2,2,11,6,5
"2021","Cheshire East 030D","E01018439",882,215,113,102,645,161,323,106,162,55,117,74,41,2,43,30,13,1,1,22,9,13
"2021","Cheshire East 031A","E01018440",1102,300,76,224,757,57,382,132,200,50,186,114,66,6,127,95,32,5,5,45,21,24
"2021","Cheshire East 031B","E01018441",881,225,45,180,629,43,341,124,171,46,159,99,55,5,82,57,25,4,4,27,10,17
"2021","Cheshire East 031D","E01018443",932,248,94,154,658,95,344,118,151,75,125,66,54,5,93,58,35,1,1,26,10,16
"2021","Cheshire East 031E","E01034665",553,139,63,76,398,62,221,74,114,33,63,31,29,3,52,29,23,0,0,16,5,11
"2021","Cheshire East 031F","E01034666",658,174,71,103,466,56,245,73,145,27,92,42,48,2,69,54,15,4,4,18,8,10
"2021","Cheshire East 032A","E01018432",635,198,98,100,430,79,209,93,72,44,75,45,24,6,67,40,27,0,0,7,2,5
"2021","Cheshire East 032B","E01018433",695,236,128,108,441,116,198,83,75,40,78,51,24,3,46,30,16,3,3,18,6,12
"2021","Cheshire East 032C","E01018434",663,234,115,119,416,91,198,90,81,27,69,52,15,2,57,25,32,1,1,13,5,8
"2021","Cheshire East 032D","E01018435",732,308,151,157,410,59,164,65,67,32,77,51,23,3,105,70,35,5,5,14,3,11
"2021","Cheshire East 033B","E01018417",775,217,138,79,542,181,234,117,74,43,76,43,30,3,50,23,27,1,1,16,4,12
"2021","Cheshire East 033C","E01018418",685,184,97,87,472,110,236,119,69,48,66,42,17,7,59,34,25,1,1,29,15,14
"2021","Cheshire East 033D","E01018428",600,180,95,85,401,76,200,102,69,29,75,45,25,5,47,27,20,3,3,19,6,13
"2021","Cheshire East 033E","E01018429",688,183,108,75,473,121,222,107,74,41,69,46,19,4,58,36,22,3,3,32,14,18
"2021","Cheshire East 033F","E01018430",572,140,69,71,409,93,201,80,78,43,66,35,27,4,49,29,20,0,0,23,9,14
"2021","Cheshire East 033G","E01018431",549,148,60,88,380,76,220,94,83,43,50,29,15,6,34,19,15,0,0,21,4,17
"2021","Cheshire East 033H","E01034667",544,121,52,69,406,73,237,89,110,38,66,33,28,5,30,19,11,0,0,17,8,9
"2021","Cheshire East 033I","E01034668",713,129,50,79,557,66,279,127,104,48,152,105,43,4,59,44,15,1,1,27,11,16
"2021","Cheshire East 040A","E01018387",828,207,147,60,600,215,294,101,144,49,47,28,17,2,43,20,23,1,1,21,8,13
"2021","Cheshire East 040B","E01018388",765,312,118,194,428,66,157,50,75,32,99,44,51,4,102,66,36,4,4,25,15,10
"2021","Cheshire East 040C","E01018389",790,286,183,103,486,110,240,91,99,50,80,36,41,3,55,31,24,1,1,18,6,12
"2021","Cheshire East 040D","E01018390",746,238,156,82,487,120,244,104,93,47,72,38,29,5,49,29,20,2,2,21,11,10
"2021","Cheshire East 042A","E01018386",943,272,146,126,645,120,307,103,161,43,138,77,55,6,80,60,20,0,0,26,9,17
"2021","Cheshire East 042B","E01018391",1064,299,143,156,738,89,375,130,189,56,158,99,57,2,116,85,31,0,0,27,15,12
"2021","Cheshire East 042C","E01018392",785,204,115,89,558,139,308,107,146,55,66,32,30,4,45,24,21,0,0,23,11,12
"2021","Cheshire East 034A","E01018472",672,265,89,176,393,61,187,88,70,29,98,63,30,5,47,27,20,0,0,14,4,10
"2021","Cheshire East 034B","E01018473",662,166,50,116,471,43,254,88,108,58,104,51,50,3,69,46,23,1,1,25,13,12
"2021","Cheshire East 034C","E01018474",661,120,39,81,505,40,322,118,129,75,101,43,47,11,41,34,7,1,1,36,14,22
"2021","Cheshire East 034D","E01018475",640,116,33,83,503,35,348,135,138,75,82,40,36,6,37,22,15,1,1,21,11,10
"2021","Cheshire East 035A","E01018463",646,240,67,173,361,16,138,62,43,33,111,54,53,4,88,52,36,8,8,45,19,26
"2021","Cheshire East 035B","E01018476",552,134,58,76,387,18,137,27,88,22,89,31,52,6,124,91,33,19,19,31,15,16
"2021","Cheshire East 035C","E01018477",699,221,110,111,445,56,190,70,90,30,97,37,57,3,96,67,29,6,6,33,14,19
"2021","Cheshire East 035D","E01018478",649,138,54,84,477,29,209,68,104,37,142,59,69,14,89,48,41,8,8,34,20,14
"2021","Cheshire East 035E","E01018479",1052,326,132,194,687,54,319,126,131,62,194,102,90,2,117,85,32,3,3,39,15,24
"2021","Cheshire East 036A","E01018459",521,111,48,63,383,33,147,41,79,27,79,32,40,7,121,92,29,3,3,27,17,10
"2021","Cheshire East 036B","E01018460",630,187,102,85,409,92,150,65,57,28,88,42,43,3,74,35,39,5,5,34,11,23
"2021","Cheshire East 036C","E01018461",659,205,113,92,423,66,155,64,54,37,85,43,36,6,115,57,58,2,2,31,18,13
"2021","Cheshire East 036D","E01018466",1166,497,144,353,617,34,199,83,90,26,191,103,75,13,172,122,50,21,21,52,23,29
"2021","Cheshire East 036F","E01034669",610,235,47,188,320,9,93,33,39,21,120,50,65,5,86,63,23,12,12,55,19,36
"2021","Cheshire East 036G","E01034670",641,225,23,202,374,4,162,53,93,16,113,58,50,5,89,68,21,6,6,42,11,31
"2021","Cheshire East 037A","E01018482",628,210,103,107,387,61,167,67,67,33,78,40,32,6,77,46,31,4,4,31,14,17
"2021","Cheshire East 037B","E01018483",635,207,99,108,399,94,175,82,59,34,66,36,26,4,62,38,24,2,2,29,8,21
"2021","Cheshire East 037C","E01018484",783,156,34,122,574,18,248,59,159,30,153,51,88,14,148,101,47,7,7,53,24,29
"2021","Cheshire East 037D","E01018485",614,170,53,117,408,29,153,39,80,34,104,46,51,7,114,88,26,8,8,36,19,17
"2021","Cheshire East 038A","E01018499",728,276,117,159,428,82,193,95,71,27,89,40,36,13,62,39,23,2,2,24,7,17
"2021","Cheshire East 038B","E01018500",523,151,89,62,352,99,151,65,53,33,64,28,32,4,34,17,17,4,4,20,9,11
"2021","Cheshire East 038C","E01018501",792,341,186,155,416,85,168,87,51,30,92,60,30,2,66,43,23,5,5,35,10,25
"2021","Cheshire East 038D","E01018502",533,163,112,51,353,119,155,76,45,34,48,26,19,3,31,11,20,0,0,17,5,12
"2021","Cheshire East 039A","E01018462",941,416,116,300,436,25,128,57,59,12,144,98,41,5,131,93,38,8,8,89,28,61
"2021","Cheshire East 039B","E01018464",728,264,71,193,422,30,168,85,63,20,136,87,47,2,81,59,22,7,7,42,21,21
"2021","Cheshire East 039C","E01018496",679,205,77,128,441,49,221,79,110,32,80,40,38,2,88,51,37,3,3,33,18,15
"2021","Cheshire East 039D","E01018497",557,206,55,151,303,26,116,48,52,16,77,46,23,8,69,46,23,15,15,48,20,28
"2021","Cheshire East 039E","E01018498",655,177,45,132,437,17,162,51,81,30,110,53,47,10,142,103,39,6,6,41,19,22
"2021","Cheshire East 041B","E01018468",644,137,74,63,485,86,262,111,90,61,78,46,27,5,59,31,28,0,0,22,4,18
"2021","Cheshire East 041C","E01018469",725,200,112,88,506,100,249,89,100,60,84,44,31,9,64,39,25,9,9,19,11,8
"2021","Cheshire East 041D","E01018470",789,153,71,82,605,100,350,139,147,64,87,43,41,3,68,39,29,0,0,31,10,21
"2021","Cheshire East 041E","E01018471",634,189,113,76,424,81,231,92,93,46,73,43,23,7,39,21,18,0,0,21,5,16
"2021","Cheshire East 041F","E01034671",503,98,45,53,377,53,196,78,80,38,83,40,38,5,45,39,6,0,0,28,12,16
"2021","Cheshire East 041G","E01034672",495,155,83,72,325,93,161,86,45,30,39,21,17,1,31,18,13,1,1,15,7,8
"2021","Cheshire East 041H","E01034673",480,66,10,56,381,40,247,106,117,24,60,31,25,4,32,22,10,2,2,33,15,18
"2021","Cheshire East 043A","E01018486",735,349,80,269,291,13,107,42,56,9,94,54,34,6,48,33,15,29,29,95,23,72
"2021","Cheshire East 043B","E01018487",741,290,51,239,356,21,120,34,68,18,93,47,44,2,85,61,24,37,37,95,40,55
"2021","Cheshire East 043C","E01018488",652,161,61,100,459,61,237,78,101,58,96,39,50,7,64,30,34,1,1,32,17,15
"2021","Cheshire East 043D","E01018489",610,198,53,145,279,21,119,36,61,22,72,41,29,2,51,32,19,16,16,133,51,82
"2021","Cheshire East 044A","E01018510",730,190,88,102,522,59,260,107,113,40,113,54,52,7,90,58,32,0,0,18,8,10
"2021","Cheshire East 044B","E01018511",630,233,109,124,368,40,167,52,81,34,80,39,38,3,75,41,34,6,6,29,11,18
"2021","Cheshire East 044C","E01018512",703,208,110,98,461,39,218,77,105,36,93,31,58,4,107,77,30,4,4,34,20,14
"2021","Cheshire East 044D","E01018513",670,186,100,86,455,86,242,93,102,47,79,38,36,5,47,21,26,1,1,29,15,14
"2021","Cheshire East 045A","E01018445",831,290,74,216,478,14,170,50,93,27,156,88,62,6,128,93,35,10,10,63,20,43
"2021","Cheshire East 045B","E01018446",556,121,48,73,405,26,188,75,73,40,123,28,90,5,63,28,35,5,5,30,16,14
"2021","Cheshire East 045C","E01018447",802,253,47,206,412,31,157,63,70,24,119,68,48,3,90,57,33,15,15,137,42,95
"2021","Cheshire East 045D","E01018448",750,275,89,186,434,58,220,79,99,42,88,46,39,3,65,36,29,3,3,41,13,28
"2021","Cheshire East 046A","E01018490",774,189,121,68,568,166,269,103,124,42,85,53,27,5,46,28,18,2,2,17,9,8
"2021","Cheshire East 046B","E01018491",730,213,107,106,491,111,243,83,112,48,89,57,27,5,45,31,14,3,3,26,12,14
"2021","Cheshire East 046C","E01018492",517,167,116,51,341,98,162,69,55,38,44,27,12,5,34,16,18,3,3,9,4,5
"2021","Cheshire East 046D","E01018505",504,86,52,34,399,98,221,87,96,38,45,24,19,2,33,23,10,2,2,19,7,12
"2021","Cheshire East 046E","E01018506",536,88,58,30,431,99,270,130,82,58,41,21,17,3,20,4,16,1,1,17,11,6
"2021","Cheshire East 046F","E01018507",568,114,82,32,438,142,227,88,83,56,39,15,20,4,30,8,22,0,0,16,4,12
"2021","Cheshire East 047A","E01018451",748,408,218,190,330,70,126,51,41,34,78,45,25,8,54,30,24,2,2,10,4,6
"2021","Cheshire East 047B","E01018454",713,272,94,178,407,48,152,64,64,24,99,52,45,2,97,60,37,11,11,34,5,29
"2021","Cheshire East 047C","E01018455",610,193,116,77,401,100,189,69,73,47,69,45,22,2,41,15,26,2,2,16,7,9
"2021","Cheshire East 047D","E01018456",612,202,152,50,394,144,186,67,75,44,34,23,7,4,29,11,18,1,1,16,6,10
"2021","Cheshire East 047E","E01018457",802,378,179,199,406,77,162,70,60,32,94,71,23,0,63,40,23,10,10,18,2,16
"2021","Cheshire East 048A","E01018493",693,259,166,93,422,95,175,91,54,30,80,45,32,3,67,30,37,5,5,12,5,7
"2021","Cheshire East 048B","E01018494",1153,275,103,172,841,85,381,147,185,49,247,153,93,1,119,90,29,9,9,37,19,18
"2021","Cheshire East 048C","E01018495",674,179,92,87,470,73,217,85,88,44,105,64,39,2,67,47,20,8,8,25,12,13
"2021","Cheshire East 048D","E01018508",590,132,81,51,453,97,251,93,127,31,68,34,31,3,37,24,13,0,0,5,3,2
"2021","Cheshire East 048E","E01018509",557,195,83,112,346,49,155,59,66,30,85,55,28,2,54,30,24,3,3,16,6,10
"2021","Cheshire East 050A","E01018452",509,175,95,80,317,63,123,42,60,21,60,31,23,6,68,43,25,3,3,17,7,10
"2021","Cheshire East 050C","E01018503",733,189,131,58,527,167,256,94,124,38,56,34,17,5,45,24,21,3,3,17,7,10
"2021","Cheshire East 050D","E01018504",857,371,196,175,454,105,177,81,65,31,95,57,31,7,72,48,24,5,5,32,6,26
"2021","Cheshire East 050E","E01033372",595,240,83,157,337,47,155,69,63,23,86,62,23,1,45,31,14,4,4,18,7,11
"2021","Cheshire East 050F","E01033373",740,322,177,145,375,66,146,57,58,31,82,48,30,4,78,47,31,3,3,43,1,42
"2021","Cheshire East 051A","E01018449",790,207,161,46,558,175,279,135,83,61,55,33,20,2,45,21,24,4,4,25,13,12
"2021","Cheshire East 051B","E01018450",1142,299,179,120,811,161,436,185,172,79,123,80,38,5,89,51,38,2,2,32,15,17
"2021","Cheshire East 051C","E01018458",968,214,130,84,733,170,411,168,164,79,93,49,36,8,58,33,25,1,1,21,9,12
"2021","Cheshire East 051D","E01018481",843,169,87,82,641,133,389,176,137,76,79,46,29,4,35,16,19,5,5,33,12,21
"2021","Cheshire East 051E","E01018514",890,203,117,86,650,144,347,171,118,58,91,42,45,4,61,38,23,7,7,37,22,15
"2021","Cheshire East 001A","E01018585",640,196,98,98,431,89,219,95,87,37,65,37,24,4,51,25,26,7,7,13,1,12
"2021","Cheshire East 001B","E01018586",836,235,84,151,572,88,327,120,155,52,107,57,46,4,47,28,19,3,3,29,13,16
"2021","Cheshire East 001C","E01018587",697,184,100,84,490,128,257,114,104,39,62,36,25,1,42,26,16,1,1,23,9,14
"2021","Cheshire East 001D","E01018661",528,136,80,56,373,100,200,69,82,49,45,23,18,4,28,15,13,0,0,19,3,16
"2021","Cheshire East 002A","E01018657",501,175,105,70,312,52,141,45,67,29,55,24,25,6,63,35,28,1,1,14,4,10
"2021","Cheshire East 002B","E01018662",487,95,52,43,371,74,207,57,108,42,42,24,15,3,47,26,21,1,1,21,10,11
"2021","Cheshire East 002C","E01018663",679,186,145,41,477,135,249,71,136,42,46,27,17,2,44,27,17,3,3,16,7,9
"2021","Cheshire East 002D","E01018664",578,124,83,41,441,126,233,83,105,45,46,21,19,6,36,24,12,0,0,13,6,7
"2021","Cheshire East 002E","E01018665",492,128,88,40,350,63,192,64,96,32,47,24,19,4,48,20,28,0,0,14,5,9
"2021","Cheshire East 003A","E01018655",747,300,194,106,430,117,213,73,106,34,57,31,20,6,41,23,18,2,2,17,10,7
"2021","Cheshire East 003C","E01018658",486,104,61,43,371,96,208,60,99,49,33,16,14,3,34,23,11,0,0,11,6,5
"2021","Cheshire East 003D","E01018659",520,113,94,19,391,136,218,87,89,42,14,6,7,1,22,11,11,1,1,16,6,10
"2021","Cheshire East 003F","E01034658",1062,306,220,86,740,204,399,132,187,80,72,42,27,3,65,31,34,0,0,16,10,6
"2021","Cheshire East 004A","E01018582",1052,348,87,261,677,77,372,128,187,57,150,99,42,9,75,47,28,3,3,27,12,15
"2021","Cheshire East 004B","E01018592",777,239,132,107,509,84,251,65,129,57,93,61,26,6,75,40,35,6,6,29,13,16
"2021","Cheshire East 004C","E01018593",810,283,143,140,496,106,264,90,129,45,67,41,20,6,57,34,23,2,2,31,13,18
"2021","Cheshire East 004D","E01018594",848,377,152,225,433,40,178,58,91,29,89,33,47,9,120,74,46,6,6,38,8,30
"2021","Cheshire East 004E","E01018595",781,293,134,159,459,76,233,72,124,37,85,50,32,3,61,40,21,4,4,29,18,11
"2021","Cheshire East 004F","E01018596",904,326,83,243,533,23,198,66,98,34,135,61,59,15,171,117,54,6,6,45,19,26
"2021","Cheshire East 005A","E01018583",796,223,96,127,527,74,277,86,147,44,108,77,29,2,66,42,24,2,2,46,23,23
"2021","Cheshire East 005B","E01018584",749,145,72,73,570,103,366,113,198,55,52,32,17,3,48,26,22,1,1,34,14,20
"2021","Cheshire East 005C","E01018612",577,151,70,81,402,64,187,63,93,31,67,28,30,9,82,56,26,2,2,24,13,11
"2021","Cheshire East 005D","E01018613",755,300,118,182,425,39,161,53,77,31,93,47,35,11,127,73,54,5,5,30,6,24
"2021","Cheshire East 006A","E01018600",679,149,94,55,502,125,297,89,149,59,42,25,14,3,36,23,13,2,2,28,9,19
"2021","Cheshire East 006B","E01018601",923,395,237,158,496,106,208,75,111,22,109,68,33,8,70,40,30,3,3,32,11,21
"2021","Cheshire East 006C","E01018602",872,335,160,175,503,104,263,101,119,43,94,70,20,4,38,27,11,4,4,34,7,27
"2021","Cheshire East 006D","E01018652",604,115,64,51,473,84,284,78,158,48,74,42,23,9,29,20,9,2,2,16,8,8
"2021","Cheshire East 007A","E01018598",742,117,59,58,594,90,398,121,225,52,66,45,15,6,40,27,13,0,0,31,19,12
"2021","Cheshire East 007B","E01018599",488,114,68,46,360,106,194,71,87,36,29,13,10,6,30,17,13,1,1,14,4,10
"2021","Cheshire East 007C","E01018648",959,242,129,113,667,134,367,127,177,63,91,48,37,6,74,38,36,1,1,50,22,28
"2021","Cheshire East 007D","E01018649",581,160,107,53,405,124,219,94,76,49,48,26,19,3,11,5,6,3,3,16,8,8
"2021","Cheshire East 007E","E01018650",740,228,107,121,485,79,269,84,153,32,63,39,19,5,71,39,32,3,3,27,7,20
"2021","Cheshire East 007F","E01018651",500,134,79,55,341,61,195,61,99,35,51,31,12,8,31,21,10,3,3,25,14,11
"2021","Cheshire East 007G","E01018654",966,219,123,96,684,181,363,146,144,73,69,41,22,6,68,43,25,3,3,63,36,27
"2021","Cheshire East 008A","E01018588",631,162,82,80,457,69,266,76,143,47,59,33,22,4,62,32,30,1,1,12,6,6
"2021","Cheshire East 008B","E01018589",624,129,93,36,477,115,289,71,173,45,47,16,30,1,25,11,14,1,1,18,9,9
"2021","Cheshire East 008C","E01018590",795,191,103,88,582,95,330,98,193,39,82,39,38,5,72,46,26,3,3,22,8,14
"2021","Cheshire East 008D","E01018653",910,264,182,82,617,120,354,97,211,46,78,36,36,6,59,30,29,6,6,29,13,16
"2021","Cheshire East 009A","E01018605",490,134,94,40,348,104,189,76,89,24,31,17,14,0,23,12,11,1,1,8,1,7
"2021","Cheshire East 009B","E01018609",756,249,156,93,476,133,212,62,118,32,72,42,28,2,58,32,26,1,1,31,14,17
"2021","Cheshire East 009C","E01018610",899,315,126,189,552,68,240,82,125,33,135,82,49,4,104,63,41,5,5,32,12,20
"2021","Cheshire East 009D","E01018611",753,288,89,199,433,31,156,55,76,25,100,47,46,7,142,99,43,4,4,32,10,22
"2021","Cheshire East 011A","E01018666",719,117,89,28,580,190,306,91,150,65,52,24,27,1,30,17,13,2,2,22,11,11
"2021","Cheshire East 011B","E01018667",760,251,172,79,482,128,255,113,92,50,42,19,23,0,56,28,28,1,1,27,13,14
"2021","Cheshire East 011C","E01018668",702,143,84,59,532,145,298,113,119,66,58,31,23,4,28,14,14,3,3,27,8,19
"2021","Cheshire East 010A","E01018603",515,95,72,23,404,107,245,66,134,45,29,10,18,1,21,14,7,2,2,16,9,7
"2021","Cheshire East 010B","E01018604",596,162,80,82,411,62,197,65,109,23,85,49,36,0,66,39,27,1,1,23,2,21
"2021","Cheshire East 010C","E01018606",813,432,275,157,350,60,151,52,74,25,84,54,29,1,52,31,21,3,3,31,6,25
"2021","Cheshire East 010D","E01018607",511,89,66,23,403,125,235,86,117,32,26,9,15,2,17,8,9,0,0,19,8,11
"2021","Cheshire East 010E","E01018608",553,121,77,44,411,91,267,93,145,29,31,18,12,1,19,5,14,3,3,21,4,17
"2021","Cheshire East 012A","E01018572",757,245,152,93,495,117,261,88,123,50,64,31,18,15,48,25,23,5,5,17,6,11
"2021","Cheshire East 012B","E01018573",654,187,108,79,450,96,253,93,112,48,52,38,11,3,47,32,15,2,2,17,8,9
"2021","Cheshire East 012C","E01018574",1021,438,169,269,558,124,236,96,105,35,89,55,30,4,105,68,37,4,4,25,11,14
"2021","Cheshire East 012D","E01018580",785,242,139,103,513,125,285,120,124,41,60,39,19,2,40,16,24,3,3,30,10,20
"2021","Cheshire East 012E","E01018581",715,227,118,109,463,118,217,80,99,38,87,58,27,2,37,23,14,4,4,25,8,17
"2021","Cheshire East 013A","E01018575",580,163,81,82,409,62,211,77,105,29,74,38,32,4,61,41,20,1,1,8,1,7
"2021","Cheshire East 013B","E01018576",930,380,141,239,537,94,263,123,113,27,105,76,28,1,74,48,26,1,1,13,4,9
"2021","Cheshire East 013C","E01018577",1098,386,189,197,698,139,353,133,158,62,112,64,40,8,93,50,43,1,1,14,9,5
"2021","Cheshire East 013D","E01018578",508,127,62,65,365,78,195,66,86,43,54,30,20,4,36,21,15,2,2,16,4,12
"2021","Cheshire East 013E","E01018579",546,168,76,92,359,57,140,46,68,26,78,38,34,6,77,54,23,7,7,19,9,10
"2021","Cheshire East 014A","E01018641",648,139,84,55,487,99,254,77,127,50,64,27,31,6,70,47,23,0,0,22,7,15
"2021","Cheshire East 014B","E01018642",533,126,79,47,392,70,245,80,115,50,40,24,15,1,37,20,17,0,0,15,7,8
"2021","Cheshire East 014C","E01018643",798,143,85,58,633,120,410,145,192,73,58,23,32,3,45,26,19,0,0,22,10,12
"2021","Cheshire East 014D","E01018644",652,243,132,111,397,98,200,65,94,41,58,43,14,1,37,15,22,4,4,12,4,8
"2021","Cheshire East 015A","E01018614",843,298,116,182,523,86,297,119,130,48,75,47,25,3,62,44,18,3,3,22,8,14
"2021","Cheshire East 015B","E01018618",642,208,71,137,404,35,145,39,75,31,86,44,38,4,133,104,29,5,5,30,12,18
"2021","Cheshire East 015C","E01018619",624,137,77,60,475,61,294,104,151,39,66,37,27,2,52,31,21,2,2,12,5,7
"2021","Cheshire East 015D","E01018620",591,180,90,90,388,74,172,61,80,31,60,22,36,2,82,62,20,0,0,23,14,9
"2021","Cheshire East 015E","E01018621",600,177,80,97,408,71,217,74,108,35,67,35,24,8,50,25,25,3,3,15,5,10
"2021","Cheshire East 016B","E01018628",638,148,88,60,469,93,272,81,135,56,67,38,27,2,37,19,18,0,0,21,9,12
"2021","Cheshire East 016C","E01018629",848,312,124,188,503,39,201,53,109,39,121,69,46,6,135,75,60,7,7,33,5,28
"2021","Cheshire East 016D","E01018630",617,234,87,147,363,57,167,69,73,25,87,51,33,3,52,32,20,0,0,20,7,13
"2021","Cheshire East 016E","E01018631",693,326,116,210,350,37,137,65,48,24,88,39,37,12,79,56,23,9,9,17,9,8
"2021","Cheshire East 016F","E01034659",655,297,129,168,339,64,140,49,69,22,78,55,22,1,49,25,24,8,8,19,4,15
"2021","Cheshire East 016G","E01034660",580,295,104,191,256,28,110,45,52,13,63,36,23,4,52,31,21,3,3,29,3,26
"2021","Cheshire East 017A","E01018615",585,228,50,178,340,35,167,61,73,33,84,59,25,0,49,31,18,5,5,17,5,12
"2021","Cheshire East 017B","E01018616",640,214,94,120,407,90,219,79,114,26,63,34,28,1,32,19,13,3,3,19,11,8
"2021","Cheshire East 017C","E01018617",674,288,119,169,372,70,171,72,71,28,72,44,26,2,55,27,28,4,4,14,7,7
"2021","Cheshire East 017D","E01018632",726,170,75,95,527,78,297,107,141,49,90,57,30,3,61,34,27,1,1,29,10,19
"2021","Cheshire East 017E","E01018633",617,144,94,50,463,126,249,88,113,48,49,28,19,2,38,22,16,1,1,10,4,6
"2021","Cheshire East 018A","E01018622",740,386,152,234,323,22,140,54,58,28,82,66,16,0,75,51,24,4,4,31,8,23
"2021","Cheshire East 018B","E01018623",699,247,93,154,435,49,201,87,90,24,112,74,34,4,71,39,32,2,2,17,6,11
"2021","Cheshire East 018C","E01018624",1133,574,86,488,497,36,189,103,74,12,162,132,29,1,95,59,36,15,15,62,14,48
"2021","Cheshire East 018D","E01018625",727,325,61,264,373,31,156,59,78,19,115,79,35,1,66,43,23,5,5,29,6,23
"2021","Cheshire East 018E","E01018627",906,403,86,317,466,39,162,79,55,28,154,110,40,4,101,50,51,10,10,37,5,32
"2021","Cheshire East 018F","E01018635",578,224,77,147,326,45,138,54,65,19,99,73,24,2,37,27,10,7,7,28,7,21
"2021","Cheshire East 018G","E01018636",581,156,87,69,406,59,238,87,116,35,68,40,25,3,40,20,20,1,1,19,10,9
"2021","Cheshire East 019A","E01018634",768,191,122,69,552,119,293,101,134,58,78,29,43,6,58,32,26,4,4,25,8,17
"2021","Cheshire East 019B","E01018645",881,379,177,202,484,92,168,64,63,41,96,48,41,7,122,84,38,6,6,18,7,11
"2021","Cheshire East 019C","E01018646",746,222,103,119,499,52,222,74,94,54,94,41,43,10,127,83,44,4,4,25,9,16
"2021","Cheshire East 019D","E01018647",664,205,113,92,445,64,221,67,102,52,74,33,38,3,83,47,36,3,3,14,7,7
"2021","Cheshire East 020A","E01018591",1056,276,176,100,737,215,385,159,148,78,87,57,26,4,49,15,34,1,1,43,12,31
"2021","Cheshire East 020C","E01018669",1114,295,169,126,777,182,443,191,185,67,107,66,34,7,42,20,22,3,3,42,16,26
"2021","Cheshire East 020D","E01018670",1030,307,174,133,671,165,382,169,138,75,70,37,31,2,52,28,24,2,2,52,22,30
"2021","Cheshire East 020E","E01034661",428,93,53,40,321,79,180,75,87,18,39,22,11,6,23,14,9,0,0,14,7,7
"2021","Cheshire East 020F","E01034662",823,194,83,111,604,121,317,128,137,52,91,56,32,3,71,45,26,4,4,25,8,17
"2021","Cheshire East 021A","E01018637",749,219,67,152,499,36,236,79,110,47,98,36,54,8,122,82,40,7,7,31,14,17
"2021","Cheshire East 021B","E01018638",679,235,114,121,425,69,175,70,68,37,84,38,39,7,92,57,35,5,5,19,5,14
"2021","Cheshire East 021C","E01018639",793,316,66,250,441,23,153,49,87,17,159,118,39,2,102,63,39,4,4,36,6,30
"2021","Cheshire East 021D","E01018640",625,292,93,199,312,37,121,50,51,20,73,44,26,3,79,51,28,2,2,21,9,12
"2021","Cheshire East 052A","E01034674",599,92,32,60,481,31,248,90,135,23,165,91,70,4,33,19,14,4,4,26,10,16
"2021","Cheshire East 052B","E01034675",624,156,90,66,431,75,258,127,92,39,70,45,23,2,27,16,11,1,1,37,18,19
"2021","Cheshire East 052C","E01034676",474,121,42,79,343,34,171,79,72,20,96,67,24,5,41,28,13,1,1,10,0,10
"2021","Cheshire East 052D","E01034677",588,117,67,50,427,102,239,115,81,43,57,39,17,1,29,16,13,0,0,44,14,30
"2021","Cheshire East 052E","E01034678",518,107,20,87,388,40,196,69,113,14,86,47,34,5,64,51,13,2,2,23,9,14
"2021","Cheshire East 053F","E01018515",922,166,75,91,713,127,462,202,201,59,80,43,31,6,41,25,16,3,3,43,21,22
"2021","Cheshire East 053C","E01018516",700,179,102,77,498,104,251,107,101,43,87,52,27,8,52,21,31,4,4,23,5,18
"2021","Cheshire East 053B","E01033375",722,124,19,105,570,47,363,87,241,35,87,44,42,1,71,54,17,2,2,28,13,15
"2021","Cheshire East 053A","E01033376",446,104,7,97,322,11,173,37,115,21,76,47,27,2,61,45,16,1,1,20,10,10
"2021","Cheshire East 053E","E01033378",586,120,58,62,444,69,293,95,143,55,54,28,23,3,28,12,16,0,0,22,9,13
"2021","Cheshire West and Chester 022A","E01018308",847,236,124,112,568,117,308,114,139,55,71,36,28,7,68,32,36,4,4,43,26,17
"2021","Cheshire West and Chester 022B","E01018336",532,142,72,70,367,65,181,72,61,48,69,38,30,1,50,28,22,2,2,23,12,11
"2021","Cheshire West and Chester 022C","E01018337",540,158,72,86,353,58,181,76,72,33,62,38,22,2,49,24,25,3,3,29,16,13
"2021","Cheshire West and Chester 022D","E01018338",795,266,98,168,509,71,271,103,116,52,97,55,33,9,68,46,22,2,2,20,5,15
"2021","Cheshire West and Chester 022E","E01018358",501,113,42,71,367,71,182,61,92,29,57,26,29,2,56,36,20,1,1,21,12,9
"2021","Cheshire West and Chester 022F","E01018359",439,93,64,29,325,81,197,69,96,32,28,14,11,3,18,8,10,1,1,21,8,13
"2021","Cheshire West and Chester 025A","E01018360",834,184,107,77,604,102,349,122,176,51,101,71,29,1,52,32,20,0,0,46,20,26
"2021","Cheshire West and Chester 025B","E01018366",646,167,108,59,458,130,239,97,94,48,43,30,13,0,44,19,25,2,2,21,9,12
"2021","Cheshire West and Chester 025C","E01018367",871,257,152,105,574,111,311,108,140,63,79,40,30,9,66,44,22,7,7,40,17,23
"2021","Cheshire West and Chester 027A","E01018364",728,264,120,144,440,23,155,57,67,31,100,46,47,7,153,108,45,9,9,24,11,13
"2021","Cheshire West and Chester 027B","E01018365",937,355,244,111,565,128,303,100,150,53,67,36,25,6,64,33,31,3,3,17,8,9
"2021","Cheshire West and Chester 027C","E01018378",537,183,102,81,331,30,145,36,73,36,54,16,31,7,93,51,42,9,9,23,7,16
"2021","Cheshire West and Chester 027D","E01018379",610,182,118,64,412,100,219,72,96,51,43,18,20,5,49,28,21,1,1,16,3,13
"2021","Cheshire West and Chester 027E","E01018380",505,150,82,68,340,74,185,63,82,40,40,18,19,3,41,22,19,0,0,15,7,8
"2021","Cheshire West and Chester 028A","E01018362",634,173,90,83,439,51,268,82,142,44,76,43,31,2,41,21,20,3,3,22,8,14
"2021","Cheshire West and Chester 028B","E01018363",472,148,92,56,310,87,154,54,70,30,45,22,15,8,22,12,10,2,2,14,4,10
"2021","Cheshire West and Chester 028C","E01018374",765,247,81,166,487,84,284,97,142,45,89,54,30,5,27,16,11,3,3,31,4,27
"2021","Cheshire West and Chester 028D","E01018375",844,329,76,253,446,65,190,78,82,30,133,102,31,0,45,22,23,13,13,69,12,57
"2021","Cheshire West and Chester 028E","E01018376",649,133,72,61,487,82,276,75,154,47,68,21,43,4,59,34,25,2,2,29,12,17
"2021","Cheshire West and Chester 028F","E01018377",841,173,85,88,630,95,368,127,188,53,96,58,32,6,67,41,26,4,4,38,15,23
"2021","Cheshire West and Chester 029A","E01018309",659,145,70,75,474,77,206,77,79,50,85,40,41,4,98,58,40,8,8,40,19,21
"2021","Cheshire West and Chester 029B","E01018310",643,170,73,97,424,30,145,48,59,38,95,28,53,14,137,85,52,17,17,49,23,26
"2021","Cheshire West and Chester 029C","E01018311",668,289,93,196,351,18,123,39,56,28,92,44,44,4,115,80,35,3,3,28,13,15
"2021","Cheshire West and Chester 029D","E01018312",597,154,71,83,409,29,183,43,94,46,77,22,42,13,111,72,39,9,9,34,9,25
"2021","Cheshire West and Chester 031A","E01018313",605,158,93,65,422,81,180,64,63,53,96,39,48,9,63,30,33,2,2,25,9,16
"2021","Cheshire West and Chester 031B","E01018314",716,227,100,127,461,45,194,65,85,44,87,24,53,10,127,87,40,8,8,28,13,15
"2021","Cheshire West and Chester 031C","E01018315",553,181,104,77,352,61,172,64,60,48,57,28,22,7,60,42,18,2,2,20,7,13
"2021","Cheshire West and Chester 031D","E01018316",584,164,62,102,392,24,133,48,57,28,81,25,47,9,145,92,53,9,9,28,15,13
"2021","Cheshire West and Chester 031E","E01018317",750,326,73,253,397,17,126,42,59,25,96,39,53,4,151,107,44,7,7,27,13,14
"2021","Cheshire West and Chester 030A","E01018349",757,195,119,76,529,130,274,92,134,48,71,43,24,4,54,34,20,0,0,33,9,24
"2021","Cheshire West and Chester 030B","E01018350",912,213,136,77,683,169,394,151,180,63,74,37,31,6,46,28,18,0,0,16,1,15
"2021","Cheshire West and Chester 030C","E01018368",677,201,104,97,444,104,201,61,96,44,70,40,30,0,66,40,26,3,3,32,10,22
"2021","Cheshire West and Chester 030D","E01018370",657,128,80,48,515,116,293,91,143,59,57,26,29,2,48,28,20,1,1,14,11,3
"2021","Cheshire West and Chester 032A","E01018345",500,92,48,44,384,49,222,64,107,51,77,39,36,2,36,23,13,0,0,24,8,16
"2021","Cheshire West and Chester 032B","E01018346",616,165,99,66,436,64,244,79,131,34,94,80,14,0,32,16,16,2,2,15,6,9
"2021","Cheshire West and Chester 032C","E01018347",627,210,94,116,391,45,161,61,72,28,83,44,33,6,91,42,49,11,11,26,11,15
"2021","Cheshire West and Chester 032D","E01018383",597,163,101,62,415,55,250,60,139,51,56,24,28,4,50,27,23,4,4,19,6,13
"2021","Cheshire West and Chester 032E","E01018384",629,183,112,71,431,88,228,67,114,47,61,35,24,2,54,30,24,0,0,15,2,13
"2021","Cheshire West and Chester 033C","E01018343",802,392,128,264,318,24,113,49,48,16,116,96,19,1,55,37,18,10,10,92,7,85
"2021","Cheshire West and Chester 033D","E01018361",599,182,49,133,341,34,187,55,105,27,83,58,24,1,30,19,11,7,7,76,7,69
"2021","Cheshire West and Chester 033E","E01032930",1134,618,168,450,426,41,137,79,40,18,171,150,18,3,62,27,35,15,15,90,3,87
"2021","Cheshire West and Chester 033F","E01032931",615,256,58,198,276,30,101,58,33,10,103,91,11,1,35,16,19,7,7,83,1,82
"2021","Cheshire West and Chester 033G","E01035373",721,367,92,275,301,21,80,45,30,5,154,127,25,2,43,23,20,3,3,53,8,45
"2021","Cheshire West and Chester 033H","E01035374",655,432,178,254,197,23,64,38,20,6,57,45,12,0,45,19,26,8,8,26,2,24
"2021","Cheshire West and Chester 034B","E01018328",454,133,30,103,158,17,71,33,27,11,38,29,7,2,19,11,8,13,13,163,7,156
"2021","Cheshire West and Chester 034D","E01018330",471,113,41,72,253,37,105,48,34,23,66,47,19,0,38,20,18,7,7,105,2,103
"2021","Cheshire West and Chester 034E","E01018331",755,309,51,258,282,13,101,48,42,11,129,96,31,2,28,21,7,11,11,164,9,155
"2021","Cheshire West and Chester 034F","E01035375",450,228,91,137,130,11,43,23,14,6,56,49,7,0,8,5,3,12,12,92,2,90
"2021","Cheshire West and Chester 034G","E01035376",708,376,121,255,292,33,86,53,25,8,98,62,36,0,74,19,55,1,1,40,4,36
"2021","Cheshire West and Chester 034H","E01035377",815,432,46,386,299,24,83,50,28,5,145,138,7,0,26,15,11,21,21,84,6,78
"2021","Cheshire West and Chester 034I","E01035378",678,345,138,207,291,63,87,60,17,10,98,68,30,0,35,20,15,8,8,42,6,36
"2021","Cheshire West and Chester 036A","E01018319",1025,356,122,234,580,47,237,85,126,26,167,114,49,4,116,75,41,13,13,89,13,76
"2021","Cheshire West and Chester 036B","E01018344",903,324,75,249,522,26,223,97,100,26,192,150,40,2,70,38,32,11,11,57,7,50
"2021","Cheshire West and Chester 036C","E01018381",515,157,78,79,326,51,175,50,97,28,52,26,24,2,45,30,15,3,3,32,13,19
"2021","Cheshire West and Chester 036D","E01018382",847,398,241,157,419,79,203,69,110,24,82,61,16,5,50,31,19,5,5,30,0,30
"2021","Cheshire West and Chester 039A","E01018323",603,184,93,91,400,69,229,63,121,45,58,35,18,5,43,29,14,1,1,19,10,9
"2021","Cheshire West and Chester 039B","E01018324",556,125,74,51,416,85,242,69,121,52,38,20,16,2,49,34,15,2,2,15,8,7
"2021","Cheshire West and Chester 039C","E01018325",599,137,91,46,440,121,244,77,114,53,51,20,24,7,23,17,6,1,1,22,6,16
"2021","Cheshire West and Chester 039D","E01018385",845,211,145,66,609,165,321,107,151,63,54,24,29,1,67,38,29,2,2,25,11,14
"2021","Cheshire West and Chester 041A","E01018320",607,153,109,44,435,70,233,72,116,45,71,34,31,6,58,32,26,3,3,19,9,10
"2021","Cheshire West and Chester 041B","E01018321",559,194,115,79,356,75,180,67,86,27,60,27,32,1,41,18,23,0,0,9,2,7
"2021","Cheshire West and Chester 041C","E01018322",503,151,121,30,337,96,188,81,71,36,25,12,12,1,28,14,14,0,0,15,6,9
"2021","Cheshire West and Chester 041E","E01035379",579,153,37,116,419,25,217,59,131,27,98,59,37,2,79,54,25,0,0,7,5,2
"2021","Cheshire West and Chester 041F","E01035380",588,88,8,80,485,20,272,64,197,11,121,64,52,5,71,61,10,1,1,15,10,5
"2021","Cheshire West and Chester 041G","E01035381",591,126,59,67,448,76,242,68,128,46,59,30,19,10,70,45,25,1,1,17,6,11
"2021","Cheshire West and Chester 043A","E01018332",474,165,63,102,294,47,181,62,92,27,39,23,16,0,27,18,9,0,0,15,8,7
"2021","Cheshire West and Chester 043B","E01018333",692,189,116,73,484,167,249,86,121,42,36,28,6,2,32,18,14,0,0,19,3,16
"2021","Cheshire West and Chester 043C","E01018334",685,169,118,51,487,132,247,81,124,42,64,37,20,7,43,22,21,1,1,29,17,12
"2021","Cheshire West and Chester 043D","E01018340",746,231,142,89,479,74,226,81,105,40,63,41,16,6,108,81,27,8,8,36,19,17
"2021","Cheshire West and Chester 043E","E01018341",516,143,97,46,355,105,171,70,74,27,37,25,10,2,39,18,21,3,3,18,4,14
"2021","Cheshire West and Chester 043F","E01018342",965,423,185,238,518,60,173,72,87,14,215,127,25,63,60,39,21,10,10,24,6,18
"2021","Cheshire West and Chester 044A","E01018351",654,241,72,169,373,19,118,47,45,26,89,27,50,12,142,100,42,5,5,40,16,24
"2021","Cheshire West and Chester 044B","E01018352",904,354,134,220,505,33,242,77,126,39,150,86,59,5,78,48,30,2,2,45,14,31
"2021","Cheshire West and Chester 044C","E01018353",624,153,69,84,457,82,252,73,128,51,64,34,23,7,56,36,20,3,3,14,8,6
"2021","Cheshire West and Chester 044D","E01018354",659,155,57,98,478,48,194,79,78,37,106,55,47,4,123,96,27,7,7,26,13,13
"2021","Cheshire West and Chester 046A","E01018335",954,259,113,146,657,131,370,129,163,78,87,59,21,7,69,45,24,0,0,38,14,24
"2021","Cheshire West and Chester 046B","E01018369",659,157,81,76,470,99,263,94,116,53,72,40,26,6,35,19,16,1,1,32,17,15
"2021","Cheshire West and Chester 046C","E01018371",942,263,154,109,651,145,342,143,136,63,84,37,38,9,75,49,26,5,5,28,12,16
"2021","Cheshire West and Chester 046D","E01018372",966,275,154,121,652,160,338,130,159,49,92,57,27,8,58,33,25,4,4,39,13,26
"2021","Cheshire West and Chester 047A","E01018339",1127,294,169,125,804,162,426,157,213,56,115,62,50,3,98,68,30,3,3,29,12,17
"2021","Cheshire West and Chester 047B","E01018355",637,244,145,99,376,76,146,59,59,28,80,42,33,5,71,27,44,3,3,17,6,11
"2021","Cheshire West and Chester 047C","E01018356",688,163,74,89,495,93,272,95,107,70,71,35,31,5,53,29,24,6,6,30,9,21
"2021","Cheshire West and Chester 047D","E01018357",768,162,84,78,579,107,331,122,161,48,87,39,44,4,52,37,15,2,2,27,16,11
"2021","Cheshire West and Chester 047E","E01018373",951,265,126,139,645,126,348,144,140,64,103,64,32,7,64,36,28,4,4,41,16,25
"2021","Cheshire West and Chester 001A","E01018534",1194,490,191,299,655,77,243,81,112,50,147,80,60,7,182,106,76,6,6,49,13,36
"2021","Cheshire West and Chester 001B","E01018535",680,194,126,68,429,83,215,82,93,40,54,23,25,6,72,45,27,5,5,57,17,40
"2021","Cheshire West and Chester 001C","E01018536",815,276,165,111,521,144,253,95,110,48,72,43,25,4,52,32,20,0,0,18,4,14
"2021","Cheshire West and Chester 001D","E01018537",955,279,181,98,641,228,331,149,111,71,39,27,9,3,43,19,24,0,0,35,21,14
"2021","Cheshire West and Chester 004A","E01018518",689,153,94,59,510,171,254,118,87,49,54,34,16,4,31,15,16,0,0,26,6,20
"2021","Cheshire West and Chester 004B","E01018569",558,117,94,23,419,129,237,97,100,40,27,16,9,2,25,8,17,1,1,22,10,12
"2021","Cheshire West and Chester 004C","E01018570",599,166,90,76,415,74,231,91,95,45,60,40,18,2,43,27,16,7,7,18,5,13
"2021","Cheshire West and Chester 004D","E01018571",661,242,121,121,404,113,188,80,72,36,58,37,17,4,44,21,23,1,1,15,6,9
"2021","Cheshire West and Chester 005A","E01018546",677,226,91,135,422,36,195,67,72,56,75,40,30,5,110,66,44,6,6,29,14,15
"2021","Cheshire West and Chester 005B","E01018547",629,222,104,118,386,84,185,77,67,41,57,28,18,11,54,27,27,6,6,21,9,12
"2021","Cheshire West and Chester 005C","E01018548",926,316,150,166,559,72,261,100,101,60,101,43,48,10,120,65,55,5,5,51,24,27
"2021","Cheshire West and Chester 005D","E01018549",693,236,92,144,435,101,198,72,72,54,82,47,30,5,52,26,26,2,2,22,9,13
"2021","Cheshire West and Chester 006A","E01018532",872,305,156,149,520,104,245,96,101,48,78,44,25,9,87,52,35,6,6,47,13,34
"2021","Cheshire West and Chester 006B","E01018533",645,157,104,53,468,154,208,82,90,36,56,26,23,7,49,25,24,1,1,20,7,13
"2021","Cheshire West and Chester 006C","E01018544",638,169,94,75,447,124,227,92,79,56,54,33,17,4,41,19,22,1,1,22,8,14
"2021","Cheshire West and Chester 006D","E01018545",821,238,140,98,541,116,274,100,116,58,81,44,33,4,70,37,33,0,0,42,9,33
"2021","Cheshire West and Chester 007A","E01018519",711,318,66,252,347,19,124,50,55,19,84,45,37,2,111,80,31,9,9,46,12,34
"2021","Cheshire West and Chester 007B","E01018520",890,298,60,238,549,20,189,73,89,27,223,128,87,8,108,83,25,9,9,43,16,27
"2021","Cheshire West and Chester 007C","E01018525",755,234,98,136,486,27,195,72,88,35,108,47,54,7,152,105,47,4,4,35,18,17
"2021","Cheshire West and Chester 007F","E01035365",678,324,90,234,331,28,109,45,45,19,92,62,28,2,97,71,26,5,5,23,8,15
"2021","Cheshire West and Chester 007G","E01035366",819,228,34,194,552,19,216,58,132,26,221,127,88,6,91,60,31,5,5,39,19,20
"2021","Cheshire West and Chester 007H","E01035367",610,226,70,156,356,27,130,46,51,33,104,42,57,5,90,63,27,5,5,28,12,16
"2021","Cheshire West and Chester 007I","E01035368",652,343,94,249,288,7,75,26,36,13,75,38,35,2,126,88,38,5,5,21,11,10
"2021","Cheshire West and Chester 008A","E01018523",606,205,81,124,372,22,150,52,63,35,82,30,41,11,115,64,51,3,3,29,11,18
"2021","Cheshire West and Chester 008B","E01018524",607,188,76,112,394,10,150,41,77,32,84,21,55,8,149,112,37,1,1,25,12,13
"2021","Cheshire West and Chester 008C","E01018541",625,211,92,119,398,57,192,90,70,32,71,33,35,3,76,52,24,2,2,16,4,12
"2021","Cheshire West and Chester 008D","E01018542",511,128,41,87,351,15,124,33,64,27,75,27,42,6,134,97,37,3,3,32,15,17
"2021","Cheshire West and Chester 008E","E01018543",615,244,101,143,343,28,136,59,56,21,92,44,43,5,83,53,30,4,4,28,12,16
"2021","Cheshire West and Chester 009A","E01018528",727,165,78,87,534,63,264,101,119,44,126,62,61,3,78,46,32,3,3,28,19,9
"2021","Cheshire West and Chester 009B","E01018529",632,189,131,58,431,106,226,97,69,60,63,40,16,7,34,19,15,2,2,12,6,6
"2021","Cheshire West and Chester 009C","E01018530",570,106,48,58,454,67,306,114,123,69,54,31,18,5,26,16,10,1,1,10,6,4
"2021","Cheshire West and Chester 009D","E01018531",715,230,113,117,457,83,241,87,106,48,76,46,26,4,55,27,28,2,2,28,9,19
"2021","Cheshire West and Chester 009E","E01018560",473,103,54,49,357,65,188,69,74,45,54,32,19,3,48,21,27,2,2,13,5,8
"2021","Cheshire West and Chester 009F","E01018561",486,102,57,45,371,71,231,86,100,45,49,21,25,3,20,8,12,0,0,13,5,8
"2021","Cheshire West and Chester 009G","E01018562",555,110,32,78,428,33,280,93,127,60,75,45,28,2,37,24,13,3,3,17,7,10
"2021","Cheshire West and Chester 010A","E01018522",612,182,73,109,393,49,160,63,66,31,73,34,31,8,109,66,43,2,2,37,17,20
"2021","Cheshire West and Chester 010B","E01018538",481,125,55,70,330,40,146,56,44,46,56,29,17,10,84,57,27,4,4,26,14,12
"2021","Cheshire West and Chester 010C","E01018539",515,182,63,119,315,23,117,27,62,28,87,26,56,5,81,49,32,7,7,18,8,10
"2021","Cheshire West and Chester 010D","E01018540",616,193,102,91,396,51,206,64,94,48,79,27,48,4,59,33,26,1,1,27,9,18
"2021","Cheshire West and Chester 011A","E01018521",570,180,73,107,366,25,128,37,59,32,95,33,55,7,117,72,45,1,1,24,16,8
"2021","Cheshire West and Chester 011B","E01018550",503,192,62,130,283,21,88,29,36,23,61,27,34,0,109,69,40,4,4,28,8,20
"2021","Cheshire West and Chester 011C","E01018551",721,269,76,193,417,38,124,41,57,26,103,39,58,6,149,88,61,3,3,35,17,18
"2021","Cheshire West and Chester 011D","E01018552",1108,265,79,186,787,44,274,86,142,46,190,94,85,11,270,220,50,9,9,56,27,29
"2021","Cheshire West and Chester 011E","E01018553",747,226,103,123,471,58,203,62,99,42,99,32,59,8,109,70,39,2,2,50,22,28
"2021","Cheshire West and Chester 013A","E01018556",634,189,124,65,428,117,193,78,72,43,65,25,29,11,52,25,27,1,1,17,6,11
"2021","Cheshire West and Chester 013B","E01018557",653,257,137,120,370,43,161,63,67,31,62,25,34,3,96,62,34,8,8,26,9,17
"2021","Cheshire West and Chester 013C","E01018558",485,100,40,60,368,49,179,70,70,39,76,48,22,6,63,33,30,1,1,17,5,12
"2021","Cheshire West and Chester 013D","E01018559",463,97,57,40,355,90,166,54,63,49,57,28,25,4,42,20,22,0,0,11,6,5
"2021","Cheshire West and Chester 014A","E01018565",634,152,83,69,465,82,278,106,111,61,63,30,29,4,40,21,19,2,2,17,6,11
"2021","Cheshire West and Chester 014B","E01018566",598,182,120,62,398,111,183,75,62,46,62,40,16,6,39,18,21,3,3,18,8,10
"2021","Cheshire West and Chester 014C","E01018567",597,135,79,56,433,88,239,86,96,57,63,25,27,11,43,21,22,0,0,29,9,20
"2021","Cheshire West and Chester 014D","E01018568",570,106,27,79,448,41,289,86,151,52,82,50,25,7,36,27,9,0,0,16,5,11
"2021","Cheshire West and Chester 016A","E01018526",653,153,95,58,470,90,257,95,105,57,64,30,31,3,56,28,28,3,3,30,9,21
"2021","Cheshire West and Chester 016B","E01018527",650,148,84,64,483,92,265,90,96,79,65,30,33,2,59,31,28,2,2,19,5,14
"2021","Cheshire West and Chester 016C","E01018554",989,287,175,112,674,158,360,138,136,86,97,61,32,4,55,22,33,4,4,28,8,20
"2021","Cheshire West and Chester 016D","E01018555",485,131,61,70,339,59,166,66,70,30,73,35,31,7,39,17,22,2,2,15,4,11
"2021","Cheshire West and Chester 002A","E01018685",628,252,117,135,360,35,139,57,52,30,70,28,35,7,114,77,37,2,2,16,9,7
"2021","Cheshire West and Chester 002B","E01018686",636,172,46,126,449,43,209,62,117,30,108,74,32,2,88,53,35,1,1,15,6,9
"2021","Cheshire West and Chester 002C","E01018687",575,137,101,36,428,130,227,89,97,41,31,15,14,2,39,20,19,1,1,10,5,5
"2021","Cheshire West and Chester 002D","E01018688",711,233,126,107,459,110,237,90,107,40,55,27,24,4,53,25,28,4,4,19,6,13
"2021","Cheshire West and Chester 002E","E01018689",668,272,161,111,386,82,175,63,76,36,69,42,24,3,59,32,27,1,1,10,3,7
"2021","Cheshire West and Chester 002F","E01018690",898,219,130,89,656,148,402,150,175,77,51,30,17,4,54,26,28,1,1,23,10,13
"2021","Cheshire West and Chester 003A","E01018675",880,201,121,80,641,160,361,155,141,65,78,46,28,4,39,22,17,3,3,38,12,26
"2021","Cheshire West and Chester 003B","E01018708",943,227,145,82,682,153,386,165,144,77,90,57,27,6,52,23,29,1,1,34,18,16
"2021","Cheshire West and Chester 003C","E01018721",988,235,143,92,709,167,406,198,131,77,81,55,25,1,52,25,27,3,3,44,19,25
"2021","Cheshire West and Chester 012A","E01018671",514,104,65,39,387,101,208,96,81,31,46,27,16,3,32,17,15,0,0,23,11,12
"2021","Cheshire West and Chester 012B","E01018672",720,194,91,103,497,57,193,75,83,35,126,56,57,13,116,81,35,5,5,29,17,12
"2021","Cheshire West and Chester 012C","E01018673",537,177,98,79,340,63,154,64,53,37,67,27,38,2,53,38,15,3,3,20,8,12
"2021","Cheshire West and Chester 012D","E01018674",702,223,74,149,453,55,198,77,93,28,119,71,44,4,77,49,28,4,4,26,6,20
"2021","Cheshire West and Chester 015A","E01018684",1006,228,137,91,749,197,420,198,145,77,88,52,24,12,44,20,24,0,0,29,11,18
"2021","Cheshire West and Chester 015B","E01018695",943,329,154,175,584,77,262,102,108,52,149,95,47,7,94,61,33,2,2,30,10,20
"2021","Cheshire West and Chester 015C","E01018696",667,198,122,76,457,114,229,81,97,51,71,40,28,3,41,20,21,2,2,12,6,6
"2021","Cheshire West and Chester 015D","E01018697",778,233,125,108,527,92,278,91,125,62,91,67,21,3,62,36,26,4,4,18,9,9
"2021","Cheshire West and Chester 015E","E01018698",843,186,128,58,626,167,354,152,136,66,68,40,25,3,36,21,15,1,1,31,14,17
"2021","Cheshire West and Chester 017A","E01018704",619,226,121,105,373,74,178,74,70,34,64,36,22,6,55,32,23,2,2,20,8,12
"2021","Cheshire West and Chester 017B","E01018705",620,139,74,65,457,93,261,102,114,45,55,34,19,2,48,24,24,0,0,24,12,12
"2021","Cheshire West and Chester 017C","E01018706",734,169,59,110,537,61,266,96,123,47,128,71,44,13,79,54,25,3,3,28,9,19
"2021","Cheshire West and Chester 017D","E01018718",799,215,90,125,547,78,289,123,115,51,113,73,30,10,61,30,31,6,6,37,17,20
"2021","Cheshire West and Chester 017E","E01018722",1115,250,151,99,822,192,440,188,166,86,94,62,31,1,94,31,63,2,2,43,16,27
"2021","Cheshire West and Chester 018B","E01018714",1043,535,164,371,470,52,156,60,70,26,148,65,77,6,106,80,26,8,8,38,10,28
"2021","Cheshire West and Chester 018C","E01018715",798,294,69,225,463,42,167,76,53,38,138,69,62,7,102,64,38,14,14,41,13,28
"2021","Cheshire West and Chester 018D","E01035369",570,221,70,151,330,35,114,53,50,11,117,73,42,2,63,40,23,1,1,19,11,8
"2021","Cheshire West and Chester 018E","E01035370",606,99,12,87,489,16,273,65,185,23,146,84,58,4,51,37,14,3,3,18,10,8
"2021","Cheshire West and Chester 018F","E01035371",518,168,56,112,321,42,150,54,62,34,79,44,29,6,50,34,16,0,0,29,11,18
"2021","Cheshire West and Chester 018G","E01035372",616,123,26,97,480,20,243,65,151,27,171,98,68,5,45,33,12,1,1,13,3,10
"2021","Cheshire West and Chester 019A","E01018726",622,163,73,90,431,70,195,74,75,46,79,24,45,10,86,48,38,1,1,28,14,14
"2021","Cheshire West and Chester 019B","E01018727",794,202,115,87,562,153,273,121,101,51,77,53,22,2,57,25,32,2,2,30,10,20
"2021","Cheshire West and Chester 019C","E01018728",633,160,86,74,447,55,233,71,114,48,86,29,46,11,69,35,34,4,4,26,13,13
"2021","Cheshire West and Chester 019D","E01018729",750,259,135,124,461,60,198,60,93,45,90,40,45,5,109,68,41,4,4,30,15,15
"2021","Cheshire West and Chester 020A","E01018709",671,231,55,176,409,24,154,57,71,26,129,70,52,7,95,62,33,7,7,31,8,23
"2021","Cheshire West and Chester 020B","E01018710",589,180,73,107,373,40,181,70,77,34,74,35,32,7,74,48,26,4,4,36,12,24
"2021","Cheshire West and Chester 020C","E01018711",722,289,103,186,414,66,208,89,91,28,81,56,23,2,57,37,20,2,2,19,6,13
"2021","Cheshire West and Chester 020D","E01018712",744,310,108,202,398,58,181,75,69,37,86,50,30,6,69,42,27,4,4,36,13,23
"2021","Cheshire West and Chester 021A","E01018699",654,163,79,84,467,69,238,81,113,44,72,50,17,5,87,53,34,1,1,24,11,13
"2021","Cheshire West and Chester 021B","E01018701",626,206,111,95,397,45,146,46,69,31,89,45,41,3,111,75,36,6,6,23,9,14
"2021","Cheshire West and Chester 021C","E01018716",659,207,99,108,405,48,177,67,70,40,83,38,38,7,93,53,40,4,4,47,23,24
"2021","Cheshire West and Chester 021D","E01018717",739,208,65,143,478,59,219,77,95,47,100,60,32,8,89,56,33,11,11,53,23,30
"2021","Cheshire West and Chester 021E","E01018719",636,175,76,99,434,58,212,92,80,40,92,48,32,12,70,39,31,2,2,27,7,20
"2021","Cheshire West and Chester 021F","E01018720",775,240,115,125,507,53,200,74,75,51,136,68,57,11,114,74,40,4,4,28,15,13
"2021","Cheshire West and Chester 023A","E01018691",726,217,107,110,488,101,267,86,135,46,72,39,31,2,47,25,22,1,1,21,3,18
"2021","Cheshire West and Chester 023B","E01018693",865,216,114,102,623,126,373,134,181,58,74,41,32,1,48,31,17,2,2,26,13,13
"2021","Cheshire West and Chester 023C","E01018694",917,207,113,94,695,145,403,130,207,66,71,39,29,3,75,46,29,1,1,15,4,11
"2021","Cheshire West and Chester 023D","E01018700",748,173,55,118,565,61,367,112,195,60,76,43,27,6,59,45,14,2,2,10,9,1
"2021","Cheshire West and Chester 023E","E01018702",583,123,34,89,448,47,272,83,143,46,66,35,29,2,62,37,25,1,1,12,5,7
"2021","Cheshire West and Chester 023F","E01018703",967,362,150,212,584,128,275,111,115,49,107,73,29,5,71,43,28,3,3,21,9,12
"2021","Cheshire West and Chester 024A","E01018676",798,185,108,77,598,158,305,124,144,37,63,31,29,3,72,40,32,0,0,15,5,10
"2021","Cheshire West and Chester 024B","E01018677",749,188,121,67,533,164,270,124,97,49,62,35,21,6,35,15,20,2,2,28,10,18
"2021","Cheshire West and Chester 024C","E01018678",516,114,81,33,394,102,218,80,98,40,37,18,17,2,35,13,22,2,2,8,4,4
"2021","Cheshire West and Chester 024D","E01018679",908,252,123,129,628,79,302,89,154,59,147,57,83,7,100,65,35,0,0,28,14,14
"2021","Cheshire West and Chester 024E","E01018692",817,170,103,67,620,136,382,151,177,54,68,34,25,9,32,15,17,2,2,27,9,18
"2021","Cheshire West and Chester 026A","E01018680",712,157,77,80,531,105,296,120,121,55,69,41,25,3,61,32,29,0,0,24,9,15
"2021","Cheshire West and Chester 026B","E01018681",718,177,76,101,516,114,225,81,96,48,90,46,43,1,83,52,31,4,4,25,10,15
"2021","Cheshire West and Chester 026C","E01018682",582,172,82,90,388,73,183,72,77,34,66,36,25,5,64,42,22,2,2,22,7,15
"2021","Cheshire West and Chester 026D","E01018683",751,197,109,88,535,108,296,113,138,45,80,38,38,4,48,28,20,3,3,19,9,10
"2021","Cheshire West and Chester 035A","E01018733",632,190,116,74,419,86,193,98,47,48,80,48,30,2,56,26,30,4,4,23,4,19
"2021","Cheshire West and Chester 035B","E01018734",512,148,74,74,341,61,154,59,67,28,68,33,31,4,56,26,30,2,2,23,8,15
"2021","Cheshire West and Chester 035C","E01018748",510,129,65,64,325,10,118,31,47,40,61,14,38,9,133,96,37,3,3,56,27,29
"2021","Cheshire West and Chester 035D","E01018749",974,202,42,160,715,50,352,130,162,60,162,72,78,12,144,98,46,7,7,57,26,31
"2021","Cheshire West and Chester 037A","E01018736",741,189,67,122,513,61,230,96,87,47,129,47,73,9,90,53,37,3,3,39,12,27
"2021","Cheshire West and Chester 037B","E01018737",861,152,51,101,675,76,340,130,141,69,166,94,67,5,90,68,22,3,3,34,16,18
"2021","Cheshire West and Chester 037C","E01018743",607,176,82,94,409,103,198,85,60,53,61,36,24,1,44,25,19,3,3,22,9,13
"2021","Cheshire West and Chester 037D","E01018744",678,146,63,83,501,56,237,87,91,59,95,39,48,8,109,58,51,4,4,31,10,21
"2021","Cheshire West and Chester 038A","E01018732",552,168,57,111,351,42,157,69,48,40,92,52,33,7,58,32,26,2,2,33,12,21
"2021","Cheshire West and Chester 038B","E01018745",716,298,122,176,388,22,153,57,60,36,79,32,39,8,131,83,48,3,3,30,15,15
"2021","Cheshire West and Chester 038C","E01018746",855,300,108,192,516,66,232,94,85,53,102,49,47,6,106,68,38,10,10,39,18,21
"2021","Cheshire West and Chester 038D","E01018747",742,216,79,137,486,48,201,84,72,45,144,58,76,10,88,50,38,5,5,40,12,28
"2021","Cheshire West and Chester 040A","E01018730",652,222,118,104,391,60,181,65,71,45,80,39,36,5,68,39,29,2,2,39,12,27
"2021","Cheshire West and Chester 040B","E01018738",681,182,108,74,458,26,124,34,65,25,145,21,117,7,161,124,37,2,2,41,21,20
"2021","Cheshire West and Chester 040C","E01018739",819,227,41,186,550,33,187,55,97,35,149,71,71,7,177,143,34,4,4,42,16,26
"2021","Cheshire West and Chester 040D","E01018741",518,157,70,87,335,77,173,69,71,33,49,27,16,6,33,17,16,3,3,26,11,15
"2021","Cheshire West and Chester 042A","E01018731",849,243,81,162,551,52,238,85,112,41,143,82,55,6,108,58,50,10,10,55,18,37
"2021","Cheshire West and Chester 042B","E01018735",553,148,46,102,388,60,199,96,55,48,87,59,25,3,38,22,16,4,4,17,5,12
"2021","Cheshire West and Chester 042C","E01018740",619,202,87,115,382,48,147,50,59,38,67,20,40,7,115,88,27,5,5,35,20,15
"2021","Cheshire West and Chester 042D","E01018742",968,220,95,125,714,107,355,135,143,77,168,77,82,9,81,58,23,3,3,34,13,21
"2021","Cheshire West and Chester 045A","E01018707",771,193,125,68,544,148,293,135,106,52,60,31,23,6,40,18,22,3,3,34,17,17
"2021","Cheshire West and Chester 045B","E01018723",641,191,98,93,428,87,218,83,108,27,64,40,24,0,56,37,19,3,3,22,4,18
"2021","Cheshire West and Chester 045C","E01018724",799,243,157,86,539,155,273,101,136,36,53,31,17,5,58,36,22,0,0,17,7,10
"2021","Cheshire West and Chester 045D","E01018725",585,122,74,48,431,87,244,88,111,45,52,29,18,5,47,21,26,1,1,32,18,14
"2021","Allerdale 001A","E01019126",757,266,147,119,476,81,200,85,67,48,96,48,42,6,96,68,28,3,3,15,5,10
"2021","Allerdale 001B","E01019127",715,209,148,61,481,165,228,123,50,55,50,28,16,6,34,22,12,4,4,25,9,16
"2021","Allerdale 001C","E01019132",761,185,99,86,546,124,305,124,106,75,62,31,27,4,51,29,22,4,4,30,18,12
"2021","Allerdale 001D","E01019134",655,230,128,102,416,112,196,93,56,47,71,30,37,4,35,11,24,2,2,9,5,4
"2021","Allerdale 001E","E01019135",709,228,120,108,462,78,182,75,71,36,100,42,46,12,97,58,39,5,5,19,7,12
"2021","Allerdale 001F","E01019136",863,254,114,140,581,91,288,97,142,49,106,48,49,9,93,63,30,3,3,28,16,12
"2021","Allerdale 001G","E01019137",560,294,128,166,252,51,92,34,33,25,52,39,12,1,53,26,27,4,4,14,5,9
"2021","Allerdale 002A","E01019083",802,216,124,92,553,133,301,142,105,54,77,42,33,2,39,15,24,3,3,33,9,24
"2021","Allerdale 002B","E01019107",700,210,125,85,470,105,257,124,78,55,70,34,32,4,35,16,19,3,3,20,10,10
"2021","Allerdale 002C","E01019130",759,180,97,83,561,122,310,128,118,64,74,41,28,5,54,27,27,1,1,18,6,12
"2021","Allerdale 002D","E01019131",803,213,120,93,559,130,307,120,102,85,79,55,20,4,38,17,21,5,5,31,10,21
"2021","Allerdale 003A","E01019081",828,271,118,153,542,95,225,89,92,44,107,48,50,9,113,76,37,2,2,15,7,8
"2021","Allerdale 003B","E01019082",675,228,108,120,427,87,196,88,73,35,91,41,46,4,51,28,23,2,2,20,8,12
"2021","Allerdale 003C","E01019102",723,222,120,102,475,91,240,120,79,41,73,35,33,5,67,37,30,4,4,26,11,15
"2021","Allerdale 003D","E01019128",691,176,103,73,478,110,233,109,85,39,81,37,38,6,50,25,25,4,4,37,18,19
"2021","Allerdale 003E","E01019133",683,201,90,111,457,102,262,107,89,66,59,34,22,3,32,14,18,2,2,25,12,13
"2021","Allerdale 004A","E01019093",670,166,80,86,475,92,232,92,97,43,99,51,41,7,51,32,19,1,1,29,11,18
"2021","Allerdale 004B","E01019094",924,268,129,139,636,107,337,126,158,53,111,59,44,8,77,53,24,4,4,20,9,11
"2021","Allerdale 004C","E01019096",982,282,167,115,683,173,322,135,133,54,110,53,49,8,73,43,30,5,5,17,5,12
"2021","Allerdale 004D","E01019114",644,216,85,131,386,73,190,73,67,50,74,34,30,10,49,28,21,0,0,42,13,29
"2021","Allerdale 004E","E01019115",792,394,147,247,378,71,157,62,59,36,84,49,25,10,64,42,22,2,2,20,8,12
"2021","Allerdale 005A","E01019095",644,246,99,147,379,50,129,58,42,29,86,32,49,5,111,81,30,3,3,19,10,9
"2021","Allerdale 005B","E01019097",771,240,117,123,506,48,181,60,67,54,119,45,68,6,151,96,55,7,7,25,18,7
"2021","Allerdale 005C","E01019098",713,232,103,129,452,65,194,68,73,53,92,31,51,10,96,61,35,5,5,29,19,10
"2021","Allerdale 005D","E01019099",783,254,117,137,505,84,216,96,70,50,94,54,39,1,106,80,26,5,5,24,9,15
"2021","Allerdale 006A","E01019084",723,228,93,135,473,69,245,90,110,45,82,42,37,3,75,46,29,2,2,22,13,9
"2021","Allerdale 006B","E01019085",828,193,69,124,612,119,333,122,162,49,95,61,30,4,64,44,20,1,1,23,10,13
"2021","Allerdale 006C","E01019086",452,113,71,42,324,83,203,75,93,35,23,15,6,2,14,8,6,1,1,15,7,8
"2021","Allerdale 006D","E01019088",1050,567,244,323,467,101,194,94,71,29,85,64,18,3,85,50,35,2,2,16,4,12
"2021","Allerdale 006E","E01019091",782,210,122,88,544,126,305,143,111,51,80,53,23,4,31,15,16,2,2,28,14,14
"2021","Allerdale 007A","E01019078",646,187,118,69,447,130,239,90,98,51,47,28,14,5,30,19,11,1,1,12,8,4
"2021","Allerdale 007B","E01019079",652,206,120,86,432,109,222,96,92,34,52,32,15,5,49,34,15,0,0,14,5,9
"2021","Allerdale 007C","E01019080",905,322,118,204,556,80,249,97,112,40,94,52,35,7,129,83,46,4,4,27,5,22
"2021","Allerdale 007D","E01019087",703,220,135,85,467,108,261,113,109,39,58,32,21,5,40,19,21,0,0,16,5,11
"2021","Allerdale 007E","E01019090",649,174,97,77,441,116,249,141,71,37,49,34,14,1,26,10,16,1,1,34,9,25
"2021","Allerdale 008A","E01019116",613,292,87,205,304,48,135,60,43,32,60,42,15,3,59,35,24,2,2,17,7,10
"2021","Allerdale 008B","E01019118",642,274,90,184,349,38,135,61,53,21,97,58,29,10,73,47,26,6,6,19,9,10
"2021","Allerdale 008C","E01019122",673,304,95,209,348,43,142,65,45,32,64,26,33,5,97,75,22,2,2,21,12,9
"2021","Allerdale 008D","E01019123",762,212,113,99,535,90,236,78,103,55,111,44,62,5,96,68,28,2,2,15,6,9
"2021","Allerdale 008E","E01019124",844,199,130,69,631,134,346,147,123,76,108,51,50,7,42,21,21,1,1,14,8,6
"2021","Allerdale 008F","E01019125",682,227,118,109,446,103,222,102,85,35,60,28,25,7,58,35,23,3,3,9,5,4
"2021","Allerdale 009A","E01019111",823,268,94,174,534,58,210,86,90,34,119,50,65,4,141,107,34,6,6,21,13,8
"2021","Allerdale 009B","E01019112",733,236,89,147,461,52,181,78,61,42,92,28,56,8,130,81,49,6,6,36,20,16
"2021","Allerdale 009C","E01019113",815,367,148,219,429,30,143,61,54,28,77,30,40,7,173,131,42,6,6,19,8,11
"2021","Allerdale 009D","E01019120",785,321,121,200,452,51,212,100,66,46,106,55,46,5,80,48,32,3,3,12,4,8
"2021","Allerdale 009E","E01019121",1041,564,184,380,445,53,178,80,57,41,107,62,40,5,104,64,40,3,3,32,14,18
"2021","Allerdale 010A","E01019108",651,172,65,107,459,48,161,65,57,39,97,39,52,6,150,117,33,3,3,20,7,13
"2021","Allerdale 010B","E01019109",737,218,111,107,492,60,219,90,80,49,88,38,43,7,121,90,31,4,4,27,17,10
"2021","Allerdale 010C","E01019110",830,384,133,251,430,60,152,67,43,42,81,35,41,5,133,102,31,4,4,16,9,7
"2021","Allerdale 010D","E01019117",640,223,88,135,404,66,189,82,71,36,96,58,31,7,51,33,18,2,2,13,6,7
"2021","Allerdale 010E","E01019119",643,170,104,66,462,133,250,109,84,57,49,27,18,4,30,14,16,0,0,11,3,8
"2021","Allerdale 011A","E01019089",742,262,116,146,467,63,218,97,90,31,88,38,47,3,94,60,34,4,4,13,4,9
"2021","Allerdale 011B","E01019100",912,295,114,181,577,83,278,112,116,50,128,64,60,4,87,56,31,1,1,40,20,20
"2021","Allerdale 011C","E01019101",623,156,91,65,460,125,245,107,96,42,59,26,29,4,31,13,18,0,0,7,3,4
"2021","Allerdale 011D","E01019129",902,216,111,105,670,144,364,145,153,66,101,57,40,4,60,37,23,1,1,16,8,8
"2021","Allerdale 012A","E01019092",618,169,99,70,417,117,213,96,73,44,61,42,17,2,25,9,16,1,1,32,4,28
"2021","Allerdale 012C","E01019104",719,348,203,145,353,108,136,75,45,16,53,29,20,4,51,30,21,5,5,18,6,12
"2021","Allerdale 012E","E01019106",631,184,109,75,415,114,216,113,68,35,47,26,18,3,37,14,23,1,1,32,16,16
"2021","Allerdale 012F","E01034068",939,320,157,163,568,99,281,129,98,54,99,64,31,4,80,45,35,9,9,51,19,32
"2021","Barrow-in-Furness 001A","E01019144",607,174,96,78,415,89,221,99,70,52,63,34,26,3,41,17,24,1,1,18,8,10
"2021","Barrow-in-Furness 001B","E01019145",886,269,119,150,605,82,335,143,119,73,120,61,54,5,66,34,32,2,2,12,3,9
"2021","Barrow-in-Furness 001C","E01019146",582,179,96,83,388,69,225,91,82,52,60,33,25,2,34,16,18,0,0,15,7,8
"2021","Barrow-in-Furness 001D","E01019147",703,280,91,189,404,47,177,55,84,38,87,43,36,8,89,54,35,4,4,19,12,7
"2021","Barrow-in-Furness 002A","E01019148",604,185,109,76,406,87,211,91,74,46,64,38,22,4,42,21,21,2,2,13,5,8
"2021","Barrow-in-Furness 002B","E01019149",682,237,71,166,421,71,205,82,78,45,82,53,25,4,62,30,32,1,1,24,10,14
"2021","Barrow-in-Furness 002C","E01019150",754,311,118,193,418,48,168,77,56,35,108,61,43,4,91,66,25,3,3,25,10,15
"2021","Barrow-in-Furness 002D","E01019151",611,162,101,61,433,95,169,65,69,35,89,32,51,6,80,40,40,0,0,16,8,8
"2021","Barrow-in-Furness 003A","E01019152",528,163,67,96,342,65,209,61,105,43,49,23,25,1,19,11,8,0,0,23,13,10
"2021","Barrow-in-Furness 003B","E01019153",460,133,90,43,310,77,164,75,46,43,46,22,20,4,20,7,13,3,3,17,7,10
"2021","Barrow-in-Furness 003C","E01019154",623,208,151,57,392,129,195,86,65,44,45,23,22,0,22,3,19,1,1,23,10,13
"2021","Barrow-in-Furness 003D","E01019155",670,248,190,58,404,162,178,87,58,33,36,19,15,2,25,9,16,3,3,18,9,9
"2021","Barrow-in-Furness 003E","E01019162",676,174,95,79,488,97,259,95,118,46,85,41,38,6,45,25,20,2,2,14,5,9
"2021","Barrow-in-Furness 003F","E01019163",501,106,62,44,378,103,217,75,99,43,37,17,18,2,21,12,9,0,0,17,6,11
"2021","Barrow-in-Furness 004A","E01019156",770,427,185,242,318,32,90,31,46,13,84,40,38,6,104,79,25,8,8,25,10,15
"2021","Barrow-in-Furness 004B","E01019159",566,209,62,147,344,30,142,58,52,32,80,38,41,1,85,54,31,7,7,13,5,8
"2021","Barrow-in-Furness 004C","E01019164",619,196,61,135,402,26,146,45,63,38,91,25,58,8,136,95,41,3,3,21,10,11
"2021","Barrow-in-Furness 004D","E01019165",687,260,103,157,402,58,163,81,54,28,83,29,47,7,95,71,24,3,3,25,12,13
"2021","Barrow-in-Furness 004E","E01019166",640,288,103,185,333,39,136,59,44,33,65,30,30,5,88,59,29,5,5,19,10,9
"2021","Barrow-in-Furness 005A","E01019167",715,305,101,204,396,57,155,64,61,30,98,56,36,6,85,61,24,1,1,14,5,9
"2021","Barrow-in-Furness 005B","E01019168",596,186,109,77,387,62,213,93,74,46,65,35,24,6,45,23,22,2,2,23,9,14
"2021","Barrow-in-Furness 005C","E01019169",544,130,69,61,396,68,218,80,92,46,65,30,30,5,44,24,20,1,1,18,4,14
"2021","Barrow-in-Furness 005D","E01019170",505,133,45,88,349,33,169,54,73,42,81,33,42,6,63,38,25,3,3,23,10,13
"2021","Barrow-in-Furness 005E","E01019171",578,231,65,166,335,27,113,45,43,25,95,46,48,1,97,67,30,3,3,12,3,9
"2021","Barrow-in-Furness 006A","E01019161",816,207,99,108,588,65,301,94,156,51,120,49,62,9,101,56,45,1,1,21,14,7
"2021","Barrow-in-Furness 006B","E01019176",742,165,112,53,558,137,315,117,145,53,71,29,34,8,32,13,19,3,3,19,14,5
"2021","Barrow-in-Furness 006C","E01019177",609,190,78,112,402,47,193,71,81,41,69,26,40,3,92,69,23,1,1,17,12,5
"2021","Barrow-in-Furness 006D","E01019178",696,198,105,93,467,90,221,99,74,48,95,50,42,3,59,31,28,2,2,31,14,17
"2021","Barrow-in-Furness 006E","E01019179",523,123,61,62,389,99,199,88,72,39,60,36,20,4,31,13,18,0,0,11,4,7
"2021","Barrow-in-Furness 007B","E01019160",611,235,83,152,354,30,154,52,61,41,82,23,54,5,86,46,40,2,2,22,10,12
"2021","Barrow-in-Furness 007C","E01019172",618,256,78,178,341,32,134,61,53,20,87,44,42,1,84,57,27,4,4,21,7,14
"2021","Barrow-in-Furness 007D","E01019173",566,232,74,158,324,46,113,54,35,24,75,35,40,0,87,47,40,3,3,10,3,7
"2021","Barrow-in-Furness 007F","E01019175",601,163,81,82,412,47,157,52,72,33,100,34,52,14,102,63,39,6,6,26,11,15
"2021","Barrow-in-Furness 007G","E01034069",927,359,117,242,534,34,205,73,78,54,112,46,52,14,175,121,54,8,8,34,19,15
"2021","Barrow-in-Furness 008A","E01019141",721,441,123,318,252,21,71,32,25,14,75,43,31,1,81,63,18,4,4,28,5,23
"2021","Barrow-in-Furness 008B","E01019142",664,282,72,210,357,26,92,37,36,19,91,41,47,3,139,97,42,9,9,25,12,13
"2021","Barrow-in-Furness 008C","E01019143",655,336,81,255,274,25,85,30,43,12,74,28,36,10,85,61,24,5,5,45,20,25
"2021","Barrow-in-Furness 008D","E01019157",702,352,107,245,331,32,122,60,35,27,86,47,33,6,88,60,28,3,3,19,11,8
"2021","Barrow-in-Furness 008E","E01019158",557,249,74,175,287,13,89,40,30,19,75,36,38,1,104,78,26,6,6,21,5,16
"2021","Barrow-in-Furness 009A","E01019180",817,274,170,104,525,142,244,121,70,53,85,49,34,2,53,28,25,1,1,18,3,15
"2021","Barrow-in-Furness 009C","E01019182",631,200,80,120,415,64,200,79,84,37,86,36,47,3,64,41,23,1,1,16,8,8
"2021","Barrow-in-Furness 009E","E01019184",652,247,85,162,387,56,155,71,57,27,96,40,52,4,78,49,29,2,2,18,11,7
"2021","Barrow-in-Furness 009F","E01033160",1043,381,204,177,637,108,258,102,106,50,134,61,57,16,134,79,55,3,3,25,13,12
"2021","Barrow-in-Furness 010A","E01019138",597,249,94,155,339,66,135,64,44,27,60,31,25,4,78,49,29,0,0,9,2,7
"2021","Barrow-in-Furness 010B","E01019139",624,373,58,315,234,15,74,36,23,15,75,39,32,4,65,39,26,5,5,17,3,14
"2021","Barrow-in-Furness 010C","E01019185",616,172,107,65,439,109,224,98,83,43,61,23,31,7,41,23,18,4,4,5,1,4
"2021","Barrow-in-Furness 010D","E01019186",604,246,99,147,345,62,124,44,49,31,87,39,45,3,72,47,25,0,0,13,4,9
"2021","Barrow-in-Furness 010E","E01019187",567,182,86,96,361,67,164,68,64,32,72,22,46,4,57,35,22,1,1,24,11,13
"2021","Carlisle 001A","E01019226",485,117,54,63,348,77,199,90,76,33,41,19,18,4,29,13,16,2,2,20,7,13
"2021","Carlisle 001B","E01019227",679,291,123,168,372,61,145,72,50,23,87,40,41,6,73,52,21,6,6,16,9,7
"2021","Carlisle 001C","E01019228",713,224,101,123,469,85,242,93,92,57,85,47,34,4,52,29,23,5,5,20,4,16
"2021","Carlisle 001D","E01019229",830,239,127,112,552,104,322,163,102,57,67,42,19,6,53,22,31,6,6,39,9,30
"2021","Carlisle 002A","E01019200",762,235,131,104,507,141,236,117,85,34,75,46,26,3,52,31,21,3,3,20,6,14
"2021","Carlisle 002B","E01019201",708,329,190,139,367,84,167,73,61,33,46,25,15,6,70,42,28,0,0,12,4,8
"2021","Carlisle 002C","E01019202",720,270,129,141,432,55,193,80,74,39,81,39,32,10,102,70,32,1,1,18,8,10
"2021","Carlisle 002D","E01019225",845,220,97,123,585,133,310,157,96,57,88,53,27,8,51,23,28,3,3,40,24,16
"2021","Carlisle 003A","E01019188",701,247,103,144,428,61,196,76,89,31,79,30,45,4,89,57,32,3,3,26,13,13
"2021","Carlisle 003B","E01019189",660,257,76,181,384,35,170,65,60,45,89,50,34,5,86,60,26,4,4,19,8,11
"2021","Carlisle 003C","E01019190",784,240,155,85,528,150,271,108,116,47,69,42,26,1,36,22,14,2,2,16,9,7
"2021","Carlisle 003D","E01019191",686,236,142,94,435,109,221,89,88,44,50,26,22,2,54,33,21,1,1,15,3,12
"2021","Carlisle 003E","E01019244",671,213,152,61,444,93,237,93,102,42,68,37,25,6,45,25,20,1,1,14,3,11
"2021","Carlisle 004A","E01019196",840,277,115,162,531,79,251,115,91,45,112,58,47,7,83,49,34,6,6,32,16,16
"2021","Carlisle 004B","E01019238",674,182,103,79,474,103,250,109,111,30,72,45,26,1,46,31,15,3,3,18,10,8
"2021","Carlisle 004C","E01019240",898,209,91,118,652,102,377,134,177,66,113,59,49,5,59,39,20,1,1,37,18,19
"2021","Carlisle 004D","E01019241",795,172,86,86,610,138,323,113,155,55,84,54,27,3,65,45,20,0,0,13,8,5
"2021","Carlisle 004E","E01019243",621,201,102,99,406,89,204,82,80,42,65,39,19,7,44,27,17,4,4,14,4,10
"2021","Carlisle 004F","E01019251",927,252,136,116,648,123,332,129,149,54,115,68,42,5,75,55,20,3,3,27,14,13
"2021","Carlisle 005A","E01019192",603,160,106,54,425,108,216,86,81,49,57,27,28,2,41,22,19,3,3,18,7,11
"2021","Carlisle 005B","E01019195",570,161,93,68,396,85,223,91,84,48,58,23,32,3,30,19,11,0,0,13,7,6
"2021","Carlisle 005C","E01019203",925,214,113,101,667,142,415,190,164,61,69,40,25,4,40,21,19,1,1,44,14,30
"2021","Carlisle 005D","E01019254",599,162,96,66,428,99,215,101,71,43,68,28,34,6,43,24,19,3,3,9,2,7
"2021","Carlisle 005E","E01019255",550,108,69,39,427,89,236,112,78,46,67,33,30,4,33,14,19,2,2,15,6,9
"2021","Carlisle 006A","E01019204",603,365,66,299,214,30,72,40,22,10,74,57,17,0,36,24,12,2,2,24,4,20
"2021","Carlisle 006B","E01019206",917,561,89,472,276,18,137,57,48,32,89,69,16,4,26,15,11,6,6,80,13,67
"2021","Carlisle 006C","E01019234",807,450,136,314,295,28,96,52,27,17,80,51,26,3,86,57,29,5,5,62,8,54
"2021","Carlisle 006D","E01019235",673,251,90,161,381,64,149,67,53,29,102,59,37,6,58,29,29,8,8,41,8,33
"2021","Carlisle 006E","E01019237",558,200,59,141,313,44,168,62,71,35,55,30,19,6,43,23,20,3,3,45,16,29
"2021","Carlisle 006F","E01019242",602,269,138,131,295,54,145,50,69,26,54,27,23,4,35,21,14,7,7,38,13,25
"2021","Carlisle 007A","E01019219",986,300,165,135,652,149,354,168,128,58,97,59,30,8,52,30,22,0,0,34,14,20
"2021","Carlisle 007B","E01019224",883,248,150,98,602,160,314,128,121,65,63,37,25,1,63,36,27,2,2,33,10,23
"2021","Carlisle 007C","E01019239",613,156,74,82,426,85,243,89,89,65,66,39,22,5,32,15,17,0,0,31,19,12
"2021","Carlisle 007D","E01019249",740,220,137,83,505,155,255,132,82,41,68,34,30,4,27,12,15,0,0,15,5,10
"2021","Carlisle 007E","E01019250",719,193,106,87,509,101,288,117,120,51,77,51,25,1,41,19,22,2,2,17,6,11
"2021","Carlisle 008A","E01019205",876,432,98,334,398,35,143,78,44,21,96,60,33,3,118,79,39,6,6,46,6,40
"2021","Carlisle 008B","E01019207",683,297,74,223,363,27,116,49,42,25,111,71,34,6,103,74,29,6,6,23,7,16
"2021","Carlisle 008C","E01019215",758,338,120,218,393,48,170,70,72,28,92,54,36,2,81,53,28,2,2,27,4,23
"2021","Carlisle 008D","E01019218",633,211,68,143,402,37,178,69,79,30,91,44,42,5,95,60,35,1,1,20,9,11
"2021","Carlisle 008E","E01019233",643,241,133,108,383,82,169,73,51,45,68,32,32,4,63,35,28,1,1,19,10,9
"2021","Carlisle 009A","E01019193",869,300,91,209,552,28,197,83,89,25,143,58,82,3,179,130,49,5,5,17,9,8
"2021","Carlisle 009B","E01019194",890,281,91,190,581,45,245,76,125,44,143,62,78,3,146,106,40,2,2,28,12,16
"2021","Carlisle 009C","E01019230",799,359,153,206,428,54,164,66,59,39,101,49,50,2,105,61,44,4,4,12,2,10
"2021","Carlisle 009D","E01019231",922,468,157,311,437,40,156,63,62,31,116,56,54,6,122,95,27,3,3,17,5,12
"2021","Carlisle 009E","E01019232",635,211,93,118,407,70,192,69,85,38,87,45,38,4,53,31,22,5,5,17,3,14
"2021","Carlisle 009F","E01019252",654,238,120,118,401,104,147,65,57,25,74,32,33,9,74,40,34,2,2,15,4,11
"2021","Carlisle 010A","E01019209",666,280,82,198,363,32,171,72,72,27,84,48,31,5,74,45,29,2,2,23,10,13
"2021","Carlisle 010B","E01019211",790,355,81,274,413,26,164,71,61,32,132,81,46,5,85,52,33,6,6,22,6,16
"2021","Carlisle 010C","E01019216",851,438,129,309,375,27,141,61,54,26,130,80,48,2,75,46,29,2,2,38,9,29
"2021","Carlisle 010D","E01019217",874,418,86,332,419,39,158,80,50,28,123,90,31,2,96,55,41,3,3,37,12,25
"2021","Carlisle 010E","E01019220",687,251,73,178,410,49,208,84,85,39,91,51,39,1,54,26,28,8,8,26,9,17
"2021","Carlisle 010F","E01019236",797,342,61,281,383,14,163,70,76,17,115,74,36,5,80,55,25,11,11,72,18,54
"2021","Carlisle 011A","E01019197",876,262,116,146,571,46,216,65,109,42,125,53,62,10,180,141,39,4,4,43,24,19
"2021","Carlisle 011B","E01019198",616,242,92,150,357,37,135,56,56,23,88,45,39,4,95,65,30,2,2,17,9,8
"2021","Carlisle 011C","E01019199",486,161,56,105,318,26,113,44,49,20,72,29,37,6,107,88,19,0,0,7,0,7
"2021","Carlisle 011D","E01019221",813,284,101,183,505,50,199,78,84,37,123,57,55,11,129,87,42,4,4,24,10,14
"2021","Carlisle 011E","E01019222",780,316,132,184,436,47,198,61,96,41,87,38,48,1,101,75,26,3,3,28,8,20
"2021","Carlisle 011F","E01019245",646,234,85,149,376,24,161,52,72,37,92,33,50,9,94,60,34,5,5,36,19,17
"2021","Carlisle 012A","E01019208",613,169,66,103,426,36,167,67,64,36,114,42,61,11,106,76,30,3,3,18,7,11
"2021","Carlisle 012B","E01019210",557,156,66,90,388,41,160,62,63,35,69,29,34,6,118,79,39,0,0,13,6,7
"2021","Carlisle 012C","E01019246",592,254,148,106,324,47,116,47,45,24,67,28,38,1,88,54,34,6,6,14,8,6
"2021","Carlisle 012D","E01019247",632,217,111,106,398,74,178,72,61,45,67,33,34,0,77,45,32,2,2,17,8,9
"2021","Carlisle 012E","E01019248",516,173,66,107,319,26,109,41,51,17,76,35,38,3,104,74,30,4,4,24,11,13
"2021","Carlisle 013A","E01019212",739,194,120,74,524,145,283,113,125,45,45,25,17,3,50,34,16,1,1,21,5,16
"2021","Carlisle 013D","E01019223",615,165,119,46,432,114,226,108,66,52,58,36,19,3,34,19,15,0,0,18,7,11
"2021","Carlisle 013E","E01019253",783,264,143,121,507,122,251,103,103,45,77,37,34,6,56,32,24,1,1,12,6,6
"2021","Carlisle 013F","E01034070",467,119,40,79,341,49,194,76,95,23,60,35,23,2,38,23,15,0,0,7,3,4
"2021","Carlisle 013G","E01034071",628,145,38,107,457,47,252,90,133,29,109,59,46,4,48,34,14,1,1,26,12,14
"2021","Carlisle 013H","E01034072",514,135,58,77,368,51,169,69,79,21,102,57,45,0,44,31,13,2,2,11,5,6
"2021","Carlisle 013I","E01034073",661,219,147,72,427,128,200,87,75,38,46,25,17,4,51,31,20,2,2,15,9,6
"2021","Carlisle 013J","E01034074",756,183,76,107,535,73,269,106,113,50,143,78,59,6,45,39,6,5,5,38,16,22
"2021","Copeland 001B","E01019269",676,234,112,122,422,73,188,71,65,52,73,21,45,7,84,62,22,4,4,20,7,13
"2021","Copeland 001C","E01019270",586,177,74,103,393,59,161,66,51,44,74,34,36,4,95,66,29,4,4,16,10,6
"2021","Copeland 001E","E01034075",1038,282,126,156,736,163,396,172,130,94,106,57,40,9,67,37,30,4,4,20,9,11
"2021","Copeland 002A","E01019260",619,189,65,124,406,49,186,70,78,38,72,29,39,4,95,54,41,4,4,24,9,15
"2021","Copeland 002B","E01019280",1033,737,228,509,268,59,97,64,22,11,57,51,4,2,50,19,31,5,5,28,4,24
"2021","Copeland 002C","E01019281",569,235,123,112,319,69,155,72,44,39,60,37,20,3,33,21,12,2,2,15,3,12
"2021","Copeland 002D","E01019282",496,137,55,82,340,49,172,67,69,36,62,31,30,1,52,29,23,5,5,19,11,8
"2021","Copeland 003A","E01019261",717,162,79,83,534,111,306,133,117,56,70,43,25,2,43,23,20,4,4,21,10,11
"2021","Copeland 003B","E01019262",704,202,64,138,484,83,285,121,107,57,78,50,26,2,34,22,12,4,4,18,9,9
"2021","Copeland 003C","E01019284",571,244,121,123,319,54,116,34,50,32,67,30,29,8,80,54,26,2,2,8,6,2
"2021","Copeland 003D","E01019285",603,178,72,106,399,40,181,86,66,29,78,39,35,4,98,62,36,2,2,26,11,15
"2021","Copeland 003E","E01019286",633,251,126,125,364,79,161,69,57,35,68,35,29,4,53,36,17,3,3,18,10,8
"2021","Copeland 003F","E01019287",496,147,77,70,341,101,168,59,74,35,39,25,12,2,33,16,17,0,0,8,2,6
"2021","Copeland 003G","E01019288",539,121,55,66,404,71,231,76,111,44,67,31,31,5,32,23,9,3,3,14,10,4
"2021","Copeland 004A","E01019256",660,209,77,132,432,78,251,146,67,38,65,37,23,5,37,23,14,1,1,19,6,13
"2021","Copeland 004C","E01019264",780,242,112,130,515,74,281,98,123,60,88,45,37,6,71,45,26,1,1,23,12,11
"2021","Copeland 004D","E01019265",621,264,88,176,334,65,153,78,47,28,57,33,20,4,55,29,26,4,4,23,8,15
"2021","Copeland 004E","E01019266",645,235,81,154,402,49,201,98,56,47,67,29,32,6,83,56,27,2,2,8,0,8
"2021","Copeland 004F","E01019267",591,247,124,123,326,40,124,53,41,30,52,14,34,4,106,75,31,4,4,18,6,12
"2021","Copeland 004H","E01019277",559,213,102,111,321,44,113,49,44,20,65,30,33,2,92,54,38,7,7,25,14,11
"2021","Copeland 004I","E01019278",618,185,75,110,420,70,229,103,85,41,63,36,26,1,55,37,18,3,3,13,6,7
"2021","Copeland 004J","E01034076",930,298,126,172,592,106,298,134,98,66,98,50,42,6,87,57,30,3,3,40,21,19
"2021","Copeland 005A","E01019291",659,236,100,136,412,49,200,72,92,36,81,44,33,4,80,58,22,2,2,11,5,6
"2021","Copeland 005B","E01019292",501,167,87,80,316,71,154,67,51,36,52,29,21,2,39,21,18,0,0,18,7,11
"2021","Copeland 005C","E01019294",604,186,88,98,397,47,179,67,80,32,70,26,42,2,99,58,41,2,2,21,10,11
"2021","Copeland 005D","E01019295",593,168,60,108,396,34,153,51,64,38,63,21,37,5,142,111,31,4,4,29,16,13
"2021","Copeland 005E","E01019296",604,205,97,108,379,56,170,70,58,42,75,33,37,5,74,44,30,4,4,20,13,7
"2021","Copeland 005F","E01019301",721,274,75,199,415,25,154,65,63,26,81,29,45,7,152,108,44,3,3,32,12,20
"2021","Copeland 005G","E01019302",662,195,53,142,448,45,219,85,99,35,127,76,48,3,53,35,18,4,4,19,9,10
"2021","Copeland 006A","E01019271",573,190,80,110,364,58,169,70,66,33,57,22,28,7,79,57,22,1,1,19,11,8
"2021","Copeland 006B","E01019272",587,165,75,90,402,63,162,57,68,37,81,23,53,5,93,64,29,3,3,20,10,10
"2021","Copeland 006C","E01019273",685,219,100,119,438,87,228,96,84,48,61,37,19,5,59,34,25,3,3,28,12,16
"2021","Copeland 006D","E01019274",768,369,146,223,375,73,162,79,46,37,70,32,33,5,67,42,25,3,3,24,10,14
"2021","Copeland 006E","E01019275",918,297,138,159,592,108,277,116,94,67,121,52,67,2,85,54,31,1,1,29,10,19
"2021","Copeland 007A","E01019257",638,205,105,100,411,87,197,105,58,34,60,30,26,4,62,36,26,5,5,22,7,15
"2021","Copeland 007B","E01019258",653,191,94,97,445,101,252,113,104,35,56,28,24,4,32,12,20,4,4,17,9,8
"2021","Copeland 007C","E01019279",628,218,125,93,396,117,197,104,63,30,47,29,16,2,35,17,18,0,0,14,3,11
"2021","Copeland 007D","E01019300",750,228,89,139,506,116,279,134,107,38,69,41,25,3,40,29,11,2,2,16,7,9
"2021","Copeland 007E","E01019303",682,220,109,111,433,89,227,94,94,39,63,35,27,1,49,29,20,5,5,29,11,18
"2021","Copeland 007F","E01019304",540,166,84,82,348,93,179,102,47,30,40,29,8,3,36,12,24,0,0,26,9,17
"2021","Copeland 008A","E01019259",579,206,116,90,357,70,179,84,59,36,64,31,29,4,41,18,23,3,3,16,7,9
"2021","Copeland 008B","E01019283",571,176,100,76,372,107,185,78,60,47,51,29,18,4,29,10,19,0,0,23,13,10
"2021","Copeland 008C","E01019289",569,179,96,83,379,51,193,77,64,52,79,46,28,5,56,27,29,0,0,11,7,4
"2021","Copeland 008D","E01019290",464,153,62,91,302,31,161,73,54,34,52,19,30,3,57,38,19,1,1,9,3,6
"2021","Copeland 008E","E01019293",559,148,91,57,384,105,197,98,64,35,49,35,12,2,32,15,17,1,1,27,15,12
"2021","Copeland 008F","E01019298",684,223,118,105,449,105,203,98,69,36,66,25,38,3,73,38,35,2,2,12,4,8
"2021","Copeland 008G","E01019299",917,391,148,243,509,63,196,77,73,46,109,47,53,9,138,91,47,3,3,17,10,7
"2021","Eden 001A","E01019305",958,339,164,175,576,101,291,165,71,55,120,65,45,10,60,32,28,4,4,43,24,19
"2021","Eden 001B","E01019314",587,136,93,43,429,101,238,109,87,42,52,28,23,1,33,16,17,5,5,22,8,14
"2021","Eden 001C","E01019320",599,133,71,62,436,96,240,108,86,46,68,42,22,4,29,12,17,3,3,30,10,20
"2021","Eden 001D","E01019321",672,169,88,81,478,96,272,115,105,52,68,44,20,4,42,23,19,0,0,25,10,15
"2021","Eden 002A","E01019315",797,232,123,109,529,112,294,121,99,74,82,50,28,4,39,17,22,2,2,36,22,14
"2021","Eden 002B","E01019316",558,130,67,63,407,60,239,112,88,39,59,36,23,0,47,26,21,2,2,21,6,15
"2021","Eden 002C","E01019322",702,183,97,86,501,110,282,105,115,62,64,43,20,1,44,28,16,1,1,18,6,12
"2021","Eden 002D","E01019338",606,129,72,57,450,103,256,133,77,46,55,37,16,2,34,12,22,2,2,27,11,16
"2021","Eden 003A","E01019327",853,332,161,171,474,75,209,83,97,29,95,54,35,6,91,60,31,4,4,47,16,31
"2021","Eden 003B","E01019332",655,296,166,130,341,59,168,71,64,33,64,27,35,2,46,28,18,4,4,18,10,8
"2021","Eden 003C","E01019333",680,302,123,179,339,44,139,61,50,28,83,49,30,4,64,36,28,9,9,39,17,22
"2021","Eden 003D","E01019335",644,203,74,129,408,43,191,63,82,46,101,54,36,11,70,41,29,3,3,33,11,22
"2021","Eden 003E","E01019336",846,367,103,264,425,41,184,77,75,32,108,75,29,4,86,51,35,6,6,54,22,32
"2021","Eden 004A","E01019312",749,216,115,101,506,136,246,119,97,30,86,51,29,6,37,23,14,1,1,27,12,15
"2021","Eden 004B","E01019326",964,273,137,136,663,153,309,128,127,54,136,72,61,3,58,36,22,7,7,28,16,12
"2021","Eden 004C","E01019328",603,166,78,88,419,97,220,88,77,55,59,24,33,2,40,27,13,3,3,18,10,8
"2021","Eden 004D","E01019329",495,137,82,55,332,95,165,66,60,39,57,39,15,3,14,4,10,1,1,26,7,19
"2021","Eden 004E","E01019330",695,252,107,145,399,87,195,74,76,45,68,37,25,6,48,25,23,1,1,44,13,31
"2021","Eden 004F","E01019331",799,247,133,114,531,88,245,105,94,46,111,70,35,6,85,51,34,2,2,21,8,13
"2021","Eden 004G","E01019334",613,209,140,69,386,88,185,58,76,51,57,30,25,2,56,26,30,0,0,18,7,11
"2021","Eden 005A","E01019308",597,183,84,99,400,84,210,109,62,39,55,37,14,4,51,30,21,0,0,14,6,8
"2021","Eden 005B","E01019311",640,171,106,65,438,119,231,93,93,45,57,33,22,2,29,21,8,2,2,31,15,16
"2021","Eden 005C","E01019313",652,194,106,88,431,112,216,114,61,41,66,41,18,7,35,16,19,2,2,27,10,17
"2021","Eden 005D","E01019339",580,153,75,78,397,91,206,108,65,33,67,38,24,5,28,8,20,5,5,30,11,19
"2021","Eden 006A","E01019306",671,320,169,151,346,84,145,66,40,39,66,44,19,3,51,24,27,0,0,5,2,3
"2021","Eden 006B","E01019307",904,280,137,143,601,145,297,127,123,47,85,46,36,3,72,51,21,2,2,23,14,9
"2021","Eden 006C","E01019310",656,182,120,62,450,119,255,118,97,40,47,27,17,3,29,13,16,0,0,24,7,17
"2021","Eden 006D","E01019319",687,178,73,105,476,90,251,114,88,49,90,45,39,6,44,34,10,1,1,33,13,20
"2021","Eden 006E","E01019323",544,137,72,65,397,84,222,103,69,50,64,40,20,4,26,13,13,1,1,10,2,8
"2021","Eden 006F","E01019324",549,141,74,67,376,85,207,96,71,40,49,18,31,0,34,16,18,1,1,32,21,11
"2021","Eden 006G","E01019337",617,205,113,92,400,79,186,81,71,34,73,43,27,3,59,25,34,3,3,12,6,6
"2021","Eden 007A","E01019309",1030,263,145,118,723,169,392,193,131,68,94,52,33,9,64,29,35,4,4,44,18,26
"2021","Eden 007B","E01019317",596,170,110,60,414,105,228,100,81,47,50,25,24,1,29,12,17,2,2,12,2,10
"2021","Eden 007C","E01019318",629,268,128,140,338,79,138,55,58,25,70,31,37,2,47,26,21,4,4,23,9,14
"2021","Eden 007D","E01019325",630,176,84,92,435,85,231,100,80,51,77,46,25,6,38,23,15,4,4,19,8,11
"2021","Eden 007E","E01019340",570,149,76,73,394,108,211,108,66,37,46,24,17,5,27,17,10,2,2,27,7,20
"2021","South Lakeland 001A","E01019374",653,250,110,140,343,48,151,65,52,34,81,44,26,11,59,38,21,4,4,60,7,53
"2021","South Lakeland 001B","E01019375",666,250,164,86,368,123,168,100,41,27,49,33,16,0,26,13,13,2,2,48,5,43
"2021","South Lakeland 001C","E01019376",536,162,94,68,342,76,164,81,54,29,62,40,21,1,39,20,19,1,1,32,11,21
"2021","South Lakeland 001D","E01019395",887,355,224,131,497,148,220,128,58,34,72,48,21,3,53,32,21,4,4,35,9,26
"2021","South Lakeland 002A","E01019387",1004,323,196,127,632,145,299,132,117,50,114,67,39,8,70,38,32,4,4,49,9,40
"2021","South Lakeland 002B","E01019396",880,289,181,108,548,110,304,145,112,47,80,46,32,2,46,25,21,8,8,43,13,30
"2021","South Lakeland 002C","E01019397",832,286,118,168,496,117,219,108,78,33,96,70,24,2,57,37,20,7,7,50,6,44
"2021","South Lakeland 002F","E01034077",909,295,141,154,561,74,294,112,122,60,107,47,53,7,77,43,34,9,9,53,11,42
"2021","South Lakeland 003A","E01019346",853,252,132,120,566,161,251,114,90,47,98,49,41,8,53,29,24,3,3,35,10,25
"2021","South Lakeland 003B","E01019359",1135,346,157,189,736,84,318,116,156,46,168,79,80,9,161,101,60,5,5,53,20,33
"2021","South Lakeland 003C","E01019365",979,314,132,182,605,101,296,136,106,54,118,82,27,9,87,36,51,3,3,60,13,47
"2021","South Lakeland 003D","E01019370",1109,427,201,226,636,108,315,124,139,52,129,91,34,4,79,48,31,5,5,46,9,37
"2021","South Lakeland 004A","E01019360",1108,520,179,341,539,89,236,116,88,32,131,98,32,1,72,41,31,11,11,49,5,44
"2021","South Lakeland 004B","E01019363",989,448,181,267,490,72,229,116,86,27,110,76,32,2,76,45,31,3,3,51,12,39
"2021","South Lakeland 004C","E01019364",909,345,127,218,523,46,231,77,109,45,127,51,60,16,115,74,41,4,4,41,14,27
"2021","South Lakeland 004D","E01019371",936,271,109,162,618,67,301,86,163,52,132,69,52,11,116,77,39,2,2,47,16,31
"2021","South Lakeland 005A","E01019358",793,239,125,114,522,135,259,97,109,53,81,44,32,5,45,29,16,2,2,32,8,24
"2021","South Lakeland 005B","E01019362",889,279,177,102,594,176,287,131,107,49,79,46,29,4,50,17,33,2,2,16,2,14
"2021","South Lakeland 005C","E01019366",777,225,144,81,528,120,263,109,96,58,88,54,29,5,56,32,24,1,1,24,3,21
"2021","South Lakeland 005D","E01019394",941,189,97,92,698,147,411,185,146,80,101,51,40,10,35,19,16,4,4,54,13,41
"2021","South Lakeland 006A","E01019361",808,257,147,110,523,102,276,101,113,62,83,50,31,2,60,34,26,2,2,28,11,17
"2021","South Lakeland 006C","E01019368",908,224,110,114,658,119,342,118,153,71,114,65,44,5,77,46,31,6,6,26,13,13
"2021","South Lakeland 006D","E01019369",903,286,189,97,595,163,292,121,111,60,91,58,31,2,48,27,21,1,1,22,12,10
"2021","South Lakeland 006H","E01034078",584,222,109,113,327,41,142,49,64,29,78,50,24,4,64,50,14,2,2,35,10,25
"2021","South Lakeland 006I","E01034079",771,244,102,142,503,91,275,107,122,46,85,53,30,2,50,31,19,2,2,24,5,19
"2021","South Lakeland 007A","E01019356",660,209,112,97,420,108,211,115,52,44,75,51,20,4,25,15,10,1,1,31,4,27
"2021","South Lakeland 007B","E01019381",962,247,134,113,677,176,345,173,111,61,96,55,32,9,57,23,34,3,3,38,16,22
"2021","South Lakeland 007C","E01019386",802,240,130,110,528,135,264,146,74,44,94,66,23,5,33,15,18,2,2,34,9,25
"2021","South Lakeland 008A","E01019344",453,114,56,58,317,72,161,79,50,32,50,27,17,6,34,20,14,0,0,22,8,14
"2021","South Lakeland 008B","E01019345",553,168,94,74,368,92,192,97,65,30,55,26,29,0,29,13,16,0,0,17,5,12
"2021","South Lakeland 008C","E01019350",731,231,130,101,478,139,229,114,75,40,79,46,27,6,31,19,12,0,0,22,10,12
"2021","South Lakeland 008D","E01019351",777,197,97,100,545,109,301,153,93,55,96,60,29,7,38,20,18,1,1,35,10,25
"2021","South Lakeland 009A","E01019372",580,282,187,95,278,78,118,54,41,23,40,23,12,5,40,25,15,2,2,20,7,13
"2021","South Lakeland 009B","E01019373",590,155,96,59,418,104,232,112,90,30,43,21,16,6,38,18,20,1,1,17,9,8
"2021","South Lakeland 009C","E01019384",1011,245,159,86,718,200,392,192,118,82,80,56,21,3,42,18,24,4,4,48,19,29
"2021","South Lakeland 009D","E01019385",537,247,124,123,279,61,126,53,57,16,39,25,14,0,51,30,21,2,2,11,1,10
"2021","South Lakeland 010A","E01019348",523,139,81,58,375,93,203,78,93,32,50,28,20,2,29,21,8,0,0,9,4,5
"2021","South Lakeland 010B","E01019352",930,202,113,89,694,157,378,168,132,78,100,68,30,2,59,40,19,0,0,34,17,17
"2021","South Lakeland 010C","E01019377",854,232,144,88,593,185,279,121,113,45,76,46,27,3,49,26,23,4,4,29,13,16
"2021","South Lakeland 010D","E01019383",982,252,169,83,701,220,348,159,118,71,84,53,28,3,48,27,21,1,1,29,13,16
"2021","South Lakeland 011C","E01019343",658,184,124,60,445,147,213,105,59,49,59,40,16,3,23,12,11,3,3,29,12,17
"2021","South Lakeland 011D","E01019347",773,228,123,105,522,105,269,109,122,38,96,59,33,4,51,36,15,1,1,23,8,15
"2021","South Lakeland 011E","E01019382",947,302,153,149,618,114,302,112,137,53,128,60,59,9,70,43,27,4,4,27,10,17
"2021","South Lakeland 011F","E01034080",1249,455,315,140,757,271,342,189,107,46,79,48,28,3,62,30,32,3,3,37,15,22
"2021","South Lakeland 012A","E01019388",840,261,141,120,545,88,278,108,106,64,86,41,40,5,87,45,42,6,6,34,8,26
"2021","South Lakeland 012B","E01019389",1042,319,127,192,693,85,298,116,124,58,154,74,69,11,153,104,49,3,3,30,15,15
"2021","South Lakeland 012C","E01019390",975,373,165,208,567,122,280,127,106,47,102,63,35,4,63,39,24,0,0,35,7,28
"2021","South Lakeland 012D","E01019392",1011,507,178,329,467,66,213,100,79,34,108,68,36,4,76,43,33,4,4,37,7,30
"2021","South Lakeland 013A","E01019349",840,236,138,98,566,157,286,136,102,48,86,51,33,2,35,21,14,2,2,38,13,25
"2021","South Lakeland 013B","E01019353",752,254,150,104,477,146,224,115,66,43,62,35,26,1,44,26,18,1,1,21,4,17
"2021","South Lakeland 013C","E01019354",734,365,240,125,333,124,132,78,37,17,51,38,12,1,22,10,12,4,4,36,7,29
"2021","South Lakeland 013D","E01019355",728,254,187,67,463,206,188,120,40,28,43,30,12,1,26,11,15,0,0,11,1,10
"2021","South Lakeland 013E","E01019357",822,244,138,106,559,126,277,145,91,41,93,48,38,7,62,33,29,1,1,19,7,12
"2021","South Lakeland 014A","E01019378",679,188,97,91,478,102,271,105,106,60,64,28,33,3,40,24,16,1,1,13,1,12
"2021","South Lakeland 014B","E01019379",645,196,110,86,419,100,235,118,84,33,51,33,13,5,31,17,14,2,2,30,16,14
"2021","South Lakeland 014C","E01019380",503,115,66,49,368,88,199,85,85,29,57,31,25,1,22,12,10,2,2,20,13,7
"2021","South Lakeland 014D","E01019391",815,256,143,113,545,138,260,101,89,70,76,40,31,5,70,43,27,1,1,14,4,10
"2021","South Lakeland 014E","E01019393",946,297,204,93,627,198,327,157,106,64,66,43,19,4,36,20,16,0,0,22,3,19
"2021","Burnley 001A","E01024859",679,232,67,165,430,41,164,71,60,33,116,56,55,5,105,73,32,4,4,17,9,8
"2021","Burnley 001B","E01024861",539,132,87,45,392,77,203,89,64,50,61,24,27,10,50,29,21,1,1,15,9,6
"2021","Burnley 001C","E01024862",658,186,85,101,446,87,198,83,74,41,96,36,51,9,64,39,25,1,1,26,10,16
"2021","Burnley 001D","E01024891",734,179,87,92,494,100,234,65,128,41,54,26,26,2,106,73,33,0,0,61,37,24
"2021","Burnley 001E","E01024892",636,203,123,80,399,56,214,61,113,40,68,29,33,6,56,34,22,5,5,34,22,12
"2021","Burnley 001F","E01024894",529,125,54,71,375,57,168,67,62,39,55,26,24,5,94,69,25,1,1,29,14,15
"2021","Burnley 002A","E01024893",711,248,137,111,402,48,197,44,132,21,59,35,20,4,87,54,33,11,11,61,31,30
"2021","Burnley 002B","E01024896",605,183,85,98,393,58,170,57,81,32,78,43,29,6,84,51,33,3,3,29,16,13
"2021","Burnley 002C","E01024897",528,158,88,70,314,57,157,47,78,32,34,17,14,3,62,35,27,4,4,56,32,24
"2021","Burnley 002D","E01024898",733,240,51,189,407,18,193,58,113,22,78,43,26,9,105,70,35,13,13,86,35,51
"2021","Burnley 003A","E01024856",670,163,67,96,424,21,258,43,178,37,57,31,23,3,81,55,26,7,7,83,47,36
"2021","Burnley 003B","E01024875",527,126,33,93,301,5,204,33,147,24,23,13,8,2,58,32,26,11,11,100,68,32
"2021","Burnley 003C","E01024876",536,142,35,107,300,4,196,29,138,29,25,15,9,1,70,43,27,5,5,94,62,32
"2021","Burnley 003D","E01024877",754,343,53,290,317,4,181,24,127,30,43,29,10,4,77,44,33,12,12,94,57,37
"2021","Burnley 003E","E01024878",546,96,40,56,371,8,269,34,210,25,28,11,17,0,56,32,24,10,10,79,62,17
"2021","Burnley 003F","E01024895",667,218,50,168,377,15,206,45,138,23,49,22,23,4,96,60,36,11,11,72,36,36
"2021","Burnley 004A","E01024883",656,195,103,92,426,66,158,72,56,30,76,28,39,9,116,83,33,10,10,35,17,18
"2021","Burnley 004B","E01024884",708,203,110,93,474,105,198,75,76,47,94,36,51,7,77,52,25,0,0,31,16,15
"2021","Burnley 004C","E01024885",864,429,103,326,396,37,124,60,43,21,109,61,40,8,119,80,39,7,7,39,14,25
"2021","Burnley 004D","E01024886",699,249,57,192,428,35,148,63,58,27,117,45,63,9,120,88,32,8,8,22,8,14
"2021","Burnley 004E","E01024889",631,267,104,163,352,57,145,69,56,20,85,48,32,5,62,42,20,3,3,12,3,9
"2021","Burnley 004F","E01024890",733,252,110,142,447,33,146,47,64,35,100,33,56,11,165,128,37,3,3,34,16,18
"2021","Burnley 005A","E01024879",661,188,79,109,450,37,191,61,98,32,135,62,72,1,86,62,24,1,1,23,11,12
"2021","Burnley 005B","E01024880",632,199,120,79,403,85,181,87,63,31,73,35,29,9,63,41,22,1,1,30,11,19
"2021","Burnley 005C","E01024912",599,175,124,51,408,108,229,104,84,41,40,23,14,3,31,13,18,0,0,16,8,8
"2021","Burnley 005D","E01024913",503,108,41,67,376,43,212,74,100,38,68,25,33,10,48,33,15,5,5,19,8,11
"2021","Burnley 005E","E01024914",608,152,87,65,431,107,226,102,84,40,62,31,27,4,32,17,15,4,4,25,8,17
"2021","Burnley 006A","E01024881",620,209,67,142,385,42,134,58,52,24,104,44,52,8,102,71,31,3,3,26,13,13
"2021","Burnley 006B","E01024882",713,294,84,210,391,35,108,44,42,22,107,51,51,5,136,93,43,5,5,28,13,15
"2021","Burnley 006C","E01024902",927,363,158,205,527,74,190,73,90,27,124,51,65,8,134,97,37,5,5,37,14,23
"2021","Burnley 006D","E01024911",826,278,121,157,495,63,226,91,86,49,95,48,40,7,108,77,31,3,3,53,22,31
"2021","Burnley 007A","E01024855",782,402,164,238,351,46,97,45,28,24,77,36,30,11,129,85,44,2,2,29,5,24
"2021","Burnley 007B","E01024857",637,282,131,151,308,23,157,49,87,21,52,24,25,3,71,54,17,5,5,47,23,24
"2021","Burnley 007C","E01024858",695,279,59,220,344,25,105,23,72,10,85,40,41,4,107,75,32,22,22,72,40,32
"2021","Burnley 007D","E01024864",720,230,86,144,460,72,146,70,55,21,108,40,57,11,125,91,34,9,9,30,12,18
"2021","Burnley 008A","E01024863",626,165,61,104,428,47,155,44,67,44,89,24,54,11,134,89,45,3,3,33,11,22
"2021","Burnley 008B","E01024865",770,403,156,247,347,45,132,61,38,33,69,34,30,5,98,69,29,3,3,20,11,9
"2021","Burnley 008C","E01024866",854,359,170,189,464,85,200,81,69,50,89,38,45,6,89,55,34,1,1,31,11,20
"2021","Burnley 008D","E01024867",609,167,114,53,427,123,201,82,82,37,68,30,31,7,35,19,16,0,0,15,4,11
"2021","Burnley 009A","E01024860",586,147,86,61,420,75,227,102,78,47,74,35,34,5,43,19,24,1,1,19,10,9
"2021","Burnley 009B","E01024868",521,152,71,81,353,77,165,64,69,32,55,25,26,4,55,27,28,1,1,16,5,11
"2021","Burnley 009C","E01024869",645,169,119,50,457,140,222,109,54,59,58,29,20,9,37,15,22,0,0,19,12,7
"2021","Burnley 009D","E01024870",524,146,75,71,359,115,150,67,54,29,63,37,22,4,30,15,15,1,1,19,9,10
"2021","Burnley 010A","E01024872",721,275,107,168,422,32,139,57,58,24,109,38,65,6,140,109,31,2,2,24,9,15
"2021","Burnley 010B","E01024899",669,179,68,111,444,59,167,62,71,34,86,37,40,9,125,82,43,7,7,46,24,22
"2021","Burnley 010C","E01024900",706,226,88,138,438,14,158,47,82,29,105,44,47,14,154,113,41,7,7,42,21,21
"2021","Burnley 010D","E01024907",639,248,62,186,348,25,111,42,43,26,69,33,30,6,130,96,34,13,13,43,20,23
"2021","Burnley 010E","E01024908",736,297,66,231,405,17,139,51,63,25,116,55,59,2,124,95,29,9,9,34,19,15
"2021","Burnley 010F","E01024909",751,354,81,273,339,31,111,43,41,27,107,54,51,2,79,53,26,11,11,58,24,34
"2021","Burnley 011A","E01024874",456,118,59,59,313,63,158,80,39,39,57,27,21,9,32,18,14,3,3,25,12,13
"2021","Burnley 011B","E01024887",625,162,57,105,445,65,208,75,85,48,79,42,29,8,92,62,30,1,1,18,7,11
"2021","Burnley 011C","E01024888",824,225,98,127,557,86,263,105,116,42,131,57,70,4,72,50,22,5,5,42,11,31
"2021","Burnley 011D","E01024901",762,200,67,133,531,60,291,122,110,59,107,54,46,7,70,43,27,3,3,31,15,16
"2021","Burnley 014D","E01024871",518,139,61,78,348,54,190,73,74,43,50,20,23,7,51,29,22,3,3,31,9,22
"2021","Burnley 014E","E01024873",594,174,104,70,407,71,199,80,78,41,86,34,40,12,48,31,17,3,3,13,7,6
"2021","Burnley 014F","E01024903",479,104,33,71,344,35,122,36,57,29,63,21,36,6,123,89,34,1,1,31,17,14
"2021","Burnley 014A","E01024904",785,235,93,142,500,70,220,93,85,42,96,43,46,7,110,76,34,4,4,50,20,30
"2021","Burnley 014G","E01024905",501,114,62,52,363,69,190,60,84,46,63,26,30,7,40,24,16,1,1,24,11,13
"2021","Burnley 014B","E01024906",1060,417,132,285,575,34,173,75,73,25,161,70,83,8,193,146,47,14,14,68,32,36
"2021","Burnley 014C","E01024910",635,223,79,144,378,35,153,63,63,27,79,40,36,3,97,73,24,14,14,34,11,23
"2021","Chorley 001A","E01024951",481,147,55,92,303,20,118,40,58,20,60,17,38,5,101,69,32,4,4,31,13,18
"2021","Chorley 001B","E01024952",557,251,61,190,292,31,127,53,52,22,70,44,26,0,59,39,20,5,5,14,8,6
"2021","Chorley 001C","E01024953",637,267,94,173,341,29,153,50,73,30,67,26,36,5,89,60,29,3,3,29,13,16
"2021","Chorley 001D","E01024954",729,252,117,135,449,95,217,100,78,39,78,44,33,1,56,37,19,3,3,28,13,15
"2021","Chorley 002A","E01024921",900,237,125,112,634,143,331,152,118,61,99,62,32,5,61,25,36,0,0,29,14,15
"2021","Chorley 002B","E01024978",573,168,78,90,384,59,194,68,92,34,83,55,24,4,48,27,21,0,0,21,9,12
"2021","Chorley 002C","E01024979",610,168,70,98,416,85,229,98,91,40,60,44,11,5,42,20,22,0,0,26,11,15
"2021","Chorley 002D","E01024980",577,144,78,66,421,96,209,83,86,40,68,40,24,4,48,33,15,0,0,12,7,5
"2021","Chorley 003A","E01024946",521,132,85,47,366,82,207,90,83,34,41,24,14,3,35,24,11,1,1,23,10,13
"2021","Chorley 003B","E01024947",504,91,36,55,406,51,251,85,113,53,59,26,26,7,45,35,10,0,0,7,5,2
"2021","Chorley 003C","E01024955",656,253,93,160,382,79,184,69,75,40,72,36,33,3,47,27,20,0,0,21,7,14
"2021","Chorley 003D","E01024956",827,190,75,115,618,144,304,106,143,55,105,61,38,6,63,40,23,2,2,19,5,14
"2021","Chorley 003E","E01024957",1015,181,109,72,794,127,444,158,221,65,128,65,59,4,93,61,32,2,2,40,21,19
"2021","Chorley 003F","E01024958",554,164,63,101,370,35,175,61,72,42,85,41,40,4,73,49,24,2,2,20,11,9
"2021","Chorley 004A","E01024948",725,202,94,108,489,73,235,78,118,39,120,62,54,4,57,31,26,4,4,34,13,21
"2021","Chorley 004C","E01024950",542,113,47,66,418,73,270,89,121,60,42,28,14,0,32,18,14,1,1,11,1,10
"2021","Chorley 004D","E01024977",1107,224,112,112,846,122,501,186,230,85,130,80,42,8,92,58,34,1,1,37,12,25
"2021","Chorley 004E","E01034337",727,186,65,121,515,45,290,81,168,41,96,46,44,6,80,48,32,4,4,26,12,14
"2021","Chorley 004F","E01034338",593,242,40,202,336,9,151,32,108,11,109,78,28,3,63,53,10,4,4,15,7,8
"2021","Chorley 005A","E01024967",542,144,101,43,378,113,178,74,66,38,55,27,21,7,32,13,19,0,0,20,10,10
"2021","Chorley 005B","E01024968",880,188,77,111,662,85,374,121,193,60,129,67,59,3,73,59,14,1,1,30,12,18
"2021","Chorley 005C","E01024969",610,179,100,79,409,93,182,56,92,34,50,22,22,6,78,42,36,6,6,22,11,11
"2021","Chorley 005D","E01024970",574,141,72,69,422,94,196,71,86,39,86,43,38,5,44,20,24,2,2,11,6,5
"2021","Chorley 005E","E01024971",551,119,66,53,414,119,203,82,88,33,50,23,22,5,40,26,14,2,2,18,8,10
"2021","Chorley 005F","E01024972",528,141,93,48,374,70,208,84,74,50,66,35,28,3,30,16,14,0,0,13,5,8
"2021","Chorley 006B","E01024930",655,198,68,130,433,59,161,69,62,30,104,47,51,6,104,69,35,5,5,24,5,19
"2021","Chorley 006C","E01024931",666,263,74,189,374,38,139,54,64,21,110,57,42,11,84,56,28,3,3,29,11,18
"2021","Chorley 006E","E01024933",602,190,91,99,388,86,163,67,56,40,71,38,31,2,66,38,28,2,2,24,10,14
"2021","Chorley 006F","E01024937",667,194,116,78,455,104,239,88,102,49,74,42,28,4,36,13,23,2,2,18,7,11
"2021","Chorley 006G","E01034339",976,291,114,177,646,92,272,105,117,50,142,62,62,18,138,80,58,2,2,39,17,22
"2021","Chorley 007A","E01024964",649,153,96,57,469,129,245,99,107,39,50,24,20,6,42,19,23,3,3,27,9,18
"2021","Chorley 007B","E01024974",660,142,79,63,491,103,284,121,127,36,61,37,20,4,42,21,21,1,1,27,11,16
"2021","Chorley 007C","E01024975",516,108,42,66,382,48,206,65,102,39,62,40,19,3,62,34,28,4,4,26,14,12
"2021","Chorley 007D","E01024976",725,230,104,126,473,89,225,88,95,42,75,36,35,4,84,54,30,0,0,22,7,15
"2021","Chorley 008B","E01024920",938,339,186,153,583,198,276,121,100,55,62,37,21,4,47,31,16,0,0,16,9,7
"2021","Chorley 008C","E01024934",692,171,104,67,499,121,257,87,121,49,80,40,36,4,36,21,15,5,5,22,11,11
"2021","Chorley 008D","E01024935",620,177,136,41,419,146,181,72,73,36,53,28,23,2,38,18,20,1,1,24,11,13
"2021","Chorley 008E","E01034340",709,251,90,161,441,12,201,49,136,16,135,72,61,2,92,79,13,1,1,17,6,11
"2021","Chorley 008F","E01034341",691,216,24,192,448,10,186,46,120,20,144,93,48,3,101,81,20,7,7,27,16,11
"2021","Chorley 008G","E01034342",615,123,18,105,466,21,286,59,207,20,107,59,46,2,52,42,10,0,0,26,12,14
"2021","Chorley 008H","E01034343",564,166,43,123,385,34,172,51,90,31,80,29,44,7,93,59,34,6,6,13,5,8
"2021","Chorley 009A","E01024925",787,325,131,194,417,35,155,47,80,28,91,45,43,3,130,90,40,6,6,45,22,23
"2021","Chorley 009B","E01024926",1033,327,115,212,664,38,294,103,147,44,167,74,85,8,160,106,54,5,5,42,15,27
"2021","Chorley 009C","E01024927",736,240,87,153,466,85,178,67,81,30,112,63,42,7,87,56,31,4,4,30,17,13
"2021","Chorley 009D","E01024928",642,206,83,123,408,61,190,70,78,42,82,37,40,5,73,47,26,2,2,28,9,19
"2021","Chorley 010A","E01024936",854,380,152,228,445,56,139,55,52,32,132,65,54,13,107,73,34,11,11,29,8,21
"2021","Chorley 010B","E01024938",879,211,97,114,650,109,312,98,163,51,138,64,64,10,89,52,37,2,2,18,3,15
"2021","Chorley 010C","E01024939",896,150,83,67,707,147,396,116,204,76,85,43,39,3,77,45,32,2,2,39,20,19
"2021","Chorley 010D","E01024940",891,455,111,344,398,32,149,55,67,27,108,55,48,5,102,70,32,7,7,38,17,21
"2021","Chorley 010E","E01024941",898,365,137,228,498,55,181,61,83,37,123,64,49,10,133,101,32,6,6,35,9,26
"2021","Chorley 011A","E01024923",549,127,74,53,397,95,204,81,78,45,56,32,18,6,39,21,18,3,3,25,9,16
"2021","Chorley 011B","E01024924",644,172,102,70,445,107,240,107,83,50,62,29,27,6,33,16,17,3,3,27,14,13
"2021","Chorley 011C","E01024963",685,196,129,67,470,114,222,86,102,34,62,26,32,4,68,39,29,4,4,19,9,10
"2021","Chorley 011D","E01024965",583,103,67,36,462,118,249,89,95,65,54,31,18,5,41,15,26,0,0,18,9,9
"2021","Chorley 011E","E01024966",801,207,101,106,576,110,295,94,146,55,88,46,34,8,82,57,25,1,1,18,12,6
"2021","Chorley 012A","E01024942",781,347,148,199,400,54,158,59,67,32,80,34,33,13,103,58,45,5,5,34,14,20
"2021","Chorley 012B","E01024943",1011,293,76,217,669,53,261,93,119,49,167,82,72,13,184,138,46,4,4,49,23,26
"2021","Chorley 012C","E01024944",832,137,41,96,664,60,373,123,196,54,148,82,61,5,81,50,31,2,2,31,14,17
"2021","Chorley 012E","E01034344",655,171,40,131,453,24,254,61,149,44,98,52,37,9,77,53,24,0,0,31,15,16
"2021","Chorley 012F","E01034345",574,221,84,137,324,27,131,59,47,25,68,42,21,5,95,62,33,3,3,29,12,17
"2021","Chorley 013A","E01024922",593,149,76,73,430,64,211,63,90,58,87,49,32,6,66,40,26,2,2,14,4,10
"2021","Chorley 013B","E01024959",887,312,96,216,538,50,223,73,104,46,134,63,65,6,129,97,32,2,2,37,12,25
"2021","Chorley 013C","E01024960",721,175,63,112,509,55,224,78,99,47,126,57,61,8,102,70,32,2,2,37,15,22
"2021","Chorley 013D","E01024961",674,191,88,103,455,93,209,86,82,41,97,40,48,9,53,28,25,3,3,28,17,11
"2021","Chorley 013E","E01024962",651,177,109,68,457,117,243,98,79,66,56,26,25,5,40,15,25,1,1,17,5,12
"2021","Chorley 014A","E01024915",1166,363,147,216,774,97,365,109,195,61,170,89,72,9,141,99,42,1,1,29,14,15
"2021","Chorley 014B","E01024916",751,211,120,91,513,123,261,108,101,52,80,50,28,2,47,28,19,2,2,27,11,16
"2021","Chorley 014C","E01024917",816,298,99,199,497,79,216,90,90,36,106,45,52,9,95,62,33,1,1,21,7,14
"2021","Chorley 014D","E01024918",764,203,126,77,533,134,260,98,108,54,86,46,32,8,50,26,24,3,3,28,12,16
"2021","Chorley 014E","E01024973",901,204,105,99,660,153,367,172,139,56,85,54,26,5,53,26,27,2,2,37,19,18
"2021","Fylde 001A","E01024993",712,174,91,83,505,130,277,118,109,50,58,40,17,1,37,17,20,3,3,33,7,26
"2021","Fylde 001B","E01025026",584,124,71,53,419,98,219,99,71,49,64,42,21,1,36,24,12,2,2,41,17,24
"2021","Fylde 001C","E01025027",728,174,68,106,529,58,301,127,145,29,93,54,35,4,75,47,28,2,2,25,10,15
"2021","Fylde 001D","E01025028",660,137,71,66,497,76,258,104,119,35,88,34,50,4,74,52,22,1,1,26,12,14
"2021","Fylde 001E","E01025031",868,230,136,94,593,133,294,121,112,61,107,53,51,3,57,43,14,2,2,45,13,32
"2021","Fylde 002A","E01025007",808,167,59,108,605,83,302,118,133,51,149,87,56,6,70,47,23,1,1,36,16,20
"2021","Fylde 002B","E01025008",495,128,82,46,356,84,191,76,78,37,51,27,21,3,30,16,14,0,0,11,7,4
"2021","Fylde 002C","E01025009",780,324,160,164,421,73,157,79,50,28,100,53,38,9,87,58,29,4,4,35,13,22
"2021","Fylde 002D","E01025011",734,313,127,186,381,31,153,54,63,36,93,58,30,5,99,60,39,5,5,40,11,29
"2021","Fylde 002E","E01025012",1123,244,79,165,830,98,435,162,203,70,172,89,77,6,121,86,35,4,4,49,18,31
"2021","Fylde 002F","E01025013",801,289,79,210,474,45,196,73,76,47,97,55,41,1,130,92,38,6,6,38,17,21
"2021","Fylde 002G","E01025019",823,200,120,80,600,137,330,134,139,57,78,39,32,7,53,31,22,2,2,23,10,13
"2021","Fylde 003A","E01024998",703,172,93,79,492,101,213,86,82,45,71,30,34,7,104,62,42,3,3,39,21,18
"2021","Fylde 003B","E01025010",522,135,87,48,366,76,206,76,86,44,48,27,18,3,34,16,18,2,2,21,9,12
"2021","Fylde 003C","E01025014",738,181,70,111,530,102,280,114,92,74,92,55,33,4,55,36,19,1,1,27,10,17
"2021","Fylde 003D","E01025015",659,165,99,66,465,95,244,104,97,43,70,39,26,5,56,29,27,0,0,29,15,14
"2021","Fylde 004A","E01025004",596,179,95,84,392,90,206,85,79,42,47,29,16,2,49,29,20,0,0,25,9,16
"2021","Fylde 004B","E01025006",619,286,133,153,309,24,114,45,45,24,69,31,35,3,101,71,30,1,1,24,9,15
"2021","Fylde 004C","E01025023",588,158,89,69,415,100,218,111,71,36,57,31,25,1,40,16,24,0,0,15,8,7
"2021","Fylde 004D","E01025024",1044,389,229,160,605,130,223,116,70,37,118,61,51,6,128,84,44,6,6,50,23,27
"2021","Fylde 004E","E01025025",685,216,89,127,436,45,190,67,85,38,94,40,51,3,106,63,43,1,1,33,11,22
"2021","Fylde 005A","E01025001",983,344,203,141,605,146,283,122,115,46,92,49,35,8,75,48,27,9,9,34,15,19
"2021","Fylde 005B","E01025002",646,213,87,126,412,65,176,76,74,26,78,33,40,5,87,60,27,6,6,21,7,14
"2021","Fylde 005C","E01025005",726,268,177,91,435,155,185,89,50,46,47,28,16,3,47,18,29,1,1,23,9,14
"2021","Fylde 005D","E01025016",1036,264,163,101,752,222,384,166,147,71,77,36,35,6,69,46,23,0,0,20,10,10
"2021","Fylde 005E","E01025018",549,152,108,44,376,118,167,60,57,50,46,22,19,5,42,20,22,3,3,21,10,11
"2021","Fylde 006A","E01024984",670,230,141,89,417,112,218,109,73,36,50,35,10,5,34,19,15,3,3,23,7,16
"2021","Fylde 006B","E01024985",616,163,79,84,429,96,216,103,80,33,72,36,31,5,42,26,16,3,3,24,13,11
"2021","Fylde 006C","E01024986",1003,628,271,357,341,88,140,79,41,20,65,55,10,0,46,23,23,2,2,34,10,24
"2021","Fylde 006D","E01024987",754,429,80,349,285,13,97,44,37,16,79,49,25,5,93,58,35,3,3,40,15,25
"2021","Fylde 006E","E01024988",865,494,250,244,344,121,118,55,45,18,56,37,17,2,43,18,25,6,6,27,6,21
"2021","Fylde 006F","E01024989",655,205,78,127,415,77,191,75,83,33,66,40,23,3,77,46,31,4,4,35,19,16
"2021","Fylde 006G","E01024996",659,373,145,228,254,51,127,66,38,23,42,28,13,1,31,15,16,3,3,32,9,23
"2021","Fylde 007A","E01024997",682,242,128,114,414,96,198,103,55,40,68,40,25,3,52,30,22,0,0,26,10,16
"2021","Fylde 007B","E01024999",669,211,116,95,428,94,203,92,78,33,71,38,28,5,58,36,22,2,2,30,15,15
"2021","Fylde 007C","E01025000",608,188,125,63,414,113,198,107,55,36,55,30,19,6,47,27,20,1,1,6,2,4
"2021","Fylde 007D","E01025029",1175,336,187,149,798,195,352,168,134,50,150,84,60,6,96,58,38,5,5,41,17,24
"2021","Fylde 007E","E01025030",873,249,87,162,590,46,267,87,116,64,148,76,59,13,126,88,38,3,3,34,22,12
"2021","Fylde 008A","E01024981",693,265,167,98,414,170,179,87,69,23,34,25,8,1,30,14,16,1,1,14,2,12
"2021","Fylde 008B","E01024982",637,281,174,107,341,104,164,72,69,23,40,28,10,2,28,12,16,5,5,15,6,9
"2021","Fylde 008C","E01024983",603,170,77,93,407,54,250,85,129,36,57,32,21,4,42,28,14,4,4,26,11,15
"2021","Fylde 008D","E01024994",739,221,132,89,502,158,241,121,76,44,52,29,18,5,51,25,26,0,0,16,5,11
"2021","Fylde 008E","E01024995",663,245,144,101,398,118,200,81,81,38,36,25,11,0,41,18,23,3,3,20,6,14
"2021","Fylde 008F","E01025003",807,275,188,87,502,133,225,89,84,52,83,49,29,5,59,30,29,2,2,30,11,19
"2021","Fylde 008G","E01025017",801,411,277,134,368,89,159,73,64,22,56,25,25,6,63,35,28,1,1,22,3,19
"2021","Fylde 009A","E01024990",797,387,178,209,392,99,170,83,51,36,73,53,14,6,50,28,22,0,0,18,4,14
"2021","Fylde 009B","E01024991",535,245,136,109,271,97,116,64,30,22,32,22,8,2,26,10,16,0,0,19,5,14
"2021","Fylde 009C","E01024992",762,296,224,72,457,191,197,114,49,34,30,19,7,4,34,20,14,5,5,9,2,7
"2021","Fylde 009D","E01025020",623,179,76,103,426,61,199,84,85,30,73,38,31,4,89,57,32,4,4,18,8,10
"2021","Fylde 009E","E01025021",640,234,131,103,382,86,206,81,84,41,51,31,14,6,38,25,13,1,1,24,14,10
"2021","Fylde 009F","E01025022",862,273,96,177,561,82,296,118,123,55,91,57,29,5,91,56,35,1,1,28,8,20
"2021","Hyndburn 001A","E01025060",569,175,55,120,368,23,165,50,82,33,71,35,30,6,104,73,31,5,5,26,16,10
"2021","Hyndburn 001B","E01025061",762,290,198,92,440,134,197,94,63,40,69,37,28,4,36,20,16,4,4,32,20,12
"2021","Hyndburn 001C","E01025062",750,318,102,216,391,33,150,46,79,25,98,56,40,2,100,72,28,10,10,41,23,18
"2021","Hyndburn 001D","E01025063",696,271,131,140,403,72,183,64,70,49,83,42,30,11,62,37,25,3,3,22,13,9
"2021","Hyndburn 001E","E01025064",696,194,111,83,473,119,235,105,84,46,64,27,28,9,54,24,30,1,1,29,17,12
"2021","Hyndburn 001F","E01025065",790,309,90,219,449,43,153,63,67,23,134,68,57,9,113,88,25,6,6,32,13,19
"2021","Hyndburn 001G","E01025066",659,179,65,114,455,55,204,80,82,42,100,50,40,10,93,62,31,3,3,25,12,13
"2021","Hyndburn 002A","E01025032",604,177,60,117,399,63,147,65,51,31,74,31,39,4,113,73,40,2,2,28,16,12
"2021","Hyndburn 002B","E01025033",807,134,45,89,628,49,374,118,179,77,127,39,77,11,76,55,21,2,2,45,22,23
"2021","Hyndburn 002C","E01025034",726,195,71,124,492,67,202,75,93,34,103,49,44,10,117,83,34,3,3,39,17,22
"2021","Hyndburn 002D","E01025048",676,208,119,89,450,123,220,90,84,46,66,32,28,6,41,25,16,0,0,18,9,9
"2021","Hyndburn 002E","E01025049",758,330,100,230,407,36,134,68,47,19,97,50,45,2,138,99,39,2,2,21,6,15
"2021","Hyndburn 002F","E01025050",637,190,67,123,423,60,208,86,84,38,91,45,36,10,57,43,14,7,7,24,12,12
"2021","Hyndburn 002G","E01025053",625,166,69,97,427,65,209,68,96,45,80,37,34,9,70,46,24,3,3,32,15,17
"2021","Hyndburn 003A","E01025070",517,168,55,113,328,34,104,39,44,21,88,36,42,10,100,70,30,2,2,21,6,15
"2021","Hyndburn 003B","E01025071",615,224,97,127,369,48,166,75,45,46,82,42,35,5,67,45,22,6,6,22,14,8
"2021","Hyndburn 003C","E01025072",695,265,86,179,395,37,145,54,61,30,108,53,54,1,95,70,25,10,10,35,14,21
"2021","Hyndburn 003D","E01025073",596,199,89,110,378,66,155,69,55,31,69,25,37,7,82,47,35,6,6,19,9,10
"2021","Hyndburn 003E","E01025074",566,136,96,40,414,99,211,75,79,57,66,31,29,6,37,21,16,1,1,16,8,8
"2021","Hyndburn 004A","E01025051",690,215,81,134,438,54,189,66,84,39,83,34,40,9,102,61,41,10,10,37,20,17
"2021","Hyndburn 004B","E01025052",654,176,88,88,451,75,226,90,72,64,94,40,48,6,54,32,22,2,2,27,13,14
"2021","Hyndburn 004C","E01025057",700,232,120,112,433,69,160,50,74,36,84,35,47,2,116,77,39,4,4,35,14,21
"2021","Hyndburn 004D","E01025058",656,269,130,139,350,85,124,51,48,25,66,33,27,6,69,50,19,6,6,37,16,21
"2021","Hyndburn 004E","E01025059",778,268,126,142,477,68,162,66,75,21,126,48,67,11,111,77,34,10,10,33,20,13
"2021","Hyndburn 004F","E01025067",701,269,61,208,400,26,118,50,46,22,92,47,41,4,155,109,46,9,9,32,12,20
"2021","Hyndburn 004G","E01025068",760,385,119,266,327,25,96,35,49,12,79,36,40,3,123,101,22,4,4,48,19,29
"2021","Hyndburn 004H","E01025069",622,201,61,140,398,24,150,62,57,31,95,47,35,13,125,86,39,4,4,23,12,11
"2021","Hyndburn 005A","E01025044",468,138,49,89,307,32,122,28,65,29,69,21,41,7,79,56,23,5,5,23,14,9
"2021","Hyndburn 005B","E01025045",503,183,88,95,294,19,100,34,48,18,65,16,41,8,105,73,32,5,5,26,18,8
"2021","Hyndburn 005C","E01025046",658,310,125,185,328,38,117,59,44,14,86,47,32,7,76,53,23,11,11,20,8,12
"2021","Hyndburn 005D","E01025081",671,161,72,89,478,69,259,106,88,65,103,52,42,9,46,25,21,1,1,32,16,16
"2021","Hyndburn 006A","E01025041",656,272,112,160,331,21,148,34,93,21,61,16,40,5,96,68,28,5,5,53,38,15
"2021","Hyndburn 006B","E01025042",623,143,41,102,376,14,244,27,183,34,37,11,20,6,75,52,23,6,6,104,84,20
"2021","Hyndburn 006E","E01025082",640,158,73,85,442,29,192,45,91,56,71,25,39,7,142,106,36,8,8,40,25,15
"2021","Hyndburn 006F","E01025083",773,253,69,184,474,29,232,57,145,30,85,35,49,1,117,86,31,11,11,46,23,23
"2021","Hyndburn 006G","E01025084",555,138,46,92,360,16,218,44,144,30,43,19,21,3,76,53,23,7,7,57,44,13
"2021","Hyndburn 006I","E01034335",454,91,32,59,302,11,192,33,132,27,29,6,21,2,64,46,18,6,6,61,43,18
"2021","Hyndburn 006J","E01034336",635,137,34,103,437,8,237,38,169,30,69,24,41,4,114,78,36,9,9,61,40,21
"2021","Hyndburn 007A","E01025055",677,283,115,168,372,31,122,52,52,18,95,39,47,9,121,88,33,3,3,22,12,10
"2021","Hyndburn 007B","E01025075",781,284,72,212,452,36,181,64,82,35,111,52,50,9,116,80,36,8,8,45,18,27
"2021","Hyndburn 007C","E01025076",624,266,153,113,330,47,132,48,45,39,78,44,31,3,69,49,20,4,4,28,8,20
"2021","Hyndburn 007D","E01025077",627,224,128,96,382,58,155,71,53,31,86,34,47,5,79,55,24,4,4,21,11,10
"2021","Hyndburn 007E","E01025078",606,149,88,61,437,81,201,90,75,36,92,34,50,8,62,45,17,1,1,20,12,8
"2021","Hyndburn 008A","E01025035",638,225,109,116,378,56,199,89,65,45,58,36,18,4,64,33,31,1,1,35,15,20
"2021","Hyndburn 008B","E01025036",893,468,77,391,379,29,118,49,46,23,110,66,40,4,106,83,23,16,16,46,13,33
"2021","Hyndburn 008C","E01025037",651,177,75,102,435,58,178,67,88,23,81,37,37,7,114,83,31,4,4,39,23,16
"2021","Hyndburn 008D","E01025038",595,170,103,67,405,100,187,84,70,33,70,25,38,7,45,29,16,3,3,20,10,10
"2021","Hyndburn 008E","E01025039",492,100,47,53,375,73,208,85,67,56,63,36,24,3,29,11,18,2,2,17,8,9
"2021","Hyndburn 008F","E01025040",606,149,68,81,441,70,217,75,103,39,92,32,49,11,57,24,33,5,5,16,6,10
"2021","Hyndburn 009A","E01025054",736,281,118,163,428,74,177,74,68,35,96,50,36,10,81,42,39,0,0,27,11,16
"2021","Hyndburn 009B","E01025056",590,161,117,44,418,131,196,75,79,42,59,26,25,8,31,16,15,1,1,11,3,8
"2021","Hyndburn 009C","E01025079",708,199,118,81,477,108,195,85,64,46,96,48,38,10,76,40,36,2,2,32,14,18
"2021","Hyndburn 009D","E01025080",634,174,74,100,426,68,200,96,66,38,96,53,34,9,59,39,20,3,3,34,15,19
"2021","Lancaster 001A","E01025088",455,142,69,73,299,47,170,70,64,36,48,19,23,6,34,23,11,0,0,14,11,3
"2021","Lancaster 001B","E01025096",712,209,109,100,476,73,225,85,95,45,95,53,40,2,82,52,30,1,1,27,11,16
"2021","Lancaster 001C","E01025097",647,209,123,86,413,49,186,63,84,39,80,37,35,8,94,64,30,4,4,25,11,14
"2021","Lancaster 001D","E01025098",629,210,104,106,404,106,172,84,59,29,76,39,34,3,47,26,21,3,3,15,2,13
"2021","Lancaster 001E","E01025148",956,249,184,65,682,213,339,175,106,58,85,57,22,6,45,20,25,0,0,25,10,15
"2021","Lancaster 001F","E01025168",532,196,87,109,327,70,151,75,56,20,68,49,15,4,38,24,14,0,0,9,3,6
"2021","Lancaster 001G","E01025169",565,156,105,51,385,106,197,90,76,31,54,32,14,8,27,15,12,1,1,24,9,15
"2021","Lancaster 002A","E01025130",993,263,167,96,701,177,356,165,132,59,99,45,43,11,68,33,35,1,1,29,10,19
"2021","Lancaster 002B","E01025132",567,130,69,61,405,100,228,102,85,41,45,24,19,2,29,15,14,3,3,32,15,17
"2021","Lancaster 002C","E01025166",554,178,113,65,359,93,185,83,70,32,47,32,14,1,32,18,14,2,2,17,5,12
"2021","Lancaster 002D","E01025167",503,113,58,55,362,83,211,104,76,31,38,28,9,1,30,15,15,0,0,28,7,21
"2021","Lancaster 003A","E01025089",653,206,122,84,422,94,218,96,80,42,70,39,23,8,40,26,14,0,0,25,5,20
"2021","Lancaster 003B","E01025090",738,227,153,74,487,118,253,113,90,50,67,43,20,4,48,24,24,1,1,24,10,14
"2021","Lancaster 003C","E01025158",615,169,127,42,431,136,221,99,83,39,54,30,21,3,20,10,10,0,0,15,7,8
"2021","Lancaster 003D","E01025159",612,168,95,73,416,98,217,116,61,40,56,31,19,6,45,28,17,0,0,28,10,18
"2021","Lancaster 003E","E01025160",614,132,83,49,465,137,245,87,104,54,54,28,25,1,28,12,16,1,1,17,8,9
"2021","Lancaster 004A","E01025085",599,170,94,76,408,87,196,77,84,35,69,34,30,5,55,32,23,1,1,21,10,11
"2021","Lancaster 004B","E01025086",667,246,182,64,415,157,189,86,63,40,34,20,12,2,33,14,19,2,2,6,4,2
"2021","Lancaster 004C","E01025087",676,356,208,148,299,84,123,51,46,26,45,29,14,2,45,26,19,2,2,21,9,12
"2021","Lancaster 004D","E01025161",611,269,193,76,331,138,125,78,30,17,35,22,9,4,30,13,17,3,3,11,4,7
"2021","Lancaster 005A","E01025108",645,183,104,79,439,81,235,80,114,41,71,38,30,3,47,32,15,5,5,23,7,16
"2021","Lancaster 005B","E01025109",601,155,103,52,422,66,227,82,105,40,93,57,31,5,35,15,20,1,1,24,5,19
"2021","Lancaster 005C","E01025131",664,175,103,72,454,99,248,107,98,43,63,32,24,7,43,17,26,1,1,35,15,20
"2021","Lancaster 005D","E01025133",741,236,149,87,485,112,219,89,97,33,93,54,34,5,58,40,18,3,3,20,9,11
"2021","Lancaster 006A","E01025112",715,307,132,175,354,43,144,60,60,24,65,23,38,4,96,64,32,6,6,54,20,34
"2021","Lancaster 006B","E01025136",668,231,104,127,395,38,129,39,64,26,81,39,39,3,143,110,33,4,4,42,14,28
"2021","Lancaster 006C","E01025138",580,182,58,124,370,31,145,49,69,27,88,43,42,3,103,76,27,3,3,28,15,13
"2021","Lancaster 006D","E01025139",794,403,117,286,346,23,120,48,45,27,95,53,33,9,102,73,29,6,6,45,12,33
"2021","Lancaster 006E","E01025140",602,270,113,157,302,57,126,48,54,24,69,38,23,8,46,32,14,4,4,30,11,19
"2021","Lancaster 008A","E01025111",733,182,82,100,499,54,202,79,83,40,132,43,78,11,105,58,47,6,6,52,23,29
"2021","Lancaster 008B","E01025113",644,178,79,99,414,56,205,87,82,36,83,29,43,11,63,40,23,7,7,52,23,29
"2021","Lancaster 008C","E01025118",455,149,72,77,274,31,127,55,52,20,52,21,23,8,62,47,15,2,2,32,15,17
"2021","Lancaster 008D","E01025119",570,167,79,88,373,57,172,73,70,29,71,37,33,1,72,49,23,1,1,30,15,15
"2021","Lancaster 009A","E01025110",742,366,65,301,315,9,112,44,52,16,89,49,35,5,97,73,24,8,8,61,24,37
"2021","Lancaster 009B","E01025116",617,267,113,154,312,65,132,53,51,28,54,36,15,3,57,29,28,4,4,38,15,23
"2021","Lancaster 009C","E01025117",624,263,38,225,299,15,96,40,41,15,78,32,43,3,103,74,29,7,7,62,28,34
"2021","Lancaster 009D","E01025120",652,260,83,177,351,29,149,67,57,25,78,33,39,6,91,71,20,4,4,41,18,23
"2021","Lancaster 010A","E01025170",805,286,156,130,479,110,182,107,47,28,76,49,23,4,100,59,41,11,11,40,18,22
"2021","Lancaster 010B","E01025171",919,351,195,156,521,81,177,86,66,25,89,39,44,6,160,111,49,14,14,47,13,34
"2021","Lancaster 010C","E01025172",647,204,87,117,423,80,173,77,62,34,79,38,35,6,85,57,28,6,6,20,5,15
"2021","Lancaster 010D","E01025173",770,261,128,133,484,94,176,71,71,34,80,36,38,6,130,90,40,4,4,25,5,20
"2021","Lancaster 011A","E01025149",1000,355,110,245,586,51,257,109,99,49,135,73,52,10,138,112,26,5,5,59,17,42
"2021","Lancaster 011B","E01025150",623,143,55,88,441,57,212,84,81,47,95,40,49,6,74,54,20,3,3,39,12,27
"2021","Lancaster 011C","E01025151",848,389,92,297,379,28,115,52,47,16,107,50,52,5,118,90,28,11,11,80,6,74
"2021","Lancaster 011D","E01025152",635,167,76,91,422,42,163,60,68,35,97,52,40,5,117,75,42,3,3,46,16,30
"2021","Lancaster 011E","E01025154",623,244,118,126,349,42,132,48,51,33,68,24,32,12,104,68,36,3,3,30,12,18
"2021","Lancaster 013A","E01025091",719,256,120,136,412,40,185,62,77,46,90,44,37,9,89,65,24,8,8,51,23,28
"2021","Lancaster 013B","E01025092",528,168,67,101,322,22,142,43,52,47,60,29,26,5,97,60,37,1,1,38,18,20
"2021","Lancaster 013C","E01025095",1081,310,81,229,711,50,402,142,228,32,181,117,57,7,73,45,28,5,5,60,11,49
"2021","Lancaster 013D","E01025126",835,199,65,134,576,53,351,93,208,50,96,54,39,3,68,37,31,8,8,60,11,49
"2021","Lancaster 014A","E01025093",712,270,56,214,263,24,94,42,43,9,78,64,11,3,53,36,17,14,14,179,5,174
"2021","Lancaster 014B","E01025094",584,245,93,152,265,31,95,44,43,8,65,44,18,3,71,47,24,3,3,74,17,57
"2021","Lancaster 014C","E01025099",884,412,84,328,355,21,137,55,68,14,131,101,27,3,61,44,17,5,5,117,10,107
"2021","Lancaster 014E","E01033071",614,323,58,265,149,8,55,27,24,4,59,55,4,0,19,12,7,8,8,142,12,130
"2021","Lancaster 014F","E01033073",685,293,116,177,251,30,131,51,68,12,60,41,15,4,24,12,12,6,6,141,13,128
"2021","Lancaster 015B","E01025128",646,255,68,187,272,9,90,41,43,6,110,93,14,3,55,40,15,8,8,119,8,111
"2021","Lancaster 015D","E01025147",621,188,85,103,342,40,181,74,84,23,72,50,17,5,47,26,21,2,2,91,7,84
"2021","Lancaster 015E","E01034763",839,257,56,201,278,16,116,35,58,23,82,63,19,0,59,36,23,5,5,304,15,289
"2021","Lancaster 016A","E01025114",675,201,122,79,441,112,210,94,75,41,83,47,31,5,36,24,12,0,0,33,18,15
"2021","Lancaster 016B","E01025115",640,196,108,88,407,50,180,68,74,38,87,39,43,5,87,55,32,3,3,37,20,17
"2021","Lancaster 016C","E01025121",892,245,93,152,607,99,298,120,128,50,125,66,56,3,85,55,30,0,0,40,17,23
"2021","Lancaster 016D","E01025122",749,241,131,110,483,112,239,95,105,39,78,37,34,7,52,31,21,2,2,25,6,19
"2021","Lancaster 016E","E01025123",1038,220,88,132,769,84,402,143,187,72,156,76,78,2,126,100,26,1,1,49,23,26
"2021","Lancaster 016F","E01025124",653,213,99,114,408,57,168,56,77,35,74,23,46,5,103,70,33,6,6,32,16,16
"2021","Lancaster 016I","E01033072",1105,326,185,141,720,168,341,162,120,59,109,57,48,4,97,59,38,5,5,59,16,43
"2021","Lancaster 017A","E01025100",1063,322,83,239,676,43,308,123,152,33,208,122,78,8,112,79,33,5,5,65,15,50
"2021","Lancaster 017B","E01025101",615,221,75,146,334,25,133,56,60,17,78,44,29,5,98,70,28,0,0,60,11,49
"2021","Lancaster 017C","E01025102",569,173,73,100,294,42,144,47,73,24,61,32,26,3,44,28,16,3,3,102,20,82
"2021","Lancaster 017D","E01025103",517,118,70,48,368,79,224,89,98,37,42,24,17,1,20,14,6,3,3,31,8,23
"2021","Lancaster 017E","E01025144",745,322,111,211,354,42,150,66,65,19,98,55,39,4,60,29,31,4,4,69,12,57
"2021","Lancaster 017F","E01025146",780,159,87,72,573,122,337,118,160,59,67,40,23,4,44,29,15,3,3,48,13,35
"2021","Lancaster 018A","E01025127",593,160,95,65,415,99,218,85,97,36,59,23,34,2,37,18,19,2,2,18,6,12
"2021","Lancaster 018B","E01025141",579,180,99,81,369,55,208,58,113,37,53,32,17,4,50,25,25,3,3,30,5,25
"2021","Lancaster 018C","E01025143",635,243,126,117,340,51,170,59,75,36,47,20,25,2,69,49,20,3,3,52,12,40
"2021","Lancaster 018D","E01025145",589,150,57,93,364,26,171,61,92,18,91,49,41,1,75,55,20,1,1,75,7,68
"2021","Lancaster 019A","E01025105",504,116,55,61,362,75,198,76,90,32,63,39,17,7,26,13,13,0,0,26,11,15
"2021","Lancaster 019B","E01025106",882,268,103,165,570,66,284,86,154,44,131,81,44,6,83,44,39,6,6,44,21,23
"2021","Lancaster 019C","E01025107",681,182,94,88,461,80,275,128,100,47,65,44,19,2,40,17,23,1,1,38,11,27
"2021","Lancaster 019D","E01025142",629,157,114,43,437,119,231,91,100,40,50,26,18,6,34,16,18,3,3,35,11,24
"2021","Lancaster 020A","E01025137",613,181,107,74,412,73,197,74,84,39,80,32,43,5,61,35,26,1,1,20,6,14
"2021","Lancaster 020F","E01025153",513,104,54,50,382,61,196,77,83,36,72,29,37,6,52,28,24,1,1,27,11,16
"2021","Lancaster 020G","E01025155",525,111,47,64,397,61,194,71,83,40,78,39,36,3,58,27,31,6,6,17,7,10
"2021","Lancaster 020H","E01025156",483,88,26,62,350,13,130,41,62,27,76,27,45,4,128,95,33,3,3,45,26,19
"2021","Lancaster 020I","E01025157",616,275,127,148,322,44,128,49,54,25,65,29,23,13,83,61,22,2,2,19,10,9
"2021","Lancaster 020B","E01025162",691,252,176,76,424,128,190,85,73,32,65,38,24,3,41,24,17,0,0,15,7,8
"2021","Lancaster 020C","E01025163",630,194,133,61,426,123,207,88,79,40,57,32,24,1,38,25,13,1,1,10,7,3
"2021","Lancaster 020D","E01025164",628,208,115,93,397,78,192,84,69,39,71,37,28,6,54,30,24,2,2,23,7,16
"2021","Lancaster 020E","E01025165",589,146,51,95,418,49,211,73,93,45,97,40,48,9,59,38,21,2,2,25,15,10
"2021","Pendle 001A","E01025191",527,114,64,50,392,71,187,70,80,37,86,43,39,4,46,27,19,2,2,21,9,12
"2021","Pendle 001B","E01025192",661,200,72,128,439,35,188,79,75,34,106,42,55,9,110,76,34,0,0,22,8,14
"2021","Pendle 001C","E01025193",609,173,120,53,418,93,195,86,71,38,71,32,30,9,59,33,26,0,0,18,10,8
"2021","Pendle 001D","E01025194",605,216,94,122,363,39,151,50,71,30,98,35,54,9,71,52,19,4,4,26,11,15
"2021","Pendle 002A","E01025195",522,121,56,65,381,76,197,84,74,39,73,30,33,10,33,15,18,2,2,20,7,13
"2021","Pendle 002B","E01025196",792,366,114,252,380,43,135,67,50,18,108,63,41,4,90,62,28,4,4,46,17,29
"2021","Pendle 002C","E01025197",564,154,89,65,383,96,199,89,74,36,53,24,24,5,34,19,15,1,1,27,11,16
"2021","Pendle 002D","E01025198",632,186,79,107,404,60,175,72,78,25,95,46,45,4,69,48,21,5,5,42,22,20
"2021","Pendle 003A","E01025199",812,228,108,120,560,106,264,125,112,27,129,59,63,7,60,38,22,1,1,24,8,16
"2021","Pendle 003B","E01025200",688,236,102,134,428,67,204,90,76,38,95,44,43,8,57,38,19,5,5,24,6,18
"2021","Pendle 003C","E01025201",671,223,112,111,419,60,196,91,67,38,89,53,29,7,71,43,28,3,3,29,17,12
"2021","Pendle 003D","E01025202",604,162,84,78,421,89,201,96,69,36,70,27,35,8,58,29,29,3,3,21,15,6
"2021","Pendle 006A","E01025178",797,209,134,75,556,113,287,112,113,62,94,49,35,10,61,37,24,1,1,32,15,17
"2021","Pendle 006B","E01025179",689,209,84,125,463,72,200,83,78,39,115,66,44,5,72,54,18,4,4,17,7,10
"2021","Pendle 006C","E01025180",809,214,104,110,556,83,291,131,117,43,125,68,43,14,55,29,26,2,2,39,18,21
"2021","Pendle 006D","E01025203",769,202,97,105,543,111,286,138,95,53,99,61,33,5,42,31,11,5,5,24,10,14
"2021","Pendle 007A","E01025226",772,361,109,252,373,35,142,57,58,27,79,35,38,6,115,81,34,2,2,38,17,21
"2021","Pendle 007B","E01025227",943,392,126,266,499,61,143,50,62,31,126,63,54,9,158,114,44,11,11,52,18,34
"2021","Pendle 007C","E01025228",761,178,66,112,551,71,266,110,114,42,151,67,69,15,59,30,29,4,4,32,16,16
"2021","Pendle 008A","E01025174",593,167,101,66,397,86,203,80,89,34,52,26,22,4,52,28,24,4,4,29,20,9
"2021","Pendle 008B","E01025175",670,197,107,90,449,107,216,89,91,36,62,28,31,3,63,33,30,1,1,24,9,15
"2021","Pendle 008C","E01025176",1023,446,186,260,558,83,212,78,102,32,159,99,54,6,104,72,32,0,0,19,11,8
"2021","Pendle 008D","E01025177",741,184,111,73,539,142,281,118,117,46,82,51,26,5,34,15,19,0,0,18,3,15
"2021","Pendle 008E","E01025204",757,166,89,77,562,138,299,150,92,57,84,53,27,4,40,16,24,1,1,29,12,17
"2021","Pendle 008F","E01025211",706,205,124,81,474,116,234,101,104,29,72,28,41,3,50,30,20,2,2,27,18,9
"2021","Pendle 009A","E01025181",660,225,114,111,377,32,191,47,124,20,45,14,28,3,105,68,37,4,4,58,37,21
"2021","Pendle 009B","E01025182",649,208,74,134,354,27,193,42,126,25,49,30,17,2,70,37,33,15,15,87,60,27
"2021","Pendle 009C","E01025183",722,268,106,162,376,30,183,41,119,23,63,32,27,4,91,61,30,9,9,78,46,32
"2021","Pendle 009D","E01025184",597,164,32,132,332,13,204,33,148,23,28,9,18,1,77,49,28,10,10,101,80,21
"2021","Pendle 010A","E01025188",858,353,157,196,406,35,238,60,154,24,54,26,22,6,69,49,20,10,10,99,65,34
"2021","Pendle 010B","E01025189",636,207,59,148,357,29,196,64,107,25,50,18,25,7,76,46,30,6,6,72,47,25
"2021","Pendle 010C","E01025210",785,258,86,172,476,39,209,58,114,37,92,34,50,8,131,98,33,5,5,51,23,28
"2021","Pendle 010D","E01025217",619,202,75,127,359,25,181,36,130,15,65,40,20,5,84,58,26,4,4,58,34,24
"2021","Pendle 010E","E01025218",468,171,55,116,240,13,141,22,100,19,30,16,10,4,52,37,15,4,4,57,46,11
"2021","Pendle 010F","E01025219",570,215,47,168,291,18,139,37,81,21,59,27,30,2,70,51,19,5,5,64,36,28
"2021","Pendle 011A","E01025224",789,211,86,125,480,28,313,53,214,46,39,16,20,3,88,57,31,12,12,98,66,32
"2021","Pendle 011B","E01025225",631,175,86,89,405,34,228,56,137,35,50,25,21,4,87,62,25,6,6,51,31,20
"2021","Pendle 011C","E01025229",757,151,60,91,447,13,296,43,205,48,35,16,19,0,92,54,38,11,11,159,124,35
"2021","Pendle 011D","E01025230",621,164,49,115,337,5,229,31,168,30,29,14,13,2,68,48,20,6,6,120,96,24
"2021","Pendle 012A","E01025187",558,166,101,65,349,72,188,67,92,29,35,15,18,2,51,35,16,3,3,43,25,18
"2021","Pendle 012B","E01025190",623,170,77,93,399,77,213,72,107,34,54,30,18,6,55,26,29,0,0,54,41,13
"2021","Pendle 012C","E01025209",689,179,96,83,465,89,198,75,79,44,88,28,48,12,87,59,28,3,3,45,25,20
"2021","Pendle 012D","E01025216",756,152,77,75,527,39,284,77,155,52,85,33,43,9,115,81,34,4,4,77,57,20
"2021","Pendle 013A","E01025185",728,222,96,126,420,48,245,69,145,31,53,23,24,6,70,39,31,4,4,86,60,26
"2021","Pendle 013B","E01025186",699,201,61,140,434,36,236,68,143,25,73,35,32,6,79,53,26,10,10,64,39,25
"2021","Pendle 013C","E01025212",557,141,100,41,353,85,201,66,91,44,26,17,6,3,40,19,21,1,1,63,45,18
"2021","Pendle 013D","E01025213",492,101,62,39,324,43,196,52,112,32,34,19,15,0,43,27,16,8,8,67,47,20
"2021","Pendle 013E","E01025214",551,120,58,62,401,89,216,64,107,45,60,30,19,11,35,17,18,1,1,30,21,9
"2021","Pendle 013F","E01025215",517,162,60,102,300,22,175,38,109,28,28,13,14,1,73,38,35,2,2,55,39,16
"2021","Pendle 014E","E01025205",557,198,62,136,340,17,125,56,48,21,92,38,44,10,103,77,26,3,3,19,10,9
"2021","Pendle 014A","E01025206",526,129,89,40,375,82,170,81,58,31,77,39,29,9,43,24,19,3,3,22,9,13
"2021","Pendle 014G","E01025207",650,332,113,219,298,38,92,51,29,12,99,57,36,6,69,47,22,0,0,20,6,14
"2021","Pendle 014F","E01025208",619,325,147,178,285,47,113,53,40,20,66,34,27,5,58,45,13,1,1,9,2,7
"2021","Pendle 014C","E01025220",626,191,77,114,393,28,140,47,67,26,92,30,54,8,132,90,42,1,1,42,23,19
"2021","Pendle 014B","E01025221",550,113,50,63,408,45,163,54,79,30,109,35,63,11,86,64,22,5,5,29,17,12
"2021","Pendle 014D","E01025222",649,169,87,82,453,95,212,93,76,43,84,43,38,3,60,39,21,2,2,27,14,13
"2021","Pendle 014H","E01025223",631,270,101,169,335,37,133,51,51,31,82,42,31,9,78,55,23,5,5,26,13,13
"2021","Preston 001A","E01025278",1107,264,124,140,795,152,449,147,230,72,118,54,56,8,73,53,20,3,3,48,32,16
"2021","Preston 001B","E01025279",950,161,77,84,745,121,426,173,161,92,124,61,55,8,68,41,27,6,6,44,25,19
"2021","Preston 001C","E01025282",714,183,99,84,511,90,270,100,128,42,101,47,48,6,47,27,20,3,3,20,12,8
"2021","Preston 002A","E01025257",552,105,61,44,415,101,250,86,122,42,35,14,17,4,28,16,12,1,1,32,19,13
"2021","Preston 002B","E01025277",956,215,136,79,707,135,406,121,232,53,91,47,44,0,73,48,25,2,2,34,20,14
"2021","Preston 002D","E01025281",842,174,87,87,628,100,381,113,214,54,99,59,37,3,45,26,19,3,3,40,19,21
"2021","Preston 002E","E01034346",429,86,42,44,316,67,185,69,80,36,32,18,13,1,29,19,10,3,3,27,16,11
"2021","Preston 002F","E01034347",1001,190,49,141,788,43,424,122,251,51,232,133,87,12,86,66,20,3,3,23,12,11
"2021","Preston 003A","E01025256",625,211,142,69,394,81,242,71,117,54,35,21,12,2,36,23,13,0,0,20,9,11
"2021","Preston 003B","E01025258",617,148,96,52,447,115,226,75,102,49,51,23,26,2,55,26,29,0,0,22,9,13
"2021","Preston 003C","E01025259",1117,261,119,142,818,131,446,126,243,77,147,70,72,5,92,53,39,2,2,38,22,16
"2021","Preston 003D","E01025299",610,173,101,72,410,90,233,69,123,41,40,17,19,4,44,26,18,3,3,27,16,11
"2021","Preston 003E","E01025301",458,129,39,90,315,23,173,61,81,31,44,20,21,3,73,46,27,2,2,14,7,7
"2021","Preston 003F","E01025302",497,142,78,64,327,52,198,77,87,34,37,20,14,3,39,18,21,1,1,28,12,16
"2021","Preston 004A","E01025253",703,156,38,118,510,29,324,110,167,47,98,58,38,2,55,34,21,4,4,37,22,15
"2021","Preston 004B","E01025254",470,134,68,66,315,42,188,66,81,41,35,20,15,0,46,21,25,4,4,21,4,17
"2021","Preston 004C","E01025255",582,137,45,92,414,37,250,70,122,58,66,34,27,5,57,38,19,4,4,31,14,17
"2021","Preston 004D","E01025300",516,274,142,132,224,56,114,39,52,23,29,15,11,3,22,15,7,3,3,18,4,14
"2021","Preston 004E","E01025303",601,214,84,130,366,54,194,71,89,34,58,38,17,3,59,32,27,1,1,21,10,11
"2021","Preston 005A","E01025260",766,377,103,274,361,33,99,38,46,15,97,40,50,7,123,84,39,9,9,28,13,15
"2021","Preston 005B","E01025262",698,299,148,151,368,67,160,70,63,27,58,22,31,5,80,41,39,3,3,31,16,15
"2021","Preston 005C","E01025263",639,254,91,163,366,39,129,51,59,19,86,40,42,4,107,77,30,5,5,19,9,10
"2021","Preston 005D","E01025264",675,279,90,189,371,55,135,50,54,31,62,30,27,5,114,84,30,5,5,25,10,15
"2021","Preston 006A","E01025239",657,250,163,87,377,97,168,63,70,35,55,30,21,4,49,21,28,8,8,30,13,17
"2021","Preston 006B","E01025241",656,178,92,86,433,78,259,87,123,49,45,22,20,3,46,19,27,5,5,45,20,25
"2021","Preston 006C","E01025242",612,138,95,43,439,99,262,67,155,40,41,21,17,3,36,19,17,1,1,35,16,19
"2021","Preston 006D","E01025243",773,252,88,164,441,56,262,72,143,47,54,31,18,5,64,32,32,5,5,80,45,35
"2021","Preston 006E","E01025251",546,151,96,55,347,57,202,58,110,34,28,7,17,4,58,40,18,2,2,48,25,23
"2021","Preston 007A","E01025234",552,142,40,102,371,36,196,60,98,38,65,17,45,3,70,57,13,4,4,39,21,18
"2021","Preston 007B","E01025235",687,179,101,78,456,74,240,75,113,52,66,24,34,8,70,39,31,6,6,52,32,20
"2021","Preston 007C","E01025237",690,261,103,158,391,37,153,46,69,38,75,26,41,8,123,82,41,3,3,38,18,20
"2021","Preston 007D","E01025238",624,217,89,128,373,20,124,46,61,17,94,28,55,11,130,94,36,5,5,34,21,13
"2021","Preston 007E","E01025245",922,214,99,115,623,48,292,64,154,74,79,21,46,12,196,138,58,8,8,85,49,36
"2021","Preston 007F","E01025252",618,246,124,122,344,47,176,55,89,32,62,36,24,2,51,28,23,8,8,28,10,18
"2021","Preston 008A","E01025233",516,133,54,79,363,42,209,67,88,54,65,23,38,4,44,21,23,3,3,20,10,10
"2021","Preston 008B","E01025240",658,167,109,58,476,88,257,89,105,63,75,35,31,9,53,28,25,3,3,15,7,8
"2021","Preston 008C","E01025261",656,231,127,104,397,71,182,82,70,30,73,36,37,0,63,30,33,8,8,28,14,14
"2021","Preston 008D","E01025266",507,140,86,54,349,64,175,78,55,42,42,23,15,4,68,29,39,0,0,18,10,8
"2021","Preston 008E","E01025309",528,160,63,97,344,52,166,56,79,31,62,28,31,3,62,43,19,2,2,24,10,14
"2021","Preston 009A","E01025236",578,145,54,91,387,34,150,35,84,31,70,16,52,2,127,87,40,6,6,46,30,16
"2021","Preston 009B","E01025283",623,155,58,97,422,23,157,38,93,26,100,25,62,13,137,102,35,5,5,46,32,14
"2021","Preston 009C","E01025284",643,157,78,79,438,47,218,88,82,48,79,28,44,7,83,48,35,11,11,48,24,24
"2021","Preston 009D","E01025285",511,128,49,79,330,30,176,42,86,48,36,16,18,2,82,54,28,6,6,53,33,20
"2021","Preston 009E","E01025286",715,207,54,153,454,20,163,56,78,29,112,39,65,8,154,118,36,5,5,54,30,24
"2021","Preston 009F","E01025287",939,426,109,317,472,24,159,57,76,26,110,56,44,10,172,133,39,7,7,41,19,22
"2021","Preston 010A","E01025270",678,174,83,91,464,60,234,89,92,53,99,43,47,9,69,50,19,2,2,40,25,15
"2021","Preston 010B","E01025272",1107,233,52,181,824,67,396,143,204,49,216,133,77,6,140,100,40,5,5,50,23,27
"2021","Preston 010C","E01025273",509,102,41,61,391,40,278,110,110,58,47,25,16,6,25,17,8,1,1,16,8,8
"2021","Preston 010D","E01025288",956,482,97,385,421,32,142,68,62,12,125,95,29,1,118,82,36,4,4,53,13,40
"2021","Preston 011A","E01025246",516,72,29,43,388,22,286,46,179,61,14,8,6,0,57,23,34,9,9,56,33,23
"2021","Preston 011B","E01025274",821,286,48,238,380,11,137,48,76,13,93,61,26,6,112,81,31,27,27,155,24,131
"2021","Preston 011C","E01025275",772,331,107,224,372,27,132,51,60,21,103,65,32,6,97,66,31,13,13,69,11,58
"2021","Preston 011D","E01025294",635,155,38,117,403,16,227,46,146,35,67,46,14,7,76,46,30,17,17,77,29,48
"2021","Preston 012A","E01025276",645,203,64,139,370,29,200,43,123,34,54,29,23,2,81,55,26,6,6,72,27,45
"2021","Preston 012B","E01025308",729,225,48,177,407,11,166,54,86,26,115,66,43,6,106,75,31,9,9,97,18,79
"2021","Preston 012C","E01025310",740,275,47,228,414,26,128,46,53,29,117,70,44,3,134,87,47,9,9,51,14,37
"2021","Preston 012D","E01025311",645,284,76,208,326,27,90,40,37,13,106,71,32,3,97,80,17,6,6,35,8,27
"2021","Preston 012E","E01025312",771,302,51,251,403,21,138,57,59,22,128,79,44,5,106,83,23,10,10,66,12,54
"2021","Preston 012F","E01025313",644,296,81,215,249,8,74,28,40,6,75,48,26,1,83,63,20,9,9,99,11,88
"2021","Preston 012G","E01025314",740,336,53,283,295,31,93,44,27,22,91,59,28,4,68,42,26,12,12,109,10,99
"2021","Preston 013A","E01025231",579,190,91,99,353,72,195,75,78,42,57,34,21,2,28,12,16,1,1,36,15,21
"2021","Preston 013B","E01025232",745,299,37,262,373,18,123,50,54,19,131,85,43,3,93,67,26,8,8,73,12,61
"2021","Preston 013C","E01025265",642,213,73,140,411,47,208,101,63,44,85,43,37,5,66,41,25,5,5,18,10,8
"2021","Preston 013D","E01025267",613,230,111,119,360,41,163,58,65,40,78,33,37,8,74,56,18,4,4,23,7,16
"2021","Preston 013E","E01025268",862,371,117,254,458,28,188,56,100,32,118,60,51,7,120,90,30,4,4,33,18,15
"2021","Preston 013F","E01025269",722,211,72,139,472,38,172,39,98,35,99,47,39,13,157,112,45,6,6,39,22,17
"2021","Preston 013G","E01025271",619,161,80,81,432,61,184,61,78,45,82,29,44,9,100,57,43,5,5,26,13,13
"2021","Preston 014A","E01025295",1098,518,134,384,507,18,206,59,125,22,106,63,41,2,160,126,34,17,17,73,24,49
"2021","Preston 014B","E01025296",731,191,43,148,484,27,229,60,127,42,93,36,49,8,129,102,27,6,6,56,34,22
"2021","Preston 014C","E01025297",895,263,70,193,532,23,208,49,131,28,121,43,73,5,169,134,35,11,11,100,57,43
"2021","Preston 014D","E01025298",665,181,43,138,411,16,175,42,107,26,59,25,29,5,148,112,36,13,13,73,38,35
"2021","Preston 015A","E01025244",499,70,26,44,366,15,271,50,168,53,23,10,10,3,52,29,23,5,5,63,43,20
"2021","Preston 015B","E01025292",618,316,33,283,238,11,70,23,43,4,67,48,17,2,67,38,29,23,23,64,10,54
"2021","Preston 015C","E01025293",906,361,109,252,444,25,218,54,120,44,65,36,26,3,114,67,47,22,22,101,32,69
"2021","Preston 016A","E01025247",631,193,49,144,380,19,203,39,128,36,63,32,28,3,84,54,30,11,11,58,29,29
"2021","Preston 016B","E01025248",498,119,38,81,348,15,129,32,76,21,64,15,48,1,135,93,42,5,5,31,20,11
"2021","Preston 016C","E01025249",434,138,60,78,279,34,122,50,43,29,61,32,24,5,62,40,22,0,0,17,10,7
"2021","Preston 016D","E01025250",607,164,48,116,382,17,191,38,120,33,45,15,24,6,127,94,33,2,2,61,28,33
"2021","Preston 016E","E01025304",632,145,79,66,423,36,263,53,165,45,46,14,26,6,67,40,27,11,11,64,32,32
"2021","Preston 016F","E01025305",638,196,51,145,383,19,209,53,116,40,59,34,24,1,82,48,34,14,14,59,27,32
"2021","Preston 017A","E01025289",629,223,46,177,322,15,147,66,60,21,78,52,22,4,74,49,25,8,8,84,29,55
"2021","Preston 017B","E01025290",771,327,42,285,317,13,119,38,51,30,96,80,14,2,73,43,30,16,16,127,21,106
"2021","Preston 017C","E01025291",644,263,97,166,337,27,160,61,66,33,77,45,25,7,65,39,26,8,8,44,11,33
"2021","Preston 017D","E01025306",956,512,55,457,336,15,137,47,63,27,122,108,14,0,48,25,23,14,14,108,16,92
"2021","Preston 017F","E01033223",636,414,40,374,146,6,51,30,20,1,58,54,4,0,14,8,6,17,17,76,7,69
"2021","Preston 017G","E01033224",553,293,56,237,220,9,82,34,38,10,57,41,15,1,63,50,13,9,9,40,11,29
"2021","Preston 017H","E01033226",535,238,65,173,263,14,106,27,67,12,55,35,18,2,70,48,22,18,18,34,16,18
"2021","Ribble Valley 001A","E01025315",568,139,68,71,410,65,240,97,92,51,74,44,24,6,28,17,11,3,3,19,7,12
"2021","Ribble Valley 001B","E01025320",536,109,49,60,398,85,233,96,88,49,44,27,11,6,36,19,17,0,0,29,12,17
"2021","Ribble Valley 001C","E01025331",590,148,75,73,405,67,247,102,101,44,55,27,20,8,34,19,15,2,2,37,15,22
"2021","Ribble Valley 001D","E01025348",772,253,173,80,496,150,251,141,78,32,57,30,21,6,35,18,17,3,3,23,10,13
"2021","Ribble Valley 001E","E01025349",592,140,84,56,432,105,242,114,80,48,57,33,20,4,27,14,13,1,1,20,14,6
"2021","Ribble Valley 002A","E01025334",920,261,125,136,630,129,289,108,132,49,120,68,48,4,88,58,30,4,4,29,16,13
"2021","Ribble Valley 002B","E01025344",650,270,132,138,356,80,151,55,61,35,67,41,20,6,56,38,18,2,2,24,6,18
"2021","Ribble Valley 002C","E01025345",660,223,146,77,424,104,228,71,106,51,52,19,28,5,38,20,18,2,2,13,3,10
"2021","Ribble Valley 002D","E01025346",653,189,73,116,439,58,214,83,94,37,87,50,33,4,72,43,29,8,8,25,12,13
"2021","Ribble Valley 002E","E01025347",776,233,79,154,520,60,252,88,115,49,111,63,41,7,93,56,37,4,4,23,12,11
"2021","Ribble Valley 003A","E01025329",896,242,141,101,625,103,323,94,187,42,109,39,65,5,84,50,34,6,6,29,14,15
"2021","Ribble Valley 003B","E01025330",696,251,112,139,427,79,196,75,98,23,88,50,32,6,61,39,22,3,3,18,4,14
"2021","Ribble Valley 003C","E01025335",685,329,173,156,329,63,133,59,52,22,57,29,25,3,69,45,24,7,7,27,8,19
"2021","Ribble Valley 003D","E01025338",743,287,89,198,419,40,189,76,73,40,117,78,29,10,69,44,25,4,4,37,12,25
"2021","Ribble Valley 003E","E01025339",999,283,118,165,680,102,323,111,156,56,160,87,66,7,93,62,31,2,2,36,16,20
"2021","Ribble Valley 004A","E01025322",617,145,71,74,453,78,283,133,93,57,57,31,19,7,28,16,12,7,7,19,6,13
"2021","Ribble Valley 004B","E01025326",782,265,137,128,497,91,230,110,74,46,104,59,38,7,69,42,27,3,3,20,12,8
"2021","Ribble Valley 004C","E01025327",553,139,64,75,395,70,222,92,83,47,57,29,27,1,40,24,16,6,6,19,8,11
"2021","Ribble Valley 004D","E01025342",674,188,109,79,458,101,239,108,86,45,64,28,32,4,51,28,23,3,3,28,12,16
"2021","Ribble Valley 005A","E01025321",583,188,85,103,376,62,209,82,84,43,55,33,19,3,49,28,21,1,1,19,13,6
"2021","Ribble Valley 005B","E01025340",622,184,89,95,414,81,212,85,85,42,70,32,34,4,50,30,20,1,1,24,8,16
"2021","Ribble Valley 005C","E01025341",505,94,67,27,392,113,219,73,101,45,42,18,21,3,18,8,10,0,0,19,6,13
"2021","Ribble Valley 005D","E01025343",713,219,105,114,476,73,260,101,105,54,87,52,27,8,55,37,18,1,1,18,7,11
"2021","Ribble Valley 005E","E01025354",974,228,99,129,725,134,393,153,185,55,121,72,42,7,76,52,24,1,1,21,7,14
"2021","Ribble Valley 006A","E01025316",669,130,76,54,511,106,282,109,106,67,65,27,34,4,53,29,24,5,5,28,13,15
"2021","Ribble Valley 006B","E01025317",479,157,62,95,307,49,139,59,52,28,70,31,33,6,49,34,15,0,0,15,4,11
"2021","Ribble Valley 006C","E01025325",742,329,147,182,396,55,155,59,61,35,92,48,36,8,89,60,29,5,5,17,8,9
"2021","Ribble Valley 006D","E01025328",656,187,88,99,456,92,220,90,92,38,99,57,40,2,42,28,14,3,3,13,5,8
"2021","Ribble Valley 007A","E01025318",496,120,63,57,368,60,171,67,71,33,72,31,33,8,60,35,25,5,5,8,3,5
"2021","Ribble Valley 007B","E01025319",824,181,91,90,617,91,385,125,185,75,82,41,34,7,58,28,30,1,1,26,10,16
"2021","Ribble Valley 007C","E01025333",556,146,90,56,384,84,194,73,83,38,50,26,19,5,54,26,28,2,2,26,11,15
"2021","Ribble Valley 007D","E01025350",727,237,141,96,472,97,248,106,101,41,75,38,31,6,49,32,17,3,3,18,8,10
"2021","Ribble Valley 007E","E01025351",1150,340,178,162,769,142,440,155,227,58,107,51,43,13,75,40,35,5,5,41,19,22
"2021","Ribble Valley 008A","E01025323",492,133,88,45,342,76,200,83,70,47,47,25,18,4,19,10,9,0,0,17,6,11
"2021","Ribble Valley 008B","E01025324",577,142,82,60,405,87,219,92,96,31,54,35,16,3,43,33,10,2,2,30,14,16
"2021","Ribble Valley 008D","E01025336",481,123,66,57,335,107,161,71,63,27,37,22,15,0,28,14,14,2,2,23,9,14
"2021","Ribble Valley 008E","E01025337",685,218,142,76,446,114,237,95,99,43,46,29,14,3,47,24,23,2,2,21,10,11
"2021","Ribble Valley 008F","E01025352",560,113,79,34,436,87,261,85,109,67,50,22,26,2,38,16,22,0,0,11,6,5
"2021","Ribble Valley 008H","E01034764",897,241,146,95,624,156,347,123,151,73,68,37,27,4,50,28,22,3,3,32,17,15
"2021","Rossendale 001A","E01025355",886,152,91,61,699,110,421,134,202,85,94,43,46,5,74,44,30,0,0,35,20,15
"2021","Rossendale 001B","E01025361",906,276,113,163,593,65,291,127,110,54,139,77,56,6,95,53,42,3,3,37,17,20
"2021","Rossendale 001C","E01025362",844,231,137,94,584,80,325,101,167,57,129,66,53,10,48,31,17,2,2,29,14,15
"2021","Rossendale 001D","E01025393",620,187,71,116,401,52,209,95,81,33,89,45,35,9,49,28,21,2,2,32,16,16
"2021","Rossendale 002A","E01025363",559,181,92,89,358,54,191,72,77,42,65,33,26,6,47,29,18,1,1,20,8,12
"2021","Rossendale 002B","E01025364",536,124,74,50,384,72,227,74,110,43,53,21,28,4,30,20,10,2,2,28,19,9
"2021","Rossendale 002C","E01025366",589,183,45,138,366,22,175,49,94,32,69,26,43,0,97,68,29,3,3,40,31,9
"2021","Rossendale 002D","E01025395",717,249,105,144,429,60,198,91,69,38,120,71,46,3,45,32,13,6,6,39,20,19
"2021","Rossendale 002E","E01025396",655,317,119,198,309,35,110,34,45,31,76,41,26,9,82,55,27,6,6,29,21,8
"2021","Rossendale 002F","E01025397",662,196,48,148,406,32,167,48,106,13,99,55,39,5,103,71,32,5,5,60,40,20
"2021","Rossendale 002G","E01025398",557,182,82,100,336,27,148,51,78,19,67,26,37,4,90,69,21,4,4,39,22,17
"2021","Rossendale 003A","E01025367",729,161,55,106,518,63,279,107,121,51,107,52,50,5,66,42,24,3,3,50,22,28
"2021","Rossendale 003B","E01025368",753,250,95,155,468,60,194,76,81,37,92,46,39,7,119,92,27,3,3,35,13,22
"2021","Rossendale 003C","E01025369",599,236,83,153,340,37,125,52,47,26,83,41,38,4,91,67,24,4,4,23,11,12
"2021","Rossendale 003D","E01025381",632,170,70,100,423,44,157,61,65,31,95,31,56,8,122,90,32,5,5,39,22,17
"2021","Rossendale 003E","E01025382",814,302,117,185,482,59,188,70,81,37,92,49,41,2,137,91,46,6,6,30,12,18
"2021","Rossendale 003F","E01025383",1150,256,99,157,841,85,452,155,224,73,197,81,100,16,101,66,35,6,6,53,27,26
"2021","Rossendale 004A","E01025356",668,275,114,161,364,42,160,50,89,21,87,43,42,2,73,47,26,2,2,29,16,13
"2021","Rossendale 004C","E01025373",720,233,109,124,467,82,246,83,123,40,74,41,29,4,62,37,25,3,3,20,12,8
"2021","Rossendale 004D","E01025385",584,253,97,156,304,16,104,47,40,17,76,25,43,8,105,71,34,3,3,27,16,11
"2021","Rossendale 004F","E01025387",719,132,66,66,557,61,319,110,164,45,115,54,53,8,62,40,22,0,0,30,16,14
"2021","Rossendale 004G","E01033281",1178,412,194,218,698,76,322,136,146,40,167,78,79,10,125,78,47,8,8,68,31,37
"2021","Rossendale 007A","E01025377",645,156,69,87,465,86,270,91,131,48,61,28,26,7,47,32,15,1,1,24,9,15
"2021","Rossendale 007B","E01025378",702,200,82,118,482,78,251,106,105,40,89,56,31,2,61,37,24,3,3,20,8,12
"2021","Rossendale 007C","E01025379",632,255,124,131,356,57,139,56,55,28,80,29,43,8,80,56,24,0,0,21,11,10
"2021","Rossendale 007D","E01025380",624,128,84,44,480,128,226,75,113,38,72,35,34,3,54,37,17,0,0,16,6,10
"2021","Rossendale 008A","E01025357",621,217,77,140,378,56,154,59,68,27,85,43,39,3,82,42,40,1,1,26,9,17
"2021","Rossendale 008B","E01025358",946,250,115,135,664,120,354,118,169,67,112,57,48,7,72,36,36,6,6,32,12,20
"2021","Rossendale 008C","E01025365",674,211,99,112,443,79,198,91,67,40,95,48,42,5,67,44,23,4,4,20,12,8
"2021","Rossendale 008D","E01025384",548,165,99,66,357,81,174,75,71,28,69,29,31,9,32,17,15,1,1,26,14,12
"2021","Rossendale 009A","E01025359",736,197,87,110,516,95,225,92,86,47,107,52,45,10,84,56,28,5,5,23,7,16
"2021","Rossendale 009B","E01025360",954,370,150,220,557,88,209,87,79,43,153,75,62,16,104,63,41,3,3,27,14,13
"2021","Rossendale 009C","E01025375",681,171,64,107,484,81,251,107,85,59,91,46,39,6,60,37,23,1,1,26,13,13
"2021","Rossendale 009D","E01025376",1110,394,160,234,676,70,277,110,118,49,169,67,85,17,155,107,48,5,5,40,19,21
"2021","Rossendale 010F","E01025370",547,158,55,103,362,71,163,74,58,31,74,40,29,5,54,37,17,0,0,27,14,13
"2021","Rossendale 010A","E01025371",665,255,117,138,379,54,145,57,56,32,108,47,58,3,69,41,28,3,3,31,17,14
"2021","Rossendale 010B","E01025374",623,223,104,119,373,57,167,54,66,47,87,39,44,4,59,39,20,3,3,27,13,14
"2021","Rossendale 010G","E01025388",687,255,99,156,405,53,154,68,55,31,103,50,47,6,89,61,28,6,6,27,12,15
"2021","Rossendale 010H","E01025389",607,205,64,141,368,27,142,44,57,41,85,31,49,5,108,78,30,6,6,34,21,13
"2021","Rossendale 010I","E01025390",534,231,101,130,278,57,117,47,42,28,53,26,24,3,51,27,24,0,0,25,7,18
"2021","Rossendale 010C","E01025391",661,225,78,147,419,31,173,60,75,38,104,42,56,6,105,72,33,6,6,17,11,6
"2021","Rossendale 010D","E01025392",609,249,98,151,353,46,160,77,60,23,82,51,27,4,61,36,25,4,4,7,1,6
"2021","Rossendale 010E","E01025394",677,239,88,151,401,50,186,76,70,40,85,33,44,8,78,50,28,2,2,37,13,24
"2021","South Ribble 001A","E01025424",506,111,61,50,371,76,227,62,120,45,41,20,18,3,26,15,11,1,1,24,11,13
"2021","South Ribble 001B","E01025425",540,143,72,71,388,47,229,85,97,47,59,28,25,6,52,26,26,1,1,9,3,6
"2021","South Ribble 001C","E01025426",501,105,57,48,382,80,237,85,104,48,33,16,16,1,32,16,16,0,0,14,9,5
"2021","South Ribble 001D","E01025466",661,188,139,49,454,106,228,64,121,43,63,37,26,0,54,34,20,3,3,19,12,7
"2021","South Ribble 002A","E01025413",762,247,138,109,489,104,240,109,97,34,68,31,34,3,75,45,30,2,2,26,11,15
"2021","South Ribble 002B","E01025414",696,203,131,72,476,159,231,97,73,61,53,30,20,3,32,15,17,1,1,17,5,12
"2021","South Ribble 002C","E01025456",467,103,61,42,333,68,196,80,71,45,42,26,16,0,25,12,13,2,2,31,15,16
"2021","South Ribble 002D","E01025458",715,231,87,144,450,49,200,73,86,41,110,58,47,5,84,57,27,7,7,34,17,17
"2021","South Ribble 003A","E01025408",647,198,116,82,427,135,208,87,82,39,46,29,16,1,36,15,21,2,2,22,13,9
"2021","South Ribble 003B","E01025409",576,170,74,96,386,81,176,84,68,24,56,30,23,3,71,40,31,2,2,20,7,13
"2021","South Ribble 003C","E01025410",521,94,58,36,413,65,270,95,118,57,41,12,22,7,37,23,14,0,0,14,7,7
"2021","South Ribble 003D","E01025467",871,272,177,95,584,148,288,119,116,53,75,29,40,6,70,40,30,3,3,15,7,8
"2021","South Ribble 004A","E01025403",876,214,80,134,636,47,374,110,209,55,131,62,63,6,83,48,35,1,1,26,13,13
"2021","South Ribble 004B","E01025457",610,198,80,118,386,61,184,80,75,29,74,48,21,5,64,36,28,3,3,26,12,14
"2021","South Ribble 004C","E01025463",589,170,61,109,399,50,197,78,81,38,91,57,31,3,57,36,21,4,4,20,6,14
"2021","South Ribble 004D","E01025464",515,112,79,33,385,88,240,108,83,49,41,20,18,3,16,7,9,0,0,18,7,11
"2021","South Ribble 004E","E01025465",488,176,84,92,287,38,134,51,58,25,66,44,19,3,47,29,18,2,2,25,10,15
"2021","South Ribble 005A","E01025411",952,278,106,172,644,105,312,113,143,56,124,60,58,6,97,66,31,6,6,30,17,13
"2021","South Ribble 005B","E01025448",722,236,111,125,464,79,188,80,70,38,118,67,45,6,70,42,28,9,9,22,13,9
"2021","South Ribble 005E","E01034348",856,278,157,121,554,76,268,92,115,61,98,38,48,12,105,59,46,7,7,24,8,16
"2021","South Ribble 006A","E01025412",675,259,145,114,396,89,173,70,65,38,59,25,32,2,70,43,27,5,5,20,13,7
"2021","South Ribble 006B","E01025427",679,283,135,148,370,54,163,65,62,36,79,46,26,7,72,45,27,2,2,26,14,12
"2021","South Ribble 006C","E01025428",617,192,79,113,387,37,181,63,80,38,83,38,40,5,86,58,28,0,0,38,17,21
"2021","South Ribble 006D","E01025429",615,216,69,147,380,23,134,48,68,18,80,39,34,7,142,97,45,1,1,19,12,7
"2021","South Ribble 007A","E01025404",552,179,129,50,361,91,167,63,66,38,61,30,29,2,40,15,25,2,2,12,3,9
"2021","South Ribble 007B","E01025405",567,226,90,136,323,52,118,60,29,29,65,36,26,3,83,56,27,5,5,18,4,14
"2021","South Ribble 007C","E01025406",547,190,117,73,336,77,131,64,38,29,70,42,23,5,57,26,31,1,1,21,14,7
"2021","South Ribble 007D","E01025407",897,368,116,252,488,37,190,68,96,26,121,59,56,6,133,91,42,7,7,41,15,26
"2021","South Ribble 008A","E01025399",612,191,62,129,402,44,154,55,60,39,84,43,37,4,114,67,47,6,6,19,9,10
"2021","South Ribble 008B","E01025400",808,162,88,74,605,101,320,112,145,63,105,48,48,9,76,44,32,3,3,41,29,12
"2021","South Ribble 008C","E01025401",754,250,94,156,475,77,186,83,66,37,131,77,49,5,75,40,35,6,6,29,7,22
"2021","South Ribble 008D","E01025402",792,206,49,157,559,38,258,65,152,41,135,55,77,3,125,82,43,3,3,27,9,18
"2021","South Ribble 009A","E01025442",515,215,67,148,274,24,83,34,34,15,91,53,34,4,71,54,17,5,5,26,8,18
"2021","South Ribble 009B","E01025443",602,202,95,107,384,94,188,86,60,42,60,34,22,4,42,24,18,0,0,16,6,10
"2021","South Ribble 009C","E01025444",556,158,68,90,370,55,186,71,77,38,71,33,29,9,55,36,19,3,3,28,5,23
"2021","South Ribble 009D","E01025461",785,173,87,86,584,87,321,120,145,56,110,52,49,9,64,35,29,2,2,28,11,17
"2021","South Ribble 009E","E01025462",851,214,97,117,616,87,291,101,135,55,149,72,69,8,85,59,26,4,4,21,9,12
"2021","South Ribble 010A","E01025439",602,153,101,52,420,103,227,76,99,52,44,18,23,3,46,18,28,0,0,29,19,10
"2021","South Ribble 010B","E01025453",717,167,97,70,528,101,294,104,138,52,75,34,34,7,55,34,21,3,3,22,10,12
"2021","South Ribble 010C","E01025454",526,110,70,40,400,104,215,70,101,44,47,20,21,6,30,17,13,4,4,16,10,6
"2021","South Ribble 010D","E01025455",701,191,131,60,483,117,241,83,110,48,65,34,28,3,59,29,30,1,1,27,14,13
"2021","South Ribble 011A","E01025436",949,217,110,107,697,137,355,123,140,92,109,53,48,8,93,46,47,3,3,35,16,19
"2021","South Ribble 011B","E01025437",869,263,135,128,573,108,284,105,118,61,92,44,41,7,86,50,36,3,3,33,14,19
"2021","South Ribble 011C","E01025438",548,126,84,42,407,89,228,92,94,42,44,24,16,4,45,20,25,1,1,15,7,8
"2021","South Ribble 011D","E01025440",617,195,137,58,406,105,206,78,70,58,57,37,17,3,37,26,11,1,1,16,10,6
"2021","South Ribble 011E","E01025441",657,211,152,59,427,125,196,89,70,37,53,28,24,1,48,30,18,5,5,19,9,10
"2021","South Ribble 012A","E01025417",662,203,108,95,430,86,211,83,87,41,81,40,36,5,52,23,29,0,0,29,10,19
"2021","South Ribble 012B","E01025418",627,184,87,97,423,58,199,86,71,42,84,37,43,4,79,45,34,3,3,20,12,8
"2021","South Ribble 012C","E01025419",683,208,93,115,450,72,224,94,89,41,81,31,40,10,72,37,35,1,1,25,10,15
"2021","South Ribble 012E","E01034349",701,155,92,63,508,104,300,125,114,61,68,37,24,7,35,11,24,1,1,38,17,21
"2021","South Ribble 012F","E01034350",881,178,48,130,673,40,304,98,176,30,234,159,74,1,93,69,24,2,2,30,17,13
"2021","South Ribble 013A","E01025421",996,279,70,209,673,53,353,95,197,61,163,93,60,10,94,66,28,10,10,44,13,31
"2021","South Ribble 013B","E01025422",705,281,143,138,406,64,157,61,62,34,102,59,38,5,78,43,35,5,5,18,9,9
"2021","South Ribble 013C","E01025431",939,345,79,266,555,27,221,82,104,35,159,95,58,6,145,105,40,3,3,39,16,23
"2021","South Ribble 013D","E01025433",723,255,113,142,438,73,217,90,69,58,79,36,40,3,67,40,27,2,2,30,16,14
"2021","South Ribble 014A","E01025416",628,162,95,67,435,84,242,118,84,40,66,28,29,9,41,26,15,2,2,31,14,17
"2021","South Ribble 014B","E01025451",747,141,77,64,582,103,342,122,155,65,87,47,37,3,47,27,20,3,3,24,5,19
"2021","South Ribble 014C","E01025452",739,241,81,160,455,59,177,81,62,34,97,42,50,5,117,82,35,5,5,43,19,24
"2021","South Ribble 015A","E01025415",860,255,113,142,571,80,246,102,86,58,127,64,57,6,114,61,53,4,4,34,13,21
"2021","South Ribble 015B","E01025423",590,240,85,155,322,26,82,26,28,28,85,28,52,5,124,82,42,5,5,28,16,12
"2021","South Ribble 015C","E01025435",683,267,115,152,392,76,179,82,62,35,59,31,25,3,76,50,26,2,2,24,10,14
"2021","South Ribble 015D","E01025446",654,202,123,79,423,82,208,100,72,36,71,39,27,5,61,35,26,1,1,29,8,21
"2021","South Ribble 016C","E01025434",810,196,152,44,596,214,319,123,122,74,31,21,10,0,32,10,22,0,0,18,8,10
"2021","South Ribble 016F","E01034351",1288,361,196,165,880,166,440,184,177,79,139,65,67,7,131,78,53,4,4,47,26,21
"2021","South Ribble 016G","E01034352",577,136,33,103,411,22,219,49,145,25,94,52,38,4,75,53,22,1,1,30,14,16
"2021","South Ribble 016H","E01034353",630,199,39,160,410,12,195,63,120,12,112,69,40,3,89,73,16,2,2,21,8,13
"2021","South Ribble 017A","E01025445",597,132,40,92,435,38,133,47,52,34,115,33,75,7,145,113,32,4,4,30,16,14
"2021","South Ribble 017B","E01025447",528,222,116,106,287,41,82,28,35,19,57,19,34,4,104,73,31,3,3,19,9,10
"2021","South Ribble 017C","E01025459",735,227,92,135,486,72,226,85,88,53,90,37,47,6,94,59,35,4,4,22,9,13
"2021","South Ribble 017D","E01025460",917,384,144,240,510,75,204,82,70,52,119,47,57,15,105,67,38,7,7,23,8,15
"2021","West Lancashire 001A","E01025496",506,107,56,51,369,62,176,76,56,44,72,36,31,5,58,33,25,1,1,30,12,18
"2021","West Lancashire 001B","E01025497",576,108,56,52,430,67,247,79,111,57,62,32,27,3,52,20,32,2,2,38,12,26
"2021","West Lancashire 001C","E01025498",589,130,77,53,444,90,231,81,103,47,58,21,34,3,62,37,25,3,3,15,9,6
"2021","West Lancashire 001D","E01025530",694,169,90,79,499,120,248,102,86,60,75,36,36,3,54,33,21,2,2,26,11,15
"2021","West Lancashire 001E","E01025532",719,173,108,65,527,119,283,96,118,69,73,33,36,4,50,27,23,2,2,19,7,12
"2021","West Lancashire 001F","E01025533",714,242,141,101,446,111,224,90,92,42,65,39,23,3,45,26,19,1,1,26,18,8
"2021","West Lancashire 002A","E01025507",860,220,88,132,606,116,302,153,91,58,116,71,41,4,70,36,34,2,2,34,15,19
"2021","West Lancashire 002B","E01025508",631,187,91,96,415,81,192,87,66,39,70,33,29,8,69,40,29,3,3,29,10,19
"2021","West Lancashire 002C","E01025509",591,198,114,84,375,78,179,88,62,29,52,17,30,5,62,28,34,4,4,18,5,13
"2021","West Lancashire 002D","E01025513",919,249,142,107,630,150,357,140,129,88,67,32,33,2,55,25,30,1,1,40,17,23
"2021","West Lancashire 002E","E01025531",492,116,59,57,345,99,171,83,51,37,41,27,12,2,30,13,17,4,4,31,11,20
"2021","West Lancashire 003A","E01025474",528,116,62,54,384,66,203,77,80,46,69,32,29,8,43,22,21,3,3,28,12,16
"2021","West Lancashire 003B","E01025495",912,230,129,101,633,139,299,114,113,72,103,52,44,7,88,43,45,4,4,49,25,24
"2021","West Lancashire 003C","E01025514",1044,240,143,97,756,164,378,148,141,89,104,57,43,4,101,52,49,9,9,48,20,28
"2021","West Lancashire 003D","E01025515",737,236,145,91,475,116,246,123,82,41,59,36,17,6,51,21,30,3,3,26,12,14
"2021","West Lancashire 004A","E01025483",1068,352,176,176,673,115,301,82,157,62,135,74,53,8,116,66,50,6,6,43,13,30
"2021","West Lancashire 004B","E01025484",893,213,120,93,644,130,330,103,166,61,107,62,41,4,72,38,34,5,5,36,17,19
"2021","West Lancashire 004C","E01025485",731,234,93,141,468,80,233,88,102,43,84,46,34,4,68,42,26,3,3,29,16,13
"2021","West Lancashire 004D","E01025486",653,151,83,68,472,81,223,70,106,47,94,41,50,3,73,39,34,1,1,30,14,16
"2021","West Lancashire 004E","E01025487",708,175,95,80,510,73,260,84,118,58,93,41,46,6,81,45,36,3,3,23,11,12
"2021","West Lancashire 005A","E01025510",511,90,67,23,402,117,233,86,97,50,34,14,16,4,18,10,8,0,0,19,8,11
"2021","West Lancashire 005B","E01025511",476,115,67,48,341,92,176,62,82,32,35,19,15,1,36,12,24,2,2,20,9,11
"2021","West Lancashire 005C","E01025512",564,195,117,78,341,67,173,70,69,34,55,33,21,1,45,26,19,1,1,28,10,18
"2021","West Lancashire 005D","E01025538",656,163,100,63,465,119,244,92,95,57,59,33,22,4,40,15,25,3,3,28,7,21
"2021","West Lancashire 005E","E01025539",581,157,82,75,404,74,214,71,106,37,69,38,28,3,43,24,19,4,4,20,8,12
"2021","West Lancashire 006A","E01025499",585,170,80,90,367,60,167,57,68,42,68,43,20,5,67,43,24,5,5,48,13,35
"2021","West Lancashire 006B","E01025501",488,140,109,31,333,101,167,58,66,43,31,20,11,0,33,12,21,1,1,15,4,11
"2021","West Lancashire 006C","E01025502",636,158,110,48,447,106,257,86,118,53,55,25,24,6,28,11,17,1,1,31,10,21
"2021","West Lancashire 006D","E01025516",629,176,97,79,426,87,209,73,98,38,69,33,23,13,60,29,31,1,1,27,10,17
"2021","West Lancashire 006E","E01025517",861,195,76,119,611,55,271,88,137,46,145,72,69,4,133,94,39,7,7,55,17,38
"2021","West Lancashire 006F","E01025519",507,145,82,63,336,73,171,64,62,45,54,27,21,6,35,15,20,3,3,26,7,19
"2021","West Lancashire 007A","E01025488",916,309,150,159,457,97,211,73,97,41,69,44,24,1,75,47,28,5,5,150,18,132
"2021","West Lancashire 007B","E01025489",551,143,60,83,367,53,191,59,91,41,64,33,28,3,59,35,24,0,0,41,4,37
"2021","West Lancashire 007C","E01025490",501,168,76,92,243,45,132,39,67,26,31,24,7,0,31,21,10,4,4,90,7,83
"2021","West Lancashire 007D","E01025500",833,373,235,138,384,92,148,68,50,30,76,53,21,2,60,34,26,8,8,76,9,67
"2021","West Lancashire 007E","E01025518",671,301,116,185,258,39,98,38,35,25,63,35,21,7,49,32,17,9,9,112,12,100
"2021","West Lancashire 008A","E01025479",927,230,123,107,639,119,328,147,106,75,119,72,39,8,69,35,34,4,4,58,23,35
"2021","West Lancashire 008B","E01025491",569,148,107,41,391,116,196,73,80,43,40,18,21,1,37,17,20,2,2,30,7,23
"2021","West Lancashire 008C","E01025506",885,219,123,96,630,156,331,133,127,71,89,60,23,6,51,21,30,3,3,36,15,21
"2021","West Lancashire 009A","E01025468",635,100,41,59,499,67,285,101,111,73,88,43,35,10,58,30,28,1,1,36,12,24
"2021","West Lancashire 009B","E01025469",809,363,157,206,421,63,184,69,64,51,101,42,53,6,71,38,33,2,2,25,8,17
"2021","West Lancashire 009C","E01025470",739,143,54,89,559,69,295,107,109,79,136,62,68,6,59,33,26,0,0,37,16,21
"2021","West Lancashire 009D","E01025522",503,167,124,43,311,79,140,59,48,33,48,24,17,7,43,24,19,1,1,25,10,15
"2021","West Lancashire 010A","E01025471",596,164,51,113,386,29,142,46,56,40,74,24,42,8,136,97,39,5,5,46,23,23
"2021","West Lancashire 010B","E01025480",513,131,46,85,344,30,140,40,66,34,66,26,36,4,105,69,36,3,3,38,18,20
"2021","West Lancashire 010C","E01025481",692,221,65,156,434,33,162,45,71,46,96,38,48,10,133,86,47,10,10,37,18,19
"2021","West Lancashire 010D","E01025482",629,201,39,162,373,19,135,49,62,24,86,30,51,5,129,94,35,4,4,55,22,33
"2021","West Lancashire 010E","E01025520",521,189,89,100,288,33,116,33,51,32,54,20,28,6,79,52,27,6,6,44,21,23
"2021","West Lancashire 010F","E01025521",640,162,57,105,433,46,170,49,83,38,83,24,51,8,123,81,42,11,11,45,15,30
"2021","West Lancashire 011A","E01025523",691,185,77,108,462,42,208,85,87,36,97,53,38,6,111,79,32,4,4,44,17,27
"2021","West Lancashire 011B","E01025524",761,382,104,278,345,28,113,40,44,29,84,35,40,9,113,71,42,7,7,34,14,20
"2021","West Lancashire 011C","E01025525",647,150,73,77,456,60,213,82,75,56,79,24,45,10,99,62,37,5,5,41,20,21
"2021","West Lancashire 011D","E01025526",796,314,139,175,446,76,163,65,51,47,114,62,46,6,89,60,29,4,4,36,9,27
"2021","West Lancashire 012A","E01025472",562,103,75,28,442,114,257,75,125,57,34,12,19,3,34,13,21,3,3,17,13,4
"2021","West Lancashire 012B","E01025473",599,200,111,89,387,97,186,63,78,45,48,19,27,2,52,25,27,4,4,12,3,9
"2021","West Lancashire 012C","E01025475",611,161,122,39,436,125,239,71,95,73,29,13,15,1,40,18,22,3,3,14,11,3
"2021","West Lancashire 012D","E01025476",626,210,138,72,398,109,208,77,83,48,46,21,21,4,35,17,18,0,0,18,8,10
"2021","West Lancashire 012E","E01025477",481,129,60,69,335,66,189,69,73,47,40,19,19,2,38,21,17,2,2,17,6,11
"2021","West Lancashire 012F","E01025478",501,107,79,28,376,89,218,67,106,45,33,13,18,2,35,17,18,1,1,18,4,14
"2021","West Lancashire 013A","E01025492",515,135,66,69,347,48,153,51,53,49,68,25,37,6,72,39,33,6,6,33,13,20
"2021","West Lancashire 013B","E01025527",674,282,117,165,354,35,132,51,50,31,87,33,48,6,92,61,31,8,8,38,17,21
"2021","West Lancashire 013C","E01025528",772,194,48,146,535,20,214,59,117,38,103,34,58,11,186,144,42,12,12,43,23,20
"2021","West Lancashire 013D","E01025529",740,213,65,148,471,47,206,50,117,39,106,41,58,7,106,70,36,6,6,56,21,35
"2021","West Lancashire 014A","E01025493",661,202,40,162,406,20,91,31,37,23,107,35,66,6,178,128,50,10,10,53,22,31
"2021","West Lancashire 014B","E01025494",786,316,108,208,414,26,139,46,62,31,93,38,50,5,146,99,47,10,10,56,17,39
"2021","West Lancashire 014C","E01025503",539,121,39,82,369,25,117,35,56,26,73,20,48,5,141,102,39,13,13,49,17,32
"2021","West Lancashire 014D","E01025504",476,163,68,95,284,15,87,27,42,18,71,27,36,8,106,70,36,5,5,29,9,20
"2021","West Lancashire 014E","E01025505",644,242,91,151,364,62,170,73,56,41,67,31,33,3,57,31,26,8,8,38,19,19
"2021","West Lancashire 015A","E01025534",685,149,89,60,504,84,282,88,136,58,84,44,36,4,52,35,17,2,2,32,10,22
"2021","West Lancashire 015B","E01025535",678,164,84,80,482,72,266,93,118,55,75,39,29,7,66,35,31,3,3,32,19,13
"2021","West Lancashire 015C","E01025536",654,216,110,106,407,43,185,74,70,41,64,27,27,10,111,80,31,4,4,31,18,13
"2021","West Lancashire 015D","E01025537",723,234,110,124,469,108,223,90,87,46,76,47,23,6,58,26,32,4,4,20,10,10
"2021","West Lancashire 015E","E01025540",498,124,70,54,361,95,201,57,89,55,39,20,16,3,26,10,16,0,0,13,6,7
"2021","Wyre 001A","E01025573",580,165,113,52,387,70,169,72,56,41,76,32,39,5,69,42,27,3,3,28,9,19
"2021","Wyre 001B","E01025574",740,338,154,184,379,55,111,52,29,30,91,44,43,4,122,87,35,0,0,23,8,15
"2021","Wyre 001C","E01025581",612,209,87,122,360,42,155,67,48,40,76,26,44,6,85,60,25,2,2,43,13,30
"2021","Wyre 001D","E01025582",616,268,89,179,319,33,109,47,41,21,71,40,24,7,97,73,24,9,9,29,10,19
"2021","Wyre 001E","E01025583",624,245,74,171,333,29,111,46,39,26,76,36,34,6,111,76,35,6,6,46,14,32
"2021","Wyre 001F","E01025584",887,559,156,403,276,38,92,53,24,15,68,41,25,2,71,39,32,7,7,52,15,37
"2021","Wyre 002A","E01025605",562,137,93,44,413,88,213,92,74,47,59,20,36,3,49,29,20,4,4,12,6,6
"2021","Wyre 002B","E01025606",543,166,70,96,346,25,111,40,43,28,72,20,42,10,130,96,34,8,8,31,18,13
"2021","Wyre 002C","E01025607",639,174,125,49,439,79,227,88,85,54,66,27,32,7,66,39,27,1,1,26,15,11
"2021","Wyre 002D","E01025608",667,181,105,76,459,78,224,82,97,45,76,32,40,4,80,46,34,1,1,27,10,17
"2021","Wyre 003A","E01025590",672,220,103,117,415,39,118,45,45,28,96,35,53,8,154,99,55,8,8,37,22,15
"2021","Wyre 003B","E01025591",746,208,141,67,517,180,217,121,52,44,71,38,30,3,46,15,31,3,3,21,5,16
"2021","Wyre 003C","E01025592",523,149,72,77,350,31,110,32,48,30,64,26,33,5,141,99,42,4,4,24,14,10
"2021","Wyre 003D","E01025593",643,172,133,39,444,159,198,98,56,44,56,23,32,1,29,13,16,2,2,27,9,18
"2021","Wyre 004A","E01025563",515,175,110,65,317,112,147,75,41,31,36,23,9,4,20,11,9,2,2,23,4,19
"2021","Wyre 004B","E01025564",823,248,153,95,546,131,243,97,100,46,83,38,41,4,85,51,34,4,4,29,12,17
"2021","Wyre 004C","E01025565",767,221,132,89,515,127,246,117,100,29,86,38,38,10,52,29,23,4,4,31,16,15
"2021","Wyre 004D","E01025586",722,230,165,65,477,165,216,103,66,47,44,27,16,1,50,31,19,2,2,15,6,9
"2021","Wyre 004E","E01025587",778,238,155,83,512,162,206,115,60,31,79,36,37,6,63,34,29,2,2,28,16,12
"2021","Wyre 004F","E01025588",722,322,208,114,371,131,145,88,24,33,46,27,17,2,46,26,20,3,3,29,9,20
"2021","Wyre 004G","E01025589",499,132,63,69,330,50,164,67,62,35,65,27,33,5,50,37,13,1,1,37,11,26
"2021","Wyre 005A","E01025557",670,176,97,79,462,105,231,115,75,41,67,32,29,6,57,32,25,2,2,32,12,20
"2021","Wyre 005B","E01025575",868,334,141,193,504,51,221,92,104,25,92,36,55,1,133,91,42,7,7,30,14,16
"2021","Wyre 005C","E01025578",643,170,73,97,435,44,181,65,71,45,104,29,62,13,103,69,34,3,3,38,13,25
"2021","Wyre 005D","E01025579",521,126,64,62,370,30,137,40,59,38,68,12,51,5,133,94,39,2,2,25,17,8
"2021","Wyre 005E","E01025580",531,135,85,50,371,92,189,72,78,39,34,15,15,4,54,32,22,2,2,25,9,16
"2021","Wyre 006A","E01025547",921,255,109,146,629,116,330,124,144,62,92,54,36,2,89,54,35,2,2,37,20,17
"2021","Wyre 006B","E01025549",997,250,121,129,713,148,376,152,153,71,110,58,48,4,78,53,25,1,1,34,13,21
"2021","Wyre 006C","E01025609",960,237,118,119,670,132,381,183,142,56,103,60,36,7,53,29,24,1,1,53,21,32
"2021","Wyre 007A","E01025548",843,319,217,102,502,187,220,114,78,28,60,33,25,2,35,16,19,0,0,22,9,13
"2021","Wyre 007B","E01025553",1145,287,135,152,820,147,441,166,196,79,134,68,56,10,93,52,41,5,5,38,20,18
"2021","Wyre 007C","E01025558",809,288,207,81,506,211,210,100,64,46,44,25,16,3,38,13,25,3,3,15,11,4
"2021","Wyre 007D","E01025559",940,334,148,186,574,88,277,116,111,50,119,68,43,8,86,47,39,4,4,32,15,17
"2021","Wyre 007E","E01025560",642,209,171,38,409,164,163,84,51,28,38,25,13,0,42,19,23,2,2,24,10,14
"2021","Wyre 008A","E01025554",750,277,185,92,452,139,168,97,37,34,75,53,17,5,65,30,35,5,5,21,5,16
"2021","Wyre 008B","E01025556",633,181,87,94,415,84,180,60,78,42,76,25,41,10,71,46,25,4,4,37,15,22
"2021","Wyre 008C","E01025570",729,433,205,228,268,84,87,44,25,18,47,34,13,0,48,27,21,2,2,28,11,17
"2021","Wyre 008D","E01025571",605,203,98,105,363,59,148,57,52,39,66,28,33,5,88,61,27,2,2,39,19,20
"2021","Wyre 008E","E01025572",646,222,148,74,390,137,165,83,39,43,41,17,19,5,45,17,28,2,2,34,10,24
"2021","Wyre 008F","E01025604",662,242,131,111,383,65,180,79,55,46,65,33,27,5,70,35,35,3,3,37,20,17
"2021","Wyre 009A","E01025561",650,153,96,57,471,93,254,86,106,62,74,45,26,3,48,20,28,2,2,26,12,14
"2021","Wyre 009B","E01025562",1089,273,155,118,771,150,393,171,150,72,136,76,52,8,87,49,38,5,5,45,25,20
"2021","Wyre 009C","E01025585",1073,224,124,100,787,198,382,168,136,78,111,68,37,6,94,51,43,2,2,62,29,33
"2021","Wyre 010A","E01025542",798,229,130,99,542,120,274,118,97,59,83,43,35,5,64,46,18,1,1,27,12,15
"2021","Wyre 010B","E01025555",688,253,167,86,415,129,176,100,45,31,55,24,24,7,54,26,28,1,1,20,11,9
"2021","Wyre 010C","E01025601",654,176,128,48,461,158,215,96,77,42,51,21,23,7,36,25,11,1,1,17,4,13
"2021","Wyre 010D","E01025602",757,259,110,149,471,80,228,95,89,44,102,59,40,3,58,37,21,3,3,27,9,18
"2021","Wyre 010E","E01025603",706,237,152,85,451,142,202,109,55,38,57,34,19,4,48,29,19,2,2,18,3,15
"2021","Wyre 011A","E01025541",973,241,77,164,687,53,335,108,176,51,175,79,91,5,117,75,42,7,7,45,16,29
"2021","Wyre 011B","E01025543",751,227,87,140,484,50,190,77,88,25,117,60,53,4,121,75,46,6,6,40,22,18
"2021","Wyre 011C","E01025544",719,313,178,135,382,90,166,82,58,26,56,36,18,2,66,30,36,4,4,24,8,16
"2021","Wyre 011D","E01025576",1109,371,198,173,701,152,311,118,132,61,110,53,44,13,124,77,47,4,4,37,19,18
"2021","Wyre 011E","E01025577",658,234,102,132,404,52,155,60,60,35,84,28,48,8,110,64,46,3,3,20,5,15
"2021","Wyre 012A","E01025550",696,202,120,82,468,130,214,91,87,36,69,37,23,9,52,26,26,3,3,26,6,20
"2021","Wyre 012B","E01025552",510,113,57,56,378,82,203,72,91,40,48,27,21,0,45,23,22,0,0,19,8,11
"2021","Wyre 012C","E01025594",724,247,153,94,444,134,204,98,66,40,58,36,19,3,48,25,23,0,0,33,7,26
"2021","Wyre 012D","E01025595",631,157,104,53,454,134,230,94,96,40,60,26,26,8,28,16,12,2,2,20,4,16
"2021","Wyre 012E","E01025596",894,249,119,130,612,113,351,133,159,59,79,33,40,6,68,49,19,1,1,33,13,20
"2021","Wyre 012F","E01025597",487,153,90,63,312,77,130,62,48,20,56,27,23,6,48,30,18,1,1,22,10,12
"2021","Wyre 013A","E01025545",1060,348,188,160,671,162,321,106,153,62,94,57,34,3,92,65,27,2,2,41,21,20
"2021","Wyre 013B","E01025546",764,303,136,167,434,59,190,80,86,24,91,56,34,1,86,60,26,8,8,27,12,15
"2021","Wyre 013C","E01025551",549,155,80,75,380,73,187,89,72,26,55,27,26,2,63,43,20,2,2,14,7,7
"2021","Wyre 013D","E01025567",810,289,148,141,499,108,207,82,78,47,86,54,29,3,94,53,41,4,4,22,10,12
"2021","Wyre 013E","E01025598",771,354,184,170,396,95,149,59,63,27,69,39,26,4,77,42,35,6,6,21,6,15
"2021","Wyre 014A","E01025566",889,238,164,74,621,172,325,149,112,64,69,35,24,10,55,24,31,0,0,30,13,17
"2021","Wyre 014B","E01025568",884,288,149,139,558,100,260,114,101,45,99,54,41,4,95,64,31,4,4,38,17,21
"2021","Wyre 014C","E01025569",922,301,204,97,594,161,265,116,93,56,92,53,33,6,75,42,33,1,1,27,9,18
"2021","Wyre 014D","E01025599",455,119,80,39,324,75,170,73,61,36,44,24,15,5,34,26,8,1,1,12,6,6
"2021","Wyre 014E","E01025600",677,202,114,88,459,91,213,77,98,38,80,52,27,1,72,43,29,3,3,16,8,8
"2021","Bolton 001A","E01004768",613,101,58,43,487,95,290,104,127,59,61,26,30,5,41,27,14,0,0,25,15,10
"2021","Bolton 001B","E01004803",713,202,104,98,494,123,232,64,114,54,85,44,38,3,49,28,21,5,5,17,9,8
"2021","Bolton 001C","E01004804",608,142,92,50,443,110,243,82,120,41,55,24,28,3,33,20,13,2,2,23,8,15
"2021","Bolton 001D","E01004807",580,150,41,109,416,50,240,81,113,46,75,36,35,4,49,31,18,2,2,14,7,7
"2021","Bolton 001E","E01004808",690,182,102,80,492,97,263,86,128,49,74,45,25,4,54,33,21,4,4,16,7,9
"2021","Bolton 002A","E01004788",606,170,127,43,422,126,220,79,88,53,44,17,20,7,32,16,16,0,0,14,3,11
"2021","Bolton 002B","E01004790",644,194,100,94,426,91,171,61,76,34,78,45,32,1,85,54,31,1,1,24,11,13
"2021","Bolton 002C","E01004805",664,149,91,58,500,132,250,94,110,46,69,36,28,5,49,25,24,0,0,15,8,7
"2021","Bolton 002D","E01004806",658,193,122,71,438,105,213,65,103,45,73,33,36,4,47,31,16,0,0,27,13,14
"2021","Bolton 002E","E01004810",634,154,80,74,457,69,280,98,127,55,55,23,29,3,51,31,20,2,2,23,9,14
"2021","Bolton 003A","E01004769",685,230,121,109,435,70,226,82,97,47,94,58,32,4,43,22,21,2,2,20,11,9
"2021","Bolton 003B","E01004770",611,159,107,52,430,103,224,67,116,41,62,33,26,3,38,17,21,3,3,22,18,4
"2021","Bolton 003C","E01004771",628,120,76,44,485,85,287,76,154,57,63,24,36,3,50,31,19,0,0,23,11,12
"2021","Bolton 003D","E01004773",856,310,108,202,507,63,245,88,103,54,109,66,36,7,88,61,27,2,2,39,19,20
"2021","Bolton 003E","E01004809",870,365,161,204,484,48,203,98,69,36,113,64,40,9,117,62,55,3,3,21,12,9
"2021","Bolton 004A","E01004777",789,295,107,188,471,52,192,85,73,34,117,52,56,9,106,64,42,4,4,23,9,14
"2021","Bolton 004B","E01004881",781,384,181,203,381,52,123,57,50,16,100,62,33,5,100,65,35,6,6,16,6,10
"2021","Bolton 004C","E01004888",571,157,64,93,398,54,197,87,59,51,69,37,26,6,75,41,34,3,3,16,10,6
"2021","Bolton 004D","E01004889",633,209,105,104,403,53,171,56,76,39,83,43,34,6,96,62,34,0,0,21,10,11
"2021","Bolton 004E","E01004890",681,268,92,176,394,57,164,60,64,40,98,57,35,6,70,37,33,5,5,19,6,13
"2021","Bolton 005A","E01004766",805,367,186,181,404,64,177,56,88,33,74,35,35,4,88,56,32,1,1,34,14,20
"2021","Bolton 005B","E01004767",850,347,118,229,462,67,224,72,110,42,92,51,35,6,72,42,30,7,7,41,22,19
"2021","Bolton 005C","E01004772",749,213,83,130,504,36,199,59,97,43,99,21,72,6,167,123,44,3,3,32,14,18
"2021","Bolton 005D","E01004774",739,258,91,167,443,27,209,69,101,39,86,38,40,8,118,73,45,3,3,38,20,18
"2021","Bolton 005E","E01004824",495,64,21,43,339,29,242,45,144,53,14,5,7,2,52,33,19,2,2,92,71,21
"2021","Bolton 006A","E01004784",508,107,84,23,388,113,196,78,76,42,44,21,19,4,30,17,13,5,5,13,7,6
"2021","Bolton 006B","E01004785",651,196,105,91,431,76,190,55,89,46,80,30,40,10,83,48,35,2,2,24,14,10
"2021","Bolton 006C","E01004786",686,229,151,78,437,101,200,78,72,50,86,47,34,5,50,21,29,0,0,20,10,10
"2021","Bolton 006D","E01004789",607,139,91,48,449,99,253,96,103,54,60,24,31,5,36,16,20,1,1,19,9,10
"2021","Bolton 006E","E01004791",652,250,163,87,387,89,153,59,62,32,89,50,35,4,56,28,28,0,0,15,3,12
"2021","Bolton 006F","E01004792",640,178,131,47,448,149,221,87,88,46,44,21,18,5,34,16,18,0,0,14,4,10
"2021","Bolton 007A","E01004779",621,118,49,69,477,47,227,73,101,53,100,37,52,11,98,64,34,5,5,26,16,10
"2021","Bolton 007B","E01004781",952,306,89,217,606,72,306,97,158,51,146,91,48,7,81,60,21,1,1,40,17,23
"2021","Bolton 007C","E01004882",626,227,104,123,364,55,167,60,63,44,72,42,24,6,68,34,34,2,2,35,18,17
"2021","Bolton 007D","E01004883",795,232,78,154,541,68,250,105,104,41,131,78,44,9,89,65,24,3,3,22,12,10
"2021","Bolton 007E","E01004884",697,201,118,83,473,130,252,122,79,51,56,38,14,4,33,14,19,2,2,23,10,13
"2021","Bolton 008A","E01004864",680,240,84,156,418,45,195,75,82,38,94,55,34,5,80,42,38,4,4,22,13,9
"2021","Bolton 008B","E01004867",594,176,59,117,382,27,199,43,122,34,59,30,25,4,94,69,25,3,3,36,20,16
"2021","Bolton 008C","E01004921",716,229,106,123,459,60,206,79,89,38,91,33,54,4,97,61,36,5,5,28,20,8
"2021","Bolton 008D","E01004924",622,128,80,48,468,82,275,106,115,54,77,29,42,6,30,15,15,4,4,26,13,13
"2021","Bolton 008E","E01004925",643,166,87,79,443,68,230,78,103,49,81,36,40,5,56,28,28,8,8,34,26,8
"2021","Bolton 009A","E01004778",543,167,101,66,353,93,154,66,54,34,57,27,23,7,47,24,23,2,2,23,6,17
"2021","Bolton 009B","E01004780",978,267,103,164,675,104,321,110,165,46,155,73,64,18,88,59,29,7,7,36,15,21
"2021","Bolton 009C","E01004782",583,183,102,81,372,58,154,54,72,28,91,42,45,4,66,42,24,3,3,28,18,10
"2021","Bolton 009D","E01004783",660,192,96,96,435,86,215,85,91,39,73,37,28,8,56,32,24,5,5,33,12,21
"2021","Bolton 010A","E01004802",756,210,90,120,493,31,185,47,91,47,85,25,54,6,187,136,51,5,5,53,32,21
"2021","Bolton 010B","E01004926",520,128,52,76,355,16,140,39,62,39,61,16,35,10,136,93,43,2,2,37,27,10
"2021","Bolton 010C","E01004927",1049,439,128,311,561,37,189,54,100,35,135,61,67,7,192,142,50,8,8,49,30,19
"2021","Bolton 010D","E01004929",1122,348,116,232,719,40,294,68,174,52,194,88,92,14,186,129,57,5,5,55,24,31
"2021","Bolton 011A","E01004820",621,206,57,149,365,10,199,38,133,28,52,18,30,4,100,75,25,4,4,50,30,20
"2021","Bolton 011B","E01004825",602,180,52,128,343,20,253,40,178,35,20,7,10,3,47,31,16,3,3,79,67,12
"2021","Bolton 011C","E01004826",598,204,70,134,345,13,180,35,119,26,43,17,24,2,105,78,27,4,4,49,35,14
"2021","Bolton 011D","E01004865",738,322,106,216,379,38,166,48,85,33,75,36,36,3,97,55,42,3,3,37,20,17
"2021","Bolton 011E","E01004866",756,276,107,169,412,23,222,48,148,26,58,23,34,1,107,69,38,2,2,68,31,37
"2021","Bolton 012A","E01004840",724,212,107,105,476,93,239,87,103,49,68,36,31,1,70,39,31,6,6,36,16,20
"2021","Bolton 012B","E01004841",656,200,59,141,418,19,139,37,74,28,85,22,48,15,169,127,42,6,6,38,20,18
"2021","Bolton 012C","E01004842",732,230,150,80,485,108,273,62,150,61,62,28,29,5,41,20,21,1,1,17,11,6
"2021","Bolton 012D","E01004919",648,188,97,91,433,88,222,75,110,37,60,29,27,4,60,33,27,3,3,27,15,12
"2021","Bolton 012E","E01004920",662,187,85,102,439,72,190,63,104,23,76,29,37,10,97,63,34,4,4,36,20,16
"2021","Bolton 013A","E01004787",755,272,83,189,460,25,129,44,55,30,115,38,64,13,186,133,53,5,5,23,10,13
"2021","Bolton 013B","E01004793",698,230,81,149,436,41,155,57,63,35,85,24,52,9,150,116,34,5,5,32,14,18
"2021","Bolton 013C","E01004794",721,159,68,91,519,46,183,42,111,30,110,24,78,8,166,122,44,14,14,43,28,15
"2021","Bolton 013D","E01004795",694,283,107,176,387,61,137,55,52,30,83,26,53,4,99,65,34,7,7,24,16,8
"2021","Bolton 013E","E01004797",519,116,54,62,369,28,154,28,70,56,78,21,46,11,104,71,33,5,5,34,19,15
"2021","Bolton 014A","E01004775",929,243,97,146,635,91,338,99,190,49,126,73,49,4,70,42,28,10,10,51,26,25
"2021","Bolton 014B","E01004885",566,120,75,45,425,94,251,81,121,49,49,27,19,3,31,14,17,0,0,21,10,11
"2021","Bolton 014C","E01004886",619,215,79,136,375,52,147,43,62,42,80,42,31,7,89,55,34,7,7,29,15,14
"2021","Bolton 014D","E01004887",609,194,90,104,387,70,169,65,56,48,67,29,30,8,76,50,26,5,5,28,15,13
"2021","Bolton 015A","E01004868",725,198,47,151,461,24,270,55,154,61,56,22,32,2,89,57,32,22,22,66,41,25
"2021","Bolton 015B","E01004869",827,288,104,184,491,42,224,43,153,28,76,32,41,3,131,99,32,18,18,48,28,20
"2021","Bolton 015C","E01004870",754,336,70,266,318,40,188,47,106,35,31,19,9,3,51,33,18,8,8,100,49,51
"2021","Bolton 015D","E01004871",509,120,34,86,295,14,183,28,126,29,30,16,10,4,61,47,14,7,7,94,70,24
"2021","Bolton 015E","E01004922",883,266,99,167,545,42,260,55,154,51,95,47,39,9,137,98,39,11,11,72,39,33
"2021","Bolton 016B","E01004822",610,206,79,127,340,15,232,36,154,42,25,9,13,3,65,36,29,3,3,64,42,22
"2021","Bolton 016C","E01004823",861,368,111,257,442,25,219,61,130,28,56,28,23,5,136,88,48,6,6,51,29,22
"2021","Bolton 016D","E01004848",778,401,123,278,328,10,140,36,87,17,47,24,19,4,122,54,68,9,9,49,31,18
"2021","Bolton 016E","E01033217",645,356,94,262,252,11,105,31,62,12,62,43,14,5,60,30,30,14,14,37,11,26
"2021","Bolton 016F","E01033220",741,444,76,368,261,14,116,34,70,12,49,40,7,2,68,38,30,14,14,36,15,21
"2021","Bolton 017A","E01004818",687,295,61,234,324,20,130,34,71,25,62,36,22,4,108,81,27,4,4,68,41,27
"2021","Bolton 017B","E01004819",600,196,92,104,363,50,171,56,69,46,70,43,23,4,70,42,28,2,2,41,20,21
"2021","Bolton 017C","E01004928",681,275,85,190,365,33,118,44,50,24,89,52,33,4,117,89,28,8,8,41,14,27
"2021","Bolton 017D","E01004930",630,148,77,71,452,84,196,83,73,40,98,33,56,9,73,40,33,1,1,30,16,14
"2021","Bolton 017E","E01004931",744,309,176,133,404,59,146,57,59,30,84,40,37,7,112,72,40,3,3,31,15,16
"2021","Bolton 017F","E01004932",723,290,73,217,397,35,146,58,60,28,107,62,36,9,102,65,37,7,7,36,16,20
"2021","Bolton 018A","E01004834",580,154,62,92,384,22,218,42,147,29,49,21,23,5,88,66,22,7,7,42,26,16
"2021","Bolton 018B","E01004838",653,181,51,130,409,30,201,40,127,34,59,22,33,4,114,87,27,5,5,63,49,14
"2021","Bolton 018C","E01004843",625,162,81,81,431,73,246,77,121,48,61,33,23,5,50,31,19,1,1,32,17,15
"2021","Bolton 018D","E01004845",714,199,83,116,473,72,282,70,150,62,49,22,23,4,67,41,26,3,3,42,25,17
"2021","Bolton 018E","E01004923",634,191,58,133,383,29,194,48,100,46,74,43,29,2,79,51,28,7,7,60,39,21
"2021","Bolton 019A","E01004796",669,208,83,125,431,59,208,65,84,59,93,42,45,6,67,42,25,4,4,30,16,14
"2021","Bolton 019B","E01004798",665,209,94,115,428,46,160,53,55,52,102,32,65,5,111,93,18,9,9,28,14,14
"2021","Bolton 019C","E01004799",581,169,108,61,390,116,182,89,55,38,46,18,22,6,42,23,19,4,4,22,17,5
"2021","Bolton 019D","E01004800",534,117,63,54,389,75,201,81,75,45,59,18,31,10,52,22,30,2,2,28,14,14
"2021","Bolton 019E","E01004801",662,197,52,145,424,22,128,39,53,36,90,23,58,9,178,124,54,6,6,41,28,13
"2021","Bolton 019F","E01004917",954,264,103,161,646,80,257,83,127,47,131,60,67,4,177,119,58,1,1,44,23,21
"2021","Bolton 020A","E01004835",558,151,89,62,358,91,203,56,96,51,18,10,7,1,41,20,21,5,5,49,34,15
"2021","Bolton 020B","E01004836",604,144,94,50,413,95,218,54,121,43,42,29,11,2,52,29,23,6,6,47,32,15
"2021","Bolton 020C","E01004837",595,116,84,32,449,100,279,98,114,67,31,10,15,6,36,15,21,3,3,30,17,13
"2021","Bolton 020D","E01004844",617,118,73,45,467,131,273,83,136,54,30,17,12,1,32,16,16,1,1,32,23,9
"2021","Bolton 020E","E01004897",456,144,61,83,291,62,132,51,52,29,56,31,21,4,40,25,15,1,1,21,10,11
"2021","Bolton 021A","E01004827",673,190,66,124,434,22,232,46,157,29,54,22,30,2,115,81,34,11,11,49,32,17
"2021","Bolton 021B","E01004849",498,92,31,61,350,24,211,32,137,42,29,5,24,0,75,38,37,11,11,56,42,14
"2021","Bolton 021C","E01004850",773,271,54,217,425,29,223,51,145,27,48,20,24,4,95,50,45,30,30,77,54,23
"2021","Bolton 021D","E01004851",625,228,99,129,327,28,199,51,108,40,19,10,8,1,69,38,31,12,12,70,39,31
"2021","Bolton 021E","E01004853",496,116,46,70,332,12,222,44,135,43,31,16,11,4,63,35,28,4,4,48,33,15
"2021","Bolton 022A","E01004811",651,230,97,133,358,22,174,43,108,23,60,37,22,1,94,65,29,8,8,63,51,12
"2021","Bolton 022B","E01004812",683,151,30,121,421,16,228,36,164,28,63,34,27,2,97,53,44,17,17,111,83,28
"2021","Bolton 022C","E01004813",522,108,43,65,355,31,177,29,113,35,46,23,22,1,93,71,22,8,8,59,44,15
"2021","Bolton 022D","E01004815",567,139,62,77,373,29,234,48,156,30,38,18,16,4,69,40,29,3,3,55,42,13
"2021","Bolton 022E","E01004817",971,479,116,363,428,61,202,80,81,41,93,64,26,3,59,33,26,13,13,64,20,44
"2021","Bolton 023A","E01004828",630,144,48,96,413,18,264,50,182,32,27,11,15,1,97,62,35,7,7,73,39,34
"2021","Bolton 023B","E01004829",480,120,29,91,311,12,208,41,119,48,28,12,14,2,56,32,24,7,7,49,34,15
"2021","Bolton 023C","E01004832",637,173,68,105,425,36,211,66,116,29,61,21,34,6,110,70,40,7,7,39,27,12
"2021","Bolton 023D","E01004854",467,74,24,50,333,19,238,30,150,58,15,1,11,3,57,30,27,4,4,60,39,21
"2021","Bolton 023E","E01004878",548,120,57,63,367,34,219,40,134,45,41,15,23,3,69,38,31,4,4,61,44,17
"2021","Bolton 024A","E01004911",722,283,102,181,400,64,147,56,61,30,77,30,39,8,112,87,25,0,0,39,14,25
"2021","Bolton 024B","E01004912",650,183,115,68,451,132,200,73,83,44,62,33,26,3,54,22,32,3,3,16,11,5
"2021","Bolton 024C","E01004913",781,219,81,138,518,38,246,70,132,44,106,34,63,9,122,67,55,6,6,44,17,27
"2021","Bolton 024D","E01004914",518,140,105,35,360,116,159,53,60,46,48,16,30,2,36,14,22,1,1,18,9,9
"2021","Bolton 024E","E01004915",530,117,85,32,386,95,185,78,60,47,61,23,29,9,41,19,22,4,4,27,14,13
"2021","Bolton 024F","E01004916",672,244,125,119,393,64,146,50,56,40,69,24,39,6,110,64,46,4,4,35,12,23
"2021","Bolton 024G","E01004918",514,118,79,39,370,83,187,67,71,49,55,22,31,2,43,20,23,2,2,26,7,19
"2021","Bolton 025A","E01004846",491,155,56,99,294,19,161,28,113,20,37,16,19,2,74,52,22,3,3,42,28,14
"2021","Bolton 025B","E01004847",654,114,34,80,479,16,284,43,208,33,49,12,30,7,126,88,38,4,4,61,46,15
"2021","Bolton 025C","E01004852",489,78,31,47,339,19,234,35,150,49,16,6,9,1,65,36,29,5,5,72,42,30
"2021","Bolton 025D","E01004877",667,208,113,95,412,23,241,39,177,25,35,8,20,7,111,60,51,2,2,47,37,10
"2021","Bolton 025E","E01004879",534,143,55,88,344,19,189,38,126,25,46,17,25,4,86,56,30,4,4,47,30,17
"2021","Bolton 026A","E01004830",729,266,107,159,417,46,191,46,114,31,66,28,31,7,104,71,33,10,10,46,31,15
"2021","Bolton 026B","E01004831",645,149,62,87,452,49,270,69,147,54,57,23,30,4,74,46,28,2,2,44,28,16
"2021","Bolton 026C","E01004833",644,181,83,98,434,82,237,80,94,63,64,28,28,8,48,20,28,3,3,29,18,11
"2021","Bolton 026D","E01004839",961,378,162,216,533,38,246,58,150,38,87,34,45,8,153,109,44,9,9,50,34,16
"2021","Bolton 027A","E01004814",561,160,41,119,341,33,163,34,97,32,66,34,26,6,75,43,32,4,4,60,37,23
"2021","Bolton 027B","E01004855",623,190,52,138,395,37,156,57,72,27,93,48,39,6,104,74,30,5,5,38,26,12
"2021","Bolton 027C","E01004856",636,221,74,147,373,28,160,42,96,22,76,35,36,5,105,71,34,4,4,42,20,22
"2021","Bolton 027D","E01004857",662,184,50,134,416,26,159,45,88,26,101,39,59,3,126,80,46,4,4,62,41,21
"2021","Bolton 028A","E01004891",740,271,143,128,442,109,210,83,75,52,70,35,31,4,50,18,32,3,3,27,17,10
"2021","Bolton 028B","E01004893",639,160,123,37,444,95,257,99,100,58,56,23,31,2,35,12,23,1,1,35,17,18
"2021","Bolton 028C","E01004894",850,266,131,135,556,74,238,81,112,45,129,59,62,8,108,63,45,7,7,28,15,13
"2021","Bolton 028E","E01004901",772,213,98,115,542,101,317,123,109,85,72,32,32,8,48,22,26,4,4,17,5,12
"2021","Bolton 028F","E01033218",630,151,34,117,458,41,213,63,119,31,115,55,54,6,88,67,21,1,1,21,8,13
"2021","Bolton 028G","E01033219",597,130,65,65,446,94,242,87,111,44,72,41,27,4,37,24,13,1,1,21,7,14
"2021","Bolton 029A","E01004816",597,92,58,34,346,24,230,37,155,38,29,5,20,4,59,29,30,4,4,159,142,17
"2021","Bolton 029B","E01004872",611,139,48,91,412,30,186,48,105,33,81,26,46,9,110,68,42,5,5,60,31,29
"2021","Bolton 029C","E01004873",622,145,62,83,419,19,242,44,156,42,53,11,38,4,100,59,41,5,5,58,37,21
"2021","Bolton 029D","E01004875",655,160,98,62,460,70,197,62,89,46,90,34,46,10,98,67,31,5,5,35,23,12
"2021","Bolton 029E","E01004880",502,95,46,49,354,54,222,54,126,42,37,15,18,4,40,23,17,1,1,53,31,22
"2021","Bolton 030A","E01004892",711,217,142,75,467,126,225,74,99,52,61,34,22,5,52,22,30,3,3,27,14,13
"2021","Bolton 030B","E01004896",546,122,100,22,410,128,211,80,79,52,43,16,20,7,27,8,19,1,1,14,8,6
"2021","Bolton 030C","E01004899",619,156,78,78,427,53,225,66,117,42,68,32,28,8,78,47,31,3,3,36,13,23
"2021","Bolton 030D","E01004900",624,154,42,112,432,38,248,63,140,45,76,37,32,7,68,48,20,2,2,38,22,16
"2021","Bolton 031A","E01004776",825,276,91,185,519,52,222,79,92,51,118,65,48,5,121,81,40,6,6,30,11,19
"2021","Bolton 031B","E01004895",603,198,124,74,379,52,170,72,58,40,76,30,40,6,78,43,35,3,3,26,14,12
"2021","Bolton 031C","E01004936",1012,362,133,229,612,82,277,108,122,47,153,96,53,4,95,56,39,5,5,38,13,25
"2021","Bolton 031D","E01004938",628,203,107,96,391,36,156,45,75,36,72,19,43,10,125,79,46,2,2,34,19,15
"2021","Bolton 031E","E01004939",708,212,69,143,471,80,204,89,72,43,90,36,45,9,93,66,27,4,4,25,16,9
"2021","Bolton 032A","E01004858",712,268,91,177,411,42,153,55,61,37,101,41,53,7,108,57,51,7,7,33,18,15
"2021","Bolton 032B","E01004859",698,349,124,225,316,24,106,42,42,22,78,34,40,4,104,67,37,4,4,33,23,10
"2021","Bolton 032C","E01004860",683,240,102,138,405,57,143,55,52,36,92,37,44,11,109,68,41,4,4,38,12,26
"2021","Bolton 032D","E01004902",880,358,116,242,485,71,170,59,79,32,131,76,51,4,108,74,34,5,5,37,16,21
"2021","Bolton 032E","E01004906",888,416,196,220,437,50,160,61,65,34,109,54,46,9,113,66,47,5,5,35,16,19
"2021","Bolton 033A","E01004861",664,128,25,103,471,15,182,55,107,20,117,44,61,12,156,116,40,1,1,65,46,19
"2021","Bolton 033B","E01004862",588,195,71,124,362,37,116,40,49,27,89,22,50,17,119,86,33,1,1,31,17,14
"2021","Bolton 033C","E01004863",642,212,72,140,387,23,143,40,67,36,75,28,41,6,142,93,49,4,4,43,27,16
"2021","Bolton 033D","E01004874",660,136,64,72,475,54,200,55,101,44,95,34,52,9,121,77,44,5,5,49,28,21
"2021","Bolton 033E","E01004876",785,226,107,119,514,39,227,56,127,44,98,37,53,8,142,94,48,8,8,45,23,22
"2021","Bolton 034A","E01004903",580,138,59,79,424,51,231,71,102,58,91,35,47,9,49,30,19,2,2,18,9,9
"2021","Bolton 034B","E01004904",738,231,100,131,469,47,229,83,93,53,111,54,52,5,79,52,27,3,3,38,21,17
"2021","Bolton 034C","E01004905",673,220,86,134,413,37,152,56,53,43,113,43,60,10,108,72,36,3,3,40,22,18
"2021","Bolton 034D","E01004907",546,175,69,106,341,17,113,39,51,23,87,22,56,9,116,81,35,8,8,30,14,16
"2021","Bolton 034E","E01004908",559,160,100,60,382,82,163,59,60,44,72,24,41,7,60,35,25,5,5,17,8,9
"2021","Bolton 034F","E01004909",641,254,151,103,361,57,150,51,67,32,76,29,39,8,76,47,29,2,2,26,13,13
"2021","Bolton 034G","E01004910",928,337,93,244,546,71,220,77,99,44,148,56,86,6,104,68,36,3,3,45,21,24
"2021","Bolton 035A","E01004933",575,161,69,92,390,51,195,74,67,54,94,49,40,5,50,30,20,0,0,24,16,8
"2021","Bolton 035B","E01004934",552,107,32,75,422,42,237,85,101,51,70,18,44,8,69,46,23,4,4,23,9,14
"2021","Bolton 035C","E01004935",749,197,81,116,521,42,286,84,148,54,105,53,46,6,86,51,35,2,2,31,19,12
"2021","Bolton 035D","E01004937",623,108,52,56,486,58,299,94,141,64,79,39,33,7,49,24,25,1,1,29,16,13
"2021","Bolton 035E","E01004940",606,134,80,54,448,88,223,98,74,51,68,29,33,6,69,40,29,0,0,24,17,7
"2021","Bury 001A","E01005014",758,311,137,174,429,101,173,78,76,19,94,64,26,4,60,37,23,1,1,18,8,10
"2021","Bury 001B","E01005015",687,240,111,129,412,56,162,67,68,27,99,54,37,8,93,60,33,2,2,35,13,22
"2021","Bury 001C","E01005016",711,243,76,167,446,49,217,92,100,25,118,74,37,7,60,40,20,2,2,22,8,14
"2021","Bury 001D","E01005017",777,210,115,95,542,78,272,75,148,49,103,52,43,8,86,51,35,3,3,25,14,11
"2021","Bury 001E","E01005018",723,253,85,168,450,52,170,54,86,30,104,56,43,5,120,85,35,4,4,20,11,9
"2021","Bury 001F","E01005021",420,101,62,39,301,63,169,54,84,31,41,20,18,3,28,12,16,0,0,18,9,9
"2021","Bury 002A","E01005019",628,142,87,55,460,104,230,83,102,45,60,32,25,3,66,38,28,0,0,26,10,16
"2021","Bury 002B","E01005023",546,157,100,57,381,99,187,55,82,50,48,19,21,8,46,21,25,1,1,8,1,7
"2021","Bury 002C","E01005046",679,215,175,40,443,158,211,62,116,33,39,18,17,4,30,12,18,5,5,21,6,15
"2021","Bury 002D","E01005048",663,104,72,32,537,166,296,102,137,57,42,15,26,1,30,20,10,3,3,22,10,12
"2021","Bury 003A","E01005020",506,62,28,34,432,55,296,103,128,65,48,20,23,5,32,17,15,1,1,12,3,9
"2021","Bury 003B","E01005022",633,169,62,107,443,77,245,82,115,48,66,31,30,5,55,35,20,0,0,21,11,10
"2021","Bury 003C","E01005047",592,130,89,41,447,103,254,110,99,45,54,28,19,7,32,18,14,4,4,15,5,10
"2021","Bury 003D","E01005049",752,242,134,108,487,95,230,84,98,48,88,45,35,8,71,47,24,3,3,23,7,16
"2021","Bury 003E","E01005051",695,246,107,139,434,55,238,103,93,42,78,40,32,6,60,33,27,3,3,15,4,11
"2021","Bury 004A","E01004976",641,196,83,113,410,52,165,66,71,28,77,35,36,6,109,57,52,7,7,35,20,15
"2021","Bury 004B","E01004977",789,311,163,148,452,73,200,78,84,38,100,54,42,4,76,48,28,3,3,26,10,16
"2021","Bury 004C","E01004978",661,163,68,95,430,39,233,72,122,39,69,36,30,3,84,55,29,5,5,68,33,35
"2021","Bury 004D","E01004981",623,183,87,96,408,73,197,75,81,41,81,41,33,7,56,32,24,1,1,32,12,20
"2021","Bury 004E","E01004982",655,181,110,71,452,105,229,89,82,58,66,39,26,1,48,22,26,4,4,22,14,8
"2021","Bury 005A","E01004961",629,202,87,115,405,59,171,55,78,38,78,30,45,3,93,60,33,4,4,22,12,10
"2021","Bury 005B","E01004965",506,111,77,34,376,101,208,74,93,41,37,12,24,1,29,14,15,1,1,19,8,11
"2021","Bury 005C","E01004966",722,187,88,99,493,53,203,55,106,42,82,29,44,9,148,101,47,7,7,42,19,23
"2021","Bury 005D","E01004967",465,92,68,24,342,95,181,65,77,39,35,11,23,1,31,12,19,0,0,31,18,13
"2021","Bury 006A","E01004963",694,227,118,109,453,92,205,74,80,51,82,45,29,8,71,46,25,3,3,14,5,9
"2021","Bury 006B","E01004968",614,150,85,65,445,81,252,86,112,54,72,36,33,3,38,16,22,2,2,19,11,8
"2021","Bury 006C","E01005050",853,212,96,116,609,57,313,97,169,47,125,51,64,10,114,74,40,0,0,32,13,19
"2021","Bury 006D","E01005052",581,125,74,51,443,104,230,64,103,63,63,19,43,1,46,20,26,0,0,13,9,4
"2021","Bury 006E","E01005053",634,159,67,92,450,65,197,73,87,37,90,40,41,9,93,53,40,5,5,25,8,17
"2021","Bury 007A","E01004954",646,201,110,91,410,87,187,73,72,42,71,38,22,11,63,32,31,2,2,35,17,18
"2021","Bury 007B","E01004955",550,159,55,104,358,34,161,58,68,35,77,28,38,11,76,42,34,10,10,33,14,19
"2021","Bury 007C","E01004956",783,301,117,184,434,41,191,56,98,37,73,31,38,4,117,81,36,12,12,48,24,24
"2021","Bury 007D","E01004957",792,276,78,198,481,26,188,50,106,32,93,40,41,12,165,113,52,9,9,35,21,14
"2021","Bury 007E","E01004960",654,204,46,158,418,13,145,39,86,20,80,20,51,9,172,138,34,8,8,32,17,15
"2021","Bury 008A","E01004958",689,270,82,188,382,19,141,47,70,24,89,44,33,12,125,83,42,8,8,37,22,15
"2021","Bury 008B","E01004959",728,246,78,168,439,36,195,60,102,33,94,44,37,13,106,71,35,8,8,43,19,24
"2021","Bury 008C","E01004979",672,219,44,175,382,24,173,40,95,38,62,29,29,4,113,78,35,10,10,71,47,24
"2021","Bury 008D","E01004980",642,258,69,189,343,14,135,47,64,24,78,53,22,3,108,71,37,8,8,41,23,18
"2021","Bury 008E","E01005024",995,365,61,304,517,12,268,75,168,25,126,93,33,0,97,52,45,14,14,113,65,48
"2021","Bury 008F","E01005026",648,133,32,101,417,20,257,52,181,24,46,23,20,3,86,57,29,8,8,98,74,24
"2021","Bury 009A","E01004947",660,229,41,188,396,34,142,44,77,21,91,45,40,6,127,90,37,2,2,35,17,18
"2021","Bury 009B","E01004948",837,350,132,218,447,43,210,65,105,40,78,39,35,4,112,75,37,4,4,40,12,28
"2021","Bury 009C","E01004962",834,240,78,162,556,46,254,65,147,42,136,73,51,12,117,88,29,3,3,38,18,20
"2021","Bury 009D","E01004964",839,315,98,217,492,52,177,63,78,36,140,73,56,11,119,86,33,4,4,32,15,17
"2021","Bury 010A","E01004949",582,133,86,47,436,118,241,65,126,50,40,17,18,5,37,17,20,0,0,13,6,7
"2021","Bury 010B","E01004950",617,143,102,41,456,136,244,72,111,61,44,21,19,4,32,22,10,0,0,18,10,8
"2021","Bury 010C","E01004951",646,158,117,41,459,118,245,97,101,47,54,24,28,2,39,18,21,3,3,29,15,14
"2021","Bury 010D","E01004952",616,174,141,33,427,158,206,82,79,45,33,15,15,3,29,10,19,1,1,15,9,6
"2021","Bury 010E","E01004953",631,167,116,51,444,87,249,69,127,53,54,30,21,3,53,24,29,1,1,20,8,12
"2021","Bury 011A","E01005025",716,228,90,138,445,51,227,83,101,43,97,56,34,7,66,37,29,4,4,43,30,13
"2021","Bury 011B","E01005027",687,241,80,161,373,31,191,45,107,39,71,36,30,5,71,35,36,9,9,73,39,34
"2021","Bury 011C","E01005028",830,259,91,168,503,29,237,54,142,41,91,44,41,6,141,98,43,5,5,68,50,18
"2021","Bury 011D","E01005029",635,159,74,85,396,36,240,45,148,47,42,21,20,1,69,46,23,9,9,80,52,28
"2021","Bury 012A","E01005000",588,126,51,75,442,65,264,101,94,69,62,32,23,7,50,25,25,1,1,20,11,9
"2021","Bury 012B","E01005001",497,91,31,60,384,58,233,82,96,55,61,22,36,3,29,15,14,3,3,22,10,12
"2021","Bury 012C","E01005005",623,181,95,86,421,75,203,80,76,47,82,35,39,8,59,35,24,2,2,21,8,13
"2021","Bury 012D","E01005006",810,174,83,91,603,84,288,93,139,56,126,55,63,8,97,55,42,8,8,33,13,20
"2021","Bury 013A","E01005030",789,333,117,216,422,31,177,57,90,30,77,40,34,3,129,92,37,8,8,34,24,10
"2021","Bury 013B","E01005054",705,233,119,114,447,67,205,72,90,43,87,49,32,6,87,49,38,1,1,25,14,11
"2021","Bury 013C","E01005059",723,230,85,145,447,53,234,77,124,33,69,29,33,7,84,54,30,7,7,46,24,22
"2021","Bury 013D","E01005060",731,240,112,128,438,77,211,71,106,34,80,40,35,5,69,39,30,1,1,53,26,27
"2021","Bury 014A","E01004997",619,174,59,115,408,41,171,64,68,39,81,32,43,6,108,61,47,7,7,37,17,20
"2021","Bury 014B","E01004998",738,224,123,101,491,92,211,84,93,34,110,56,49,5,72,51,21,6,6,23,9,14
"2021","Bury 014C","E01004999",597,147,78,69,418,55,201,67,72,62,85,38,43,4,72,40,32,5,5,32,15,17
"2021","Bury 014D","E01005002",644,172,97,75,443,83,204,84,71,49,79,34,37,8,73,46,27,4,4,29,19,10
"2021","Bury 014E","E01005003",680,257,118,139,402,44,144,42,66,36,96,39,54,3,116,85,31,2,2,21,8,13
"2021","Bury 015A","E01004991",598,192,74,118,367,40,144,46,66,32,82,38,36,8,100,72,28,1,1,39,17,22
"2021","Bury 015B","E01004992",634,214,83,131,396,37,152,51,70,31,101,44,49,8,103,80,23,3,3,24,12,12
"2021","Bury 015C","E01004993",783,202,83,119,552,34,280,79,143,58,132,51,69,12,102,62,40,4,4,29,13,16
"2021","Bury 015D","E01004994",678,274,77,197,389,35,133,57,53,23,100,50,44,6,118,94,24,3,3,15,7,8
"2021","Bury 016A","E01004990",667,215,101,114,422,50,156,50,69,37,108,43,57,8,104,68,36,4,4,30,16,14
"2021","Bury 016B","E01004996",753,363,91,272,365,36,114,38,59,17,81,47,31,3,123,87,36,11,11,25,13,12
"2021","Bury 016C","E01005004",858,462,146,316,368,45,124,58,43,23,76,26,44,6,113,84,29,10,10,28,11,17
"2021","Bury 016D","E01005008",949,357,101,256,540,22,204,71,100,33,124,53,59,12,181,139,42,9,9,52,21,31
"2021","Bury 016E","E01005009",859,379,60,319,437,36,134,47,66,21,101,53,40,8,153,112,41,13,13,43,12,31
"2021","Bury 017A","E01004945",645,195,128,67,414,86,214,63,96,55,59,30,26,3,54,23,31,1,1,36,20,16
"2021","Bury 017B","E01005055",589,138,84,54,415,78,236,67,112,57,49,28,21,0,51,25,26,1,1,36,16,20
"2021","Bury 017C","E01005056",602,216,121,95,364,97,162,50,69,43,54,33,17,4,47,25,22,4,4,22,14,8
"2021","Bury 017D","E01005057",667,160,71,89,482,62,238,81,105,52,71,39,28,4,105,64,41,6,6,25,15,10
"2021","Bury 017E","E01005058",494,92,60,32,380,75,225,61,112,52,43,14,26,3,36,15,21,1,1,22,14,8
"2021","Bury 018A","E01004995",648,180,111,69,435,125,204,82,73,49,66,26,34,6,34,17,17,6,6,33,17,16
"2021","Bury 018B","E01005010",652,158,64,94,460,61,219,74,90,55,105,49,41,15,74,42,32,1,1,34,18,16
"2021","Bury 018C","E01005012",778,267,69,198,474,43,179,60,89,30,100,45,48,7,144,97,47,8,8,37,18,19
"2021","Bury 018D","E01005013",1017,257,69,188,709,31,276,77,158,41,185,82,83,20,211,163,48,6,6,51,24,27
"2021","Bury 019A","E01004984",573,163,109,54,384,85,228,67,123,38,32,22,8,2,38,18,20,1,1,26,10,16
"2021","Bury 019B","E01004985",592,136,82,54,433,132,249,72,127,50,14,6,8,0,38,18,20,0,0,23,10,13
"2021","Bury 019C","E01004989",568,147,76,71,398,83,221,66,113,42,57,28,25,4,34,20,14,3,3,23,7,16
"2021","Bury 019D","E01005007",700,244,131,113,432,88,195,92,66,37,98,55,35,8,48,27,21,3,3,24,8,16
"2021","Bury 019E","E01005011",598,150,73,77,427,61,210,60,110,40,103,67,32,4,50,25,25,3,3,21,9,12
"2021","Bury 020A","E01004983",569,167,58,109,373,27,201,66,97,38,80,51,21,8,54,35,19,11,11,29,13,16
"2021","Bury 020B","E01004986",819,321,125,196,459,66,181,66,85,30,114,79,32,3,95,61,34,3,3,39,13,26
"2021","Bury 020C","E01004987",660,348,147,201,278,27,119,39,61,19,46,16,26,4,81,50,31,5,5,34,12,22
"2021","Bury 020D","E01004988",629,206,90,116,393,45,180,64,82,34,88,57,27,4,73,40,33,7,7,30,14,16
"2021","Bury 021A","E01004941",757,233,114,119,483,37,213,56,105,52,108,45,58,5,123,90,33,2,2,41,21,20
"2021","Bury 021B","E01004942",636,188,77,111,404,12,139,33,85,21,74,28,37,9,179,136,43,0,0,44,25,19
"2021","Bury 021C","E01004943",709,157,47,110,509,42,235,67,131,37,115,60,48,7,111,80,31,6,6,43,23,20
"2021","Bury 021D","E01004944",629,145,73,72,448,62,241,87,107,47,78,50,24,4,63,33,30,4,4,36,18,18
"2021","Bury 021E","E01004946",778,304,119,185,435,22,110,38,46,26,87,27,53,7,207,130,77,9,9,39,17,22
"2021","Bury 022A","E01004969",707,296,113,183,371,45,196,75,80,41,68,41,24,3,55,30,25,7,7,40,19,21
"2021","Bury 022B","E01004970",607,117,63,54,452,76,235,62,121,52,84,33,45,6,53,29,24,4,4,38,20,18
"2021","Bury 022C","E01004971",604,153,89,64,424,81,225,56,122,47,71,35,29,7,42,18,24,5,5,27,12,15
"2021","Bury 022D","E01005034",714,227,103,124,446,45,221,71,117,33,121,78,42,1,54,32,22,5,5,41,16,25
"2021","Bury 023A","E01004972",570,146,61,85,377,26,145,34,82,29,79,37,31,11,125,73,52,2,2,47,22,25
"2021","Bury 023B","E01004973",652,179,79,100,449,42,232,80,114,38,110,66,35,9,60,30,30,5,5,24,10,14
"2021","Bury 023C","E01004975",769,321,120,201,411,23,146,57,67,22,149,109,36,4,86,59,27,7,7,37,12,25
"2021","Bury 023D","E01005039",686,253,113,140,403,47,143,48,69,26,101,59,34,8,108,67,41,4,4,30,15,15
"2021","Bury 023E","E01005045",725,246,134,112,440,43,221,77,103,41,106,70,31,5,62,28,34,8,8,39,16,23
"2021","Bury 024A","E01004974",601,164,78,86,399,64,209,73,103,33,68,44,21,3,57,29,28,1,1,38,14,24
"2021","Bury 024B","E01005033",593,170,69,101,394,60,261,67,163,31,38,21,15,2,34,15,19,1,1,29,14,15
"2021","Bury 024C","E01005036",1067,542,190,352,475,55,222,92,99,31,110,80,26,4,84,37,47,4,4,50,13,37
"2021","Bury 024D","E01005037",630,188,89,99,400,56,216,76,101,39,80,46,30,4,46,29,17,2,2,42,20,22
"2021","Bury 025A","E01005031",637,195,67,128,409,34,181,56,88,37,88,30,45,13,106,68,38,0,0,33,22,11
"2021","Bury 025B","E01005032",558,230,78,152,298,24,118,27,76,15,61,33,26,2,90,60,30,5,5,30,11,19
"2021","Bury 025C","E01005035",656,205,72,133,417,39,201,66,108,27,118,75,35,8,57,32,25,2,2,34,10,24
"2021","Bury 025D","E01005038",527,110,64,46,392,63,218,62,112,44,61,29,25,7,48,24,24,2,2,25,11,14
"2021","Bury 026A","E01005040",691,186,64,122,448,50,274,67,157,50,66,40,18,8,57,32,25,1,1,57,31,26
"2021","Bury 026B","E01005041",523,60,34,26,410,53,274,55,166,53,25,6,15,4,54,32,22,4,4,53,28,25
"2021","Bury 026C","E01005042",611,132,72,60,436,56,292,60,190,42,31,19,9,3,56,28,28,1,1,43,22,21
"2021","Bury 026D","E01005043",490,75,38,37,381,48,284,31,219,34,16,8,6,2,29,15,14,4,4,34,26,8
"2021","Bury 026E","E01005044",473,106,38,68,322,23,238,18,203,17,18,11,5,2,37,19,18,6,6,45,27,18
"2021","Manchester 001A","E01005098",765,329,108,221,399,40,109,41,52,16,87,34,38,15,151,86,65,12,12,37,18,19
"2021","Manchester 001B","E01005099",692,182,72,110,458,17,172,39,107,26,63,13,45,5,202,146,56,4,4,52,28,24
"2021","Manchester 001C","E01005100",656,181,85,96,435,46,175,61,73,41,80,26,43,11,128,85,43,6,6,40,22,18
"2021","Manchester 001D","E01005102",623,202,68,134,379,45,142,48,55,39,74,28,42,4,116,73,43,2,2,42,13,29
"2021","Manchester 001E","E01005103",862,383,188,195,435,37,145,42,69,34,68,22,37,9,179,116,63,6,6,44,26,18
"2021","Manchester 002A","E01005101",724,212,87,125,452,36,155,39,80,36,90,30,41,19,163,105,58,8,8,60,34,26
"2021","Manchester 002B","E01005135",658,166,66,100,428,20,173,45,82,46,73,13,49,11,151,99,52,11,11,64,44,20
"2021","Manchester 002C","E01005136",613,198,68,130,362,39,176,59,70,47,67,30,29,8,75,46,29,5,5,53,23,30
"2021","Manchester 002D","E01005138",994,320,84,236,610,19,244,69,143,32,130,57,66,7,206,157,49,11,11,64,45,19
"2021","Manchester 002F","E01034107",595,200,39,161,344,16,139,47,78,14,81,42,34,5,96,73,23,12,12,51,23,28
"2021","Manchester 002G","E01034108",789,204,51,153,519,32,260,70,156,34,90,45,38,7,132,100,32,5,5,66,37,29
"2021","Manchester 003B","E01005139",769,188,86,102,525,37,221,61,107,53,105,42,52,11,153,99,54,9,9,56,32,24
"2021","Manchester 003C","E01005141",793,320,110,210,429,21,168,31,104,33,74,17,48,9,162,115,47,4,4,44,28,16
"2021","Manchester 003D","E01005251",645,159,53,106,444,23,151,45,73,33,87,25,51,11,172,113,59,11,11,42,19,23
"2021","Manchester 003E","E01005252",764,236,107,129,462,44,181,47,90,44,74,28,38,8,151,81,70,12,12,66,36,30
"2021","Manchester 003F","E01033685",630,199,63,136,382,23,190,59,106,25,63,29,31,3,100,66,34,6,6,49,26,23
"2021","Manchester 003G","E01033687",763,458,182,276,279,45,108,50,37,21,44,19,21,4,75,46,29,7,7,26,10,16
"2021","Manchester 004A","E01005104",821,289,53,236,467,30,174,41,111,22,89,49,35,5,150,106,44,24,24,65,38,27
"2021","Manchester 004B","E01005160",705,226,76,150,395,33,215,44,128,43,44,23,17,4,99,55,44,4,4,84,57,27
"2021","Manchester 004C","E01005161",660,150,53,97,458,57,230,60,140,30,58,22,32,4,108,77,31,5,5,52,38,14
"2021","Manchester 004D","E01005162",655,225,103,122,373,30,256,50,153,53,26,13,10,3,56,25,31,5,5,57,34,23
"2021","Manchester 004E","E01005163",652,234,90,144,358,43,215,44,133,38,40,19,21,0,57,39,18,3,3,60,43,17
"2021","Manchester 005A","E01005247",621,199,91,108,382,57,156,47,65,44,62,36,21,5,102,53,49,5,5,40,19,21
"2021","Manchester 005B","E01005248",586,172,86,86,376,77,171,62,56,53,60,28,28,4,62,27,35,6,6,38,19,19
"2021","Manchester 005C","E01005249",905,283,111,172,554,36,257,89,126,42,114,51,54,9,130,94,36,17,17,68,27,41
"2021","Manchester 005D","E01005250",761,194,84,110,518,35,197,38,110,49,84,21,52,11,193,149,44,9,9,49,29,20
"2021","Manchester 005E","E01005253",624,141,67,74,422,27,139,39,69,31,75,29,36,10,169,107,62,12,12,61,25,36
"2021","Manchester 005F","E01005254",705,219,76,143,449,44,194,63,80,51,103,41,53,9,104,63,41,4,4,37,11,26
"2021","Manchester 006A","E01005164",785,255,48,207,446,9,259,46,188,25,49,24,21,4,115,75,40,14,14,84,54,30
"2021","Manchester 006B","E01005205",877,328,121,207,477,18,147,38,97,12,88,39,38,11,214,157,57,10,10,72,42,30
"2021","Manchester 006C","E01005206",725,235,69,166,423,31,188,64,90,34,59,28,26,5,130,103,27,15,15,67,43,24
"2021","Manchester 006D","E01005207",780,229,65,164,486,27,183,45,107,31,73,24,44,5,182,147,35,21,21,65,31,34
"2021","Manchester 007A","E01005223",606,171,39,132,374,28,168,37,91,40,57,25,27,5,109,76,33,12,12,61,36,25
"2021","Manchester 007B","E01005224",758,183,50,133,487,11,194,42,116,36,64,24,32,8,202,166,36,16,16,88,47,41
"2021","Manchester 007C","E01005225",856,270,107,163,521,40,176,53,80,43,70,33,32,5,224,166,58,11,11,65,39,26
"2021","Manchester 007D","E01005226",697,194,56,138,440,14,172,32,106,34,67,20,43,4,179,145,34,8,8,63,39,24
"2021","Manchester 007E","E01005229",606,157,75,82,411,60,194,73,64,57,78,23,47,8,71,45,26,8,8,38,23,15
"2021","Manchester 008A","E01005145",777,137,34,103,514,15,366,41,280,45,27,15,12,0,90,53,37,16,16,126,88,38
"2021","Manchester 008C","E01005149",504,64,29,35,328,14,237,11,187,39,12,5,7,0,59,24,35,6,6,112,92,20
"2021","Manchester 008D","E01005165",885,406,147,259,402,12,244,59,158,27,53,33,17,3,73,43,30,20,20,77,45,32
"2021","Manchester 008E","E01005166",706,258,82,176,362,14,224,33,157,34,30,17,12,1,80,38,42,14,14,86,56,30
"2021","Manchester 008F","E01005167",632,115,28,87,411,6,261,38,187,36,38,19,18,1,97,50,47,9,9,106,81,25
"2021","Manchester 008G","E01034109",426,104,43,61,244,16,154,19,111,24,19,7,11,1,45,25,20,10,10,78,61,17
"2021","Manchester 008H","E01034110",483,113,25,88,308,6,163,25,115,23,49,21,26,2,81,61,20,9,9,62,39,23
"2021","Manchester 009A","E01005202",857,268,84,184,492,20,153,34,97,22,66,27,32,7,242,165,77,11,11,97,71,26
"2021","Manchester 009B","E01005203",861,343,68,275,450,21,144,31,90,23,71,23,39,9,200,136,64,14,14,68,32,36
"2021","Manchester 009D","E01005227",741,213,56,157,459,19,184,38,121,25,63,14,42,7,185,135,50,8,8,69,38,31
"2021","Manchester 009E","E01005228",892,288,106,182,549,15,185,42,120,23,86,32,44,10,247,179,68,16,16,55,33,22
"2021","Manchester 009F","E01033678",652,232,44,188,368,15,156,30,107,19,50,12,32,6,134,95,39,13,13,52,29,23
"2021","Manchester 009G","E01033679",578,235,67,168,297,12,115,31,60,24,40,13,22,5,120,72,48,10,10,46,34,12
"2021","Manchester 011A","E01005256",1049,364,104,260,601,27,219,64,117,38,108,40,54,14,218,150,68,29,29,84,41,43
"2021","Manchester 011B","E01005257",805,275,77,198,478,20,150,52,70,28,100,35,57,8,199,152,47,9,9,52,24,28
"2021","Manchester 011C","E01005258",779,322,109,213,419,24,140,47,63,30,79,34,32,13,168,126,42,8,8,38,18,20
"2021","Manchester 011D","E01005259",755,302,95,207,397,20,113,36,55,22,62,18,42,2,195,146,49,7,7,56,34,22
"2021","Manchester 011E","E01005260",593,194,73,121,362,47,161,55,65,41,67,23,36,8,80,55,25,7,7,37,19,18
"2021","Manchester 012A","E01005093",679,216,91,125,422,27,154,34,90,30,72,21,49,2,157,104,53,12,12,41,20,21
"2021","Manchester 012B","E01005094",664,221,65,156,390,22,134,31,79,24,44,12,26,6,176,125,51,14,14,53,32,21
"2021","Manchester 012C","E01005097",650,129,42,87,463,23,151,19,106,26,67,22,37,8,213,142,71,9,9,58,30,28
"2021","Manchester 012D","E01005255",778,383,116,267,343,25,108,33,60,15,61,29,22,10,140,95,45,9,9,52,29,23
"2021","Manchester 012E","E01005261",674,204,62,142,414,14,140,27,84,29,76,34,34,8,178,122,56,6,6,56,36,20
"2021","Manchester 015A","E01005092",781,253,82,171,479,20,157,29,113,15,89,50,37,2,200,146,54,13,13,49,27,22
"2021","Manchester 015C","E01005105",1130,305,52,253,686,19,361,95,235,31,113,62,45,6,169,121,48,24,24,139,46,93
"2021","Manchester 015D","E01005106",902,264,68,196,517,29,183,35,115,33,96,42,48,6,186,136,50,23,23,121,59,62
"2021","Manchester 015E","E01005107",744,240,69,171,429,16,162,39,95,28,66,23,40,3,179,130,49,6,6,75,37,38
"2021","Manchester 015F","E01033668",597,259,21,238,274,9,102,43,52,7,97,83,11,3,55,34,21,11,11,64,10,54
"2021","Manchester 015G","E01033669",649,270,77,193,323,26,94,33,40,21,65,33,25,7,125,82,43,13,13,56,29,27
"2021","Manchester 017D","E01005189",802,357,134,223,397,26,134,44,76,14,56,27,25,4,167,108,59,14,14,48,24,24
"2021","Manchester 017E","E01005190",938,287,91,196,577,25,232,53,138,41,96,31,52,13,202,165,37,22,22,74,36,38
"2021","Manchester 017G","E01034111",559,140,44,96,381,23,137,23,98,16,63,19,38,6,146,95,51,12,12,38,23,15
"2021","Manchester 017H","E01034112",734,233,66,167,432,21,171,50,90,31,71,31,39,1,142,107,35,27,27,69,35,34
"2021","Manchester 017I","E01034113",565,158,49,109,347,12,123,29,71,23,60,23,34,3,135,100,35,17,17,60,23,37
"2021","Manchester 017J","E01034114",728,231,69,162,415,16,196,59,106,31,88,49,31,8,106,71,35,9,9,82,42,40
"2021","Manchester 018A","E01005061",656,210,54,156,387,10,158,22,115,21,49,25,20,4,157,101,56,13,13,59,26,33
"2021","Manchester 018C","E01005063",762,246,52,194,441,10,235,30,180,25,48,22,20,6,136,75,61,12,12,75,29,46
"2021","Manchester 018D","E01005065",798,258,48,210,445,8,189,45,123,21,54,31,17,6,172,109,63,22,22,95,34,61
"2021","Manchester 018E","E01005066",509,260,24,236,186,3,75,19,46,10,45,28,14,3,44,28,16,19,19,63,13,50
"2021","Manchester 018F","E01034115",421,130,32,98,207,8,98,20,63,15,22,9,10,3,58,35,23,21,21,84,13,71
"2021","Manchester 018G","E01034116",416,108,34,74,189,6,103,16,77,10,34,26,7,1,37,23,14,9,9,119,18,101
"2021","Manchester 019A","E01005208",1100,379,49,330,505,2,194,62,117,15,149,115,31,3,131,84,47,29,29,216,19,197
"2021","Manchester 019C","E01005210",447,221,39,182,178,3,65,15,42,8,24,17,6,1,69,42,27,17,17,48,12,36
"2021","Manchester 019D","E01005214",986,296,23,273,426,5,179,61,109,9,104,90,12,2,105,62,43,33,33,264,37,227
"2021","Manchester 019E","E01034117",473,188,15,173,175,1,86,37,47,2,39,35,4,0,21,13,8,28,28,110,7,103
"2021","Manchester 019F","E01034118",457,228,44,184,183,3,64,15,41,8,19,8,7,4,75,45,30,22,22,46,20,26
"2021","Manchester 020A","E01005067",807,287,55,232,448,10,217,44,147,26,62,34,25,3,142,101,41,17,17,72,40,32
"2021","Manchester 020B","E01005186",1051,308,77,231,654,22,308,71,174,63,120,45,64,11,188,126,62,16,16,89,47,42
"2021","Manchester 020C","E01005232",707,247,76,171,394,18,230,35,170,25,36,23,13,0,85,49,36,25,25,66,41,25
"2021","Manchester 020D","E01005235",716,211,65,146,437,14,231,45,163,23,37,12,20,5,141,89,52,14,14,68,47,21
"2021","Manchester 020E","E01005239",630,213,52,161,354,6,153,17,115,21,30,9,13,8,154,93,61,11,11,63,33,30
"2021","Manchester 021A","E01005187",835,214,54,160,552,23,178,31,111,36,98,32,60,6,233,195,38,20,20,69,28,41
"2021","Manchester 021B","E01005188",727,184,68,116,487,44,213,57,105,51,90,25,56,9,128,84,44,12,12,56,23,33
"2021","Manchester 021C","E01005191",796,280,93,187,473,23,159,35,101,23,71,29,35,7,209,166,43,11,11,43,18,25
"2021","Manchester 021D","E01005192",681,221,57,164,394,31,191,62,83,46,72,31,31,10,87,62,25,13,13,66,37,29
"2021","Manchester 021E","E01005193",803,310,84,226,447,31,156,50,80,26,102,52,42,8,140,109,31,18,18,46,17,29
"2021","Manchester 022B","E01005230",766,296,41,255,290,10,148,37,94,17,45,36,5,4,66,38,28,21,21,180,50,130
"2021","Manchester 022C","E01005231",695,268,30,238,191,7,84,28,47,9,60,53,6,1,22,11,11,18,18,236,15,221
"2021","Manchester 022D","E01005236",696,197,41,156,319,6,208,23,162,23,28,13,13,2,62,39,23,15,15,180,57,123
"2021","Manchester 022E","E01005237",526,110,20,90,290,6,206,28,136,42,13,4,9,0,50,24,26,15,15,126,87,39
"2021","Manchester 022H","E01034119",766,270,39,231,327,6,166,31,112,23,44,32,10,2,87,46,41,24,24,169,27,142
"2021","Manchester 023A","E01005195",879,239,81,158,575,22,233,44,158,31,94,27,56,11,215,150,65,11,11,65,44,21
"2021","Manchester 023C","E01005197",700,282,98,184,346,18,130,32,74,24,67,31,27,9,116,80,36,15,15,72,33,39
"2021","Manchester 023D","E01005198",710,226,76,150,415,19,210,30,145,35,58,17,32,9,120,72,48,8,8,69,46,23
"2021","Manchester 023E","E01005201",786,211,58,153,485,9,177,33,133,11,63,24,34,5,215,174,41,21,21,90,38,52
"2021","Manchester 023F","E01034120",596,175,61,114,366,17,145,14,113,18,52,12,31,9,142,105,37,10,10,55,36,19
"2021","Manchester 023G","E01034121",449,83,13,70,321,3,164,25,126,13,55,18,34,3,86,65,21,13,13,45,33,12
"2021","Manchester 024B","E01005243",1146,417,108,309,579,9,231,47,163,21,80,56,22,2,236,118,118,23,23,150,66,84
"2021","Manchester 024C","E01005245",962,305,127,178,543,15,208,27,160,21,50,25,22,3,238,150,88,32,32,114,58,56
"2021","Manchester 024D","E01005246",754,199,57,142,452,4,198,23,161,14,23,10,10,3,189,136,53,38,38,103,62,41
"2021","Manchester 024E","E01034122",628,156,22,134,362,4,169,22,129,18,46,33,12,1,123,94,29,20,20,110,34,76
"2021","Manchester 024F","E01034123",634,240,69,171,323,10,136,20,105,11,54,26,26,2,109,78,31,14,14,71,34,37
"2021","Manchester 025C","E01005244",812,226,58,168,311,11,128,22,89,17,40,29,11,0,106,75,31,26,26,275,26,249
"2021","Manchester 025D","E01005285",511,176,42,134,237,5,125,14,98,13,14,6,6,2,64,38,26,29,29,98,30,68
"2021","Manchester 025E","E01005288",676,205,33,172,255,4,117,24,83,10,34,23,8,3,77,50,27,23,23,216,19,197
"2021","Manchester 025F","E01034124",557,153,37,116,318,5,131,26,96,9,18,7,11,0,155,116,39,9,9,86,29,57
"2021","Manchester 025G","E01034125",550,126,20,106,320,3,159,22,129,8,39,26,11,2,111,89,22,8,8,104,21,83
"2021","Manchester 025H","E01034126",608,142,23,119,390,7,188,27,150,11,76,44,30,2,102,74,28,17,17,76,21,55
"2021","Manchester 025I","E01034127",583,194,38,156,292,13,106,15,82,9,81,59,20,2,74,53,21,18,18,97,15,82
"2021","Manchester 026A","E01005280",535,89,44,45,311,15,198,18,134,46,15,5,10,0,74,40,34,9,9,135,96,39
"2021","Manchester 026B","E01005281",532,284,68,216,164,7,67,39,22,6,64,62,2,0,16,8,8,10,10,84,4,80
"2021","Manchester 026C","E01005284",657,269,30,239,227,3,111,48,52,11,51,44,7,0,43,19,24,19,19,161,14,147
"2021","Manchester 026D","E01005286",763,233,30,203,259,17,142,41,81,20,56,48,8,0,32,15,17,12,12,271,16,255
"2021","Manchester 026E","E01005287",655,164,48,116,346,14,217,30,149,38,19,9,10,0,84,44,40,12,12,145,98,47
"2021","Manchester 028A","E01005297",949,344,46,298,463,20,217,53,130,34,126,96,27,3,85,44,41,15,15,142,46,96
"2021","Manchester 028B","E01005298",627,158,37,121,372,18,200,46,131,23,89,52,35,2,59,35,24,6,6,97,42,55
"2021","Manchester 028C","E01005302",1000,456,66,390,435,12,182,54,109,19,132,104,28,0,95,72,23,14,14,109,22,87
"2021","Manchester 028E","E01033680",672,346,40,306,251,3,112,46,61,5,83,65,17,1,40,24,16,13,13,75,12,63
"2021","Manchester 028F","E01033686",649,332,61,271,255,14,113,33,67,13,71,39,26,6,51,34,17,6,6,62,17,45
"2021","Manchester 029A","E01005150",843,390,71,319,323,8,101,34,62,5,173,148,21,4,28,16,12,13,13,130,6,124
"2021","Manchester 029B","E01005151",700,340,94,246,312,23,146,52,78,16,101,78,22,1,38,22,16,4,4,48,13,35
"2021","Manchester 029C","E01005152",585,149,58,91,400,22,228,62,141,25,111,64,44,3,34,15,19,5,5,36,3,33
"2021","Manchester 029D","E01005159",682,198,71,127,382,36,178,60,99,19,109,77,26,6,48,29,19,11,11,102,11,91
"2021","Manchester 029E","E01005296",626,197,74,123,343,38,176,56,88,32,84,62,19,3,39,23,16,6,6,86,34,52
"2021","Manchester 029F","E01005299",545,124,53,71,326,17,178,43,96,39,66,47,18,1,58,27,31,7,7,95,44,51
"2021","Manchester 030A","E01005178",741,193,68,125,422,13,190,39,122,29,72,49,17,6,137,75,62,10,10,126,38,88
"2021","Manchester 030B","E01005179",920,402,52,350,412,23,211,64,115,32,95,68,23,4,74,49,25,9,9,106,44,62
"2021","Manchester 030C","E01005180",763,264,89,175,419,18,194,33,126,35,47,27,14,6,147,89,58,13,13,80,37,43
"2021","Manchester 030D","E01005181",687,199,38,161,367,28,213,38,143,32,49,35,11,3,71,47,24,6,6,121,67,54
"2021","Manchester 030E","E01005182",470,98,43,55,303,13,146,20,89,37,26,9,16,1,112,59,53,6,6,69,40,29
"2021","Manchester 030F","E01005183",647,190,67,123,387,20,173,27,97,49,43,18,15,10,137,67,70,14,14,70,38,32
"2021","Manchester 031A","E01005219",924,363,79,284,423,6,208,58,121,29,126,85,38,3,70,44,26,13,13,138,39,99
"2021","Manchester 031B","E01005220",743,205,47,158,456,14,241,53,167,21,112,75,35,2,83,48,35,6,6,82,39,43
"2021","Manchester 031C","E01005221",871,229,47,182,497,10,264,58,176,30,112,73,33,6,92,58,34,19,19,145,61,84
"2021","Manchester 031D","E01005222",912,349,85,264,492,15,203,39,139,25,135,93,38,4,122,73,49,17,17,71,27,44
"2021","Manchester 032A","E01005184",778,209,31,178,296,10,157,39,103,15,61,40,19,2,48,20,28,20,20,273,27,246
"2021","Manchester 032B","E01005185",515,112,11,101,89,0,24,11,11,2,21,14,5,2,22,12,10,22,22,314,7,307
"2021","Manchester 032C","E01005271",619,207,35,172,158,14,61,30,27,4,48,40,8,0,22,12,10,13,13,254,7,247
"2021","Manchester 032F","E01034128",891,137,44,93,379,11,217,47,128,42,58,37,12,9,74,40,34,19,19,375,56,319
"2021","Manchester 033A","E01005154",656,229,47,182,333,12,153,58,78,17,128,101,23,4,33,20,13,7,7,94,15,79
"2021","Manchester 033B","E01005156",627,163,52,111,388,21,173,49,102,22,143,95,45,3,46,22,24,5,5,76,13,63
"2021","Manchester 033C","E01005158",697,283,107,176,347,35,146,46,83,17,104,68,32,4,55,33,22,7,7,67,22,45
"2021","Manchester 033D","E01005300",485,83,45,38,319,24,195,31,104,60,41,18,21,2,55,27,28,4,4,83,45,38
"2021","Manchester 033E","E01005301",590,199,45,154,314,35,164,35,92,37,79,55,21,3,30,14,16,6,6,77,25,52
"2021","Manchester 034A","E01005118",477,98,59,39,328,45,199,40,95,64,31,18,12,1,50,26,24,3,3,51,35,16
"2021","Manchester 034B","E01005120",668,163,65,98,431,31,223,43,134,46,76,45,24,7,95,58,37,6,6,74,38,36
"2021","Manchester 034C","E01005215",731,182,55,127,479,31,245,48,161,36,89,41,40,8,102,53,49,12,12,70,37,33
"2021","Manchester 034D","E01005216",610,155,50,105,388,28,190,67,93,30,96,62,34,0,68,39,29,6,6,67,23,44
"2021","Manchester 034E","E01005217",700,176,108,68,446,52,257,45,168,44,72,41,23,8,60,33,27,5,5,78,40,38
"2021","Manchester 034F","E01005218",629,215,110,105,280,21,158,35,95,28,45,33,11,1,52,26,26,4,4,134,33,101
"2021","Manchester 035A","E01005270",685,192,60,132,417,21,159,39,83,37,75,48,21,6,149,95,54,13,13,76,27,49
"2021","Manchester 035B","E01005272",809,283,113,170,474,18,147,37,86,24,85,37,34,14,202,107,95,22,22,52,25,27
"2021","Manchester 035C","E01005273",593,181,35,146,188,5,57,21,28,8,59,47,11,1,60,33,27,7,7,224,7,217
"2021","Manchester 035D","E01005278",537,85,39,46,269,10,152,24,86,42,34,19,12,3,65,27,38,8,8,183,30,153
"2021","Manchester 035E","E01005279",816,214,60,154,508,24,224,45,131,48,70,43,23,4,168,105,63,22,22,94,39,55
"2021","Manchester 036A","E01005305",586,108,48,60,355,37,189,47,105,37,79,55,22,2,45,21,24,5,5,123,22,101
"2021","Manchester 036B","E01005309",950,389,92,297,255,16,70,25,37,8,107,101,6,0,27,15,12,35,35,306,9,297
"2021","Manchester 036C","E01005310",585,99,36,63,214,9,67,19,39,9,38,19,14,5,84,59,25,16,16,272,20,252
"2021","Manchester 036D","E01005311",659,179,46,133,309,21,129,29,81,19,95,71,22,2,50,23,27,14,14,171,18,153
"2021","Manchester 036E","E01005312",646,240,71,169,129,11,32,12,16,4,43,40,2,1,21,9,12,22,22,277,4,273
"2021","Manchester 037A","E01005082",751,245,99,146,446,20,172,53,95,24,117,79,34,4,128,59,69,9,9,60,32,28
"2021","Manchester 037B","E01005153",782,309,100,209,418,17,177,85,75,17,159,133,22,4,63,39,24,2,2,55,6,49
"2021","Manchester 037C","E01005155",667,223,78,145,397,22,199,79,103,17,145,106,38,1,27,20,7,4,4,47,5,42
"2021","Manchester 037D","E01005157",597,130,65,65,430,46,258,80,130,48,87,42,42,3,39,25,14,0,0,37,17,20
"2021","Manchester 038A","E01005274",695,199,62,137,362,28,138,35,82,21,85,70,11,4,100,50,50,11,11,134,22,112
"2021","Manchester 038B","E01005275",801,338,37,301,305,16,113,43,60,10,148,131,17,0,20,15,5,8,8,158,7,151
"2021","Manchester 038C","E01005276",616,214,35,179,268,14,114,39,65,10,108,97,8,3,25,16,9,7,7,134,7,127
"2021","Manchester 038D","E01005277",782,279,45,234,408,35,216,78,120,18,124,107,14,3,27,18,9,6,6,95,13,82
"2021","Manchester 039A","E01005076",740,349,45,304,306,12,82,30,45,7,180,162,16,2,22,14,8,10,10,85,2,83
"2021","Manchester 039C","E01005081",775,301,75,226,420,9,154,37,88,29,78,41,34,3,170,102,68,9,9,54,27,27
"2021","Manchester 039D","E01005083",955,445,49,396,398,13,164,74,86,4,189,170,18,1,23,15,8,9,9,112,8,104
"2021","Manchester 039E","E01033670",784,318,18,300,387,2,124,49,68,7,233,219,14,0,16,12,4,12,12,79,6,73
"2021","Manchester 039F","E01033671",828,269,40,229,441,15,181,82,93,6,219,188,28,3,24,15,9,2,2,118,6,112
"2021","Manchester 040A","E01005125",612,183,65,118,360,23,153,29,94,30,64,32,27,5,112,65,47,8,8,69,30,39
"2021","Manchester 040B","E01005304",665,214,53,161,260,10,134,39,78,17,74,53,19,2,29,14,15,13,13,191,9,182
"2021","Manchester 040C","E01005306",723,246,81,165,411,59,241,89,124,28,73,57,13,3,31,15,16,7,7,66,9,57
"2021","Manchester 040D","E01005307",716,199,71,128,330,36,153,39,83,31,102,80,16,6,30,16,14,9,9,187,14,173
"2021","Manchester 040E","E01005308",619,143,58,85,400,24,175,59,93,23,76,39,31,6,119,70,49,6,6,76,19,57
"2021","Manchester 041A","E01005119",670,203,78,125,417,25,159,35,100,24,70,32,26,12,160,93,67,3,3,50,32,18
"2021","Manchester 041B","E01005121",604,156,59,97,383,13,152,28,86,38,64,27,26,11,145,85,60,9,9,65,43,22
"2021","Manchester 041C","E01005122",642,162,78,84,406,13,188,34,124,30,53,21,25,7,148,89,59,4,4,74,50,24
"2021","Manchester 041D","E01005123",614,126,39,87,434,15,178,22,124,32,60,22,25,13,174,95,79,7,7,54,29,25
"2021","Manchester 041E","E01005124",670,156,54,102,453,19,183,44,104,35,76,27,42,7,171,103,68,4,4,61,38,23
"2021","Manchester 042A","E01005077",630,191,47,144,395,12,142,37,84,21,72,30,33,9,167,110,57,2,2,44,21,23
"2021","Manchester 042B","E01005078",832,426,105,321,347,17,126,68,52,6,170,160,7,3,27,16,11,7,7,59,5,54
"2021","Manchester 042C","E01005079",638,176,72,104,404,29,180,54,104,22,97,60,33,4,92,44,48,6,6,58,26,32
"2021","Manchester 042D","E01005084",859,249,76,173,535,35,191,49,113,29,151,98,43,10,136,82,54,22,22,75,24,51
"2021","Manchester 043A","E01005172",796,371,121,250,366,50,173,61,93,19,124,106,13,5,16,7,9,3,3,59,9,50
"2021","Manchester 043B","E01005173",720,231,89,142,424,57,238,82,130,26,96,70,24,2,29,18,11,4,4,65,8,57
"2021","Manchester 043C","E01005174",617,175,64,111,408,53,268,67,174,27,58,29,28,1,28,12,16,1,1,34,7,27
"2021","Manchester 043D","E01005175",688,211,77,134,424,40,208,60,127,21,110,75,30,5,57,27,30,9,9,53,9,44
"2021","Manchester 043E","E01005176",894,337,81,256,466,36,148,64,70,14,229,205,23,1,45,32,13,8,8,91,4,87
"2021","Manchester 043F","E01005177",619,227,112,115,359,47,184,61,100,23,91,63,25,3,31,14,17,6,6,33,3,30
"2021","Manchester 044A","E01005115",785,246,102,144,484,49,214,59,115,40,100,42,51,7,115,69,46,6,6,55,19,36
"2021","Manchester 044B","E01005262",851,340,96,244,474,25,186,74,89,23,113,70,42,1,141,93,48,9,9,37,13,24
"2021","Manchester 044C","E01005264",616,176,61,115,387,19,168,42,86,40,58,21,27,10,135,82,53,7,7,53,22,31
"2021","Manchester 044D","E01005265",700,195,72,123,455,38,158,48,83,27,81,32,43,6,168,119,49,10,10,50,27,23
"2021","Manchester 044E","E01005266",831,232,96,136,538,27,191,53,106,32,121,60,56,5,198,135,63,1,1,61,23,38
"2021","Manchester 045A","E01005126",803,242,105,137,494,44,243,64,132,47,126,89,33,4,72,38,34,9,9,67,34,33
"2021","Manchester 045B","E01005168",521,119,57,62,366,50,222,44,136,42,52,22,24,6,38,16,22,4,4,36,14,22
"2021","Manchester 045C","E01005169",598,172,68,104,400,53,221,76,105,40,78,56,18,4,43,22,21,5,5,26,9,17
"2021","Manchester 045D","E01005170",579,117,60,57,420,51,225,58,129,38,92,57,31,4,46,26,20,6,6,42,15,27
"2021","Manchester 045E","E01005171",701,187,63,124,445,35,225,76,123,26,115,82,29,4,60,24,36,10,10,69,23,46
"2021","Manchester 046A","E01005263",802,356,132,224,386,27,179,61,88,30,94,43,47,4,79,45,34,7,7,60,18,42
"2021","Manchester 046B","E01005267",649,179,86,93,410,57,181,51,91,39,87,49,33,5,82,42,40,3,3,60,18,42
"2021","Manchester 046C","E01005268",1071,428,154,274,577,62,256,92,127,37,175,127,44,4,70,41,29,14,14,66,16,50
"2021","Manchester 046D","E01005269",615,170,98,72,388,59,217,75,92,50,57,23,23,11,51,21,30,4,4,57,25,32
"2021","Manchester 047A","E01005069",654,219,74,145,420,62,196,76,81,39,81,36,40,5,77,45,32,4,4,15,7,8
"2021","Manchester 047B","E01005111",607,175,61,114,405,27,136,37,71,28,98,40,48,10,137,82,55,7,7,27,13,14
"2021","Manchester 047C","E01005113",810,354,92,262,429,18,128,46,53,29,90,32,47,11,184,132,52,9,9,27,16,11
"2021","Manchester 047D","E01005114",819,303,171,132,460,114,210,71,100,39,68,41,21,6,64,29,35,4,4,56,24,32
"2021","Manchester 047E","E01005116",993,372,130,242,574,54,224,78,112,34,151,89,53,9,135,90,45,10,10,47,16,31
"2021","Manchester 048A","E01005071",736,249,65,184,432,28,181,58,83,40,75,22,45,8,136,95,41,12,12,55,25,30
"2021","Manchester 048B","E01005072",859,375,108,267,436,11,170,50,92,28,113,67,44,2,134,88,46,8,8,48,15,33
"2021","Manchester 048C","E01005073",612,149,57,92,422,63,215,64,84,67,78,31,42,5,63,36,27,3,3,41,19,22
"2021","Manchester 048D","E01005112",674,181,75,106,449,35,189,58,88,43,84,37,41,6,136,96,40,5,5,44,30,14
"2021","Manchester 048E","E01005117",973,388,80,308,522,20,198,41,128,29,99,34,57,8,187,131,56,18,18,63,40,23
"2021","Manchester 049A","E01005085",601,138,38,100,404,9,136,33,79,24,76,29,43,4,178,133,45,5,5,59,37,22
"2021","Manchester 049B","E01005086",702,171,61,110,478,35,149,29,85,35,99,27,65,7,182,137,45,13,13,53,35,18
"2021","Manchester 049C","E01005089",696,174,54,120,452,22,143,26,88,29,99,23,66,10,176,133,43,12,12,70,34,36
"2021","Manchester 049D","E01005289",782,337,163,174,389,49,112,39,55,18,74,22,42,10,151,103,48,3,3,56,35,21
"2021","Manchester 049E","E01005295",1139,382,76,306,673,34,287,98,147,42,180,117,59,4,157,105,52,15,15,84,33,51
"2021","Manchester 050A","E01005087",801,156,44,112,559,19,173,35,103,35,125,56,62,7,231,182,49,11,11,86,56,30
"2021","Manchester 050B","E01005088",728,181,63,118,482,22,145,38,73,34,84,25,52,7,214,156,58,17,17,65,38,27
"2021","Manchester 050C","E01005090",861,354,114,240,469,26,129,36,76,17,112,57,50,5,187,149,38,15,15,38,18,20
"2021","Manchester 050D","E01005091",875,206,70,136,596,19,216,38,148,30,116,39,63,14,239,179,60,6,6,73,38,35
"2021","Manchester 050E","E01005291",680,293,111,182,337,22,110,30,53,27,59,22,31,6,139,94,45,7,7,50,24,26
"2021","Manchester 051A","E01005068",721,237,92,145,435,23,145,43,70,32,98,38,52,8,156,99,57,13,13,49,16,33
"2021","Manchester 051B","E01005070",802,311,101,210,419,21,159,55,74,30,87,34,39,14,141,101,40,11,11,72,28,44
"2021","Manchester 051C","E01005074",642,184,73,111,415,25,156,47,66,43,77,25,37,15,151,99,52,6,6,43,23,20
"2021","Manchester 051D","E01005075",675,239,95,144,395,33,140,45,62,33,84,32,40,12,127,80,47,11,11,41,22,19
"2021","Manchester 051E","E01005319",898,223,88,135,579,34,186,47,99,40,132,55,70,7,213,135,78,14,14,96,46,50
"2021","Manchester 052A","E01005290",686,221,73,148,406,27,139,40,65,34,81,19,55,7,153,92,61,6,6,59,24,35
"2021","Manchester 052B","E01005292",667,238,87,151,390,23,109,34,56,19,84,26,48,10,165,106,59,9,9,39,18,21
"2021","Manchester 052C","E01005293",512,144,59,85,351,43,170,72,61,37,80,37,35,8,55,34,21,3,3,17,7,10
"2021","Manchester 052D","E01005294",639,170,79,91,408,57,211,64,85,62,69,35,26,8,62,34,28,9,9,61,32,29
"2021","Manchester 052E","E01005317",920,326,97,229,530,41,177,60,82,35,106,58,41,7,181,117,64,25,25,64,29,35
"2021","Manchester 053A","E01005313",601,159,62,97,396,21,118,39,55,24,96,30,52,14,152,95,57,9,9,46,24,22
"2021","Manchester 053B","E01005314",638,157,67,90,416,20,134,36,58,40,80,22,49,9,171,114,57,11,11,65,41,24
"2021","Manchester 053C","E01005315",815,321,122,199,438,44,130,50,57,23,87,29,46,12,161,113,48,16,16,56,21,35
"2021","Manchester 053D","E01005316",690,220,52,168,403,26,168,53,88,27,86,36,43,7,114,75,39,9,9,67,34,33
"2021","Manchester 053E","E01005318",786,214,81,133,497,20,171,49,82,40,128,50,66,12,168,120,48,10,10,75,27,48
"2021","Manchester 054A","E01005130",733,342,62,280,329,12,102,35,54,13,79,59,17,3,118,75,43,18,18,62,16,46
"2021","Manchester 054B","E01033651",957,363,8,355,358,0,89,48,30,11,222,215,7,0,13,5,8,34,34,236,4,232
"2021","Manchester 054C","E01033658",711,363,9,354,252,6,75,60,15,0,135,130,4,1,12,7,5,24,24,96,3,93
"2021","Manchester 054D","E01033664",1079,500,4,496,357,0,96,41,54,1,213,200,13,0,24,7,17,24,24,222,1,221
"2021","Manchester 054E","E01033667",880,389,18,371,310,3,97,82,15,0,179,176,3,0,7,4,3,24,24,181,2,179
"2021","Manchester 055A","E01005128",697,365,5,360,216,3,39,34,3,2,123,121,2,0,7,1,6,44,44,116,0,116
"2021","Manchester 055B","E01033653",1150,597,108,489,370,24,86,66,18,2,203,199,4,0,19,6,13,38,38,183,3,180
"2021","Manchester 055C","E01033654",562,263,8,255,200,1,71,58,12,1,111,111,0,0,2,0,2,15,15,99,1,98
"2021","Manchester 055E","E01033661",1200,532,113,419,408,10,74,61,12,1,288,276,10,2,17,5,12,19,19,260,2,258
"2021","Manchester 055F","E01034129",638,255,7,248,273,4,54,40,12,2,179,177,1,1,8,3,5,28,28,110,1,109
"2021","Manchester 055G","E01034130",782,248,3,245,298,1,56,45,10,1,206,197,9,0,11,6,5,24,24,236,0,236
"2021","Manchester 056A","E01005143",791,162,39,123,467,10,310,22,234,54,19,7,11,1,111,59,52,17,17,162,113,49
"2021","Manchester 056B","E01033655",745,288,1,287,275,0,65,39,25,1,183,179,4,0,2,0,2,25,25,182,3,179
"2021","Manchester 056C","E01033665",916,437,41,396,367,8,115,73,34,8,208,198,10,0,18,10,8,18,18,112,3,109
"2021","Manchester 056D","E01033676",733,258,80,178,404,18,176,36,113,27,54,24,23,7,148,114,34,8,8,71,42,29
"2021","Manchester 057A","E01005212",761,322,41,281,285,1,97,32,59,6,94,76,18,0,70,46,24,23,23,154,13,141
"2021","Manchester 057B","E01033656",484,163,0,163,156,0,36,26,8,2,98,95,3,0,2,0,2,20,20,165,0,165
"2021","Manchester 057C","E01033662",967,498,6,492,307,3,61,43,16,2,191,187,4,0,14,10,4,38,38,162,1,161
"2021","Manchester 058A","E01005142",703,199,46,153,436,5,234,26,176,32,47,14,29,4,131,78,53,19,19,68,54,14
"2021","Manchester 058B","E01005147",898,240,58,182,560,10,293,39,202,52,46,14,24,8,193,130,63,18,18,98,63,35
"2021","Manchester 058C","E01033674",668,243,16,227,322,21,133,47,73,13,114,101,11,2,37,28,9,17,17,103,15,88
"2021","Manchester 058D","E01033675",772,184,33,151,513,12,249,32,187,30,63,28,30,5,178,115,63,11,11,75,36,39
"2021","Manchester 059A","E01005213",1163,501,98,403,472,9,148,40,98,10,111,79,29,3,169,101,68,35,35,190,26,164
"2021","Manchester 059B","E01033660",860,329,6,323,357,2,56,48,7,1,278,273,5,0,9,4,5,12,12,174,2,172
"2021","Manchester 059C","E01033672",921,420,44,376,381,3,91,44,38,9,145,125,18,2,107,71,36,35,35,120,9,111
"2021","Manchester 059D","E01033673",855,335,9,326,317,0,52,41,9,2,242,238,4,0,5,2,3,18,18,203,2,201
"2021","Manchester 060A","E01033677",612,285,12,273,215,1,76,48,25,3,94,92,2,0,24,3,21,20,20,112,5,107
"2021","Manchester 060B","E01033681",850,415,13,402,311,4,69,53,15,1,205,200,5,0,9,5,4,24,24,124,3,121
"2021","Manchester 060C","E01033682",751,336,40,296,276,8,68,47,17,4,172,168,4,0,10,7,3,18,18,139,1,138
"2021","Manchester 060E","E01034131",649,311,2,309,224,0,50,37,13,0,137,132,4,1,22,1,21,15,15,114,0,114
"2021","Manchester 060F","E01034132",959,437,0,437,321,1,83,59,20,4,181,178,3,0,16,12,4,40,40,201,1,200
"2021","Manchester 061A","E01005129",836,335,72,263,425,11,125,45,64,16,115,82,29,4,160,98,62,14,14,76,21,55
"2021","Manchester 061B","E01005132",840,240,68,172,503,12,181,59,88,34,105,56,42,7,196,119,77,9,9,97,49,48
"2021","Manchester 061C","E01034133",879,340,94,246,394,15,122,55,49,18,152,123,23,6,90,55,35,15,15,145,39,106
"2021","Manchester 061D","E01034134",672,216,2,214,294,1,54,36,18,0,213,207,5,1,11,6,5,15,15,162,0,162
"2021","Manchester 062D","E01033684",1017,311,2,309,387,0,73,56,15,2,273,266,7,0,5,4,1,36,36,319,2,317
"2021","Manchester 062B","E01033688",701,266,94,172,380,19,133,26,84,23,55,31,16,8,150,91,59,23,23,55,29,26
"2021","Manchester 062A","E01034135",641,289,9,280,265,3,83,49,31,3,145,138,7,0,22,13,9,12,12,87,9,78
"2021","Manchester 062C","E01034136",603,274,1,273,228,2,54,43,11,0,152,148,4,0,4,4,0,16,16,101,4,97
"2021","Manchester 063B","E01005233",786,121,31,90,513,10,319,26,261,32,41,14,24,3,131,103,28,12,12,152,107,45
"2021","Manchester 063A","E01005234",650,154,50,104,397,8,241,27,187,27,25,9,15,1,106,63,43,17,17,99,66,33
"2021","Manchester 063D","E01005238",584,91,20,71,378,14,241,22,175,44,24,10,12,2,82,45,37,17,17,115,72,43
"2021","Manchester 063C","E01034137",495,78,18,60,349,20,224,36,160,28,24,10,13,1,67,47,20,14,14,68,47,21
"2021","Manchester 064C","E01005199",906,271,51,220,525,16,277,52,209,16,94,56,33,5,125,75,50,13,13,110,51,59
"2021","Manchester 064A","E01005200",963,306,82,224,559,25,269,51,193,25,104,62,38,4,145,102,43,16,16,98,41,57
"2021","Manchester 064B","E01034138",452,118,25,93,276,5,146,20,115,11,29,16,13,0,84,61,23,12,12,58,37,21
"2021","Oldham 001A","E01005357",618,171,128,43,430,100,225,82,93,50,60,31,24,5,43,22,21,2,2,17,12,5
"2021","Oldham 001B","E01005358",716,270,113,157,421,42,178,56,78,44,94,36,50,8,102,65,37,5,5,25,10,15
"2021","Oldham 001C","E01005359",761,268,155,113,466,136,199,84,67,48,79,48,24,7,51,27,24,1,1,27,14,13
"2021","Oldham 001D","E01005360",642,219,140,79,402,94,154,68,49,37,78,32,38,8,75,44,31,1,1,21,13,8
"2021","Oldham 002A","E01005441",753,312,123,189,420,53,167,69,69,29,85,40,31,14,111,71,40,4,4,21,11,10
"2021","Oldham 002B","E01005442",578,142,88,54,418,93,207,76,83,48,68,33,27,8,46,22,24,4,4,18,9,9
"2021","Oldham 002C","E01005444",659,247,116,131,391,52,146,62,53,31,91,40,43,8,97,61,36,5,5,21,10,11
"2021","Oldham 002D","E01005445",665,251,75,176,371,24,117,35,49,33,101,49,45,7,125,84,41,4,4,43,20,23
"2021","Oldham 003A","E01005361",732,210,139,71,495,131,232,95,82,55,74,26,42,6,57,33,24,1,1,27,13,14
"2021","Oldham 003B","E01005443",543,106,54,52,416,98,221,89,80,52,53,19,28,6,43,17,26,1,1,21,13,8
"2021","Oldham 003C","E01005446",596,149,57,92,418,66,172,65,65,42,80,31,37,12,98,57,41,2,2,29,13,16
"2021","Oldham 003D","E01005447",722,305,122,183,385,34,135,44,69,22,98,54,39,5,110,78,32,8,8,32,18,14
"2021","Oldham 004A","E01005390",609,173,93,80,410,93,171,63,70,38,75,35,35,5,70,42,28,1,1,26,15,11
"2021","Oldham 004B","E01005394",642,196,115,81,425,87,214,74,98,42,59,30,23,6,64,33,31,1,1,21,6,15
"2021","Oldham 004C","E01005395",623,176,86,90,427,84,198,70,84,44,70,30,38,2,72,41,31,3,3,20,9,11
"2021","Oldham 004D","E01005396",575,135,75,60,408,94,188,65,75,48,58,20,30,8,65,37,28,3,3,32,16,16
"2021","Oldham 005A","E01005355",625,189,69,120,398,39,157,57,76,24,104,41,53,10,95,53,42,3,3,38,19,19
"2021","Oldham 005B","E01005356",497,97,41,56,381,52,227,86,87,54,55,27,21,7,47,30,17,0,0,19,9,10
"2021","Oldham 005C","E01005399",710,225,105,120,457,95,205,81,79,45,92,33,51,8,64,34,30,1,1,28,10,18
"2021","Oldham 005D","E01005403",691,174,69,105,488,52,228,70,107,51,125,52,59,14,83,65,18,0,0,29,14,15
"2021","Oldham 006A","E01005410",622,131,77,54,461,96,261,98,115,48,62,30,24,8,39,18,21,3,3,30,13,17
"2021","Oldham 006B","E01005411",735,281,173,108,441,98,227,74,105,48,60,32,24,4,55,30,25,1,1,13,4,9
"2021","Oldham 006C","E01005414",560,137,69,68,410,70,234,80,114,40,69,41,23,5,35,16,19,2,2,13,6,7
"2021","Oldham 006D","E01005415",513,174,122,52,327,77,159,57,67,35,37,19,14,4,54,31,23,0,0,12,5,7
"2021","Oldham 007C","E01005452",538,140,64,76,362,77,192,72,63,57,58,33,24,1,35,17,18,0,0,36,17,19
"2021","Oldham 007D","E01005453",633,148,71,77,455,61,243,77,114,52,97,47,42,8,49,29,20,5,5,30,13,17
"2021","Oldham 007E","E01032558",659,157,56,101,463,28,143,46,72,25,106,19,79,8,182,140,42,4,4,39,29,10
"2021","Oldham 007F","E01032559",1008,207,67,140,737,47,362,102,179,81,177,75,88,14,150,99,51,1,1,64,31,33
"2021","Oldham 008A","E01005391",655,175,80,95,455,72,203,69,76,58,71,25,34,12,103,65,38,6,6,25,15,10
"2021","Oldham 008B","E01005392",805,355,173,182,433,61,126,50,54,22,81,27,46,8,157,101,56,8,8,17,5,12
"2021","Oldham 008C","E01005393",531,153,97,56,358,86,155,55,58,42,58,25,27,6,57,34,23,2,2,20,9,11
"2021","Oldham 008D","E01005401",684,189,122,67,478,94,247,88,88,71,86,36,41,9,51,16,35,0,0,17,10,7
"2021","Oldham 009A","E01005397",607,208,77,131,372,61,153,61,52,40,85,33,47,5,72,41,31,1,1,27,9,18
"2021","Oldham 009B","E01005398",675,225,84,141,422,55,175,62,65,48,97,43,46,8,90,50,40,5,5,28,15,13
"2021","Oldham 009C","E01005400",796,364,178,186,411,86,133,48,55,30,69,32,29,8,119,77,42,4,4,21,10,11
"2021","Oldham 009D","E01005402",663,225,96,129,393,39,178,57,78,43,67,29,34,4,104,73,31,5,5,45,31,14
"2021","Oldham 010A","E01005335",541,132,72,60,389,82,168,40,85,43,69,37,30,2,62,32,30,8,8,20,11,9
"2021","Oldham 010B","E01005337",790,188,50,138,544,24,322,44,259,19,59,18,37,4,129,90,39,10,10,58,42,16
"2021","Oldham 010C","E01005339",602,127,81,46,453,99,264,72,120,72,48,28,17,3,36,21,15,6,6,22,9,13
"2021","Oldham 010D","E01005340",626,219,90,129,371,40,153,34,89,30,62,19,35,8,113,77,36,3,3,36,21,15
"2021","Oldham 011A","E01005421",771,251,74,177,481,28,143,46,61,36,121,60,51,10,178,142,36,11,11,39,20,19
"2021","Oldham 011B","E01005422",524,85,33,52,405,13,128,44,61,23,83,18,58,7,180,141,39,1,1,34,24,10
"2021","Oldham 011E","E01032920",1062,322,112,210,670,49,233,76,107,50,162,57,97,8,218,159,59,8,8,70,25,45
"2021","Oldham 012A","E01005448",741,335,123,212,376,19,137,41,77,19,63,26,35,2,150,120,30,7,7,30,20,10
"2021","Oldham 012B","E01005449",679,253,146,107,387,52,137,57,53,27,75,21,51,3,119,75,44,4,4,39,21,18
"2021","Oldham 012C","E01005454",573,146,62,84,402,57,202,87,69,46,77,34,39,4,63,40,23,3,3,25,10,15
"2021","Oldham 012D","E01005455",610,156,56,100,419,48,198,67,84,47,76,32,36,8,95,57,38,2,2,35,12,23
"2021","Oldham 012E","E01005456",762,308,67,241,414,31,122,35,62,25,81,30,42,9,168,111,57,12,12,40,16,24
"2021","Oldham 013A","E01005407",752,200,96,104,526,117,294,103,135,56,74,41,29,4,40,18,22,1,1,26,14,12
"2021","Oldham 013B","E01005412",789,265,136,129,499,96,250,106,104,40,75,51,17,7,76,42,34,2,2,25,11,14
"2021","Oldham 013C","E01005416",670,206,91,115,443,72,211,80,102,29,100,59,38,3,58,39,19,2,2,21,11,10
"2021","Oldham 013D","E01005417",643,160,76,84,448,109,223,81,112,30,74,38,30,6,38,17,21,4,4,35,19,16
"2021","Oldham 014A","E01005348",746,249,95,154,399,30,217,46,135,36,48,9,33,6,97,62,35,7,7,98,87,11
"2021","Oldham 014B","E01005350",1063,580,139,441,418,14,179,42,125,12,60,35,21,4,137,92,45,28,28,65,47,18
"2021","Oldham 014C","E01005432",689,232,69,163,398,18,136,42,66,28,77,23,44,10,165,123,42,2,2,59,35,24
"2021","Oldham 014D","E01005433",934,370,63,307,497,16,181,32,125,24,95,36,55,4,187,138,49,18,18,67,48,19
"2021","Oldham 015A","E01005329",631,155,66,89,452,83,250,90,108,52,66,37,22,7,47,25,22,6,6,24,12,12
"2021","Oldham 015B","E01005330",691,147,64,83,496,85,250,76,109,65,90,40,42,8,70,44,26,1,1,48,16,32
"2021","Oldham 015C","E01005333",499,112,72,40,367,83,201,72,77,52,47,21,20,6,35,19,16,1,1,20,10,10
"2021","Oldham 015D","E01005336",631,159,101,58,447,98,233,77,91,65,63,28,29,6,50,23,27,3,3,25,14,11
"2021","Oldham 016A","E01005349",588,67,28,39,404,4,287,27,226,34,17,2,15,0,87,54,33,9,9,117,98,19
"2021","Oldham 016B","E01005351",471,72,16,56,309,9,229,17,182,30,8,2,6,0,59,39,20,4,4,90,68,22
"2021","Oldham 016C","E01005352",467,140,37,103,266,21,160,26,114,20,13,6,6,1,67,39,28,5,5,61,46,15
"2021","Oldham 016D","E01005353",409,91,25,66,242,4,151,18,116,17,14,2,11,1,64,30,34,9,9,76,60,16
"2021","Oldham 016E","E01005354",573,129,40,89,379,13,215,43,140,32,59,25,31,3,83,55,28,9,9,65,52,13
"2021","Oldham 017A","E01005327",778,253,127,126,484,64,242,58,133,51,87,43,41,3,88,53,35,3,3,41,23,18
"2021","Oldham 017B","E01005328",746,336,101,235,369,27,162,34,97,31,54,33,18,3,114,82,32,12,12,41,30,11
"2021","Oldham 017C","E01005331",657,162,68,94,470,74,204,56,114,34,86,29,49,8,105,77,28,1,1,25,15,10
"2021","Oldham 017D","E01005334",554,120,51,69,420,57,232,56,105,71,72,23,38,11,59,45,14,0,0,14,9,5
"2021","Oldham 017E","E01005338",761,283,159,124,434,68,216,45,142,29,49,26,18,5,89,52,37,12,12,44,29,15
"2021","Oldham 018A","E01005387",641,179,71,108,446,58,173,63,76,34,123,53,63,7,91,52,39,1,1,16,7,9
"2021","Oldham 018B","E01005388",587,180,88,92,379,62,151,52,64,35,72,37,30,5,91,51,40,3,3,28,9,19
"2021","Oldham 018C","E01005389",783,291,94,197,458,45,145,59,63,23,100,40,53,7,161,105,56,7,7,34,18,16
"2021","Oldham 018D","E01005418",594,158,100,58,421,71,220,66,100,54,66,35,27,4,63,31,32,1,1,15,7,8
"2021","Oldham 019A","E01005428",528,94,24,70,310,8,210,29,158,23,24,7,17,0,59,40,19,9,9,124,102,22
"2021","Oldham 019B","E01005431",698,192,71,121,469,35,253,89,140,24,65,28,34,3,108,74,34,8,8,37,22,15
"2021","Oldham 019C","E01005450",670,138,34,104,465,13,303,109,175,19,50,15,33,2,91,74,17,8,8,67,53,14
"2021","Oldham 019D","E01005451",494,105,40,65,337,40,184,46,101,37,44,17,24,3,65,47,18,4,4,52,38,14
"2021","Oldham 020C","E01005408",891,280,165,115,579,120,296,101,144,51,95,44,44,7,67,46,21,1,1,32,12,20
"2021","Oldham 020D","E01005409",661,175,101,74,457,92,255,89,111,55,58,27,27,4,48,21,27,4,4,29,13,16
"2021","Oldham 020E","E01032922",1071,324,222,102,719,165,369,126,154,89,84,34,43,7,98,54,44,3,3,28,14,14
"2021","Oldham 021A","E01005406",587,132,76,56,433,86,256,97,115,44,56,23,25,8,34,17,17,1,1,22,6,16
"2021","Oldham 021B","E01005413",642,133,79,54,487,75,281,102,121,58,77,43,26,8,49,25,24,5,5,22,11,11
"2021","Oldham 021C","E01005419",650,195,96,99,435,73,205,81,86,38,75,39,27,9,78,55,23,4,4,20,9,11
"2021","Oldham 021D","E01005420",744,276,165,111,449,77,184,70,68,46,104,51,44,9,80,46,34,4,4,19,12,7
"2021","Oldham 022A","E01005321",619,167,48,119,389,13,262,33,209,20,42,16,21,5,66,48,18,6,6,63,46,17
"2021","Oldham 022B","E01005326",557,62,20,42,310,5,223,16,168,39,7,1,5,1,69,41,28,6,6,185,157,28
"2021","Oldham 022C","E01005427",509,64,21,43,325,3,235,20,183,32,18,2,16,0,64,32,32,5,5,120,97,23
"2021","Oldham 022D","E01005429",463,69,22,47,282,11,203,22,153,28,8,2,6,0,56,31,25,4,4,112,83,29
"2021","Oldham 022E","E01005430",720,130,35,95,463,20,319,42,243,34,27,17,8,2,86,55,31,11,11,127,101,26
"2021","Oldham 024A","E01005320",646,131,31,100,407,10,263,37,187,39,43,10,31,2,89,65,24,2,2,108,91,17
"2021","Oldham 024B","E01005434",791,302,72,230,409,16,210,51,153,6,37,22,14,1,131,107,24,15,15,80,51,29
"2021","Oldham 024C","E01005437",543,68,20,48,409,11,298,51,202,45,19,8,8,3,77,48,29,4,4,66,51,15
"2021","Oldham 024D","E01005459",481,112,52,60,292,7,166,16,130,20,33,5,27,1,80,47,33,6,6,77,59,18
"2021","Oldham 026A","E01005383",709,171,67,104,467,33,259,52,170,37,63,26,32,5,108,83,25,4,4,71,55,16
"2021","Oldham 026D","E01005386",647,206,90,116,401,25,144,59,65,20,88,30,49,9,138,93,45,6,6,40,26,14
"2021","Oldham 026E","E01032556",670,197,88,109,445,72,153,56,64,33,108,51,51,6,110,76,34,2,2,28,12,16
"2021","Oldham 026F","E01032557",764,270,103,167,439,23,129,38,74,17,84,27,50,7,198,155,43,5,5,55,33,22
"2021","Oldham 027A","E01005342",725,334,130,204,349,34,145,47,77,21,50,29,15,6,113,67,46,7,7,42,22,20
"2021","Oldham 027B","E01005343",546,136,50,86,380,40,152,40,79,33,90,21,55,14,96,61,35,2,2,30,15,15
"2021","Oldham 027C","E01005344",778,260,54,206,475,26,167,42,98,27,138,62,65,11,139,104,35,5,5,43,25,18
"2021","Oldham 027D","E01005381",757,279,104,175,402,35,179,39,112,28,70,32,33,5,110,73,37,8,8,76,46,30
"2021","Oldham 028A","E01005332",986,367,135,232,562,65,234,63,124,47,95,54,37,4,162,110,52,6,6,57,29,28
"2021","Oldham 028B","E01005341",592,179,67,112,383,35,163,57,65,41,109,44,56,9,69,43,26,7,7,30,19,11
"2021","Oldham 028C","E01005345",619,159,86,73,430,59,203,78,84,41,89,38,33,18,78,41,37,1,1,30,18,12
"2021","Oldham 028D","E01005346",598,186,106,80,383,56,190,67,66,57,62,21,32,9,70,31,39,5,5,29,14,15
"2021","Oldham 028E","E01005347",539,164,64,100,349,37,152,47,72,33,85,42,31,12,72,48,24,3,3,26,14,12
"2021","Oldham 029A","E01005322",536,126,37,89,369,17,157,28,100,29,51,17,31,3,138,88,50,6,6,41,25,16
"2021","Oldham 029B","E01005323",620,188,62,126,397,39,121,42,50,29,75,27,43,5,157,110,47,5,5,35,18,17
"2021","Oldham 029C","E01005324",690,211,79,132,444,27,152,61,65,26,100,30,61,9,160,107,53,5,5,35,18,17
"2021","Oldham 029D","E01005325",513,140,39,101,334,19,117,33,63,21,69,14,52,3,125,104,21,4,4,39,25,14
"2021","Oldham 029E","E01005438",1006,257,92,165,664,45,340,65,228,47,94,45,40,9,151,113,38,34,34,85,58,27
"2021","Oldham 030A","E01005377",635,168,43,125,440,14,180,48,95,37,91,35,44,12,152,109,43,3,3,27,16,11
"2021","Oldham 030B","E01005379",484,118,49,69,332,13,93,25,54,14,63,15,40,8,161,122,39,2,2,34,22,12
"2021","Oldham 030C","E01005380",523,94,41,53,396,17,163,51,69,43,68,14,44,10,141,105,36,7,7,33,20,13
"2021","Oldham 030D","E01005382",653,226,111,115,386,41,153,37,77,39,59,22,29,8,123,78,45,10,10,41,20,21
"2021","Oldham 030E","E01005439",650,175,86,89,425,75,207,74,87,46,71,41,22,8,72,37,35,0,0,50,24,26
"2021","Oldham 031A","E01005362",597,182,103,79,387,61,160,45,66,49,68,27,32,9,96,55,41,2,2,28,11,17
"2021","Oldham 031B","E01005364",690,193,117,76,479,74,233,90,70,73,90,38,42,10,80,45,35,2,2,18,9,9
"2021","Oldham 031C","E01005368",759,320,88,232,406,29,122,54,47,21,86,47,35,4,159,111,48,10,10,33,13,20
"2021","Oldham 031D","E01005376",571,180,70,110,347,28,117,25,66,26,69,30,35,4,127,85,42,6,6,44,21,23
"2021","Oldham 031E","E01005378",664,205,81,124,424,55,171,68,73,30,86,36,43,7,109,83,26,3,3,35,18,17
"2021","Oldham 032A","E01005363",840,330,110,220,477,46,176,66,72,38,123,70,45,8,125,77,48,7,7,33,13,20
"2021","Oldham 032B","E01005369",828,238,82,156,543,40,188,60,106,22,141,80,55,6,168,90,78,6,6,47,16,31
"2021","Oldham 032C","E01005370",792,356,166,190,411,47,130,53,49,28,87,38,38,11,142,86,56,5,5,25,10,15
"2021","Oldham 032D","E01005371",605,194,52,142,363,25,135,49,60,26,115,55,54,6,84,58,26,4,4,48,28,20
"2021","Oldham 033A","E01005365",615,180,93,87,406,62,203,78,62,63,67,39,25,3,70,42,28,4,4,29,16,13
"2021","Oldham 033B","E01005366",753,295,162,133,433,116,146,44,50,52,64,25,31,8,104,52,52,3,3,25,14,11
"2021","Oldham 033C","E01005367",565,128,81,47,415,75,220,69,80,71,61,28,30,3,58,31,27,1,1,22,12,10
"2021","Oldham 033D","E01005440",654,224,98,126,396,47,184,76,66,42,77,36,39,2,83,55,28,5,5,34,16,18
"2021","Oldham 034A","E01005372",535,150,70,80,365,33,138,40,66,32,82,34,38,10,109,76,33,3,3,20,8,12
"2021","Oldham 034B","E01005373",509,153,100,53,338,62,161,50,67,44,61,19,35,7,54,31,23,0,0,18,8,10
"2021","Oldham 034C","E01005374",614,156,82,74,423,56,165,63,63,39,89,35,47,7,112,73,39,1,1,35,15,20
"2021","Oldham 034D","E01005375",646,180,115,65,439,81,206,75,82,49,76,33,40,3,74,36,38,2,2,27,8,19
"2021","Oldham 036C","E01005460",817,196,71,125,532,23,289,49,204,36,51,19,27,5,156,118,38,13,13,89,68,21
"2021","Oldham 036D","E01005463",511,107,27,80,355,9,204,29,156,19,27,12,15,0,103,80,23,12,12,49,36,13
"2021","Oldham 036A","E01034232",434,103,22,81,258,6,158,13,130,15,15,6,9,0,71,52,19,8,8,73,65,8
"2021","Oldham 036B","E01034233",431,100,24,76,245,7,160,29,103,28,18,2,16,0,52,26,26,8,8,86,61,25
"2021","Oldham 037B","E01005435",494,57,24,33,346,13,245,31,188,26,6,3,1,2,80,58,22,2,2,91,65,26
"2021","Oldham 037D","E01005436",519,91,39,52,348,29,211,40,132,39,40,17,16,7,63,40,23,5,5,80,55,25
"2021","Oldham 037A","E01005461",576,85,37,48,363,15,234,26,166,42,12,2,9,1,94,55,39,8,8,128,99,29
"2021","Oldham 037C","E01005462",628,140,56,84,388,31,247,45,170,32,37,15,18,4,66,41,25,7,7,100,70,30
"2021","Rochdale 001A","E01005518",674,180,78,102,457,62,187,78,71,38,106,50,48,8,96,68,28,6,6,37,17,20
"2021","Rochdale 001B","E01005520",806,271,116,155,507,69,212,84,88,40,107,59,42,6,115,71,44,4,4,28,14,14
"2021","Rochdale 001C","E01005522",770,362,138,224,383,43,125,49,55,21,102,59,40,3,111,73,38,2,2,25,10,15
"2021","Rochdale 001D","E01005523",807,259,103,156,518,86,232,73,107,52,112,61,43,8,84,59,25,4,4,30,15,15
"2021","Rochdale 002A","E01005519",622,134,58,76,460,49,225,75,101,49,115,55,55,5,68,48,20,3,3,28,16,12
"2021","Rochdale 002B","E01005594",599,136,65,71,431,60,195,80,83,32,92,38,42,12,80,42,38,4,4,32,24,8
"2021","Rochdale 002C","E01005597",828,226,91,135,584,86,281,91,150,40,133,57,67,9,82,58,24,2,2,18,5,13
"2021","Rochdale 002D","E01005598",689,191,104,87,472,136,212,83,82,47,78,35,37,6,45,24,21,1,1,26,14,12
"2021","Rochdale 003A","E01005516",524,114,60,54,388,60,212,90,82,40,61,28,30,3,55,30,25,0,0,22,12,10
"2021","Rochdale 003B","E01005517",643,192,110,82,430,110,188,84,65,39,82,43,29,10,47,31,16,3,3,21,7,14
"2021","Rochdale 003C","E01005521",674,212,101,111,445,63,250,133,81,36,82,50,23,9,48,19,29,2,2,17,11,6
"2021","Rochdale 003D","E01005596",816,194,79,115,569,83,312,103,155,54,98,47,45,6,74,46,28,2,2,53,36,17
"2021","Rochdale 004A","E01005578",514,183,47,136,277,17,145,32,83,30,29,13,16,0,82,60,22,4,4,54,37,17
"2021","Rochdale 004B","E01005579",550,110,39,71,395,16,202,18,160,24,52,8,35,9,118,81,37,7,7,45,34,11
"2021","Rochdale 004C","E01005586",635,221,102,119,368,26,142,29,99,14,73,35,29,9,126,100,26,1,1,46,28,18
"2021","Rochdale 004D","E01005593",755,167,60,107,554,56,265,76,149,40,109,42,56,11,121,90,31,3,3,34,26,8
"2021","Rochdale 004E","E01005595",749,432,163,269,288,25,116,46,45,25,45,26,16,3,100,68,32,2,2,29,15,14
"2021","Rochdale 005A","E01005489",507,112,73,39,376,85,173,68,71,34,59,21,31,7,55,35,20,4,4,19,13,6
"2021","Rochdale 005B","E01005490",424,102,46,56,299,24,126,24,69,33,55,18,28,9,86,54,32,8,8,23,16,7
"2021","Rochdale 005C","E01005491",688,271,125,146,388,60,160,64,66,30,87,45,36,6,77,51,26,4,4,29,14,15
"2021","Rochdale 005D","E01005493",715,199,88,111,477,84,253,97,105,51,76,34,37,5,62,35,27,2,2,39,21,18
"2021","Rochdale 005E","E01005494",713,203,91,112,465,65,220,78,108,34,74,35,31,8,99,61,38,7,7,45,26,19
"2021","Rochdale 005F","E01005495",698,233,97,136,400,83,193,65,91,37,56,34,19,3,66,45,21,2,2,65,41,24
"2021","Rochdale 006A","E01005488",585,109,46,63,460,40,259,77,122,60,91,47,38,6,68,42,26,2,2,16,11,5
"2021","Rochdale 006B","E01005492",616,127,75,52,456,94,250,105,98,47,60,27,28,5,48,20,28,4,4,33,18,15
"2021","Rochdale 006C","E01005499",682,219,99,120,439,77,205,93,64,48,93,44,38,11,64,40,24,0,0,24,11,13
"2021","Rochdale 006D","E01005571",726,208,88,120,497,102,253,92,103,58,97,49,40,8,44,20,24,1,1,21,7,14
"2021","Rochdale 007A","E01005570",588,194,93,101,378,88,186,84,67,35,61,29,30,2,42,24,18,1,1,16,5,11
"2021","Rochdale 007B","E01005572",620,156,80,76,442,83,223,80,107,36,65,41,20,4,71,40,31,0,0,22,12,10
"2021","Rochdale 007C","E01005573",566,124,75,49,407,94,234,75,106,53,45,19,16,10,33,16,17,1,1,35,21,14
"2021","Rochdale 007D","E01005574",692,167,92,75,488,110,262,78,120,64,58,30,20,8,57,30,27,1,1,37,24,13
"2021","Rochdale 007E","E01005587",517,87,40,47,399,45,263,99,114,50,51,25,22,4,37,24,13,3,3,31,14,17
"2021","Rochdale 007F","E01005588",658,282,157,125,360,94,124,45,49,30,56,26,26,4,85,52,33,1,1,16,4,12
"2021","Rochdale 008A","E01005580",578,154,51,103,373,14,185,48,111,26,52,25,25,2,113,83,30,9,9,51,35,16
"2021","Rochdale 008B","E01005581",721,249,92,157,419,26,239,45,163,31,55,28,23,4,91,73,18,8,8,53,35,18
"2021","Rochdale 008D","E01005583",516,149,57,92,277,6,179,26,113,40,15,3,12,0,71,28,43,6,6,90,70,20
"2021","Rochdale 008F","E01005585",502,127,36,91,314,18,161,24,116,21,49,27,17,5,75,54,21,11,11,61,43,18
"2021","Rochdale 008H","E01034234",457,78,18,60,298,5,208,23,151,34,12,6,5,1,63,29,34,10,10,81,63,18
"2021","Rochdale 008I","E01034235",468,92,19,73,296,6,171,26,110,35,39,15,22,2,73,46,27,7,7,80,62,18
"2021","Rochdale 009A","E01005496",507,138,52,86,333,19,130,39,66,25,57,12,38,7,120,95,25,7,7,36,25,11
"2021","Rochdale 009B","E01005589",715,235,63,172,436,40,168,45,85,38,100,48,50,2,122,89,33,6,6,44,23,21
"2021","Rochdale 009C","E01005590",561,114,45,69,361,26,201,36,132,33,42,21,18,3,90,62,28,2,2,86,61,25
"2021","Rochdale 009D","E01005591",660,205,105,100,428,73,187,59,97,31,80,35,38,7,85,61,24,3,3,27,17,10
"2021","Rochdale 009E","E01005592",609,192,80,112,365,40,160,45,92,23,56,17,36,3,105,65,40,4,4,52,30,22
"2021","Rochdale 010A","E01005472",663,224,90,134,402,26,165,36,95,34,78,36,35,7,124,84,40,9,9,37,19,18
"2021","Rochdale 010B","E01005473",506,125,38,87,311,19,190,24,129,37,23,9,12,2,67,46,21,12,12,70,51,19
"2021","Rochdale 010C","E01005482",893,557,99,458,303,13,118,42,65,11,61,39,18,4,102,71,31,9,9,33,19,14
"2021","Rochdale 010D","E01005483",562,246,59,187,254,13,133,23,91,19,25,14,10,1,74,44,30,9,9,62,42,20
"2021","Rochdale 010E","E01005484",775,313,87,226,387,10,187,37,122,28,44,17,23,4,135,103,32,11,11,75,47,28
"2021","Rochdale 010F","E01005486",600,167,36,131,394,9,227,49,146,32,53,17,33,3,95,71,24,10,10,39,21,18
"2021","Rochdale 010G","E01005487",584,148,71,77,363,32,205,43,124,38,34,9,23,2,85,53,32,7,7,73,48,25
"2021","Rochdale 011A","E01005474",479,123,76,47,323,66,163,44,80,39,32,17,13,2,58,33,25,4,4,33,24,9
"2021","Rochdale 011B","E01005575",761,230,147,83,505,137,236,80,97,59,65,36,18,11,61,40,21,6,6,26,12,14
"2021","Rochdale 011C","E01005576",543,100,70,30,388,93,238,68,107,63,27,18,5,4,30,8,22,0,0,55,37,18
"2021","Rochdale 011D","E01005577",647,201,111,90,418,104,226,80,102,44,45,24,20,1,41,16,25,2,2,28,14,14
"2021","Rochdale 012A","E01005469",682,179,75,104,463,60,219,58,113,48,83,29,45,9,96,60,36,5,5,40,25,15
"2021","Rochdale 012B","E01005563",704,159,44,115,462,20,239,48,139,52,62,30,27,5,128,101,27,13,13,83,61,22
"2021","Rochdale 012C","E01005565",534,124,43,81,364,21,194,41,102,51,55,20,26,9,89,50,39,5,5,46,26,20
"2021","Rochdale 012D","E01005566",828,214,67,147,544,22,240,58,152,30,92,37,49,6,180,139,41,10,10,70,50,20
"2021","Rochdale 012E","E01005568",653,212,54,158,379,14,155,25,112,18,46,15,27,4,146,107,39,18,18,62,45,17
"2021","Rochdale 012F","E01005569",641,193,74,119,392,41,181,38,106,37,58,22,31,5,106,72,34,6,6,56,36,20
"2021","Rochdale 013A","E01005556",697,217,68,149,460,72,216,78,84,54,88,47,31,10,77,50,27,7,7,20,4,16
"2021","Rochdale 013B","E01005559",661,260,130,130,372,48,142,46,72,24,79,32,42,5,100,70,30,3,3,29,13,16
"2021","Rochdale 013C","E01005560",691,234,119,115,433,101,183,81,66,36,81,57,18,6,68,42,26,0,0,24,11,13
"2021","Rochdale 013D","E01005567",809,249,69,180,526,47,252,88,127,37,125,60,55,10,95,74,21,7,7,34,19,15
"2021","Rochdale 014A","E01005555",551,117,55,62,410,64,220,64,103,53,64,36,25,3,62,41,21,0,0,24,10,14
"2021","Rochdale 014B","E01005557",496,122,85,37,364,97,164,60,66,38,59,21,32,6,42,23,19,2,2,10,6,4
"2021","Rochdale 014C","E01005558",701,232,112,120,445,59,185,60,91,34,88,34,44,10,113,74,39,0,0,24,13,11
"2021","Rochdale 014D","E01005561",648,206,92,114,413,57,179,85,58,36,92,54,31,7,85,60,25,0,0,29,14,15
"2021","Rochdale 014E","E01005562",681,223,99,124,435,48,206,82,84,40,90,44,42,4,84,57,27,7,7,23,12,11
"2021","Rochdale 015A","E01005470",511,55,15,40,369,12,251,25,185,41,14,4,10,0,83,45,38,9,9,87,61,26
"2021","Rochdale 015B","E01005471",569,147,67,80,361,23,221,45,144,32,34,11,21,2,72,50,22,11,11,61,45,16
"2021","Rochdale 015C","E01005475",596,171,76,95,374,21,204,26,126,52,43,12,24,7,93,54,39,13,13,51,41,10
"2021","Rochdale 015D","E01005485",676,192,55,137,359,12,223,32,137,54,16,9,2,5,97,53,44,11,11,125,87,38
"2021","Rochdale 015E","E01005564",739,163,58,105,484,11,252,33,177,42,59,26,28,5,143,92,51,19,19,92,60,32
"2021","Rochdale 016A","E01005464",666,130,51,79,477,20,197,32,123,42,78,21,49,8,173,121,52,9,9,59,39,20
"2021","Rochdale 016B","E01005465",793,285,117,168,475,53,221,77,98,46,100,52,41,7,93,63,30,8,8,33,20,13
"2021","Rochdale 016C","E01005466",1020,355,105,250,619,29,225,58,135,32,118,37,71,10,235,168,67,12,12,46,23,23
"2021","Rochdale 016D","E01005467",831,278,106,172,520,25,187,56,100,31,127,46,75,6,173,119,54,8,8,33,18,15
"2021","Rochdale 016E","E01005468",829,165,65,100,635,81,338,103,168,67,134,60,68,6,77,50,27,5,5,29,18,11
"2021","Rochdale 017A","E01005476",777,259,112,147,485,58,219,74,104,41,90,37,50,3,114,82,32,4,4,33,17,16
"2021","Rochdale 017B","E01005477",850,359,129,230,445,35,138,45,69,24,109,53,50,6,153,117,36,10,10,46,21,25
"2021","Rochdale 017C","E01005478",668,191,95,96,435,76,189,70,76,43,77,33,40,4,89,58,31,4,4,42,20,22
"2021","Rochdale 017D","E01005479",785,193,94,99,549,73,231,79,102,50,125,61,55,9,112,69,43,8,8,43,21,22
"2021","Rochdale 017E","E01005480",718,245,147,98,442,73,203,79,75,49,61,31,22,8,95,58,37,10,10,31,15,16
"2021","Rochdale 017F","E01005481",582,145,67,78,393,41,211,60,107,44,66,37,23,6,74,39,35,1,1,44,22,22
"2021","Rochdale 018A","E01005497",750,204,91,113,504,49,186,64,83,39,111,30,70,11,155,132,23,3,3,42,26,16
"2021","Rochdale 018B","E01005501",992,540,220,320,417,46,139,59,50,30,99,51,39,9,127,102,25,6,6,35,11,24
"2021","Rochdale 018C","E01005502",681,278,121,157,377,55,144,61,50,33,79,44,28,7,92,65,27,7,7,26,13,13
"2021","Rochdale 018D","E01005504",709,214,79,135,464,35,157,53,63,41,106,44,44,18,159,113,46,7,7,31,14,17
"2021","Rochdale 018E","E01005505",960,295,126,169,632,51,256,101,114,41,154,77,66,11,164,106,58,7,7,33,18,15
"2021","Rochdale 018F","E01005509",722,351,106,245,338,30,119,47,43,29,87,32,45,10,99,73,26,3,3,33,10,23
"2021","Rochdale 019A","E01005510",443,94,53,41,329,69,172,63,64,45,50,15,30,5,36,17,19,2,2,20,7,13
"2021","Rochdale 019B","E01005511",494,124,52,72,346,61,156,63,61,32,59,19,34,6,68,30,38,2,2,24,16,8
"2021","Rochdale 019C","E01005512",662,227,79,148,406,43,148,66,55,27,96,44,44,8,114,69,45,5,5,29,12,17
"2021","Rochdale 019D","E01005513",633,197,69,128,400,25,126,42,63,21,86,33,46,7,155,118,37,8,8,36,25,11
"2021","Rochdale 019E","E01005514",778,228,82,146,511,28,191,72,84,35,133,63,57,13,151,108,43,8,8,39,17,22
"2021","Rochdale 019F","E01005515",685,172,67,105,468,32,145,45,71,29,83,23,49,11,201,158,43,7,7,45,19,26
"2021","Rochdale 020A","E01005498",594,186,53,133,383,38,129,46,50,33,88,37,42,9,123,94,29,5,5,25,9,16
"2021","Rochdale 020B","E01005500",648,177,72,105,431,42,210,88,68,54,94,40,50,4,81,50,31,4,4,40,21,19
"2021","Rochdale 020C","E01005503",529,112,65,47,402,91,241,79,100,62,41,19,17,5,29,16,13,0,0,15,9,6
"2021","Rochdale 020D","E01005506",650,221,98,123,397,58,179,56,81,42,69,19,41,9,88,61,27,3,3,32,13,19
"2021","Rochdale 020E","E01005507",979,312,71,241,639,47,255,62,141,52,166,76,80,10,164,122,42,7,7,28,12,16
"2021","Rochdale 020F","E01005508",785,172,106,66,572,100,298,92,148,58,110,46,56,8,61,34,27,3,3,41,25,16
"2021","Rochdale 021A","E01005524",618,191,75,116,402,61,190,65,82,43,78,28,36,14,70,37,33,3,3,25,13,12
"2021","Rochdale 021B","E01005525",858,345,109,236,472,35,166,54,82,30,101,47,48,6,159,122,37,11,11,41,25,16
"2021","Rochdale 021C","E01005526",785,219,72,147,530,39,212,77,91,44,139,74,56,9,132,95,37,8,8,36,21,15
"2021","Rochdale 021D","E01005528",671,209,79,130,432,50,164,50,68,46,91,34,48,9,123,77,46,4,4,30,7,23
"2021","Rochdale 021E","E01005536",682,172,52,120,473,39,185,63,90,32,106,57,45,4,138,96,42,5,5,37,20,17
"2021","Rochdale 021F","E01005543",514,142,72,70,352,54,160,61,57,42,71,25,40,6,64,37,27,3,3,20,8,12
"2021","Rochdale 022A","E01005527",825,248,80,168,531,27,187,50,113,24,146,72,62,12,153,104,49,18,18,46,28,18
"2021","Rochdale 022B","E01005529",744,286,119,167,427,43,117,41,55,21,91,24,58,9,166,105,61,10,10,31,17,14
"2021","Rochdale 022C","E01005551",831,263,97,166,510,23,175,56,94,25,110,33,67,10,188,129,59,14,14,58,39,19
"2021","Rochdale 022D","E01005552",892,258,120,138,573,30,189,46,120,23,111,30,71,10,226,175,51,17,17,61,41,20
"2021","Rochdale 022E","E01005553",770,195,103,92,509,52,165,36,88,41,98,32,57,9,176,111,65,18,18,66,42,24
"2021","Rochdale 022F","E01005554",882,233,77,156,593,55,296,99,154,43,142,70,62,10,91,58,33,9,9,56,37,19
"2021","Rochdale 023A","E01005534",619,209,97,112,378,41,160,50,64,46,83,33,43,7,88,52,36,6,6,32,18,14
"2021","Rochdale 023B","E01005535",652,226,55,171,395,48,155,53,60,42,79,28,39,12,108,78,30,5,5,31,14,17
"2021","Rochdale 023C","E01005537",560,158,71,87,375,71,186,76,55,55,68,35,29,4,48,28,20,2,2,27,13,14
"2021","Rochdale 023D","E01005538",566,135,63,72,400,19,133,32,72,29,97,33,50,14,148,101,47,3,3,31,15,16
"2021","Rochdale 023E","E01005540",592,186,75,111,373,30,172,70,70,32,87,43,40,4,83,53,30,1,1,33,15,18
"2021","Rochdale 023F","E01005541",691,226,55,171,435,26,152,64,55,33,116,57,50,9,138,90,48,3,3,30,13,17
"2021","Rochdale 023G","E01005542",702,252,112,140,416,29,144,50,68,26,103,46,55,2,134,103,31,6,6,34,21,13
"2021","Rochdale 024A","E01005533",804,330,138,192,435,45,158,60,64,34,110,67,34,9,119,82,37,3,3,39,23,16
"2021","Rochdale 024B","E01005539",669,312,103,209,336,36,119,56,45,18,64,33,24,7,110,76,34,7,7,21,9,12
"2021","Rochdale 024C","E01005546",624,272,122,150,328,53,144,66,48,30,69,34,33,2,60,42,18,2,2,24,11,13
"2021","Rochdale 024D","E01005547",735,217,67,150,471,42,200,64,101,35,115,55,52,8,110,76,34,4,4,47,20,27
"2021","Rochdale 024E","E01005548",620,293,118,175,304,30,123,47,57,19,61,30,25,6,85,58,27,5,5,23,7,16
"2021","Rochdale 025A","E01005530",633,184,130,54,416,90,200,77,70,53,70,33,30,7,53,28,25,3,3,33,23,10
"2021","Rochdale 025B","E01005531",522,182,71,111,312,32,131,49,57,25,70,28,34,8,77,49,28,2,2,28,15,13
"2021","Rochdale 025C","E01005532",671,252,86,166,375,28,139,39,62,38,67,28,35,4,136,102,34,5,5,44,20,24
"2021","Rochdale 025D","E01005544",587,141,87,54,425,77,238,63,131,44,65,28,33,4,44,21,23,1,1,21,12,9
"2021","Rochdale 025E","E01005545",482,105,69,36,346,77,206,53,97,56,30,13,16,1,31,15,16,2,2,31,21,10
"2021","Rochdale 025F","E01005549",590,110,64,46,450,99,268,77,122,69,52,14,28,10,31,15,16,0,0,30,18,12
"2021","Rochdale 025G","E01005550",617,169,113,56,419,95,218,66,100,52,67,33,29,5,39,16,23,0,0,29,14,15
"2021","Salford 001A","E01005659",629,181,66,115,414,36,124,42,49,33,106,38,54,14,139,91,48,9,9,34,15,19
"2021","Salford 001B","E01005660",735,251,92,159,448,34,136,37,69,30,99,33,59,7,175,137,38,4,4,36,24,12
"2021","Salford 001C","E01005663",670,240,64,176,393,31,145,51,66,28,98,43,40,15,105,80,25,14,14,37,21,16
"2021","Salford 001D","E01005664",622,170,71,99,416,20,129,27,78,24,94,25,59,10,161,129,32,12,12,36,25,11
"2021","Salford 001E","E01005665",813,253,111,142,500,21,117,20,65,32,95,26,56,13,246,185,61,21,21,60,44,16
"2021","Salford 002A","E01005703",753,282,90,192,430,21,145,56,57,32,96,31,57,8,162,124,38,6,6,41,21,20
"2021","Salford 002B","E01005704",589,188,69,119,371,50,146,58,52,36,76,31,37,8,93,62,31,6,6,30,15,15
"2021","Salford 002C","E01005706",659,225,66,159,392,41,131,42,60,29,81,30,45,6,133,88,45,6,6,42,18,24
"2021","Salford 002D","E01005708",723,328,146,182,368,45,134,56,52,26,95,47,41,7,88,62,26,6,6,27,11,16
"2021","Salford 003A","E01005702",1145,374,141,233,704,57,265,94,121,50,207,116,77,14,170,106,64,5,5,67,47,20
"2021","Salford 003C","E01005707",768,278,90,188,454,31,156,49,77,30,107,40,58,9,154,104,50,6,6,36,20,16
"2021","Salford 003D","E01033976",807,181,36,145,600,27,271,95,147,29,210,129,74,7,86,63,23,6,6,26,15,11
"2021","Salford 003E","E01033977",538,210,73,137,302,34,108,39,42,27,81,43,30,8,76,48,28,3,3,26,8,18
"2021","Salford 004A","E01005661",756,219,60,159,510,38,191,60,93,38,120,49,60,11,151,108,43,10,10,27,21,6
"2021","Salford 004B","E01005662",634,178,71,107,422,29,125,36,61,28,77,17,47,13,187,149,38,4,4,34,24,10
"2021","Salford 004C","E01005709",629,196,89,107,401,38,138,38,70,30,82,16,53,13,135,99,36,8,8,32,25,7
"2021","Salford 004D","E01005710",839,147,66,81,649,90,316,103,156,57,127,73,48,6,112,59,53,4,4,43,21,22
"2021","Salford 005A","E01005670",817,325,158,167,462,40,181,56,88,37,101,51,40,10,133,99,34,7,7,30,10,20
"2021","Salford 005B","E01005672",611,215,62,153,360,29,157,78,50,29,96,57,39,0,71,51,20,7,7,36,14,22
"2021","Salford 005C","E01005676",550,154,79,75,383,92,208,90,71,47,49,24,18,7,34,14,20,0,0,13,4,9
"2021","Salford 005D","E01005677",682,218,82,136,430,67,194,65,75,54,84,38,37,9,76,47,29,9,9,34,16,18
"2021","Salford 006A","E01005686",636,211,79,132,383,39,143,49,55,39,98,39,52,7,97,60,37,6,6,42,18,24
"2021","Salford 006B","E01005688",652,169,84,85,451,72,181,50,87,44,88,31,47,10,107,70,37,3,3,32,14,18
"2021","Salford 006C","E01005691",667,226,127,99,414,106,189,75,57,57,66,34,26,6,53,26,27,0,0,27,15,12
"2021","Salford 006D","E01005692",734,375,119,256,335,38,98,30,40,28,92,46,42,4,99,71,28,8,8,24,9,15
"2021","Salford 007A","E01005711",628,196,76,120,404,80,174,60,78,36,94,57,28,9,54,34,20,2,2,28,14,14
"2021","Salford 007B","E01005712",840,323,94,229,475,40,172,54,77,41,150,92,54,4,105,68,37,8,8,42,24,18
"2021","Salford 007C","E01005713",705,161,107,54,523,118,247,98,103,46,106,59,41,6,50,32,18,2,2,21,11,10
"2021","Salford 007D","E01005714",699,183,83,100,488,50,188,50,96,42,120,59,46,15,119,80,39,11,11,28,12,16
"2021","Salford 007E","E01005715",757,213,101,112,511,88,248,77,125,46,113,62,47,4,57,27,30,5,5,33,13,20
"2021","Salford 007F","E01005718",792,325,116,209,434,67,182,79,66,37,99,52,45,2,84,46,38,2,2,33,9,24
"2021","Salford 008A","E01005673",659,209,56,153,410,43,162,55,69,38,90,45,38,7,109,73,36,6,6,40,12,28
"2021","Salford 008C","E01005678",650,168,55,113,441,30,141,53,57,31,84,36,38,10,180,134,46,6,6,41,13,28
"2021","Salford 008D","E01005679",665,210,65,145,415,25,125,34,64,27,92,40,50,2,166,130,36,7,7,40,18,22
"2021","Salford 008E","E01033978",405,103,23,80,272,16,131,39,68,24,72,38,32,2,48,38,10,5,5,30,16,14
"2021","Salford 008F","E01033979",469,124,28,96,312,17,106,27,58,21,114,60,50,4,72,51,21,3,3,33,20,13
"2021","Salford 009A","E01005687",809,266,106,160,501,36,219,76,105,38,146,91,50,5,96,66,30,4,4,42,14,28
"2021","Salford 009B","E01005689",526,148,62,86,352,13,143,34,74,35,73,25,39,9,120,91,29,3,3,26,13,13
"2021","Salford 009C","E01005690",691,204,80,124,438,56,194,73,74,47,105,64,37,4,82,38,44,1,1,49,10,39
"2021","Salford 009D","E01005693",634,194,96,98,409,48,165,55,71,39,104,48,50,6,91,57,34,1,1,31,15,16
"2021","Salford 010A","E01005646",550,151,81,70,319,47,213,47,151,15,27,17,8,2,29,22,7,3,3,80,61,19
"2021","Salford 010B","E01005649",643,219,97,122,397,83,259,69,175,15,19,16,3,0,35,21,14,1,1,27,11,16
"2021","Salford 010C","E01005650",629,274,87,187,324,22,216,35,160,21,37,17,18,2,48,39,9,1,1,31,12,19
"2021","Salford 010D","E01005651",555,97,39,58,414,31,307,51,217,39,27,11,14,2,44,23,21,5,5,44,23,21
"2021","Salford 011A","E01005647",626,279,110,169,324,49,201,59,120,22,34,26,7,1,38,24,14,2,2,23,5,18
"2021","Salford 011B","E01005648",1024,369,90,279,597,53,325,113,179,33,113,76,31,6,89,59,30,17,17,58,30,28
"2021","Salford 011C","E01005652",565,138,45,93,380,26,166,40,94,32,80,30,39,11,106,60,46,2,2,47,33,14
"2021","Salford 011D","E01005653",592,159,54,105,364,20,130,34,70,26,69,32,28,9,127,81,46,18,18,69,27,42
"2021","Salford 012A","E01005671",756,315,118,197,393,39,150,48,79,23,87,49,33,5,112,68,44,5,5,48,19,29
"2021","Salford 012B","E01005674",624,184,72,112,400,32,174,48,87,39,88,43,37,8,101,58,43,5,5,40,19,21
"2021","Salford 012C","E01005694",686,155,61,94,504,57,247,78,106,63,109,45,56,8,90,49,41,1,1,27,16,11
"2021","Salford 012D","E01005696",714,156,68,88,528,53,235,97,106,32,128,63,61,4,109,75,34,3,3,30,19,11
"2021","Salford 012E","E01005698",782,304,134,170,427,33,149,40,78,31,86,39,42,5,155,109,46,4,4,51,24,27
"2021","Salford 012F","E01005700",656,190,77,113,432,45,178,63,70,45,90,57,29,4,113,70,43,6,6,34,13,21
"2021","Salford 013A","E01005716",671,133,70,63,516,105,270,98,100,72,85,42,37,6,55,36,19,1,1,22,7,15
"2021","Salford 013B","E01005717",561,77,34,43,464,49,311,85,166,60,49,23,24,2,50,35,15,5,5,20,7,13
"2021","Salford 013C","E01005734",625,213,103,110,388,52,166,49,79,38,83,43,30,10,82,52,30,5,5,24,11,13
"2021","Salford 013D","E01005735",597,144,94,50,437,95,229,70,109,50,63,24,34,5,49,26,23,1,1,16,7,9
"2021","Salford 013E","E01005736",624,189,112,77,420,88,178,59,83,36,95,53,34,8,56,40,16,3,3,15,6,9
"2021","Salford 013F","E01005737",589,104,66,38,452,108,255,76,117,62,64,36,26,2,25,10,15,0,0,33,15,18
"2021","Salford 013G","E01005739",786,172,79,93,579,62,329,97,189,43,118,65,45,8,65,38,27,5,5,35,16,19
"2021","Salford 014A","E01005695",628,145,84,61,462,75,263,78,138,47,77,33,40,4,44,24,20,3,3,21,8,13
"2021","Salford 014B","E01005697",649,180,97,83,448,80,234,78,115,41,78,34,41,3,54,35,19,2,2,21,9,12
"2021","Salford 014C","E01005738",824,229,129,100,568,108,288,95,134,59,119,80,36,3,51,31,20,2,2,27,14,13
"2021","Salford 014D","E01005740",699,219,119,100,464,102,249,82,147,20,67,32,29,6,44,26,18,2,2,16,9,7
"2021","Salford 014E","E01005741",684,178,119,59,489,88,303,94,159,50,65,27,33,5,32,18,14,1,1,17,8,9
"2021","Salford 014F","E01005742",665,193,90,103,448,71,219,52,124,43,87,48,32,7,67,42,25,4,4,24,9,15
"2021","Salford 015A","E01005625",605,182,89,93,392,54,178,53,76,49,95,63,28,4,62,37,25,3,3,31,13,18
"2021","Salford 015B","E01005627",473,120,69,51,318,50,156,49,65,42,68,30,31,7,40,19,21,4,4,35,16,19
"2021","Salford 015C","E01005699",755,215,95,120,518,80,250,72,113,65,112,55,57,0,76,49,27,0,0,22,14,8
"2021","Salford 015D","E01005701",713,164,87,77,508,89,267,73,133,61,90,46,39,5,60,29,31,2,2,41,9,32
"2021","Salford 017A","E01005624",719,210,72,138,449,34,157,57,79,21,96,35,51,10,151,103,48,11,11,60,36,24
"2021","Salford 017B","E01005680",794,380,68,312,360,14,115,36,51,28,75,45,24,6,144,92,52,12,12,54,20,34
"2021","Salford 017C","E01005683",890,285,101,184,528,17,154,52,73,29,101,50,47,4,247,190,57,9,9,77,22,55
"2021","Salford 017G","E01033980",428,119,19,100,228,2,74,23,45,6,78,51,21,6,68,55,13,6,6,81,11,70
"2021","Salford 017H","E01033981",737,210,60,150,295,19,83,31,39,13,73,45,19,9,101,64,37,19,19,232,23,209
"2021","Salford 018A","E01005622",665,205,92,113,385,19,132,46,62,24,140,79,55,6,85,57,28,9,9,75,12,63
"2021","Salford 018B","E01005623",493,111,55,56,320,44,153,47,65,41,77,37,33,7,43,28,15,3,3,62,26,36
"2021","Salford 018C","E01005626",517,126,69,57,363,49,193,66,72,55,69,32,31,6,46,19,27,6,6,28,14,14
"2021","Salford 018D","E01005628",663,219,71,148,338,52,144,58,57,29,80,52,24,4,53,24,29,9,9,106,17,89
"2021","Salford 019A","E01005725",559,177,63,114,337,30,109,23,57,29,78,24,43,11,115,69,46,5,5,45,25,20
"2021","Salford 019B","E01005726",617,197,65,132,377,33,159,59,66,34,103,48,42,13,74,52,22,8,8,43,17,26
"2021","Salford 019C","E01005727",649,249,54,195,372,23,153,71,56,26,116,88,25,3,71,45,26,9,9,28,8,20
"2021","Salford 019D","E01005728",763,207,93,114,512,61,227,68,113,46,133,77,52,4,89,53,36,2,2,44,13,31
"2021","Salford 019E","E01005733",497,116,53,63,323,25,117,37,61,19,80,40,32,8,99,63,36,2,2,58,42,16
"2021","Salford 020A","E01005631",1041,723,277,446,277,26,88,37,40,11,77,53,19,5,69,36,33,17,17,41,7,34
"2021","Salford 020B","E01005632",1114,445,123,322,576,38,238,62,144,32,202,160,37,5,89,66,23,9,9,93,27,66
"2021","Salford 020C","E01005633",607,188,77,111,371,34,162,37,75,50,73,30,30,13,97,57,40,5,5,48,19,29
"2021","Salford 020D","E01005634",665,169,78,91,471,69,248,76,128,44,113,63,44,6,39,19,20,2,2,25,10,15
"2021","Salford 020E","E01005635",679,270,76,194,359,47,177,58,82,37,88,61,24,3,42,19,23,5,5,50,19,31
"2021","Salford 020F","E01005636",701,244,104,140,402,73,204,54,99,51,89,65,19,5,32,12,20,4,4,55,15,40
"2021","Salford 020G","E01005637",659,209,98,111,399,39,164,56,81,27,126,87,36,3,65,34,31,5,5,51,9,42
"2021","Salford 021A","E01005629",673,235,128,107,385,36,190,64,94,32,83,56,23,4,70,35,35,6,6,53,16,37
"2021","Salford 021B","E01005630",649,211,82,129,387,31,157,46,85,26,107,62,37,8,89,48,41,3,3,51,17,34
"2021","Salford 021C","E01005719",1013,431,133,298,457,34,171,67,80,24,134,110,21,3,99,64,35,19,19,125,21,104
"2021","Salford 021E","E01005722",796,226,88,138,490,21,182,51,94,37,154,91,50,13,120,76,44,13,13,80,32,48
"2021","Salford 021F","E01005723",655,197,84,113,383,17,146,35,77,34,100,60,30,10,114,74,40,6,6,75,24,51
"2021","Salford 021G","E01005724",637,229,121,108,381,62,205,70,85,50,74,44,26,4,36,14,22,4,4,27,7,20
"2021","Salford 021H","E01033982",760,232,84,148,447,29,140,46,69,25,99,56,40,3,168,123,45,11,11,81,21,60
"2021","Salford 021I","E01033983",641,263,19,244,311,7,74,36,32,6,142,120,20,2,76,58,18,12,12,67,12,55
"2021","Salford 023A","E01005654",925,328,56,272,460,11,139,47,76,16,157,134,20,3,133,94,39,20,20,137,28,109
"2021","Salford 023B","E01005656",713,229,65,164,360,23,88,34,30,24,114,71,37,6,127,96,31,8,8,124,38,86
"2021","Salford 023C","E01005657",753,267,123,144,390,29,134,52,47,35,111,50,56,5,102,53,49,14,14,96,20,76
"2021","Salford 023D","E01005721",785,359,126,233,377,53,140,63,46,31,83,56,18,9,95,54,41,6,6,49,12,37
"2021","Salford 024C","E01005681",551,269,109,160,232,27,60,22,23,15,45,29,13,3,89,65,24,11,11,50,8,42
"2021","Salford 024D","E01005682",1000,599,145,454,354,12,137,36,93,8,74,41,24,9,113,78,35,18,18,47,25,22
"2021","Salford 024E","E01033984",997,300,81,219,593,21,193,48,113,32,150,86,51,13,215,141,74,14,14,104,39,65
"2021","Salford 025A","E01005729",777,386,96,290,339,13,79,27,37,15,73,28,35,10,166,106,60,8,8,52,36,16
"2021","Salford 025B","E01005730",731,230,71,159,461,43,192,63,89,40,111,57,47,7,111,81,30,4,4,40,18,22
"2021","Salford 025C","E01005731",587,157,67,90,384,22,147,36,78,33,79,25,42,12,123,86,37,13,13,46,22,24
"2021","Salford 025D","E01005732",544,199,63,136,301,32,116,46,43,27,73,31,36,6,75,41,34,5,5,44,21,23
"2021","Salford 026A","E01005599",871,336,86,250,472,24,170,57,80,33,115,78,34,3,121,80,41,42,42,63,19,44
"2021","Salford 026B","E01005600",889,274,47,227,541,25,205,76,103,26,196,133,52,11,107,87,20,8,8,74,24,50
"2021","Salford 026C","E01005601",680,206,53,153,437,29,165,43,88,34,95,35,52,8,141,93,48,7,7,37,15,22
"2021","Salford 026D","E01005602",890,439,121,318,407,17,130,50,63,17,100,50,45,5,149,110,39,11,11,44,15,29
"2021","Salford 027A","E01005603",750,209,48,161,480,18,168,49,91,28,129,68,50,11,157,118,39,8,8,61,21,40
"2021","Salford 027B","E01005604",727,243,104,139,436,40,179,62,81,36,105,42,53,10,104,66,38,8,8,48,15,33
"2021","Salford 027C","E01005605",735,248,74,174,436,29,149,51,67,31,113,53,54,6,139,87,52,6,6,51,15,36
"2021","Salford 027D","E01005638",974,378,69,309,504,16,166,66,70,30,177,112,58,7,135,96,39,10,10,92,26,66
"2021","Salford 029A","E01005639",568,153,57,96,384,16,96,26,52,18,81,22,55,4,188,149,39,3,3,31,15,16
"2021","Salford 029B","E01005640",527,134,57,77,350,27,128,41,59,28,81,20,51,10,111,68,43,3,3,43,19,24
"2021","Salford 029C","E01005641",619,230,133,97,359,51,116,35,47,34,86,39,40,7,105,60,45,1,1,30,15,15
"2021","Salford 029D","E01005642",504,121,44,77,356,56,168,62,64,42,68,31,34,3,62,51,11,2,2,27,15,12
"2021","Salford 029E","E01005643",666,259,148,111,383,101,156,63,47,46,72,38,31,3,49,28,21,5,5,24,8,16
"2021","Salford 029F","E01005644",610,151,55,96,435,46,210,58,94,58,102,48,44,10,73,43,30,4,4,24,12,12
"2021","Salford 029G","E01005645",591,164,105,59,402,99,213,75,76,62,55,19,30,6,34,14,20,1,1,25,7,18
"2021","Salford 030A","E01005616",609,204,96,108,374,51,145,43,64,38,73,23,42,8,103,61,42,2,2,31,16,15
"2021","Salford 030B","E01005617",605,152,66,86,424,57,188,69,84,35,91,35,46,10,87,49,38,1,1,29,13,16
"2021","Salford 030C","E01005618",916,287,113,174,597,46,239,77,120,42,143,72,62,9,161,117,44,8,8,32,14,18
"2021","Salford 030D","E01005619",513,148,67,81,337,46,145,52,57,36,72,25,39,8,68,36,32,6,6,28,16,12
"2021","Salford 030E","E01005620",1047,293,82,211,710,68,335,86,187,62,161,86,63,12,142,97,45,4,4,44,23,21
"2021","Salford 030F","E01005621",790,317,117,200,433,49,148,52,65,31,125,52,65,8,108,79,29,3,3,40,20,20
"2021","Salford 031B","E01005612",1051,548,150,398,463,25,235,58,156,21,65,26,33,6,119,76,43,19,19,40,22,18
"2021","Salford 031A","E01005613",997,407,62,345,504,25,252,51,176,25,56,18,30,8,152,101,51,19,19,86,37,49
"2021","Salford 031C","E01005614",619,98,30,68,489,22,373,35,318,20,26,9,17,0,62,46,16,6,6,32,21,11
"2021","Salford 032C","E01005611",1050,386,96,290,487,32,173,59,88,26,103,59,35,9,157,105,52,22,22,177,41,136
"2021","Salford 032D","E01005615",685,187,65,122,395,20,213,28,164,21,66,35,24,7,76,52,24,20,20,103,38,65
"2021","Salford 032A","E01033985",677,225,44,181,364,11,125,34,72,19,94,53,33,8,117,74,43,17,17,88,21,67
"2021","Salford 032B","E01033986",661,226,20,206,338,7,157,51,98,8,113,89,21,3,50,37,13,11,11,97,21,76
"2021","Salford 033F","E01032909",1043,466,8,458,350,0,78,55,21,2,223,217,6,0,8,4,4,41,41,227,2,225
"2021","Salford 033E","E01033330",824,491,100,391,277,6,118,47,52,19,67,44,18,5,72,38,34,14,14,56,9,47
"2021","Salford 033A","E01033987",581,164,6,158,284,2,66,40,23,3,165,156,9,0,27,17,10,24,24,133,3,130
"2021","Salford 033B","E01033988",843,415,2,413,282,1,38,28,10,0,178,175,3,0,39,37,2,26,26,146,0,146
"2021","Salford 033C","E01033989",675,315,11,304,253,3,65,42,18,5,145,141,4,0,15,11,4,25,25,107,3,104
"2021","Salford 033D","E01033990",670,229,4,225,262,1,41,29,12,0,144,140,3,1,11,6,5,65,65,179,4,175
"2021","Salford 034C","E01005610",478,122,41,81,278,11,85,21,54,10,64,26,31,7,108,76,32,10,10,78,19,59
"2021","Salford 034D","E01032684",630,244,37,207,288,5,104,39,56,9,106,82,21,3,67,49,18,6,6,98,8,90
"2021","Salford 034E","E01032906",1138,553,33,520,405,1,115,65,42,8,217,206,9,2,49,33,16,23,23,180,11,169
"2021","Salford 034A","E01033991",791,318,41,277,362,4,123,36,50,37,149,119,26,4,65,47,18,21,21,111,7,104
"2021","Salford 034B","E01033992",754,270,1,269,312,0,78,39,38,1,207,203,4,0,10,7,3,17,17,172,1,171
"2021","Salford 035C","E01005667",1032,386,90,296,499,33,146,42,70,34,137,91,35,11,165,104,61,18,18,147,33,114
"2021","Salford 035B","E01032912",977,373,101,272,495,35,122,29,69,24,131,86,41,4,187,148,39,20,20,109,29,80
"2021","Salford 035A","E01032914",1145,493,18,475,492,2,138,70,61,7,259,197,61,1,66,51,15,27,27,160,14,146
"2021","Salford 036C","E01032915",945,315,73,242,456,19,170,46,65,59,140,108,28,4,113,75,38,14,14,174,29,145
"2021","Salford 036A","E01033993",891,237,29,208,336,7,69,34,32,3,169,154,14,1,48,35,13,43,43,318,7,311
"2021","Salford 036B","E01033994",637,204,3,201,215,1,35,23,10,2,151,148,3,0,6,2,4,22,22,218,0,218
"2021","Salford 037A","E01033995",716,318,9,309,295,2,100,67,29,4,152,148,3,1,13,5,8,28,28,103,3,100
"2021","Salford 037B","E01033996",704,312,12,300,319,16,110,71,34,5,158,147,11,0,13,5,8,22,22,73,4,69
"2021","Salford 037C","E01033997",624,317,17,300,211,3,71,33,36,2,119,114,5,0,9,4,5,9,9,96,3,93
"2021","Salford 037D","E01033998",748,285,15,270,330,11,90,60,25,5,195,191,4,0,19,10,9,15,15,133,2,131
"2021","Salford 037E","E01033999",668,226,9,217,296,3,98,43,54,1,162,153,9,0,10,3,7,23,23,146,5,141
"2021","Stockport 001A","E01005886",682,253,52,201,401,30,147,48,59,40,97,50,41,6,121,77,44,6,6,28,10,18
"2021","Stockport 001B","E01005888",592,145,62,83,408,37,193,57,83,53,75,33,34,8,97,66,31,6,6,39,24,15
"2021","Stockport 001C","E01005889",674,253,107,146,385,49,150,59,58,33,77,43,31,3,103,68,35,6,6,36,14,22
"2021","Stockport 001D","E01005891",573,191,98,93,355,88,162,69,54,39,59,30,26,3,41,20,21,5,5,27,14,13
"2021","Stockport 001E","E01005894",567,145,73,72,395,43,158,54,66,38,107,46,51,10,82,46,36,5,5,27,13,14
"2021","Stockport 002A","E01005887",659,176,57,119,449,26,182,53,91,38,91,34,48,9,146,111,35,4,4,34,16,18
"2021","Stockport 002B","E01005890",588,149,58,91,397,35,162,53,79,30,84,35,37,12,110,72,38,6,6,42,28,14
"2021","Stockport 002C","E01005893",1095,428,86,342,626,43,182,64,81,37,264,193,63,8,127,87,40,10,10,41,15,26
"2021","Stockport 002D","E01005896",783,273,62,211,465,37,157,71,60,26,116,60,47,9,149,111,38,6,6,45,11,34
"2021","Stockport 002E","E01005919",701,283,79,204,379,20,128,49,58,21,89,46,35,8,136,94,42,6,6,39,21,18
"2021","Stockport 003A","E01005862",593,139,69,70,439,50,272,80,135,57,68,37,26,5,47,24,23,2,2,15,8,7
"2021","Stockport 003B","E01005892",551,156,56,100,366,49,144,45,69,30,88,51,33,4,82,45,37,3,3,29,10,19
"2021","Stockport 003C","E01005895",485,145,75,70,313,35,133,49,53,31,56,19,32,5,86,52,34,3,3,27,15,12
"2021","Stockport 003D","E01005920",631,132,72,60,460,53,256,84,114,58,95,52,38,5,54,30,24,2,2,39,14,25
"2021","Stockport 003E","E01005921",713,280,83,197,398,29,148,61,57,30,100,59,38,3,113,76,37,8,8,35,10,25
"2021","Stockport 003F","E01005922",615,201,78,123,391,79,161,66,61,34,94,53,33,8,54,23,31,3,3,23,7,16
"2021","Stockport 004A","E01005753",688,195,83,112,449,26,134,36,55,43,90,34,49,7,191,138,53,8,8,44,25,19
"2021","Stockport 004B","E01005754",1037,545,97,448,451,18,108,37,38,33,108,48,51,9,207,158,49,10,10,41,16,25
"2021","Stockport 004C","E01005755",720,243,61,182,443,22,149,37,64,48,101,34,60,7,169,129,40,2,2,34,14,20
"2021","Stockport 004D","E01005756",1039,382,50,332,616,18,187,71,99,17,194,104,80,10,211,161,50,6,6,41,24,17
"2021","Stockport 005A","E01005745",600,167,69,98,402,68,194,74,80,40,75,34,32,9,60,34,26,5,5,31,7,24
"2021","Stockport 005B","E01005746",783,427,177,250,338,76,134,58,51,25,66,31,27,8,60,33,27,2,2,18,8,10
"2021","Stockport 005C","E01005747",589,152,69,83,419,69,230,68,112,50,75,45,30,0,44,17,27,1,1,18,9,9
"2021","Stockport 005D","E01005748",661,182,115,67,454,120,241,81,99,61,69,34,30,5,23,11,12,1,1,25,8,17
"2021","Stockport 006A","E01005863",768,279,150,129,447,56,271,93,142,36,89,60,25,4,30,13,17,1,1,42,14,28
"2021","Stockport 006B","E01005864",641,199,61,138,409,41,241,74,132,35,93,57,30,6,29,12,17,5,5,33,8,25
"2021","Stockport 006C","E01005866",797,344,90,254,404,33,209,76,106,27,108,72,30,6,45,23,22,9,9,49,17,32
"2021","Stockport 006D","E01005869",656,187,115,72,431,69,230,67,118,45,77,37,32,8,52,26,26,3,3,38,15,23
"2021","Stockport 007A","E01005914",672,248,84,164,403,54,171,61,75,35,98,44,46,8,76,38,38,4,4,21,11,10
"2021","Stockport 007B","E01005915",715,257,74,183,421,30,154,55,64,35,120,70,39,11,109,67,42,8,8,37,23,14
"2021","Stockport 007C","E01005916",727,240,63,177,448,44,179,59,83,37,119,78,36,5,88,59,29,18,18,39,15,24
"2021","Stockport 007D","E01005917",901,369,84,285,483,22,145,62,63,20,154,113,32,9,141,103,38,21,21,49,19,30
"2021","Stockport 008A","E01005859",631,230,74,156,376,34,223,70,118,35,81,60,16,5,31,20,11,7,7,25,10,15
"2021","Stockport 008B","E01005865",773,179,73,106,560,91,334,87,197,50,74,46,28,0,59,38,21,2,2,34,15,19
"2021","Stockport 008C","E01005867",644,220,111,109,403,78,222,61,133,28,67,39,27,1,34,20,14,2,2,21,8,13
"2021","Stockport 008D","E01005868",608,184,114,70,389,74,207,51,124,32,55,22,27,6,50,21,29,3,3,35,20,15
"2021","Stockport 009A","E01005743",567,168,96,72,373,70,184,70,59,55,65,28,32,5,54,25,29,0,0,26,8,18
"2021","Stockport 009B","E01005744",653,224,96,128,399,43,152,51,63,38,96,44,47,5,104,66,38,4,4,30,13,17
"2021","Stockport 009C","E01005749",733,211,100,111,498,79,221,68,107,46,104,52,42,10,87,49,38,7,7,24,8,16
"2021","Stockport 009D","E01005750",698,178,77,101,497,53,244,86,100,58,123,64,54,5,73,46,27,4,4,23,10,13
"2021","Stockport 009E","E01005751",615,189,75,114,400,46,165,58,74,33,120,58,52,10,68,40,28,1,1,26,13,13
"2021","Stockport 010A","E01005897",597,155,82,73,414,51,173,45,95,33,92,48,39,5,98,55,43,0,0,28,16,12
"2021","Stockport 010B","E01005898",737,218,126,92,486,93,230,72,102,56,88,37,40,11,72,42,30,3,3,33,13,20
"2021","Stockport 010C","E01005900",789,308,158,150,460,90,183,70,73,40,90,44,35,11,94,70,24,3,3,21,8,13
"2021","Stockport 010D","E01005903",632,144,92,52,463,127,242,95,84,63,52,30,17,5,40,15,25,2,2,25,7,18
"2021","Stockport 010E","E01005904",670,222,148,74,426,87,232,65,130,37,65,30,32,3,41,22,19,1,1,22,6,16
"2021","Stockport 011A","E01005853",670,212,87,125,426,30,217,65,109,43,77,38,30,9,99,56,43,3,3,32,20,12
"2021","Stockport 011B","E01005856",653,177,80,97,445,57,241,63,136,42,68,37,28,3,72,41,31,7,7,31,15,16
"2021","Stockport 011C","E01005860",589,115,60,55,453,58,266,76,153,37,70,38,27,5,49,32,17,10,10,21,10,11
"2021","Stockport 011D","E01005861",712,274,134,140,414,57,236,79,122,35,66,30,32,4,54,28,26,1,1,24,11,13
"2021","Stockport 012A","E01005752",630,230,108,122,381,48,144,36,69,39,76,33,35,8,110,73,37,3,3,19,11,8
"2021","Stockport 012B","E01005899",751,298,188,110,423,109,190,60,96,34,65,40,23,2,57,39,18,2,2,30,12,18
"2021","Stockport 012C","E01005901",627,182,127,55,427,121,195,69,66,60,67,37,29,1,42,14,28,2,2,18,6,12
"2021","Stockport 012D","E01005902",739,256,129,127,461,59,168,69,64,35,89,40,35,14,143,107,36,2,2,22,9,13
"2021","Stockport 012E","E01005905",599,197,60,137,376,29,116,36,59,21,95,37,51,7,133,102,31,3,3,26,11,15
"2021","Stockport 013A","E01005852",684,237,98,139,412,57,200,74,81,45,104,69,32,3,49,29,20,2,2,35,15,20
"2021","Stockport 013B","E01005854",721,211,112,99,491,55,272,60,166,46,115,66,42,7,48,28,20,1,1,19,11,8
"2021","Stockport 013C","E01005855",583,163,95,68,397,56,270,81,143,46,42,16,25,1,27,11,16,2,2,23,12,11
"2021","Stockport 013D","E01005857",619,188,106,82,378,60,224,53,127,44,40,23,15,2,51,29,22,3,3,53,39,14
"2021","Stockport 013E","E01005858",787,316,123,193,450,60,222,81,97,44,106,83,21,2,56,28,28,6,6,21,6,15
"2021","Stockport 014A","E01005757",724,235,60,175,453,29,189,103,62,24,108,59,46,3,123,81,42,4,4,36,15,21
"2021","Stockport 014C","E01005766",800,323,93,230,405,24,134,47,68,19,110,62,42,6,131,103,28,6,6,72,20,52
"2021","Stockport 014D","E01005918",833,472,107,365,330,23,86,33,43,10,57,29,25,3,159,120,39,5,5,31,11,20
"2021","Stockport 014E","E01033947",858,434,69,365,377,14,109,50,46,13,124,89,29,6,121,74,47,9,9,47,7,40
"2021","Stockport 014F","E01033948",864,542,121,421,297,12,60,37,20,3,84,63,18,3,132,100,32,9,9,25,10,15
"2021","Stockport 015A","E01005870",607,185,70,115,398,34,163,54,71,38,105,57,44,4,93,66,27,3,3,24,12,12
"2021","Stockport 015B","E01005871",622,198,65,133,389,40,134,55,60,19,108,42,56,10,101,67,34,6,6,35,12,23
"2021","Stockport 015C","E01005873",582,143,70,73,418,46,210,62,94,54,89,36,46,7,69,35,34,4,4,21,8,13
"2021","Stockport 015D","E01005875",653,162,80,82,463,59,226,79,105,42,100,49,42,9,77,45,32,1,1,28,13,15
"2021","Stockport 016A","E01005764",777,272,97,175,481,28,159,70,65,24,146,88,50,8,136,94,42,12,12,24,6,18
"2021","Stockport 016B","E01005816",709,222,62,160,438,17,171,75,74,22,139,85,47,7,106,77,29,5,5,49,15,34
"2021","Stockport 016C","E01005817",661,238,65,173,387,24,158,60,79,19,115,81,31,3,84,51,33,6,6,36,9,27
"2021","Stockport 016D","E01005822",1036,506,103,403,459,14,120,53,49,18,133,92,36,5,174,113,61,18,18,71,27,44
"2021","Stockport 017A","E01005880",658,185,96,89,460,88,251,98,115,38,74,44,28,2,44,21,23,3,3,13,9,4
"2021","Stockport 017B","E01005881",494,91,63,28,388,117,214,79,97,38,40,15,23,2,15,8,7,2,2,15,7,8
"2021","Stockport 017C","E01005883",666,160,109,51,484,161,244,84,127,33,41,23,15,3,38,16,22,0,0,22,6,16
"2021","Stockport 017D","E01005908",639,123,86,37,491,102,303,98,147,58,54,30,24,0,32,17,15,0,0,25,13,12
"2021","Stockport 018A","E01005765",568,131,53,78,414,51,215,73,91,51,91,43,44,4,52,32,20,5,5,23,9,14
"2021","Stockport 018B","E01005818",551,129,41,88,393,23,172,52,85,35,100,51,43,6,95,68,27,3,3,29,16,13
"2021","Stockport 018C","E01005819",653,156,75,81,474,56,265,94,119,52,105,55,46,4,43,22,21,5,5,23,5,18
"2021","Stockport 018D","E01005820",645,214,81,133,399,26,192,73,89,30,110,71,35,4,66,52,14,5,5,32,18,14
"2021","Stockport 018E","E01005821",665,249,76,173,392,35,165,55,77,33,107,59,42,6,81,45,36,4,4,24,9,15
"2021","Stockport 018F","E01005823",706,235,69,166,432,29,186,59,102,25,108,54,46,8,106,73,33,3,3,39,16,23
"2021","Stockport 019A","E01005825",760,242,72,170,478,51,204,67,96,41,92,55,33,4,128,106,22,3,3,40,21,19
"2021","Stockport 019B","E01005872",800,306,83,223,453,49,168,66,72,30,139,81,54,4,93,54,39,4,4,41,15,26
"2021","Stockport 019C","E01005874",1041,536,138,398,462,28,154,68,59,27,120,70,44,6,149,112,37,11,11,43,14,29
"2021","Stockport 019D","E01005876",606,127,59,68,447,53,213,78,87,48,104,56,40,8,74,39,35,3,3,32,18,14
"2021","Stockport 019E","E01005877",767,233,91,142,509,51,219,68,102,49,88,49,33,6,149,117,32,2,2,25,6,19
"2021","Stockport 020A","E01005878",737,224,122,102,486,59,217,58,109,50,92,39,49,4,114,82,32,4,4,27,15,12
"2021","Stockport 020B","E01005879",587,184,96,88,382,54,179,61,90,28,74,36,35,3,74,50,24,1,1,21,7,14
"2021","Stockport 020C","E01005882",497,101,79,22,379,113,211,62,96,53,30,10,17,3,24,16,8,1,1,17,6,11
"2021","Stockport 020D","E01005884",591,127,95,32,442,112,240,82,102,56,49,26,17,6,39,20,19,2,2,22,5,17
"2021","Stockport 020E","E01005885",690,263,152,111,410,67,169,40,96,33,90,65,25,0,78,45,33,6,6,17,8,9
"2021","Stockport 021A","E01005832",637,205,103,102,411,69,200,73,78,49,72,31,34,7,70,37,33,0,0,21,8,13
"2021","Stockport 021B","E01005833",464,162,89,73,278,55,132,51,59,22,43,17,19,7,43,29,14,5,5,24,9,15
"2021","Stockport 021C","E01005835",578,151,87,64,406,86,236,87,87,62,58,32,21,5,26,11,15,0,0,21,12,9
"2021","Stockport 021D","E01005837",662,191,83,108,452,58,225,80,105,40,108,53,50,5,58,38,20,3,3,19,9,10
"2021","Stockport 021E","E01005843",594,137,84,53,432,91,229,74,101,54,65,31,26,8,46,31,15,1,1,25,14,11
"2021","Stockport 022A","E01005769",785,316,117,199,429,56,149,68,62,19,156,129,26,1,64,37,27,4,4,40,11,29
"2021","Stockport 022B","E01005778",602,166,67,99,414,52,197,66,90,41,104,63,34,7,58,32,26,3,3,22,9,13
"2021","Stockport 022C","E01005779",592,148,86,62,414,36,233,66,113,54,76,36,33,7,66,44,22,3,3,30,16,14
"2021","Stockport 022D","E01005780",569,113,45,68,431,34,247,71,129,47,89,38,45,6,55,32,23,6,6,25,13,12
"2021","Stockport 022E","E01005781",905,493,161,332,392,28,137,46,62,29,83,41,40,2,139,93,46,5,5,20,5,15
"2021","Stockport 023A","E01005759",726,203,65,138,494,41,207,68,98,41,123,62,57,4,112,71,41,11,11,29,10,19
"2021","Stockport 023B","E01005760",876,322,83,239,516,26,193,60,103,30,154,90,63,1,134,102,32,9,9,38,14,24
"2021","Stockport 023C","E01005797",676,239,57,182,411,15,146,49,74,23,123,83,30,10,124,96,28,3,3,26,4,22
"2021","Stockport 023D","E01005800",685,192,104,88,472,63,254,76,133,45,96,56,33,7,57,26,31,2,2,21,7,14
"2021","Stockport 023E","E01005804",464,150,53,97,294,23,141,45,73,23,60,37,21,2,67,46,21,3,3,20,7,13
"2021","Stockport 024A","E01005824",617,169,103,66,414,60,210,60,105,45,82,40,37,5,55,27,28,7,7,34,18,16
"2021","Stockport 024B","E01005826",633,200,92,108,398,43,118,31,57,30,85,28,48,9,149,113,36,3,3,35,23,12
"2021","Stockport 024C","E01005827",740,199,116,83,499,95,262,95,113,54,89,37,44,8,52,25,27,1,1,42,19,23
"2021","Stockport 024D","E01005828",570,198,73,125,349,25,94,21,56,17,63,19,36,8,164,126,38,3,3,23,12,11
"2021","Stockport 024E","E01005829",491,138,45,93,333,31,134,37,61,36,57,27,22,8,105,67,38,6,6,20,11,9
"2021","Stockport 025A","E01005768",758,158,81,77,556,78,342,89,190,63,78,44,32,2,57,34,23,1,1,44,24,20
"2021","Stockport 025B","E01005770",637,204,129,75,403,76,224,67,131,26,54,27,23,4,48,33,15,1,1,30,14,16
"2021","Stockport 025C","E01005771",569,148,71,77,387,40,244,69,131,44,56,33,19,4,43,19,24,4,4,34,19,15
"2021","Stockport 025D","E01005775",642,171,110,61,439,66,282,63,177,42,51,33,14,4,37,18,19,3,3,32,17,15
"2021","Stockport 026A","E01005761",543,160,70,90,351,23,184,55,87,42,64,26,35,3,79,58,21,1,1,32,17,15
"2021","Stockport 026B","E01005762",799,235,80,155,527,31,195,67,85,43,129,62,55,12,164,106,58,8,8,37,22,15
"2021","Stockport 026C","E01005763",644,169,60,109,428,37,178,53,93,32,65,25,36,4,141,97,44,7,7,47,24,23
"2021","Stockport 026D","E01005799",696,189,38,151,455,16,161,39,98,24,102,37,54,11,169,117,52,7,7,52,29,23
"2021","Stockport 027A","E01005798",808,393,159,234,387,49,188,67,87,34,82,53,23,6,63,28,35,5,5,28,11,17
"2021","Stockport 027B","E01005801",894,251,94,157,607,40,310,68,201,41,145,82,58,5,109,71,38,3,3,36,10,26
"2021","Stockport 027C","E01005802",602,152,64,88,428,41,255,68,137,50,76,39,34,3,50,20,30,6,6,22,10,12
"2021","Stockport 027D","E01005803",592,151,96,55,426,68,272,106,115,51,60,33,24,3,25,16,9,1,1,15,11,4
"2021","Stockport 027E","E01005830",704,230,111,119,454,56,208,72,97,39,104,62,36,6,81,50,31,5,5,20,11,9
"2021","Stockport 027F","E01005831",676,186,61,125,447,38,212,66,107,39,112,60,45,7,84,47,37,1,1,43,21,22
"2021","Stockport 028A","E01005767",597,119,92,27,426,132,237,66,103,68,24,12,9,3,32,16,16,1,1,52,30,22
"2021","Stockport 028B","E01005772",565,146,91,55,376,69,222,44,123,55,34,19,13,2,46,24,22,5,5,43,28,15
"2021","Stockport 028C","E01005773",655,194,112,82,424,71,237,63,131,43,62,31,26,5,52,25,27,2,2,37,10,27
"2021","Stockport 028D","E01005774",729,327,152,175,361,34,156,46,80,30,85,46,36,3,83,49,34,3,3,41,16,25
"2021","Stockport 028E","E01005776",615,138,97,41,431,84,267,51,149,67,29,17,11,1,51,29,22,0,0,46,31,15
"2021","Stockport 029A","E01005909",658,163,115,48,477,116,263,99,118,46,51,26,20,5,47,29,18,0,0,18,10,8
"2021","Stockport 029B","E01005910",758,302,177,125,425,71,165,60,68,37,103,48,51,4,82,52,30,4,4,31,14,17
"2021","Stockport 029C","E01005911",542,153,104,49,366,103,196,60,82,54,35,15,18,2,30,12,18,2,2,23,12,11
"2021","Stockport 029D","E01005912",663,194,109,85,444,98,198,72,99,27,93,57,33,3,53,32,21,2,2,25,13,12
"2021","Stockport 030A","E01005782",581,174,96,78,380,93,168,78,65,25,67,37,27,3,52,30,22,0,0,27,10,17
"2021","Stockport 030B","E01005783",732,273,144,129,441,111,204,51,107,46,60,38,20,2,64,36,28,2,2,18,4,14
"2021","Stockport 030C","E01005784",550,107,64,43,412,97,242,56,147,39,40,18,20,2,33,16,17,0,0,31,19,12
"2021","Stockport 030D","E01005785",659,169,104,65,462,68,287,71,170,46,47,23,22,2,60,27,33,0,0,28,12,16
"2021","Stockport 030E","E01005786",810,294,92,202,479,60,291,72,179,40,86,51,28,7,39,19,20,3,3,37,11,26
"2021","Stockport 031A","E01005834",630,183,86,97,409,38,187,52,95,40,79,34,38,7,95,61,34,10,10,38,20,18
"2021","Stockport 031B","E01005836",847,306,152,154,511,107,226,84,102,40,88,53,26,9,85,48,37,5,5,30,15,15
"2021","Stockport 031C","E01005838",892,382,165,217,478,53,193,61,105,27,136,89,39,8,92,61,31,4,4,32,9,23
"2021","Stockport 031D","E01005840",765,286,128,158,451,66,177,50,95,32,114,72,39,3,89,64,25,5,5,28,13,15
"2021","Stockport 032A","E01005927",491,82,50,32,386,68,253,72,140,41,36,15,20,1,27,6,21,2,2,23,11,12
"2021","Stockport 032B","E01005928",672,193,91,102,448,43,200,44,108,48,93,41,42,10,108,75,33,4,4,31,13,18
"2021","Stockport 032C","E01005929",599,153,96,57,421,129,224,75,115,34,39,23,12,4,26,15,11,3,3,25,15,10
"2021","Stockport 032D","E01005930",598,86,65,21,498,140,297,78,162,57,30,13,15,2,29,14,15,2,2,14,11,3
"2021","Stockport 033A","E01005806",498,114,81,33,362,86,168,47,77,44,62,34,25,3,46,26,20,0,0,22,12,10
"2021","Stockport 033B","E01005813",598,173,96,77,402,91,205,75,93,37,59,29,27,3,47,25,22,0,0,23,9,14
"2021","Stockport 033C","E01005814",541,144,115,29,383,98,220,57,108,55,38,17,20,1,27,10,17,0,0,14,3,11
"2021","Stockport 033D","E01005815",583,133,95,38,426,83,228,66,113,49,69,37,25,7,46,21,25,0,0,24,11,13
"2021","Stockport 034A","E01005777",711,266,125,141,415,53,178,51,98,29,89,51,34,4,92,50,42,3,3,30,13,17
"2021","Stockport 034B","E01005787",481,73,56,17,382,75,259,66,132,61,33,17,16,0,15,7,8,0,0,26,17,9
"2021","Stockport 034C","E01005788",622,144,64,80,455,79,260,65,141,54,64,27,33,4,50,26,24,2,2,23,8,15
"2021","Stockport 034D","E01005790",506,166,89,77,319,42,171,42,99,30,41,14,26,1,62,35,27,3,3,21,6,15
"2021","Stockport 035A","E01005805",585,116,81,35,445,72,276,73,140,63,65,32,32,1,32,16,16,0,0,24,13,11
"2021","Stockport 035B","E01005807",624,137,101,36,464,112,265,86,130,49,46,22,20,4,40,14,26,1,1,23,10,13
"2021","Stockport 035C","E01005839",548,130,105,25,403,122,217,73,104,40,28,12,12,4,35,13,22,1,1,15,7,8
"2021","Stockport 035D","E01005841",630,167,97,70,433,95,207,70,85,52,73,40,31,2,55,27,28,3,3,30,11,19
"2021","Stockport 036A","E01005844",547,150,98,52,345,82,189,34,109,46,34,20,14,0,38,18,20,2,2,52,27,25
"2021","Stockport 036B","E01005845",613,141,95,46,424,84,224,59,116,49,49,22,22,5,66,25,41,1,1,48,33,15
"2021","Stockport 036C","E01005849",654,163,127,36,444,98,252,67,126,59,58,27,26,5,33,10,23,3,3,47,23,24
"2021","Stockport 036D","E01005851",601,140,99,41,421,83,253,62,128,63,40,22,16,2,43,19,24,2,2,40,31,9
"2021","Stockport 037A","E01005808",526,99,69,30,402,86,256,66,147,43,24,8,15,1,34,15,19,2,2,25,12,13
"2021","Stockport 037B","E01005809",499,128,90,38,353,64,193,59,95,39,43,12,28,3,52,32,20,1,1,18,7,11
"2021","Stockport 037C","E01005810",661,223,140,83,415,93,215,50,122,43,50,26,21,3,56,33,23,1,1,23,10,13
"2021","Stockport 037D","E01005811",629,225,111,114,389,76,216,98,81,37,65,37,22,6,30,14,16,2,2,15,3,12
"2021","Stockport 037E","E01005812",479,91,64,27,378,103,220,72,103,45,36,15,19,2,19,7,12,0,0,10,4,6
"2021","Stockport 038A","E01005842",652,143,92,51,486,118,254,92,105,57,60,25,28,7,48,25,23,6,6,23,9,14
"2021","Stockport 038B","E01005906",635,176,126,50,436,166,207,90,78,39,40,27,10,3,23,10,13,0,0,23,11,12
"2021","Stockport 038C","E01005907",616,189,126,63,409,143,180,67,73,40,55,29,19,7,30,14,16,1,1,18,4,14
"2021","Stockport 038D","E01005913",637,193,120,73,419,113,231,94,98,39,45,28,15,2,30,8,22,0,0,25,10,15
"2021","Stockport 039A","E01005789",734,242,144,98,473,83,268,67,157,44,65,39,23,3,54,27,27,3,3,19,5,14
"2021","Stockport 039B","E01005791",640,165,99,66,450,79,237,62,130,45,61,31,22,8,72,48,24,1,1,25,10,15
"2021","Stockport 039C","E01005793",629,168,98,70,439,78,229,65,123,41,65,33,28,4,64,37,27,3,3,22,15,7
"2021","Stockport 039D","E01005795",527,110,77,33,404,71,239,63,124,52,52,25,25,2,40,20,20,2,2,13,5,8
"2021","Stockport 039E","E01005796",497,103,70,33,373,73,219,59,118,42,38,23,15,0,40,23,17,3,3,21,8,13
"2021","Stockport 040A","E01005846",619,155,88,67,409,57,238,54,139,45,63,33,26,4,45,22,23,6,6,55,34,21
"2021","Stockport 040B","E01005847",627,178,90,88,400,58,196,55,96,45,57,25,24,8,85,50,35,4,4,49,24,25
"2021","Stockport 040C","E01005848",802,197,109,88,571,91,334,90,174,70,76,41,29,6,63,42,21,7,7,34,21,13
"2021","Stockport 040D","E01005850",743,223,103,120,475,83,236,58,127,51,65,26,35,4,82,54,28,9,9,45,25,20
"2021","Stockport 041A","E01005792",593,116,80,36,454,113,269,74,152,43,33,13,18,2,39,20,19,0,0,23,11,12
"2021","Stockport 041B","E01005794",499,108,81,27,369,74,234,69,120,45,27,10,16,1,34,18,16,0,0,22,14,8
"2021","Stockport 041C","E01005923",609,143,108,35,455,122,251,62,147,42,38,16,18,4,44,19,25,0,0,11,7,4
"2021","Stockport 041D","E01005931",634,199,144,55,417,114,222,85,99,38,42,19,18,5,38,15,23,1,1,18,7,11
"2021","Stockport 042A","E01005924",527,129,91,38,377,88,234,80,122,32,31,17,14,0,24,10,14,0,0,21,10,11
"2021","Stockport 042B","E01005925",609,196,149,47,394,91,231,64,131,36,36,24,9,3,35,21,14,1,1,19,12,7
"2021","Stockport 042C","E01005926",858,156,71,85,666,102,418,127,227,64,107,57,46,4,37,22,15,2,2,36,12,24
"2021","Stockport 042D","E01005932",522,105,82,23,406,115,220,63,106,51,38,22,14,2,33,16,17,0,0,11,4,7
"2021","Tameside 001A","E01006053",844,240,89,151,579,93,292,107,136,49,126,67,54,5,67,45,22,1,1,25,11,14
"2021","Tameside 001B","E01006054",806,320,145,175,461,43,212,70,109,33,99,45,47,7,103,70,33,4,4,25,10,15
"2021","Tameside 001C","E01006055",691,223,69,154,443,49,176,76,73,27,130,69,57,4,84,61,23,4,4,25,13,12
"2021","Tameside 001D","E01006057",674,183,70,113,473,58,214,83,96,35,119,69,46,4,77,41,36,5,5,18,9,9
"2021","Tameside 001E","E01006058",1019,413,128,285,562,62,205,82,89,34,181,123,50,8,107,83,24,7,7,44,20,24
"2021","Tameside 001F","E01006059",632,187,76,111,428,50,198,63,94,41,100,59,36,5,77,51,26,3,3,17,7,10
"2021","Tameside 002A","E01005938",649,191,83,108,429,72,209,67,80,62,70,28,37,5,78,50,28,0,0,29,10,19
"2021","Tameside 002B","E01005939",481,105,78,27,328,80,177,51,70,56,25,9,11,5,43,19,24,3,3,48,20,28
"2021","Tameside 002C","E01005940",593,160,102,58,405,118,206,63,83,60,33,14,17,2,46,26,20,2,2,28,15,13
"2021","Tameside 002D","E01005955",627,123,70,53,464,69,272,95,102,75,71,29,38,4,48,25,23,4,4,40,20,20
"2021","Tameside 003A","E01006056",507,158,59,99,326,22,94,25,54,15,86,16,59,11,121,84,37,3,3,23,17,6
"2021","Tameside 003B","E01006061",979,244,84,160,686,58,325,94,169,62,132,43,78,11,165,114,51,6,6,49,25,24
"2021","Tameside 003C","E01006062",811,175,93,82,609,105,347,126,153,68,89,37,46,6,65,37,28,3,3,27,16,11
"2021","Tameside 003D","E01006063",568,130,61,69,408,75,201,76,80,45,80,37,34,9,46,21,25,6,6,30,10,20
"2021","Tameside 004A","E01005936",644,146,82,64,476,107,230,92,92,46,79,37,33,9,58,33,25,2,2,22,11,11
"2021","Tameside 004B","E01005937",712,194,78,116,484,56,188,59,85,44,90,31,51,8,144,112,32,6,6,34,20,14
"2021","Tameside 004C","E01005945",751,208,71,137,498,28,194,53,107,34,110,44,57,9,162,118,44,4,4,45,30,15
"2021","Tameside 004D","E01005946",691,223,70,153,438,42,196,61,94,41,80,37,37,6,113,80,33,7,7,30,11,19
"2021","Tameside 004E","E01005947",817,304,84,220,466,13,173,56,91,26,99,44,51,4,170,129,41,11,11,47,24,23
"2021","Tameside 005A","E01005954",760,402,217,185,334,50,128,43,56,29,76,36,34,6,78,45,33,2,2,24,16,8
"2021","Tameside 005B","E01005956",584,176,103,73,374,73,204,96,49,59,63,31,26,6,34,17,17,0,0,34,20,14
"2021","Tameside 005C","E01005957",618,174,85,89,403,62,199,66,93,40,67,33,29,5,70,47,23,5,5,41,25,16
"2021","Tameside 005D","E01005958",679,211,81,130,430,40,152,53,67,32,99,38,53,8,134,103,31,5,5,38,22,16
"2021","Tameside 005E","E01005959",728,186,79,107,494,32,205,45,112,48,88,34,44,10,164,103,61,5,5,48,35,13
"2021","Tameside 006A","E01005933",549,128,40,88,382,19,152,30,88,34,77,19,45,13,128,93,35,6,6,39,25,14
"2021","Tameside 006B","E01005934",626,159,71,88,439,67,200,79,86,35,73,31,35,7,97,64,33,2,2,28,19,9
"2021","Tameside 006C","E01005935",639,225,86,139,389,21,122,45,46,31,77,23,46,8,166,121,45,3,3,25,11,14
"2021","Tameside 006D","E01005949",713,272,112,160,398,43,170,54,78,38,92,48,36,8,81,55,26,12,12,43,25,18
"2021","Tameside 006E","E01005960",733,255,89,166,437,34,166,51,83,32,90,36,48,6,132,93,39,15,15,41,25,16
"2021","Tameside 007A","E01005941",777,283,83,200,427,30,180,56,97,27,91,40,48,3,116,77,39,10,10,67,37,30
"2021","Tameside 007B","E01005942",710,195,86,109,477,67,214,72,91,51,102,45,51,6,89,51,38,5,5,38,18,20
"2021","Tameside 007C","E01005943",849,314,102,212,492,50,172,80,64,28,144,86,46,12,123,95,28,3,3,43,21,22
"2021","Tameside 007D","E01005944",722,151,59,92,530,54,268,79,142,47,117,58,53,6,88,50,38,3,3,41,18,23
"2021","Tameside 008A","E01006060",708,297,75,222,373,18,131,43,69,19,99,38,50,11,120,86,34,5,5,38,17,21
"2021","Tameside 008B","E01006064",797,329,172,157,443,33,167,54,81,32,85,29,44,12,151,114,37,7,7,25,16,9
"2021","Tameside 008C","E01006065",511,80,36,44,401,32,147,44,72,31,71,19,45,7,144,108,36,7,7,30,19,11
"2021","Tameside 008D","E01006066",604,191,63,128,375,40,116,45,49,22,105,57,39,9,110,72,38,4,4,38,13,25
"2021","Tameside 009A","E01006067",738,153,57,96,558,76,328,118,152,58,96,44,44,8,56,36,20,2,2,27,16,11
"2021","Tameside 009B","E01006068",827,415,153,262,382,49,119,58,43,18,128,57,65,6,81,48,33,5,5,30,8,22
"2021","Tameside 009C","E01006069",703,195,73,122,471,37,195,64,88,43,95,41,44,10,141,97,44,3,3,37,23,14
"2021","Tameside 009D","E01006073",819,234,53,181,562,26,229,69,115,45,143,63,68,12,146,108,38,18,18,23,8,15
"2021","Tameside 010A","E01005993",609,193,95,98,395,66,179,74,62,43,86,43,38,5,62,37,25,2,2,21,9,12
"2021","Tameside 010B","E01005995",516,92,49,43,397,58,236,88,84,64,68,29,32,7,34,16,18,1,1,27,16,11
"2021","Tameside 010C","E01005996",798,222,86,136,534,54,223,59,101,63,116,43,63,10,133,88,45,8,8,42,20,22
"2021","Tameside 010D","E01005997",686,245,112,133,411,41,184,56,75,53,87,41,40,6,92,55,37,7,7,30,14,16
"2021","Tameside 010E","E01006000",938,454,224,230,447,69,148,56,57,35,99,54,39,6,128,89,39,3,3,37,12,25
"2021","Tameside 011A","E01005994",610,153,66,87,427,34,165,65,66,34,120,40,62,18,104,59,45,4,4,30,11,19
"2021","Tameside 011B","E01005999",926,308,89,219,543,42,241,69,124,48,131,66,53,12,122,74,48,7,7,75,33,42
"2021","Tameside 011C","E01006002",558,165,98,67,357,30,186,60,66,60,61,19,32,10,77,35,42,3,3,36,16,20
"2021","Tameside 011D","E01006004",617,131,62,69,465,79,206,70,73,63,100,39,50,11,79,51,28,1,1,21,13,8
"2021","Tameside 011E","E01006005",630,244,90,154,358,26,117,44,44,29,75,35,34,6,134,107,27,6,6,28,21,7
"2021","Tameside 011F","E01006007",648,185,75,110,429,33,196,75,73,48,106,37,60,9,91,64,27,3,3,34,15,19
"2021","Tameside 012A","E01005998",754,193,57,136,502,45,213,72,94,47,106,42,56,8,127,83,44,11,11,59,32,27
"2021","Tameside 012B","E01006001",644,179,82,97,418,46,187,71,71,45,93,46,35,12,88,46,42,4,4,47,23,24
"2021","Tameside 012C","E01006003",631,178,77,101,400,42,170,61,71,38,76,34,36,6,108,65,43,4,4,53,21,32
"2021","Tameside 012D","E01006006",601,146,76,70,429,78,196,69,69,58,102,54,39,9,51,23,28,2,2,26,12,14
"2021","Tameside 013A","E01005948",1174,697,116,581,405,15,171,47,101,23,100,63,31,6,103,72,31,16,16,72,46,26
"2021","Tameside 013B","E01005950",643,145,35,110,413,20,230,33,169,28,33,15,17,1,121,82,39,9,9,85,63,22
"2021","Tameside 013C","E01005951",754,254,90,164,454,32,177,55,98,24,100,45,49,6,135,109,26,10,10,46,30,16
"2021","Tameside 013E","E01005953",876,298,130,168,506,32,216,46,125,45,86,48,31,7,165,117,48,7,7,72,41,31
"2021","Tameside 013F","E01033949",594,342,70,272,211,3,95,22,60,13,30,22,6,2,74,44,30,9,9,41,21,20
"2021","Tameside 013G","E01033950",684,359,96,263,286,10,97,36,46,15,57,32,21,4,114,76,38,8,8,39,19,20
"2021","Tameside 014A","E01005961",1105,232,85,147,802,56,427,108,258,61,186,82,91,13,127,91,36,6,6,71,34,37
"2021","Tameside 014B","E01005962",596,173,102,71,389,69,176,62,75,39,75,37,37,1,68,41,27,1,1,34,18,16
"2021","Tameside 014C","E01005968",618,196,86,110,395,62,198,76,69,53,75,35,32,8,57,26,31,3,3,27,13,14
"2021","Tameside 014D","E01005969",569,162,86,76,380,74,175,66,58,51,73,37,27,9,56,30,26,2,2,27,14,13
"2021","Tameside 015A","E01006022",1040,480,148,332,531,74,201,89,63,49,148,101,41,6,102,60,42,6,6,29,10,19
"2021","Tameside 015B","E01006023",801,351,108,243,417,36,146,60,59,27,88,50,32,6,139,100,39,8,8,33,10,23
"2021","Tameside 015C","E01006070",619,190,70,120,399,49,179,67,73,39,109,62,44,3,61,37,24,1,1,30,13,17
"2021","Tameside 015D","E01006071",697,140,88,52,540,154,284,102,125,57,63,20,37,6,36,17,19,3,3,17,10,7
"2021","Tameside 015E","E01006072",671,146,98,48,498,123,274,98,120,56,54,20,29,5,47,26,21,0,0,27,13,14
"2021","Tameside 016A","E01006009",586,185,79,106,370,37,157,67,52,38,81,37,37,7,92,51,41,3,3,31,19,12
"2021","Tameside 016B","E01006017",552,107,61,46,430,84,234,61,112,61,70,33,30,7,40,20,20,2,2,15,6,9
"2021","Tameside 016C","E01006018",564,130,91,39,412,102,201,83,57,61,66,32,25,9,43,21,22,0,0,22,8,14
"2021","Tameside 016D","E01006021",604,176,101,75,395,73,162,64,57,41,88,34,47,7,70,50,20,2,2,33,15,18
"2021","Tameside 017A","E01006008",614,166,56,110,425,32,175,70,66,39,112,61,43,8,102,73,29,4,4,23,7,16
"2021","Tameside 017B","E01006010",657,268,118,150,369,29,123,47,54,22,97,34,54,9,113,82,31,7,7,20,11,9
"2021","Tameside 017C","E01006012",798,226,86,140,530,63,221,89,93,39,127,51,70,6,116,79,37,3,3,42,25,17
"2021","Tameside 017D","E01006015",524,102,47,55,396,51,238,83,107,48,64,26,31,7,42,19,23,1,1,26,14,12
"2021","Tameside 017E","E01006016",1034,546,130,416,441,32,147,67,64,16,124,75,41,8,132,95,37,6,6,47,21,26
"2021","Tameside 018A","E01006011",694,225,81,144,427,45,164,46,88,30,93,29,53,11,121,80,41,4,4,42,21,21
"2021","Tameside 018B","E01006013",564,164,79,85,380,73,151,53,60,38,82,31,42,9,71,45,26,3,3,20,9,11
"2021","Tameside 018C","E01006014",478,83,40,43,373,38,158,47,76,35,77,34,28,15,97,75,22,3,3,22,12,10
"2021","Tameside 018D","E01006019",815,426,181,245,367,41,140,68,39,33,116,70,43,3,66,44,22,4,4,22,11,11
"2021","Tameside 018E","E01006020",625,162,80,82,434,50,180,56,81,43,91,26,52,13,107,68,39,6,6,29,16,13
"2021","Tameside 019A","E01005963",487,131,59,72,331,42,158,56,63,39,69,32,33,4,60,30,30,2,2,25,11,14
"2021","Tameside 019B","E01005964",657,201,78,123,427,50,179,65,77,37,100,40,53,7,93,62,31,5,5,29,14,15
"2021","Tameside 019C","E01005965",799,278,110,168,490,49,181,90,67,24,143,80,51,12,114,78,36,3,3,31,20,11
"2021","Tameside 019D","E01005966",624,168,49,119,418,22,170,56,76,38,104,35,62,7,117,76,41,5,5,38,24,14
"2021","Tameside 019E","E01005967",712,325,140,185,360,33,144,50,66,28,82,35,31,16,96,65,31,5,5,27,14,13
"2021","Tameside 020A","E01006031",939,302,93,209,588,25,231,66,132,33,184,97,82,5,143,97,46,5,5,49,30,19
"2021","Tameside 020B","E01006032",600,159,60,99,418,31,193,52,112,29,91,41,46,4,93,54,39,10,10,23,11,12
"2021","Tameside 020C","E01006033",790,257,66,191,513,40,195,67,88,40,143,67,68,8,130,89,41,5,5,20,9,11
"2021","Tameside 020D","E01006034",933,330,121,209,562,50,222,65,122,35,137,57,67,13,146,105,41,7,7,41,23,18
"2021","Tameside 020E","E01006035",1018,411,148,263,562,56,219,81,100,38,156,86,61,9,126,78,48,5,5,45,24,21
"2021","Tameside 020F","E01006036",949,363,83,280,545,37,227,73,112,42,129,65,51,13,147,107,40,5,5,41,24,17
"2021","Tameside 021A","E01005970",648,207,120,87,419,90,216,95,72,49,67,32,33,2,42,15,27,4,4,22,12,10
"2021","Tameside 021B","E01005972",763,245,57,188,476,40,163,54,74,35,129,52,65,12,136,85,51,8,8,42,17,25
"2021","Tameside 021C","E01005974",820,313,103,210,467,47,128,42,51,35,140,73,58,9,141,90,51,11,11,40,17,23
"2021","Tameside 021D","E01005975",688,239,92,147,426,35,185,62,88,35,71,37,33,1,131,82,49,4,4,23,12,11
"2021","Tameside 022A","E01006024",686,123,63,60,531,74,327,116,124,87,79,32,35,12,49,20,29,2,2,32,16,16
"2021","Tameside 022B","E01006026",731,285,100,185,425,47,177,73,68,36,113,58,46,9,83,54,29,5,5,21,11,10
"2021","Tameside 022C","E01006037",647,134,78,56,482,81,252,87,110,55,95,44,37,14,54,36,18,0,0,31,12,19
"2021","Tameside 022D","E01006038",664,162,85,77,479,104,202,82,67,53,88,41,40,7,81,43,38,4,4,23,15,8
"2021","Tameside 023A","E01006047",591,172,83,89,393,58,157,65,59,33,89,49,36,4,87,58,29,2,2,26,13,13
"2021","Tameside 023B","E01006048",762,276,148,128,459,106,185,76,67,42,97,60,33,4,67,48,19,4,4,27,15,12
"2021","Tameside 023C","E01006049",767,280,103,177,467,79,198,102,52,44,97,54,37,6,90,60,30,3,3,20,5,15
"2021","Tameside 023D","E01006051",725,214,86,128,476,83,217,95,85,37,98,53,38,7,77,45,32,1,1,35,10,25
"2021","Tameside 024A","E01005985",697,220,134,86,449,90,231,88,91,52,79,40,34,5,46,13,33,3,3,28,14,14
"2021","Tameside 024B","E01005987",698,221,132,89,454,83,228,101,73,54,84,39,37,8,55,27,28,4,4,23,13,10
"2021","Tameside 024C","E01005988",639,152,78,74,453,72,231,64,117,50,85,33,48,4,63,35,28,2,2,34,14,20
"2021","Tameside 024D","E01005990",627,218,105,113,386,76,175,61,72,42,73,37,32,4,60,32,28,2,2,23,14,9
"2021","Tameside 024E","E01005991",623,179,80,99,409,60,178,41,88,49,84,46,30,8,81,50,31,6,6,35,17,18
"2021","Tameside 025A","E01005971",632,209,71,138,399,53,152,65,49,38,93,48,39,6,96,50,46,5,5,24,11,13
"2021","Tameside 025B","E01005986",535,171,59,112,335,31,147,50,61,36,75,34,36,5,79,48,31,3,3,29,18,11
"2021","Tameside 025C","E01005989",506,126,71,55,364,76,204,64,87,53,46,20,22,4,36,15,21,2,2,16,6,10
"2021","Tameside 025D","E01005992",585,261,88,173,300,29,117,40,47,30,63,38,23,2,90,60,30,1,1,24,10,14
"2021","Tameside 026A","E01005973",598,166,89,77,408,76,167,63,63,41,85,32,44,9,75,36,39,5,5,24,5,19
"2021","Tameside 026B","E01005976",631,223,85,138,375,46,139,37,61,41,95,34,53,8,90,55,35,5,5,33,21,12
"2021","Tameside 026C","E01005977",664,207,113,94,435,83,178,66,67,45,94,47,43,4,80,43,37,0,0,22,11,11
"2021","Tameside 026D","E01005978",600,190,78,112,392,49,120,44,46,30,80,30,32,18,132,90,42,11,11,18,6,12
"2021","Tameside 027A","E01006025",781,202,78,124,533,34,189,60,88,41,135,68,58,9,169,114,55,6,6,46,24,22
"2021","Tameside 027B","E01006027",1005,360,92,268,593,24,204,77,99,28,181,81,89,11,176,131,45,8,8,52,26,26
"2021","Tameside 027C","E01006050",781,272,93,179,472,28,139,43,62,34,104,33,60,11,195,143,52,6,6,37,25,12
"2021","Tameside 027D","E01006052",663,198,92,106,429,51,140,48,57,35,77,33,37,7,157,102,55,4,4,36,21,15
"2021","Tameside 028A","E01006028",893,461,205,256,396,58,155,56,68,31,77,37,36,4,100,74,26,6,6,36,18,18
"2021","Tameside 028B","E01006029",715,208,51,157,455,22,229,53,146,30,84,45,35,4,116,92,24,4,4,52,41,11
"2021","Tameside 028C","E01006030",779,243,71,172,496,32,218,79,95,44,112,41,59,12,129,79,50,5,5,40,20,20
"2021","Tameside 028D","E01006039",455,128,45,83,287,37,151,34,87,30,42,26,14,2,49,31,18,8,8,40,31,9
"2021","Tameside 028E","E01006040",629,187,49,138,373,15,202,52,128,22,58,34,21,3,92,66,26,6,6,69,46,23
"2021","Tameside 028F","E01006041",700,224,95,129,432,32,199,44,117,38,105,56,43,6,93,74,19,3,3,44,25,19
"2021","Tameside 029A","E01005979",774,305,167,138,439,83,168,72,60,36,94,49,39,6,92,56,36,2,2,30,12,18
"2021","Tameside 029B","E01005980",636,217,82,135,397,35,143,57,56,30,90,40,44,6,126,84,42,3,3,22,10,12
"2021","Tameside 029C","E01005981",801,362,213,149,413,55,150,53,69,28,90,28,45,17,114,69,45,4,4,26,10,16
"2021","Tameside 029D","E01005982",570,173,86,87,372,70,151,49,57,45,64,29,28,7,84,55,29,3,3,25,14,11
"2021","Tameside 029E","E01005983",693,222,133,89,446,103,216,79,83,54,77,43,29,5,48,26,22,2,2,25,16,9
"2021","Tameside 029F","E01005984",808,371,122,249,405,32,104,42,46,16,97,40,47,10,164,103,61,8,8,32,22,10
"2021","Tameside 030A","E01006042",811,307,125,182,476,60,194,71,79,44,131,84,43,4,85,62,23,6,6,28,12,16
"2021","Tameside 030B","E01006043",605,173,93,80,408,47,185,66,81,38,90,38,43,9,84,54,30,2,2,24,14,10
"2021","Tameside 030C","E01006044",653,195,105,90,432,92,215,81,100,34,76,37,34,5,48,32,16,1,1,26,13,13
"2021","Tameside 030D","E01006045",531,132,89,43,373,87,202,80,74,48,51,23,25,3,33,15,18,0,0,26,9,17
"2021","Tameside 030E","E01006046",630,146,79,67,457,94,214,74,103,37,83,47,30,6,64,31,33,2,2,27,15,12
"2021","Trafford 001A","E01006109",531,284,55,229,210,9,90,23,57,10,29,16,11,2,69,46,23,13,13,37,22,15
"2021","Trafford 001B","E01006110",655,156,51,105,416,18,201,39,134,28,72,33,37,2,115,64,51,10,10,83,34,49
"2021","Trafford 001C","E01006111",558,128,42,86,360,8,156,16,109,31,47,21,23,3,138,78,60,11,11,70,39,31
"2021","Trafford 001D","E01006112",701,214,100,114,386,14,188,30,119,39,42,20,20,2,131,84,47,11,11,101,55,46
"2021","Trafford 001F","E01006188",786,252,37,215,424,12,196,44,120,32,111,85,25,1,80,50,30,25,25,110,45,65
"2021","Trafford 001G","E01034000",751,399,11,388,271,1,61,40,19,2,155,151,4,0,36,26,10,18,18,81,8,73
"2021","Trafford 001H","E01034001",777,366,90,276,341,13,141,35,97,9,68,51,17,0,103,74,29,16,16,70,19,51
"2021","Trafford 002A","E01006116",537,129,69,60,380,55,190,53,105,32,67,36,26,5,67,48,19,1,1,28,14,14
"2021","Trafford 002B","E01006117",637,109,78,31,497,79,297,79,169,49,68,30,34,4,50,21,29,3,3,31,17,14
"2021","Trafford 002C","E01006118",670,249,115,134,398,48,211,65,93,53,71,38,25,8,68,36,32,0,0,23,10,13
"2021","Trafford 002D","E01006119",633,116,75,41,488,71,283,81,141,61,58,37,16,5,72,40,32,4,4,29,15,14
"2021","Trafford 002E","E01006121",596,136,66,70,435,77,190,65,70,55,78,32,40,6,89,52,37,1,1,25,13,12
"2021","Trafford 003A","E01006141",645,154,57,97,444,24,235,50,141,44,80,41,34,5,94,48,46,11,11,47,27,20
"2021","Trafford 003B","E01006186",946,345,70,275,521,26,217,67,114,36,141,92,37,12,126,77,49,11,11,80,19,61
"2021","Trafford 003C","E01006187",1148,379,85,294,675,23,264,80,141,43,183,108,68,7,198,133,65,7,7,94,26,68
"2021","Trafford 003D","E01006189",931,250,74,176,621,44,278,68,162,48,140,81,54,5,150,96,54,9,9,60,23,37
"2021","Trafford 004A","E01006113",478,78,42,36,299,24,174,30,96,48,45,19,22,4,53,27,26,3,3,101,59,42
"2021","Trafford 004B","E01006114",564,158,76,82,311,30,159,27,88,44,43,22,16,5,74,39,35,5,5,95,55,40
"2021","Trafford 004C","E01006115",594,209,68,141,315,32,160,31,88,41,55,36,16,3,61,21,40,7,7,70,31,39
"2021","Trafford 004D","E01006145",805,250,80,170,463,30,209,49,119,41,81,54,22,5,133,80,53,10,10,92,39,53
"2021","Trafford 004E","E01006146",645,147,73,74,431,34,250,57,144,49,58,29,28,1,84,45,39,5,5,67,34,33
"2021","Trafford 005A","E01006122",742,199,110,89,517,103,270,81,127,62,89,41,40,8,55,26,29,0,0,26,15,11
"2021","Trafford 005B","E01006123",650,143,78,65,480,92,257,77,121,59,66,26,34,6,65,36,29,0,0,27,10,17
"2021","Trafford 005C","E01006124",609,148,96,52,437,106,257,81,116,60,41,18,20,3,31,13,18,2,2,24,14,10
"2021","Trafford 005D","E01006128",782,215,138,77,545,92,280,72,161,47,100,54,38,8,70,42,28,3,3,22,8,14
"2021","Trafford 005E","E01006131",622,179,94,85,418,71,254,68,122,64,46,23,21,2,46,23,23,1,1,25,13,12
"2021","Trafford 006A","E01006155",721,172,67,105,510,57,253,79,131,43,115,68,39,8,83,48,35,2,2,39,19,20
"2021","Trafford 006B","E01006157",659,150,55,95,477,35,264,77,142,45,92,46,37,9,83,46,37,3,3,32,16,16
"2021","Trafford 006C","E01006159",707,182,62,120,473,28,193,51,108,34,76,27,42,7,171,102,69,5,5,52,34,18
"2021","Trafford 006D","E01006182",586,121,70,51,429,38,263,70,132,61,62,35,23,4,65,24,41,1,1,36,23,13
"2021","Trafford 006E","E01006183",635,147,65,82,445,57,262,59,143,60,64,34,22,8,57,19,38,5,5,43,26,17
"2021","Trafford 007A","E01006125",608,137,85,52,442,64,220,63,93,64,72,31,38,3,83,50,33,3,3,29,15,14
"2021","Trafford 007B","E01006126",745,236,90,146,467,45,186,53,106,27,96,30,58,8,139,87,52,1,1,42,22,20
"2021","Trafford 007C","E01006127",619,132,73,59,467,73,227,73,96,58,86,37,41,8,76,40,36,5,5,20,12,8
"2021","Trafford 007D","E01006130",739,210,125,85,505,71,280,87,136,57,87,41,40,6,66,45,21,1,1,24,11,13
"2021","Trafford 007E","E01006132",672,234,114,120,410,49,240,69,115,56,65,34,26,5,55,25,30,1,1,28,16,12
"2021","Trafford 008A","E01006156",698,215,84,131,444,57,219,68,109,42,65,29,26,10,99,56,43,4,4,39,19,20
"2021","Trafford 008B","E01006158",788,287,82,205,475,56,198,66,103,29,76,35,32,9,134,94,40,11,11,26,15,11
"2021","Trafford 008C","E01006179",852,366,139,227,446,35,205,58,100,47,86,54,28,4,108,77,31,12,12,40,15,25
"2021","Trafford 008D","E01006184",754,283,133,150,436,59,210,66,97,47,63,32,26,5,100,64,36,4,4,35,17,18
"2021","Trafford 009A","E01006198",701,295,134,161,378,56,176,45,89,42,92,64,25,3,53,30,23,1,1,28,12,16
"2021","Trafford 009B","E01006199",747,279,106,173,439,33,172,72,80,20,113,72,37,4,117,66,51,4,4,29,9,20
"2021","Trafford 009C","E01006200",681,287,165,122,377,83,192,65,96,31,66,41,22,3,33,15,18,3,3,17,5,12
"2021","Trafford 009D","E01006201",655,237,90,147,391,25,199,64,105,30,104,59,39,6,61,33,28,2,2,27,8,19
"2021","Trafford 009E","E01006202",607,240,90,150,343,45,209,62,105,42,51,31,18,2,37,25,12,1,1,24,9,15
"2021","Trafford 010A","E01006120",559,121,73,48,419,92,243,67,133,43,49,21,21,7,33,17,16,2,2,19,9,10
"2021","Trafford 010B","E01006129",636,227,131,96,388,77,180,56,87,37,59,29,26,4,68,33,35,4,4,21,9,12
"2021","Trafford 010C","E01006133",646,196,125,71,432,101,217,89,79,49,65,32,31,2,47,24,23,2,2,18,12,6
"2021","Trafford 010D","E01006197",596,148,97,51,426,46,239,57,137,45,84,48,29,7,55,31,24,2,2,22,8,14
"2021","Trafford 010E","E01006203",517,115,52,63,390,69,230,69,105,56,48,22,20,6,40,22,18,3,3,12,7,5
"2021","Trafford 011A","E01006142",756,293,152,141,412,45,206,59,106,41,77,43,31,3,78,49,29,6,6,51,19,32
"2021","Trafford 011B","E01006143",696,241,97,144,409,49,236,64,133,39,82,43,32,7,37,19,18,5,5,46,22,24
"2021","Trafford 011C","E01006144",692,297,111,186,361,25,119,49,51,19,81,59,20,2,132,85,47,4,4,34,11,23
"2021","Trafford 011D","E01006180",782,243,54,189,477,22,209,57,123,29,128,76,48,4,108,73,35,10,10,62,19,43
"2021","Trafford 011E","E01006181",652,181,99,82,412,39,223,52,135,36,68,36,28,4,78,36,42,4,4,59,27,32
"2021","Trafford 012A","E01006147",531,94,57,37,427,56,264,57,164,43,61,28,28,5,43,23,20,3,3,10,5,5
"2021","Trafford 012B","E01006149",686,228,131,97,438,52,247,59,152,36,73,48,22,3,62,43,19,4,4,20,8,12
"2021","Trafford 012C","E01006150",865,360,142,218,477,70,248,62,149,37,99,72,24,3,56,36,20,4,4,28,10,18
"2021","Trafford 012D","E01006154",661,194,56,138,441,32,233,43,159,31,101,68,27,6,73,47,26,2,2,26,12,14
"2021","Trafford 012E","E01006165",911,278,85,193,596,33,265,90,153,22,173,133,36,4,114,76,38,11,11,37,14,23
"2021","Trafford 013A","E01006166",680,205,85,120,442,51,221,65,110,46,86,43,37,6,82,52,30,2,2,33,17,16
"2021","Trafford 013B","E01006169",663,161,100,61,477,83,245,55,136,54,67,31,29,7,74,40,34,8,8,25,9,16
"2021","Trafford 013C","E01006170",679,201,119,82,450,61,240,72,132,36,73,33,38,2,73,44,29,3,3,28,14,14
"2021","Trafford 013D","E01006171",766,263,96,167,473,28,191,55,97,39,94,34,47,13,152,100,52,8,8,30,21,9
"2021","Trafford 014A","E01006098",512,125,75,50,370,61,231,58,143,30,41,19,20,2,35,22,13,2,2,17,8,9
"2021","Trafford 014B","E01006099",547,157,74,83,362,49,200,49,125,26,65,42,21,2,46,26,20,2,2,28,14,14
"2021","Trafford 014C","E01006164",727,200,110,90,509,94,287,71,166,50,72,35,33,4,56,28,28,0,0,18,9,9
"2021","Trafford 014D","E01006174",816,289,111,178,488,77,256,68,155,33,86,52,31,3,67,37,30,2,2,39,15,24
"2021","Trafford 014E","E01006178",769,218,95,123,528,79,282,72,168,42,94,53,33,8,71,42,29,2,2,23,12,11
"2021","Trafford 015A","E01006097",822,322,157,165,476,99,251,69,152,30,73,54,16,3,49,26,23,4,4,24,7,17
"2021","Trafford 015B","E01006160",1092,544,240,304,521,46,284,78,192,14,120,83,35,2,63,42,21,8,8,27,14,13
"2021","Trafford 015C","E01006161",946,331,97,234,578,71,334,97,212,25,102,68,29,5,66,50,16,5,5,37,12,25
"2021","Trafford 015D","E01006162",676,216,82,134,434,47,294,77,183,34,56,42,12,2,36,17,19,1,1,26,8,18
"2021","Trafford 015E","E01006163",814,246,69,177,534,36,272,83,161,28,147,98,48,1,74,56,18,5,5,34,7,27
"2021","Trafford 016A","E01006148",685,215,106,109,435,86,245,70,134,41,60,34,24,2,40,24,16,4,4,35,14,21
"2021","Trafford 016B","E01006151",573,100,66,34,447,76,304,76,176,52,27,13,14,0,34,14,20,6,6,26,11,15
"2021","Trafford 016C","E01006152",621,117,79,38,472,121,282,70,160,52,36,16,16,4,32,14,18,1,1,32,17,15
"2021","Trafford 016D","E01006153",627,156,109,47,450,100,293,71,156,66,21,8,9,4,36,15,21,0,0,21,12,9
"2021","Trafford 016E","E01006172",649,190,129,61,437,98,267,85,134,48,32,14,17,1,38,20,18,2,2,22,9,13
"2021","Trafford 017A","E01006104",755,251,106,145,471,74,204,82,75,47,107,42,52,13,81,46,35,5,5,33,12,21
"2021","Trafford 017B","E01006105",674,183,70,113,456,21,144,46,67,31,87,20,57,10,198,154,44,6,6,35,19,16
"2021","Trafford 017C","E01006106",598,178,84,94,396,34,160,71,53,36,85,27,55,3,114,72,42,3,3,24,11,13
"2021","Trafford 017D","E01006107",697,257,127,130,405,52,164,50,80,34,84,31,44,9,101,63,38,4,4,35,19,16
"2021","Trafford 017E","E01006108",624,144,43,101,437,7,115,43,48,24,69,22,40,7,240,172,68,6,6,43,22,21
"2021","Trafford 018A","E01006102",567,161,96,65,389,45,218,50,129,39,57,26,29,2,69,41,28,0,0,17,15,2
"2021","Trafford 018B","E01006173",607,126,75,51,466,69,265,73,153,39,78,33,38,7,53,19,34,1,1,15,7,8
"2021","Trafford 018C","E01006175",741,249,133,116,455,28,168,48,91,29,83,27,45,11,172,118,54,4,4,37,19,18
"2021","Trafford 018D","E01006176",725,202,106,96,489,61,253,65,137,51,92,55,32,5,75,43,32,8,8,34,14,20
"2021","Trafford 018E","E01006177",598,146,61,85,401,24,170,36,90,44,76,24,39,13,125,95,30,6,6,51,31,20
"2021","Trafford 019A","E01006091",1155,310,78,232,794,40,473,93,325,55,144,95,40,9,131,88,43,6,6,51,27,24
"2021","Trafford 019B","E01006092",498,115,51,64,358,13,138,29,83,26,68,22,37,9,133,77,56,6,6,25,14,11
"2021","Trafford 019C","E01006095",684,194,105,89,466,52,281,69,162,50,75,37,29,9,55,31,24,3,3,24,9,15
"2021","Trafford 019D","E01006167",725,291,89,202,399,26,141,34,71,36,63,33,20,10,167,110,57,2,2,35,19,16
"2021","Trafford 019E","E01006168",734,236,63,173,435,18,147,42,78,27,74,24,44,6,190,132,58,6,6,63,36,27
"2021","Trafford 020A","E01006090",992,317,84,233,640,68,353,102,190,61,117,81,32,4,88,59,29,14,14,35,14,21
"2021","Trafford 020B","E01006094",595,141,100,41,425,69,279,55,189,35,34,9,20,5,42,17,25,1,1,29,14,15
"2021","Trafford 020C","E01006096",572,92,54,38,455,69,292,61,190,41,50,23,24,3,42,23,19,2,2,25,14,11
"2021","Trafford 020D","E01006100",603,165,78,87,422,62,265,68,141,56,61,31,24,6,33,20,13,1,1,16,11,5
"2021","Trafford 020E","E01006103",601,91,54,37,485,73,332,70,205,57,42,13,24,5,38,20,18,0,0,25,11,14
"2021","Trafford 021A","E01006101",552,83,64,19,450,78,297,71,177,49,37,21,14,2,37,16,21,1,1,19,9,10
"2021","Trafford 021B","E01006190",641,139,77,62,486,82,312,80,178,54,49,19,27,3,41,22,19,2,2,16,7,9
"2021","Trafford 021C","E01006195",665,109,65,44,520,87,339,77,197,65,53,23,26,4,41,20,21,0,0,36,17,19
"2021","Trafford 021D","E01006196",681,165,83,82,493,55,308,87,171,50,77,38,36,3,50,25,25,3,3,23,12,11
"2021","Trafford 021E","E01006210",635,146,71,75,468,81,288,69,163,56,49,32,13,4,49,29,20,1,1,21,13,8
"2021","Trafford 022A","E01006204",703,234,168,66,438,99,241,62,134,45,40,23,15,2,55,29,26,3,3,31,15,16
"2021","Trafford 022B","E01006206",751,248,134,114,461,43,235,58,133,44,58,19,32,7,122,77,45,3,3,42,21,21
"2021","Trafford 022C","E01006207",778,313,110,203,432,45,142,38,70,34,96,34,53,9,140,96,44,9,9,33,25,8
"2021","Trafford 022D","E01006208",624,185,101,84,412,67,207,53,122,32,52,24,22,6,81,53,28,5,5,27,13,14
"2021","Trafford 022E","E01006211",650,176,90,86,430,49,206,62,114,30,63,31,24,8,109,69,40,3,3,44,18,26
"2021","Trafford 023A","E01006093",615,152,84,68,445,68,270,75,157,38,57,33,20,4,49,33,16,1,1,18,9,9
"2021","Trafford 023B","E01006191",645,135,89,46,490,96,317,66,190,61,46,20,21,5,30,14,16,1,1,20,9,11
"2021","Trafford 023C","E01006192",626,168,118,50,445,84,260,72,140,48,54,27,24,3,45,22,23,2,2,13,7,6
"2021","Trafford 023D","E01006205",554,152,100,52,383,101,223,60,119,44,34,11,20,3,24,10,14,1,1,19,10,9
"2021","Trafford 023E","E01006209",638,144,110,34,468,107,272,60,153,59,46,19,23,4,42,24,18,1,1,26,12,14
"2021","Trafford 024A","E01006078",986,344,101,243,613,40,276,75,170,31,190,145,43,2,101,68,33,6,6,29,7,22
"2021","Trafford 024B","E01006080",827,242,105,137,550,66,309,81,182,46,109,68,36,5,63,39,24,3,3,35,10,25
"2021","Trafford 024C","E01006089",811,192,77,115,564,45,307,72,203,32,130,82,44,4,75,45,30,7,7,55,19,36
"2021","Trafford 024D","E01006193",621,162,99,63,441,73,254,53,158,43,53,33,19,1,59,37,22,2,2,18,12,6
"2021","Trafford 024E","E01006194",983,286,100,186,650,34,370,69,263,38,136,81,49,6,107,70,37,3,3,47,15,32
"2021","Trafford 025A","E01006074",628,177,98,79,428,49,229,53,154,22,66,37,21,8,82,46,36,2,2,23,15,8
"2021","Trafford 025B","E01006075",1036,423,154,269,580,89,318,87,191,40,119,97,18,4,44,27,17,10,10,33,2,31
"2021","Trafford 025C","E01006076",816,318,167,151,469,129,227,88,110,29,62,45,16,1,46,29,17,5,5,29,12,17
"2021","Trafford 025D","E01006079",1055,264,92,172,765,79,450,111,286,53,152,118,28,6,75,48,27,9,9,26,10,16
"2021","Trafford 025E","E01006087",559,105,61,44,424,101,233,72,107,54,56,34,18,4,31,20,11,3,3,30,18,12
"2021","Trafford 026A","E01006083",482,81,50,31,379,80,241,61,129,51,26,14,10,2,29,16,13,3,3,22,7,15
"2021","Trafford 026B","E01006084",635,116,62,54,493,80,323,80,196,47,40,14,25,1,47,28,19,3,3,26,12,14
"2021","Trafford 026C","E01006088",662,179,78,101,463,32,303,81,187,35,70,40,27,3,55,38,17,3,3,20,6,14
"2021","Trafford 026D","E01006139",717,185,101,84,508,51,322,76,216,30,78,51,24,3,53,26,27,4,4,24,9,15
"2021","Trafford 026E","E01006140",628,128,68,60,477,55,307,62,204,41,57,34,21,2,58,34,24,0,0,23,10,13
"2021","Trafford 027A","E01006077",802,327,152,175,443,63,193,50,126,17,112,85,26,1,70,53,17,5,5,32,12,20
"2021","Trafford 027B","E01006081",502,82,57,25,399,91,259,71,139,49,25,14,10,1,23,12,11,1,1,21,11,10
"2021","Trafford 027C","E01006082",673,216,112,104,442,125,232,75,113,44,45,33,9,3,39,22,17,1,1,15,7,8
"2021","Trafford 027D","E01006085",630,180,105,75,443,83,251,70,150,31,68,44,19,5,41,29,12,0,0,7,3,4
"2021","Trafford 027E","E01006086",654,177,95,82,442,80,249,62,141,46,39,17,18,4,71,43,28,3,3,35,17,18
"2021","Trafford 028A","E01006134",527,83,54,29,405,79,277,65,158,54,23,13,10,0,26,10,16,0,0,39,19,20
"2021","Trafford 028B","E01006135",650,149,102,47,473,114,271,65,156,50,39,12,23,4,49,31,18,0,0,28,18,10
"2021","Trafford 028C","E01006136",619,132,92,40,449,93,292,74,171,47,24,11,11,2,39,28,11,1,1,38,20,18
"2021","Trafford 028D","E01006137",477,88,66,22,346,66,235,58,127,50,14,3,10,1,30,13,17,1,1,43,31,12
"2021","Trafford 028E","E01006138",780,276,182,94,474,88,275,63,178,34,42,16,21,5,66,40,26,3,3,30,16,14
"2021","Wigan 001A","E01006315",651,160,78,82,473,74,245,88,103,54,110,68,37,5,42,26,16,2,2,18,12,6
"2021","Wigan 001B","E01006316",838,194,89,105,625,106,326,113,163,50,138,81,48,9,54,36,18,1,1,19,9,10
"2021","Wigan 001C","E01006317",727,242,138,104,464,88,194,76,65,53,99,49,39,11,81,46,35,2,2,21,5,16
"2021","Wigan 001D","E01006319",585,103,37,66,459,18,275,86,145,44,111,47,61,3,52,37,15,3,3,23,8,15
"2021","Wigan 002A","E01006229",649,204,105,99,427,136,197,75,74,48,53,31,18,4,40,21,19,1,1,18,5,13
"2021","Wigan 002B","E01006230",859,181,89,92,646,91,354,123,182,49,132,80,47,5,67,34,33,2,2,32,14,18
"2021","Wigan 002C","E01006233",564,111,73,38,440,101,263,94,107,62,43,23,16,4,33,13,20,0,0,13,7,6
"2021","Wigan 002D","E01006237",795,191,87,104,589,74,337,106,169,62,123,71,45,7,50,26,24,5,5,15,8,7
"2021","Wigan 002E","E01006238",744,321,154,167,397,52,133,55,48,30,98,48,42,8,111,65,46,3,3,26,10,16
"2021","Wigan 003A","E01006259",551,140,61,79,394,66,201,72,87,42,78,39,33,6,49,23,26,0,0,17,6,11
"2021","Wigan 003B","E01006312",621,173,105,68,434,120,211,83,86,42,49,26,21,2,52,28,24,2,2,14,8,6
"2021","Wigan 003C","E01006313",590,162,70,92,405,28,181,48,97,36,93,37,51,5,98,59,39,5,5,23,12,11
"2021","Wigan 003D","E01006314",795,247,146,101,520,117,278,112,106,60,82,48,30,4,42,24,18,1,1,28,8,20
"2021","Wigan 003E","E01006318",634,176,121,55,436,133,208,76,79,53,56,25,26,5,39,18,21,0,0,22,9,13
"2021","Wigan 003F","E01006320",561,142,82,60,404,108,206,75,91,40,47,21,20,6,41,19,22,2,2,15,9,6
"2021","Wigan 003G","E01006321",690,189,105,84,470,73,272,116,112,44,67,30,32,5,57,35,22,1,1,31,13,18
"2021","Wigan 004A","E01006231",640,176,101,75,438,81,255,107,100,48,59,27,28,4,42,23,19,1,1,26,11,15
"2021","Wigan 004B","E01006232",812,198,78,120,584,81,336,119,158,59,104,63,39,2,60,33,27,3,3,30,14,16
"2021","Wigan 004C","E01006234",535,167,104,63,354,106,146,48,59,39,41,20,17,4,60,27,33,1,1,14,4,10
"2021","Wigan 004D","E01006235",705,270,141,129,413,38,178,61,74,43,90,30,49,11,103,75,28,4,4,22,10,12
"2021","Wigan 005A","E01006253",674,209,117,92,451,75,168,69,57,42,94,31,54,9,107,59,48,7,7,14,6,8
"2021","Wigan 005B","E01006254",609,174,81,93,409,28,162,42,76,44,87,24,57,6,127,82,45,5,5,26,13,13
"2021","Wigan 005C","E01006255",663,197,87,110,441,77,226,81,84,61,72,42,26,4,60,30,30,6,6,25,12,13
"2021","Wigan 005D","E01006256",745,188,69,119,534,64,226,90,95,41,144,84,53,7,98,64,34,2,2,23,8,15
"2021","Wigan 005E","E01006260",635,188,101,87,421,50,210,77,84,49,71,17,44,10,84,54,30,6,6,26,16,10
"2021","Wigan 006A","E01006370",950,453,82,371,450,40,192,58,102,32,128,85,41,2,77,42,35,13,13,47,14,33
"2021","Wigan 006B","E01006372",664,142,83,59,491,122,276,99,117,60,56,32,19,5,35,12,23,2,2,31,12,19
"2021","Wigan 006C","E01006373",632,170,94,76,439,89,228,71,110,47,79,46,30,3,38,20,18,5,5,23,7,16
"2021","Wigan 006D","E01006374",676,213,115,98,458,96,242,93,99,50,84,47,35,2,36,22,14,0,0,5,3,2
"2021","Wigan 006E","E01006390",770,280,138,142,461,74,191,84,67,40,84,39,40,5,109,70,39,3,3,29,6,23
"2021","Wigan 007A","E01006236",694,194,111,83,474,115,247,93,94,60,72,35,33,4,38,21,17,2,2,26,15,11
"2021","Wigan 007B","E01006388",807,255,92,163,523,57,210,77,94,39,143,69,66,8,110,66,44,3,3,29,14,15
"2021","Wigan 007C","E01006389",506,91,31,60,394,38,229,80,88,61,66,28,35,3,61,42,19,0,0,21,8,13
"2021","Wigan 007D","E01006391",666,170,103,67,467,112,219,99,69,51,71,27,35,9,62,28,34,3,3,29,11,18
"2021","Wigan 008A","E01006257",534,169,67,102,353,37,149,47,60,42,103,54,43,6,59,29,30,5,5,12,6,6
"2021","Wigan 008B","E01006258",710,250,114,136,440,64,220,74,97,49,87,52,31,4,69,39,30,0,0,20,9,11
"2021","Wigan 008C","E01006369",1050,482,94,388,518,28,168,64,89,15,170,97,67,6,137,90,47,15,15,50,14,36
"2021","Wigan 008D","E01006371",646,207,77,130,406,38,188,72,73,43,106,61,41,4,69,40,29,5,5,33,18,15
"2021","Wigan 008E","E01006375",741,243,75,168,453,55,232,90,104,38,96,55,34,7,67,39,28,3,3,45,17,28
"2021","Wigan 009A","E01006306",832,456,148,308,337,33,110,48,44,18,91,52,33,6,94,51,43,9,9,39,14,25
"2021","Wigan 009B","E01006307",609,203,77,126,378,47,176,66,64,46,85,35,39,11,68,40,28,2,2,28,12,16
"2021","Wigan 009C","E01006386",932,593,190,403,316,35,95,44,32,19,64,38,23,3,114,61,53,8,8,23,7,16
"2021","Wigan 009D","E01006387",574,174,73,101,379,39,146,67,44,35,92,44,43,5,99,66,33,3,3,21,11,10
"2021","Wigan 009E","E01006392",598,207,55,152,357,15,144,39,77,28,84,31,42,11,107,77,30,7,7,34,25,9
"2021","Wigan 010A","E01006350",738,229,106,123,467,32,156,48,77,31,115,41,66,8,154,114,40,10,10,42,20,22
"2021","Wigan 010B","E01006351",869,274,88,186,545,30,165,59,79,27,133,43,77,13,209,140,69,8,8,50,27,23
"2021","Wigan 010C","E01006357",641,174,99,75,427,28,148,36,76,36,104,26,68,10,145,108,37,2,2,40,27,13
"2021","Wigan 010D","E01006360",691,214,62,152,437,22,133,50,42,41,125,37,75,13,145,95,50,12,12,40,26,14
"2021","Wigan 010E","E01006361",658,196,58,138,424,26,137,42,69,26,113,40,63,10,141,100,41,7,7,38,21,17
"2021","Wigan 011A","E01006356",572,165,66,99,367,31,161,49,59,53,83,29,41,13,92,54,38,0,0,40,24,16
"2021","Wigan 011B","E01006396",602,141,68,73,437,73,220,84,93,43,88,51,31,6,54,29,25,2,2,24,11,13
"2021","Wigan 011C","E01006397",568,272,135,137,295,34,129,48,55,26,68,34,29,5,63,40,23,1,1,1,0,1
"2021","Wigan 011D","E01006398",488,192,74,118,277,31,115,43,49,23,71,30,34,7,58,36,22,2,2,19,5,14
"2021","Wigan 011E","E01006399",698,213,86,127,457,53,213,63,106,44,107,66,38,3,77,49,28,7,7,28,13,15
"2021","Wigan 012A","E01006305",670,193,65,128,431,35,160,39,75,46,88,23,56,9,139,83,56,9,9,46,30,16
"2021","Wigan 012B","E01006308",698,226,69,157,426,38,164,62,70,32,115,47,55,13,99,60,39,10,10,46,25,21
"2021","Wigan 012C","E01006309",651,161,45,116,459,20,190,58,87,45,112,43,58,11,133,90,43,4,4,31,18,13
"2021","Wigan 012D","E01006310",710,268,110,158,408,42,146,43,71,32,105,44,49,12,109,68,41,6,6,34,19,15
"2021","Wigan 012E","E01006311",634,186,83,103,408,49,168,67,66,35,88,32,49,7,99,62,37,4,4,40,24,16
"2021","Wigan 013A","E01006269",819,309,148,161,473,77,206,76,78,52,91,42,45,4,90,58,32,9,9,37,14,23
"2021","Wigan 013B","E01006271",749,222,85,137,500,82,244,101,86,57,104,62,35,7,69,34,35,1,1,27,13,14
"2021","Wigan 013C","E01006272",758,294,78,216,440,41,202,77,82,43,104,52,48,4,89,59,30,4,4,24,9,15
"2021","Wigan 013D","E01006273",655,212,92,120,415,61,163,64,57,42,90,48,39,3,100,65,35,1,1,28,14,14
"2021","Wigan 013E","E01006276",890,234,95,139,620,46,334,113,159,62,130,70,53,7,105,63,42,5,5,36,18,18
"2021","Wigan 014A","E01006353",663,205,81,124,426,72,187,80,60,47,90,46,35,9,70,35,35,7,7,32,12,20
"2021","Wigan 014B","E01006354",629,220,119,101,388,42,153,60,56,37,99,36,55,8,88,57,31,6,6,21,12,9
"2021","Wigan 014C","E01006355",695,236,89,147,435,76,173,72,56,45,111,58,49,4,73,40,33,2,2,24,13,11
"2021","Wigan 014D","E01006358",927,309,130,179,579,59,224,79,100,45,174,78,82,14,117,75,42,5,5,39,21,18
"2021","Wigan 014E","E01006359",591,187,83,104,373,47,149,52,62,35,77,26,43,8,96,62,34,4,4,31,18,13
"2021","Wigan 015A","E01006349",1013,401,104,297,545,47,207,82,87,38,189,128,51,10,96,49,47,6,6,67,15,52
"2021","Wigan 015B","E01006352",869,253,71,182,571,49,206,99,74,33,166,84,76,6,138,104,34,12,12,45,29,16
"2021","Wigan 015C","E01006404",733,245,92,153,455,34,203,53,107,43,108,45,54,9,105,73,32,5,5,33,23,10
"2021","Wigan 015D","E01006405",787,297,125,172,453,46,180,70,73,37,123,51,63,9,102,69,33,2,2,37,21,16
"2021","Wigan 015E","E01006411",671,301,100,201,344,31,114,42,56,16,72,21,41,10,126,85,41,1,1,26,13,13
"2021","Wigan 016A","E01006270",634,240,124,116,353,77,141,49,47,45,64,24,35,5,66,32,34,5,5,41,25,16
"2021","Wigan 016B","E01006274",667,233,113,120,408,34,138,40,64,34,113,38,63,12,121,88,33,2,2,26,16,10
"2021","Wigan 016C","E01006275",684,236,112,124,419,40,135,33,68,34,93,31,52,10,145,97,48,6,6,29,16,13
"2021","Wigan 016D","E01006277",674,98,36,62,549,50,340,107,165,68,106,40,54,12,52,33,19,1,1,27,20,7
"2021","Wigan 016E","E01006286",698,232,144,88,436,112,184,72,64,48,81,38,32,11,56,31,25,3,3,30,15,15
"2021","Wigan 017A","E01006239",999,452,143,309,511,44,187,55,90,42,105,45,50,10,156,104,52,19,19,36,18,18
"2021","Wigan 017B","E01006240",599,149,50,99,409,26,134,41,67,26,107,36,68,3,138,104,34,4,4,41,17,24
"2021","Wigan 017C","E01006241",976,236,69,167,692,40,249,69,145,35,218,121,86,11,177,120,57,8,8,48,32,16
"2021","Wigan 017D","E01006287",485,107,62,45,348,83,182,67,69,46,47,22,18,7,35,19,16,1,1,30,14,16
"2021","Wigan 017E","E01006289",807,346,96,250,423,30,143,51,63,29,104,52,44,8,139,95,44,7,7,38,23,15
"2021","Wigan 018A","E01006362",731,208,118,90,505,105,259,94,121,44,86,48,36,2,52,30,22,3,3,18,10,8
"2021","Wigan 018B","E01006363",714,225,173,52,467,127,222,89,76,57,70,34,34,2,43,16,27,5,5,22,7,15
"2021","Wigan 018C","E01006364",830,293,130,163,511,69,244,73,137,34,91,42,40,9,104,69,35,3,3,26,10,16
"2021","Wigan 018D","E01006365",869,172,80,92,676,86,403,110,207,86,97,40,50,7,90,57,33,0,0,21,12,9
"2021","Wigan 018E","E01006366",871,312,151,161,539,95,259,86,111,62,102,50,43,9,81,46,35,2,2,20,8,12
"2021","Wigan 018F","E01006367",770,195,111,84,560,124,278,105,126,47,91,47,42,2,65,48,17,2,2,15,6,9
"2021","Wigan 018G","E01006368",820,229,140,89,576,99,279,94,126,59,112,59,44,9,83,50,33,3,3,15,6,9
"2021","Wigan 019A","E01006278",749,220,112,108,493,111,189,84,59,46,99,46,48,5,89,49,40,5,5,36,23,13
"2021","Wigan 019B","E01006279",636,136,68,68,474,89,242,86,109,47,87,37,46,4,54,30,24,2,2,26,13,13
"2021","Wigan 019C","E01006280",641,190,108,82,429,75,197,80,67,50,73,30,34,9,81,48,33,3,3,22,10,12
"2021","Wigan 019D","E01006281",796,178,87,91,581,85,291,113,120,58,129,60,64,5,71,44,27,5,5,37,19,18
"2021","Wigan 019E","E01006285",823,191,105,86,598,124,314,142,110,62,104,59,41,4,50,23,27,6,6,34,13,21
"2021","Wigan 020A","E01006406",621,163,90,73,442,111,198,81,61,56,73,36,29,8,56,25,31,4,4,16,11,5
"2021","Wigan 020B","E01006407",596,141,66,75,431,84,223,81,77,65,75,23,45,7,48,26,22,1,1,24,11,13
"2021","Wigan 020C","E01006408",704,172,68,104,499,46,198,62,83,53,112,39,65,8,142,92,50,1,1,33,17,16
"2021","Wigan 020D","E01006409",575,145,92,53,417,104,201,78,65,58,69,30,29,10,42,17,25,1,1,13,4,9
"2021","Wigan 020E","E01006410",534,121,75,46,395,85,238,86,82,70,37,16,20,1,29,14,15,6,6,18,8,10
"2021","Wigan 021A","E01006393",607,167,90,77,431,88,219,79,77,63,83,44,33,6,41,22,19,0,0,9,3,6
"2021","Wigan 021B","E01006394",643,150,99,51,469,120,229,77,102,50,64,31,28,5,55,27,28,1,1,24,13,11
"2021","Wigan 021C","E01006395",932,118,41,77,784,72,523,125,286,112,119,50,57,12,70,48,22,0,0,30,16,14
"2021","Wigan 021D","E01006400",729,114,46,68,593,66,348,84,201,63,116,55,56,5,62,44,18,1,1,22,13,9
"2021","Wigan 021E","E01006401",558,143,75,68,390,79,206,62,92,52,65,29,30,6,39,21,18,1,1,25,14,11
"2021","Wigan 021F","E01006402",471,112,75,37,344,84,184,62,66,56,49,19,25,5,27,8,19,0,0,15,9,6
"2021","Wigan 021G","E01006403",680,139,86,53,507,127,253,83,99,71,70,34,28,8,55,20,35,2,2,34,13,21
"2021","Wigan 022A","E01006290",625,189,97,92,411,107,191,68,84,39,67,31,29,7,44,26,18,2,2,25,15,10
"2021","Wigan 022B","E01006291",688,244,91,153,421,47,167,63,60,44,107,51,47,9,98,57,41,2,2,23,10,13
"2021","Wigan 022C","E01006292",655,172,106,66,458,96,201,87,62,52,77,38,30,9,79,41,38,5,5,25,16,9
"2021","Wigan 022D","E01006293",758,285,112,173,443,61,190,77,85,28,96,46,46,4,92,66,26,4,4,30,11,19
"2021","Wigan 023A","E01006242",868,260,109,151,578,87,213,96,84,33,147,88,52,7,127,73,54,4,4,30,19,11
"2021","Wigan 023B","E01006243",907,252,105,147,623,88,292,105,134,53,154,69,74,11,85,51,34,4,4,32,15,17
"2021","Wigan 023C","E01006244",884,451,204,247,406,61,127,55,49,23,112,61,44,7,102,65,37,4,4,27,10,17
"2021","Wigan 023D","E01006245",1157,355,108,247,764,88,343,106,174,63,196,100,80,16,135,94,41,2,2,38,15,23
"2021","Wigan 024A","E01006213",699,270,88,182,394,28,161,55,67,39,78,30,38,10,122,95,27,5,5,35,14,21
"2021","Wigan 024B","E01006215",757,299,109,190,418,44,169,65,72,32,101,51,48,2,99,62,37,5,5,40,20,20
"2021","Wigan 024C","E01006217",935,228,96,132,667,64,297,80,159,58,160,57,85,18,135,94,41,11,11,40,20,20
"2021","Wigan 024D","E01006218",995,283,67,216,655,40,277,90,145,42,199,89,99,11,138,99,39,1,1,57,27,30
"2021","Wigan 024E","E01006219",522,137,61,76,364,81,160,63,57,40,52,26,20,6,66,36,30,5,5,21,12,9
"2021","Wigan 025A","E01006288",758,233,106,127,485,70,151,60,64,27,113,40,69,4,145,97,48,6,6,40,22,18
"2021","Wigan 025B","E01006294",910,321,75,246,555,33,225,93,92,40,145,79,53,13,145,100,45,7,7,34,8,26
"2021","Wigan 025C","E01006295",801,345,122,223,437,52,162,46,69,47,113,60,46,7,105,59,46,5,5,19,6,13
"2021","Wigan 025D","E01006377",658,167,95,72,462,99,249,83,106,60,72,35,32,5,42,16,26,0,0,29,13,16
"2021","Wigan 025E","E01006378",595,179,119,60,395,88,198,89,73,36,69,29,36,4,40,13,27,0,0,21,7,14
"2021","Wigan 026A","E01006212",582,143,90,53,417,101,187,70,81,36,72,31,35,6,56,29,27,1,1,22,12,10
"2021","Wigan 026B","E01006214",609,205,50,155,383,39,150,53,56,41,89,35,46,8,102,69,33,3,3,21,10,11
"2021","Wigan 026C","E01006216",872,197,78,119,639,77,315,108,158,49,148,71,65,12,94,55,39,5,5,36,25,11
"2021","Wigan 026D","E01006322",875,232,59,173,592,37,225,83,106,36,201,100,88,13,127,87,40,2,2,51,27,24
"2021","Wigan 026E","E01006329",487,151,45,106,308,32,142,47,58,37,63,28,28,7,68,41,27,3,3,28,15,13
"2021","Wigan 027A","E01006282",749,198,93,105,524,75,236,85,110,41,114,53,56,5,94,63,31,5,5,27,15,12
"2021","Wigan 027B","E01006283",719,260,76,184,427,33,163,63,73,27,107,48,54,5,120,83,37,4,4,32,13,19
"2021","Wigan 027C","E01006284",675,226,81,145,416,48,191,69,81,41,87,39,41,7,87,46,41,3,3,33,21,12
"2021","Wigan 027D","E01006336",701,262,87,175,409,29,133,43,66,24,99,35,60,4,132,89,43,16,16,30,21,9
"2021","Wigan 027E","E01006337",669,202,84,118,444,68,218,95,88,35,83,35,37,11,72,37,35,3,3,23,9,14
"2021","Wigan 028A","E01006376",739,239,91,148,468,41,195,57,101,37,94,33,54,7,136,86,50,2,2,32,19,13
"2021","Wigan 028B","E01006381",772,143,38,105,600,53,380,120,200,60,89,40,46,3,77,49,28,1,1,29,14,15
"2021","Wigan 028C","E01006382",511,97,67,30,397,99,219,73,90,56,46,12,33,1,33,20,13,0,0,17,12,5
"2021","Wigan 028D","E01006383",629,133,62,71,467,52,255,81,125,49,87,35,41,11,72,39,33,1,1,29,17,12
"2021","Wigan 028E","E01006384",586,173,77,96,399,63,217,87,83,47,73,28,41,4,43,15,28,3,3,14,6,8
"2021","Wigan 029A","E01006250",915,232,84,148,663,114,321,111,166,44,158,81,71,6,70,39,31,0,0,20,7,13
"2021","Wigan 029B","E01006251",655,167,78,89,458,71,229,93,92,44,102,57,38,7,55,29,26,1,1,30,13,17
"2021","Wigan 029C","E01006379",689,186,102,84,480,87,217,73,99,45,98,47,47,4,77,42,35,1,1,23,8,15
"2021","Wigan 029D","E01006380",1148,293,121,172,803,44,350,124,178,48,252,130,107,15,153,97,56,4,4,52,23,29
"2021","Wigan 029E","E01006385",602,131,83,48,447,108,220,79,95,46,72,31,35,6,46,23,23,1,1,24,9,15
"2021","Wigan 030A","E01006328",702,280,75,205,380,24,138,51,62,25,105,47,53,5,105,69,36,8,8,42,19,23
"2021","Wigan 030B","E01006333",1013,455,95,360,518,45,205,77,99,29,141,84,51,6,114,82,32,13,13,40,18,22
"2021","Wigan 030C","E01006334",1000,404,91,313,543,27,176,71,78,27,173,90,73,10,150,101,49,17,17,53,18,35
"2021","Wigan 030D","E01006338",783,303,97,206,446,41,163,72,61,30,139,58,79,2,100,66,34,3,3,34,19,15
"2021","Wigan 031A","E01006248",1021,359,76,283,634,32,193,65,93,35,228,90,131,7,176,123,53,5,5,28,15,13
"2021","Wigan 031B","E01006249",665,171,73,98,459,55,181,65,84,32,107,39,60,8,111,75,36,5,5,35,20,15
"2021","Wigan 031C","E01006330",670,153,82,71,497,120,253,106,85,62,77,43,33,1,47,27,20,0,0,20,10,10
"2021","Wigan 031D","E01006331",640,133,73,60,493,95,272,104,97,71,71,33,33,5,52,26,26,3,3,14,9,5
"2021","Wigan 031E","E01006332",911,393,93,300,491,47,226,86,96,44,131,69,52,10,77,49,28,10,10,27,13,14
"2021","Wigan 032A","E01006262",704,192,72,120,483,37,197,66,82,49,130,65,56,9,116,78,38,3,3,29,16,13
"2021","Wigan 032B","E01006263",639,172,116,56,447,130,226,64,90,72,46,20,24,2,44,17,27,1,1,20,9,11
"2021","Wigan 032C","E01006266",627,173,128,45,432,125,184,86,51,47,70,26,35,9,52,19,33,1,1,22,9,13
"2021","Wigan 032D","E01006267",730,294,147,147,408,51,148,50,59,39,88,21,54,13,115,80,35,6,6,28,12,16
"2021","Wigan 032E","E01006268",702,219,100,119,462,63,231,72,97,62,82,32,42,8,82,56,26,4,4,21,10,11
"2021","Wigan 033A","E01006323",642,185,81,104,431,47,166,63,74,29,104,43,52,9,110,69,41,4,4,26,18,8
"2021","Wigan 033B","E01006324",634,253,97,156,353,52,146,67,45,34,72,36,33,3,77,47,30,6,6,28,9,19
"2021","Wigan 033C","E01006325",636,161,72,89,442,64,199,85,60,54,93,42,41,10,83,50,33,3,3,33,16,17
"2021","Wigan 033D","E01006326",699,295,92,203,370,30,117,48,36,33,104,51,47,6,112,68,44,7,7,34,8,26
"2021","Wigan 033E","E01006327",1054,323,130,193,677,27,248,82,129,37,239,121,110,8,158,100,58,5,5,54,23,31
"2021","Wigan 034A","E01006246",717,253,96,157,444,78,175,70,75,30,90,40,44,6,96,51,45,5,5,20,10,10
"2021","Wigan 034B","E01006247",552,145,83,62,385,75,187,79,52,56,68,30,33,5,55,27,28,0,0,22,9,13
"2021","Wigan 034C","E01006252",624,187,97,90,409,103,189,68,75,46,72,23,37,12,45,25,20,0,0,28,11,17
"2021","Wigan 034D","E01006297",739,284,91,193,420,28,132,41,57,34,98,35,55,8,156,103,53,6,6,35,20,15
"2021","Wigan 034E","E01006335",765,313,82,231,421,35,154,75,48,31,128,54,61,13,100,65,35,4,4,31,12,19
"2021","Wigan 035A","E01006220",762,246,115,131,491,76,186,74,65,47,103,36,57,10,124,75,49,2,2,25,13,12
"2021","Wigan 035B","E01006221",695,191,89,102,488,89,217,90,82,45,92,48,37,7,85,51,34,5,5,16,7,9
"2021","Wigan 035C","E01006222",634,136,86,50,474,102,263,85,113,65,57,24,26,7,50,25,25,2,2,24,9,15
"2021","Wigan 035D","E01006224",501,59,28,31,419,34,260,84,122,54,69,26,32,11,55,37,18,1,1,23,11,12
"2021","Wigan 035E","E01006226",756,221,112,109,503,101,240,88,111,41,78,38,34,6,79,48,31,5,5,32,15,17
"2021","Wigan 036A","E01006223",755,295,94,201,438,59,181,74,70,37,121,69,40,12,71,41,30,6,6,22,4,18
"2021","Wigan 036B","E01006225",639,173,96,77,441,118,217,77,92,48,61,32,23,6,44,25,19,1,1,25,14,11
"2021","Wigan 036C","E01006261",649,201,120,81,428,76,166,57,64,45,88,36,43,9,91,47,44,7,7,20,8,12
"2021","Wigan 036D","E01006264",515,96,71,25,409,101,225,86,83,56,38,20,15,3,44,20,24,1,1,10,6,4
"2021","Wigan 036E","E01006265",623,192,83,109,408,72,169,66,69,34,75,37,30,8,90,53,37,2,2,23,6,17
"2021","Wigan 037A","E01006296",688,250,71,179,414,26,148,48,68,32,111,41,61,9,124,77,47,5,5,24,12,12
"2021","Wigan 037B","E01006298",678,292,128,164,365,39,130,35,64,31,83,43,32,8,109,69,40,4,4,21,12,9
"2021","Wigan 037C","E01006299",873,284,119,165,560,88,269,86,136,47,119,63,41,15,80,48,32,4,4,29,11,18
"2021","Wigan 037D","E01006300",607,174,127,47,416,120,225,73,99,53,42,18,19,5,29,12,17,0,0,17,4,13
"2021","Wigan 037E","E01006301",589,107,72,35,463,97,261,86,121,54,68,32,27,9,35,15,20,2,2,19,8,11
"2021","Wigan 038A","E01006227",631,140,63,77,465,74,232,87,94,51,81,31,40,10,77,48,29,1,1,26,14,12
"2021","Wigan 038B","E01006228",745,257,79,178,463,54,179,84,67,28,119,53,59,7,108,81,27,3,3,25,12,13
"2021","Wigan 038C","E01006342",705,256,123,133,424,52,164,61,67,36,103,47,46,10,101,59,42,4,4,25,11,14
"2021","Wigan 038D","E01006344",575,159,96,63,381,53,139,43,59,37,77,29,42,6,107,63,44,5,5,35,19,16
"2021","Wigan 038E","E01006346",944,334,127,207,570,68,253,93,118,42,153,82,66,5,93,62,31,3,3,40,24,16
"2021","Wigan 039A","E01006339",577,168,105,63,394,118,181,78,61,42,51,23,23,5,42,17,25,2,2,15,7,8
"2021","Wigan 039B","E01006340",821,238,96,142,552,60,238,92,95,51,162,94,59,9,89,48,41,3,3,31,15,16
"2021","Wigan 039C","E01006343",642,127,46,81,488,80,276,94,120,62,76,32,41,3,56,32,24,0,0,27,12,15
"2021","Wigan 039D","E01006345",676,181,104,77,468,84,227,90,94,43,81,43,36,2,73,41,32,3,3,27,12,15
"2021","Wigan 039E","E01006348",1119,283,108,175,806,126,405,143,200,62,188,114,67,7,85,58,27,2,2,30,12,18
"2021","Wigan 040A","E01006302",778,199,72,127,552,70,262,89,120,53,138,82,51,5,81,53,28,1,1,27,15,12
"2021","Wigan 040B","E01006303",702,183,88,95,488,94,221,80,95,46,110,54,51,5,62,34,28,1,1,31,16,15
"2021","Wigan 040C","E01006304",659,186,90,96,456,90,194,69,85,40,101,54,38,9,70,39,31,1,1,17,9,8
"2021","Wigan 040D","E01006341",756,274,129,145,454,59,209,83,89,37,83,40,39,4,101,72,29,2,2,28,18,10
"2021","Wigan 040E","E01006347",649,163,121,42,465,112,257,95,112,50,57,29,23,5,39,21,18,0,0,21,9,12
"2021","Knowsley 001A","E01006448",853,246,91,155,547,21,143,47,52,44,118,36,71,11,255,177,78,10,10,60,32,28
"2021","Knowsley 001B","E01006492",513,105,51,54,375,58,150,51,46,53,66,18,36,12,98,54,44,3,3,33,20,13
"2021","Knowsley 001C","E01006493",725,157,66,91,526,21,161,47,73,41,151,77,66,8,186,143,43,7,7,42,20,22
"2021","Knowsley 001D","E01006494",685,153,46,107,465,27,131,43,57,31,81,35,42,4,218,168,50,8,8,67,40,27
"2021","Knowsley 001E","E01006495",858,156,45,111,643,43,234,60,120,54,135,48,70,17,227,152,75,4,4,59,31,28
"2021","Knowsley 002A","E01006454",661,174,98,76,449,66,190,63,65,62,110,52,55,3,77,43,34,6,6,38,20,18
"2021","Knowsley 002B","E01006456",683,242,133,109,406,55,214,72,68,74,71,25,37,9,62,29,33,4,4,35,21,14
"2021","Knowsley 002C","E01006457",551,153,101,52,369,99,149,48,44,57,66,30,30,6,53,16,37,2,2,29,17,12
"2021","Knowsley 002D","E01006458",655,191,82,109,434,51,146,46,57,43,94,32,58,4,135,79,56,8,8,30,14,16
"2021","Knowsley 002E","E01006490",1059,265,64,201,749,37,345,104,164,77,193,86,98,9,170,115,55,4,4,45,24,21
"2021","Knowsley 002F","E01006491",802,201,48,153,576,44,277,84,134,59,139,58,74,7,111,80,31,5,5,25,15,10
"2021","Knowsley 003A","E01006415",777,207,65,142,517,34,212,57,84,71,115,32,65,18,148,80,68,8,8,53,27,26
"2021","Knowsley 003B","E01006417",565,209,81,128,325,24,103,41,29,33,78,33,36,9,116,77,39,4,4,31,20,11
"2021","Knowsley 003C","E01006436",646,265,54,211,335,17,128,32,40,56,52,18,27,7,133,89,44,5,5,46,31,15
"2021","Knowsley 003D","E01006437",678,298,107,191,346,33,117,47,46,24,49,24,21,4,142,102,40,5,5,34,19,15
"2021","Knowsley 003E","E01006447",667,316,70,246,312,21,107,33,39,35,64,35,22,7,110,67,43,10,10,39,13,26
"2021","Knowsley 004A","E01006455",755,236,61,175,473,47,135,42,53,40,71,33,34,4,207,146,61,13,13,46,29,17
"2021","Knowsley 004B","E01006506",597,200,46,154,371,32,127,55,36,36,88,41,40,7,121,84,37,3,3,26,15,11
"2021","Knowsley 004C","E01006507",665,224,78,146,411,29,125,36,42,47,73,25,38,10,182,118,64,2,2,30,14,16
"2021","Knowsley 004D","E01006508",604,203,60,143,370,27,145,50,48,47,78,26,39,13,117,74,43,3,3,31,19,12
"2021","Knowsley 004E","E01006509",777,277,104,173,457,35,152,42,64,46,83,27,46,10,179,122,57,8,8,43,17,26
"2021","Knowsley 004F","E01006510",576,143,71,72,406,60,155,63,52,40,61,23,32,6,120,77,43,10,10,27,14,13
"2021","Knowsley 005A","E01006416",679,233,82,151,403,32,108,44,37,27,76,26,37,13,181,122,59,6,6,43,19,24
"2021","Knowsley 005B","E01006418",566,194,81,113,324,28,102,34,36,32,64,27,28,9,123,71,52,7,7,48,28,20
"2021","Knowsley 005C","E01006434",650,219,52,167,392,26,121,39,44,38,74,20,37,17,165,107,58,6,6,39,21,18
"2021","Knowsley 005D","E01006435",665,214,93,121,403,55,139,56,44,39,62,17,35,10,139,90,49,8,8,48,27,21
"2021","Knowsley 005E","E01006438",489,144,86,58,316,69,148,52,56,40,47,16,25,6,47,18,29,5,5,29,13,16
"2021","Knowsley 005F","E01006439",693,211,87,124,449,58,175,48,77,50,111,45,55,11,98,49,49,7,7,33,14,19
"2021","Knowsley 005G","E01006446",595,182,62,120,372,37,107,32,39,36,68,17,40,11,146,95,51,14,14,41,26,15
"2021","Knowsley 006A","E01006412",623,162,69,93,409,44,105,22,51,32,56,16,30,10,195,110,85,9,9,52,24,28
"2021","Knowsley 006B","E01006413",814,449,111,338,332,22,81,43,17,21,72,33,32,7,148,92,56,9,9,33,13,20
"2021","Knowsley 006C","E01006414",616,221,98,123,370,50,102,33,29,40,49,16,27,6,164,114,50,5,5,25,11,14
"2021","Knowsley 006E","E01034832",475,170,69,101,282,31,98,38,35,25,68,28,28,12,79,46,33,6,6,23,12,11
"2021","Knowsley 006F","E01034833",836,193,43,150,595,16,285,86,148,51,130,59,62,9,153,103,50,11,11,48,28,20
"2021","Knowsley 007A","E01006460",644,220,85,135,393,28,129,40,56,33,82,23,46,13,147,98,49,7,7,31,20,11
"2021","Knowsley 007B","E01006461",595,167,63,104,399,37,140,56,47,37,77,30,40,7,138,102,36,7,7,29,17,12
"2021","Knowsley 007D","E01006464",1190,364,167,197,784,78,327,115,143,69,256,168,83,5,116,76,40,7,7,42,13,29
"2021","Knowsley 007E","E01006466",743,304,141,163,422,51,171,68,63,40,104,56,43,5,89,46,43,7,7,17,5,12
"2021","Knowsley 007F","E01034834",711,411,116,295,281,22,81,43,26,12,59,32,22,5,109,63,46,10,10,19,9,10
"2021","Knowsley 007G","E01034835",537,223,24,199,297,10,140,43,85,12,79,43,32,4,62,44,18,6,6,17,7,10
"2021","Knowsley 008A","E01006453",511,162,56,106,329,16,90,29,32,29,52,20,29,3,165,103,62,6,6,20,9,11
"2021","Knowsley 008B","E01006467",561,164,62,102,367,22,99,34,34,31,51,20,25,6,187,123,64,8,8,30,13,17
"2021","Knowsley 008E","E01006470",622,229,77,152,354,19,126,49,40,37,64,19,30,15,132,73,59,13,13,39,18,21
"2021","Knowsley 008F","E01033228",1129,317,120,197,756,36,223,58,116,49,176,89,74,13,300,208,92,21,21,56,35,21
"2021","Knowsley 009A","E01006459",702,215,67,148,452,63,214,68,86,60,76,33,39,4,93,49,44,6,6,35,14,21
"2021","Knowsley 009B","E01006462",720,205,89,116,488,63,224,66,100,58,109,48,53,8,89,55,34,3,3,27,14,13
"2021","Knowsley 009C","E01006496",609,202,98,104,373,49,163,59,58,46,81,36,34,11,74,46,28,6,6,34,16,18
"2021","Knowsley 009D","E01006498",586,101,46,55,467,49,295,89,132,74,69,39,18,12,53,29,24,1,1,18,8,10
"2021","Knowsley 009E","E01006499",837,259,94,165,547,54,279,95,133,51,123,58,61,4,87,52,35,4,4,31,13,18
"2021","Knowsley 010A","E01006440",596,168,52,116,390,21,117,37,35,45,77,34,38,5,164,103,61,11,11,38,24,14
"2021","Knowsley 010B","E01006442",713,313,103,210,369,27,116,45,47,24,80,27,39,14,138,89,49,8,8,31,16,15
"2021","Knowsley 010C","E01006443",707,327,135,192,355,31,105,28,42,35,51,17,28,6,161,101,60,7,7,25,16,9
"2021","Knowsley 010D","E01006444",493,109,49,60,358,23,110,25,48,37,61,18,36,7,151,90,61,13,13,26,19,7
"2021","Knowsley 010E","E01006445",529,146,53,93,348,16,115,35,34,46,49,17,24,8,161,113,48,7,7,35,20,15
"2021","Knowsley 011A","E01006465",636,166,81,85,441,50,261,74,120,67,76,31,33,12,52,22,30,2,2,29,16,13
"2021","Knowsley 011B","E01006482",583,165,67,98,378,39,157,48,59,50,66,25,37,4,110,73,37,6,6,40,21,19
"2021","Knowsley 011C","E01006483",641,223,101,122,396,25,142,40,56,46,77,41,32,4,144,79,65,8,8,22,14,8
"2021","Knowsley 011D","E01006484",544,173,84,89,328,32,138,31,54,53,56,27,22,7,98,63,35,4,4,43,27,16
"2021","Knowsley 012A","E01006449",660,219,115,104,406,38,176,53,71,52,77,30,43,4,105,54,51,10,10,35,22,13
"2021","Knowsley 012B","E01006450",761,229,97,132,495,37,149,54,59,36,162,97,56,9,143,93,50,4,4,37,18,19
"2021","Knowsley 012C","E01006451",600,177,83,94,386,45,138,52,39,47,84,33,46,5,117,72,45,2,2,37,17,20
"2021","Knowsley 012D","E01006452",615,200,73,127,393,37,163,62,61,40,83,37,33,13,106,76,30,4,4,22,11,11
"2021","Knowsley 013A","E01006497",501,148,66,82,334,50,137,50,50,37,51,29,15,7,91,58,33,5,5,19,12,7
"2021","Knowsley 013B","E01006500",465,160,83,77,278,36,115,40,41,34,45,20,23,2,75,43,32,7,7,27,17,10
"2021","Knowsley 013C","E01006501",547,130,55,75,400,37,162,44,85,33,106,44,53,9,94,69,25,1,1,17,8,9
"2021","Knowsley 013D","E01006504",491,155,61,94,308,24,111,34,44,33,48,21,21,6,124,90,34,1,1,28,12,16
"2021","Knowsley 013E","E01006505",683,222,101,121,434,39,146,45,55,46,84,21,51,12,164,96,68,1,1,27,11,16
"2021","Knowsley 014A","E01006472",616,157,93,64,439,75,240,74,93,73,67,23,36,8,56,28,28,1,1,20,11,9
"2021","Knowsley 014B","E01006485",747,191,90,101,533,54,262,65,131,66,116,51,58,7,98,55,43,3,3,23,12,11
"2021","Knowsley 014C","E01006486",489,129,58,71,340,62,161,48,65,48,62,32,24,6,52,28,24,3,3,20,10,10
"2021","Knowsley 014D","E01006487",627,176,89,87,426,74,187,59,68,60,87,37,45,5,76,39,37,2,2,25,17,8
"2021","Knowsley 014E","E01006488",966,233,106,127,687,84,372,98,198,76,155,81,64,10,70,38,32,6,6,46,19,27
"2021","Knowsley 014F","E01006489",574,141,73,68,419,55,187,61,70,56,103,51,41,11,70,41,29,4,4,14,7,7
"2021","Knowsley 015A","E01006477",658,215,58,157,420,38,137,56,49,32,93,44,39,10,149,105,44,3,3,23,13,10
"2021","Knowsley 015B","E01006478",797,257,90,167,500,27,165,59,63,43,120,53,54,13,176,117,59,12,12,40,21,19
"2021","Knowsley 015C","E01006479",605,175,71,104,401,35,151,40,72,39,81,31,42,8,131,83,48,3,3,29,12,17
"2021","Knowsley 015D","E01006480",641,249,125,124,356,36,120,39,55,26,51,18,30,3,139,82,57,10,10,36,23,13
"2021","Knowsley 015E","E01006481",653,301,114,187,321,38,120,43,41,36,60,25,25,10,98,60,38,5,5,31,11,20
"2021","Knowsley 016A","E01006471",616,154,87,67,441,75,217,65,90,62,73,38,32,3,72,36,36,4,4,21,6,15
"2021","Knowsley 016B","E01006473",631,127,60,67,477,73,273,91,119,63,79,35,39,5,51,23,28,1,1,27,15,12
"2021","Knowsley 016C","E01006474",820,218,117,101,576,101,258,94,119,45,148,80,64,4,64,26,38,5,5,26,13,13
"2021","Knowsley 016D","E01006475",546,151,74,77,373,76,206,73,56,77,51,23,19,9,39,18,21,1,1,22,8,14
"2021","Knowsley 016E","E01006476",591,131,91,40,438,75,258,103,81,74,62,22,31,9,43,18,25,0,0,22,5,17
"2021","Knowsley 017A","E01006420",909,183,67,116,675,59,408,110,210,88,130,66,57,7,73,39,34,5,5,51,25,26
"2021","Knowsley 017B","E01006424",799,181,89,92,574,81,331,131,99,101,87,47,31,9,70,42,28,5,5,44,19,25
"2021","Knowsley 017C","E01006502",763,243,125,118,499,110,225,90,68,67,92,46,39,7,66,41,25,6,6,21,10,11
"2021","Knowsley 017D","E01006503",555,184,120,64,344,79,186,70,71,45,48,24,20,4,30,13,17,1,1,27,13,14
"2021","Knowsley 018A","E01006421",441,97,38,59,325,33,207,63,79,65,47,20,20,7,36,17,19,2,2,19,13,6
"2021","Knowsley 018B","E01006425",552,179,65,114,346,35,180,53,70,57,61,26,25,10,66,39,27,4,4,27,17,10
"2021","Knowsley 018C","E01006430",692,308,128,180,351,31,121,43,50,28,88,33,42,13,107,63,44,4,4,33,24,9
"2021","Knowsley 018D","E01006433",702,256,85,171,414,53,155,39,62,54,99,50,37,12,102,57,45,5,5,32,16,16
"2021","Knowsley 019A","E01006419",624,202,73,129,404,48,214,79,78,57,74,38,29,7,66,33,33,2,2,18,12,6
"2021","Knowsley 019B","E01006422",558,183,110,73,358,70,173,47,69,57,60,25,29,6,49,17,32,6,6,17,10,7
"2021","Knowsley 019C","E01006423",531,109,49,60,402,64,202,71,77,54,74,27,42,5,61,35,26,1,1,20,13,7
"2021","Knowsley 019D","E01006427",627,177,115,62,434,76,193,62,71,60,81,41,36,4,80,36,44,4,4,16,9,7
"2021","Knowsley 020A","E01006426",626,253,81,172,339,30,102,28,33,41,62,25,26,11,143,80,63,2,2,34,25,9
"2021","Knowsley 020B","E01006428",645,196,63,133,422,27,166,45,81,40,79,29,42,8,145,97,48,5,5,27,12,15
"2021","Knowsley 020C","E01006429",482,159,65,94,288,20,93,24,37,32,51,15,27,9,117,68,49,7,7,35,23,12
"2021","Knowsley 020D","E01006431",837,314,118,196,487,42,210,81,84,45,108,54,49,5,121,79,42,6,6,36,19,17
"2021","Knowsley 020E","E01006432",672,223,78,145,408,46,130,46,46,38,81,32,39,10,144,102,42,7,7,41,22,19
"2021","Liverpool 001A","E01006651",628,135,45,90,467,40,264,78,106,80,84,34,44,6,77,44,33,2,2,26,17,9
"2021","Liverpool 001B","E01006653",786,278,90,188,471,38,178,54,72,52,113,51,54,8,134,90,44,8,8,37,18,19
"2021","Liverpool 001C","E01006655",729,194,91,103,489,44,202,60,85,57,85,31,47,7,151,82,69,7,7,46,20,26
"2021","Liverpool 001D","E01006658",638,230,76,154,368,31,83,28,28,27,66,25,35,6,181,130,51,7,7,40,15,25
"2021","Liverpool 001E","E01006660",624,233,108,125,354,37,140,24,70,46,56,23,29,4,112,61,51,9,9,37,14,23
"2021","Liverpool 002A","E01006652",624,201,86,115,388,41,163,50,52,61,81,25,45,11,98,65,33,5,5,35,16,19
"2021","Liverpool 002B","E01006656",646,239,77,162,383,38,138,49,55,34,87,42,40,5,115,66,49,5,5,24,9,15
"2021","Liverpool 002C","E01006657",572,261,80,181,292,31,97,34,30,33,53,25,21,7,106,62,44,5,5,19,7,12
"2021","Liverpool 002D","E01006780",569,165,73,92,377,46,175,59,69,47,87,39,44,4,67,36,31,2,2,27,13,14
"2021","Liverpool 002E","E01006783",591,196,63,133,376,37,153,45,59,49,72,32,32,8,111,66,45,3,3,19,12,7
"2021","Liverpool 003A","E01006781",571,156,75,81,396,56,210,79,65,66,63,29,31,3,67,33,34,0,0,19,5,14
"2021","Liverpool 003B","E01006782",636,222,68,154,375,24,153,43,68,42,92,42,45,5,99,57,42,7,7,39,16,23
"2021","Liverpool 003C","E01006784",534,166,51,115,343,31,143,57,49,37,80,42,32,6,83,60,23,6,6,25,9,16
"2021","Liverpool 003D","E01006785",772,277,87,190,459,53,184,53,64,67,97,47,46,4,117,78,39,8,8,36,18,18
"2021","Liverpool 003E","E01006786",741,247,89,158,467,58,227,63,94,70,93,41,37,15,87,37,50,2,2,27,14,13
"2021","Liverpool 004A","E01006661",725,267,117,150,406,48,138,43,50,45,60,16,38,6,153,95,58,7,7,52,30,22
"2021","Liverpool 004B","E01006662",803,327,164,163,433,44,166,39,74,53,64,34,28,2,154,108,46,5,5,43,23,20
"2021","Liverpool 004C","E01006663",481,153,58,95,302,21,101,34,44,23,87,42,35,10,87,55,32,6,6,26,9,17
"2021","Liverpool 004D","E01006664",830,308,109,199,466,32,158,44,81,33,94,35,54,5,173,123,50,9,9,56,36,20
"2021","Liverpool 004E","E01006669",540,118,42,76,400,31,235,70,98,67,59,24,29,6,73,48,25,2,2,22,16,6
"2021","Liverpool 005A","E01006654",625,238,100,138,362,25,186,68,67,51,67,42,20,5,81,52,29,3,3,25,11,14
"2021","Liverpool 005B","E01006659",539,237,62,175,273,13,100,29,46,25,55,24,23,8,95,54,41,10,10,29,15,14
"2021","Liverpool 005C","E01006734",623,185,84,101,402,23,115,35,54,26,63,18,38,7,193,142,51,8,8,36,18,18
"2021","Liverpool 005D","E01006735",605,165,63,102,403,20,107,34,45,28,78,26,45,7,188,108,80,10,10,37,18,19
"2021","Liverpool 005E","E01006736",569,140,44,96,379,27,139,32,64,43,73,26,40,7,133,75,58,7,7,50,28,22
"2021","Liverpool 005F","E01006737",555,145,64,81,377,34,144,47,51,46,65,20,28,17,120,72,48,14,14,33,17,16
"2021","Liverpool 006A","E01006787",554,211,40,171,293,24,116,26,54,36,70,30,34,6,80,53,27,3,3,50,13,37
"2021","Liverpool 006B","E01006788",683,177,71,106,453,45,172,46,65,61,83,26,45,12,146,96,50,7,7,53,19,34
"2021","Liverpool 006C","E01006790",864,339,103,236,491,27,128,39,56,33,111,56,45,10,217,150,67,8,8,34,16,18
"2021","Liverpool 006D","E01006791",833,378,138,240,411,41,122,43,41,38,71,37,28,6,163,115,48,14,14,44,24,20
"2021","Liverpool 007A","E01006665",626,181,67,114,410,47,206,69,71,66,69,33,29,7,84,53,31,4,4,35,18,17
"2021","Liverpool 007B","E01006666",508,95,39,56,386,36,250,76,107,67,44,17,22,5,53,27,26,3,3,27,13,14
"2021","Liverpool 007C","E01006667",629,199,95,104,395,61,152,50,56,46,57,27,25,5,114,70,44,11,11,35,15,20
"2021","Liverpool 007D","E01006668",583,134,52,82,429,25,238,69,120,49,93,36,53,4,64,39,25,9,9,20,12,8
"2021","Liverpool 007E","E01006670",610,167,65,102,403,53,216,74,84,58,74,30,38,6,56,26,30,4,4,40,14,26
"2021","Liverpool 008A","E01006607",641,181,79,102,415,42,143,28,46,69,59,18,35,6,169,88,81,2,2,45,29,16
"2021","Liverpool 008B","E01006612",713,347,140,207,340,24,111,29,46,36,54,19,25,10,146,87,59,5,5,26,15,11
"2021","Liverpool 008C","E01006729",520,101,49,52,383,19,118,29,54,35,71,16,41,14,168,104,64,7,7,36,20,16
"2021","Liverpool 008F","E01032510",954,319,83,236,590,32,234,81,111,42,150,71,73,6,169,110,59,5,5,45,17,28
"2021","Liverpool 008G","E01032511",609,200,74,126,382,68,156,61,53,42,69,32,31,6,87,63,24,2,2,27,13,14
"2021","Liverpool 009A","E01006608",519,188,79,109,304,37,117,39,44,34,60,34,26,0,84,51,33,6,6,27,14,13
"2021","Liverpool 009B","E01006609",532,187,67,120,303,23,115,27,47,41,56,33,18,5,100,69,31,9,9,42,20,22
"2021","Liverpool 009C","E01006610",689,289,118,171,365,25,115,40,41,34,51,17,27,7,164,110,54,10,10,35,15,20
"2021","Liverpool 009D","E01006613",602,257,115,142,317,48,115,36,37,42,62,21,30,11,82,41,41,10,10,28,14,14
"2021","Liverpool 009E","E01006705",620,249,60,189,337,32,110,35,43,32,63,34,22,7,126,92,34,6,6,34,11,23
"2021","Liverpool 010A","E01006598",703,223,101,122,444,17,121,29,63,29,96,34,56,6,202,154,48,8,8,36,21,15
"2021","Liverpool 010B","E01006599",718,139,53,86,536,11,182,52,105,25,117,45,68,4,222,176,46,4,4,43,23,20
"2021","Liverpool 010E","E01006672",777,222,89,133,521,40,169,36,86,47,87,26,53,8,220,147,73,5,5,34,24,10
"2021","Liverpool 010G","E01034396",713,185,64,121,475,17,190,43,119,28,112,40,60,12,151,102,49,5,5,53,36,17
"2021","Liverpool 010H","E01034397",674,102,17,85,543,9,212,58,137,17,160,73,83,4,158,132,26,4,4,29,20,9
"2021","Liverpool 011A","E01006600",580,165,77,88,371,39,133,39,47,47,64,17,35,12,123,60,63,12,12,44,18,26
"2021","Liverpool 011B","E01006603",603,189,76,113,375,30,128,45,44,39,67,17,42,8,138,77,61,12,12,39,16,23
"2021","Liverpool 011C","E01006730",536,138,70,68,363,39,116,22,55,39,69,14,36,19,128,74,54,11,11,35,21,14
"2021","Liverpool 011D","E01006731",474,125,53,72,316,31,118,27,49,42,51,10,32,9,111,66,45,5,5,33,18,15
"2021","Liverpool 011E","E01006732",628,160,65,95,437,17,138,20,79,39,62,8,44,10,213,148,65,7,7,31,22,9
"2021","Liverpool 012A","E01006611",684,315,58,257,316,12,67,28,29,10,70,42,24,4,159,108,51,8,8,53,25,28
"2021","Liverpool 012B","E01006614",556,238,62,176,280,34,83,34,31,18,60,27,32,1,97,63,34,6,6,38,12,26
"2021","Liverpool 012C","E01006615",689,262,80,182,400,33,99,49,29,21,73,37,26,10,190,122,68,5,5,27,11,16
"2021","Liverpool 012D","E01006698",675,245,91,154,381,33,133,30,52,51,64,31,26,7,145,101,44,6,6,49,27,22
"2021","Liverpool 012E","E01006700",664,257,86,171,358,37,122,21,65,36,63,27,30,6,123,68,55,13,13,49,21,28
"2021","Liverpool 013A","E01006623",521,109,70,39,393,94,239,71,77,91,26,10,13,3,33,11,22,1,1,19,12,7
"2021","Liverpool 013B","E01006624",709,271,106,165,401,58,155,54,65,36,70,31,32,7,111,64,47,7,7,37,22,15
"2021","Liverpool 013C","E01006627",590,195,96,99,362,47,162,46,68,48,77,30,35,12,74,41,33,2,2,33,13,20
"2021","Liverpool 013D","E01006671",505,113,60,53,349,34,185,62,57,66,42,14,20,8,86,45,41,2,2,43,18,25
"2021","Liverpool 014A","E01006699",758,278,73,205,425,47,121,26,63,32,82,33,39,10,156,103,53,19,19,55,34,21
"2021","Liverpool 014B","E01006701",745,310,118,192,381,39,156,57,57,42,58,19,32,7,120,80,40,8,8,54,21,33
"2021","Liverpool 014C","E01006702",748,266,87,179,412,30,116,39,50,27,77,44,26,7,176,120,56,13,13,70,23,47
"2021","Liverpool 014D","E01006703",799,373,112,261,378,35,97,29,42,26,68,24,39,5,168,115,53,10,10,48,18,30
"2021","Liverpool 014E","E01006778",1076,495,158,337,503,36,128,38,58,32,109,58,36,15,213,124,89,17,17,78,32,46
"2021","Liverpool 015A","E01006541",766,344,119,225,391,47,133,43,50,40,84,57,21,6,120,78,42,7,7,31,12,19
"2021","Liverpool 015B","E01006543",500,148,67,81,323,55,171,65,40,66,38,14,17,7,58,34,24,1,1,29,16,13
"2021","Liverpool 015C","E01006544",718,249,85,164,436,29,136,37,56,43,60,24,29,7,206,135,71,5,5,33,13,20
"2021","Liverpool 015D","E01006616",605,233,114,119,334,40,140,42,44,54,52,19,28,5,93,55,38,9,9,38,22,16
"2021","Liverpool 015E","E01006762",728,216,86,130,470,50,195,69,86,40,59,21,28,10,161,88,73,5,5,42,19,23
"2021","Liverpool 016A","E01006604",611,152,67,85,413,26,161,49,52,60,78,20,46,12,143,80,63,5,5,46,25,21
"2021","Liverpool 016B","E01006605",685,248,112,136,404,38,157,39,69,49,72,30,30,12,131,81,50,6,6,33,17,16
"2021","Liverpool 016C","E01006618",694,226,125,101,425,45,171,42,73,56,68,27,34,7,128,70,58,13,13,43,22,21
"2021","Liverpool 016D","E01006625",607,211,117,94,377,69,161,41,61,59,69,31,31,7,73,40,33,5,5,19,12,7
"2021","Liverpool 016E","E01006626",588,162,104,58,396,59,207,59,81,67,54,25,25,4,72,37,35,4,4,30,11,19
"2021","Liverpool 017A","E01006637",651,215,79,136,412,28,150,30,83,37,68,26,33,9,157,119,38,9,9,24,14,10
"2021","Liverpool 017B","E01006638",560,179,64,115,343,19,100,33,39,28,58,28,28,2,162,115,47,4,4,38,20,18
"2021","Liverpool 017C","E01006639",658,184,75,109,438,35,193,50,85,58,94,40,43,11,109,75,34,7,7,36,12,24
"2021","Liverpool 017D","E01006644",925,398,120,278,478,30,197,51,89,57,99,57,35,7,143,91,52,9,9,49,27,22
"2021","Liverpool 017E","E01006645",686,282,132,150,369,29,122,28,66,28,57,22,31,4,151,98,53,10,10,35,22,13
"2021","Liverpool 018A","E01006542",587,200,40,160,337,21,143,25,76,42,57,21,29,7,99,64,35,17,17,50,16,34
"2021","Liverpool 018B","E01006558",612,261,45,216,303,21,84,18,45,21,57,33,20,4,135,84,51,6,6,48,24,24
"2021","Liverpool 018E","E01006562",695,298,80,218,353,22,104,33,38,33,75,30,40,5,145,107,38,7,7,44,20,24
"2021","Liverpool 018F","E01033747",809,304,119,185,454,23,176,40,112,24,114,54,54,6,135,86,49,6,6,51,28,23
"2021","Liverpool 019A","E01006545",598,186,59,127,379,26,126,38,50,38,58,27,25,6,157,109,48,12,12,33,20,13
"2021","Liverpool 019B","E01006546",588,216,47,169,314,21,119,45,51,23,54,28,15,11,110,71,39,10,10,58,21,37
"2021","Liverpool 019C","E01006547",745,280,67,213,380,21,111,36,51,24,69,41,28,0,166,113,53,13,13,85,15,70
"2021","Liverpool 019D","E01006548",760,309,75,234,381,23,121,27,71,23,77,34,37,6,145,94,51,15,15,70,32,38
"2021","Liverpool 019E","E01006766",584,240,38,202,302,14,96,25,53,18,52,29,18,5,125,75,50,15,15,42,19,23
"2021","Liverpool 019F","E01006767",806,332,70,262,398,20,163,45,85,33,78,36,36,6,127,87,40,10,10,76,27,49
"2021","Liverpool 020A","E01006606",683,226,79,147,427,50,154,54,53,47,93,38,49,6,122,78,44,8,8,30,9,21
"2021","Liverpool 020B","E01006761",703,333,83,250,334,31,121,45,46,30,65,32,25,8,109,73,36,8,8,36,9,27
"2021","Liverpool 020C","E01006763",644,193,68,125,411,39,117,35,51,31,66,36,23,7,184,136,48,5,5,40,18,22
"2021","Liverpool 020D","E01006764",679,261,63,198,363,29,125,27,63,35,70,31,33,6,125,82,43,14,14,55,24,31
"2021","Liverpool 020E","E01006765",654,220,73,147,387,25,145,43,63,39,102,55,37,10,107,58,49,8,8,47,18,29
"2021","Liverpool 020F","E01006768",585,235,56,179,298,36,145,45,59,41,57,26,20,11,56,32,24,4,4,52,24,28
"2021","Liverpool 021A","E01006617",693,274,102,172,390,48,191,66,80,45,81,45,30,6,67,31,36,3,3,29,17,12
"2021","Liverpool 021B","E01006619",780,263,115,148,479,61,214,57,100,57,107,52,49,6,90,54,36,7,7,38,19,19
"2021","Liverpool 021C","E01006620",625,236,147,89,374,72,188,56,80,52,54,19,29,6,57,28,29,3,3,15,9,6
"2021","Liverpool 021D","E01006621",651,179,101,78,435,91,236,64,103,69,60,27,26,7,46,23,23,2,2,37,16,21
"2021","Liverpool 021E","E01006622",586,111,64,47,453,91,259,76,115,68,58,27,30,1,43,23,20,2,2,22,10,12
"2021","Liverpool 021F","E01006640",755,209,102,107,497,62,285,66,155,64,65,27,33,5,81,43,38,4,4,49,22,27
"2021","Liverpool 022B","E01006776",901,362,148,214,485,57,149,63,48,38,108,66,31,11,155,85,70,16,16,54,14,40
"2021","Liverpool 022D","E01006779",922,364,163,201,485,36,128,28,59,41,71,27,27,17,232,128,104,18,18,73,31,42
"2021","Liverpool 022F","E01034398",480,168,58,110,267,10,112,26,73,13,50,21,22,7,89,55,34,6,6,45,21,24
"2021","Liverpool 022G","E01034399",589,308,103,205,233,29,73,24,38,11,47,26,20,1,78,45,33,6,6,48,9,39
"2021","Liverpool 022H","E01034400",546,255,66,189,263,17,69,26,28,15,67,48,15,4,101,56,45,9,9,28,4,24
"2021","Liverpool 023A","E01006560",946,467,149,318,422,34,122,31,54,37,54,22,26,6,202,129,73,10,10,57,29,28
"2021","Liverpool 023B","E01006564",779,314,146,168,424,80,146,42,48,56,54,29,21,4,138,76,62,6,6,41,29,12
"2021","Liverpool 023C","E01006646",934,433,95,338,443,28,153,45,79,29,105,71,28,6,148,60,88,9,9,58,23,35
"2021","Liverpool 023D","E01006648",1076,419,109,310,532,40,159,51,59,49,121,91,23,7,186,96,90,26,26,125,29,96
"2021","Liverpool 024A","E01006540",806,340,85,255,406,14,121,35,71,15,75,36,36,3,183,127,56,13,13,60,26,34
"2021","Liverpool 024B","E01006563",878,450,186,264,363,37,99,35,43,21,46,21,25,0,164,98,66,17,17,65,18,47
"2021","Liverpool 024C","E01006647",861,274,85,189,528,28,180,36,104,40,76,28,38,10,231,152,79,13,13,59,24,35
"2021","Liverpool 024D","E01006693",790,375,155,220,366,53,126,48,54,24,46,24,16,6,127,69,58,14,14,49,18,31
"2021","Liverpool 025A","E01006572",537,158,58,100,358,29,110,33,52,25,48,13,27,8,160,108,52,11,11,21,10,11
"2021","Liverpool 025B","E01006574",633,249,112,137,340,38,143,36,53,54,56,26,23,7,101,56,45,2,2,44,36,8
"2021","Liverpool 025C","E01006641",634,174,31,143,435,19,206,55,117,34,111,57,43,11,96,58,38,3,3,25,15,10
"2021","Liverpool 025D","E01006642",615,208,60,148,372,25,89,33,33,23,68,22,32,14,185,129,56,5,5,35,18,17
"2021","Liverpool 025E","E01006643",761,227,86,141,496,22,165,50,67,48,97,30,60,7,203,130,73,9,9,38,19,19
"2021","Liverpool 026A","E01006567",880,468,210,258,381,50,173,42,72,59,50,25,22,3,93,55,38,15,15,31,10,21
"2021","Liverpool 026B","E01006568",618,190,78,112,394,41,169,59,63,47,79,35,35,9,95,64,31,10,10,34,15,19
"2021","Liverpool 026C","E01006570",601,178,109,69,396,57,212,67,87,58,69,33,28,8,58,34,24,0,0,27,11,16
"2021","Liverpool 026D","E01006571",607,217,92,125,366,36,149,43,55,51,68,21,38,9,109,60,49,4,4,24,15,9
"2021","Liverpool 027A","E01006711",676,243,71,172,388,25,159,48,74,37,73,35,29,9,121,87,34,10,10,45,18,27
"2021","Liverpool 027D","E01006717",572,150,59,91,384,63,177,50,57,70,59,29,27,3,79,37,42,6,6,38,12,26
"2021","Liverpool 027E","E01006718",667,253,103,150,374,39,150,38,53,59,82,37,31,14,100,61,39,3,3,40,19,21
"2021","Liverpool 027F","E01006719",589,175,83,92,383,37,143,41,62,40,89,42,36,11,106,61,45,8,8,31,15,16
"2021","Liverpool 027G","E01032508",838,358,80,278,403,28,139,45,62,32,76,42,29,5,147,92,55,13,13,77,27,50
"2021","Liverpool 027H","E01032509",614,242,62,180,339,28,124,34,56,34,72,35,36,1,112,73,39,3,3,33,8,25
"2021","Liverpool 028A","E01006690",838,413,61,352,328,14,125,32,66,27,51,31,17,3,122,95,27,16,16,97,19,78
"2021","Liverpool 028B","E01006692",1084,413,118,295,567,36,225,60,122,43,100,50,34,16,178,111,67,28,28,104,34,70
"2021","Liverpool 028C","E01006695",934,515,78,437,359,14,125,34,61,30,99,60,33,6,106,51,55,15,15,60,18,42
"2021","Liverpool 028D","E01006759",425,146,39,107,226,21,91,33,33,25,60,39,12,9,51,25,26,3,3,53,24,29
"2021","Liverpool 028E","E01006760",676,341,78,263,260,12,104,37,47,20,72,49,18,5,60,34,26,12,12,75,15,60
"2021","Liverpool 029A","E01006565",624,165,80,85,416,57,165,52,68,45,69,26,32,11,115,62,53,10,10,43,18,25
"2021","Liverpool 029B","E01006569",605,204,88,116,362,42,119,34,48,37,66,27,34,5,127,68,59,8,8,39,20,19
"2021","Liverpool 029C","E01006573",749,370,156,214,345,39,105,39,40,26,61,39,15,7,134,81,53,6,6,34,8,26
"2021","Liverpool 029D","E01006712",525,185,66,119,313,28,119,47,45,27,58,25,27,6,96,56,40,12,12,27,13,14
"2021","Liverpool 029E","E01006713",576,189,79,110,357,33,148,53,56,39,74,35,31,8,99,66,33,3,3,30,15,15
"2021","Liverpool 030A","E01006691",661,192,63,129,287,12,90,27,51,12,60,43,15,2,108,70,38,17,17,182,21,161
"2021","Liverpool 030B","E01006694",824,300,75,225,383,21,139,23,94,22,74,36,33,5,115,81,34,34,34,141,37,104
"2021","Liverpool 030C","E01006696",820,273,81,192,436,26,200,49,111,40,63,32,31,0,132,73,59,15,15,111,23,88
"2021","Liverpool 030D","E01006697",750,248,66,182,307,20,111,27,68,16,70,24,43,3,88,54,34,18,18,195,22,173
"2021","Liverpool 030E","E01006746",669,218,76,142,291,30,97,15,57,25,35,13,13,9,120,52,68,9,9,160,15,145
"2021","Liverpool 031A","E01006512",540,260,34,226,195,1,76,34,34,8,78,76,2,0,31,17,14,9,9,85,5,80
"2021","Liverpool 031B","E01006747",731,308,53,255,279,20,76,24,43,9,70,50,18,2,82,42,40,31,31,144,10,134
"2021","Liverpool 031C","E01006748",707,183,53,130,174,16,64,17,32,15,30,18,12,0,51,23,28,13,13,350,11,339
"2021","Liverpool 031F","E01006751",791,335,139,196,342,21,104,21,65,18,57,29,16,12,148,69,79,12,12,114,29,85
"2021","Liverpool 031G","E01033763",1031,456,138,318,430,24,210,53,123,34,72,52,15,5,112,66,46,12,12,145,23,122
"2021","Liverpool 032A","E01006566",592,193,85,108,368,52,175,52,76,47,64,29,24,11,74,32,42,3,3,31,15,16
"2021","Liverpool 032B","E01006585",620,258,73,185,329,31,136,33,60,43,53,18,28,7,101,51,50,8,8,33,17,16
"2021","Liverpool 032C","E01006586",850,367,124,243,440,50,175,53,80,42,105,56,28,21,101,48,53,9,9,43,17,26
"2021","Liverpool 032D","E01006587",676,254,75,179,371,59,185,50,88,47,45,26,18,1,76,31,45,6,6,51,16,35
"2021","Liverpool 032E","E01006716",661,297,80,217,327,24,94,34,43,17,70,36,33,1,133,85,48,6,6,37,18,19
"2021","Liverpool 034A","E01006575",556,179,71,108,346,47,157,41,77,39,67,38,24,5,71,38,33,4,4,31,20,11
"2021","Liverpool 034B","E01006576",730,175,89,86,530,66,278,82,136,60,103,61,39,3,79,46,33,4,4,25,10,15
"2021","Liverpool 034C","E01006577",590,118,64,54,443,66,260,71,115,74,56,23,30,3,59,25,34,2,2,29,16,13
"2021","Liverpool 034D","E01006579",597,118,81,37,445,73,264,69,113,82,60,23,30,7,47,20,27,1,1,34,19,15
"2021","Liverpool 034E","E01006584",629,195,94,101,415,61,210,60,90,60,82,44,35,3,59,23,36,3,3,19,9,10
"2021","Liverpool 035B","E01006725",723,273,77,196,389,33,140,50,58,32,79,59,16,4,124,81,43,13,13,61,22,39
"2021","Liverpool 035C","E01006726",626,180,36,144,282,13,136,34,76,26,46,29,16,1,76,42,34,11,11,164,16,148
"2021","Liverpool 035D","E01006727",598,230,67,163,325,28,116,45,44,27,89,60,26,3,87,60,27,5,5,43,12,31
"2021","Liverpool 035E","E01006728",808,348,99,249,390,3,87,29,40,18,89,63,23,3,192,142,50,19,19,70,9,61
"2021","Liverpool 035G","E01034401",1520,534,106,428,787,28,333,68,217,48,110,56,49,5,231,157,74,85,85,199,68,131
"2021","Liverpool 036A","E01006578",539,125,59,66,385,48,192,44,92,56,75,27,43,5,70,32,38,0,0,29,12,17
"2021","Liverpool 036B","E01006580",508,108,76,32,379,66,237,69,117,51,41,18,16,7,35,15,20,0,0,21,14,7
"2021","Liverpool 036C","E01006581",597,116,65,51,453,85,255,69,123,63,64,31,30,3,47,20,27,2,2,28,17,11
"2021","Liverpool 036D","E01006773",552,137,71,66,390,62,192,67,80,45,68,32,33,3,68,34,34,0,0,25,15,10
"2021","Liverpool 036E","E01006774",535,111,62,49,404,43,242,68,95,79,73,30,38,5,42,21,21,4,4,20,8,12
"2021","Liverpool 037A","E01006514",772,463,97,366,206,11,80,38,34,8,76,62,11,3,25,14,11,14,14,103,4,99
"2021","Liverpool 037D","E01006673",942,427,109,318,419,6,172,32,131,9,85,61,17,7,135,77,58,21,21,96,27,69
"2021","Liverpool 037E","E01033757",523,309,19,290,150,3,38,15,20,3,55,49,6,0,21,15,6,33,33,64,1,63
"2021","Liverpool 037F","E01033768",739,473,65,408,191,3,41,23,14,4,93,87,4,2,50,27,23,4,4,75,5,70
"2021","Liverpool 037G","E01034402",583,436,32,404,114,10,23,14,5,4,48,41,6,1,26,12,14,7,7,33,1,32
"2021","Liverpool 037H","E01034403",637,295,74,221,282,14,75,33,32,10,100,85,12,3,80,50,30,13,13,60,10,50
"2021","Liverpool 038A","E01006550",499,115,28,87,158,16,62,23,31,8,43,31,11,1,33,11,22,4,4,226,18,208
"2021","Liverpool 038B","E01006557",583,131,39,92,174,11,67,20,33,14,41,33,6,2,48,25,23,7,7,278,14,264
"2021","Liverpool 038C","E01006721",816,403,111,292,353,7,109,34,62,13,95,64,27,4,132,95,37,10,10,60,12,48
"2021","Liverpool 038D","E01006722",562,93,26,67,167,7,88,19,51,18,27,20,5,2,40,21,19,5,5,302,21,281
"2021","Liverpool 038E","E01006723",691,248,72,176,203,17,80,25,38,17,39,32,7,0,55,28,27,12,12,240,17,223
"2021","Liverpool 038F","E01006724",505,118,37,81,182,13,72,22,39,11,42,23,15,4,46,19,27,9,9,205,17,188
"2021","Liverpool 039A","E01006552",766,290,48,242,391,14,153,29,112,12,62,42,18,2,147,103,44,15,15,85,36,49
"2021","Liverpool 039B","E01006556",835,360,81,279,379,7,170,35,119,16,58,29,27,2,135,85,50,9,9,96,23,73
"2021","Liverpool 039C","E01006674",885,334,109,225,476,14,205,23,158,24,50,24,24,2,195,119,76,12,12,75,40,35
"2021","Liverpool 039D","E01006679",951,356,85,271,495,4,235,36,172,27,47,27,18,2,192,91,101,17,17,100,60,40
"2021","Liverpool 040A","E01006709",671,258,110,148,387,32,146,48,66,32,81,32,39,10,124,74,50,4,4,26,8,18
"2021","Liverpool 040B","E01006769",660,284,133,151,349,56,110,47,38,25,66,26,30,10,111,64,47,6,6,27,14,13
"2021","Liverpool 040C","E01006770",505,178,73,105,308,28,104,28,50,26,64,21,38,5,107,56,51,5,5,19,12,7
"2021","Liverpool 040D","E01006771",811,367,198,169,411,48,120,38,41,41,72,36,27,9,168,68,100,3,3,33,13,20
"2021","Liverpool 040E","E01006772",493,159,88,71,311,38,135,43,45,47,61,25,32,4,74,36,38,3,3,23,13,10
"2021","Liverpool 040F","E01006775",667,220,97,123,406,45,131,46,50,35,81,38,35,8,142,69,73,7,7,41,24,17
"2021","Liverpool 041A","E01006582",610,121,68,53,460,78,284,70,141,73,54,21,30,3,44,17,27,0,0,29,21,8
"2021","Liverpool 041B","E01006589",578,139,83,56,410,63,231,57,111,63,65,34,23,8,49,15,34,2,2,29,11,18
"2021","Liverpool 041C","E01006591",625,195,75,120,397,38,197,57,104,36,92,47,40,5,67,34,33,3,3,33,8,25
"2021","Liverpool 041D","E01006592",603,172,119,53,391,70,243,62,118,63,34,21,13,0,40,20,20,4,4,40,12,28
"2021","Liverpool 041E","E01006597",695,202,114,88,457,90,242,80,117,45,69,30,32,7,49,24,25,7,7,36,13,23
"2021","Liverpool 042A","E01006553",541,124,34,90,287,16,127,38,70,19,84,63,17,4,54,29,25,6,6,130,12,118
"2021","Liverpool 042C","E01006588",695,245,78,167,386,41,159,55,79,25,96,61,27,8,86,51,35,4,4,64,13,51
"2021","Liverpool 042D","E01006590",657,213,70,143,370,21,151,54,74,23,116,74,39,3,75,40,35,7,7,74,14,60
"2021","Liverpool 042E","E01006593",589,158,37,121,371,25,166,50,90,26,108,68,38,2,65,45,20,7,7,60,9,51
"2021","Liverpool 042H","E01034404",426,112,38,74,265,17,108,38,52,18,85,53,30,2,51,18,33,4,4,49,6,43
"2021","Liverpool 043A","E01006520",1058,690,162,528,302,11,87,53,30,4,156,142,12,2,44,27,17,4,4,66,5,61
"2021","Liverpool 043B","E01006549",776,432,55,377,262,16,95,39,44,12,106,94,11,1,34,20,14,11,11,82,11,71
"2021","Liverpool 043C","E01006675",1110,664,95,569,367,12,110,47,60,3,147,126,20,1,86,48,38,12,12,79,10,69
"2021","Liverpool 043D","E01006677",657,180,56,124,437,5,155,41,101,13,127,88,33,6,143,97,46,7,7,40,15,25
"2021","Liverpool 044A","E01006518",816,360,120,240,391,32,152,45,76,31,55,35,14,6,142,78,64,10,10,65,24,41
"2021","Liverpool 044B","E01006630",958,302,66,236,560,17,184,54,106,24,176,114,49,13,162,97,65,21,21,96,34,62
"2021","Liverpool 044C","E01006632",858,372,96,276,438,22,156,45,78,33,82,40,30,12,167,108,59,11,11,48,14,34
"2021","Liverpool 044D","E01006676",799,281,69,212,435,8,167,28,123,16,57,25,23,9,188,132,56,15,15,83,44,39
"2021","Liverpool 044E","E01006678",949,445,152,293,439,32,112,36,51,25,86,50,25,11,193,106,87,16,16,65,24,41
"2021","Liverpool 045A","E01006706",557,194,97,97,323,30,91,28,31,32,40,9,23,8,155,89,66,7,7,40,23,17
"2021","Liverpool 045B","E01006707",582,183,96,87,365,30,114,30,55,29,70,23,35,12,147,83,64,4,4,34,21,13
"2021","Liverpool 045C","E01006708",750,233,109,124,480,40,184,46,95,43,85,33,42,10,159,100,59,12,12,37,20,17
"2021","Liverpool 045D","E01006710",633,216,88,128,392,54,135,46,37,52,60,14,39,7,139,88,51,4,4,25,12,13
"2021","Liverpool 046A","E01006792",568,162,94,68,389,86,225,69,107,49,40,16,22,2,33,14,19,5,5,17,9,8
"2021","Liverpool 046B","E01006794",712,217,107,110,459,99,215,76,95,44,82,54,25,3,60,33,27,3,3,36,13,23
"2021","Liverpool 046C","E01006800",677,239,149,90,415,128,175,58,73,44,62,29,29,4,47,22,25,3,3,23,11,12
"2021","Liverpool 046D","E01006801",835,222,122,100,597,93,301,100,145,56,133,72,57,4,66,28,38,4,4,16,6,10
"2021","Liverpool 047A","E01006532",617,151,97,54,445,116,256,66,117,73,42,19,21,2,29,11,18,2,2,21,13,8
"2021","Liverpool 047B","E01006539",587,160,96,64,402,107,222,74,92,56,43,25,14,4,27,15,12,3,3,25,11,14
"2021","Liverpool 047C","E01006583",462,81,62,19,361,75,234,51,121,62,24,11,12,1,26,17,9,2,2,20,7,13
"2021","Liverpool 047D","E01006594",558,152,88,64,389,101,234,69,110,55,33,18,11,4,20,10,10,1,1,17,6,11
"2021","Liverpool 047E","E01006796",619,132,84,48,459,98,287,76,143,68,43,16,20,7,28,8,20,3,3,28,8,20
"2021","Liverpool 048A","E01006522",1020,581,76,505,353,5,86,54,24,8,199,176,20,3,59,30,29,4,4,86,6,80
"2021","Liverpool 048B","E01006524",640,315,129,186,303,56,140,51,69,20,64,41,20,3,40,18,22,3,3,22,8,14
"2021","Liverpool 048C","E01006526",635,247,80,167,363,50,166,49,83,34,85,54,25,6,58,32,26,4,4,25,11,14
"2021","Liverpool 048D","E01006529",540,136,58,78,360,36,188,55,94,39,79,46,30,3,52,19,33,5,5,44,19,25
"2021","Liverpool 048E","E01006551",792,524,225,299,240,43,80,40,19,21,55,47,8,0,57,31,26,5,5,28,4,24
"2021","Liverpool 048F","E01006554",629,242,57,185,226,21,91,27,45,19,78,66,11,1,30,16,14,6,6,161,14,147
"2021","Liverpool 049A","E01006525",472,102,63,39,347,74,187,46,103,38,63,35,23,5,22,13,9,1,1,23,14,9
"2021","Liverpool 049B","E01006595",794,254,122,132,507,58,242,84,122,36,108,66,36,6,91,47,44,8,8,33,15,18
"2021","Liverpool 049C","E01006596",575,149,83,66,390,56,216,63,99,54,62,30,27,5,53,24,29,3,3,36,23,13
"2021","Liverpool 049D","E01006689",673,214,108,106,438,63,257,75,124,58,68,35,29,4,50,28,22,0,0,21,9,12
"2021","Liverpool 050B","E01006633",682,322,136,186,320,21,89,33,32,24,59,31,19,9,144,87,57,7,7,40,18,22
"2021","Liverpool 050F","E01032505",565,193,79,114,345,50,154,50,68,36,61,37,17,7,79,52,27,1,1,27,14,13
"2021","Liverpool 050G","E01032506",678,278,93,185,345,21,126,53,45,28,109,75,31,3,77,50,27,12,12,55,10,45
"2021","Liverpool 050H","E01032507",643,208,67,141,382,26,164,68,66,30,125,88,33,4,60,33,27,7,7,53,7,46
"2021","Liverpool 050I","E01033748",727,355,54,301,306,9,72,44,21,7,175,165,10,0,34,19,15,16,16,66,4,62
"2021","Liverpool 050J","E01033767",513,219,58,161,267,13,70,34,25,11,72,46,22,4,109,77,32,3,3,27,10,17
"2021","Liverpool 051A","E01006793",724,342,135,207,369,78,151,45,80,26,54,36,15,3,82,56,26,4,4,13,4,9
"2021","Liverpool 051B","E01006795",643,202,93,109,421,70,227,74,106,47,77,53,19,5,46,22,24,1,1,20,6,14
"2021","Liverpool 051C","E01006797",626,230,86,144,372,30,153,52,62,39,77,46,27,4,107,60,47,5,5,24,12,12
"2021","Liverpool 051D","E01006798",574,173,92,81,375,70,201,66,85,50,54,28,18,8,48,19,29,2,2,26,11,15
"2021","Liverpool 051E","E01006799",1048,660,411,249,375,67,155,76,47,32,87,61,22,4,64,31,33,2,2,13,5,8
"2021","Liverpool 052A","E01006521",894,494,173,321,346,71,127,47,56,24,78,62,14,2,64,35,29,6,6,54,11,43
"2021","Liverpool 052B","E01006523",808,422,113,309,324,19,125,57,51,17,102,85,16,1,71,36,35,7,7,62,9,53
"2021","Liverpool 052C","E01006528",572,185,50,135,331,31,159,42,89,28,85,54,26,5,49,28,21,7,7,56,20,36
"2021","Liverpool 052D","E01006628",653,233,101,132,373,36,168,56,76,36,109,80,26,3,50,23,27,10,10,47,11,36
"2021","Liverpool 052E","E01006629",601,202,89,113,369,59,158,66,60,32,93,46,36,11,56,28,28,3,3,30,14,16
"2021","Liverpool 053A","E01006527",649,241,117,124,372,52,179,55,85,39,63,39,20,4,76,38,38,2,2,36,15,21
"2021","Liverpool 053B","E01006680",583,120,80,40,430,84,251,59,130,62,51,23,25,3,40,12,28,4,4,33,11,22
"2021","Liverpool 053C","E01006682",494,103,68,35,369,65,227,59,118,50,44,17,21,6,33,14,19,0,0,22,8,14
"2021","Liverpool 053D","E01006683",583,114,76,38,459,77,279,72,147,60,54,23,27,4,49,25,24,0,0,10,8,2
"2021","Liverpool 053E","E01006686",527,109,77,32,384,68,225,69,108,48,40,19,16,5,51,20,31,0,0,34,17,17
"2021","Liverpool 054A","E01006534",749,195,73,122,515,47,293,81,139,73,69,30,36,3,96,50,46,10,10,39,19,20
"2021","Liverpool 054B","E01006535",651,205,85,120,408,34,201,62,79,60,87,36,45,6,79,25,54,7,7,38,22,16
"2021","Liverpool 054C","E01006536",803,273,127,146,482,47,197,58,79,60,90,37,39,14,136,66,70,12,12,48,26,22
"2021","Liverpool 054D","E01006681",691,259,101,158,409,73,219,64,101,54,50,20,24,6,66,36,30,1,1,23,17,6
"2021","Liverpool 055A","E01006530",604,169,108,61,415,80,206,63,95,48,72,33,34,5,54,22,32,3,3,20,9,11
"2021","Liverpool 055B","E01006531",655,228,169,59,408,98,207,60,97,50,67,32,34,1,32,9,23,4,4,19,5,14
"2021","Liverpool 055C","E01006533",594,207,118,89,363,65,187,54,83,50,59,31,24,4,50,22,28,2,2,24,11,13
"2021","Liverpool 055D","E01006537",1089,342,95,247,694,61,276,78,123,75,189,92,84,13,159,108,51,9,9,53,29,24
"2021","Liverpool 055E","E01006538",512,112,72,40,374,63,187,59,66,62,56,19,30,7,64,30,34,4,4,26,14,12
"2021","Liverpool 056A","E01006519",523,124,76,48,367,70,218,59,106,53,42,20,17,5,35,15,20,2,2,32,12,20
"2021","Liverpool 056B","E01006684",980,339,146,193,604,95,306,107,149,50,129,85,27,17,67,36,31,7,7,37,10,27
"2021","Liverpool 056C","E01006685",596,153,70,83,412,72,212,71,101,40,56,27,23,6,69,28,41,3,3,31,15,16
"2021","Liverpool 056D","E01006687",1037,363,168,195,634,75,369,107,219,43,118,47,65,6,69,37,32,3,3,40,20,20
"2021","Liverpool 056E","E01006688",722,264,82,182,416,63,191,49,102,40,83,53,29,1,73,42,31,6,6,42,16,26
"2021","Liverpool 057A","E01006740",683,222,83,139,417,25,133,39,75,19,79,31,41,7,174,118,56,6,6,44,22,22
"2021","Liverpool 057B","E01006742",653,170,69,101,451,38,181,36,90,55,97,45,47,5,129,78,51,6,6,32,13,19
"2021","Liverpool 057C","E01006744",734,311,99,212,397,34,145,60,55,30,99,54,38,7,111,75,36,8,8,26,13,13
"2021","Liverpool 057D","E01006745",852,346,63,283,454,20,141,60,54,27,107,62,36,9,174,115,59,12,12,52,12,40
"2021","Liverpool 058A","E01006738",645,237,83,154,385,33,102,32,40,30,73,26,39,8,171,108,63,6,6,23,16,7
"2021","Liverpool 058B","E01006739",1007,255,90,165,698,31,242,85,114,43,172,73,86,13,241,173,68,12,12,54,28,26
"2021","Liverpool 058C","E01006741",822,269,80,189,504,25,201,66,82,53,116,56,48,12,155,86,69,7,7,49,28,21
"2021","Liverpool 058D","E01006743",948,357,93,264,542,42,217,85,89,43,125,74,44,7,152,101,51,6,6,49,16,33
"2021","Liverpool 059A","E01006753",791,248,84,164,496,22,165,67,68,30,120,47,62,11,182,120,62,7,7,47,26,21
"2021","Liverpool 059B","E01006754",836,328,121,207,478,32,123,41,54,28,110,43,61,6,197,137,60,16,16,30,12,18
"2021","Liverpool 059C","E01006755",662,233,86,147,388,23,131,38,53,40,76,33,32,11,151,106,45,7,7,41,15,26
"2021","Liverpool 059D","E01006756",731,208,67,141,491,26,154,40,64,50,95,34,46,15,204,146,58,12,12,32,19,13
"2021","Liverpool 059E","E01006757",601,151,66,85,417,27,122,44,43,35,88,35,44,9,174,124,50,6,6,33,18,15
"2021","Liverpool 059F","E01006758",631,233,84,149,363,36,130,31,54,45,70,17,47,6,124,77,47,3,3,35,18,17
"2021","Liverpool 060B","E01033758",490,279,18,261,139,4,47,33,9,5,47,46,1,0,22,13,9,19,19,72,1,71
"2021","Liverpool 060C","E01033760",438,259,9,250,110,1,26,20,5,1,70,69,0,1,3,2,1,10,10,69,0,69
"2021","Liverpool 060D","E01033761",1069,606,5,601,324,6,65,41,23,1,210,203,7,0,14,9,5,29,29,139,3,136
"2021","Liverpool 060E","E01033762",601,344,29,315,201,3,67,32,25,10,94,92,2,0,23,8,15,14,14,56,2,54
"2021","Liverpool 060F","E01034405",410,146,9,137,179,1,34,13,19,2,74,61,13,0,36,34,2,34,34,85,4,81
"2021","Liverpool 060G","E01034406",425,195,17,178,126,3,33,21,11,1,62,61,1,0,11,5,6,17,17,104,3,101
"2021","Liverpool 061A","E01033750",1138,537,37,500,463,28,139,89,40,10,245,231,13,1,24,11,13,27,27,138,4,134
"2021","Liverpool 061C","E01033756",575,301,25,276,166,24,54,35,16,3,61,60,1,0,5,2,3,22,22,108,3,105
"2021","Liverpool 061D","E01033765",720,275,88,187,408,23,123,49,50,24,110,81,19,10,142,90,52,10,10,37,11,26
"2021","Liverpool 061E","E01034407",703,263,5,258,271,1,48,31,17,0,198,190,7,1,6,1,5,18,18,169,2,167
"2021","Liverpool 061F","E01034408",744,352,75,277,281,11,75,42,26,7,131,113,11,7,56,23,33,8,8,111,10,101
"2021","Liverpool 062A","E01033751",858,451,54,397,321,14,83,53,20,10,140,133,7,0,55,28,27,29,29,86,5,81
"2021","Liverpool 062E","E01034409",1206,591,17,574,444,6,106,66,32,8,269,258,11,0,12,10,2,51,51,171,4,167
"2021","Liverpool 062F","E01034410",594,315,23,292,207,5,52,42,6,4,116,113,3,0,11,8,3,23,23,72,0,72
"2021","Liverpool 062G","E01034411",742,487,7,480,200,7,48,28,18,2,111,108,3,0,9,5,4,25,25,55,0,55
"2021","St. Helens 001A","E01006882",505,119,96,23,378,118,174,53,71,50,50,18,26,6,35,17,18,1,1,8,2,6
"2021","St. Helens 001B","E01006883",629,197,118,79,406,106,198,68,83,47,58,28,22,8,42,21,21,2,2,26,9,17
"2021","St. Helens 001C","E01006884",625,179,109,70,432,108,209,79,83,47,53,25,28,0,61,30,31,1,1,14,6,8
"2021","St. Helens 001D","E01006885",577,160,104,56,396,103,224,82,102,40,45,27,14,4,21,7,14,3,3,21,9,12
"2021","St. Helens 001E","E01006886",572,165,117,48,390,99,180,81,57,42,65,34,30,1,45,15,30,1,1,17,11,6
"2021","St. Helens 001F","E01006887",598,211,121,90,371,79,163,51,70,42,66,30,29,7,62,32,30,1,1,16,7,9
"2021","St. Helens 002A","E01006802",724,224,123,101,477,115,231,86,83,62,63,24,29,10,65,39,26,3,3,23,5,18
"2021","St. Helens 002B","E01006804",654,168,107,61,462,113,213,79,68,66,63,36,18,9,73,41,32,0,0,24,14,10
"2021","St. Helens 002C","E01006806",614,155,113,42,445,141,228,76,87,65,46,23,17,6,28,16,12,2,2,14,7,7
"2021","St. Helens 002D","E01006807",587,152,113,39,417,137,190,85,67,38,41,19,21,1,47,24,23,2,2,18,8,10
"2021","St. Helens 003A","E01006803",611,154,77,77,427,116,201,82,68,51,72,41,21,10,37,18,19,1,1,30,15,15
"2021","St. Helens 003B","E01006805",624,171,90,81,427,70,183,56,80,47,96,41,50,5,77,46,31,1,1,26,21,5
"2021","St. Helens 003C","E01006808",534,152,74,78,362,94,175,71,59,45,45,18,22,5,45,22,23,3,3,20,8,12
"2021","St. Helens 003D","E01006809",600,161,103,58,415,112,203,78,72,53,53,34,14,5,43,21,22,4,4,24,9,15
"2021","St. Helens 004A","E01006849",646,224,90,134,396,41,151,48,62,41,76,29,38,9,123,89,34,5,5,26,17,9
"2021","St. Helens 004B","E01006850",763,312,130,182,433,58,171,62,63,46,87,44,39,4,111,79,32,6,6,18,4,14
"2021","St. Helens 004C","E01006851",597,159,83,76,411,81,175,79,55,41,94,49,33,12,56,31,25,5,5,27,14,13
"2021","St. Helens 004D","E01006852",530,116,74,42,394,94,196,63,78,55,53,24,25,4,50,20,30,1,1,20,9,11
"2021","St. Helens 004E","E01006853",739,196,67,129,524,77,276,99,118,59,117,65,46,6,52,23,29,2,2,19,12,7
"2021","St. Helens 004F","E01006854",639,205,96,109,406,52,168,69,61,38,81,35,41,5,100,62,38,5,5,28,15,13
"2021","St. Helens 004G","E01006855",658,187,101,86,443,92,168,64,67,37,81,32,44,5,94,57,37,8,8,28,15,13
"2021","St. Helens 005A","E01006836",631,193,102,91,414,72,171,68,64,39,81,30,42,9,87,51,36,3,3,24,10,14
"2021","St. Helens 005B","E01006839",568,178,77,101,375,57,188,70,62,56,62,29,25,8,66,37,29,2,2,15,9,6
"2021","St. Helens 005C","E01006840",663,217,95,122,419,88,180,82,46,52,90,41,44,5,53,39,14,8,8,27,15,12
"2021","St. Helens 005D","E01006842",674,204,90,114,437,22,171,52,82,37,103,28,65,10,136,89,47,5,5,33,18,15
"2021","St. Helens 006A","E01006837",620,163,76,87,433,64,207,77,80,50,86,36,39,11,71,43,28,5,5,24,10,14
"2021","St. Helens 006B","E01006838",737,328,181,147,388,56,154,66,57,31,89,43,41,5,81,53,28,8,8,21,12,9
"2021","St. Helens 006C","E01006841",658,156,92,64,480,92,287,104,113,70,59,23,29,7,40,18,22,2,2,22,9,13
"2021","St. Helens 006D","E01006843",549,169,103,66,369,81,137,51,53,33,78,26,39,13,73,35,38,0,0,11,3,8
"2021","St. Helens 007A","E01006914",537,135,98,37,377,116,198,48,105,45,36,18,15,3,26,14,12,1,1,25,12,13
"2021","St. Helens 007B","E01006915",664,205,106,99,434,72,199,83,68,48,67,32,34,1,91,46,45,5,5,25,8,17
"2021","St. Helens 007C","E01006916",662,230,102,128,407,48,193,66,89,38,68,37,30,1,94,55,39,4,4,25,9,16
"2021","St. Helens 007D","E01006917",705,166,108,58,526,89,305,82,150,73,70,28,33,9,58,29,29,4,4,13,2,11
"2021","St. Helens 007E","E01006918",517,143,56,87,353,43,204,61,92,51,53,32,16,5,52,28,24,1,1,21,10,11
"2021","St. Helens 007F","E01006919",747,197,57,140,529,34,186,58,96,32,113,50,56,7,192,131,61,4,4,21,11,10
"2021","St. Helens 008A","E01006810",495,116,78,38,367,98,194,73,64,57,38,16,17,5,37,9,28,0,0,12,10,2
"2021","St. Helens 008B","E01006811",612,182,90,92,396,104,157,71,45,41,64,32,24,8,66,39,27,5,5,34,14,20
"2021","St. Helens 008C","E01006812",594,151,72,79,405,29,135,45,54,36,83,27,43,13,151,103,48,7,7,38,16,22
"2021","St. Helens 008D","E01006813",676,244,114,130,413,39,151,44,66,41,108,50,48,10,106,68,38,9,9,19,8,11
"2021","St. Helens 008E","E01006814",601,129,75,54,447,105,218,77,85,56,76,45,21,10,46,21,25,2,2,25,12,13
"2021","St. Helens 008F","E01006815",553,171,88,83,369,61,150,52,61,37,77,30,37,10,76,38,38,5,5,13,10,3
"2021","St. Helens 008G","E01006818",521,114,73,41,387,93,170,67,54,49,58,28,26,4,66,29,37,0,0,20,7,13
"2021","St. Helens 009A","E01006822",639,159,86,73,466,95,252,79,117,56,55,36,16,3,61,37,24,3,3,14,7,7
"2021","St. Helens 009B","E01006823",579,167,136,31,398,105,204,46,112,46,41,28,12,1,46,17,29,2,2,14,6,8
"2021","St. Helens 009C","E01006824",516,146,105,41,355,80,210,60,104,46,34,15,15,4,31,16,15,0,0,15,11,4
"2021","St. Helens 009D","E01006825",632,136,89,47,480,131,275,109,122,44,43,27,15,1,30,17,13,1,1,16,6,10
"2021","St. Helens 010A","E01006866",692,185,81,104,478,43,192,58,98,36,107,44,51,12,130,84,46,6,6,29,11,18
"2021","St. Helens 010B","E01006867",814,167,57,110,624,51,374,116,194,64,128,71,47,10,69,44,25,2,2,23,10,13
"2021","St. Helens 010C","E01006868",663,216,95,121,430,42,172,61,91,20,111,57,48,6,102,68,34,3,3,17,8,9
"2021","St. Helens 010D","E01006869",747,278,90,188,438,42,190,78,79,33,122,73,41,8,81,46,35,3,3,31,9,22
"2021","St. Helens 011A","E01006819",724,178,65,113,516,63,233,86,93,54,112,46,57,9,101,69,32,7,7,30,15,15
"2021","St. Helens 011B","E01006820",619,175,56,119,406,24,135,47,57,31,92,33,50,9,142,96,46,13,13,38,15,23
"2021","St. Helens 011C","E01006821",677,243,94,149,405,42,130,56,47,27,86,35,44,7,140,93,47,7,7,29,13,16
"2021","St. Helens 011D","E01006871",746,264,88,176,445,32,148,55,61,32,126,57,60,9,136,99,37,3,3,37,16,21
"2021","St. Helens 012A","E01006832",814,327,55,272,452,18,188,65,94,29,122,67,42,13,114,73,41,10,10,35,10,25
"2021","St. Helens 012B","E01006834",635,291,74,217,314,19,98,42,37,19,85,40,39,6,106,71,35,6,6,30,10,20
"2021","St. Helens 012C","E01006877",885,520,188,332,330,33,133,63,35,35,69,40,26,3,91,55,36,4,4,35,7,28
"2021","St. Helens 012D","E01006880",754,399,111,288,334,31,98,43,33,22,83,39,38,6,118,73,45,4,4,21,7,14
"2021","St. Helens 012E","E01006881",756,367,104,263,362,21,122,47,47,28,90,52,31,7,123,82,41,6,6,27,6,21
"2021","St. Helens 013A","E01006863",889,441,149,292,416,45,143,63,34,46,112,68,35,9,110,81,29,6,6,32,13,19
"2021","St. Helens 013B","E01006864",898,303,88,215,566,62,261,113,94,54,140,88,43,9,96,61,35,7,7,29,11,18
"2021","St. Helens 013D","E01033793",537,117,26,91,397,28,150,57,74,19,161,91,66,4,54,42,12,4,4,23,12,11
"2021","St. Helens 013E","E01033794",792,300,153,147,469,30,153,58,71,24,150,81,59,10,131,91,40,5,5,23,15,8
"2021","St. Helens 014A","E01006845",847,302,71,231,512,35,188,87,61,40,154,87,57,10,132,84,48,3,3,33,13,20
"2021","St. Helens 014B","E01006870",697,281,86,195,373,30,127,49,55,23,108,56,45,7,102,63,39,6,6,43,15,28
"2021","St. Helens 014C","E01006872",866,457,127,330,373,23,106,47,32,27,123,80,34,9,107,76,31,14,14,36,12,24
"2021","St. Helens 014D","E01006873",625,213,83,130,377,23,92,26,47,19,88,33,47,8,169,127,42,5,5,35,15,20
"2021","St. Helens 014E","E01006874",638,247,71,176,359,27,96,42,35,19,75,29,42,4,151,115,36,10,10,32,16,16
"2021","St. Helens 015A","E01006856",708,245,82,163,444,41,215,73,109,33,106,66,36,4,78,50,28,4,4,19,5,14
"2021","St. Helens 015B","E01006857",628,177,95,82,435,83,225,81,79,65,81,53,28,0,42,17,25,4,4,16,9,7
"2021","St. Helens 015C","E01006858",626,165,55,110,433,33,157,60,66,31,104,41,49,14,132,78,54,7,7,28,14,14
"2021","St. Helens 015D","E01006859",744,201,97,104,519,99,293,113,123,57,86,60,24,2,39,17,22,2,2,24,8,16
"2021","St. Helens 015E","E01006860",672,237,76,161,410,37,184,70,86,28,104,57,38,9,81,50,31,4,4,25,17,8
"2021","St. Helens 015F","E01006861",776,202,62,140,545,28,199,50,114,35,132,50,73,9,183,140,43,3,3,29,19,10
"2021","St. Helens 015G","E01006862",993,293,97,196,668,50,270,95,128,47,212,130,71,11,131,86,45,5,5,32,18,14
"2021","St. Helens 016A","E01006831",684,281,99,182,373,53,123,53,45,25,91,55,26,10,97,65,32,9,9,30,13,17
"2021","St. Helens 016B","E01006833",997,376,104,272,590,47,238,81,111,46,176,105,68,3,124,81,43,5,5,31,11,20
"2021","St. Helens 016C","E01006835",621,236,88,148,368,62,176,65,58,53,69,35,32,2,58,25,33,3,3,17,8,9
"2021","St. Helens 016D","E01006876",659,245,92,153,375,35,149,59,47,43,93,54,36,3,96,67,29,2,2,39,9,30
"2021","St. Helens 016E","E01006878",641,252,83,169,377,58,154,66,41,47,68,43,20,5,93,59,34,4,4,12,5,7
"2021","St. Helens 016F","E01006879",610,166,71,95,410,38,179,67,70,42,78,29,43,6,107,56,51,8,8,34,23,11
"2021","St. Helens 016G","E01006904",668,157,70,87,480,62,194,59,73,62,95,46,39,10,126,70,56,3,3,31,11,20
"2021","St. Helens 017A","E01006816",729,242,80,162,439,25,162,64,62,36,107,37,57,13,137,103,34,8,8,48,21,27
"2021","St. Helens 017B","E01006817",647,261,84,177,348,22,127,53,46,28,77,22,46,9,110,78,32,12,12,38,16,22
"2021","St. Helens 017C","E01006875",546,140,46,94,372,26,147,54,48,45,86,35,43,8,107,76,31,6,6,34,15,19
"2021","St. Helens 017D","E01006899",874,250,92,158,577,44,251,78,124,49,148,66,71,11,120,66,54,14,14,47,22,25
"2021","St. Helens 018A","E01006826",592,243,123,120,327,74,127,51,46,30,36,14,19,3,88,52,36,2,2,22,12,10
"2021","St. Helens 018B","E01006827",619,139,63,76,461,82,267,85,118,64,63,28,27,8,48,21,27,1,1,19,9,10
"2021","St. Helens 018C","E01006828",906,233,156,77,646,135,380,129,151,100,82,40,37,5,49,24,25,0,0,27,19,8
"2021","St. Helens 018D","E01006829",717,181,79,102,511,99,268,91,126,51,92,48,39,5,45,23,22,7,7,25,9,16
"2021","St. Helens 020A","E01006844",807,350,114,236,423,23,162,78,56,28,108,48,44,16,118,83,35,12,12,34,14,20
"2021","St. Helens 020B","E01006846",618,168,89,79,430,97,187,66,73,48,80,45,30,5,64,29,35,2,2,20,13,7
"2021","St. Helens 020C","E01006847",777,201,74,127,530,38,205,63,105,37,99,40,47,12,184,135,49,4,4,46,26,20
"2021","St. Helens 020D","E01006848",620,222,87,135,375,93,162,60,57,45,69,37,29,3,50,28,22,1,1,23,10,13
"2021","St. Helens 020E","E01006896",655,195,121,74,442,112,209,79,70,60,56,19,30,7,65,22,43,0,0,18,8,10
"2021","St. Helens 020F","E01006897",657,196,96,100,438,90,215,85,72,58,71,37,26,8,59,28,31,3,3,23,8,15
"2021","St. Helens 020G","E01006901",628,144,61,83,461,63,216,84,77,55,120,66,52,2,60,37,23,2,2,23,9,14
"2021","St. Helens 021A","E01006890",614,182,82,100,416,57,170,51,76,43,92,48,38,6,93,54,39,4,4,16,8,8
"2021","St. Helens 021B","E01006892",566,159,95,64,391,60,188,59,76,53,57,34,21,2,81,44,37,5,5,16,8,8
"2021","St. Helens 021C","E01006893",602,203,87,116,371,62,166,61,74,31,71,35,31,5,71,36,35,1,1,28,16,12
"2021","St. Helens 021D","E01006894",638,209,142,67,412,120,168,58,67,43,60,22,34,4,63,33,30,1,1,17,10,7
"2021","St. Helens 022A","E01006898",781,248,123,125,487,85,207,93,72,42,76,33,34,9,111,68,43,8,8,46,18,28
"2021","St. Helens 022C","E01006908",621,246,73,173,361,39,131,49,49,33,77,26,45,6,109,75,34,5,5,14,11,3
"2021","St. Helens 022D","E01006909",495,128,53,75,338,21,100,35,40,25,71,20,45,6,140,96,44,6,6,29,17,12
"2021","St. Helens 022E","E01006910",816,253,101,152,519,46,208,86,82,40,108,38,60,10,153,95,58,4,4,44,21,23
"2021","St. Helens 022F","E01006911",619,153,113,40,434,124,199,71,62,66,56,28,19,9,52,22,30,3,3,32,20,12
"2021","St. Helens 022G","E01033795",567,108,22,86,439,21,276,77,158,41,84,49,32,3,57,33,24,1,1,20,12,8
"2021","St. Helens 022H","E01033796",717,177,58,119,508,34,201,81,87,33,152,101,41,10,118,73,45,3,3,32,18,14
"2021","St. Helens 023A","E01006888",504,131,94,37,354,99,184,44,84,56,27,11,13,3,42,20,22,2,2,19,11,8
"2021","St. Helens 023B","E01006889",578,155,90,65,395,74,226,71,94,61,45,23,17,5,46,22,24,4,4,28,15,13
"2021","St. Helens 023C","E01006891",640,172,103,69,437,64,256,82,108,66,53,19,28,6,60,35,25,4,4,31,17,14
"2021","St. Helens 023D","E01006895",644,222,161,61,404,153,179,52,75,52,35,13,16,6,36,13,23,1,1,18,7,11
"2021","St. Helens 024A","E01006903",740,345,142,203,364,37,140,59,39,42,80,35,39,6,101,60,41,6,6,31,13,18
"2021","St. Helens 024B","E01006905",623,229,86,143,364,48,149,75,36,38,57,25,31,1,102,66,36,8,8,30,18,12
"2021","St. Helens 024C","E01006907",675,205,91,114,449,59,197,77,79,41,85,37,43,5,101,56,45,7,7,21,11,10
"2021","St. Helens 024E","E01006912",683,198,53,145,448,36,198,64,96,38,87,43,37,7,122,84,38,5,5,37,21,16
"2021","St. Helens 024D","E01006913",569,130,61,69,412,56,157,54,72,31,65,27,30,8,131,82,49,3,3,27,16,11
"2021","St. Helens 025A","E01006830",655,197,84,113,421,25,153,43,75,35,101,55,40,6,136,101,35,6,6,37,15,22
"2021","St. Helens 025B","E01006906",696,237,91,146,439,49,171,61,68,42,98,48,39,11,116,77,39,5,5,20,7,13
"2021","St. Helens 025C","E01032904",707,145,85,60,530,80,303,84,150,69,83,38,38,7,59,33,26,5,5,32,19,13
"2021","St. Helens 025D","E01032905",1134,298,153,145,800,64,431,122,262,47,227,127,94,6,78,63,15,0,0,36,23,13
"2021","Sefton 001A","E01006946",717,287,189,98,415,117,164,77,50,37,64,36,23,5,67,37,30,3,3,15,5,10
"2021","Sefton 001B","E01007028",605,155,80,75,420,80,179,66,72,41,78,44,31,3,81,50,31,2,2,30,14,16
"2021","Sefton 001C","E01007029",603,210,171,39,378,151,146,75,34,37,42,28,11,3,37,16,21,2,2,15,6,9
"2021","Sefton 001D","E01007030",638,167,80,87,437,54,179,56,81,42,95,34,54,7,109,70,39,0,0,34,15,19
"2021","Sefton 001E","E01007036",527,142,93,49,375,104,178,80,54,44,49,26,22,1,42,20,22,2,2,10,4,6
"2021","Sefton 002A","E01006947",623,171,114,57,439,121,212,88,73,51,53,32,17,4,53,26,27,0,0,13,5,8
"2021","Sefton 002B","E01007031",576,144,81,63,418,78,215,77,91,47,67,31,31,5,56,25,31,2,2,14,6,8
"2021","Sefton 002C","E01007032",576,160,108,52,395,85,221,78,94,49,54,23,25,6,35,22,13,0,0,21,12,9
"2021","Sefton 002D","E01007033",603,176,122,54,408,95,196,67,79,50,55,22,28,5,61,34,27,1,1,19,7,12
"2021","Sefton 002E","E01007035",600,184,103,81,399,103,204,81,80,43,41,23,15,3,50,26,24,1,1,17,8,9
"2021","Sefton 003A","E01006944",936,534,322,212,377,156,121,65,33,23,51,36,13,2,44,19,25,5,5,25,10,15
"2021","Sefton 003B","E01006948",669,286,168,118,368,51,145,63,55,27,60,20,36,4,107,58,49,5,5,15,7,8
"2021","Sefton 003C","E01006949",770,363,244,119,387,127,179,77,73,29,41,26,12,3,39,17,22,1,1,20,9,11
"2021","Sefton 003D","E01006951",785,366,209,157,392,142,155,74,49,32,47,38,7,2,46,27,19,2,2,27,3,24
"2021","Sefton 003E","E01007034",556,140,93,47,397,102,214,85,82,47,52,25,22,5,28,16,12,1,1,19,7,12
"2021","Sefton 004A","E01006945",934,488,198,290,369,69,132,74,39,19,86,59,20,7,73,38,35,9,9,77,32,45
"2021","Sefton 004B","E01006950",936,573,171,402,318,42,113,64,32,17,94,62,30,2,61,44,17,8,8,45,20,25
"2021","Sefton 004D","E01006969",720,331,104,227,345,28,153,63,68,22,72,32,37,3,81,43,38,11,11,44,16,28
"2021","Sefton 004F","E01033094",683,391,82,309,257,44,80,38,34,8,81,68,12,1,43,25,18,9,9,35,3,32
"2021","Sefton 004G","E01033097",638,345,135,210,238,30,83,37,37,9,71,49,20,2,46,23,23,8,8,55,20,35
"2021","Sefton 004H","E01033797",643,414,163,251,207,46,53,26,17,10,59,49,8,2,39,28,11,10,10,22,4,18
"2021","Sefton 004I","E01033798",634,391,70,321,190,11,57,31,15,11,66,53,10,3,43,30,13,13,13,53,7,46
"2021","Sefton 005A","E01007055",571,184,67,117,350,31,137,45,71,21,59,14,41,4,118,72,46,5,5,37,18,19
"2021","Sefton 005B","E01007056",678,162,76,86,488,47,189,65,76,48,117,51,63,3,128,87,41,7,7,28,16,12
"2021","Sefton 005C","E01007057",652,205,79,126,422,48,183,63,89,31,84,38,40,6,100,70,30,7,7,25,12,13
"2021","Sefton 005D","E01007062",610,158,64,94,423,57,238,106,84,48,67,40,25,2,59,32,27,2,2,29,14,15
"2021","Sefton 005E","E01007063",622,176,93,83,413,44,217,71,96,50,81,39,32,10,69,40,29,2,2,33,10,23
"2021","Sefton 006A","E01007058",663,219,66,153,395,29,184,57,88,39,92,50,35,7,84,50,34,6,6,49,20,29
"2021","Sefton 006B","E01007059",624,139,62,77,446,45,236,99,106,31,81,36,40,5,80,51,29,4,4,39,20,19
"2021","Sefton 006C","E01007060",597,169,73,96,393,43,176,64,78,34,75,31,40,4,93,55,38,6,6,35,11,24
"2021","Sefton 006D","E01007061",589,142,51,91,403,46,202,77,87,38,72,35,31,6,79,45,34,4,4,44,24,20
"2021","Sefton 006E","E01007064",475,94,48,46,352,45,213,69,93,51,51,21,27,3,42,19,23,1,1,29,16,13
"2021","Sefton 007A","E01006934",658,229,78,151,400,65,161,57,63,41,93,45,39,9,81,47,34,0,0,29,7,22
"2021","Sefton 007B","E01006970",950,395,136,259,417,56,151,60,69,22,102,68,29,5,98,60,38,10,10,138,21,117
"2021","Sefton 007C","E01006994",741,253,86,167,436,29,187,50,102,35,92,40,49,3,117,79,38,11,11,52,21,31
"2021","Sefton 007D","E01006996",765,263,73,190,420,35,200,60,98,42,83,34,41,8,97,63,34,5,5,82,20,62
"2021","Sefton 007E","E01006998",688,229,80,149,389,42,160,48,84,28,98,47,44,7,86,58,28,3,3,70,32,38
"2021","Sefton 008A","E01006995",512,105,49,56,373,64,210,80,92,38,55,28,21,6,41,18,23,3,3,34,16,18
"2021","Sefton 008B","E01006997",635,202,72,130,398,35,189,66,89,34,76,33,36,7,93,57,36,5,5,35,12,23
"2021","Sefton 008C","E01006999",709,218,126,92,460,78,194,72,91,31,62,34,27,1,122,78,44,4,4,31,16,15
"2021","Sefton 008D","E01007000",605,158,74,84,404,27,175,60,80,35,59,26,28,5,141,73,68,2,2,43,23,20
"2021","Sefton 008E","E01007001",710,237,75,162,438,43,180,55,94,31,94,45,44,5,116,81,35,5,5,35,20,15
"2021","Sefton 008F","E01007002",907,252,104,148,625,113,271,100,126,45,133,80,48,5,99,60,39,9,9,30,13,17
"2021","Sefton 009A","E01006928",594,150,92,58,415,84,237,78,106,53,49,24,16,9,45,22,23,0,0,29,14,15
"2021","Sefton 009B","E01006935",699,232,104,128,432,72,207,56,95,56,82,45,32,5,69,49,20,2,2,35,14,21
"2021","Sefton 009C","E01006971",794,341,196,145,418,146,154,71,54,29,60,38,20,2,54,32,22,4,4,35,12,23
"2021","Sefton 009D","E01006972",877,476,333,143,381,168,125,70,29,26,45,30,11,4,38,13,25,5,5,20,10,10
"2021","Sefton 009E","E01006973",679,249,158,91,402,134,180,82,54,44,33,22,11,0,51,20,31,4,4,28,12,16
"2021","Sefton 009F","E01006974",665,202,125,77,436,126,245,96,81,68,31,18,11,2,31,8,23,3,3,27,14,13
"2021","Sefton 010A","E01006929",618,168,80,88,428,48,217,70,97,50,77,37,37,3,83,61,22,3,3,22,9,13
"2021","Sefton 010B","E01006930",626,205,99,106,395,44,185,64,76,45,74,38,33,3,90,48,42,2,2,26,16,10
"2021","Sefton 010C","E01006931",652,186,105,81,441,75,220,79,95,46,80,30,43,7,60,32,28,6,6,25,9,16
"2021","Sefton 010D","E01006932",586,127,85,42,441,86,254,100,106,48,47,23,17,7,53,25,28,1,1,18,6,12
"2021","Sefton 010E","E01006933",584,169,71,98,402,43,185,56,83,46,74,38,32,4,96,58,38,4,4,13,3,10
"2021","Sefton 011A","E01006920",716,223,129,94,465,84,203,71,83,49,85,46,35,4,90,52,38,3,3,28,16,12
"2021","Sefton 011B","E01006924",667,274,134,140,365,48,133,46,61,26,70,20,45,5,112,65,47,2,2,28,14,14
"2021","Sefton 011C","E01006925",700,166,86,80,495,51,217,63,99,55,94,28,59,7,130,83,47,3,3,39,17,22
"2021","Sefton 011D","E01006927",795,316,200,116,450,99,223,80,86,57,66,29,31,6,61,27,34,1,1,29,17,12
"2021","Sefton 012A","E01006921",589,159,126,33,406,135,202,77,67,58,29,16,10,3,40,16,24,0,0,24,12,12
"2021","Sefton 012B","E01006922",598,125,95,30,446,146,216,82,67,67,51,21,29,1,31,12,19,2,2,27,16,11
"2021","Sefton 012C","E01006923",709,206,144,62,474,153,210,94,71,45,60,40,16,4,48,20,28,3,3,29,17,12
"2021","Sefton 012D","E01006926",739,177,130,47,521,177,268,107,107,54,50,24,17,9,26,12,14,0,0,41,13,28
"2021","Sefton 013A","E01006985",591,153,104,49,422,126,221,81,91,49,43,21,17,5,31,18,13,1,1,16,6,10
"2021","Sefton 013B","E01006986",534,115,87,28,400,138,195,72,86,37,27,11,14,2,38,18,20,2,2,19,8,11
"2021","Sefton 013C","E01006987",525,146,109,37,359,109,168,61,68,39,42,24,16,2,38,18,20,2,2,20,14,6
"2021","Sefton 013D","E01006989",539,160,124,36,364,130,183,72,76,35,25,11,12,2,26,13,13,0,0,15,4,11
"2021","Sefton 013E","E01006990",475,93,76,17,372,112,197,67,92,38,34,14,16,4,29,12,17,0,0,10,5,5
"2021","Sefton 014A","E01006988",663,227,148,79,408,97,184,68,72,44,62,25,34,3,63,33,30,2,2,28,10,18
"2021","Sefton 014B","E01007079",652,201,142,59,423,126,219,66,98,55,44,21,21,2,30,10,20,4,4,28,9,19
"2021","Sefton 014C","E01007080",630,196,114,82,414,95,183,61,83,39,61,25,28,8,74,41,33,1,1,20,12,8
"2021","Sefton 014D","E01007081",763,304,229,75,437,126,203,51,106,46,36,16,18,2,67,17,50,5,5,22,9,13
"2021","Sefton 015A","E01006991",597,126,104,22,451,137,237,73,102,62,38,18,16,4,36,13,23,3,3,20,12,8
"2021","Sefton 015B","E01006992",511,151,89,62,340,56,166,35,91,40,62,28,29,5,56,31,25,0,0,20,6,14
"2021","Sefton 015C","E01006993",592,142,108,34,433,132,231,72,107,52,29,14,14,1,38,16,22,3,3,17,10,7
"2021","Sefton 015D","E01007078",634,161,124,37,447,126,218,68,94,56,42,11,27,4,59,24,35,2,2,26,11,15
"2021","Sefton 016A","E01007075",605,216,142,74,368,96,147,44,65,38,60,29,27,4,64,33,31,1,1,21,7,14
"2021","Sefton 016B","E01007076",625,147,93,54,457,71,267,83,121,63,67,25,35,7,52,26,26,0,0,21,7,14
"2021","Sefton 016C","E01007077",591,149,91,58,424,66,216,55,104,57,58,24,32,2,80,27,53,4,4,18,11,7
"2021","Sefton 016D","E01007082",602,208,124,84,380,96,165,49,76,40,56,28,26,2,63,27,36,0,0,14,6,8
"2021","Sefton 017A","E01007067",603,165,89,76,394,87,219,88,74,57,48,29,16,3,38,13,25,2,2,44,8,36
"2021","Sefton 017B","E01007068",476,123,80,43,331,68,191,69,71,51,39,12,23,4,31,18,13,2,2,22,9,13
"2021","Sefton 017C","E01007069",666,257,139,118,381,73,158,51,73,34,59,34,19,6,86,46,40,5,5,28,14,14
"2021","Sefton 017D","E01007070",594,138,102,36,437,109,230,76,88,66,49,19,25,5,49,18,31,0,0,19,12,7
"2021","Sefton 017E","E01007101",599,161,107,54,413,100,207,53,102,52,53,15,34,4,49,12,37,4,4,25,14,11
"2021","Sefton 018C","E01007095",699,228,152,76,449,99,212,61,80,71,76,40,31,5,61,27,34,1,1,22,12,10
"2021","Sefton 018D","E01007096",563,175,124,51,377,86,191,59,73,59,46,15,28,3,50,16,34,4,4,11,7,4
"2021","Sefton 018E","E01007100",588,189,118,71,376,80,178,56,76,46,58,29,28,1,58,25,33,2,2,23,14,9
"2021","Sefton 018G","E01033799",589,135,64,71,438,44,184,50,85,49,102,40,55,7,105,83,22,3,3,16,10,6
"2021","Sefton 018H","E01033800",624,154,108,46,447,103,215,64,90,61,66,29,24,13,63,27,36,0,0,23,14,9
"2021","Sefton 019A","E01007074",615,193,106,87,400,50,196,65,69,62,79,38,34,7,72,31,41,3,3,22,10,12
"2021","Sefton 019B","E01007097",645,184,115,69,438,110,178,37,83,58,79,34,40,5,68,33,35,3,3,23,8,15
"2021","Sefton 019C","E01007098",717,201,103,98,494,110,240,83,97,60,79,42,32,5,62,39,23,3,3,22,10,12
"2021","Sefton 019D","E01007099",689,271,200,71,396,106,189,72,65,52,55,25,21,9,44,22,22,2,2,22,13,9
"2021","Sefton 020A","E01007065",489,94,48,46,370,54,193,65,82,46,58,20,34,4,62,32,30,3,3,25,5,20
"2021","Sefton 020B","E01007066",595,149,73,76,424,56,219,70,84,65,77,41,29,7,71,44,27,1,1,22,13,9
"2021","Sefton 020C","E01007071",591,152,80,72,431,92,238,81,97,60,57,34,17,6,43,18,25,1,1,8,5,3
"2021","Sefton 020D","E01007072",677,274,203,71,383,114,203,73,81,49,34,16,15,3,31,9,22,1,1,20,10,10
"2021","Sefton 020E","E01007073",489,120,80,40,347,57,200,50,91,59,47,21,22,4,42,15,27,1,1,22,11,11
"2021","Sefton 021A","E01007020",575,195,88,107,359,26,154,49,56,49,67,25,31,11,103,46,57,9,9,21,8,13
"2021","Sefton 021B","E01007022",589,213,95,118,342,52,167,50,77,40,46,23,20,3,74,35,39,3,3,34,17,17
"2021","Sefton 021C","E01007023",531,123,81,42,385,92,208,54,105,49,53,29,22,2,32,11,21,0,0,23,12,11
"2021","Sefton 021D","E01007027",903,227,151,76,651,172,356,154,119,83,67,37,26,4,54,19,35,2,2,25,11,14
"2021","Sefton 021E","E01007037",713,210,127,83,474,110,221,82,84,55,98,64,30,4,44,21,23,1,1,29,14,15
"2021","Sefton 021F","E01007038",658,138,67,71,495,82,223,85,82,56,87,41,42,4,97,55,42,6,6,25,10,15
"2021","Sefton 022A","E01006936",752,330,189,141,390,107,188,97,45,46,48,31,13,4,40,16,24,7,7,32,8,24
"2021","Sefton 022B","E01006937",500,88,51,37,388,69,244,59,139,46,32,17,15,0,39,18,21,4,4,24,11,13
"2021","Sefton 022C","E01006938",583,160,109,51,397,118,193,78,75,40,38,20,15,3,45,18,27,3,3,26,15,11
"2021","Sefton 022D","E01006939",702,264,128,136,412,60,189,63,86,40,76,40,29,7,82,46,36,5,5,26,6,20
"2021","Sefton 022E","E01006940",641,253,130,123,358,86,210,70,98,42,38,18,17,3,22,13,9,2,2,30,15,15
"2021","Sefton 022F","E01006943",485,83,54,29,383,78,240,54,119,67,32,12,19,1,33,11,22,0,0,19,8,11
"2021","Sefton 023A","E01007083",472,115,64,51,324,48,149,44,46,59,49,22,24,3,75,40,35,3,3,33,16,17
"2021","Sefton 023B","E01007085",556,167,68,99,348,26,113,29,51,33,61,23,30,8,142,85,57,6,6,41,20,21
"2021","Sefton 023C","E01007086",502,180,62,118,309,30,107,36,43,28,44,18,23,3,121,72,49,7,7,13,5,8
"2021","Sefton 023D","E01007091",599,264,124,140,311,44,110,41,31,38,58,24,25,9,96,54,42,3,3,24,11,13
"2021","Sefton 023E","E01007092",490,177,76,101,289,25,103,37,34,32,49,20,23,6,108,71,37,4,4,24,8,16
"2021","Sefton 024A","E01006979",601,218,80,138,353,21,88,32,35,21,57,23,29,5,163,99,64,24,24,30,19,11
"2021","Sefton 024B","E01006980",620,238,67,171,351,20,116,53,37,26,67,29,25,13,145,86,59,3,3,31,19,12
"2021","Sefton 024C","E01007024",507,212,108,104,276,29,89,42,27,20,49,24,18,7,106,55,51,3,3,19,10,9
"2021","Sefton 024D","E01007026",535,202,86,116,303,30,127,43,54,30,52,20,28,4,84,50,34,10,10,30,11,19
"2021","Sefton 024E","E01007089",664,253,124,129,384,37,126,43,40,43,84,31,46,7,132,77,55,5,5,27,18,9
"2021","Sefton 025A","E01007021",532,147,104,43,363,77,210,70,91,49,42,19,23,0,32,14,18,2,2,22,7,15
"2021","Sefton 025B","E01007025",532,125,90,35,386,80,217,79,84,54,49,17,29,3,40,16,24,0,0,21,9,12
"2021","Sefton 025C","E01007105",739,266,167,99,445,75,216,76,92,48,78,42,33,3,73,42,31,3,3,28,12,16
"2021","Sefton 025D","E01007106",740,200,97,103,512,59,255,68,128,59,107,49,45,13,87,54,33,4,4,28,10,18
"2021","Sefton 025E","E01007107",485,84,48,36,385,53,228,50,111,67,61,24,33,4,41,15,26,2,2,16,7,9
"2021","Sefton 025F","E01007108",600,116,65,51,457,69,237,64,108,65,73,34,36,3,76,37,39,2,2,27,13,14
"2021","Sefton 026A","E01007039",515,131,65,66,352,49,174,53,74,47,49,16,30,3,76,43,33,4,4,32,21,11
"2021","Sefton 026B","E01007040",837,211,94,117,574,77,275,74,117,84,117,61,50,6,101,65,36,4,4,52,21,31
"2021","Sefton 026C","E01007042",549,160,84,76,365,61,166,36,77,53,61,23,33,5,74,45,29,3,3,24,12,12
"2021","Sefton 026D","E01007044",623,188,134,54,407,111,202,56,91,55,45,15,28,2,44,20,24,5,5,28,17,11
"2021","Sefton 026E","E01007045",474,103,76,27,351,68,191,46,74,71,49,19,23,7,42,15,27,1,1,20,8,12
"2021","Sefton 027A","E01007041",576,150,83,67,395,55,188,63,59,66,87,28,50,9,59,30,29,6,6,31,19,12
"2021","Sefton 027B","E01007043",605,191,105,86,394,98,185,64,73,48,59,25,28,6,52,24,28,0,0,20,10,10
"2021","Sefton 027C","E01007046",729,181,72,109,522,69,249,84,97,68,108,35,66,7,91,56,35,5,5,26,11,15
"2021","Sefton 027D","E01007053",558,151,67,84,379,48,169,58,58,53,72,27,36,9,85,53,32,5,5,28,14,14
"2021","Sefton 027E","E01007084",528,140,61,79,360,51,209,86,72,51,57,30,25,2,43,20,23,0,0,28,11,17
"2021","Sefton 028A","E01006941",686,241,141,100,406,80,194,51,78,65,64,39,23,2,65,28,37,3,3,39,10,29
"2021","Sefton 028B","E01006942",638,217,103,114,378,41,175,73,67,35,81,32,43,6,81,40,41,0,0,43,25,18
"2021","Sefton 028C","E01006954",685,238,106,132,410,108,185,67,61,57,60,25,31,4,52,35,17,5,5,37,15,22
"2021","Sefton 028D","E01007104",567,159,84,75,386,51,215,61,109,45,58,30,27,1,57,36,21,5,5,22,7,15
"2021","Sefton 028E","E01007109",664,204,95,109,436,58,205,68,90,47,89,46,36,7,81,46,35,3,3,24,10,14
"2021","Sefton 029A","E01007048",624,177,55,122,403,19,139,31,58,50,74,21,43,10,164,94,70,7,7,44,28,16
"2021","Sefton 029B","E01007054",599,205,83,122,374,54,142,56,37,49,74,32,34,8,100,61,39,4,4,20,12,8
"2021","Sefton 029C","E01007087",617,234,74,160,353,32,123,47,37,39,68,27,33,8,125,82,43,5,5,30,13,17
"2021","Sefton 029D","E01007088",601,245,100,145,328,35,139,38,32,69,57,22,31,4,90,48,42,7,7,28,13,15
"2021","Sefton 029E","E01007090",565,203,70,133,342,12,132,31,58,43,61,23,34,4,130,88,42,7,7,20,11,9
"2021","Sefton 030A","E01006955",627,139,45,94,458,51,211,62,100,49,95,46,41,8,94,47,47,7,7,30,13,17
"2021","Sefton 030B","E01006956",789,369,72,297,376,23,150,60,63,27,126,77,37,12,72,42,30,5,5,44,17,27
"2021","Sefton 030C","E01006958",801,418,176,242,329,34,124,36,50,38,79,44,31,4,87,47,40,5,5,54,18,36
"2021","Sefton 030D","E01007102",594,159,67,92,395,33,205,57,106,42,86,41,40,5,66,37,29,5,5,40,22,18
"2021","Sefton 030E","E01007103",618,168,81,87,425,54,233,64,112,57,72,47,22,3,63,35,28,3,3,25,8,17
"2021","Sefton 031A","E01006978",560,151,67,84,375,63,169,58,59,52,71,30,33,8,69,34,35,3,3,34,15,19
"2021","Sefton 031B","E01006981",591,206,82,124,348,29,138,44,59,35,49,17,22,10,126,69,57,6,6,37,18,19
"2021","Sefton 031C","E01006982",543,150,84,66,377,59,165,53,68,44,73,31,27,15,77,38,39,3,3,16,10,6
"2021","Sefton 031D","E01006983",683,193,79,114,458,52,194,68,63,63,114,52,47,15,93,59,34,5,5,32,20,12
"2021","Sefton 031E","E01006984",500,123,37,86,349,27,101,30,56,15,77,26,38,13,137,91,46,7,7,28,18,10
"2021","Sefton 032A","E01006952",610,268,59,209,314,16,106,32,50,24,69,38,24,7,118,56,62,5,5,28,15,13
"2021","Sefton 032B","E01006953",703,320,66,254,356,38,163,62,58,43,45,20,23,2,108,62,46,2,2,27,12,15
"2021","Sefton 032C","E01006957",844,488,128,360,302,41,102,42,39,21,75,56,14,5,81,43,38,3,3,54,31,23
"2021","Sefton 032D","E01006959",684,263,96,167,393,50,192,71,73,48,75,46,26,3,70,31,39,6,6,28,11,17
"2021","Sefton 032E","E01006977",983,502,272,230,457,50,149,50,46,53,107,43,51,13,148,104,44,3,3,24,14,10
"2021","Sefton 033A","E01006976",607,180,82,98,401,46,164,52,63,49,81,33,42,6,105,57,48,5,5,26,18,8
"2021","Sefton 033B","E01007014",631,178,109,69,415,62,220,80,78,62,75,27,41,7,57,29,28,1,1,38,16,22
"2021","Sefton 033E","E01007047",717,305,149,156,386,57,159,34,65,60,62,19,35,8,106,58,48,2,2,26,15,11
"2021","Sefton 033F","E01033095",1018,250,129,121,736,87,346,109,147,90,187,83,87,17,106,62,44,10,10,32,16,16
"2021","Sefton 034A","E01007004",659,268,99,169,368,18,108,43,45,20,70,37,26,7,167,121,46,5,5,23,14,9
"2021","Sefton 034B","E01007005",682,301,115,186,342,15,102,27,52,23,91,35,51,5,129,75,54,5,5,39,17,22
"2021","Sefton 034C","E01007011",689,311,103,208,350,16,104,37,34,33,67,26,31,10,154,80,74,9,9,28,14,14
"2021","Sefton 034D","E01007016",773,226,69,157,501,28,166,56,53,57,127,70,47,10,174,119,55,6,6,46,28,18
"2021","Sefton 034E","E01007017",753,298,83,215,434,36,122,42,46,34,94,47,44,3,177,120,57,5,5,21,10,11
"2021","Sefton 035A","E01007019",617,190,39,151,392,18,131,43,54,34,72,30,34,8,166,102,64,5,5,35,23,12
"2021","Sefton 035B","E01007049",896,274,123,151,571,40,262,79,122,61,125,61,58,6,138,70,68,6,6,51,23,28
"2021","Sefton 035C","E01007050",475,114,65,49,336,48,162,42,64,56,62,22,28,12,61,34,27,3,3,25,12,13
"2021","Sefton 035D","E01007051",515,132,70,62,348,28,106,33,38,35,60,23,30,7,149,81,68,5,5,35,23,12
"2021","Sefton 035E","E01007052",547,161,63,98,354,32,139,41,49,49,52,20,26,6,123,89,34,8,8,32,22,10
"2021","Sefton 036A","E01006964",706,282,79,203,369,31,128,46,41,41,86,33,48,5,120,65,55,4,4,55,34,21
"2021","Sefton 036B","E01007003",579,237,62,175,304,19,74,28,32,14,66,29,30,7,144,78,66,1,1,38,8,30
"2021","Sefton 036C","E01007006",623,253,95,158,338,21,114,35,51,28,61,20,36,5,136,79,57,6,6,32,9,23
"2021","Sefton 036D","E01007012",635,233,65,168,378,34,132,45,63,24,82,44,32,6,122,77,45,8,8,24,11,13
"2021","Sefton 036E","E01007013",689,292,76,216,367,22,94,28,42,24,95,43,48,4,148,110,38,8,8,30,9,21
"2021","Sefton 037A","E01006967",887,468,170,298,378,33,153,40,42,71,81,41,30,10,108,61,47,3,3,41,17,24
"2021","Sefton 037B","E01007007",686,345,103,242,317,12,96,54,29,13,60,35,22,3,144,93,51,5,5,24,12,12
"2021","Sefton 037C","E01007008",647,269,65,204,330,17,102,44,36,22,53,28,20,5,150,115,35,8,8,48,10,38
"2021","Sefton 037D","E01007009",931,540,161,379,353,26,117,42,57,18,111,53,49,9,90,46,44,9,9,38,6,32
"2021","Sefton 037E","E01007010",691,252,62,190,341,11,108,32,55,21,76,39,31,6,133,94,39,13,13,98,22,76
"2021","Sefton 038A","E01006960",445,100,44,56,317,61,159,50,48,61,46,19,17,10,49,27,22,2,2,28,22,6
"2021","Sefton 038B","E01006961",690,251,63,188,393,30,161,42,76,43,78,38,31,9,116,75,41,8,8,46,11,35
"2021","Sefton 038C","E01006962",645,274,118,156,332,45,154,60,48,46,65,24,34,7,65,38,27,3,3,39,21,18
"2021","Sefton 038D","E01006963",697,224,36,188,413,25,122,32,70,20,98,38,50,10,158,118,40,10,10,60,27,33
"2021","Sefton 038E","E01006965",593,168,82,86,375,32,140,33,49,58,62,13,42,7,132,85,47,9,9,50,28,22
"2021","Sefton 038F","E01006966",718,242,114,128,444,32,163,38,62,63,85,36,39,10,158,105,53,6,6,32,18,14
"2021","Wirral 001A","E01007229",733,247,72,175,442,48,182,61,78,43,117,68,42,7,94,56,38,1,1,44,21,23
"2021","Wirral 001B","E01007230",566,193,84,109,343,50,170,69,63,38,63,37,20,6,58,38,20,2,2,30,12,18
"2021","Wirral 001C","E01007231",726,301,101,200,382,61,181,73,76,32,83,52,27,4,52,26,26,5,5,43,14,29
"2021","Wirral 001D","E01007237",930,524,244,280,381,99,147,75,40,32,68,51,15,2,60,30,30,7,7,25,9,16
"2021","Wirral 001E","E01007238",932,558,202,356,333,46,106,51,31,24,89,63,23,3,86,59,27,6,6,41,14,27
"2021","Wirral 002A","E01007218",687,255,103,152,406,24,139,50,53,36,105,39,58,8,132,97,35,6,6,26,10,16
"2021","Wirral 002B","E01007232",636,232,84,148,362,48,167,66,58,43,70,44,21,5,71,38,33,6,6,42,25,17
"2021","Wirral 002C","E01007233",754,281,96,185,433,40,193,78,79,36,90,43,41,6,105,65,40,5,5,40,16,24
"2021","Wirral 002D","E01007234",702,267,90,177,385,53,179,83,72,24,68,37,24,7,81,43,38,4,4,50,29,21
"2021","Wirral 002E","E01007236",581,221,96,125,334,45,147,53,58,36,67,29,34,4,71,45,26,4,4,26,14,12
"2021","Wirral 003A","E01007307",718,220,118,102,454,79,249,91,101,57,78,49,24,5,46,26,20,2,2,44,21,23
"2021","Wirral 003B","E01007308",723,294,160,134,401,115,194,100,66,28,44,30,12,2,46,24,22,2,2,28,11,17
"2021","Wirral 003C","E01007312",657,215,115,100,419,71,216,75,98,43,63,33,24,6,67,45,22,2,2,23,13,10
"2021","Wirral 003D","E01007313",790,360,177,183,399,74,168,58,67,43,68,32,29,7,87,56,31,2,2,31,16,15
"2021","Wirral 003E","E01007315",617,156,87,69,434,66,217,61,107,49,85,37,46,2,63,32,31,3,3,27,6,21
"2021","Wirral 004A","E01007211",501,132,68,64,338,68,155,59,59,37,60,36,24,0,49,25,24,6,6,31,14,17
"2021","Wirral 004B","E01007235",592,151,74,77,408,61,196,59,97,40,72,23,42,7,77,46,31,2,2,33,11,22
"2021","Wirral 004C","E01007310",521,122,61,61,377,60,219,73,91,55,50,21,28,1,46,17,29,2,2,22,13,9
"2021","Wirral 004D","E01007311",599,157,95,62,423,80,237,94,80,63,70,33,31,6,33,18,15,3,3,19,5,14
"2021","Wirral 004E","E01007314",586,178,74,104,370,45,179,57,74,48,62,27,31,4,80,48,32,4,4,38,19,19
"2021","Wirral 004F","E01007316",594,137,91,46,433,72,231,75,97,59,70,29,34,7,59,36,23,1,1,24,9,15
"2021","Wirral 005A","E01007215",748,386,178,208,329,53,99,34,48,17,73,36,31,6,99,70,29,5,5,33,13,20
"2021","Wirral 005B","E01007216",709,281,117,164,390,47,153,48,64,41,79,39,36,4,108,69,39,3,3,38,19,19
"2021","Wirral 005C","E01007219",601,193,65,128,366,33,182,58,75,49,71,28,36,7,75,46,29,5,5,42,20,22
"2021","Wirral 005D","E01007220",592,226,57,169,337,16,81,27,40,14,67,25,36,6,172,140,32,1,1,29,14,15
"2021","Wirral 005E","E01007275",642,267,75,192,339,26,133,41,60,32,73,35,36,2,107,82,25,0,0,36,15,21
"2021","Wirral 006A","E01007203",844,253,100,153,570,69,299,119,118,62,119,53,56,10,81,43,38,2,2,21,10,11
"2021","Wirral 006B","E01007205",618,154,77,77,414,31,180,53,84,43,88,30,48,10,108,74,34,7,7,50,24,26
"2021","Wirral 006C","E01007210",871,252,94,158,577,48,196,77,76,43,109,42,60,7,222,153,69,2,2,42,18,24
"2021","Wirral 006D","E01007309",600,130,81,49,444,89,257,85,96,76,57,25,30,2,40,19,21,1,1,26,10,16
"2021","Wirral 007A","E01007212",610,177,93,84,398,60,190,67,71,52,78,28,42,8,63,32,31,7,7,35,21,14
"2021","Wirral 007B","E01007213",646,199,108,91,424,80,198,71,72,55,77,39,28,10,66,37,29,3,3,23,12,11
"2021","Wirral 007C","E01007214",690,266,115,151,400,36,162,47,81,34,81,25,51,5,113,71,42,8,8,24,10,14
"2021","Wirral 007D","E01007217",848,356,121,235,455,43,130,57,51,22,96,51,41,4,181,104,77,5,5,37,21,16
"2021","Wirral 007E","E01007276",597,163,70,93,404,38,167,52,70,45,88,36,46,6,109,62,47,2,2,30,15,15
"2021","Wirral 008A","E01007272",592,211,62,149,357,26,106,31,42,33,72,26,42,4,149,120,29,4,4,24,13,11
"2021","Wirral 008B","E01007273",623,253,78,175,335,17,90,39,29,22,61,25,29,7,163,129,34,4,4,35,17,18
"2021","Wirral 008C","E01007274",666,321,112,209,312,9,86,30,35,21,65,24,37,4,145,97,48,7,7,33,14,19
"2021","Wirral 008D","E01007277",602,241,95,146,327,26,112,37,39,36,74,33,35,6,108,69,39,7,7,34,17,17
"2021","Wirral 008E","E01007278",617,210,87,123,365,22,106,39,45,22,74,28,40,6,156,113,43,7,7,42,19,23
"2021","Wirral 009A","E01007204",667,191,55,136,431,20,106,20,60,26,92,25,56,11,207,154,53,6,6,45,19,26
"2021","Wirral 009B","E01007206",751,200,82,118,515,45,244,89,103,52,119,57,54,8,98,59,39,9,9,36,18,18
"2021","Wirral 009C","E01007207",680,307,159,148,347,38,101,43,35,23,58,23,31,4,149,98,51,1,1,26,12,14
"2021","Wirral 009D","E01007209",716,337,180,157,355,50,126,48,46,32,75,33,35,7,96,52,44,8,8,24,7,17
"2021","Wirral 010C","E01007269",781,282,62,220,465,27,124,49,42,33,98,52,37,9,205,131,74,11,11,34,17,17
"2021","Wirral 010D","E01007270",822,332,65,267,457,29,147,54,65,28,90,34,52,4,183,131,52,8,8,33,16,17
"2021","Wirral 010E","E01007271",757,309,102,207,417,38,131,45,59,27,93,41,46,6,153,106,47,2,2,31,9,22
"2021","Wirral 010G","E01034836",517,150,42,108,349,19,100,32,51,17,65,20,38,7,159,116,43,6,6,18,9,9
"2021","Wirral 010H","E01034837",754,267,79,188,452,39,139,49,48,42,99,54,35,10,170,120,50,5,5,35,19,16
"2021","Wirral 011A","E01007120",534,161,61,100,340,32,131,47,60,24,52,16,32,4,121,77,44,4,4,33,20,13
"2021","Wirral 011B","E01007121",676,248,75,173,393,11,106,35,48,23,79,31,40,8,191,130,61,6,6,35,17,18
"2021","Wirral 011C","E01007122",753,329,100,229,397,18,99,33,42,24,76,25,46,5,193,133,60,11,11,27,11,16
"2021","Wirral 011D","E01007123",669,203,64,139,435,4,102,39,40,23,111,61,42,8,216,155,61,2,2,31,13,18
"2021","Wirral 011E","E01007124",690,239,92,147,403,11,109,38,41,30,77,24,43,10,203,155,48,3,3,48,30,18
"2021","Wirral 012A","E01007208",757,266,145,121,448,73,178,72,68,38,74,32,38,4,117,64,53,6,6,43,18,25
"2021","Wirral 012B","E01007221",648,200,109,91,411,64,198,67,79,52,73,33,36,4,74,43,31,2,2,37,16,21
"2021","Wirral 012C","E01007225",883,222,148,74,623,134,311,119,110,82,110,57,51,2,64,33,31,4,4,38,16,22
"2021","Wirral 012D","E01007227",673,264,130,134,375,42,151,46,65,40,67,27,29,11,110,67,43,5,5,34,23,11
"2021","Wirral 012E","E01007228",677,272,137,135,374,69,133,49,49,35,62,20,41,1,107,66,41,3,3,31,12,19
"2021","Wirral 013A","E01007195",664,159,98,61,488,98,271,82,129,60,47,18,25,4,70,30,40,2,2,17,9,8
"2021","Wirral 013B","E01007199",609,135,95,40,454,126,257,62,130,65,41,14,22,5,29,11,18,1,1,20,10,10
"2021","Wirral 013C","E01007222",702,223,121,102,457,64,216,89,76,51,89,52,31,6,83,50,33,5,5,22,11,11
"2021","Wirral 013D","E01007223",626,200,58,142,401,37,220,80,98,42,66,34,30,2,76,49,27,2,2,25,11,14
"2021","Wirral 014A","E01007193",740,293,184,109,416,98,215,80,85,50,57,36,20,1,42,18,24,4,4,31,12,19
"2021","Wirral 014B","E01007194",669,282,128,154,355,47,172,50,93,29,71,43,24,4,61,34,27,4,4,32,13,19
"2021","Wirral 014C","E01007200",648,160,98,62,467,90,301,91,134,76,42,20,15,7,33,14,19,1,1,21,7,14
"2021","Wirral 014D","E01007201",626,189,92,97,416,57,235,92,106,37,65,42,20,3,56,30,26,3,3,21,10,11
"2021","Wirral 014E","E01007202",680,281,125,156,384,52,158,63,60,35,85,52,24,9,86,42,44,3,3,15,6,9
"2021","Wirral 015A","E01007125",762,291,116,175,453,36,145,48,57,40,96,45,42,9,174,121,53,2,2,18,5,13
"2021","Wirral 015B","E01007156",675,243,96,147,402,67,172,47,78,47,88,45,31,12,72,43,29,3,3,30,12,18
"2021","Wirral 015C","E01007157",601,138,65,73,442,54,195,60,79,56,100,37,50,13,91,62,29,2,2,21,11,10
"2021","Wirral 015D","E01007158",689,227,107,120,420,81,194,75,74,45,79,47,26,6,64,30,34,2,2,42,20,22
"2021","Wirral 015E","E01007159",793,214,107,107,538,102,305,98,141,66,76,33,35,8,52,28,24,3,3,41,19,22
"2021","Wirral 016B","E01007127",718,269,58,211,390,14,109,25,56,28,62,29,26,7,198,153,45,7,7,59,27,32
"2021","Wirral 016C","E01007128",915,550,192,358,318,20,110,29,53,28,64,36,24,4,115,71,44,9,9,47,25,22
"2021","Wirral 016D","E01007129",720,384,73,311,292,14,104,41,42,21,68,23,40,5,101,65,36,5,5,44,25,19
"2021","Wirral 016E","E01007133",701,402,119,283,271,11,60,33,18,9,53,33,13,7,139,95,44,8,8,28,10,18
"2021","Wirral 016F","E01034838",576,317,82,235,236,13,75,42,24,9,58,43,11,4,83,58,25,7,7,23,11,12
"2021","Wirral 016G","E01034839",742,513,90,423,210,14,51,29,17,5,71,66,4,1,70,46,24,4,4,19,5,14
"2021","Wirral 017A","E01007224",619,168,102,66,431,93,212,76,86,50,56,20,32,4,68,45,23,2,2,20,8,12
"2021","Wirral 017B","E01007226",749,250,166,84,466,115,210,98,58,54,70,34,31,5,67,28,39,4,4,33,14,19
"2021","Wirral 017C","E01007265",527,113,58,55,393,48,217,59,98,60,70,39,26,5,58,29,29,0,0,21,11,10
"2021","Wirral 017D","E01007299",586,196,106,90,372,62,187,73,72,42,66,35,30,1,54,20,34,3,3,18,7,11
"2021","Wirral 017E","E01007306",732,234,93,141,471,84,236,110,85,41,79,44,26,9,70,37,33,2,2,27,13,14
"2021","Wirral 018A","E01007297",645,232,149,83,393,57,151,39,80,32,55,18,33,4,128,89,39,2,2,20,12,8
"2021","Wirral 018B","E01007298",618,159,128,31,430,118,243,70,108,65,38,16,19,3,27,6,21,4,4,29,16,13
"2021","Wirral 018C","E01007301",709,229,133,96,463,89,248,87,96,65,63,34,20,9,61,37,24,2,2,17,9,8
"2021","Wirral 018D","E01007302",897,360,135,225,499,64,209,62,114,33,122,58,55,9,98,60,38,6,6,38,21,17
"2021","Wirral 018E","E01007305",738,250,128,122,472,97,232,87,88,57,72,33,34,5,65,36,29,6,6,16,8,8
"2021","Wirral 019A","E01007119",724,242,91,151,458,45,141,52,51,38,77,28,45,4,190,143,47,5,5,24,13,11
"2021","Wirral 019B","E01007161",638,178,120,58,429,72,227,82,89,56,51,17,28,6,79,47,32,0,0,31,17,14
"2021","Wirral 019C","E01007162",541,134,72,62,366,21,119,31,49,39,55,16,33,6,165,113,52,6,6,41,29,12
"2021","Wirral 019D","E01007300",929,291,96,195,603,46,211,66,96,49,115,42,66,7,222,154,68,9,9,35,20,15
"2021","Wirral 020A","E01007155",994,656,210,446,296,33,111,43,44,24,81,52,24,5,68,40,28,3,3,42,17,25
"2021","Wirral 020B","E01007160",820,385,119,266,402,71,173,62,70,41,87,60,24,3,66,40,26,5,5,33,12,21
"2021","Wirral 020C","E01007240",892,549,123,426,311,50,125,41,62,22,82,61,21,0,51,29,22,3,3,32,10,22
"2021","Wirral 020D","E01007241",706,300,209,91,398,108,210,107,60,43,34,23,11,0,45,24,21,1,1,8,2,6
"2021","Wirral 020E","E01007242",869,405,195,210,437,110,208,87,81,40,72,47,21,4,47,27,20,0,0,27,12,15
"2021","Wirral 021A","E01007130",717,263,51,212,408,17,185,44,122,19,66,34,27,5,130,91,39,10,10,46,20,26
"2021","Wirral 021B","E01007131",768,320,90,230,410,25,127,49,61,17,96,40,51,5,156,104,52,6,6,38,20,18
"2021","Wirral 021C","E01007179",651,321,70,251,298,16,104,41,42,21,68,32,34,2,103,73,30,7,7,32,10,22
"2021","Wirral 021D","E01007291",850,394,108,286,418,23,109,44,44,21,86,46,35,5,189,142,47,11,11,38,14,24
"2021","Wirral 021E","E01007292",725,295,75,220,404,22,109,50,40,19,101,43,50,8,164,119,45,8,8,26,16,10
"2021","Wirral 021F","E01007294",680,268,65,203,376,21,97,30,44,23,91,43,44,4,161,121,40,6,6,36,15,21
"2021","Wirral 022A","E01007180",686,252,102,150,398,43,171,67,64,40,80,36,39,5,101,73,28,3,3,36,16,20
"2021","Wirral 022B","E01007181",694,238,70,168,418,41,168,61,72,35,77,45,28,4,127,96,31,5,5,38,8,30
"2021","Wirral 022C","E01007239",800,360,84,276,396,30,146,67,59,20,93,61,26,6,122,93,29,5,5,44,16,28
"2021","Wirral 022D","E01007243",813,364,164,200,428,98,187,75,68,44,76,48,23,5,65,30,35,2,2,21,6,15
"2021","Wirral 022E","E01007244",935,326,53,273,565,28,173,46,94,33,167,69,90,8,192,156,36,5,5,44,15,29
"2021","Wirral 023A","E01007259",487,109,67,42,366,90,203,53,100,50,39,24,14,1,32,18,14,2,2,12,3,9
"2021","Wirral 023B","E01007261",602,162,120,42,420,149,199,81,79,39,39,22,14,3,33,11,22,0,0,20,5,15
"2021","Wirral 023C","E01007264",650,202,137,65,440,114,215,93,75,47,56,34,18,4,53,24,29,2,2,8,2,6
"2021","Wirral 023D","E01007266",613,150,91,59,449,87,277,93,129,55,42,13,24,5,43,26,17,0,0,14,10,4
"2021","Wirral 023E","E01007267",634,196,113,83,425,76,239,81,96,62,55,29,21,5,50,24,26,5,5,13,8,5
"2021","Wirral 023F","E01007268",651,268,195,73,357,112,154,60,55,39,40,24,12,4,48,31,17,3,3,26,12,14
"2021","Wirral 024A","E01007163",917,217,113,104,663,97,341,102,151,88,108,42,52,14,114,72,42,3,3,37,23,14
"2021","Wirral 024B","E01007245",631,189,118,71,421,73,206,61,92,53,79,43,34,2,57,27,30,6,6,21,10,11
"2021","Wirral 024C","E01007246",586,133,72,61,436,92,209,67,87,55,64,27,30,7,70,32,38,1,1,17,7,10
"2021","Wirral 024D","E01007247",660,136,78,58,499,95,260,84,102,74,70,27,40,3,71,35,36,3,3,25,15,10
"2021","Wirral 024E","E01007252",644,177,76,101,445,70,212,73,92,47,99,63,32,4,62,30,32,2,2,22,12,10
"2021","Wirral 025A","E01007249",585,210,103,107,346,27,116,32,49,35,76,31,38,7,124,86,38,3,3,29,14,15
"2021","Wirral 025B","E01007251",510,207,106,101,285,35,142,47,54,41,54,28,21,5,51,27,24,3,3,18,7,11
"2021","Wirral 025C","E01007257",593,227,102,125,341,37,104,35,39,30,60,18,37,5,138,103,35,2,2,25,7,18
"2021","Wirral 025D","E01007303",705,327,142,185,344,18,117,39,42,36,78,25,44,9,122,85,37,9,9,34,17,17
"2021","Wirral 025E","E01007304",634,229,108,121,370,22,124,34,45,45,58,17,34,7,161,110,51,5,5,35,17,18
"2021","Wirral 026A","E01007196",780,351,234,117,413,104,186,55,85,46,67,45,17,5,55,30,25,1,1,16,7,9
"2021","Wirral 026B","E01007197",667,156,88,68,499,124,262,77,135,50,54,23,24,7,56,34,22,3,3,12,7,5
"2021","Wirral 026C","E01007198",801,358,175,183,425,77,201,59,111,31,72,50,22,0,69,38,31,6,6,18,4,14
"2021","Wirral 026D","E01007263",633,222,121,101,378,46,161,49,78,34,78,34,37,7,91,59,32,2,2,33,17,16
"2021","Wirral 026E","E01007282",647,255,137,118,370,69,160,48,84,28,71,45,26,0,62,32,30,8,8,22,3,19
"2021","Wirral 027A","E01007175",907,382,97,285,491,26,138,47,56,35,100,49,38,13,219,125,94,8,8,34,14,20
"2021","Wirral 027B","E01007290",935,458,142,316,428,37,121,34,62,25,105,60,38,7,158,105,53,7,7,49,24,25
"2021","Wirral 027C","E01007293",761,317,109,208,423,18,101,40,39,22,76,40,31,5,221,169,52,7,7,21,11,10
"2021","Wirral 027D","E01007295",726,230,52,178,459,21,129,36,68,25,116,59,51,6,189,145,44,4,4,37,19,18
"2021","Wirral 027E","E01007296",837,363,93,270,443,26,126,41,56,29,90,38,48,4,193,148,45,8,8,31,15,16
"2021","Wirral 028A","E01007258",634,192,120,72,422,100,198,79,97,22,46,19,25,2,78,43,35,0,0,20,6,14
"2021","Wirral 028B","E01007260",636,142,99,43,476,99,281,89,138,54,42,24,14,4,51,24,27,3,3,18,6,12
"2021","Wirral 028C","E01007262",653,176,122,54,464,120,279,104,119,56,41,19,17,5,24,13,11,0,0,13,2,11
"2021","Wirral 028D","E01007281",593,194,130,64,380,116,198,55,107,36,33,17,13,3,32,16,16,1,1,19,10,9
"2021","Wirral 028E","E01007283",477,81,54,27,365,125,209,77,86,46,18,7,9,2,13,7,6,0,0,31,12,19
"2021","Wirral 029A","E01007173",591,170,89,81,394,63,193,53,90,50,56,15,33,8,80,47,33,2,2,27,13,14
"2021","Wirral 029B","E01007174",726,221,98,123,471,44,214,78,85,51,115,48,57,10,90,59,31,8,8,34,17,17
"2021","Wirral 029C","E01007176",763,333,83,250,401,28,149,53,64,32,82,43,33,6,139,99,40,3,3,29,15,14
"2021","Wirral 029D","E01007177",665,218,106,112,417,57,170,50,77,43,84,37,41,6,97,65,32,9,9,30,10,20
"2021","Wirral 029E","E01007178",706,258,100,158,405,42,174,60,76,38,68,27,37,4,117,56,61,4,4,43,23,20
"2021","Wirral 030A","E01007248",600,179,90,89,383,89,215,48,106,61,39,16,21,2,36,18,18,4,4,38,15,23
"2021","Wirral 030B","E01007250",557,123,75,48,416,87,220,66,95,59,58,22,28,8,48,29,19,3,3,18,10,8
"2021","Wirral 030C","E01007253",742,274,112,162,442,57,161,50,81,30,90,39,45,6,125,79,46,9,9,26,15,11
"2021","Wirral 030D","E01007254",640,137,90,47,482,93,278,82,124,72,55,30,21,4,52,18,34,4,4,21,11,10
"2021","Wirral 031A","E01007115",655,181,98,83,446,57,205,65,100,40,72,30,35,7,110,54,56,2,2,28,16,12
"2021","Wirral 031B","E01007138",802,325,97,228,442,32,144,49,71,24,92,45,40,7,167,119,48,7,7,35,17,18
"2021","Wirral 031C","E01007139",708,242,73,169,421,33,173,67,72,34,96,53,38,5,116,74,42,3,3,45,17,28
"2021","Wirral 031D","E01007141",860,395,194,201,442,59,161,80,53,28,88,60,24,4,132,72,60,2,2,23,9,14
"2021","Wirral 031E","E01007289",650,198,60,138,410,16,118,33,53,32,72,19,47,6,195,140,55,9,9,42,17,25
"2021","Wirral 032A","E01007111",579,108,63,45,451,77,264,77,118,69,52,22,25,5,55,21,34,3,3,20,5,15
"2021","Wirral 032B","E01007112",654,208,95,113,416,56,211,62,102,47,66,33,28,5,78,39,39,5,5,30,15,15
"2021","Wirral 032C","E01007113",580,191,89,102,366,73,215,67,101,47,36,20,14,2,40,28,12,2,2,23,13,10
"2021","Wirral 032D","E01007114",576,121,57,64,428,38,182,53,86,43,85,30,44,11,120,88,32,3,3,27,13,14
"2021","Wirral 032E","E01007116",658,213,102,111,438,90,202,61,98,43,74,27,43,4,66,43,23,6,6,7,3,4
"2021","Wirral 033A","E01007280",723,206,134,72,502,83,272,96,110,66,79,39,37,3,67,35,32,1,1,15,5,10
"2021","Wirral 033B","E01007284",688,163,109,54,507,130,295,99,135,61,44,20,22,2,36,20,16,2,2,18,6,12
"2021","Wirral 033C","E01007285",627,158,110,48,444,118,207,73,94,40,63,33,26,4,53,24,29,3,3,25,10,15
"2021","Wirral 033D","E01007287",852,302,196,106,516,126,232,89,85,58,82,45,31,6,75,37,38,1,1,34,15,19
"2021","Wirral 034A","E01007183",520,121,75,46,382,79,211,70,87,54,49,28,19,2,41,23,18,2,2,17,8,9
"2021","Wirral 034B","E01007255",680,224,115,109,435,78,226,70,115,41,71,39,24,8,57,30,27,3,3,21,6,15
"2021","Wirral 034C","E01007256",758,258,183,75,475,166,205,94,75,36,52,31,19,2,50,24,26,2,2,25,14,11
"2021","Wirral 034D","E01007279",659,172,91,81,461,69,250,80,118,52,70,34,31,5,71,45,26,1,1,26,9,17
"2021","Wirral 034E","E01007286",633,172,98,74,432,83,210,80,86,44,67,27,33,7,67,42,25,5,5,29,14,15
"2021","Wirral 035A","E01007110",730,233,117,116,474,109,223,76,103,44,76,37,36,3,62,29,33,4,4,23,8,15
"2021","Wirral 035B","E01007117",628,125,65,60,483,62,274,66,149,59,68,32,32,4,74,46,28,5,5,20,8,12
"2021","Wirral 035C","E01007118",631,217,88,129,387,27,191,63,86,42,70,29,28,13,91,57,34,8,8,27,10,17
"2021","Wirral 035D","E01007151",645,174,117,57,447,90,258,88,117,53,54,26,24,4,43,15,28,2,2,24,11,13
"2021","Wirral 035E","E01007154",613,139,92,47,464,92,235,74,108,53,69,33,31,5,68,39,29,0,0,10,5,5
"2021","Wirral 036B","E01007142",866,280,129,151,550,121,261,113,96,52,96,58,34,4,65,33,32,7,7,36,14,22
"2021","Wirral 036C","E01007143",804,209,56,153,570,44,244,74,125,45,148,79,64,5,129,85,44,5,5,25,9,16
"2021","Wirral 036D","E01007152",778,313,179,134,445,73,208,86,92,30,75,46,25,4,89,41,48,0,0,20,8,12
"2021","Wirral 036E","E01007153",621,227,144,83,369,61,166,43,76,47,61,29,27,5,79,55,24,2,2,25,14,11
"2021","Wirral 036F","E01034840",647,221,78,143,401,26,173,66,79,28,103,58,36,9,92,64,28,7,7,25,10,15
"2021","Wirral 036G","E01034841",560,143,28,115,405,9,172,40,114,18,167,94,67,6,54,38,16,3,3,12,6,6
"2021","Wirral 037A","E01007182",713,271,183,88,424,111,221,82,107,32,38,29,6,3,54,34,20,0,0,18,7,11
"2021","Wirral 037B","E01007184",673,252,144,108,403,85,204,67,93,44,57,30,19,8,54,31,23,3,3,18,8,10
"2021","Wirral 037C","E01007185",718,236,106,130,460,60,200,62,90,48,90,54,33,3,106,65,41,4,4,22,11,11
"2021","Wirral 037D","E01007192",656,282,193,89,353,94,186,70,75,41,34,21,12,1,39,21,18,0,0,21,12,9
"2021","Wirral 037E","E01007288",761,256,165,91,486,109,191,65,75,51,72,33,35,4,111,55,56,3,3,19,7,12
"2021","Wirral 038A","E01007144",548,145,94,51,385,103,184,78,76,30,50,32,14,4,45,23,22,3,3,18,8,10
"2021","Wirral 038B","E01007145",531,141,92,49,387,143,183,59,83,41,31,16,11,4,29,6,23,1,1,3,1,2
"2021","Wirral 038C","E01007146",678,215,131,84,444,113,220,89,80,51,65,37,25,3,41,21,20,5,5,19,9,10
"2021","Wirral 038D","E01007147",610,166,120,46,431,115,218,66,102,50,50,27,23,0,46,22,24,2,2,13,4,9
"2021","Wirral 038E","E01007148",653,146,120,26,492,147,280,91,122,67,38,16,19,3,26,12,14,1,1,15,6,9
"2021","Wirral 039A","E01007135",666,191,107,84,453,96,241,79,103,59,58,31,26,1,54,24,30,4,4,22,6,16
"2021","Wirral 039B","E01007136",695,188,73,115,471,49,166,63,64,39,98,34,56,8,153,96,57,5,5,36,21,15
"2021","Wirral 039C","E01007137",784,322,133,189,427,49,165,50,79,36,83,42,35,6,120,81,39,10,10,35,15,20
"2021","Wirral 039D","E01007170",720,202,126,76,498,113,239,77,111,51,87,53,30,4,59,30,29,0,0,20,11,9
"2021","Wirral 040A","E01007186",645,173,129,44,467,121,264,72,119,73,32,14,16,2,50,27,23,0,0,5,2,3
"2021","Wirral 040B","E01007187",646,163,108,55,461,150,246,97,94,55,38,22,10,6,25,11,14,2,2,22,8,14
"2021","Wirral 040C","E01007188",626,156,109,47,446,125,239,84,109,46,40,19,17,4,42,19,23,0,0,24,6,18
"2021","Wirral 040D","E01007189",709,207,146,61,487,166,247,98,100,49,34,16,14,4,39,14,25,1,1,15,6,9
"2021","Wirral 040E","E01007190",645,143,111,32,485,163,261,101,116,44,27,16,7,4,34,14,20,0,0,17,8,9
"2021","Wirral 040F","E01007191",541,103,82,21,421,131,255,83,115,57,18,5,12,1,17,8,9,0,0,17,9,8
"2021","Wirral 041A","E01007149",629,161,119,42,445,132,230,72,107,51,43,26,16,1,38,20,18,2,2,23,15,8
"2021","Wirral 041B","E01007150",566,153,96,57,387,79,200,74,78,48,59,28,29,2,47,23,24,2,2,26,14,12
"2021","Wirral 041C","E01007165",548,155,101,54,372,122,152,56,59,37,45,23,19,3,53,23,30,0,0,21,10,11
"2021","Wirral 041D","E01007171",615,146,101,45,442,80,254,73,127,54,65,26,35,4,41,21,20,2,2,27,12,15
"2021","Wirral 041E","E01007172",642,207,158,49,411,121,226,88,97,41,31,17,13,1,31,13,18,2,2,24,6,18
"2021","Wirral 042A","E01007164",756,209,84,125,522,63,298,96,145,57,95,55,37,3,62,40,22,4,4,25,11,14
"2021","Wirral 042B","E01007166",623,167,100,67,443,110,207,87,72,48,70,34,33,3,52,27,25,4,4,13,6,7
"2021","Wirral 042C","E01007167",633,168,76,92,430,49,196,63,94,39,79,33,38,8,103,65,38,3,3,35,19,16
"2021","Wirral 042D","E01007168",733,242,113,129,456,46,180,57,95,28,83,34,42,7,144,82,62,3,3,35,14,21
"2021","Wirral 042E","E01007169",746,231,129,102,482,61,225,93,87,45,86,46,37,3,96,55,41,14,14,33,18,15
"2021","Kingston upon Hull 002A","E01012782",554,188,86,102,332,29,105,23,51,31,82,13,53,16,112,81,31,4,4,34,18,16
"2021","Kingston upon Hull 002B","E01012785",550,183,58,125,336,21,112,48,48,16,78,24,50,4,120,83,37,5,5,31,19,12
"2021","Kingston upon Hull 002C","E01012786",518,152,74,78,350,40,151,61,59,31,74,20,44,10,81,41,40,4,4,16,11,5
"2021","Kingston upon Hull 002D","E01012787",635,227,77,150,383,44,126,46,53,27,87,30,49,8,121,87,34,5,5,25,14,11
"2021","Kingston upon Hull 002E","E01012788",577,156,55,101,401,29,128,42,58,28,86,25,55,6,156,106,50,2,2,20,11,9
"2021","Kingston upon Hull 002F","E01012789",544,169,58,111,350,35,118,42,46,30,74,29,39,6,117,88,29,6,6,25,16,9
"2021","Kingston upon Hull 003A","E01012875",593,197,57,140,362,20,134,23,91,20,78,17,50,11,127,98,29,3,3,34,28,6
"2021","Kingston upon Hull 003B","E01012876",626,189,82,107,402,19,145,42,76,27,96,21,64,11,140,109,31,2,2,35,26,9
"2021","Kingston upon Hull 003C","E01012877",550,128,41,87,396,19,125,24,79,22,94,12,74,8,154,110,44,4,4,26,18,8
"2021","Kingston upon Hull 003D","E01012878",732,218,80,138,480,26,141,49,62,30,139,30,78,31,172,133,39,2,2,34,18,16
"2021","Kingston upon Hull 003E","E01012879",567,183,43,140,361,17,102,27,53,22,89,31,50,8,147,103,44,6,6,23,14,9
"2021","Kingston upon Hull 004A","E01012778",519,105,35,70,379,25,124,40,60,24,82,20,56,6,147,102,45,1,1,35,23,12
"2021","Kingston upon Hull 004B","E01012783",535,201,78,123,309,21,79,25,33,21,102,33,63,6,97,75,22,10,10,25,11,14
"2021","Kingston upon Hull 004C","E01012784",760,181,61,120,535,34,246,79,113,54,135,53,68,14,116,86,30,4,4,44,27,17
"2021","Kingston upon Hull 004D","E01012790",603,234,102,132,349,60,128,53,42,33,72,31,27,14,85,60,25,4,4,20,6,14
"2021","Kingston upon Hull 004E","E01012906",662,204,77,127,427,30,142,50,56,36,131,33,92,6,123,91,32,1,1,31,17,14
"2021","Kingston upon Hull 004F","E01012908",440,151,67,84,275,45,106,47,38,21,59,21,27,11,63,49,14,2,2,14,7,7
"2021","Kingston upon Hull 005A","E01012764",562,194,115,79,359,111,143,75,38,30,56,42,11,3,48,25,23,1,1,9,3,6
"2021","Kingston upon Hull 005B","E01012765",623,176,51,125,428,62,189,73,84,32,103,60,40,3,72,42,30,2,2,19,6,13
"2021","Kingston upon Hull 005C","E01012768",692,286,122,164,387,95,160,83,45,32,81,51,30,0,49,22,27,2,2,19,9,10
"2021","Kingston upon Hull 005D","E01012769",681,264,160,104,404,137,159,89,34,36,67,45,18,4,39,20,19,2,2,13,7,6
"2021","Kingston upon Hull 006A","E01012829",853,282,134,148,537,92,271,120,107,44,109,56,48,5,64,37,27,1,1,34,16,18
"2021","Kingston upon Hull 006B","E01012830",610,156,90,66,430,93,197,82,78,37,87,35,43,9,49,29,20,4,4,24,9,15
"2021","Kingston upon Hull 006C","E01012905",575,203,111,92,349,52,135,45,60,30,65,18,39,8,94,66,28,3,3,23,13,10
"2021","Kingston upon Hull 006D","E01012910",465,71,36,35,374,47,195,68,74,53,79,32,39,8,53,29,24,0,0,20,8,12
"2021","Kingston upon Hull 006E","E01012912",744,206,134,72,503,123,226,97,86,43,91,36,49,6,60,36,24,3,3,35,13,22
"2021","Kingston upon Hull 007A","E01012822",654,212,127,85,424,75,216,65,96,55,77,31,39,7,52,32,20,4,4,18,6,12
"2021","Kingston upon Hull 007B","E01012904",551,200,106,94,341,70,170,78,65,27,58,29,25,4,35,20,15,8,8,10,5,5
"2021","Kingston upon Hull 007C","E01012907",754,318,133,185,415,71,171,77,64,30,90,41,39,10,77,39,38,6,6,21,9,12
"2021","Kingston upon Hull 007D","E01012909",581,201,78,123,367,55,178,88,49,41,84,53,31,0,46,26,20,4,4,13,7,6
"2021","Kingston upon Hull 007E","E01012911",482,112,50,62,357,78,182,82,59,41,69,36,28,5,27,14,13,1,1,13,4,9
"2021","Kingston upon Hull 008A","E01012873",624,192,78,114,399,22,127,38,66,23,98,28,56,14,147,98,49,5,5,33,26,7
"2021","Kingston upon Hull 008B","E01012874",632,218,78,140,380,24,132,46,56,30,81,17,49,15,142,102,40,1,1,34,14,20
"2021","Kingston upon Hull 008C","E01012880",696,181,59,122,483,22,152,49,64,39,138,44,81,13,166,124,42,5,5,32,13,19
"2021","Kingston upon Hull 008D","E01012881",628,206,67,139,371,18,134,44,65,25,101,32,58,11,112,73,39,6,6,51,27,24
"2021","Kingston upon Hull 008E","E01012915",639,201,86,115,377,40,127,50,50,27,95,37,50,8,110,78,32,5,5,61,36,25
"2021","Kingston upon Hull 008F","E01012917",765,265,144,121,469,54,166,60,71,35,148,46,96,6,93,64,29,8,8,31,12,19
"2021","Kingston upon Hull 008G","E01012918",625,147,46,101,413,19,162,52,71,39,87,31,46,10,138,103,35,7,7,65,39,26
"2021","Kingston upon Hull 009A","E01012833",654,183,87,96,440,34,142,53,57,32,113,25,77,11,146,116,30,5,5,31,11,20
"2021","Kingston upon Hull 009B","E01012835",517,143,96,47,348,112,155,90,32,33,55,27,21,7,24,10,14,2,2,26,8,18
"2021","Kingston upon Hull 009C","E01012836",730,340,121,219,364,27,129,63,40,26,115,47,60,8,90,58,32,3,3,26,12,14
"2021","Kingston upon Hull 009D","E01012839",540,115,71,44,412,65,186,84,62,40,69,20,46,3,89,60,29,3,3,13,7,6
"2021","Kingston upon Hull 009E","E01012840",633,184,68,116,431,39,130,48,55,27,93,24,60,9,165,110,55,4,4,18,9,9
"2021","Kingston upon Hull 010A","E01012824",770,194,74,120,546,63,278,116,114,48,135,56,67,12,69,35,34,1,1,30,11,19
"2021","Kingston upon Hull 010B","E01012825",671,193,121,72,461,108,222,91,75,56,89,43,39,7,38,22,16,4,4,17,7,10
"2021","Kingston upon Hull 010C","E01012834",636,156,64,92,455,31,143,38,78,27,104,25,73,6,173,119,54,4,4,25,13,12
"2021","Kingston upon Hull 010D","E01012837",694,229,110,119,434,45,144,64,50,30,106,35,63,8,131,88,43,8,8,31,14,17
"2021","Kingston upon Hull 010E","E01012838",616,141,64,77,451,29,157,35,98,24,107,34,62,11,154,115,39,4,4,24,13,11
"2021","Kingston upon Hull 011A","E01012821",866,340,173,167,500,68,207,80,83,44,111,50,54,7,110,68,42,4,4,26,13,13
"2021","Kingston upon Hull 011D","E01012827",763,320,200,120,411,84,195,88,77,30,90,54,27,9,41,14,27,1,1,32,13,19
"2021","Kingston upon Hull 011E","E01012828",659,200,89,111,438,58,171,61,66,44,99,44,46,9,104,58,46,6,6,21,12,9
"2021","Kingston upon Hull 011F","E01035463",1078,359,173,186,689,101,232,98,89,45,157,53,89,15,193,132,61,6,6,30,9,21
"2021","Kingston upon Hull 012A","E01012766",550,101,42,59,416,50,223,88,91,44,104,50,49,5,36,20,16,3,3,33,17,16
"2021","Kingston upon Hull 012B","E01012767",546,135,42,93,294,30,137,58,55,24,79,43,30,6,44,20,24,4,4,117,21,96
"2021","Kingston upon Hull 012C","E01012914",568,135,23,112,138,9,48,11,32,5,47,39,7,1,24,17,7,10,10,295,7,288
"2021","Kingston upon Hull 012D","E01012916",751,254,108,146,399,56,176,69,74,33,97,47,40,10,67,41,26,3,3,98,6,92
"2021","Kingston upon Hull 013A","E01012812",517,108,70,38,393,70,218,67,110,41,67,21,40,6,37,17,20,1,1,16,5,11
"2021","Kingston upon Hull 013B","E01012813",668,133,74,59,514,99,297,121,113,63,67,25,35,7,51,32,19,0,0,21,9,12
"2021","Kingston upon Hull 013C","E01012814",607,123,82,41,463,97,233,78,95,60,77,29,43,5,55,21,34,1,1,21,9,12
"2021","Kingston upon Hull 013D","E01012815",660,178,64,114,460,70,207,92,76,39,108,54,42,12,71,51,20,4,4,22,11,11
"2021","Kingston upon Hull 013E","E01012818",499,112,64,48,368,62,187,67,70,50,76,29,41,6,41,19,22,2,2,19,10,9
"2021","Kingston upon Hull 014A","E01012791",659,154,103,51,481,85,257,101,110,46,87,36,43,8,52,33,19,0,0,24,11,13
"2021","Kingston upon Hull 014B","E01012792",629,168,92,76,431,70,209,76,94,39,99,40,52,7,50,27,23,3,3,30,10,20
"2021","Kingston upon Hull 014C","E01012793",617,211,131,80,373,94,191,88,66,37,51,27,20,4,35,17,18,2,2,33,17,16
"2021","Kingston upon Hull 014D","E01012794",623,166,66,100,437,54,218,86,90,42,94,38,49,7,71,39,32,0,0,20,5,15
"2021","Kingston upon Hull 014E","E01012913",831,246,74,172,531,54,224,70,117,37,118,53,56,9,130,82,48,5,5,54,19,35
"2021","Kingston upon Hull 015A","E01012761",859,458,102,356,313,29,93,38,45,10,112,81,18,13,68,49,19,11,11,88,25,63
"2021","Kingston upon Hull 015B","E01012868",661,241,65,176,227,8,78,30,37,11,85,49,34,2,46,35,11,10,10,193,39,154
"2021","Kingston upon Hull 015C","E01012869",638,197,60,137,257,23,96,31,47,18,87,58,26,3,36,20,16,15,15,184,30,154
"2021","Kingston upon Hull 015D","E01012871",738,287,43,244,347,20,140,60,61,19,104,61,38,5,63,43,20,20,20,104,31,73
"2021","Kingston upon Hull 015E","E01012872",634,250,58,192,216,3,64,26,31,7,90,63,16,11,46,28,18,13,13,168,37,131
"2021","Kingston upon Hull 016A","E01012804",777,247,76,171,497,59,236,115,85,36,150,81,60,9,49,29,20,3,3,33,10,23
"2021","Kingston upon Hull 016B","E01012806",706,300,61,239,370,24,129,50,55,24,101,46,50,5,110,82,28,6,6,36,11,25
"2021","Kingston upon Hull 016C","E01012807",604,187,97,90,386,79,182,78,64,40,75,36,29,10,45,26,19,5,5,31,16,15
"2021","Kingston upon Hull 016D","E01012817",689,259,61,198,410,37,152,64,63,25,149,95,49,5,66,43,23,6,6,20,6,14
"2021","Kingston upon Hull 016E","E01012819",604,181,70,111,396,56,162,57,70,35,105,43,53,9,69,42,27,4,4,27,12,15
"2021","Kingston upon Hull 017A","E01012841",631,142,68,74,453,30,136,52,61,23,96,24,63,9,185,132,53,6,6,36,9,27
"2021","Kingston upon Hull 017B","E01012844",591,223,107,116,347,28,97,47,36,14,86,32,47,7,130,96,34,6,6,21,10,11
"2021","Kingston upon Hull 017C","E01012849",671,193,98,95,451,37,151,61,59,31,132,53,68,11,125,74,51,6,6,27,15,12
"2021","Kingston upon Hull 017F","E01012898",770,290,202,88,453,72,144,54,62,28,115,35,48,32,118,71,47,4,4,27,17,10
"2021","Kingston upon Hull 017G","E01035464",937,298,146,152,602,31,178,67,76,35,151,37,102,12,232,175,57,10,10,37,25,12
"2021","Kingston upon Hull 018A","E01012758",700,247,72,175,421,54,209,73,105,31,109,73,33,3,41,23,18,8,8,32,9,23
"2021","Kingston upon Hull 018B","E01012762",590,184,55,129,350,25,151,61,66,24,98,54,38,6,64,38,26,12,12,56,13,43
"2021","Kingston upon Hull 018C","E01012763",866,454,55,399,329,29,127,48,59,20,107,83,20,4,56,35,21,10,10,83,19,64
"2021","Kingston upon Hull 018D","E01012866",747,243,39,204,373,19,116,52,46,18,143,84,54,5,89,61,28,6,6,131,21,110
"2021","Kingston upon Hull 018E","E01012870",686,191,34,157,312,14,135,66,60,9,111,77,28,6,43,22,21,9,9,183,29,154
"2021","Kingston upon Hull 019A","E01012774",639,175,72,103,442,38,183,78,64,41,120,51,58,11,98,71,27,3,3,22,5,17
"2021","Kingston upon Hull 019B","E01012795",895,306,161,145,555,51,212,76,88,48,129,59,58,12,159,117,42,4,4,34,14,20
"2021","Kingston upon Hull 019C","E01012797",612,212,98,114,382,55,149,61,61,27,108,55,45,8,65,45,20,5,5,18,7,11
"2021","Kingston upon Hull 019D","E01012798",817,373,206,167,419,59,169,64,65,40,87,33,42,12,99,69,30,5,5,25,10,15
"2021","Kingston upon Hull 019E","E01012801",646,204,104,100,418,66,190,89,70,31,82,45,34,3,77,46,31,3,3,24,12,12
"2021","Kingston upon Hull 020A","E01012816",596,177,84,93,386,35,191,75,74,42,76,30,39,7,82,54,28,2,2,33,14,19
"2021","Kingston upon Hull 020B","E01012848",588,250,44,206,318,16,112,50,45,17,107,74,29,4,79,55,24,4,4,20,8,12
"2021","Kingston upon Hull 020C","E01012894",837,183,55,128,603,47,205,60,95,50,181,69,96,16,162,94,68,8,8,51,27,24
"2021","Kingston upon Hull 020D","E01012896",791,224,83,141,512,35,270,109,116,45,111,43,56,12,89,56,33,7,7,55,29,26
"2021","Kingston upon Hull 020E","E01012901",614,182,77,105,419,48,191,75,64,52,109,52,44,13,70,44,26,1,1,13,8,5
"2021","Kingston upon Hull 021A","E01012842",565,135,53,82,399,27,133,41,62,30,104,32,62,10,132,108,24,3,3,31,17,14
"2021","Kingston upon Hull 021B","E01012843",637,194,68,126,414,28,117,50,45,22,117,36,74,7,147,113,34,5,5,29,14,15
"2021","Kingston upon Hull 021C","E01012845",600,165,72,93,403,24,135,44,57,34,76,26,42,8,160,135,25,8,8,32,20,12
"2021","Kingston upon Hull 021D","E01012846",564,177,84,93,365,26,139,51,51,37,96,30,58,8,98,79,19,6,6,22,11,11
"2021","Kingston upon Hull 021E","E01012847",487,120,53,67,343,26,104,36,47,21,91,24,58,9,118,89,29,4,4,24,18,6
"2021","Kingston upon Hull 022A","E01012820",540,141,45,96,369,32,178,56,80,42,86,40,39,7,70,41,29,3,3,30,17,13
"2021","Kingston upon Hull 022B","E01012899",670,216,79,137,425,47,170,80,55,35,105,50,46,9,96,52,44,7,7,29,9,20
"2021","Kingston upon Hull 022C","E01012900",751,313,92,221,403,43,106,46,35,25,130,67,60,3,112,82,30,12,12,35,12,23
"2021","Kingston upon Hull 022D","E01012902",606,139,66,73,426,55,183,72,65,46,110,46,54,10,70,46,24,8,8,41,31,10
"2021","Kingston upon Hull 022E","E01012903",820,338,93,245,452,52,152,65,61,26,142,73,62,7,103,77,26,3,3,30,18,12
"2021","Kingston upon Hull 023A","E01012796",581,187,90,97,379,69,151,56,59,36,100,52,35,13,54,33,21,5,5,15,5,10
"2021","Kingston upon Hull 023B","E01012799",603,214,63,151,378,19,119,62,31,26,135,79,54,2,103,73,30,2,2,11,7,4
"2021","Kingston upon Hull 023C","E01012800",750,317,118,199,410,37,153,75,43,35,142,78,59,5,74,49,25,4,4,23,5,18
"2021","Kingston upon Hull 023D","E01012802",646,226,86,140,403,59,131,57,52,22,127,65,55,7,83,60,23,3,3,17,4,13
"2021","Kingston upon Hull 023E","E01012803",647,219,83,136,412,58,130,58,49,23,132,69,58,5,86,55,31,6,6,16,7,9
"2021","Kingston upon Hull 024A","E01012850",781,359,66,293,347,6,121,36,72,13,113,78,27,8,93,58,35,14,14,75,24,51
"2021","Kingston upon Hull 024B","E01012852",765,339,78,261,364,21,150,45,78,27,90,61,20,9,95,58,37,8,8,62,29,33
"2021","Kingston upon Hull 024C","E01012856",787,371,146,225,384,37,173,34,107,32,77,24,49,4,90,46,44,7,7,32,18,14
"2021","Kingston upon Hull 024D","E01012857",798,352,110,242,387,25,161,56,91,14,101,45,46,10,89,54,35,11,11,59,23,36
"2021","Kingston upon Hull 024E","E01012867",725,245,56,189,419,14,128,37,72,19,182,124,44,14,84,62,22,11,11,61,27,34
"2021","Kingston upon Hull 025A","E01012756",713,268,92,176,415,52,166,74,57,35,121,72,45,4,72,47,25,4,4,30,8,22
"2021","Kingston upon Hull 025B","E01012757",639,234,41,193,342,24,142,59,65,18,109,72,32,5,57,38,19,10,10,63,18,45
"2021","Kingston upon Hull 025C","E01012759",797,317,99,218,444,32,138,57,53,28,149,86,58,5,117,79,38,8,8,36,13,23
"2021","Kingston upon Hull 025D","E01012760",716,285,58,227,388,26,139,55,61,23,134,91,39,4,82,53,29,7,7,43,9,34
"2021","Kingston upon Hull 025E","E01012862",603,237,95,142,325,27,111,42,47,22,78,43,29,6,98,63,35,11,11,41,12,29
"2021","Kingston upon Hull 026A","E01012805",669,278,64,214,348,25,109,44,43,22,77,35,40,2,127,89,38,10,10,43,16,27
"2021","Kingston upon Hull 026B","E01012808",834,393,161,232,404,43,141,45,73,23,88,41,42,5,117,76,41,15,15,37,14,23
"2021","Kingston upon Hull 026C","E01012809",887,420,88,332,415,18,148,74,53,21,147,78,61,8,90,52,38,12,12,52,11,41
"2021","Kingston upon Hull 026D","E01012810",909,381,151,230,501,66,273,110,135,28,106,68,27,11,53,40,13,3,3,27,13,14
"2021","Kingston upon Hull 026E","E01012811",828,389,87,302,410,34,213,97,101,15,121,94,24,3,39,22,17,3,3,29,8,21
"2021","Kingston upon Hull 027A","E01012773",751,254,81,173,481,51,201,83,74,44,152,88,59,5,76,44,32,1,1,16,1,15
"2021","Kingston upon Hull 027B","E01012776",665,214,75,139,423,51,189,92,68,29,113,68,38,7,68,45,23,2,2,28,12,16
"2021","Kingston upon Hull 027C","E01012863",990,288,87,201,648,28,274,94,133,47,213,102,103,8,126,89,37,7,7,54,28,26
"2021","Kingston upon Hull 027D","E01012864",753,297,35,262,390,10,140,55,60,25,110,54,45,11,121,97,24,9,9,66,32,34
"2021","Kingston upon Hull 027E","E01012865",547,181,64,117,302,24,127,53,57,17,58,30,26,2,88,44,44,5,5,64,13,51
"2021","Kingston upon Hull 028A","E01012770",595,105,62,43,475,74,271,100,112,59,92,42,42,8,34,19,15,4,4,15,7,8
"2021","Kingston upon Hull 028B","E01012771",635,155,85,70,454,72,218,83,87,48,99,49,39,11,61,31,30,4,4,26,14,12
"2021","Kingston upon Hull 028C","E01012772",660,189,60,129,445,53,238,88,98,52,98,43,46,9,56,32,24,0,0,26,8,18
"2021","Kingston upon Hull 028D","E01012775",720,233,93,140,463,61,174,71,77,26,126,62,59,5,99,71,28,3,3,24,14,10
"2021","Kingston upon Hull 028E","E01012777",793,396,262,134,374,71,158,59,72,27,82,35,39,8,56,33,23,7,7,23,10,13
"2021","Kingston upon Hull 029C","E01012854",1152,621,128,493,477,36,172,57,98,17,130,97,29,4,127,94,33,12,12,54,24,30
"2021","Kingston upon Hull 029D","E01012855",894,414,107,307,416,20,157,28,104,25,108,55,45,8,121,76,45,10,10,64,39,25
"2021","Kingston upon Hull 029E","E01033104",1077,795,112,683,242,21,67,58,6,3,117,111,5,1,26,20,6,11,11,40,1,39
"2021","Kingston upon Hull 029F","E01033109",880,606,73,533,232,11,80,31,46,3,87,70,16,1,46,29,17,8,8,42,4,38
"2021","Kingston upon Hull 029G","E01035465",647,353,39,314,247,10,65,27,27,11,110,87,18,5,47,29,18,15,15,47,9,38
"2021","Kingston upon Hull 029H","E01035466",767,459,76,383,264,6,96,42,44,10,82,58,22,2,61,36,25,19,19,44,8,36
"2021","Kingston upon Hull 030A","E01012859",712,276,51,225,397,14,178,85,72,21,97,47,40,10,99,67,32,9,9,39,24,15
"2021","Kingston upon Hull 030B","E01012889",759,332,98,234,381,21,115,47,51,17,115,47,66,2,124,88,36,6,6,46,21,25
"2021","Kingston upon Hull 030C","E01012891",1013,426,53,373,511,18,158,50,87,21,169,113,49,7,142,109,33,24,24,76,38,38
"2021","Kingston upon Hull 030D","E01012892",776,228,49,179,457,17,185,64,94,27,140,53,86,1,104,73,31,11,11,91,32,59
"2021","Kingston upon Hull 030E","E01012893",746,301,95,206,381,19,112,42,53,17,92,44,39,9,153,116,37,5,5,64,17,47
"2021","Kingston upon Hull 031A","E01012858",872,237,82,155,583,45,192,62,101,29,186,61,110,15,152,96,56,8,8,52,29,23
"2021","Kingston upon Hull 031B","E01012860",1031,264,66,198,729,48,305,108,145,52,217,111,100,6,151,103,48,8,8,38,24,14
"2021","Kingston upon Hull 031D","E01012886",706,241,123,118,432,58,189,88,50,51,84,34,41,9,97,62,35,4,4,33,15,18
"2021","Kingston upon Hull 031E","E01012888",760,274,50,224,430,14,117,43,43,31,139,83,51,5,147,111,36,13,13,56,14,42
"2021","Kingston upon Hull 031H","E01035467",665,213,57,156,400,16,170,52,94,24,130,58,66,6,79,57,22,5,5,52,27,25
"2021","Kingston upon Hull 031I","E01035468",551,234,104,130,291,29,104,33,54,17,55,23,29,3,100,63,37,3,3,26,11,15
"2021","Kingston upon Hull 033A","E01012882",675,186,79,107,460,68,211,93,78,40,111,52,48,11,68,38,30,2,2,29,13,16
"2021","Kingston upon Hull 033B","E01012883",798,371,261,110,412,127,169,91,51,27,70,36,27,7,42,19,23,4,4,15,7,8
"2021","Kingston upon Hull 033C","E01012884",832,314,156,158,477,61,163,53,68,42,118,45,67,6,129,83,46,6,6,41,25,16
"2021","Kingston upon Hull 033D","E01012887",707,288,86,202,386,40,126,41,55,30,89,38,43,8,126,92,34,5,5,33,17,16
"2021","Kingston upon Hull 033E","E01032595",806,270,121,149,494,51,196,68,82,46,97,40,51,6,147,103,44,3,3,42,23,19
"2021","Kingston upon Hull 034A","E01012779",502,125,32,93,331,23,92,30,39,23,86,26,56,4,128,99,29,2,2,46,22,24
"2021","Kingston upon Hull 034D","E01012780",695,150,43,107,515,39,132,40,57,35,132,34,85,13,212,130,82,0,0,30,15,15
"2021","Kingston upon Hull 034B","E01012781",473,111,53,58,339,45,114,24,61,29,65,21,40,4,115,86,29,0,0,23,14,9
"2021","Kingston upon Hull 034E","E01012832",760,201,29,172,524,30,220,81,103,36,186,102,75,9,83,59,24,5,5,35,18,17
"2021","Kingston upon Hull 034C","E01035469",802,141,23,118,629,25,303,107,161,35,215,108,101,6,86,70,16,0,0,32,10,22
"2021","Kingston upon Hull 035D","E01033105",594,102,27,75,475,25,264,106,116,42,133,67,59,7,53,36,17,0,0,17,6,11
"2021","Kingston upon Hull 035E","E01033107",483,76,12,64,382,20,198,76,93,29,110,51,56,3,49,37,12,5,5,25,12,13
"2021","Kingston upon Hull 035A","E01035470",952,170,8,162,739,10,365,70,265,30,296,166,126,4,66,59,7,2,2,43,16,27
"2021","Kingston upon Hull 035B","E01035471",592,210,14,196,360,7,181,62,99,20,126,73,50,3,44,37,7,2,2,22,9,13
"2021","Kingston upon Hull 035C","E01035472",676,142,6,136,507,9,282,74,180,28,146,71,74,1,70,50,20,0,0,27,14,13
"2021","East Riding of Yorkshire 001A","E01012933",485,143,104,39,327,117,141,71,44,26,48,34,11,3,20,10,10,1,1,15,8,7
"2021","East Riding of Yorkshire 001B","E01012934",812,258,112,146,526,140,218,122,64,32,95,48,45,2,73,43,30,0,0,28,7,21
"2021","East Riding of Yorkshire 001D","E01012939",841,218,152,66,596,246,240,108,81,51,76,35,37,4,33,22,11,1,1,27,15,12
"2021","East Riding of Yorkshire 001E","E01012940",851,326,219,107,501,191,188,111,38,39,68,38,26,4,51,31,20,3,3,24,8,16
"2021","East Riding of Yorkshire 001F","E01012941",720,271,206,65,430,179,179,109,34,36,39,17,20,2,30,13,17,3,3,19,6,13
"2021","East Riding of Yorkshire 001G","E01034752",635,149,99,50,471,112,176,75,73,28,72,27,39,6,108,77,31,3,3,15,7,8
"2021","East Riding of Yorkshire 001H","E01034753",617,236,156,80,362,126,146,89,33,24,46,24,19,3,43,31,12,1,1,19,7,12
"2021","East Riding of Yorkshire 002A","E01012929",805,252,97,155,517,63,227,87,91,49,113,45,59,9,105,73,32,9,9,36,15,21
"2021","East Riding of Yorkshire 002B","E01012930",628,190,120,70,425,119,184,78,67,39,65,31,28,6,57,37,20,0,0,13,2,11
"2021","East Riding of Yorkshire 002C","E01012935",624,174,146,28,433,164,192,113,48,31,43,17,23,3,33,15,18,1,1,17,5,12
"2021","East Riding of Yorkshire 002D","E01012937",1056,345,220,125,675,227,327,207,59,61,81,46,28,7,39,21,18,1,1,36,12,24
"2021","East Riding of Yorkshire 002E","E01012942",647,239,176,63,392,191,138,86,29,23,36,18,18,0,26,10,16,1,1,16,6,10
"2021","East Riding of Yorkshire 003A","E01012928",744,266,154,112,451,47,169,73,70,26,73,27,40,6,155,121,34,7,7,27,15,12
"2021","East Riding of Yorkshire 003B","E01012931",786,391,238,153,373,78,127,55,51,21,67,30,36,1,96,63,33,5,5,22,6,16
"2021","East Riding of Yorkshire 003C","E01012932",774,300,148,152,459,83,158,72,58,28,101,47,50,4,113,79,34,4,4,15,7,8
"2021","East Riding of Yorkshire 003D","E01012946",702,284,149,135,394,54,117,46,42,29,89,25,60,4,130,97,33,4,4,24,8,16
"2021","East Riding of Yorkshire 003E","E01012949",625,248,137,111,357,64,130,66,37,27,79,32,39,8,80,43,37,4,4,20,11,9
"2021","East Riding of Yorkshire 004A","E01012936",645,293,171,122,333,138,134,91,25,18,37,28,7,2,22,5,17,2,2,19,8,11
"2021","East Riding of Yorkshire 004B","E01012943",759,292,148,144,420,47,150,57,57,36,118,52,58,8,102,70,32,3,3,47,15,32
"2021","East Riding of Yorkshire 004C","E01012945",706,302,103,199,362,46,140,64,54,22,83,45,31,7,83,68,15,10,10,42,19,23
"2021","East Riding of Yorkshire 004D","E01012952",718,327,116,211,358,65,153,78,41,34,57,29,25,3,79,57,22,4,4,33,15,18
"2021","East Riding of Yorkshire 005A","E01012944",728,376,90,286,308,28,130,56,53,21,77,44,27,6,64,42,22,9,9,44,14,30
"2021","East Riding of Yorkshire 005B","E01012947",619,187,93,94,394,90,187,87,68,32,63,28,32,3,51,26,25,3,3,38,18,20
"2021","East Riding of Yorkshire 005C","E01012948",694,355,120,235,289,27,131,68,40,23,50,28,22,0,76,50,26,5,5,50,10,40
"2021","East Riding of Yorkshire 005D","E01012951",542,235,111,124,273,80,108,53,35,20,41,19,18,4,42,25,17,2,2,34,16,18
"2021","East Riding of Yorkshire 006A","E01012950",584,152,106,46,408,139,197,96,60,41,43,27,11,5,26,11,15,3,3,24,13,11
"2021","East Riding of Yorkshire 006B","E01012990",617,170,92,78,418,80,220,116,65,39,69,39,27,3,48,29,19,1,1,29,13,16
"2021","East Riding of Yorkshire 006C","E01012991",707,183,105,78,502,109,265,136,83,46,80,51,27,2,48,24,24,0,0,22,10,12
"2021","East Riding of Yorkshire 006D","E01012992",636,180,103,77,421,103,199,106,60,33,68,36,26,6,49,29,20,2,2,35,19,16
"2021","East Riding of Yorkshire 008A","E01012978",755,177,126,51,559,173,249,120,96,33,90,49,37,4,47,24,23,0,0,19,9,10
"2021","East Riding of Yorkshire 008B","E01012981",596,158,80,78,406,98,222,100,84,38,55,32,18,5,31,16,15,0,0,32,13,19
"2021","East Riding of Yorkshire 008C","E01012983",771,206,115,91,541,121,264,104,115,45,92,54,36,2,61,36,25,3,3,24,10,14
"2021","East Riding of Yorkshire 008D","E01012989",790,214,135,79,546,133,282,138,98,46,83,50,32,1,47,29,18,1,1,30,11,19
"2021","East Riding of Yorkshire 008E","E01013125",754,211,115,96,524,97,267,118,103,46,98,54,35,9,60,35,25,2,2,19,12,7
"2021","East Riding of Yorkshire 009A","E01013057",676,129,67,62,520,116,280,108,123,49,88,46,37,5,32,23,9,4,4,27,8,19
"2021","East Riding of Yorkshire 009B","E01013059",694,151,79,72,522,122,282,118,127,37,77,39,28,10,40,24,16,1,1,21,10,11
"2021","East Riding of Yorkshire 009C","E01013060",1024,256,154,102,739,161,376,161,157,58,134,96,35,3,66,45,21,2,2,29,7,22
"2021","East Riding of Yorkshire 009D","E01013061",707,206,132,74,477,131,220,83,87,50,81,44,36,1,43,29,14,2,2,24,12,12
"2021","East Riding of Yorkshire 009E","E01013126",753,149,69,80,574,85,339,146,141,52,102,60,38,4,47,30,17,1,1,30,9,21
"2021","East Riding of Yorkshire 010A","E01012986",713,203,127,76,475,156,212,116,59,37,51,27,23,1,52,29,23,4,4,35,10,25
"2021","East Riding of Yorkshire 010B","E01012987",746,166,102,64,552,121,317,159,98,60,71,44,23,4,41,19,22,2,2,28,15,13
"2021","East Riding of Yorkshire 010C","E01012988",686,183,93,90,482,103,254,122,92,40,83,41,34,8,40,24,16,2,2,21,11,10
"2021","East Riding of Yorkshire 010D","E01013048",990,243,129,114,708,174,354,177,127,50,104,61,36,7,73,40,33,3,3,39,13,26
"2021","East Riding of Yorkshire 011B","E01013053",812,226,158,68,557,175,248,127,82,39,85,44,37,4,49,30,19,0,0,29,11,18
"2021","East Riding of Yorkshire 011C","E01013054",877,305,145,160,543,86,271,102,123,46,112,73,35,4,73,49,24,1,1,29,12,17
"2021","East Riding of Yorkshire 011D","E01013055",819,245,107,138,554,107,225,109,84,32,129,82,44,3,89,47,42,4,4,20,7,13
"2021","East Riding of Yorkshire 011E","E01013056",839,415,171,244,397,57,173,69,71,33,88,57,29,2,68,45,23,11,11,27,12,15
"2021","East Riding of Yorkshire 011F","E01013058",663,210,118,92,427,109,212,105,71,36,65,37,27,1,41,23,18,0,0,26,9,17
"2021","East Riding of Yorkshire 011G","E01013119",633,174,81,93,435,76,264,112,106,46,61,43,16,2,33,22,11,1,1,24,9,15
"2021","East Riding of Yorkshire 011H","E01034754",545,145,83,62,392,73,191,84,74,33,71,38,33,0,55,35,20,2,2,8,3,5
"2021","East Riding of Yorkshire 011I","E01034755",664,121,42,79,521,60,259,106,113,40,130,68,58,4,72,61,11,0,0,22,10,12
"2021","East Riding of Yorkshire 012A","E01013046",771,242,173,69,500,196,212,98,61,53,44,23,18,3,47,27,20,1,1,29,10,19
"2021","East Riding of Yorkshire 012B","E01013047",708,253,148,105,423,122,191,94,57,40,57,29,21,7,52,32,20,1,1,32,10,22
"2021","East Riding of Yorkshire 012C","E01013049",793,305,187,118,445,116,191,91,68,32,63,33,26,4,72,39,33,3,3,43,12,31
"2021","East Riding of Yorkshire 012D","E01013050",758,207,142,65,517,153,234,125,76,33,70,37,31,2,59,33,26,1,1,34,12,22
"2021","East Riding of Yorkshire 012E","E01013051",681,180,93,87,457,85,179,79,63,37,92,34,51,7,99,65,34,2,2,44,24,20
"2021","East Riding of Yorkshire 013A","E01012922",672,174,87,87,473,117,224,120,69,35,85,57,26,2,47,30,17,0,0,25,12,13
"2021","East Riding of Yorkshire 013B","E01012923",609,144,58,86,445,65,270,100,126,44,65,36,21,8,44,26,18,1,1,20,12,8
"2021","East Riding of Yorkshire 013C","E01012925",542,114,61,53,415,89,238,105,102,31,47,26,20,1,37,17,20,4,4,13,6,7
"2021","East Riding of Yorkshire 013D","E01012927",647,150,103,47,479,135,266,128,88,50,48,25,18,5,30,15,15,0,0,18,9,9
"2021","East Riding of Yorkshire 014A","E01012924",713,152,89,63,529,149,268,105,123,40,62,34,23,5,49,31,18,1,1,32,12,20
"2021","East Riding of Yorkshire 014B","E01012926",1063,301,197,104,735,205,362,135,149,78,84,45,36,3,80,44,36,4,4,27,10,17
"2021","East Riding of Yorkshire 014C","E01013027",789,236,149,87,527,127,261,115,99,47,87,53,28,6,50,25,25,2,2,26,10,16
"2021","East Riding of Yorkshire 014D","E01013034",743,155,83,72,547,117,298,141,108,49,86,49,35,2,46,32,14,0,0,41,20,21
"2021","East Riding of Yorkshire 015A","E01013120",899,230,131,99,635,156,315,163,107,45,107,65,38,4,56,34,22,1,1,34,17,17
"2021","East Riding of Yorkshire 015B","E01013121",900,195,84,111,668,97,370,150,175,45,137,62,62,13,61,39,22,3,3,37,20,17
"2021","East Riding of Yorkshire 015C","E01013123",875,215,95,120,641,107,292,97,147,48,148,85,58,5,89,59,30,5,5,19,6,13
"2021","East Riding of Yorkshire 015D","E01013124",1091,429,228,201,631,142,263,93,123,47,118,54,56,8,103,76,27,5,5,31,9,22
"2021","East Riding of Yorkshire 016A","E01013064",519,91,33,58,421,56,272,105,120,47,50,26,21,3,43,23,20,0,0,7,0,7
"2021","East Riding of Yorkshire 016B","E01013065",736,219,131,88,504,110,242,122,79,41,77,41,29,7,71,37,34,4,4,13,4,9
"2021","East Riding of Yorkshire 016C","E01013066",696,195,137,58,485,118,252,100,114,38,60,29,29,2,55,35,20,0,0,16,8,8
"2021","East Riding of Yorkshire 016D","E01013067",693,174,90,84,500,107,274,108,124,42,78,43,30,5,41,26,15,0,0,19,6,13
"2021","East Riding of Yorkshire 016E","E01013068",997,260,155,105,717,180,376,138,187,51,98,48,40,10,63,43,20,0,0,20,10,10
"2021","East Riding of Yorkshire 016F","E01013070",689,237,152,85,423,115,213,107,83,23,56,27,26,3,38,17,21,1,1,29,8,21
"2021","East Riding of Yorkshire 017A","E01013038",616,202,87,115,381,32,141,54,63,24,76,16,51,9,127,92,35,5,5,33,16,17
"2021","East Riding of Yorkshire 017B","E01013045",684,229,84,145,438,35,164,57,79,28,94,38,46,10,142,100,42,3,3,17,5,12
"2021","East Riding of Yorkshire 017C","E01013069",697,211,101,110,463,78,193,76,78,39,104,59,41,4,82,47,35,6,6,23,8,15
"2021","East Riding of Yorkshire 017D","E01013071",797,412,198,214,364,51,148,49,61,38,64,35,28,1,96,58,38,5,5,21,6,15
"2021","East Riding of Yorkshire 018A","E01013022",824,161,85,76,636,118,374,180,136,58,95,53,40,2,48,28,20,1,1,27,13,14
"2021","East Riding of Yorkshire 018B","E01013023",783,171,103,68,569,127,327,159,109,59,74,46,26,2,39,15,24,2,2,43,17,26
"2021","East Riding of Yorkshire 018C","E01013024",802,208,123,85,567,102,264,123,100,41,121,60,49,12,79,49,30,1,1,27,13,14
"2021","East Riding of Yorkshire 018D","E01013122",610,116,57,59,466,103,276,133,101,42,50,27,21,2,33,14,19,4,4,28,14,14
"2021","East Riding of Yorkshire 018E","E01013127",649,141,88,53,475,110,272,113,122,37,57,26,27,4,35,19,16,1,1,33,22,11
"2021","East Riding of Yorkshire 019A","E01013036",796,396,168,228,390,73,142,72,43,27,94,51,35,8,80,47,33,1,1,10,3,7
"2021","East Riding of Yorkshire 019B","E01013037",673,249,66,183,412,59,183,73,81,29,102,70,31,1,63,38,25,5,5,12,5,7
"2021","East Riding of Yorkshire 019C","E01013040",1075,373,106,267,670,85,295,135,115,45,175,112,56,7,108,57,51,7,7,32,8,24
"2021","East Riding of Yorkshire 019D","E01013041",927,475,282,193,442,128,167,105,46,16,82,59,18,5,59,34,25,6,6,10,3,7
"2021","East Riding of Yorkshire 019E","E01013062",905,461,211,250,421,85,195,109,57,29,81,63,17,1,56,30,26,4,4,23,8,15
"2021","East Riding of Yorkshire 019F","E01013063",732,256,161,95,459,117,243,126,88,29,49,30,17,2,48,24,24,2,2,17,4,13
"2021","East Riding of Yorkshire 020A","E01012919",531,139,90,49,379,80,219,95,95,29,45,25,18,2,34,15,19,1,1,13,6,7
"2021","East Riding of Yorkshire 020B","E01012921",495,120,66,54,358,82,187,75,80,32,43,25,13,5,46,25,21,0,0,17,10,7
"2021","East Riding of Yorkshire 020C","E01013039",873,240,131,109,593,113,288,129,104,55,118,83,31,4,74,48,26,0,0,40,18,22
"2021","East Riding of Yorkshire 020D","E01013042",670,171,98,73,481,109,263,106,104,53,61,36,22,3,46,25,21,2,2,18,11,7
"2021","East Riding of Yorkshire 020E","E01013043",550,149,62,87,384,76,201,70,82,49,48,30,15,3,57,35,22,2,2,17,8,9
"2021","East Riding of Yorkshire 020F","E01013044",793,176,95,81,602,109,329,117,151,61,119,62,53,4,45,34,11,0,0,15,7,8
"2021","East Riding of Yorkshire 021A","E01013029",650,180,96,84,438,103,218,107,67,44,65,41,23,1,48,26,22,4,4,32,14,18
"2021","East Riding of Yorkshire 021B","E01013030",658,203,127,76,433,129,214,103,66,45,61,28,26,7,27,10,17,2,2,22,3,19
"2021","East Riding of Yorkshire 021C","E01013031",619,134,92,42,467,146,232,126,59,47,58,31,21,6,30,16,14,1,1,18,11,7
"2021","East Riding of Yorkshire 021D","E01013032",617,142,88,54,453,111,223,108,76,39,71,42,27,2,45,21,24,3,3,22,9,13
"2021","East Riding of Yorkshire 021E","E01013035",629,119,72,47,491,132,229,116,77,36,81,46,35,0,46,31,15,3,3,19,10,9
"2021","East Riding of Yorkshire 022A","E01012954",639,168,89,79,445,111,204,82,88,34,81,46,32,3,47,26,21,2,2,26,11,15
"2021","East Riding of Yorkshire 022B","E01012956",485,106,76,30,363,66,202,89,79,34,57,24,30,3,37,17,20,1,1,16,7,9
"2021","East Riding of Yorkshire 022C","E01012958",497,147,104,43,344,121,158,78,52,28,36,18,16,2,29,10,19,0,0,6,1,5
"2021","East Riding of Yorkshire 022D","E01012961",933,252,163,89,662,150,297,108,151,38,132,58,69,5,80,54,26,3,3,19,11,8
"2021","East Riding of Yorkshire 022E","E01012966",591,169,115,54,414,104,211,110,56,45,66,45,19,2,32,20,12,1,1,8,4,4
"2021","East Riding of Yorkshire 023A","E01012953",591,181,85,96,385,82,212,95,84,33,61,32,23,6,29,15,14,1,1,25,11,14
"2021","East Riding of Yorkshire 023B","E01012955",723,217,123,94,489,101,245,101,109,35,85,51,31,3,55,35,20,3,3,17,8,9
"2021","East Riding of Yorkshire 023C","E01012959",661,192,101,91,453,97,227,91,106,30,78,42,35,1,49,24,25,2,2,16,5,11
"2021","East Riding of Yorkshire 023D","E01012962",508,141,82,59,346,70,203,104,62,37,54,41,10,3,19,9,10,0,0,21,8,13
"2021","East Riding of Yorkshire 023E","E01012964",755,244,123,121,486,61,219,84,91,44,106,44,52,10,96,67,29,4,4,25,15,10
"2021","East Riding of Yorkshire 024C","E01012967",685,163,100,63,509,121,258,113,102,43,80,50,27,3,49,29,20,1,1,13,5,8
"2021","East Riding of Yorkshire 024D","E01012968",706,158,94,64,530,130,285,129,103,53,61,36,18,7,53,32,21,1,1,18,6,12
"2021","East Riding of Yorkshire 024E","E01012969",468,125,65,60,324,63,174,74,68,32,49,21,21,7,37,17,20,1,1,19,8,11
"2021","East Riding of Yorkshire 024F","E01034756",1062,254,144,110,783,158,460,206,181,73,100,51,45,4,63,39,24,2,2,25,10,15
"2021","East Riding of Yorkshire 025A","E01012957",773,410,240,170,350,80,157,70,63,24,69,43,22,4,39,22,17,5,5,13,5,8
"2021","East Riding of Yorkshire 025B","E01012960",732,250,136,114,465,128,237,103,105,29,67,33,27,7,32,13,19,1,1,17,10,7
"2021","East Riding of Yorkshire 025C","E01012963",743,383,189,194,345,81,136,56,56,24,62,27,28,7,66,36,30,0,0,15,6,9
"2021","East Riding of Yorkshire 025D","E01013112",642,188,163,25,442,150,203,88,74,41,47,23,20,4,42,17,25,0,0,12,6,6
"2021","East Riding of Yorkshire 026A","E01013018",821,238,130,108,550,86,274,105,120,49,104,51,50,3,81,43,38,5,5,33,18,15
"2021","East Riding of Yorkshire 026B","E01013019",490,124,65,59,347,59,194,90,72,32,65,32,27,6,29,17,12,0,0,19,6,13
"2021","East Riding of Yorkshire 026C","E01013021",650,174,102,72,446,110,217,122,64,31,86,47,32,7,30,17,13,3,3,30,13,17
"2021","East Riding of Yorkshire 026D","E01013025",613,183,122,61,413,86,231,96,101,34,50,27,19,4,44,24,20,2,2,17,10,7
"2021","East Riding of Yorkshire 026E","E01013026",716,192,96,96,498,81,266,120,101,45,100,46,47,7,48,29,19,3,3,26,12,14
"2021","East Riding of Yorkshire 027A","E01013105",624,185,96,89,430,62,199,69,83,47,92,46,36,10,76,49,27,1,1,9,3,6
"2021","East Riding of Yorkshire 027B","E01013110",667,212,126,86,442,74,247,78,130,39,74,44,25,5,45,24,21,2,2,13,5,8
"2021","East Riding of Yorkshire 027C","E01013111",642,198,102,96,438,100,246,103,97,46,50,26,16,8,42,31,11,0,0,6,4,2
"2021","East Riding of Yorkshire 027D","E01013115",643,199,96,103,437,84,220,89,78,53,69,38,29,2,62,43,19,2,2,7,3,4
"2021","East Riding of Yorkshire 027E","E01013117",600,134,85,49,453,119,240,84,108,48,65,33,28,4,28,17,11,1,1,13,4,9
"2021","East Riding of Yorkshire 028A","E01013108",697,167,106,61,510,129,275,115,110,50,71,44,23,4,30,16,14,5,5,20,8,12
"2021","East Riding of Yorkshire 028B","E01013113",696,259,161,98,423,113,217,89,95,33,53,36,15,2,40,25,15,0,0,14,8,6
"2021","East Riding of Yorkshire 028C","E01013114",631,132,103,29,489,162,262,100,108,54,36,22,11,3,27,15,12,2,2,10,4,6
"2021","East Riding of Yorkshire 028D","E01013116",736,141,84,57,572,123,332,113,173,46,60,26,30,4,57,38,19,0,0,23,8,15
"2021","East Riding of Yorkshire 028E","E01013118",647,168,118,50,467,142,229,78,109,42,61,28,26,7,34,18,16,1,1,12,9,3
"2021","East Riding of Yorkshire 029A","E01013094",573,133,80,53,422,118,195,81,73,41,48,20,24,4,59,35,24,2,2,18,11,7
"2021","East Riding of Yorkshire 029B","E01013095",671,251,126,125,400,98,184,82,61,41,67,34,30,3,51,32,19,0,0,20,5,15
"2021","East Riding of Yorkshire 029C","E01013096",771,219,120,99,533,91,266,91,125,50,108,40,52,16,68,39,29,0,0,19,7,12
"2021","East Riding of Yorkshire 029D","E01013097",655,254,120,134,391,90,172,92,38,42,71,36,33,2,57,37,20,1,1,10,6,4
"2021","East Riding of Yorkshire 029E","E01013102",689,232,131,101,437,114,199,106,55,38,68,44,15,9,56,35,21,0,0,20,7,13
"2021","East Riding of Yorkshire 031A","E01013028",664,143,81,62,489,105,276,125,104,47,76,44,26,6,32,18,14,0,0,32,18,14
"2021","East Riding of Yorkshire 031B","E01013078",632,172,92,80,428,100,239,124,70,45,56,36,18,2,31,26,5,2,2,32,12,20
"2021","East Riding of Yorkshire 031C","E01013081",672,172,88,84,477,97,241,114,80,47,90,52,33,5,46,27,19,3,3,23,12,11
"2021","East Riding of Yorkshire 031D","E01013082",739,199,132,67,507,128,219,124,49,46,92,36,47,9,66,42,24,2,2,33,19,14
"2021","East Riding of Yorkshire 031E","E01013085",735,194,121,73,512,111,252,111,82,59,88,36,47,5,55,30,25,6,6,29,14,15
"2021","East Riding of Yorkshire 032A","E01012970",784,173,84,89,587,133,326,130,154,42,69,44,22,3,55,34,21,4,4,24,13,11
"2021","East Riding of Yorkshire 032C","E01012972",625,139,99,40,466,97,263,98,120,45,72,31,36,5,34,14,20,0,0,20,9,11
"2021","East Riding of Yorkshire 032E","E01012974",679,200,127,73,464,86,229,88,95,46,80,37,40,3,69,46,23,0,0,15,7,8
"2021","East Riding of Yorkshire 032F","E01013092",1084,281,129,152,766,96,442,124,252,66,132,77,51,4,94,58,36,2,2,37,21,16
"2021","East Riding of Yorkshire 032G","E01033495",615,181,20,161,415,17,208,47,138,23,107,55,50,2,78,65,13,5,5,19,14,5
"2021","East Riding of Yorkshire 032H","E01033496",642,143,86,57,486,70,320,117,147,56,58,28,23,7,37,23,14,1,1,13,7,6
"2021","East Riding of Yorkshire 032I","E01034757",603,223,59,164,370,58,178,84,64,30,93,63,27,3,40,27,13,1,1,10,4,6
"2021","East Riding of Yorkshire 032J","E01034758",607,126,29,97,452,20,279,62,179,38,98,55,40,3,52,34,18,3,3,29,14,15
"2021","East Riding of Yorkshire 033A","E01013033",670,180,86,94,470,81,247,103,91,53,82,46,31,5,60,39,21,0,0,20,7,13
"2021","East Riding of Yorkshire 033B","E01013098",945,254,132,122,667,132,327,114,154,59,118,58,53,7,90,60,30,0,0,24,13,11
"2021","East Riding of Yorkshire 033C","E01013099",668,234,152,82,403,96,159,78,50,31,75,36,34,5,71,41,30,2,2,31,10,21
"2021","East Riding of Yorkshire 033D","E01013100",685,159,94,65,500,114,269,124,98,47,69,34,29,6,46,27,19,2,2,26,12,14
"2021","East Riding of Yorkshire 033E","E01013101",730,211,130,81,502,112,237,103,90,44,89,37,43,9,59,39,20,5,5,17,7,10
"2021","East Riding of Yorkshire 034A","E01013008",659,252,81,171,383,41,163,68,71,24,108,64,37,7,69,52,17,2,2,24,10,14
"2021","East Riding of Yorkshire 034B","E01013009",762,328,140,188,403,68,168,72,70,26,83,35,42,6,78,52,26,6,6,31,10,21
"2021","East Riding of Yorkshire 034C","E01013013",677,227,80,147,437,64,173,68,71,34,127,62,58,7,68,45,23,5,5,13,8,5
"2021","East Riding of Yorkshire 034D","E01013014",609,164,99,65,428,54,202,92,66,44,101,46,45,10,70,47,23,1,1,17,8,9
"2021","East Riding of Yorkshire 034E","E01013107",1033,402,233,169,600,72,232,84,115,33,148,72,69,7,142,92,50,6,6,31,17,14
"2021","East Riding of Yorkshire 035A","E01013088",741,141,107,34,580,166,326,94,176,56,50,20,24,6,37,17,20,1,1,20,4,16
"2021","East Riding of Yorkshire 035B","E01013089",724,199,103,96,500,122,249,98,102,49,73,38,32,3,55,39,16,1,1,25,8,17
"2021","East Riding of Yorkshire 035C","E01013090",594,133,90,43,433,86,241,73,115,53,56,26,27,3,47,31,16,3,3,28,13,15
"2021","East Riding of Yorkshire 035D","E01013091",659,191,124,67,451,108,234,83,110,41,56,28,26,2,52,26,26,1,1,17,9,8
"2021","East Riding of Yorkshire 035E","E01013093",676,150,91,59,508,164,279,94,149,36,34,20,13,1,31,19,12,0,0,18,13,5
"2021","East Riding of Yorkshire 036A","E01013005",758,171,76,95,557,106,297,113,133,51,105,67,35,3,49,35,14,0,0,30,16,14
"2021","East Riding of Yorkshire 036B","E01013007",654,197,95,102,429,82,185,73,81,31,95,52,34,9,67,34,33,0,0,28,10,18
"2021","East Riding of Yorkshire 036C","E01013011",678,200,103,97,452,57,237,88,102,47,79,51,25,3,76,53,23,3,3,26,12,14
"2021","East Riding of Yorkshire 036D","E01013012",708,133,62,71,553,87,325,123,150,52,97,56,38,3,42,31,11,2,2,22,10,12
"2021","East Riding of Yorkshire 037A","E01012996",722,189,109,80,503,99,271,118,109,44,88,44,37,7,43,27,16,2,2,30,17,13
"2021","East Riding of Yorkshire 037B","E01012998",946,212,121,91,692,120,335,125,142,68,152,75,69,8,80,47,33,5,5,42,20,22
"2021","East Riding of Yorkshire 037C","E01013015",817,269,115,154,522,85,276,115,108,53,99,70,24,5,58,37,21,4,4,26,12,14
"2021","East Riding of Yorkshire 037D","E01013016",772,174,110,64,570,140,317,144,120,53,80,46,30,4,31,15,16,2,2,28,11,17
"2021","East Riding of Yorkshire 038A","E01013003",664,226,157,69,421,89,188,91,68,29,80,44,36,0,63,44,19,1,1,17,4,13
"2021","East Riding of Yorkshire 038B","E01013017",850,299,146,153,534,89,272,109,115,48,109,65,39,5,60,38,22,4,4,17,8,9
"2021","East Riding of Yorkshire 038C","E01013020",786,165,74,91,587,101,336,156,121,59,90,45,41,4,56,38,18,4,4,34,13,21
"2021","East Riding of Yorkshire 038D","E01013076",654,170,75,95,456,74,249,115,79,55,76,41,27,8,55,30,25,2,2,28,11,17
"2021","East Riding of Yorkshire 039A","E01013079",693,192,115,77,463,142,223,115,67,41,68,34,27,7,29,14,15,1,1,38,22,16
"2021","East Riding of Yorkshire 039B","E01013080",617,210,97,113,378,66,133,66,35,32,76,31,42,3,99,60,39,4,4,29,8,21
"2021","East Riding of Yorkshire 039C","E01013083",623,228,86,142,364,56,139,70,38,31,84,42,40,2,81,53,28,4,4,31,13,18
"2021","East Riding of Yorkshire 039D","E01013084",634,239,143,96,371,93,123,61,36,26,64,27,29,8,87,57,30,4,4,24,9,15
"2021","East Riding of Yorkshire 039E","E01013086",662,231,149,82,411,90,196,92,74,30,78,35,37,6,46,27,19,1,1,20,9,11
"2021","East Riding of Yorkshire 039F","E01013087",562,126,77,49,402,82,218,113,64,41,61,35,22,4,38,20,18,3,3,34,15,19
"2021","East Riding of Yorkshire 040A","E01012993",636,181,127,54,434,121,193,86,66,41,65,22,37,6,54,25,29,1,1,21,15,6
"2021","East Riding of Yorkshire 040B","E01012997",904,331,113,218,493,34,192,90,75,27,129,80,46,3,122,92,30,16,16,80,37,43
"2021","East Riding of Yorkshire 040C","E01012999",712,224,44,180,405,12,138,68,49,21,128,57,60,11,113,88,25,14,14,83,26,57
"2021","East Riding of Yorkshire 040D","E01013001",782,236,122,114,503,97,199,76,83,40,101,41,56,4,101,57,44,5,5,43,22,21
"2021","East Riding of Yorkshire 040E","E01013074",702,189,95,94,484,107,240,103,97,40,86,54,26,6,51,30,21,0,0,29,7,22
"2021","East Riding of Yorkshire 041A","E01012994",812,249,149,100,527,80,237,86,92,59,102,41,54,7,106,65,41,2,2,36,20,16
"2021","East Riding of Yorkshire 041B","E01012995",792,230,99,131,517,51,207,67,89,51,115,46,60,9,135,98,37,9,9,45,30,15
"2021","East Riding of Yorkshire 041C","E01013000",1063,491,92,399,501,29,168,69,77,22,170,100,64,6,125,87,38,9,9,71,23,48
"2021","East Riding of Yorkshire 041D","E01013002",758,203,64,139,515,52,190,80,74,36,117,38,73,6,151,121,30,5,5,40,16,24
"2021","East Riding of Yorkshire 041E","E01013004",679,176,66,110,441,46,176,51,95,30,114,47,56,11,96,71,25,9,9,62,28,34
"2021","East Riding of Yorkshire 042A","E01013072",726,189,95,94,502,83,237,109,92,36,103,59,38,6,76,42,34,3,3,35,19,16
"2021","East Riding of Yorkshire 042B","E01013073",763,201,99,102,539,89,293,123,124,46,93,48,37,8,63,40,23,1,1,23,13,10
"2021","East Riding of Yorkshire 042C","E01013075",581,130,81,49,430,94,226,104,83,39,67,42,21,4,42,16,26,1,1,21,10,11
"2021","East Riding of Yorkshire 042D","E01013077",846,193,105,88,623,144,298,112,128,58,92,39,41,12,86,57,29,3,3,30,19,11
"2021","East Riding of Yorkshire 043A","E01013006",655,181,67,114,445,42,209,72,95,42,101,58,36,7,93,53,40,0,0,29,14,15
"2021","East Riding of Yorkshire 043B","E01013010",638,186,102,84,429,58,195,94,64,37,108,57,47,4,66,40,26,2,2,23,11,12
"2021","East Riding of Yorkshire 043C","E01013103",601,161,106,55,430,129,198,69,78,51,60,27,29,4,42,20,22,1,1,10,5,5
"2021","East Riding of Yorkshire 043D","E01013104",559,168,96,72,379,110,161,81,51,29,63,39,23,1,41,20,21,4,4,12,5,7
"2021","East Riding of Yorkshire 043E","E01013106",467,116,59,57,327,32,138,31,73,34,69,30,36,3,86,52,34,2,2,24,16,8
"2021","East Riding of Yorkshire 043F","E01032596",616,189,100,89,405,57,202,77,78,47,94,42,43,9,50,30,20,2,2,22,12,10
"2021","East Riding of Yorkshire 044A","E01012975",740,227,144,83,494,121,231,117,73,41,93,60,27,6,47,32,15,2,2,19,5,14
"2021","East Riding of Yorkshire 044C","E01012984",786,184,101,83,574,142,319,132,133,54,70,43,22,5,43,26,17,0,0,28,8,20
"2021","East Riding of Yorkshire 044D","E01012985",776,224,139,85,533,114,270,125,101,44,87,49,31,7,61,34,27,1,1,19,10,9
"2021","East Riding of Yorkshire 044E","E01034759",657,143,59,84,493,70,268,116,114,38,104,63,40,1,47,33,14,4,4,21,6,15
"2021","East Riding of Yorkshire 044F","E01034760",619,190,86,104,403,66,210,86,81,43,71,34,33,4,54,44,10,2,2,26,10,16
"2021","East Riding of Yorkshire 045A","E01012976",588,204,109,95,362,75,145,51,53,41,61,29,29,3,78,51,27,3,3,22,11,11
"2021","East Riding of Yorkshire 045B","E01012979",815,272,132,140,501,100,182,90,64,28,121,60,57,4,96,48,48,2,2,42,14,28
"2021","East Riding of Yorkshire 045C","E01012980",820,388,183,205,409,63,166,76,68,22,89,59,29,1,88,55,33,3,3,23,8,15
"2021","East Riding of Yorkshire 045D","E01012982",797,360,172,188,416,100,180,94,58,28,82,44,32,6,49,33,16,5,5,21,6,15
"2021","North East Lincolnshire 001A","E01013174",549,115,27,88,390,13,148,52,64,32,103,31,65,7,125,92,33,1,1,44,21,23
"2021","North East Lincolnshire 001B","E01013175",758,211,110,101,517,65,290,126,113,51,116,52,60,4,40,18,22,6,6,30,20,10
"2021","North East Lincolnshire 001C","E01013176",600,173,81,92,395,71,214,90,78,46,58,23,28,7,48,31,17,4,4,32,17,15
"2021","North East Lincolnshire 001D","E01013177",651,283,136,147,337,43,121,52,48,21,71,30,35,6,96,66,30,6,6,31,15,16
"2021","North East Lincolnshire 001E","E01013178",621,183,113,70,415,117,164,79,53,32,72,39,32,1,59,32,27,3,3,23,11,12
"2021","North East Lincolnshire 001F","E01013179",663,203,110,93,419,63,182,79,61,42,87,38,39,10,81,50,31,6,6,41,21,20
"2021","North East Lincolnshire 001G","E01013180",610,169,108,61,414,93,203,91,66,46,71,27,37,7,45,20,25,2,2,27,15,12
"2021","North East Lincolnshire 002A","E01013136",720,429,134,295,261,24,58,35,13,10,56,31,21,4,114,85,29,9,9,30,10,20
"2021","North East Lincolnshire 002D","E01013142",757,312,60,252,384,13,108,49,39,20,95,33,53,9,158,118,40,10,10,61,16,45
"2021","North East Lincolnshire 002E","E01035473",1117,595,199,396,477,28,144,61,51,32,113,46,61,6,179,143,36,13,13,45,28,17
"2021","North East Lincolnshire 003A","E01013218",586,199,51,148,343,22,138,68,48,22,89,50,37,2,85,60,25,9,9,44,17,27
"2021","North East Lincolnshire 003B","E01013219",686,241,74,167,414,29,150,66,59,25,101,53,39,9,124,88,36,10,10,31,14,17
"2021","North East Lincolnshire 003C","E01013220",743,275,87,188,427,24,135,70,51,14,116,57,52,7,145,109,36,7,7,41,18,23
"2021","North East Lincolnshire 003D","E01013221",947,541,163,378,364,23,94,41,35,18,102,61,38,3,133,106,27,12,12,42,18,24
"2021","North East Lincolnshire 003E","E01013222",697,265,80,185,381,22,123,47,60,16,113,51,52,10,115,77,38,8,8,51,19,32
"2021","North East Lincolnshire 004A","E01013144",786,445,148,297,320,33,103,46,31,26,80,34,39,7,103,72,31,1,1,21,13,8
"2021","North East Lincolnshire 004B","E01013145",502,101,57,44,373,100,182,90,47,45,56,22,31,3,35,18,17,0,0,28,15,13
"2021","North East Lincolnshire 004C","E01013146",701,175,70,105,497,64,240,104,103,33,112,56,49,7,79,55,24,2,2,29,13,16
"2021","North East Lincolnshire 004D","E01013148",578,148,71,77,401,96,221,104,67,50,47,21,20,6,34,16,18,3,3,29,14,15
"2021","North East Lincolnshire 005A","E01013195",602,212,75,137,366,23,145,62,48,35,100,32,60,8,96,81,15,2,2,24,5,19
"2021","North East Lincolnshire 005B","E01013196",549,189,58,131,325,19,113,45,49,19,81,36,43,2,108,89,19,4,4,35,18,17
"2021","North East Lincolnshire 005C","E01013201",644,219,64,155,376,25,115,43,50,22,98,34,55,9,130,105,25,8,8,49,25,24
"2021","North East Lincolnshire 005D","E01013202",599,167,55,112,387,24,139,57,55,27,98,43,48,7,117,89,28,9,9,45,20,25
"2021","North East Lincolnshire 005E","E01013203",689,276,57,219,376,16,109,49,40,20,101,38,58,5,139,106,33,11,11,37,16,21
"2021","North East Lincolnshire 006A","E01013138",603,234,54,180,334,11,76,36,27,13,85,39,41,5,150,113,37,12,12,35,9,26
"2021","North East Lincolnshire 006B","E01013140",574,166,43,123,367,18,117,41,51,25,91,37,51,3,133,99,34,8,8,41,15,26
"2021","North East Lincolnshire 006C","E01013141",622,184,59,125,397,20,135,46,59,30,94,34,53,7,141,109,32,7,7,41,18,23
"2021","North East Lincolnshire 006D","E01013143",570,161,60,101,375,21,124,50,46,28,105,35,62,8,120,91,29,5,5,34,13,21
"2021","North East Lincolnshire 007A","E01013173",582,170,92,78,398,78,208,103,69,36,62,31,31,0,48,31,17,2,2,14,6,8
"2021","North East Lincolnshire 007C","E01013224",857,222,113,109,605,104,319,132,136,51,105,48,49,8,73,49,24,4,4,30,16,14
"2021","North East Lincolnshire 007D","E01013226",620,158,94,64,440,95,242,103,80,59,63,28,31,4,40,23,17,0,0,22,13,9
"2021","North East Lincolnshire 007E","E01035474",623,147,80,67,455,127,237,104,96,37,58,21,33,4,30,26,4,3,3,21,8,13
"2021","North East Lincolnshire 007F","E01035475",640,106,44,62,509,49,315,105,159,51,94,40,46,8,50,37,13,1,1,25,15,10
"2021","North East Lincolnshire 008A","E01013187",790,485,188,297,272,62,92,45,29,18,55,32,21,2,59,35,24,4,4,33,10,23
"2021","North East Lincolnshire 008B","E01013188",687,193,96,97,456,66,217,98,71,48,106,51,46,9,61,35,26,6,6,38,20,18
"2021","North East Lincolnshire 008C","E01013231",698,246,93,153,418,43,143,63,43,37,113,41,65,7,116,82,34,3,3,34,17,17
"2021","North East Lincolnshire 008D","E01013233",598,176,64,112,389,38,165,72,49,44,93,29,57,7,89,63,26,4,4,33,12,21
"2021","North East Lincolnshire 009A","E01013147",579,163,78,85,386,55,130,55,46,29,84,33,46,5,115,85,30,2,2,30,10,20
"2021","North East Lincolnshire 009D","E01013234",657,259,135,124,385,57,158,71,61,26,113,64,43,6,51,34,17,6,6,13,4,9
"2021","North East Lincolnshire 009E","E01033414",1201,330,132,198,819,118,355,144,145,66,173,67,94,12,168,111,57,5,5,52,23,29
"2021","North East Lincolnshire 011A","E01013159",645,208,47,161,392,8,93,40,40,13,125,54,65,6,159,124,35,7,7,45,18,27
"2021","North East Lincolnshire 011B","E01013161",541,179,42,137,321,9,116,43,44,29,83,34,41,8,106,79,27,7,7,41,16,25
"2021","North East Lincolnshire 011C","E01013162",647,246,53,193,365,22,134,43,50,41,104,43,55,6,96,70,26,9,9,36,13,23
"2021","North East Lincolnshire 011D","E01013165",575,224,44,180,299,16,106,45,43,18,75,36,33,6,95,68,27,7,7,52,14,38
"2021","North East Lincolnshire 012A","E01013158",589,169,77,92,401,56,174,70,59,45,82,30,47,5,88,60,28,1,1,19,6,13
"2021","North East Lincolnshire 012B","E01013160",645,206,95,111,413,63,192,94,49,49,107,58,44,5,49,32,17,2,2,26,9,17
"2021","North East Lincolnshire 012C","E01013163",589,175,98,77,394,94,196,106,55,35,70,40,28,2,32,17,15,2,2,20,10,10
"2021","North East Lincolnshire 012D","E01013164",712,175,68,107,505,44,207,81,90,36,120,56,52,12,126,83,43,8,8,32,17,15
"2021","North East Lincolnshire 012E","E01013197",510,132,63,69,351,40,161,66,52,43,95,44,46,5,54,39,15,1,1,27,8,19
"2021","North East Lincolnshire 013A","E01013149",486,109,64,45,364,105,165,74,52,39,68,34,27,7,26,11,15,0,0,13,5,8
"2021","North East Lincolnshire 013B","E01013150",514,120,56,64,371,78,198,91,68,39,66,31,33,2,27,18,9,2,2,23,10,13
"2021","North East Lincolnshire 013C","E01013227",729,246,123,123,460,89,183,88,48,47,105,58,42,5,80,53,27,3,3,23,10,13
"2021","North East Lincolnshire 013D","E01013228",670,199,61,138,450,61,214,107,73,34,99,41,52,6,73,58,15,3,3,21,11,10
"2021","North East Lincolnshire 013E","E01013229",578,106,39,67,437,30,175,68,71,36,109,33,64,12,121,89,32,2,2,35,20,15
"2021","North East Lincolnshire 014A","E01013131",763,363,134,229,373,32,121,62,49,10,97,44,49,4,118,88,30,5,5,27,14,13
"2021","North East Lincolnshire 014B","E01013132",648,194,97,97,436,80,177,88,52,37,106,55,44,7,73,46,27,0,0,18,13,5
"2021","North East Lincolnshire 014C","E01013133",744,338,128,210,385,41,146,69,49,28,90,45,41,4,105,79,26,3,3,21,8,13
"2021","North East Lincolnshire 014D","E01013134",680,246,139,107,418,95,146,70,42,34,87,41,43,3,87,50,37,3,3,16,8,8
"2021","North East Lincolnshire 015A","E01013206",571,162,73,89,380,58,150,53,52,45,79,28,42,9,89,58,31,4,4,29,15,14
"2021","North East Lincolnshire 015B","E01013207",603,190,102,88,385,71,156,75,50,31,82,37,42,3,74,52,22,2,2,28,11,17
"2021","North East Lincolnshire 015C","E01013211",636,195,82,113,413,52,176,76,70,30,98,45,49,4,82,54,28,5,5,28,12,16
"2021","North East Lincolnshire 015D","E01013212",556,212,60,152,314,11,114,36,44,34,68,18,45,5,118,94,24,3,3,30,14,16
"2021","North East Lincolnshire 016A","E01013181",604,194,46,148,360,17,105,29,54,22,94,36,53,5,139,107,32,5,5,50,16,34
"2021","North East Lincolnshire 016B","E01013182",618,195,123,72,395,99,197,96,65,36,63,33,25,5,32,14,18,4,4,28,13,15
"2021","North East Lincolnshire 016C","E01013183",645,180,89,91,429,64,217,97,77,43,76,26,41,9,70,49,21,2,2,36,15,21
"2021","North East Lincolnshire 016D","E01013184",645,235,79,156,362,49,160,65,64,31,76,43,27,6,71,51,20,6,6,48,17,31
"2021","North East Lincolnshire 016E","E01013185",569,141,74,67,399,52,188,82,72,34,86,41,42,3,70,46,24,3,3,29,12,17
"2021","North East Lincolnshire 016F","E01013186",600,124,55,69,452,64,253,91,114,48,81,36,41,4,53,38,15,1,1,24,15,9
"2021","North East Lincolnshire 018A","E01013130",595,212,109,103,353,49,141,54,58,29,70,29,36,5,90,55,35,3,3,30,12,18
"2021","North East Lincolnshire 018B","E01013135",750,327,204,123,407,109,134,65,44,25,79,34,38,7,78,51,27,7,7,16,7,9
"2021","North East Lincolnshire 018C","E01013154",610,173,122,51,426,147,177,81,59,37,66,35,23,8,36,17,19,0,0,11,4,7
"2021","North East Lincolnshire 018D","E01013156",685,300,209,91,368,144,146,77,39,30,46,24,19,3,29,17,12,3,3,17,8,9
"2021","North East Lincolnshire 019A","E01013204",584,168,81,87,390,57,161,59,65,37,81,26,45,10,89,50,39,2,2,26,13,13
"2021","North East Lincolnshire 019B","E01013205",500,122,39,83,345,18,132,39,62,31,66,18,41,7,125,97,28,4,4,33,18,15
"2021","North East Lincolnshire 019C","E01013208",519,142,65,77,341,17,113,38,54,21,77,20,51,6,131,93,38,3,3,36,22,14
"2021","North East Lincolnshire 019D","E01013209",664,243,87,156,397,32,125,52,41,32,84,33,45,6,145,105,40,11,11,24,8,16
"2021","North East Lincolnshire 019E","E01013210",510,115,38,77,365,23,131,46,57,28,80,24,46,10,126,94,32,5,5,30,17,13
"2021","North East Lincolnshire 020A","E01013153",634,213,148,65,409,157,183,100,40,43,47,25,16,6,21,10,11,1,1,12,4,8
"2021","North East Lincolnshire 020B","E01013157",726,177,89,88,533,99,277,107,115,55,103,56,41,6,53,35,18,1,1,16,7,9
"2021","North East Lincolnshire 020D","E01013167",806,258,155,103,522,139,265,118,95,52,82,47,29,6,35,15,20,1,1,26,11,15
"2021","North East Lincolnshire 020F","E01035476",1177,391,271,120,750,210,359,181,103,75,97,58,33,6,83,44,39,1,1,36,12,24
"2021","North East Lincolnshire 021A","E01013189",711,216,141,75,473,120,222,91,96,35,71,37,26,8,59,36,23,1,1,22,12,10
"2021","North East Lincolnshire 021C","E01013191",656,161,109,52,487,111,251,113,87,51,82,46,32,4,42,20,22,1,1,8,0,8
"2021","North East Lincolnshire 021D","E01013192",702,326,144,182,352,43,136,49,64,23,96,38,50,8,75,48,27,2,2,24,11,13
"2021","North East Lincolnshire 021E","E01013194",675,224,155,69,437,125,200,85,66,49,68,35,27,6,43,26,17,1,1,14,8,6
"2021","North East Lincolnshire 021F","E01035477",761,181,97,84,550,96,288,118,128,42,108,52,51,5,56,39,17,2,2,30,16,14
"2021","North East Lincolnshire 021G","E01035478",766,149,17,132,585,8,308,79,202,27,160,87,65,8,108,93,15,1,1,32,24,8
"2021","North East Lincolnshire 022B","E01013170",662,190,127,63,457,105,217,109,69,39,68,35,27,6,64,41,23,3,3,15,6,9
"2021","North East Lincolnshire 022C","E01013171",698,114,61,53,558,73,334,106,156,72,102,47,50,5,45,23,22,4,4,26,9,17
"2021","North East Lincolnshire 022D","E01013172",691,226,152,74,444,130,210,88,68,54,59,38,14,7,45,25,20,0,0,21,10,11
"2021","North East Lincolnshire 022E","E01013193",722,214,141,73,487,144,222,113,67,42,74,43,26,5,46,25,21,1,1,21,6,15
"2021","North East Lincolnshire 022F","E01035479",596,161,108,53,420,130,196,85,75,36,55,27,22,6,36,18,18,3,3,15,7,8
"2021","North East Lincolnshire 022G","E01035480",655,148,38,110,489,46,233,67,132,34,111,54,53,4,99,81,18,0,0,18,8,10
"2021","North East Lincolnshire 023A","E01013213",604,279,178,101,311,73,114,52,39,23,62,33,23,6,57,36,21,5,5,14,4,10
"2021","North East Lincolnshire 023B","E01013214",664,183,122,61,458,142,215,120,62,33,64,33,25,6,35,20,15,2,2,23,11,12
"2021","North East Lincolnshire 023C","E01013215",684,158,104,54,506,124,275,119,98,58,66,32,29,5,41,25,16,0,0,20,12,8
"2021","North East Lincolnshire 023D","E01013216",499,95,51,44,391,78,221,94,89,38,56,27,27,2,36,19,17,0,0,13,4,9
"2021","North East Lincolnshire 023E","E01013217",629,171,103,68,443,107,225,104,83,38,60,37,21,2,49,28,21,2,2,15,9,6
"2021","North East Lincolnshire 023F","E01013225",455,110,52,58,329,70,184,76,71,37,46,23,17,6,26,7,19,3,3,16,5,11
"2021","North East Lincolnshire 024E","E01013128",605,228,87,141,340,39,112,51,42,19,73,34,34,5,110,83,27,6,6,37,13,24
"2021","North East Lincolnshire 024D","E01013129",684,332,83,249,308,28,106,46,39,21,78,46,25,7,94,70,24,2,2,44,15,29
"2021","North East Lincolnshire 024G","E01013151",509,110,79,31,390,110,214,89,84,41,47,25,21,1,19,9,10,0,0,9,4,5
"2021","North East Lincolnshire 024F","E01013152",659,212,147,65,436,109,226,84,100,42,68,27,34,7,31,19,12,2,2,11,5,6
"2021","North East Lincolnshire 024H","E01013155",601,177,108,69,418,131,190,81,81,28,67,41,23,3,28,21,7,2,2,6,4,2
"2021","North East Lincolnshire 024A","E01013198",626,208,74,134,385,53,153,62,53,38,93,52,35,6,84,58,26,2,2,33,17,16
"2021","North East Lincolnshire 024B","E01013199",484,191,41,150,263,25,92,41,38,13,70,42,20,8,69,50,19,7,7,30,8,22
"2021","North East Lincolnshire 024C","E01013200",501,116,54,62,369,54,178,89,63,26,89,31,51,7,48,32,16,0,0,16,6,10
"2021","North Lincolnshire 001A","E01013254",853,331,162,169,501,84,204,95,65,44,104,54,45,5,106,66,40,3,3,21,12,9
"2021","North Lincolnshire 001B","E01013255",1013,389,163,226,587,108,261,126,96,39,139,83,47,9,73,35,38,6,6,37,12,25
"2021","North Lincolnshire 001C","E01013256",1104,315,120,195,738,103,366,159,141,66,177,97,70,10,91,61,30,1,1,51,20,31
"2021","North Lincolnshire 001D","E01013257",849,231,116,115,593,151,289,131,105,53,94,61,28,5,57,32,25,2,2,25,8,17
"2021","North Lincolnshire 001E","E01013258",709,203,106,97,478,44,249,98,99,52,85,29,46,10,95,58,37,5,5,28,13,15
"2021","North Lincolnshire 001F","E01013259",836,191,97,94,613,97,258,119,98,41,134,56,67,11,120,89,31,4,4,32,16,16
"2021","North Lincolnshire 002A","E01013303",584,168,86,82,376,69,182,91,60,31,69,33,33,3,55,37,18,1,1,40,14,26
"2021","North Lincolnshire 002B","E01013304",683,169,93,76,486,97,272,127,94,51,74,36,30,8,42,25,17,1,1,28,17,11
"2021","North Lincolnshire 002C","E01013305",668,146,76,70,493,94,270,131,92,47,82,41,39,2,46,24,22,1,1,29,15,14
"2021","North Lincolnshire 002D","E01013307",796,226,121,105,554,113,284,131,106,47,92,49,37,6,64,39,25,1,1,16,6,10
"2021","North Lincolnshire 003A","E01013288",679,208,132,76,453,72,209,91,68,50,100,45,48,7,69,46,23,3,3,18,5,13
"2021","North Lincolnshire 003B","E01013291",626,183,99,84,413,44,158,57,64,37,97,34,59,4,109,79,30,5,5,30,12,18
"2021","North Lincolnshire 003C","E01013292",764,203,112,91,541,129,245,124,77,44,98,59,37,2,66,36,30,3,3,20,8,12
"2021","North Lincolnshire 003D","E01013294",683,169,85,84,478,115,267,121,96,50,66,40,21,5,26,15,11,4,4,36,16,20
"2021","North Lincolnshire 004A","E01013270",856,203,95,108,613,109,309,151,118,40,116,58,49,9,73,48,25,6,6,40,19,21
"2021","North Lincolnshire 004B","E01013306",687,169,86,83,484,77,261,131,90,40,82,44,32,6,63,34,29,1,1,34,18,16
"2021","North Lincolnshire 004C","E01013308",807,216,115,101,546,81,264,139,78,47,106,58,38,10,94,65,29,1,1,45,22,23
"2021","North Lincolnshire 004D","E01013309",710,187,102,85,492,84,257,126,95,36,90,46,38,6,56,28,28,5,5,31,16,15
"2021","North Lincolnshire 005A","E01013286",1191,524,289,235,640,150,220,120,66,34,130,68,56,6,136,88,48,4,4,27,13,14
"2021","North Lincolnshire 005B","E01013287",690,240,125,115,423,95,207,113,59,35,74,39,29,6,45,18,27,2,2,27,14,13
"2021","North Lincolnshire 005C","E01013289",712,236,94,142,445,62,234,109,89,36,91,51,33,7,55,27,28,3,3,31,12,19
"2021","North Lincolnshire 005D","E01013290",748,181,99,82,524,131,255,123,83,49,90,60,26,4,46,28,18,2,2,43,17,26
"2021","North Lincolnshire 005E","E01013293",669,194,143,51,464,114,237,113,74,50,66,34,32,0,46,25,21,1,1,11,4,7
"2021","North Lincolnshire 006A","E01013245",608,171,84,87,406,44,162,72,61,29,93,34,48,11,105,73,32,2,2,31,17,14
"2021","North Lincolnshire 006B","E01013246",645,160,71,89,450,77,247,126,79,42,75,37,29,9,47,30,17,4,4,35,17,18
"2021","North Lincolnshire 006C","E01013247",732,182,92,90,512,85,292,137,85,70,88,48,33,7,44,22,22,3,3,38,17,21
"2021","North Lincolnshire 006D","E01013248",790,231,119,112,530,126,259,107,104,48,82,37,40,5,62,33,29,1,1,29,12,17
"2021","North Lincolnshire 006E","E01013249",793,247,114,133,506,62,215,93,93,29,124,53,60,11,102,74,28,3,3,40,26,14
"2021","North Lincolnshire 007A","E01013297",1010,262,115,147,649,52,314,94,167,53,142,62,68,12,132,83,49,9,9,99,36,63
"2021","North Lincolnshire 007B","E01013300",614,167,46,121,322,9,136,41,73,22,89,40,43,6,62,41,21,26,26,125,55,70
"2021","North Lincolnshire 007C","E01013302",565,124,66,58,385,76,196,66,86,44,62,26,30,6,49,21,28,2,2,56,20,36
"2021","North Lincolnshire 007D","E01013331",822,394,120,274,376,36,140,61,59,20,101,64,34,3,79,53,26,20,20,52,19,33
"2021","North Lincolnshire 008A","E01013296",661,185,37,148,355,11,143,43,74,26,79,39,31,9,106,61,45,16,16,121,42,79
"2021","North Lincolnshire 008B","E01013298",568,108,32,76,398,27,185,44,103,38,84,17,56,11,98,59,39,4,4,62,35,27
"2021","North Lincolnshire 008C","E01013299",646,217,93,124,384,27,168,52,84,32,90,33,49,8,94,74,20,5,5,45,28,17
"2021","North Lincolnshire 008D","E01013330",824,327,75,252,411,21,159,46,90,23,115,72,37,6,98,68,30,18,18,86,37,49
"2021","North Lincolnshire 008E","E01013332",671,185,56,129,366,36,162,42,83,37,63,37,21,5,80,48,32,25,25,120,56,64
"2021","North Lincolnshire 009A","E01013295",606,160,103,57,428,104,183,78,64,41,72,40,28,4,65,41,24,4,4,18,11,7
"2021","North Lincolnshire 009B","E01013301",658,171,91,80,446,71,204,78,81,45,96,41,45,10,73,49,24,2,2,41,17,24
"2021","North Lincolnshire 009C","E01013333",605,140,59,81,409,42,236,73,122,41,65,24,36,5,60,36,24,6,6,56,24,32
"2021","North Lincolnshire 009D","E01013334",661,155,61,94,463,49,211,82,86,43,122,57,56,9,75,41,34,6,6,43,23,20
"2021","North Lincolnshire 010A","E01013310",620,172,74,98,396,50,162,63,66,33,86,36,43,7,97,67,30,1,1,52,24,28
"2021","North Lincolnshire 010B","E01013312",842,287,69,218,501,16,159,56,67,36,135,59,69,7,172,137,35,19,19,54,24,30
"2021","North Lincolnshire 010C","E01013313",672,207,92,115,428,57,199,70,77,52,93,42,42,9,73,52,21,6,6,37,12,25
"2021","North Lincolnshire 010D","E01013314",649,202,59,143,394,47,171,56,74,41,100,41,50,9,72,49,23,4,4,53,23,30
"2021","North Lincolnshire 011A","E01013267",523,133,71,62,380,79,216,106,69,41,60,38,19,3,25,15,10,0,0,10,6,4
"2021","North Lincolnshire 011B","E01013268",566,163,85,78,385,86,196,108,60,28,62,34,23,5,39,27,12,2,2,18,8,10
"2021","North Lincolnshire 011C","E01013269",748,183,107,76,540,115,293,125,112,56,88,46,37,5,44,28,16,0,0,25,12,13
"2021","North Lincolnshire 011D","E01013271",814,197,82,115,579,62,265,97,115,53,128,53,68,7,121,76,45,3,3,38,20,18
"2021","North Lincolnshire 011E","E01013272",865,402,212,190,415,94,164,90,50,24,94,49,35,10,57,34,23,6,6,48,17,31
"2021","North Lincolnshire 011F","E01013273",752,218,146,72,512,141,259,128,85,46,74,39,28,7,35,18,17,3,3,22,12,10
"2021","North Lincolnshire 012A","E01013279",725,324,112,212,377,35,122,55,47,20,87,36,45,6,128,94,34,5,5,24,9,15
"2021","North Lincolnshire 012B","E01013285",520,136,79,57,360,93,152,65,54,33,71,33,33,5,41,28,13,3,3,24,9,15
"2021","North Lincolnshire 012C","E01013316",582,125,76,49,427,101,215,86,86,43,73,29,39,5,35,18,17,3,3,30,13,17
"2021","North Lincolnshire 012D","E01013321",672,155,75,80,489,88,259,116,103,40,84,44,35,5,56,25,31,2,2,28,16,12
"2021","North Lincolnshire 013A","E01013274",833,244,100,144,561,90,290,131,101,58,121,62,48,11,59,30,29,1,1,28,11,17
"2021","North Lincolnshire 013B","E01013275",651,153,81,72,485,116,241,109,90,42,78,42,33,3,48,32,16,2,2,13,5,8
"2021","North Lincolnshire 013C","E01013276",746,239,129,110,479,101,201,94,71,36,96,42,48,6,74,47,27,7,7,28,13,15
"2021","North Lincolnshire 013D","E01013277",644,187,109,78,433,72,222,119,69,34,84,43,37,4,55,31,24,0,0,24,10,14
"2021","North Lincolnshire 014A","E01013315",777,384,197,187,368,55,144,66,57,21,82,38,40,4,80,52,28,7,7,25,7,18
"2021","North Lincolnshire 014B","E01013317",552,156,76,80,370,58,190,87,76,27,65,30,28,7,54,31,23,3,3,26,15,11
"2021","North Lincolnshire 014C","E01013318",608,181,87,94,394,45,187,67,74,46,95,43,41,11,63,36,27,4,4,33,12,21
"2021","North Lincolnshire 014D","E01013319",898,290,84,206,566,51,212,71,95,46,144,56,81,7,152,104,48,7,7,42,20,22
"2021","North Lincolnshire 015A","E01013238",773,301,101,200,436,44,167,69,59,39,111,49,56,6,106,77,29,8,8,36,12,24
"2021","North Lincolnshire 015C","E01013311",755,257,85,172,452,33,143,45,72,26,121,44,67,10,149,118,31,6,6,46,23,23
"2021","North Lincolnshire 015D","E01013320",597,204,93,111,377,53,175,68,76,31,81,40,34,7,65,31,34,3,3,16,6,10
"2021","North Lincolnshire 015E","E01035481",587,166,80,86,393,43,160,60,61,39,84,28,46,10,102,61,41,4,4,28,11,17
"2021","North Lincolnshire 015F","E01035482",509,133,19,114,357,8,160,42,104,14,125,65,58,2,63,46,17,1,1,19,9,10
"2021","North Lincolnshire 015G","E01035483",522,137,31,106,366,12,159,31,116,12,130,60,68,2,58,45,13,7,7,19,12,7
"2021","North Lincolnshire 016A","E01013278",657,218,61,157,403,21,111,39,58,14,109,36,63,10,156,119,37,6,6,36,22,14
"2021","North Lincolnshire 016B","E01013280",609,157,79,78,416,76,186,86,67,33,81,32,41,8,70,45,25,3,3,36,20,16
"2021","North Lincolnshire 016C","E01013281",520,116,60,56,360,30,136,51,69,16,90,33,48,9,103,73,30,1,1,44,23,21
"2021","North Lincolnshire 016D","E01013283",537,103,52,51,399,46,158,51,71,36,83,22,51,10,110,85,25,2,2,35,15,20
"2021","North Lincolnshire 017A","E01013236",736,257,149,108,452,81,184,86,57,41,113,42,66,5,74,53,21,0,0,27,11,16
"2021","North Lincolnshire 017B","E01013239",701,284,119,165,396,65,161,77,51,33,92,49,36,7,73,50,23,5,5,21,6,15
"2021","North Lincolnshire 017C","E01013282",652,194,90,104,422,36,189,68,86,35,104,41,55,8,89,55,34,4,4,36,18,18
"2021","North Lincolnshire 017D","E01013284",638,189,83,106,417,39,154,60,65,29,112,44,54,14,107,72,35,5,5,32,20,12
"2021","North Lincolnshire 018B","E01013237",640,177,90,87,413,28,170,45,92,33,80,22,51,7,134,87,47,1,1,50,26,24
"2021","North Lincolnshire 018C","E01013261",639,182,135,47,447,125,213,91,77,45,68,31,30,7,40,32,8,1,1,10,5,5
"2021","North Lincolnshire 018D","E01013262",599,179,124,55,406,144,187,81,70,36,44,18,23,3,31,15,16,0,0,14,10,4
"2021","North Lincolnshire 018E","E01013263",659,207,133,74,426,110,198,96,63,39,73,42,27,4,45,29,16,0,0,26,12,14
"2021","North Lincolnshire 018F","E01033296",594,167,92,75,400,69,187,67,86,34,86,36,43,7,55,34,21,3,3,27,16,11
"2021","North Lincolnshire 018G","E01033297",685,152,16,136,508,6,228,66,141,21,157,82,70,5,111,85,26,6,6,25,11,14
"2021","North Lincolnshire 019A","E01013260",660,189,122,67,447,132,198,98,57,43,83,36,36,11,31,14,17,3,3,24,7,17
"2021","North Lincolnshire 019B","E01013264",827,237,113,124,557,97,260,118,98,44,131,61,63,7,67,36,31,2,2,33,8,25
"2021","North Lincolnshire 019C","E01013265",739,218,152,66,501,130,245,118,79,48,81,41,31,9,42,29,13,3,3,20,8,12
"2021","North Lincolnshire 019D","E01013266",838,262,122,140,544,122,259,114,108,37,95,45,46,4,65,44,21,3,3,32,5,27
"2021","North Lincolnshire 020A","E01013241",745,294,179,115,427,121,211,100,62,49,55,30,24,1,37,23,14,3,3,24,11,13
"2021","North Lincolnshire 020B","E01013242",736,137,73,64,563,107,331,141,122,68,77,45,28,4,46,21,25,2,2,36,20,16
"2021","North Lincolnshire 020C","E01013243",934,197,93,104,700,126,369,159,151,59,110,53,52,5,94,55,39,1,1,37,17,20
"2021","North Lincolnshire 020D","E01013244",841,250,126,124,563,100,263,95,121,47,104,51,48,5,93,65,28,3,3,28,17,11
"2021","North Lincolnshire 021A","E01013324",616,142,84,58,447,98,250,110,86,54,64,42,17,5,34,16,18,1,1,27,7,20
"2021","North Lincolnshire 021B","E01013326",706,182,116,66,512,138,246,104,94,48,73,40,29,4,55,25,30,0,0,12,7,5
"2021","North Lincolnshire 021C","E01013327",689,260,166,94,414,146,182,74,66,42,52,33,17,2,33,19,14,1,1,15,4,11
"2021","North Lincolnshire 021D","E01013328",516,89,48,41,415,89,229,105,84,40,60,24,31,5,35,22,13,2,2,12,6,6
"2021","North Lincolnshire 022A","E01013322",915,234,124,110,647,110,340,145,137,58,124,69,50,5,73,54,19,0,0,34,16,18
"2021","North Lincolnshire 022B","E01013323",684,184,94,90,471,105,250,107,89,54,64,34,25,5,50,30,20,2,2,29,13,16
"2021","North Lincolnshire 022C","E01013325",649,168,107,61,461,129,227,112,68,47,67,33,32,2,37,11,26,1,1,20,5,15
"2021","North Lincolnshire 022D","E01013329",814,225,119,106,557,121,256,110,108,38,125,67,50,8,52,32,20,3,3,32,11,21
"2021","North Lincolnshire 023A","E01013250",723,167,105,62,518,123,250,125,82,43,90,46,31,13,55,26,29,0,0,38,16,22
"2021","North Lincolnshire 023B","E01013251",782,167,112,55,589,134,330,152,107,71,72,42,26,4,51,25,26,2,2,26,10,16
"2021","North Lincolnshire 023C","E01013252",685,152,91,61,504,132,268,116,97,55,72,42,29,1,30,21,9,2,2,29,18,11
"2021","North Lincolnshire 023D","E01013253",845,227,118,109,584,102,305,150,93,62,101,50,42,9,75,36,39,1,1,34,11,23
"2021","York 001A","E01013436",637,134,60,74,474,84,296,95,162,39,57,33,22,2,36,26,10,1,1,29,20,9
"2021","York 001B","E01013438",819,215,131,84,564,88,301,88,159,54,85,36,43,6,88,47,41,2,2,40,14,26
"2021","York 001C","E01013439",537,87,41,46,432,60,287,103,141,43,45,26,16,3,38,23,15,2,2,18,5,13
"2021","York 001D","E01013440",783,185,108,77,580,118,312,115,135,62,85,45,36,4,65,38,27,0,0,18,7,11
"2021","York 002A","E01013370",753,293,192,101,449,132,193,90,81,22,67,42,22,3,56,38,18,1,1,11,2,9
"2021","York 002B","E01013373",643,191,120,71,427,94,226,68,126,32,60,26,25,9,46,28,18,1,1,25,8,17
"2021","York 002C","E01013375",594,171,115,56,410,118,204,94,71,39,53,28,20,5,35,19,16,0,0,13,2,11
"2021","York 002D","E01013376",626,139,107,32,470,152,229,95,93,41,40,21,15,4,48,24,24,1,1,17,7,10
"2021","York 003A","E01013371",584,112,72,40,448,118,254,92,116,46,41,18,23,0,34,16,18,1,1,24,8,16
"2021","York 003B","E01013372",789,329,233,96,451,139,212,95,91,26,60,33,23,4,39,18,21,1,1,9,3,6
"2021","York 003C","E01013374",594,114,71,43,456,97,250,79,129,42,66,29,29,8,41,26,15,2,2,24,10,14
"2021","York 003D","E01013377",671,145,90,55,498,109,274,112,115,47,62,30,24,8,52,28,24,1,1,28,9,19
"2021","York 004A","E01013404",728,248,122,126,440,94,198,79,91,28,68,31,31,6,77,45,32,3,3,40,15,25
"2021","York 004B","E01013407",672,237,173,64,418,138,195,83,84,28,48,26,21,1,34,20,14,3,3,17,5,12
"2021","York 004C","E01013408",616,207,144,63,392,130,185,86,62,37,36,18,13,5,39,14,25,2,2,17,5,12
"2021","York 004D","E01013410",583,199,83,116,348,36,147,60,54,33,48,17,24,7,112,79,33,5,5,36,13,23
"2021","York 005A","E01013405",609,164,100,64,418,86,205,90,81,34,65,35,26,4,56,24,32,6,6,27,4,23
"2021","York 005B","E01013406",924,279,71,208,601,89,245,84,111,50,156,99,49,8,103,61,42,8,8,44,9,35
"2021","York 005C","E01013409",807,228,132,96,543,101,270,113,118,39,94,45,43,6,73,44,29,5,5,36,15,21
"2021","York 005D","E01013411",692,230,163,67,437,110,198,85,75,38,74,41,27,6,53,23,30,2,2,25,10,15
"2021","York 006A","E01013428",748,187,72,115,518,45,246,80,120,46,138,99,31,8,84,53,31,5,5,43,16,27
"2021","York 006B","E01013429",801,184,48,136,577,53,323,118,153,52,124,80,35,9,75,42,33,2,2,40,14,26
"2021","York 006C","E01013430",710,162,90,72,519,113,260,107,106,47,85,48,35,2,58,35,23,3,3,29,9,20
"2021","York 006D","E01013431",956,292,72,220,635,40,336,115,189,32,197,135,59,3,56,41,15,6,6,29,10,19
"2021","York 006E","E01013435",622,167,84,83,432,71,237,92,93,52,68,40,26,2,53,26,27,3,3,23,8,15
"2021","York 007A","E01013344",615,230,84,146,326,51,168,79,73,16,69,55,14,0,34,20,14,4,4,59,8,51
"2021","York 007B","E01013346",807,289,147,142,472,98,219,93,100,26,95,71,21,3,53,35,18,7,7,46,8,38
"2021","York 007C","E01013432",855,220,101,119,605,95,310,123,146,41,116,60,53,3,82,53,29,2,2,30,9,21
"2021","York 007D","E01013433",626,182,124,58,424,90,228,95,83,50,54,27,23,4,49,25,24,3,3,20,7,13
"2021","York 007E","E01013434",636,182,88,94,423,80,235,84,96,55,71,42,25,4,33,16,17,4,4,31,8,23
"2021","York 008A","E01013379",601,154,101,53,415,75,255,96,117,42,50,33,16,1,35,16,19,0,0,32,7,25
"2021","York 008B","E01013380",673,214,72,142,365,68,183,65,86,32,74,58,16,0,38,22,16,2,2,94,8,86
"2021","York 008C","E01013385",626,230,80,150,371,35,181,72,83,26,88,39,29,20,65,40,25,2,2,25,11,14
"2021","York 008D","E01013387",686,195,139,56,470,125,255,100,119,36,52,29,19,4,38,18,20,0,0,21,7,14
"2021","York 008E","E01013388",503,163,113,50,319,108,143,72,43,28,51,36,15,0,16,7,9,1,1,21,3,18
"2021","York 008F","E01013389",509,139,92,47,353,74,174,63,77,34,59,28,27,4,45,25,20,1,1,17,5,12
"2021","York 008G","E01013437",553,154,92,62,366,84,180,70,85,25,65,34,28,3,36,19,17,1,1,33,7,26
"2021","York 009A","E01013343",786,286,96,190,352,32,136,65,45,26,126,102,21,3,49,27,22,9,9,148,5,143
"2021","York 009B","E01013345",810,288,97,191,398,41,161,71,66,24,128,99,25,4,56,33,23,12,12,124,7,117
"2021","York 009C","E01013347",641,189,72,117,382,16,176,52,91,33,81,38,41,2,102,61,41,7,7,70,15,55
"2021","York 009D","E01013349",530,141,39,102,349,5,148,51,71,26,73,27,38,8,122,79,43,1,1,40,17,23
"2021","York 009E","E01013350",680,230,80,150,373,24,168,60,76,32,86,43,38,5,84,54,30,11,11,77,30,47
"2021","York 010A","E01013348",630,195,41,154,320,20,121,58,39,24,120,95,21,4,57,40,17,2,2,115,8,107
"2021","York 010B","E01013368",913,264,63,201,431,31,185,81,83,21,139,112,26,1,63,33,30,13,13,218,8,210
"2021","York 010C","E01013382",761,286,110,176,421,46,167,74,80,13,102,64,31,7,98,68,30,8,8,54,11,43
"2021","York 010D","E01013383",1064,395,106,289,508,41,175,70,81,24,177,133,42,2,105,70,35,10,10,161,18,143
"2021","York 010E","E01013386",767,279,79,200,430,19,187,61,91,35,103,57,36,10,116,85,31,5,5,58,16,42
"2021","York 011A","E01013421",542,117,70,47,403,94,221,87,99,35,61,33,24,4,26,14,12,1,1,22,8,14
"2021","York 011B","E01013422",678,154,91,63,502,88,286,94,147,45,82,42,33,7,44,32,12,2,2,22,8,14
"2021","York 011C","E01013426",729,183,139,44,518,161,259,93,125,41,58,28,26,4,39,27,12,1,1,28,8,20
"2021","York 011D","E01013427",597,146,110,36,439,124,255,79,141,35,32,17,11,4,28,14,14,0,0,12,2,10
"2021","York 012A","E01013335",637,164,87,77,431,42,188,62,89,37,93,33,51,9,99,59,40,9,9,42,13,29
"2021","York 012B","E01013336",661,191,104,87,439,82,225,86,89,50,73,35,32,6,55,35,20,4,4,31,8,23
"2021","York 012C","E01013337",757,237,95,142,492,74,254,107,113,34,92,55,33,4,66,36,30,6,6,28,8,20
"2021","York 012D","E01013338",925,227,104,123,649,64,342,108,177,57,130,80,42,8,106,73,33,7,7,49,22,27
"2021","York 012E","E01013339",642,147,92,55,471,84,251,89,125,37,80,52,25,3,55,29,26,1,1,24,8,16
"2021","York 012F","E01013392",666,159,71,88,469,69,247,81,124,42,100,59,32,9,49,28,21,4,4,38,10,28
"2021","York 013A","E01013366",917,493,109,384,334,36,149,94,39,16,98,79,17,2,39,26,13,12,12,90,5,85
"2021","York 013C","E01013369",928,455,154,301,387,63,144,82,51,11,114,94,18,2,58,40,18,8,8,86,3,83
"2021","York 013E","E01013416",763,327,69,258,381,21,137,58,59,20,113,91,20,2,102,75,27,8,8,55,9,46
"2021","York 013F","E01033067",846,417,64,353,354,18,102,62,33,7,135,103,30,2,88,63,25,11,11,75,4,71
"2021","York 013G","E01033068",660,353,71,282,246,41,73,48,14,11,108,103,4,1,12,7,5,12,12,61,3,58
"2021","York 013H","E01033069",607,319,105,214,249,23,87,47,37,3,99,87,10,2,34,21,13,6,6,39,5,34
"2021","York 013I","E01033070",969,569,91,478,321,28,98,70,22,6,156,149,6,1,27,10,17,12,12,79,2,77
"2021","York 014A","E01013381",638,142,68,74,443,48,233,68,121,44,98,50,44,4,60,38,22,4,4,53,11,42
"2021","York 014B","E01013402",636,145,101,44,365,101,191,81,71,39,47,37,10,0,25,10,15,1,1,126,13,113
"2021","York 014C","E01013419",1133,295,157,138,777,137,382,141,200,41,133,79,49,5,123,82,41,2,2,61,16,45
"2021","York 014D","E01013420",834,213,110,103,522,102,245,86,99,60,104,61,32,11,67,38,29,4,4,99,14,85
"2021","York 015A","E01013384",638,172,70,102,338,22,140,54,54,32,84,42,38,4,87,56,31,5,5,128,17,111
"2021","York 015B","E01013398",569,121,50,71,323,38,160,56,78,26,58,34,23,1,63,44,19,4,4,125,13,112
"2021","York 015C","E01013399",675,188,66,122,384,19,110,29,55,26,101,37,56,8,148,102,46,6,6,103,20,83
"2021","York 015D","E01013400",783,273,31,242,279,7,90,40,39,11,129,111,17,1,41,32,9,12,12,231,3,228
"2021","York 015E","E01013401",568,115,43,72,299,31,140,52,64,24,77,41,32,4,50,29,21,1,1,154,13,141
"2021","York 015F","E01013403",633,114,52,62,255,45,113,43,54,16,52,35,14,3,40,18,22,5,5,264,12,252
"2021","York 016A","E01013393",708,248,73,175,402,25,166,72,77,17,124,89,30,5,82,52,30,5,5,58,8,50
"2021","York 016B","E01013394",698,281,92,189,393,44,136,50,66,20,82,41,39,2,128,101,27,3,3,24,8,16
"2021","York 016C","E01013395",627,181,74,107,410,49,226,90,97,39,96,64,27,5,37,22,15,2,2,36,9,27
"2021","York 016D","E01013396",749,294,171,123,415,78,198,81,86,31,71,48,20,3,63,39,24,5,5,40,14,26
"2021","York 016E","E01013441",729,251,85,166,436,65,189,79,81,29,105,79,18,8,70,36,34,7,7,42,8,34
"2021","York 016F","E01013445",794,354,154,200,391,37,148,59,74,15,110,79,29,2,92,48,44,4,4,49,13,36
"2021","York 017A","E01013390",779,295,64,231,419,13,147,82,60,5,189,156,30,3,60,38,22,10,10,65,13,52
"2021","York 017B","E01013391",985,354,71,283,541,35,211,113,75,23,214,179,35,0,67,48,19,14,14,90,21,69
"2021","York 017C","E01013397",636,192,78,114,417,60,245,85,114,46,68,43,25,0,42,28,14,2,2,27,5,22
"2021","York 017D","E01013413",682,200,81,119,431,45,251,80,147,24,98,66,30,2,35,20,15,2,2,51,8,43
"2021","York 017E","E01013417",839,300,98,202,493,76,275,123,125,27,99,76,21,2,41,25,16,2,2,46,8,38
"2021","York 018A","E01013442",631,175,89,86,436,59,207,64,104,39,85,43,37,5,79,54,25,6,6,20,5,15
"2021","York 018B","E01013443",773,348,137,211,393,34,130,42,63,25,110,52,54,4,115,80,35,4,4,32,12,20
"2021","York 018C","E01013444",600,143,57,86,421,27,139,43,79,17,112,40,62,10,140,97,43,3,3,36,14,22
"2021","York 018D","E01013446",711,211,81,130,452,50,185,59,94,32,116,66,43,7,94,58,36,7,7,48,11,37
"2021","York 018E","E01013447",624,161,50,111,415,25,165,53,87,25,89,43,35,11,126,85,41,10,10,48,18,30
"2021","York 018F","E01013448",635,237,75,162,367,26,127,42,63,22,107,53,50,4,102,75,27,5,5,31,15,16
"2021","York 019A","E01013360",633,102,49,53,452,39,294,83,179,32,67,33,31,3,48,32,16,4,4,79,11,68
"2021","York 019B","E01013361",734,196,59,137,406,49,178,75,78,25,116,88,26,2,59,34,25,4,4,132,4,128
"2021","York 019C","E01013362",766,272,143,129,428,85,216,73,120,23,75,57,17,1,49,26,23,3,3,66,6,60
"2021","York 019D","E01013363",879,333,102,231,352,41,119,53,55,11,120,98,18,4,59,39,20,13,13,194,5,189
"2021","York 019E","E01013364",835,334,95,239,305,34,115,47,52,16,94,75,14,5,46,33,13,16,16,196,3,193
"2021","York 019F","E01013418",773,320,92,228,393,37,159,74,75,10,120,94,22,4,70,35,35,7,7,60,7,53
"2021","York 020A","E01013351",789,193,132,61,554,161,290,109,117,64,48,28,16,4,55,24,31,0,0,42,12,30
"2021","York 020B","E01013352",773,249,172,77,499,144,249,77,140,32,54,33,17,4,50,29,21,2,2,25,8,17
"2021","York 020C","E01013451",497,95,52,43,385,50,232,86,115,31,65,37,25,3,37,19,18,1,1,17,6,11
"2021","York 020D","E01013452",644,157,102,55,465,89,289,96,152,41,55,17,37,1,32,20,12,0,0,22,6,16
"2021","York 021A","E01013357",918,189,125,64,704,145,413,118,227,68,86,51,31,4,60,34,26,0,0,25,8,17
"2021","York 021B","E01013358",676,192,79,113,457,83,255,90,124,41,74,49,23,2,44,26,18,1,1,27,4,23
"2021","York 021C","E01013412",1118,420,105,315,611,54,237,113,109,15,229,191,32,6,82,58,24,9,9,87,8,79
"2021","York 021D","E01013414",801,287,103,184,458,52,230,100,107,23,113,82,28,3,56,33,23,7,7,56,10,46
"2021","York 022A","E01013353",718,273,106,167,409,39,202,71,102,29,93,54,36,3,71,46,25,4,4,36,8,28
"2021","York 022B","E01013354",601,158,83,75,428,98,213,95,78,40,82,54,23,5,32,12,20,3,3,15,5,10
"2021","York 022C","E01013355",881,291,150,141,559,165,212,89,92,31,113,78,28,7,64,31,33,5,5,31,9,22
"2021","York 022D","E01013356",653,210,116,94,428,109,220,104,76,40,55,30,20,5,44,24,20,0,0,15,7,8
"2021","York 022E","E01013359",660,191,82,109,429,42,197,60,107,30,114,54,51,9,75,54,21,1,1,40,10,30
"2021","York 022F","E01013449",697,183,93,90,485,71,235,92,105,38,96,51,40,5,80,53,27,3,3,29,11,18
"2021","York 023B","E01013378",443,153,73,80,233,42,142,52,70,20,25,20,4,1,24,15,9,0,0,57,2,55
"2021","York 023C","E01013450",505,108,62,46,374,81,222,84,93,45,40,18,18,4,28,20,8,3,3,23,11,12
"2021","York 023D","E01034761",677,148,87,61,494,84,250,65,135,50,87,45,39,3,73,45,28,0,0,35,14,21
"2021","York 023E","E01034762",584,201,100,101,346,67,174,67,83,24,57,45,12,0,45,33,12,3,3,37,11,26
"2021","York 024A","E01013340",515,105,68,37,392,85,235,79,127,29,43,18,21,4,29,15,14,0,0,18,6,12
"2021","York 024B","E01013341",614,214,163,51,386,101,187,62,95,30,54,27,23,4,43,28,15,1,1,14,3,11
"2021","York 024C","E01013342",689,178,106,72,491,176,228,108,88,32,47,26,18,3,40,18,22,0,0,20,8,12
"2021","York 024D","E01013423",557,135,113,22,413,123,236,76,124,36,29,11,16,2,23,15,8,2,2,9,2,7
"2021","York 024E","E01013424",510,79,50,29,406,91,244,82,113,49,39,27,8,4,32,16,16,0,0,25,3,22
"2021","York 024F","E01013425",689,194,129,65,474,101,232,89,115,28,79,49,27,3,58,38,20,4,4,21,9,12
"2021","Craven 001A","E01027558",887,262,148,114,586,164,307,165,95,47,76,45,23,8,36,18,18,3,3,39,12,27
"2021","Craven 001B","E01027559",813,306,155,151,482,80,235,102,92,41,107,58,43,6,56,36,20,4,4,25,9,16
"2021","Craven 001C","E01027569",608,163,108,55,420,110,234,103,76,55,48,32,10,6,27,11,16,1,1,25,10,15
"2021","Craven 001D","E01027570",1140,390,207,183,717,171,355,156,141,58,120,77,38,5,67,34,33,4,4,33,15,18
"2021","Craven 003A","E01027568",1006,289,173,116,689,155,355,153,134,68,107,51,50,6,71,41,30,1,1,28,15,13
"2021","Craven 003B","E01027571",811,208,125,83,583,159,298,156,77,65,75,44,27,4,50,28,22,1,1,20,10,10
"2021","Craven 003C","E01027572",1059,426,208,218,598,138,287,149,82,56,101,63,33,5,69,33,36,3,3,35,10,25
"2021","Craven 003D","E01027573",822,302,216,86,496,147,263,136,69,58,52,34,15,3,33,20,13,1,1,24,12,12
"2021","Craven 005A","E01027574",766,206,109,97,537,153,282,104,138,40,56,32,22,2,45,21,24,1,1,23,12,11
"2021","Craven 005B","E01027575",895,302,188,114,576,117,291,142,104,45,120,72,42,6,45,21,24,3,3,17,10,7
"2021","Craven 005C","E01027577",978,380,164,216,569,101,273,135,107,31,121,84,34,3,69,39,30,5,5,29,9,20
"2021","Craven 005D","E01027579",517,181,75,106,300,16,133,49,56,28,68,30,36,2,76,53,23,7,7,36,11,25
"2021","Craven 006A","E01027578",773,337,101,236,405,42,140,60,61,19,136,93,39,4,81,52,29,6,6,31,5,26
"2021","Craven 006B","E01027580",495,174,85,89,298,37,116,40,49,27,56,23,26,7,88,58,30,1,1,23,7,16
"2021","Craven 006D","E01027582",726,235,118,117,471,73,217,84,101,32,97,51,39,7,82,45,37,2,2,20,8,12
"2021","Craven 006E","E01034956",593,225,76,149,329,26,148,43,83,22,88,52,34,2,64,38,26,3,3,39,17,22
"2021","Craven 006F","E01034957",715,366,138,228,325,74,128,65,36,27,70,47,17,6,47,31,16,6,6,24,6,18
"2021","Craven 007A","E01027556",833,216,98,118,585,83,349,143,147,59,96,61,31,4,57,37,20,0,0,32,16,16
"2021","Craven 007B","E01027560",1041,270,105,165,741,108,379,157,174,48,140,70,62,8,107,61,46,7,7,30,13,17
"2021","Craven 007C","E01027563",722,277,171,106,434,109,216,109,70,37,65,41,22,2,43,24,19,1,1,11,5,6
"2021","Craven 007D","E01027586",878,267,121,146,592,128,312,139,124,49,108,62,41,5,44,23,21,0,0,19,9,10
"2021","Craven 008A","E01027555",852,233,138,95,595,154,290,134,115,41,99,62,31,6,49,26,23,3,3,24,8,16
"2021","Craven 008B","E01027564",581,255,124,131,306,51,134,52,62,20,72,39,29,4,46,26,20,3,3,20,8,12
"2021","Craven 008C","E01027565",676,177,114,63,487,112,251,89,107,55,65,29,29,7,58,39,19,1,1,12,7,5
"2021","Craven 008D","E01027566",586,147,70,77,424,98,209,77,101,31,71,34,35,2,46,29,17,0,0,15,11,4
"2021","Craven 008E","E01027583",839,228,130,98,587,136,285,97,136,52,83,37,42,4,82,57,25,1,1,24,10,14
"2021","Craven 008F","E01027584",860,273,127,146,566,106,283,105,125,53,105,57,44,4,71,48,23,1,1,21,10,11
"2021","Craven 009D","E01027557",666,161,81,80,472,103,264,113,95,56,74,43,22,9,29,19,10,2,2,33,11,22
"2021","Craven 009E","E01027561",848,247,144,103,586,139,324,125,161,38,74,47,24,3,47,28,19,2,2,15,6,9
"2021","Craven 009C","E01027562",676,156,81,75,488,119,277,153,68,56,59,44,11,4,29,15,14,4,4,32,12,20
"2021","Craven 009B","E01027567",760,301,190,111,429,116,205,104,72,29,61,41,17,3,43,19,24,4,4,30,8,22
"2021","Craven 009F","E01027576",795,215,147,68,567,170,307,117,143,47,49,28,21,0,41,23,18,0,0,13,5,8
"2021","Craven 009A","E01027585",837,258,160,98,553,198,265,144,75,46,60,35,22,3,29,15,14,1,1,26,11,15
"2021","Hambleton 001A","E01027591",744,200,112,88,514,156,265,115,99,51,57,37,17,3,36,19,17,0,0,30,9,21
"2021","Hambleton 001B","E01027597",709,208,143,65,486,128,263,118,83,62,62,32,23,7,31,15,16,2,2,15,6,9
"2021","Hambleton 001C","E01027599",792,328,157,171,437,87,187,73,75,39,67,31,32,4,92,62,30,4,4,27,12,15
"2021","Hambleton 001D","E01027623",575,202,141,61,356,111,172,75,62,35,41,24,13,4,31,17,14,1,1,17,6,11
"2021","Hambleton 001E","E01027625",851,342,185,157,495,85,207,84,73,50,80,42,28,10,119,83,36,4,4,14,5,9
"2021","Hambleton 002A","E01027598",841,281,204,77,552,222,228,112,79,37,64,36,20,8,37,23,14,1,1,8,1,7
"2021","Hambleton 002B","E01027618",1065,271,169,102,768,233,403,181,157,65,84,49,28,7,48,25,23,0,0,26,14,12
"2021","Hambleton 002C","E01027624",573,157,97,60,403,114,214,99,69,46,36,22,12,2,39,24,15,0,0,13,6,7
"2021","Hambleton 002D","E01027626",711,197,117,80,486,131,250,104,95,51,56,33,20,3,47,27,20,2,2,28,9,19
"2021","Hambleton 002E","E01027627",798,225,129,96,540,144,307,156,99,52,49,30,14,5,32,12,20,8,8,33,17,16
"2021","Hambleton 003A","E01027590",1158,385,149,236,748,123,363,161,152,50,148,92,49,7,111,64,47,3,3,25,10,15
"2021","Hambleton 003B","E01027592",763,198,119,79,536,151,288,132,86,70,59,32,24,3,35,15,20,3,3,29,15,14
"2021","Hambleton 003C","E01027613",755,214,104,110,507,102,286,126,105,55,77,44,25,8,38,18,20,4,4,34,14,20
"2021","Hambleton 003D","E01027617",457,110,56,54,338,83,189,91,61,37,43,26,14,3,22,12,10,1,1,9,4,5
"2021","Hambleton 005A","E01027603",879,197,105,92,636,151,348,183,109,56,89,46,38,5,42,25,17,6,6,46,18,28
"2021","Hambleton 005B","E01027604",825,205,117,88,581,144,304,142,110,52,77,45,29,3,55,33,22,1,1,39,15,24
"2021","Hambleton 005C","E01027607",552,142,103,39,404,145,206,109,60,37,28,14,12,2,25,10,15,0,0,6,4,2
"2021","Hambleton 005D","E01027614",572,176,126,50,375,120,198,92,76,30,32,16,14,2,25,12,13,0,0,21,8,13
"2021","Hambleton 005E","E01027615",513,109,66,43,392,107,216,87,89,40,36,20,15,1,30,12,18,3,3,12,1,11
"2021","Hambleton 006A","E01027587",621,230,157,73,374,83,168,57,66,45,67,42,20,5,55,31,24,1,1,17,8,9
"2021","Hambleton 006B","E01027588",785,282,127,155,476,77,239,106,99,34,88,53,32,3,71,50,21,1,1,27,5,22
"2021","Hambleton 006C","E01027589",909,282,138,144,598,97,350,145,135,70,79,44,29,6,71,51,20,1,1,29,17,12
"2021","Hambleton 006D","E01027593",787,213,124,89,548,146,294,142,99,53,69,46,15,8,35,17,18,4,4,26,7,19
"2021","Hambleton 007B","E01027628",815,198,111,87,592,124,321,167,99,55,105,62,36,7,41,26,15,1,1,25,12,13
"2021","Hambleton 007C","E01027633",784,191,106,85,561,142,305,139,115,51,73,44,24,5,40,24,16,1,1,32,13,19
"2021","Hambleton 007F","E01034958",932,194,86,108,703,103,440,169,212,59,109,66,39,4,49,30,19,2,2,35,15,20
"2021","Hambleton 008A","E01027620",886,316,168,148,542,89,260,112,108,40,115,72,38,5,72,60,12,6,6,28,10,18
"2021","Hambleton 008B","E01027630",935,415,152,263,471,86,203,89,69,45,117,83,30,4,60,35,25,5,5,49,11,38
"2021","Hambleton 008C","E01027631",706,271,150,121,419,110,206,100,66,40,72,54,15,3,30,15,15,1,1,16,4,12
"2021","Hambleton 008D","E01027632",692,140,81,59,522,84,282,119,114,49,96,53,40,3,60,41,19,0,0,30,12,18
"2021","Hambleton 008E","E01027637",836,230,141,89,574,138,320,163,103,54,69,44,21,4,44,20,24,3,3,32,8,24
"2021","Hambleton 009B","E01027629",649,207,120,87,408,60,161,62,64,35,93,35,44,14,91,57,34,3,3,34,8,26
"2021","Hambleton 009C","E01027635",1020,199,87,112,782,134,456,194,196,66,142,76,61,5,48,34,14,2,2,39,14,25
"2021","Hambleton 009D","E01027636",872,213,119,94,630,161,341,166,114,61,75,49,20,6,48,23,25,5,5,29,13,16
"2021","Hambleton 009E","E01034959",777,187,98,89,576,73,281,78,171,32,142,76,59,7,75,54,21,5,5,14,6,8
"2021","Hambleton 009F","E01034960",707,234,158,76,454,123,220,105,72,43,59,33,22,4,51,33,18,1,1,19,5,14
"2021","Hambleton 010A","E01027594",909,369,201,168,520,113,207,73,97,37,90,47,39,4,106,69,37,4,4,20,6,14
"2021","Hambleton 010B","E01027595",859,289,143,146,546,119,250,121,93,36,89,55,29,5,86,47,39,2,2,24,9,15
"2021","Hambleton 010C","E01027596",831,285,191,94,534,187,228,116,67,45,68,45,22,1,48,31,17,3,3,12,1,11
"2021","Hambleton 010D","E01027601",843,189,97,92,615,128,329,128,146,55,99,44,47,8,55,29,26,4,4,39,14,25
"2021","Hambleton 010E","E01027622",857,220,119,101,604,185,298,134,110,54,67,40,23,4,48,25,23,6,6,33,10,23
"2021","Hambleton 011A","E01027600",803,187,86,101,586,115,325,140,128,57,104,68,27,9,42,22,20,0,0,30,15,15
"2021","Hambleton 011B","E01027619",895,188,79,109,670,115,365,130,172,63,112,80,26,6,75,44,31,3,3,37,16,21
"2021","Hambleton 011C","E01027634",831,167,89,78,629,106,386,156,159,71,77,46,27,4,57,36,21,3,3,35,12,23
"2021","Hambleton 012E","E01027606",688,222,142,80,452,127,235,113,82,40,44,30,12,2,42,21,21,4,4,14,2,12
"2021","Hambleton 012D","E01027609",549,150,31,119,376,17,161,60,68,33,71,27,43,1,123,97,26,4,4,23,9,14
"2021","Hambleton 012C","E01027610",749,260,130,130,465,88,214,89,75,50,81,42,32,7,79,56,23,3,3,24,9,15
"2021","Hambleton 012A","E01034961",692,189,114,75,482,146,218,113,76,29,76,44,32,0,40,20,20,2,2,21,7,14
"2021","Hambleton 012B","E01034962",544,210,133,77,311,59,148,62,67,19,61,30,27,4,40,31,9,3,3,23,8,15
"2021","Hambleton 013D","E01027605",750,336,131,205,396,44,197,87,79,31,98,63,30,5,51,27,24,6,6,18,8,10
"2021","Hambleton 013B","E01027608",765,277,106,171,449,52,183,72,78,33,99,52,43,4,110,81,29,5,5,39,16,23
"2021","Hambleton 013A","E01027612",737,251,141,110,455,63,176,75,62,39,88,36,45,7,125,81,44,3,3,31,10,21
"2021","Hambleton 013C","E01027616",677,249,132,117,406,72,195,83,79,33,62,31,29,2,74,52,22,3,3,22,7,15
"2021","Harrogate 001A","E01027666",747,180,104,76,530,143,292,129,120,43,47,25,17,5,47,26,21,1,1,37,26,11
"2021","Harrogate 001B","E01027667",600,125,59,66,450,93,265,111,105,49,51,27,21,3,39,22,17,2,2,25,7,18
"2021","Harrogate 001C","E01027685",570,225,134,91,327,92,137,63,52,22,42,23,15,4,51,28,23,5,5,18,7,11
"2021","Harrogate 001D","E01027686",462,105,57,48,334,74,218,95,89,34,29,19,9,1,13,7,6,0,0,23,9,14
"2021","Harrogate 002A","E01027712",596,107,49,58,462,76,251,88,128,35,58,27,28,3,74,55,19,3,3,27,13,14
"2021","Harrogate 002B","E01027713",799,332,150,182,447,107,227,88,101,38,49,32,12,5,60,30,30,4,4,20,3,17
"2021","Harrogate 002C","E01027714",775,300,178,122,450,118,208,98,80,30,56,36,15,5,66,43,23,2,2,25,7,18
"2021","Harrogate 002D","E01027715",423,85,40,45,328,45,200,52,133,15,51,31,20,0,31,22,9,1,1,10,6,4
"2021","Harrogate 003A","E01027643",703,223,119,104,458,120,207,90,84,33,71,40,29,2,55,31,24,5,5,22,7,15
"2021","Harrogate 003B","E01027688",706,177,104,73,514,142,274,127,113,34,52,32,20,0,42,25,17,4,4,15,7,8
"2021","Harrogate 003C","E01027736",710,160,70,90,538,105,308,140,125,43,76,45,20,11,48,26,22,1,1,12,6,6
"2021","Harrogate 003D","E01027737",648,113,46,67,511,63,313,101,178,34,95,57,34,4,38,26,12,2,2,24,10,14
"2021","Harrogate 004A","E01027705",778,256,95,161,490,75,244,97,109,38,90,44,43,3,80,53,27,1,1,32,11,21
"2021","Harrogate 004B","E01027706",957,475,233,242,457,87,181,83,68,30,93,61,29,3,89,60,29,7,7,25,6,19
"2021","Harrogate 004C","E01027707",810,255,130,125,531,103,248,107,98,43,90,57,26,7,88,50,38,2,2,24,12,12
"2021","Harrogate 004D","E01027708",592,167,105,62,412,124,198,91,73,34,46,22,21,3,43,28,15,1,1,13,6,7
"2021","Harrogate 004E","E01027709",548,138,102,36,404,101,210,93,69,48,47,26,16,5,46,31,15,0,0,6,3,3
"2021","Harrogate 004F","E01027710",499,182,94,88,302,53,129,44,55,30,46,15,30,1,71,49,22,3,3,15,5,10
"2021","Harrogate 004G","E01027711",513,123,68,55,359,29,172,63,65,44,66,24,34,8,91,51,40,1,1,31,16,15
"2021","Harrogate 005A","E01027644",667,204,122,82,445,95,218,99,86,33,75,45,25,5,55,29,26,2,2,18,4,14
"2021","Harrogate 005B","E01027645",855,265,105,160,558,99,290,128,123,39,98,58,36,4,70,43,27,1,1,32,9,23
"2021","Harrogate 005C","E01027647",787,171,92,79,581,149,330,161,118,51,67,44,22,1,34,15,19,1,1,35,12,23
"2021","Harrogate 005D","E01027687",833,185,101,84,617,115,328,148,130,50,112,66,40,6,61,42,19,1,1,31,8,23
"2021","Harrogate 006A","E01027681",713,188,94,94,498,109,285,107,119,59,63,38,22,3,39,21,18,2,2,27,9,18
"2021","Harrogate 006B","E01027693",774,210,126,84,526,120,308,152,107,49,72,39,29,4,19,6,13,7,7,38,22,16
"2021","Harrogate 006C","E01027701",675,163,78,85,484,128,239,112,94,33,73,41,26,6,43,23,20,1,1,28,9,19
"2021","Harrogate 006D","E01027702",515,193,114,79,297,76,122,55,46,21,54,32,18,4,45,30,15,0,0,25,4,21
"2021","Harrogate 007A","E01027642",638,147,83,64,482,137,266,121,103,42,41,25,13,3,37,24,13,1,1,9,5,4
"2021","Harrogate 007B","E01027646",701,163,95,68,515,121,307,128,135,44,55,32,19,4,31,15,16,1,1,23,10,13
"2021","Harrogate 007C","E01027674",545,140,92,48,394,89,254,101,98,55,35,19,13,3,16,7,9,0,0,11,6,5
"2021","Harrogate 007D","E01027675",1177,233,125,108,900,144,510,182,257,71,128,53,70,5,114,74,40,4,4,44,21,23
"2021","Harrogate 008A","E01027641",474,77,44,33,379,57,256,90,114,52,43,28,14,1,23,10,13,0,0,18,11,7
"2021","Harrogate 008C","E01027665",552,136,79,57,398,79,216,84,97,35,65,38,25,2,37,27,10,1,1,18,6,12
"2021","Harrogate 008D","E01027722",596,127,48,79,449,35,286,108,135,43,81,48,31,2,43,26,17,4,4,20,5,15
"2021","Harrogate 008E","E01034963",566,154,88,66,399,91,209,75,112,22,53,29,20,4,45,32,13,1,1,13,4,9
"2021","Harrogate 008F","E01034964",587,156,81,75,417,58,228,72,136,20,70,30,39,1,59,50,9,2,2,14,7,7
"2021","Harrogate 009A","E01027668",709,222,118,104,469,85,200,68,91,41,73,32,35,6,108,68,40,3,3,18,6,12
"2021","Harrogate 009B","E01027669",962,427,253,174,502,99,214,82,95,37,99,65,30,4,85,51,34,5,5,33,8,25
"2021","Harrogate 009C","E01027673",957,432,194,238,507,104,212,106,67,39,93,70,21,2,91,57,34,7,7,18,4,14
"2021","Harrogate 009D","E01027676",700,178,87,91,482,41,221,50,125,46,84,39,38,7,132,82,50,4,4,40,15,25
"2021","Harrogate 010A","E01027638",599,171,106,65,401,85,205,97,80,28,70,42,23,5,39,19,20,2,2,27,9,18
"2021","Harrogate 010B","E01027639",571,177,112,65,380,85,191,86,67,38,60,40,17,3,42,17,25,2,2,14,6,8
"2021","Harrogate 010C","E01027640",651,185,101,84,445,72,210,82,98,30,78,44,29,5,80,44,36,5,5,21,9,12
"2021","Harrogate 010D","E01027690",636,176,87,89,441,89,205,102,71,32,86,47,35,4,59,30,29,2,2,19,7,12
"2021","Harrogate 010E","E01027738",580,183,61,122,369,36,169,68,73,28,83,53,27,3,79,49,30,2,2,28,10,18
"2021","Harrogate 010F","E01027739",467,147,42,105,292,24,129,44,71,14,80,49,29,2,56,34,22,3,3,28,4,24
"2021","Harrogate 010G","E01027741",623,194,120,74,406,86,192,72,94,26,58,25,27,6,65,37,28,5,5,23,5,18
"2021","Harrogate 011A","E01027689",647,250,81,169,372,29,168,71,78,19,92,56,35,1,78,50,28,5,5,25,7,18
"2021","Harrogate 011B","E01027691",678,201,70,131,452,59,215,83,101,31,108,62,41,5,69,42,27,1,1,25,10,15
"2021","Harrogate 011C","E01027720",827,268,109,159,531,53,247,88,134,25,112,54,54,4,114,93,21,5,5,28,15,13
"2021","Harrogate 011D","E01027721",656,226,106,120,415,54,231,84,116,31,86,52,30,4,40,23,17,4,4,15,4,11
"2021","Harrogate 011E","E01027723",732,309,90,219,396,48,151,55,66,30,76,43,32,1,118,87,31,3,3,27,12,15
"2021","Harrogate 012A","E01027670",665,167,98,69,476,90,274,119,104,51,63,38,22,3,47,29,18,2,2,22,12,10
"2021","Harrogate 012B","E01027671",636,143,105,38,473,116,286,110,126,50,43,20,17,6,25,11,14,3,3,20,6,14
"2021","Harrogate 012C","E01027672",685,168,115,53,496,133,264,101,115,48,59,33,22,4,39,15,24,1,1,21,8,13
"2021","Harrogate 012D","E01027704",534,129,83,46,386,99,228,97,98,33,33,22,10,1,25,17,8,1,1,19,8,11
"2021","Harrogate 013A","E01027649",873,241,80,161,582,55,272,95,140,37,134,83,45,6,116,74,42,5,5,50,15,35
"2021","Harrogate 013B","E01027651",605,199,91,108,363,34,154,46,78,30,61,21,32,8,108,70,38,6,6,43,21,22
"2021","Harrogate 013C","E01027657",597,246,43,203,325,11,128,56,57,15,110,77,30,3,68,43,25,8,8,26,2,24
"2021","Harrogate 013D","E01027658",774,305,86,219,435,52,176,75,78,23,132,106,24,2,70,49,21,5,5,34,11,23
"2021","Harrogate 013E","E01027692",559,236,84,152,296,29,147,54,71,22,66,48,13,5,50,33,17,4,4,27,6,21
"2021","Harrogate 013F","E01027740",944,584,280,304,335,59,136,60,56,20,53,34,16,3,79,33,46,8,8,25,5,20
"2021","Harrogate 014A","E01027648",676,235,111,124,402,60,209,74,96,39,66,34,27,5,64,37,27,3,3,39,17,22
"2021","Harrogate 014B","E01027650",648,152,86,66,460,71,252,88,115,49,64,27,31,6,69,40,29,4,4,36,15,21
"2021","Harrogate 014C","E01027726",760,263,96,167,469,51,214,79,96,39,110,68,36,6,89,54,35,5,5,28,7,21
"2021","Harrogate 014D","E01027727",803,273,147,126,498,60,248,103,101,44,116,72,32,12,72,42,30,2,2,32,8,24
"2021","Harrogate 014E","E01027728",615,195,124,71,396,92,174,74,70,30,74,39,32,3,51,25,26,5,5,24,10,14
"2021","Harrogate 014F","E01027729",667,214,73,141,406,12,166,64,76,26,97,57,35,5,122,88,34,9,9,47,13,34
"2021","Harrogate 015A","E01027652",764,278,101,177,464,74,246,77,136,33,72,59,8,5,67,47,20,5,5,22,5,17
"2021","Harrogate 015B","E01027655",572,215,119,96,345,97,198,92,83,23,35,23,10,2,14,9,5,1,1,12,1,11
"2021","Harrogate 015C","E01027659",966,501,92,409,409,33,169,79,69,21,139,119,19,1,53,30,23,15,15,56,15,41
"2021","Harrogate 015D","E01027677",753,348,102,246,363,66,151,78,57,16,103,84,16,3,39,25,14,4,4,42,9,33
"2021","Harrogate 015E","E01027678",1019,533,89,444,415,25,143,74,52,17,164,133,24,7,62,38,24,21,21,71,8,63
"2021","Harrogate 015F","E01027680",766,436,138,298,292,35,142,68,63,11,80,59,18,3,31,20,11,4,4,38,7,31
"2021","Harrogate 016A","E01027683",734,142,71,71,570,89,294,116,131,47,121,70,41,10,66,45,21,0,0,22,7,15
"2021","Harrogate 016B","E01027684",583,106,48,58,457,93,267,106,121,40,58,39,19,0,38,20,18,1,1,20,8,12
"2021","Harrogate 016C","E01027695",711,166,78,88,527,107,296,116,138,42,73,41,27,5,50,29,21,1,1,18,5,13
"2021","Harrogate 016D","E01027696",669,122,59,63,519,85,304,109,142,53,80,53,26,1,46,30,16,4,4,28,20,8
"2021","Harrogate 016E","E01027703",836,192,83,109,611,115,347,155,137,55,94,69,20,5,50,32,18,5,5,33,15,18
"2021","Harrogate 017A","E01027660",635,175,117,58,443,119,236,67,124,45,34,15,16,3,51,27,24,3,3,17,10,7
"2021","Harrogate 017B","E01027661",618,168,99,69,434,74,217,83,108,26,65,37,24,4,76,44,32,2,2,16,4,12
"2021","Harrogate 017C","E01027662",451,84,51,33,356,61,239,62,140,37,26,14,9,3,30,16,14,0,0,11,4,7
"2021","Harrogate 017D","E01027663",625,187,100,87,413,73,197,88,82,27,83,56,26,1,58,21,37,2,2,25,5,20
"2021","Harrogate 017E","E01027697",585,132,73,59,438,73,263,83,150,30,51,24,25,2,51,27,24,0,0,15,4,11
"2021","Harrogate 017F","E01027733",514,105,68,37,398,88,250,72,145,33,28,15,13,0,31,16,15,1,1,11,1,10
"2021","Harrogate 018A","E01027682",708,166,92,74,514,140,283,113,121,49,52,29,22,1,35,17,18,4,4,28,11,17
"2021","Harrogate 018B","E01027694",492,104,67,37,377,75,220,92,89,39,46,29,14,3,35,19,16,1,1,11,7,4
"2021","Harrogate 018C","E01027734",711,161,76,85,524,113,310,129,129,52,65,39,21,5,34,24,10,2,2,26,12,14
"2021","Harrogate 018D","E01027735",689,162,87,75,504,121,290,126,99,65,64,40,20,4,26,11,15,3,3,23,6,17
"2021","Harrogate 019A","E01027656",972,470,224,246,470,142,189,94,65,30,91,70,18,3,44,18,26,4,4,32,3,29
"2021","Harrogate 019B","E01027679",787,348,180,168,418,94,202,86,93,23,66,54,10,2,54,35,19,2,2,21,2,19
"2021","Harrogate 019C","E01027730",695,250,108,142,429,75,238,76,124,38,69,51,16,2,47,24,23,0,0,16,5,11
"2021","Harrogate 019D","E01027731",638,227,101,126,396,44,228,69,134,25,65,41,22,2,56,32,24,3,3,15,4,11
"2021","Harrogate 019E","E01027732",544,191,86,105,339,74,211,77,104,30,22,14,8,0,32,20,12,0,0,14,6,8
"2021","Harrogate 020A","E01027653",781,281,164,117,471,104,208,50,128,30,65,35,27,3,90,61,29,4,4,29,8,21
"2021","Harrogate 020B","E01027654",477,111,50,61,356,81,209,89,97,23,40,24,13,3,26,12,14,0,0,10,2,8
"2021","Harrogate 020C","E01027698",639,143,83,60,477,118,268,83,137,48,48,29,18,1,42,27,15,1,1,19,10,9
"2021","Harrogate 020D","E01027716",612,136,98,38,461,128,279,85,152,42,29,16,10,3,24,18,6,1,1,15,7,8
"2021","Harrogate 020E","E01027717",609,134,75,59,454,66,274,71,168,35,57,33,21,3,53,34,19,4,4,21,12,9
"2021","Harrogate 020F","E01027718",813,192,94,98,594,117,319,96,183,40,58,25,31,2,98,66,32,2,2,27,12,15
"2021","Harrogate 020G","E01027719",644,194,109,85,429,105,223,71,125,27,50,29,20,1,50,30,20,1,1,21,9,12
"2021","Harrogate 021A","E01027699",523,105,79,26,411,103,251,80,121,50,34,13,21,0,22,14,8,1,1,7,2,5
"2021","Harrogate 021B","E01027700",583,115,68,47,450,99,257,92,124,41,51,29,22,0,42,21,21,1,1,18,7,11
"2021","Harrogate 021C","E01027724",696,153,90,63,509,109,303,124,133,46,57,35,19,3,40,22,18,0,0,34,18,16
"2021","Harrogate 021D","E01027725",655,177,98,79,457,91,261,100,121,40,59,33,26,0,43,26,17,3,3,21,10,11
"2021","Richmondshire 001A","E01027743",549,154,98,56,375,109,172,84,58,30,52,35,16,1,41,27,14,1,1,20,8,12
"2021","Richmondshire 001B","E01027751",547,125,69,56,408,89,235,97,93,45,47,27,16,4,37,22,15,0,0,14,2,12
"2021","Richmondshire 001C","E01027752",546,156,82,74,366,92,197,99,64,34,40,31,8,1,35,21,14,2,2,24,11,13
"2021","Richmondshire 001D","E01027759",635,160,85,75,457,100,270,119,97,54,51,34,12,5,34,18,16,2,2,18,7,11
"2021","Richmondshire 001E","E01027761",528,159,93,66,355,111,181,91,65,25,36,23,10,3,25,18,7,2,2,14,6,8
"2021","Richmondshire 001F","E01027762",593,135,66,69,439,92,263,138,91,34,52,34,17,1,30,19,11,2,2,19,6,13
"2021","Richmondshire 002A","E01027765",685,197,106,91,474,85,236,113,97,26,76,29,38,9,77,41,36,0,0,14,6,8
"2021","Richmondshire 002B","E01027766",609,285,171,114,306,66,137,66,44,27,57,35,21,1,45,27,18,1,1,18,2,16
"2021","Richmondshire 002C","E01027767",624,181,108,73,423,102,220,75,112,33,41,14,22,5,59,34,25,1,1,20,9,11
"2021","Richmondshire 002D","E01027768",503,143,89,54,346,84,190,70,81,39,33,17,11,5,36,27,9,3,3,14,3,11
"2021","Richmondshire 002E","E01027769",596,206,75,131,376,73,171,84,62,25,62,37,21,4,65,46,19,5,5,14,7,7
"2021","Richmondshire 002F","E01027770",861,424,167,257,417,106,177,94,53,30,69,57,11,1,63,39,24,2,2,20,5,15
"2021","Richmondshire 003A","E01027745",650,163,80,83,456,87,252,89,112,51,60,31,19,10,56,37,19,1,1,31,12,19
"2021","Richmondshire 003B","E01027746",663,203,111,92,432,90,232,105,82,45,64,40,22,2,46,25,21,0,0,28,17,11
"2021","Richmondshire 003C","E01027747",530,143,56,87,373,52,210,91,93,26,64,27,34,3,45,35,10,2,2,14,10,4
"2021","Richmondshire 003D","E01027748",540,178,126,52,344,70,157,69,60,28,60,37,18,5,57,34,23,0,0,18,9,9
"2021","Richmondshire 004A","E01027749",838,284,94,190,511,34,211,78,81,52,96,42,48,6,167,116,51,3,3,43,20,23
"2021","Richmondshire 004E","E01027771",424,27,9,18,378,10,308,89,198,21,25,6,18,1,35,33,2,0,0,19,11,8
"2021","Richmondshire 004F","E01027772",561,144,69,75,396,70,209,98,72,39,71,42,26,3,45,24,21,1,1,21,6,15
"2021","Richmondshire 004H","E01033184",507,84,14,70,395,7,249,92,132,25,75,39,35,1,63,51,12,1,1,28,16,12
"2021","Richmondshire 004I","E01034965",845,157,66,91,646,22,504,101,377,26,51,25,22,4,68,48,20,1,1,42,22,20
"2021","Richmondshire 004J","E01034966",744,204,74,130,506,65,269,100,89,80,83,35,41,7,88,61,27,1,1,34,12,22
"2021","Richmondshire 004K","E01034967",652,136,16,120,495,11,257,65,158,34,109,54,49,6,113,95,18,5,5,21,8,13
"2021","Richmondshire 005A","E01027742",616,193,110,83,412,109,210,107,66,37,60,39,17,4,33,13,20,0,0,11,8,3
"2021","Richmondshire 005B","E01027753",577,189,95,94,378,85,199,109,51,39,49,25,21,3,44,22,22,1,1,10,2,8
"2021","Richmondshire 005C","E01027763",519,163,96,67,344,93,177,109,37,31,51,35,14,2,22,4,18,1,1,12,1,11
"2021","Richmondshire 005D","E01027764",539,192,112,80,337,81,172,84,50,38,54,42,10,2,30,15,15,0,0,10,6,4
"2021","Richmondshire 005E","E01027773",516,152,82,70,354,88,202,118,60,24,41,27,13,1,22,8,14,1,1,10,3,7
"2021","Richmondshire 006A","E01027744",605,157,89,68,431,128,208,127,47,34,65,42,21,2,29,19,10,1,1,17,7,10
"2021","Richmondshire 006B","E01027756",750,172,83,89,548,83,305,138,130,37,82,59,23,0,74,53,21,4,4,30,15,15
"2021","Richmondshire 006D","E01027758",605,133,70,63,454,117,251,131,74,46,56,39,16,1,29,14,15,1,1,18,9,9
"2021","Richmondshire 006E","E01027760",570,204,112,92,340,94,171,84,54,33,49,32,17,0,21,14,7,5,5,26,8,18
"2021","Richmondshire 006F","E01033185",697,268,150,118,407,114,196,104,63,29,57,40,15,2,34,22,12,6,6,22,8,14
"2021","Richmondshire 006G","E01033186",712,241,184,57,454,151,201,116,49,36,61,33,21,7,41,23,18,0,0,17,6,11
"2021","Ryedale 001A","E01027776",688,171,100,71,482,136,260,141,76,43,53,32,16,5,32,18,14,1,1,35,12,23
"2021","Ryedale 001B","E01027777",614,169,83,86,426,99,233,136,53,44,70,50,19,1,24,15,9,0,0,19,6,13
"2021","Ryedale 001C","E01027783",884,290,169,121,565,180,244,128,74,42,80,51,25,4,61,37,24,0,0,29,9,20
"2021","Ryedale 001D","E01027784",787,293,156,137,478,89,216,84,89,43,85,40,39,6,81,49,32,7,7,16,5,11
"2021","Ryedale 002A","E01027792",1137,440,289,151,681,209,295,157,107,31,97,58,36,3,75,41,34,5,5,16,2,14
"2021","Ryedale 002B","E01027793",676,233,126,107,411,106,194,77,74,43,56,32,19,5,54,31,23,1,1,32,8,24
"2021","Ryedale 002C","E01027794",903,251,147,104,622,195,278,123,94,61,82,37,39,6,67,35,32,0,0,30,12,18
"2021","Ryedale 002D","E01027795",770,308,157,151,444,65,197,86,79,32,86,43,38,5,92,52,40,4,4,18,6,12
"2021","Ryedale 002E","E01027801",804,248,165,83,527,177,237,122,71,44,68,31,35,2,45,21,24,0,0,29,12,17
"2021","Ryedale 002F","E01027802",728,166,88,78,532,146,264,144,83,37,87,54,27,6,35,18,17,0,0,30,8,22
"2021","Ryedale 003A","E01027775",699,178,104,74,488,103,294,136,109,49,51,40,9,2,36,16,20,4,4,33,16,17
"2021","Ryedale 003B","E01027780",976,291,157,134,652,139,340,171,116,53,104,68,35,1,67,40,27,2,2,33,12,21
"2021","Ryedale 003C","E01027781",670,287,179,108,361,118,143,78,47,18,49,27,19,3,47,27,20,4,4,22,7,15
"2021","Ryedale 003D","E01027800",770,181,101,80,564,128,323,174,103,46,74,40,30,4,39,17,22,0,0,25,10,15
"2021","Ryedale 004A","E01027779",485,131,72,59,333,61,159,80,56,23,57,29,22,6,50,23,27,6,6,21,9,12
"2021","Ryedale 004B","E01027796",818,231,122,109,555,122,282,131,89,62,89,50,37,2,59,40,19,3,3,32,7,25
"2021","Ryedale 004C","E01027798",863,203,92,111,625,110,317,142,100,75,121,51,58,12,76,49,27,1,1,35,14,21
"2021","Ryedale 004D","E01027803",779,177,85,92,572,96,334,154,123,57,94,49,39,6,44,31,13,4,4,30,13,17
"2021","Ryedale 007A","E01027774",809,191,115,76,589,119,310,130,113,67,106,64,40,2,52,29,23,2,2,29,10,19
"2021","Ryedale 007B","E01027778",1017,285,140,145,688,146,381,204,116,61,104,65,29,10,56,26,30,1,1,44,14,30
"2021","Ryedale 007C","E01027782",805,246,147,99,540,135,297,161,99,37,65,43,20,2,39,19,20,4,4,19,7,12
"2021","Ryedale 007D","E01027797",707,176,89,87,493,101,280,119,122,39,72,42,28,2,38,16,22,2,2,38,13,25
"2021","Ryedale 007E","E01027799",789,207,134,73,544,136,273,122,99,52,74,50,23,1,57,38,19,4,4,38,11,27
"2021","Ryedale 009A","E01027787",822,291,153,138,490,64,213,75,88,50,108,54,47,7,102,59,43,3,3,41,13,28
"2021","Ryedale 009B","E01034968",655,140,37,103,494,25,223,71,137,15,170,107,58,5,73,58,15,3,3,21,6,15
"2021","Ryedale 009C","E01034969",666,204,63,141,438,33,210,69,118,23,126,62,60,4,66,44,22,3,3,24,10,14
"2021","Ryedale 009D","E01034970",701,359,132,227,311,49,123,58,49,16,75,53,20,2,54,33,21,10,10,31,6,25
"2021","Ryedale 009E","E01034971",628,231,113,118,364,32,159,53,71,35,95,37,49,9,74,46,28,4,4,33,9,24
"2021","Ryedale 010A","E01027786",727,217,156,61,491,150,262,116,109,37,50,37,11,2,28,15,13,1,1,19,5,14
"2021","Ryedale 010B","E01027788",746,263,160,103,466,117,225,88,90,47,72,23,40,9,50,30,20,2,2,17,4,13
"2021","Ryedale 010D","E01027790",858,295,105,190,518,63,234,94,92,48,128,79,41,8,85,49,36,8,8,45,12,33
"2021","Ryedale 010C","E01027791",721,193,116,77,514,104,254,104,103,47,104,61,37,6,48,33,15,4,4,14,4,10
"2021","Scarborough 001A","E01027837",656,277,183,94,368,69,156,59,61,36,50,26,20,4,88,50,38,5,5,11,3,8
"2021","Scarborough 001B","E01027839",838,237,137,100,579,90,294,126,118,50,126,52,67,7,64,41,23,5,5,22,11,11
"2021","Scarborough 001E","E01027871",720,254,160,94,447,103,213,98,76,39,66,35,30,1,65,34,31,0,0,19,4,15
"2021","Scarborough 001F","E01034972",1183,634,230,404,502,132,218,138,44,36,90,71,10,9,58,26,32,4,4,47,10,37
"2021","Scarborough 002A","E01027813",832,224,132,92,559,158,295,138,90,67,70,43,25,2,32,13,19,4,4,49,7,42
"2021","Scarborough 002B","E01027822",610,169,97,72,413,84,222,114,75,33,72,33,32,7,35,13,22,0,0,28,14,14
"2021","Scarborough 002C","E01027840",947,337,203,134,584,134,250,129,75,46,107,49,52,6,87,56,31,6,6,26,9,17
"2021","Scarborough 002D","E01027841",582,171,88,83,386,104,197,90,65,42,48,27,17,4,33,16,17,4,4,25,12,13
"2021","Scarborough 003A","E01027838",712,197,120,77,496,145,253,132,80,41,61,33,20,8,35,17,18,2,2,19,7,12
"2021","Scarborough 003B","E01027864",616,176,75,101,420,49,164,60,63,41,89,32,47,10,114,68,46,4,4,20,7,13
"2021","Scarborough 003C","E01027865",613,268,110,158,313,51,138,79,26,33,56,36,17,3,66,43,23,2,2,32,9,23
"2021","Scarborough 003D","E01027866",877,247,112,135,602,94,283,121,114,48,112,42,64,6,113,76,37,0,0,28,11,17
"2021","Scarborough 004A","E01027821",663,168,113,55,458,139,213,121,55,37,69,51,18,0,36,16,20,1,1,37,8,29
"2021","Scarborough 004B","E01027823",669,219,138,81,437,119,214,117,56,41,60,35,23,2,42,22,20,2,2,13,5,8
"2021","Scarborough 004E","E01027836",1000,270,154,116,697,166,355,179,119,57,108,60,44,4,65,38,27,3,3,33,15,18
"2021","Scarborough 004F","E01027857",549,160,96,64,367,113,182,85,68,29,49,27,18,4,22,10,12,1,1,22,13,9
"2021","Scarborough 004G","E01034973",881,273,170,103,576,148,281,132,88,61,85,51,29,5,62,31,31,0,0,32,12,20
"2021","Scarborough 005A","E01027842",722,226,157,69,474,107,219,87,78,54,74,34,35,5,72,44,28,2,2,22,12,10
"2021","Scarborough 005B","E01027843",635,208,124,84,407,65,192,54,100,38,76,32,36,8,74,53,21,0,0,20,10,10
"2021","Scarborough 005C","E01027844",656,161,111,50,476,118,248,115,86,47,76,37,32,7,31,14,17,3,3,19,9,10
"2021","Scarborough 005D","E01027845",706,181,124,57,508,120,264,103,99,62,74,33,36,5,50,26,24,0,0,17,7,10
"2021","Scarborough 005E","E01027855",823,222,149,73,570,184,274,116,116,42,54,26,27,1,58,40,18,0,0,31,13,18
"2021","Scarborough 005F","E01027856",661,282,217,65,366,161,154,68,50,36,31,18,10,3,20,12,8,0,0,13,3,10
"2021","Scarborough 006A","E01027805",715,366,150,216,321,51,119,65,33,21,62,37,22,3,82,45,37,7,7,28,7,21
"2021","Scarborough 006B","E01027806",919,514,114,400,363,32,105,42,47,16,104,70,31,3,112,84,28,10,10,42,15,27
"2021","Scarborough 006D","E01027847",1009,619,167,452,334,39,113,59,44,10,97,57,37,3,78,52,26,7,7,56,15,41
"2021","Scarborough 006F","E01034974",1213,403,178,225,734,99,346,145,123,78,136,67,66,3,149,98,51,4,4,76,33,43
"2021","Scarborough 007A","E01027849",515,200,119,81,292,70,148,67,46,35,41,22,15,4,27,11,16,6,6,23,8,15
"2021","Scarborough 007B","E01027850",603,242,110,132,344,42,145,55,63,27,60,23,30,7,95,66,29,2,2,17,10,7
"2021","Scarborough 007C","E01027872",605,202,101,101,377,57,138,50,52,36,75,30,40,5,100,60,40,7,7,26,11,15
"2021","Scarborough 007D","E01027874",655,167,62,105,453,27,143,48,74,21,102,24,71,7,178,140,38,3,3,35,17,18
"2021","Scarborough 008A","E01027810",649,195,67,128,402,35,130,55,54,21,107,45,58,4,125,79,46,5,5,52,24,28
"2021","Scarborough 008B","E01027811",674,220,67,153,434,38,160,56,79,25,102,57,40,5,127,93,34,7,7,20,8,12
"2021","Scarborough 008C","E01027812",783,289,97,192,432,30,142,61,54,27,108,46,56,6,142,105,37,10,10,62,23,39
"2021","Scarborough 008D","E01027851",632,183,86,97,425,56,184,79,63,42,104,53,44,7,79,45,34,2,2,24,12,12
"2021","Scarborough 008E","E01027862",802,369,147,222,395,59,141,64,55,22,92,58,28,6,100,73,27,3,3,38,13,25
"2021","Scarborough 009A","E01027824",773,300,182,118,444,111,196,110,55,31,58,27,24,7,76,32,44,3,3,29,15,14
"2021","Scarborough 009B","E01027825",926,284,66,218,575,30,216,88,94,34,166,83,74,9,153,113,40,10,10,67,22,45
"2021","Scarborough 009C","E01027826",659,240,96,144,379,39,150,72,58,20,107,61,43,3,77,50,27,6,6,40,9,31
"2021","Scarborough 009D","E01027861",671,290,135,155,351,56,152,63,60,29,73,42,24,7,63,45,18,7,7,30,12,18
"2021","Scarborough 009E","E01027863",649,219,164,55,417,127,212,109,72,31,49,30,17,2,28,10,18,1,1,13,5,8
"2021","Scarborough 009F","E01027873",699,284,190,94,390,105,206,91,76,39,42,21,16,5,37,24,13,0,0,25,8,17
"2021","Scarborough 010A","E01027804",911,572,113,459,286,28,103,63,32,8,96,73,20,3,54,37,17,5,5,53,13,40
"2021","Scarborough 010B","E01027852",884,503,117,386,333,35,132,89,31,12,91,67,21,3,72,50,22,3,3,48,8,40
"2021","Scarborough 010C","E01027853",619,312,130,182,286,72,118,70,31,17,48,39,7,2,42,21,21,6,6,21,6,15
"2021","Scarborough 010D","E01027854",833,517,148,369,276,47,104,73,20,11,68,58,10,0,48,35,13,9,9,40,6,34
"2021","Scarborough 010E","E01027868",1157,578,334,244,542,185,223,150,49,24,82,61,14,7,47,25,22,5,5,37,15,22
"2021","Scarborough 011A","E01027807",699,210,117,93,457,110,235,111,77,47,69,40,27,2,42,25,17,1,1,32,16,16
"2021","Scarborough 011B","E01027808",756,203,124,79,539,153,249,119,83,47,75,33,38,4,59,29,30,3,3,14,5,9
"2021","Scarborough 011C","E01027809",646,223,147,76,413,133,190,114,48,28,59,42,14,3,29,11,18,2,2,10,4,6
"2021","Scarborough 011D","E01027818",891,277,118,159,594,84,239,120,82,37,156,83,68,5,112,82,30,3,3,20,9,11
"2021","Scarborough 011E","E01027867",664,194,128,66,440,133,208,110,69,29,67,42,19,6,29,16,13,3,3,30,11,19
"2021","Scarborough 012A","E01027817",649,239,78,161,375,38,147,54,65,28,85,32,45,8,97,55,42,8,8,35,13,22
"2021","Scarborough 012B","E01027819",914,230,70,160,628,28,178,55,95,28,194,71,104,19,223,176,47,5,5,56,33,23
"2021","Scarborough 012C","E01027820",525,105,42,63,393,29,120,37,60,23,107,19,78,10,134,109,25,3,3,27,17,10
"2021","Scarborough 012D","E01027858",623,171,105,66,441,113,213,96,75,42,70,49,18,3,43,25,18,2,2,11,4,7
"2021","Scarborough 012E","E01027860",670,175,110,65,471,91,228,84,101,43,83,35,42,6,67,45,22,2,2,24,14,10
"2021","Scarborough 013A","E01027814",739,201,137,64,503,122,254,123,92,39,80,37,39,4,45,24,21,2,2,35,15,20
"2021","Scarborough 013B","E01027815",611,158,77,81,436,119,217,106,75,36,59,36,20,3,39,21,18,2,2,17,11,6
"2021","Scarborough 013C","E01027816",746,188,130,58,524,144,249,104,105,40,71,35,31,5,59,37,22,1,1,34,16,18
"2021","Scarborough 013D","E01027859",763,180,108,72,554,127,291,121,121,49,81,44,31,6,53,33,20,2,2,29,11,18
"2021","Scarborough 014A","E01027827",813,367,209,158,417,113,149,87,37,25,82,56,22,4,71,41,30,2,2,29,8,21
"2021","Scarborough 014B","E01027828",976,285,208,77,658,226,277,150,81,46,74,29,38,7,80,50,30,1,1,33,12,21
"2021","Scarborough 014C","E01027829",747,279,193,86,457,199,154,109,17,28,56,31,22,3,47,26,21,1,1,11,7,4
"2021","Scarborough 014D","E01027830",740,224,121,103,484,88,215,98,69,48,93,36,49,8,87,58,29,1,1,32,12,20
"2021","Scarborough 014E","E01027833",722,235,127,108,455,136,214,126,51,37,63,33,24,6,39,24,15,3,3,32,21,11
"2021","Scarborough 014F","E01027834",747,236,164,72,490,151,218,119,62,37,76,41,28,7,42,24,18,3,3,21,6,15
"2021","Scarborough 014G","E01027835",776,205,113,92,528,128,255,127,82,46,81,37,37,7,62,37,25,2,2,43,20,23
"2021","Selby 001A","E01027918",661,230,91,139,404,42,205,69,94,42,80,38,35,7,68,43,25,9,9,27,5,22
"2021","Selby 001B","E01027919",530,194,79,115,327,44,168,54,86,28,78,37,37,4,37,17,20,0,0,9,3,6
"2021","Selby 001C","E01027920",491,128,70,58,346,75,179,79,61,39,47,27,16,4,42,24,18,3,3,17,5,12
"2021","Selby 001D","E01027921",908,398,245,153,489,114,231,111,87,33,80,44,28,8,61,38,23,3,3,21,8,13
"2021","Selby 001E","E01027922",827,175,99,76,632,126,382,129,184,69,81,41,37,3,43,25,18,0,0,20,12,8
"2021","Selby 002A","E01027875",769,140,79,61,604,117,393,131,193,69,61,33,24,4,32,16,16,1,1,25,15,10
"2021","Selby 002B","E01027886",601,146,73,73,424,75,243,102,100,41,76,40,30,6,27,22,5,3,3,31,15,16
"2021","Selby 002C","E01027887",684,195,87,108,475,107,265,114,115,36,63,41,20,2,40,27,13,0,0,14,8,6
"2021","Selby 002D","E01027888",780,177,91,86,571,75,335,117,172,46,97,51,41,5,60,46,14,4,4,32,11,21
"2021","Selby 002E","E01027904",1010,204,88,116,780,115,463,176,215,72,125,72,45,8,76,56,20,1,1,26,12,14
"2021","Selby 003A","E01027876",680,189,100,89,466,58,261,106,100,55,96,61,30,5,51,34,17,0,0,25,14,11
"2021","Selby 003B","E01027877",810,200,76,124,585,82,269,110,113,46,167,97,67,3,63,47,16,4,4,25,14,11
"2021","Selby 003C","E01027900",816,167,82,85,620,105,367,156,156,55,82,42,34,6,63,38,25,3,3,29,13,16
"2021","Selby 003D","E01027901",742,157,87,70,557,111,313,123,140,50,86,62,21,3,44,26,18,3,3,28,11,17
"2021","Selby 003E","E01027902",617,146,82,64,453,78,244,115,90,39,81,44,32,5,49,35,14,1,1,18,7,11
"2021","Selby 003F","E01027903",440,100,64,36,327,74,203,73,102,28,28,16,12,0,22,9,13,0,0,13,2,11
"2021","Selby 004B","E01027914",700,197,116,81,484,114,259,112,95,52,68,44,20,4,39,18,21,4,4,19,8,11
"2021","Selby 004C","E01027915",916,288,127,161,596,74,300,124,130,46,148,85,57,6,72,53,19,2,2,32,10,22
"2021","Selby 004D","E01027916",716,232,107,125,457,49,201,79,82,40,106,62,35,9,95,53,42,6,6,27,11,16
"2021","Selby 004F","E01034975",614,97,19,78,488,30,225,79,133,13,161,107,49,5,68,54,14,4,4,29,16,13
"2021","Selby 004G","E01034976",700,112,38,74,560,50,302,106,150,46,125,76,45,4,80,58,22,3,3,28,8,20
"2021","Selby 004H","E01034977",623,175,102,73,429,73,231,97,95,39,72,50,19,3,52,36,16,1,1,19,8,11
"2021","Selby 004I","E01034978",589,150,50,100,423,37,212,83,115,14,108,69,35,4,66,50,16,0,0,16,5,11
"2021","Selby 005A","E01027878",558,169,46,123,362,37,153,66,57,30,94,49,42,3,73,50,23,5,5,27,8,19
"2021","Selby 005C","E01027907",567,178,67,111,362,34,148,46,70,32,75,22,47,6,98,65,33,7,7,27,9,18
"2021","Selby 005D","E01027908",838,361,111,250,441,34,137,73,46,18,134,80,49,5,124,90,34,12,12,36,13,23
"2021","Selby 005E","E01027909",1080,467,113,354,558,50,190,96,53,41,175,103,64,8,131,97,34,12,12,55,16,39
"2021","Selby 005G","E01034979",618,181,67,114,400,50,189,83,78,28,117,67,46,4,40,26,14,4,4,37,16,21
"2021","Selby 005H","E01034980",586,286,44,242,282,18,93,40,46,7,112,68,40,4,50,34,16,9,9,18,5,13
"2021","Selby 005I","E01034981",575,119,51,68,421,19,178,60,81,37,102,49,46,7,118,83,35,4,4,35,18,17
"2021","Selby 005J","E01034982",539,187,74,113,335,24,147,53,73,21,82,32,43,7,76,49,27,6,6,17,9,8
"2021","Selby 005K","E01034983",555,81,10,71,452,5,251,59,178,14,111,49,60,2,82,65,17,3,3,22,14,8
"2021","Selby 006A","E01027881",827,256,152,104,540,105,235,81,114,40,95,42,52,1,101,73,28,4,4,31,17,14
"2021","Selby 006B","E01027906",659,187,82,105,443,49,219,85,96,38,94,41,46,7,80,56,24,1,1,29,15,14
"2021","Selby 006E","E01027913",502,104,70,34,384,92,212,98,74,40,42,25,15,2,36,18,18,2,2,14,6,8
"2021","Selby 006F","E01034984",1071,331,187,144,693,162,338,141,115,82,101,68,25,8,90,51,39,2,2,47,23,24
"2021","Selby 007A","E01027879",564,158,86,72,396,87,200,84,70,46,66,32,27,7,42,22,20,1,1,10,3,7
"2021","Selby 007B","E01027880",630,141,95,46,472,129,257,103,101,53,43,17,19,7,37,17,20,6,6,17,11,6
"2021","Selby 007C","E01027882",731,144,78,66,571,100,330,145,131,54,88,47,40,1,53,28,25,0,0,16,6,10
"2021","Selby 007D","E01027894",1155,266,132,134,855,128,418,179,170,69,191,112,74,5,115,87,28,3,3,34,14,20
"2021","Selby 007E","E01027895",684,215,128,87,448,129,224,109,70,45,64,38,24,2,29,13,16,2,2,21,8,13
"2021","Selby 008A","E01027883",445,96,53,43,327,74,178,88,63,27,38,21,14,3,37,25,12,0,0,22,15,7
"2021","Selby 008B","E01027884",681,156,57,99,487,56,253,108,95,50,113,67,41,5,61,40,21,4,4,38,19,19
"2021","Selby 008C","E01027885",755,178,104,74,552,95,288,131,110,47,109,61,45,3,58,36,22,2,2,25,15,10
"2021","Selby 008D","E01027896",824,187,92,95,603,93,363,152,152,59,81,49,27,5,66,49,17,0,0,34,16,18
"2021","Selby 008E","E01027897",926,172,84,88,712,141,394,193,147,54,121,76,38,7,53,30,23,3,3,42,20,22
"2021","Selby 009A","E01027891",783,225,104,121,544,107,274,133,90,51,113,61,43,9,46,29,17,4,4,14,8,6
"2021","Selby 009B","E01027892",861,308,120,188,519,93,229,114,78,37,112,59,47,6,82,57,25,3,3,34,15,19
"2021","Selby 009C","E01027893",931,197,108,89,720,154,363,150,160,53,137,84,49,4,65,42,23,1,1,14,6,8
"2021","Selby 009D","E01027899",713,154,75,79,533,104,297,112,148,37,69,38,28,3,59,37,22,4,4,26,10,16
"2021","Selby 010A","E01027889",775,227,102,125,525,90,262,103,110,49,98,55,35,8,72,49,23,3,3,23,12,11
"2021","Selby 010B","E01027890",995,217,93,124,731,116,383,161,143,79,150,89,55,6,79,61,18,3,3,47,22,25
"2021","Selby 010C","E01027923",999,231,120,111,726,126,412,179,147,86,121,84,34,3,67,35,32,0,0,42,17,25
"2021","Selby 010D","E01027924",919,183,78,105,689,100,422,178,187,57,111,60,44,7,56,42,14,0,0,47,23,24
"2021","Barnsley 001A","E01007434",1040,291,102,189,705,62,333,106,172,55,175,80,85,10,131,99,32,4,4,44,21,23
"2021","Barnsley 001B","E01007435",732,269,134,135,445,53,178,74,66,38,97,38,53,6,113,74,39,4,4,18,11,7
"2021","Barnsley 001C","E01007438",619,178,100,78,418,84,218,96,64,58,61,32,27,2,55,34,21,0,0,23,13,10
"2021","Barnsley 001D","E01007439",619,123,62,61,479,92,235,108,86,41,103,54,42,7,48,33,15,1,1,17,8,9
"2021","Barnsley 002A","E01007433",696,155,79,76,518,79,221,80,83,58,107,58,44,5,109,68,41,2,2,23,12,11
"2021","Barnsley 002B","E01007436",610,180,91,89,408,81,185,80,72,33,79,33,41,5,61,44,17,2,2,22,11,11
"2021","Barnsley 002C","E01007437",633,206,64,142,396,59,193,73,70,50,65,30,29,6,74,49,25,5,5,31,14,17
"2021","Barnsley 002D","E01007440",667,235,77,158,400,41,147,64,47,36,98,41,51,6,106,72,34,8,8,32,11,21
"2021","Barnsley 003A","E01007329",640,180,80,100,429,63,231,92,87,52,73,28,35,10,59,37,22,3,3,31,14,17
"2021","Barnsley 003B","E01007331",827,247,120,127,557,97,246,119,84,43,118,58,53,7,93,65,28,3,3,23,13,10
"2021","Barnsley 003C","E01007342",566,156,82,74,389,81,186,95,47,44,68,34,29,5,54,40,14,0,0,21,12,9
"2021","Barnsley 003D","E01007343",684,235,131,104,416,76,144,69,42,33,92,42,45,5,99,67,32,5,5,33,17,16
"2021","Barnsley 004A","E01007356",615,158,81,77,437,116,199,85,60,54,86,43,39,4,36,20,16,0,0,20,6,14
"2021","Barnsley 004B","E01007357",623,202,92,110,404,52,175,70,63,42,89,39,43,7,86,53,33,2,2,17,6,11
"2021","Barnsley 004C","E01007361",838,257,78,179,552,60,256,99,125,32,148,83,56,9,84,59,25,4,4,29,14,15
"2021","Barnsley 004D","E01007362",908,204,93,111,680,109,353,138,163,52,140,83,49,8,78,55,23,0,0,24,11,13
"2021","Barnsley 004E","E01007363",800,304,147,157,478,78,203,89,71,43,91,50,31,10,105,67,38,1,1,18,10,8
"2021","Barnsley 005A","E01007355",603,139,71,68,454,59,253,99,99,55,91,51,37,3,51,31,20,0,0,10,4,6
"2021","Barnsley 005B","E01007358",638,202,84,118,418,79,196,77,83,36,90,47,36,7,51,37,14,2,2,18,8,10
"2021","Barnsley 005C","E01007359",656,216,88,128,416,67,170,68,64,38,113,62,44,7,66,39,27,0,0,24,15,9
"2021","Barnsley 005D","E01007360",656,179,120,59,449,102,199,83,73,43,78,41,31,6,68,35,33,2,2,28,16,12
"2021","Barnsley 005E","E01007386",841,256,138,118,566,118,267,106,87,74,124,81,39,4,54,38,16,3,3,19,11,8
"2021","Barnsley 006A","E01007328",854,255,93,162,550,53,212,75,82,55,176,80,77,19,104,65,39,5,5,49,28,21
"2021","Barnsley 006B","E01007330",768,204,94,110,539,82,249,114,93,42,121,58,54,9,83,51,32,4,4,25,17,8
"2021","Barnsley 006C","E01007332",986,285,102,183,651,67,285,107,124,54,155,69,82,4,138,103,35,6,6,50,23,27
"2021","Barnsley 006D","E01007333",587,152,48,104,394,35,149,53,54,42,105,46,49,10,101,68,33,4,4,41,20,21
"2021","Barnsley 007A","E01007323",660,183,55,128,448,30,174,75,63,36,119,45,62,12,121,94,27,4,4,29,13,16
"2021","Barnsley 007B","E01007324",724,232,94,138,458,70,159,80,47,32,128,47,70,11,98,69,29,3,3,34,15,19
"2021","Barnsley 007C","E01007325",595,138,49,89,432,26,155,44,74,37,97,24,64,9,150,111,39,4,4,25,12,13
"2021","Barnsley 007D","E01007326",721,220,110,110,468,47,179,62,69,48,116,44,59,13,121,85,36,5,5,33,17,16
"2021","Barnsley 007E","E01007327",790,296,154,142,461,88,191,86,62,43,80,35,36,9,98,52,46,4,4,33,14,19
"2021","Barnsley 007F","E01007411",593,182,61,121,370,28,121,37,57,27,103,40,58,5,112,81,31,6,6,41,29,12
"2021","Barnsley 008A","E01007341",514,133,32,101,354,31,128,50,47,31,79,29,41,9,109,76,33,7,7,27,11,16
"2021","Barnsley 008B","E01007345",668,207,71,136,431,50,160,57,64,39,104,48,54,2,111,75,36,6,6,30,17,13
"2021","Barnsley 008C","E01007346",671,186,71,115,463,44,210,83,82,45,105,44,48,13,103,73,30,1,1,22,12,10
"2021","Barnsley 008D","E01007347",781,199,96,103,566,56,309,135,121,53,134,69,61,4,64,43,21,3,3,16,7,9
"2021","Barnsley 009A","E01007334",560,137,62,75,410,82,196,71,72,53,78,36,35,7,53,33,20,1,1,13,11,2
"2021","Barnsley 009B","E01007335",609,149,80,69,436,79,236,114,71,51,69,40,25,4,49,28,21,3,3,24,9,15
"2021","Barnsley 009C","E01007400",958,254,133,121,681,104,349,113,174,62,141,67,66,8,83,62,21,4,4,23,14,9
"2021","Barnsley 009D","E01007404",629,181,113,68,431,120,200,122,45,33,73,33,31,9,36,19,17,2,2,17,8,9
"2021","Barnsley 009E","E01007406",816,347,148,199,433,67,168,77,58,33,94,36,52,6,103,62,41,1,1,36,17,19
"2021","Barnsley 010C","E01007408",657,217,86,131,424,61,192,82,77,33,102,52,43,7,65,40,25,4,4,16,3,13
"2021","Barnsley 010D","E01007409",655,217,69,148,399,57,205,80,82,43,86,48,29,9,47,20,27,4,4,39,12,27
"2021","Barnsley 010E","E01007410",912,396,133,263,485,58,178,87,66,25,136,77,51,8,110,62,48,3,3,31,15,16
"2021","Barnsley 010H","E01032551",1122,332,134,198,739,103,374,147,162,65,127,69,51,7,130,91,39,5,5,51,26,25
"2021","Barnsley 010I","E01034258",641,184,78,106,437,42,190,69,83,38,111,51,49,11,93,62,31,1,1,20,13,7
"2021","Barnsley 010J","E01034259",633,197,61,136,406,37,175,67,71,37,86,39,39,8,102,65,37,6,6,30,14,16
"2021","Barnsley 011A","E01007344",1050,254,80,174,753,80,354,109,170,75,191,78,105,8,125,97,28,3,3,43,21,22
"2021","Barnsley 011B","E01007402",762,188,78,110,527,35,173,48,86,39,156,69,74,13,153,123,30,10,10,47,27,20
"2021","Barnsley 011C","E01007403",614,164,69,95,409,39,163,80,46,37,90,32,45,13,116,82,34,1,1,41,17,24
"2021","Barnsley 011D","E01007405",785,194,111,83,555,118,253,106,84,63,118,49,65,4,61,40,21,5,5,36,22,14
"2021","Barnsley 012A","E01007379",691,206,126,80,467,114,212,104,71,37,82,49,27,6,58,33,25,1,1,18,7,11
"2021","Barnsley 012B","E01007380",773,180,81,99,563,102,298,120,129,49,118,63,48,7,43,30,13,2,2,30,12,18
"2021","Barnsley 012C","E01007381",900,220,114,106,653,86,340,122,140,78,142,85,47,10,81,57,24,4,4,27,14,13
"2021","Barnsley 012D","E01007387",616,179,86,93,424,63,218,84,87,47,86,50,26,10,57,34,23,0,0,13,10,3
"2021","Barnsley 012E","E01007442",665,186,134,52,452,164,188,85,61,42,70,31,30,9,28,12,16,2,2,27,14,13
"2021","Barnsley 012F","E01007444",972,317,140,177,621,103,276,91,133,52,145,75,61,9,93,57,36,4,4,34,19,15
"2021","Barnsley 012G","E01007446",628,233,127,106,375,92,149,62,52,35,81,39,37,5,49,31,18,4,4,20,9,11
"2021","Barnsley 013A","E01007336",751,299,93,206,387,42,154,78,47,29,115,72,40,3,68,44,24,8,8,65,21,44
"2021","Barnsley 013B","E01007340",870,311,43,268,474,23,182,67,79,36,141,83,49,9,106,71,35,22,22,85,22,63
"2021","Barnsley 013C","E01007415",676,215,104,111,420,63,189,82,75,32,94,48,41,5,68,40,28,6,6,41,19,22
"2021","Barnsley 013D","E01007417",840,287,57,230,496,33,164,61,66,37,169,98,65,6,115,83,32,15,15,57,23,34
"2021","Barnsley 013E","E01007441",738,297,84,213,403,20,163,70,69,24,115,70,37,8,97,67,30,8,8,38,12,26
"2021","Barnsley 013F","E01007443",1178,555,78,477,537,22,190,68,86,36,186,136,47,3,124,88,36,15,15,86,16,70
"2021","Barnsley 013G","E01007445",755,296,105,191,428,40,161,68,68,25,124,71,49,4,99,66,33,4,4,31,14,17
"2021","Barnsley 014A","E01007372",748,254,87,167,459,38,184,82,69,33,110,61,43,6,127,103,24,0,0,35,15,20
"2021","Barnsley 014B","E01007373",733,231,83,148,470,44,150,55,60,35,114,34,65,15,155,115,40,7,7,32,19,13
"2021","Barnsley 014C","E01007374",650,212,114,98,429,85,200,105,52,43,90,47,36,7,53,34,19,1,1,9,5,4
"2021","Barnsley 014D","E01007375",738,194,101,93,514,83,232,105,82,45,100,44,48,8,93,49,44,6,6,30,16,14
"2021","Barnsley 014E","E01007377",565,134,43,91,402,34,158,64,51,43,95,35,51,9,108,79,29,7,7,29,14,15
"2021","Barnsley 014F","E01007378",748,308,113,195,408,40,128,52,50,26,94,30,56,8,141,96,45,5,5,32,16,16
"2021","Barnsley 015A","E01007319",625,148,86,62,466,109,214,78,77,59,90,43,36,11,53,32,21,0,0,11,6,5
"2021","Barnsley 015B","E01007321",687,209,136,73,460,134,225,120,65,40,71,40,27,4,29,16,13,1,1,18,5,13
"2021","Barnsley 015C","E01007322",921,312,81,231,558,34,237,97,99,41,175,93,69,13,103,68,35,9,9,51,27,24
"2021","Barnsley 015D","E01007337",885,321,60,261,500,42,184,87,65,32,153,92,54,7,110,74,36,11,11,64,18,46
"2021","Barnsley 016A","E01007418",601,187,116,71,396,118,216,94,89,33,39,21,13,5,20,8,12,3,3,18,8,10
"2021","Barnsley 016B","E01007419",704,185,105,80,504,121,267,110,110,47,78,44,26,8,37,21,16,1,1,15,6,9
"2021","Barnsley 016C","E01007420",622,155,100,55,452,117,226,110,70,46,66,37,25,4,41,24,17,2,2,15,5,10
"2021","Barnsley 016D","E01007425",762,161,105,56,580,136,346,138,160,48,66,38,24,4,31,16,15,1,1,21,12,9
"2021","Barnsley 017A","E01007338",973,585,228,357,357,67,105,54,32,19,85,57,22,6,87,53,34,13,13,31,13,18
"2021","Barnsley 017B","E01007339",699,278,53,225,360,25,110,45,45,20,110,57,47,6,97,68,29,18,18,61,17,44
"2021","Barnsley 017C","E01007413",638,229,78,151,379,26,133,43,56,34,100,33,57,10,111,78,33,9,9,30,16,14
"2021","Barnsley 017D","E01007414",915,260,82,178,602,35,255,101,114,40,180,81,91,8,127,89,38,5,5,53,21,32
"2021","Barnsley 018A","E01007317",663,222,97,125,413,80,160,61,58,41,80,32,43,5,91,65,26,2,2,28,19,9
"2021","Barnsley 018B","E01007318",654,201,87,114,414,31,172,52,86,34,103,47,54,2,104,79,25,4,4,39,22,17
"2021","Barnsley 018C","E01007320",726,234,84,150,441,45,167,68,60,39,100,37,55,8,124,87,37,5,5,51,23,28
"2021","Barnsley 018D","E01007416",590,188,106,82,383,31,144,61,64,19,100,28,65,7,102,65,37,6,6,19,15,4
"2021","Barnsley 019A","E01007382",737,254,92,162,463,82,205,73,81,51,108,51,45,12,65,39,26,3,3,20,9,11
"2021","Barnsley 019B","E01007383",516,92,44,48,410,56,235,87,92,56,77,38,38,1,41,23,18,1,1,14,8,6
"2021","Barnsley 019C","E01007384",746,203,125,78,525,116,264,113,111,40,78,40,30,8,66,36,30,1,1,18,13,5
"2021","Barnsley 019D","E01007385",670,291,149,142,364,68,140,61,43,36,71,35,30,6,84,58,26,1,1,15,7,8
"2021","Barnsley 020A","E01007348",629,189,116,73,410,82,160,73,53,34,80,26,44,10,85,66,19,3,3,30,14,16
"2021","Barnsley 020B","E01007349",713,246,111,135,445,68,196,91,63,42,87,39,45,3,90,58,32,4,4,22,10,12
"2021","Barnsley 020C","E01007350",510,150,114,36,347,125,159,74,46,39,29,14,14,1,32,13,19,2,2,13,10,3
"2021","Barnsley 020D","E01007351",738,196,91,105,502,80,210,85,78,47,107,49,49,9,94,62,32,11,11,40,25,15
"2021","Barnsley 020E","E01007352",640,210,85,125,402,34,160,63,73,24,101,42,53,6,103,69,34,4,4,28,13,15
"2021","Barnsley 020F","E01007353",716,185,70,115,503,62,228,98,81,49,110,55,50,5,101,72,29,2,2,28,11,17
"2021","Barnsley 020G","E01007354",724,224,84,140,473,76,216,105,68,43,101,49,45,7,78,50,28,2,2,27,17,10
"2021","Barnsley 021A","E01007458",667,215,65,150,435,45,172,84,51,37,113,55,51,7,100,62,38,5,5,17,6,11
"2021","Barnsley 021B","E01007459",745,239,138,101,491,135,206,119,45,42,92,48,37,7,58,32,26,0,0,15,8,7
"2021","Barnsley 021C","E01007460",625,191,92,99,421,83,177,77,56,44,89,36,39,14,69,37,32,3,3,13,10,3
"2021","Barnsley 021D","E01007461",803,314,99,215,449,43,189,81,80,28,120,59,51,10,89,60,29,8,8,40,18,22
"2021","Barnsley 021E","E01007462",658,192,73,119,436,46,170,64,72,34,86,26,58,2,128,86,42,6,6,30,17,13
"2021","Barnsley 021F","E01007463",768,272,116,156,466,55,160,59,54,47,85,35,40,10,161,113,48,5,5,30,17,13
"2021","Barnsley 022A","E01007369",910,303,77,226,569,38,214,92,96,26,169,87,74,8,144,101,43,4,4,38,19,19
"2021","Barnsley 022B","E01007370",766,205,64,141,528,42,204,91,82,31,153,81,65,7,126,81,45,3,3,33,16,17
"2021","Barnsley 022C","E01007371",809,209,82,127,571,70,259,109,92,58,129,65,57,7,108,70,38,5,5,29,15,14
"2021","Barnsley 022D","E01007376",697,280,136,144,385,39,163,70,48,45,87,42,40,5,89,53,36,7,7,32,15,17
"2021","Barnsley 023A","E01007447",753,264,151,113,452,68,204,73,74,57,95,29,57,9,82,54,28,3,3,37,20,17
"2021","Barnsley 023B","E01007448",1062,353,87,266,654,42,246,103,105,38,214,135,73,6,138,98,40,14,14,55,24,31
"2021","Barnsley 023C","E01007449",820,257,98,159,523,100,202,98,61,43,125,75,41,9,87,60,27,9,9,40,12,28
"2021","Barnsley 023D","E01007450",909,315,118,197,559,79,217,97,84,36,145,67,73,5,111,69,42,7,7,35,20,15
"2021","Barnsley 024A","E01007427",731,216,93,123,493,71,272,110,121,41,90,38,46,6,58,29,29,2,2,22,9,13
"2021","Barnsley 024B","E01007428",692,208,91,117,468,75,261,116,103,42,73,38,29,6,59,39,20,0,0,16,5,11
"2021","Barnsley 024C","E01007429",715,305,192,113,392,73,158,74,61,23,79,33,39,7,77,47,30,5,5,18,6,12
"2021","Barnsley 024D","E01007430",1137,255,91,164,853,92,467,149,264,54,174,89,74,11,116,84,32,4,4,29,12,17
"2021","Barnsley 024E","E01007431",580,136,68,68,425,86,218,88,95,35,67,30,34,3,53,29,24,1,1,19,8,11
"2021","Barnsley 024F","E01007432",698,162,91,71,514,79,284,114,116,54,85,35,42,8,66,46,20,0,0,22,11,11
"2021","Barnsley 025A","E01007364",594,180,76,104,382,51,164,51,58,55,95,39,45,11,68,42,26,4,4,32,24,8
"2021","Barnsley 025B","E01007365",510,159,71,88,332,29,121,43,47,31,93,43,40,10,85,48,37,4,4,19,12,7
"2021","Barnsley 025C","E01007366",972,240,100,140,700,99,329,146,123,60,176,80,87,9,94,68,26,2,2,32,19,13
"2021","Barnsley 025D","E01007367",464,120,53,67,315,29,138,64,44,30,77,26,45,6,67,47,20,4,4,29,15,14
"2021","Barnsley 025E","E01007368",733,231,85,146,469,46,210,82,84,44,103,47,49,7,106,73,33,4,4,33,23,10
"2021","Barnsley 026A","E01007451",824,265,89,176,524,40,214,85,87,42,128,62,57,9,136,95,41,6,6,35,14,21
"2021","Barnsley 026B","E01007452",695,168,57,111,503,51,235,84,103,48,130,67,55,8,87,66,21,0,0,24,7,17
"2021","Barnsley 026C","E01007453",717,216,112,104,472,52,190,74,70,46,113,38,65,10,113,79,34,4,4,29,19,10
"2021","Barnsley 026E","E01007455",635,172,119,53,451,94,213,106,60,47,96,51,35,10,48,24,24,0,0,12,6,6
"2021","Barnsley 026F","E01032924",637,157,25,132,444,26,225,76,118,31,124,62,52,10,64,45,19,5,5,36,14,22
"2021","Barnsley 026G","E01032925",651,231,101,130,392,47,164,61,58,45,102,50,42,10,71,48,23,8,8,28,4,24
"2021","Barnsley 027A","E01007421",598,126,69,57,443,110,240,110,82,48,60,36,21,3,31,15,16,2,2,29,9,20
"2021","Barnsley 027B","E01007422",648,159,89,70,465,90,252,97,119,36,68,32,30,6,52,25,27,3,3,24,10,14
"2021","Barnsley 027C","E01007423",721,196,112,84,503,110,264,105,109,50,81,37,37,7,46,23,23,2,2,22,10,12
"2021","Barnsley 027D","E01007426",813,201,101,100,571,111,306,126,123,57,98,63,32,3,54,30,24,2,2,41,20,21
"2021","Barnsley 028A","E01007396",756,282,113,169,446,58,178,72,71,35,120,66,48,6,89,56,33,1,1,28,11,17
"2021","Barnsley 028B","E01007397",699,241,138,103,433,83,180,74,68,38,85,39,35,11,84,45,39,1,1,25,10,15
"2021","Barnsley 028C","E01007398",770,246,161,85,501,151,208,96,77,35,80,38,37,5,60,33,27,2,2,23,13,10
"2021","Barnsley 028D","E01007399",931,308,112,196,595,68,272,109,92,71,174,96,71,7,79,51,28,2,2,28,16,12
"2021","Barnsley 028E","E01007424",824,204,110,94,599,82,299,111,138,50,135,73,56,6,80,47,33,3,3,21,7,14
"2021","Barnsley 029A","E01007388",780,244,87,157,508,54,246,102,92,52,125,67,50,8,82,57,25,1,1,28,11,17
"2021","Barnsley 029B","E01007393",869,347,151,196,491,60,219,89,89,41,123,74,41,8,86,50,36,3,3,31,17,14
"2021","Barnsley 029C","E01007394",583,165,80,85,396,32,187,83,66,38,93,38,43,12,80,46,34,4,4,22,11,11
"2021","Barnsley 029D","E01007456",784,217,94,123,539,86,267,118,99,50,120,60,51,9,65,41,24,1,1,28,12,16
"2021","Barnsley 029E","E01007457",758,219,90,129,507,54,239,74,124,41,102,44,46,12,109,75,34,3,3,32,14,18
"2021","Barnsley 030A","E01007389",667,203,132,71,451,139,214,112,53,49,46,28,13,5,51,25,26,1,1,13,6,7
"2021","Barnsley 030B","E01007390",662,189,87,102,462,95,223,89,71,63,80,37,38,5,64,44,20,0,0,11,7,4
"2021","Barnsley 030C","E01007391",700,244,115,129,434,65,194,89,68,37,91,41,41,9,82,55,27,2,2,22,10,12
"2021","Barnsley 030D","E01007392",615,160,50,110,427,44,162,73,57,32,119,51,62,6,98,65,33,4,4,28,18,10
"2021","Barnsley 030E","E01007395",837,227,97,130,571,43,242,104,100,38,142,46,86,10,141,101,40,3,3,39,24,15
"2021","Doncaster 001A","E01007632",622,145,61,84,438,35,231,88,74,69,91,33,49,9,78,60,18,3,3,39,18,21
"2021","Doncaster 001B","E01007633",530,129,53,76,365,31,170,51,71,48,77,30,43,4,84,63,21,3,3,36,20,16
"2021","Doncaster 001C","E01007634",678,163,70,93,474,45,192,67,91,34,87,31,47,9,143,113,30,7,7,41,24,17
"2021","Doncaster 001D","E01007635",845,240,101,139,584,95,241,96,100,45,129,63,58,8,117,89,28,2,2,21,10,11
"2021","Doncaster 002A","E01007487",695,198,98,100,471,71,186,70,69,47,83,38,41,4,127,70,57,4,4,26,13,13
"2021","Doncaster 002B","E01007488",694,181,96,85,472,104,253,113,92,48,81,43,31,7,30,17,13,4,4,41,21,20
"2021","Doncaster 002C","E01007489",928,274,87,187,609,68,276,118,100,58,138,70,65,3,123,88,35,4,4,45,19,26
"2021","Doncaster 002D","E01007490",703,155,66,89,519,88,254,110,86,58,96,48,40,8,80,55,25,1,1,29,12,17
"2021","Doncaster 002E","E01007491",665,170,59,111,462,42,188,50,94,44,107,41,53,13,124,93,31,1,1,33,24,9
"2021","Doncaster 002F","E01007492",728,280,136,144,426,54,132,46,50,36,99,28,61,10,137,108,29,4,4,22,11,11
"2021","Doncaster 002G","E01007493",719,182,91,91,516,91,288,103,124,61,84,41,36,7,52,30,22,1,1,21,10,11
"2021","Doncaster 003A","E01007636",659,186,102,84,433,49,182,63,89,30,91,28,53,10,107,70,37,4,4,40,19,21
"2021","Doncaster 003B","E01007637",663,181,93,88,446,100,205,94,65,46,78,36,35,7,61,38,23,2,2,36,14,22
"2021","Doncaster 003C","E01007638",716,259,110,149,420,77,148,57,61,30,89,45,38,6,98,58,40,8,8,37,13,24
"2021","Doncaster 003D","E01007639",1050,448,195,253,559,84,244,103,101,40,122,71,45,6,100,56,44,9,9,43,18,25
"2021","Doncaster 003E","E01007640",748,245,138,107,474,125,243,111,78,54,73,42,29,2,31,15,16,2,2,29,16,13
"2021","Doncaster 003F","E01007641",593,140,64,76,430,56,213,93,67,53,89,41,43,5,70,43,27,2,2,23,13,10
"2021","Doncaster 003G","E01007642",640,170,81,89,434,52,182,57,83,42,93,29,51,13,105,77,28,2,2,36,13,23
"2021","Doncaster 004A","E01007625",605,131,67,64,445,98,230,99,73,58,73,46,25,2,43,26,17,1,1,29,10,19
"2021","Doncaster 004B","E01007626",682,229,60,169,425,50,175,73,63,39,101,45,53,3,91,60,31,8,8,28,18,10
"2021","Doncaster 004C","E01007627",684,216,114,102,431,61,176,66,73,37,90,26,55,9,96,64,32,8,8,37,22,15
"2021","Doncaster 004D","E01007628",530,148,62,86,344,28,128,46,56,26,84,27,46,11,100,70,30,4,4,38,24,14
"2021","Doncaster 004E","E01007629",642,196,85,111,409,49,126,52,47,27,79,24,46,9,150,121,29,5,5,37,21,16
"2021","Doncaster 005A","E01007468",595,174,128,46,397,146,176,92,49,35,50,28,16,6,23,11,12,2,2,24,9,15
"2021","Doncaster 005B","E01007469",525,132,68,64,366,56,179,79,67,33,72,33,31,8,58,42,16,1,1,27,11,16
"2021","Doncaster 005C","E01007470",534,107,48,59,396,30,150,55,58,37,115,41,64,10,98,71,27,3,3,31,14,17
"2021","Doncaster 005D","E01007472",604,214,108,106,363,25,146,63,52,31,83,32,45,6,100,70,30,9,9,27,16,11
"2021","Doncaster 005E","E01007473",593,167,63,104,401,33,165,62,63,40,93,39,48,6,100,64,36,10,10,25,13,12
"2021","Doncaster 005F","E01007474",610,264,148,116,325,64,110,56,33,21,69,39,26,4,78,46,32,4,4,21,9,12
"2021","Doncaster 006A","E01007554",683,209,73,136,457,57,239,102,95,42,93,45,43,5,67,35,32,1,1,17,9,8
"2021","Doncaster 006B","E01007555",618,245,132,113,348,69,130,57,47,26,62,24,33,5,83,60,23,4,4,25,12,13
"2021","Doncaster 006C","E01007556",534,137,51,86,372,17,157,64,56,37,80,19,54,7,114,90,24,4,4,25,12,13
"2021","Doncaster 006D","E01007561",557,123,78,45,417,102,194,83,70,41,71,40,25,6,49,31,18,1,1,17,5,12
"2021","Doncaster 006E","E01007562",611,190,87,103,409,71,192,91,64,37,80,39,39,2,63,39,24,3,3,12,3,9
"2021","Doncaster 006F","E01007563",552,133,43,90,393,29,162,61,74,27,86,24,56,6,110,90,20,6,6,26,13,13
"2021","Doncaster 007A","E01007621",572,135,66,69,415,51,228,73,95,60,74,25,43,6,61,43,18,1,1,22,10,12
"2021","Doncaster 007B","E01007622",659,217,129,88,424,98,215,91,87,37,56,27,27,2,52,35,17,3,3,18,7,11
"2021","Doncaster 007C","E01007623",633,277,149,128,345,71,148,62,54,32,54,25,25,4,72,44,28,0,0,11,4,7
"2021","Doncaster 007D","E01007624",839,221,95,126,593,90,281,95,136,50,134,80,48,6,82,50,32,6,6,25,17,8
"2021","Doncaster 007E","E01007630",647,227,157,70,402,117,177,84,53,40,62,31,24,7,44,30,14,2,2,18,11,7
"2021","Doncaster 007F","E01007631",540,119,84,35,408,151,186,86,72,28,38,23,12,3,33,12,21,0,0,13,6,7
"2021","Doncaster 008A","E01007553",737,223,115,108,488,105,238,105,96,37,86,56,25,5,58,33,25,1,1,26,7,19
"2021","Doncaster 008B","E01007557",455,125,71,54,309,68,162,69,62,31,54,23,24,7,24,15,9,1,1,21,9,12
"2021","Doncaster 008C","E01007558",617,160,87,73,435,81,201,88,68,45,85,30,47,8,64,37,27,4,4,22,8,14
"2021","Doncaster 008D","E01007559",431,122,64,58,279,72,131,61,43,27,47,28,16,3,28,10,18,1,1,30,17,13
"2021","Doncaster 008E","E01007560",725,190,99,91,519,125,243,109,94,40,94,47,42,5,57,36,21,0,0,16,12,4
"2021","Doncaster 009A","E01007464",605,162,64,98,410,48,157,59,65,33,94,43,42,9,109,66,43,2,2,33,18,15
"2021","Doncaster 009B","E01007465",754,262,84,178,465,51,210,67,93,50,122,39,76,7,82,48,34,0,0,27,16,11
"2021","Doncaster 009C","E01007466",776,176,50,126,561,30,178,67,67,44,173,79,85,9,172,133,39,8,8,39,26,13
"2021","Doncaster 009D","E01007467",648,192,77,115,408,34,185,83,67,35,99,49,44,6,84,48,36,6,6,48,12,36
"2021","Doncaster 009E","E01007471",602,142,65,77,434,63,235,105,77,53,89,52,33,4,46,26,20,1,1,26,6,20
"2021","Doncaster 009F","E01007504",609,185,81,104,391,46,162,67,60,35,84,43,35,6,93,65,28,6,6,33,11,22
"2021","Doncaster 009G","E01007507",481,105,42,63,331,17,131,34,58,39,60,24,34,2,117,83,34,6,6,45,14,31
"2021","Doncaster 010A","E01007506",711,196,56,140,456,23,206,75,87,44,116,45,60,11,109,79,30,2,2,59,29,30
"2021","Doncaster 010B","E01007508",687,224,76,148,421,30,122,43,49,30,97,41,50,6,167,124,43,5,5,42,19,23
"2021","Doncaster 010C","E01007509",799,333,133,200,430,44,121,54,45,22,121,61,48,12,137,90,47,7,7,36,9,27
"2021","Doncaster 010D","E01007510",760,333,120,213,402,39,163,64,67,32,86,44,34,8,107,73,34,7,7,25,13,12
"2021","Doncaster 010E","E01007511",607,164,74,90,393,47,149,56,66,27,84,31,46,7,110,82,28,3,3,50,25,25
"2021","Doncaster 011A","E01007475",632,161,67,94,452,73,234,101,90,43,80,40,38,2,61,38,23,4,4,19,8,11
"2021","Doncaster 011B","E01007476",754,223,127,96,505,71,238,82,113,43,104,44,54,6,89,56,33,3,3,26,17,9
"2021","Doncaster 011C","E01007477",617,174,95,79,432,89,198,86,76,36,77,34,32,11,68,35,33,0,0,11,1,10
"2021","Doncaster 011D","E01007478",695,187,98,89,478,89,208,74,84,50,106,44,53,9,69,45,24,6,6,30,15,15
"2021","Doncaster 012A","E01007512",867,240,112,128,601,47,273,101,125,47,163,73,77,13,115,77,38,3,3,26,13,13
"2021","Doncaster 012B","E01007513",686,259,153,106,402,73,169,61,65,43,88,42,40,6,70,43,27,2,2,25,13,12
"2021","Doncaster 012C","E01007515",638,204,97,107,415,45,187,68,75,44,86,36,41,9,93,58,35,4,4,19,9,10
"2021","Doncaster 012D","E01007518",622,155,88,67,447,65,238,109,79,50,89,40,42,7,52,29,23,3,3,20,5,15
"2021","Doncaster 012E","E01007519",557,184,56,128,348,22,152,68,63,21,96,39,48,9,76,44,32,2,2,25,16,9
"2021","Doncaster 013A","E01007505",701,209,109,100,465,121,218,95,91,32,70,34,32,4,56,30,26,0,0,27,11,16
"2021","Doncaster 013B","E01007514",698,255,54,201,408,28,120,52,47,21,117,58,54,5,134,89,45,9,9,35,16,19
"2021","Doncaster 013C","E01007516",640,218,102,116,406,57,183,64,72,47,101,47,47,7,61,37,24,4,4,16,9,7
"2021","Doncaster 013D","E01007517",713,281,53,228,393,33,122,51,45,26,113,67,38,8,117,87,30,8,8,39,14,25
"2021","Doncaster 014A","E01007479",681,212,108,104,431,75,171,74,59,38,94,47,42,5,88,53,35,3,3,38,20,18
"2021","Doncaster 014B","E01007480",551,118,54,64,388,26,184,53,82,49,92,36,50,6,83,53,30,3,3,45,28,17
"2021","Doncaster 014D","E01007482",669,302,145,157,335,59,129,66,41,22,82,42,38,2,59,34,25,6,6,32,11,21
"2021","Doncaster 014E","E01033259",667,171,52,119,467,37,218,62,113,43,124,58,60,6,86,64,22,2,2,29,17,12
"2021","Doncaster 014F","E01033260",647,166,37,129,442,21,210,74,104,32,121,47,67,7,88,56,32,2,2,39,21,18
"2021","Doncaster 015A","E01007570",637,188,115,73,423,93,195,82,67,46,88,43,38,7,46,25,21,1,1,26,13,13
"2021","Doncaster 015B","E01007650",839,366,159,207,439,89,196,76,69,51,87,40,39,8,60,33,27,7,7,34,18,16
"2021","Doncaster 015C","E01007651",696,157,46,111,494,26,219,64,110,45,103,40,56,7,138,93,45,8,8,45,26,19
"2021","Doncaster 015D","E01007652",837,259,96,163,537,36,250,68,132,50,118,44,62,12,125,88,37,8,8,41,17,24
"2021","Doncaster 015E","E01007653",642,179,60,119,410,39,212,71,101,40,96,48,45,3,59,32,27,4,4,53,28,25
"2021","Doncaster 015F","E01007656",670,174,88,86,455,61,193,66,80,47,80,29,43,8,114,70,44,7,7,41,22,19
"2021","Doncaster 016A","E01007581",619,163,91,72,448,94,244,106,86,52,60,32,20,8,48,32,16,2,2,8,2,6
"2021","Doncaster 016B","E01007582",615,177,75,102,419,62,211,83,81,47,84,44,36,4,62,39,23,0,0,19,6,13
"2021","Doncaster 016C","E01007588",690,185,111,74,488,63,210,62,89,59,115,46,61,8,99,64,35,1,1,17,9,8
"2021","Doncaster 016D","E01007589",732,222,123,99,486,106,237,90,99,48,91,39,45,7,51,27,24,1,1,24,9,15
"2021","Doncaster 017A","E01007483",606,187,97,90,401,82,202,98,64,40,70,33,32,5,46,27,19,1,1,18,9,9
"2021","Doncaster 017B","E01007484",624,228,123,105,373,76,182,93,59,30,56,32,22,2,58,34,24,1,1,23,10,13
"2021","Doncaster 017C","E01007485",605,156,68,88,431,67,253,117,97,39,78,44,32,2,31,19,12,2,2,18,8,10
"2021","Doncaster 017D","E01007486",633,224,165,59,390,139,157,90,39,28,53,27,22,4,36,21,15,5,5,19,3,16
"2021","Doncaster 018A","E01007564",609,154,64,90,417,37,171,60,75,36,84,26,46,12,119,82,37,6,6,38,17,21
"2021","Doncaster 018B","E01007565",636,180,106,74,412,81,197,72,86,39,73,35,31,7,59,28,31,2,2,44,20,24
"2021","Doncaster 018C","E01007566",770,316,120,196,417,40,161,60,69,32,75,32,39,4,130,80,50,11,11,37,16,21
"2021","Doncaster 018D","E01007567",533,143,61,82,349,52,155,52,66,37,62,32,24,6,75,37,38,5,5,41,19,22
"2021","Doncaster 018E","E01007568",588,145,54,91,405,27,159,42,76,41,79,25,45,9,135,89,46,5,5,38,18,20
"2021","Doncaster 018F","E01007569",617,183,84,99,398,27,185,48,93,44,77,25,40,12,105,65,40,4,4,36,20,16
"2021","Doncaster 019A","E01007644",706,207,78,129,457,44,244,82,115,47,89,44,38,7,77,42,35,3,3,42,20,22
"2021","Doncaster 019B","E01007646",736,344,130,214,340,39,146,59,64,23,89,56,28,5,51,30,21,15,15,52,19,33
"2021","Doncaster 019C","E01007647",751,319,104,215,394,41,205,98,75,32,87,54,28,5,54,29,25,7,7,38,13,25
"2021","Doncaster 019E","E01007649",615,167,65,102,410,49,193,78,82,33,81,38,37,6,74,42,32,13,13,38,21,17
"2021","Doncaster 019F","E01007654",632,207,59,148,343,26,152,62,60,30,80,43,33,4,74,39,35,11,11,82,38,44
"2021","Doncaster 019G","E01034236",625,387,27,360,191,3,75,24,43,8,61,48,10,3,40,21,19,12,12,47,11,36
"2021","Doncaster 019H","E01034237",607,358,58,300,186,11,65,26,30,9,71,49,19,3,26,12,14,13,13,63,15,48
"2021","Doncaster 020A","E01007583",614,163,100,63,431,112,210,93,59,58,77,44,26,7,32,18,14,0,0,20,8,12
"2021","Doncaster 020B","E01007586",662,186,113,73,459,115,241,119,81,41,59,34,23,2,42,24,18,2,2,17,7,10
"2021","Doncaster 020C","E01007587",778,271,151,120,487,95,222,111,67,44,72,40,27,5,97,60,37,1,1,20,9,11
"2021","Doncaster 020D","E01007620",714,174,98,76,518,133,249,101,84,64,88,51,34,3,47,25,22,1,1,22,8,14
"2021","Doncaster 021A","E01007584",692,234,105,129,427,68,179,65,74,40,112,60,50,2,65,34,31,3,3,31,10,21
"2021","Doncaster 021B","E01007585",650,189,91,98,438,49,216,90,88,38,95,41,49,5,77,45,32,1,1,23,9,14
"2021","Doncaster 021C","E01007617",642,156,101,55,475,145,230,86,90,54,57,28,26,3,41,19,22,2,2,11,7,4
"2021","Doncaster 021D","E01007618",507,118,75,43,373,89,177,77,68,32,60,27,27,6,45,26,19,2,2,16,7,9
"2021","Doncaster 021E","E01007619",744,157,97,60,574,118,345,110,177,58,74,35,31,8,35,18,17,2,2,13,9,4
"2021","Doncaster 022A","E01007529",653,265,81,184,322,17,113,38,62,13,82,33,43,6,89,63,26,21,21,66,38,28
"2021","Doncaster 022B","E01007530",664,239,46,193,367,12,155,46,91,18,92,49,41,2,94,72,22,14,14,58,31,27
"2021","Doncaster 022C","E01007531",767,344,132,212,366,39,136,54,61,21,106,66,34,6,74,50,24,11,11,57,29,28
"2021","Doncaster 022D","E01007643",629,186,72,114,390,21,146,38,83,25,69,24,37,8,150,109,41,4,4,53,30,23
"2021","Doncaster 022F","E01007655",1023,470,59,411,451,15,131,38,80,13,132,82,45,5,138,95,43,35,35,102,37,65
"2021","Doncaster 022G","E01034238",633,380,30,350,210,8,76,49,24,3,91,77,13,1,21,12,9,14,14,43,11,32
"2021","Doncaster 022H","E01034239",600,206,66,140,317,13,130,50,63,17,68,34,30,4,82,58,24,24,24,77,29,48
"2021","Doncaster 023A","E01007494",699,258,73,185,404,28,204,100,67,37,93,49,40,4,75,53,22,4,4,37,16,21
"2021","Doncaster 023B","E01007532",937,514,113,401,385,14,159,40,104,15,108,64,41,3,94,61,33,10,10,38,15,23
"2021","Doncaster 023C","E01007533",661,216,105,111,404,32,157,68,61,28,106,37,64,5,101,70,31,8,8,41,8,33
"2021","Doncaster 023D","E01007535",633,211,53,158,334,25,133,39,64,30,88,41,40,7,74,48,26,14,14,88,27,61
"2021","Doncaster 024A","E01007522",737,323,141,182,387,46,146,65,54,27,85,40,37,8,107,79,28,3,3,27,14,13
"2021","Doncaster 024B","E01007525",668,211,114,97,417,49,153,62,57,34,104,42,54,8,108,61,47,3,3,40,18,22
"2021","Doncaster 024C","E01007528",627,224,128,96,372,43,152,47,79,26,83,25,50,8,92,63,29,2,2,31,10,21
"2021","Doncaster 024D","E01007604",574,131,89,42,416,107,203,93,64,46,65,31,31,3,37,21,16,4,4,27,14,13
"2021","Doncaster 025A","E01007521",593,153,98,55,416,81,215,78,96,41,66,30,31,5,53,31,22,1,1,24,10,14
"2021","Doncaster 025B","E01007523",665,221,124,97,419,90,213,73,88,52,69,34,35,0,46,27,19,1,1,25,14,11
"2021","Doncaster 025C","E01007524",709,235,128,107,438,108,238,92,94,52,52,30,18,4,39,25,14,1,1,36,17,19
"2021","Doncaster 025D","E01007526",866,240,120,120,575,108,304,109,134,61,95,61,28,6,64,27,37,4,4,51,24,27
"2021","Doncaster 025E","E01007607",633,196,95,101,414,68,178,54,84,40,67,30,33,4,95,66,29,6,6,23,10,13
"2021","Doncaster 026A","E01007599",736,163,98,65,547,133,290,118,126,46,64,30,30,4,56,33,23,4,4,26,19,7
"2021","Doncaster 026B","E01007600",604,142,89,53,451,135,227,113,72,42,43,21,18,4,45,22,23,1,1,11,5,6
"2021","Doncaster 026C","E01007601",705,205,135,70,479,122,236,104,94,38,68,38,27,3,53,30,23,0,0,21,7,14
"2021","Doncaster 026D","E01007602",814,186,87,99,601,103,325,105,157,63,95,53,40,2,76,53,23,2,2,27,17,10
"2021","Doncaster 026E","E01007603",677,187,89,98,469,82,261,114,103,44,89,58,20,11,37,21,16,0,0,21,7,14
"2021","Doncaster 027A","E01007520",590,157,123,34,417,148,207,85,71,51,23,14,9,0,38,17,21,1,1,16,5,11
"2021","Doncaster 027C","E01007605",649,173,115,58,447,118,256,131,83,42,42,24,17,1,29,9,20,2,2,29,12,17
"2021","Doncaster 027D","E01007606",882,182,80,102,666,134,383,132,191,60,108,70,32,6,37,20,17,4,4,34,19,15
"2021","Doncaster 027E","E01034240",669,220,39,181,418,41,216,95,98,23,91,68,21,2,63,43,20,7,7,31,11,20
"2021","Doncaster 027F","E01034241",567,144,54,90,396,63,217,84,102,31,66,37,27,2,44,29,15,6,6,27,14,13
"2021","Doncaster 028A","E01007495",747,257,86,171,444,36,180,70,74,36,98,45,47,6,113,77,36,17,17,46,20,26
"2021","Doncaster 028B","E01007500",550,194,111,83,325,37,123,47,49,27,75,29,39,7,86,50,36,4,4,31,13,18
"2021","Doncaster 028D","E01007534",945,408,50,358,440,19,131,40,80,11,165,105,57,3,103,73,30,22,22,97,30,67
"2021","Doncaster 028E","E01034242",669,126,5,121,506,9,241,76,142,23,141,73,65,3,111,96,15,4,4,37,16,21
"2021","Doncaster 028F","E01034243",756,137,37,100,577,50,336,128,149,59,136,71,58,7,53,37,16,2,2,42,17,25
"2021","Doncaster 029A","E01007496",615,153,45,108,411,26,126,33,63,30,89,30,50,9,158,111,47,12,12,51,31,20
"2021","Doncaster 029B","E01007497",537,135,63,72,364,49,138,55,59,24,84,35,42,7,93,71,22,0,0,38,19,19
"2021","Doncaster 029C","E01007498",664,226,81,145,389,45,147,52,60,35,87,35,50,2,102,74,28,8,8,49,23,26
"2021","Doncaster 029D","E01007499",621,245,133,112,344,45,117,47,46,24,68,27,37,4,113,87,26,1,1,32,16,16
"2021","Doncaster 029E","E01007501",619,202,129,73,395,118,162,76,45,41,70,32,34,4,42,17,25,3,3,22,13,9
"2021","Doncaster 029F","E01007503",676,196,100,96,464,93,229,96,82,51,87,38,47,2,51,33,18,4,4,16,9,7
"2021","Doncaster 030A","E01007575",585,242,123,119,323,41,104,38,47,19,61,16,41,4,113,84,29,4,4,20,11,9
"2021","Doncaster 030B","E01007578",694,246,80,166,414,38,164,68,55,41,93,42,46,5,112,63,49,7,7,34,22,12
"2021","Doncaster 030C","E01007579",1195,311,86,225,832,65,356,138,162,56,222,111,98,13,180,147,33,9,9,52,25,27
"2021","Doncaster 030D","E01007580",604,184,110,74,401,123,171,75,48,48,52,27,23,2,53,26,27,2,2,19,5,14
"2021","Doncaster 031A","E01007571",761,240,82,158,481,50,190,85,60,45,128,55,65,8,109,85,24,4,4,40,7,33
"2021","Doncaster 031B","E01007572",576,140,83,57,411,89,173,89,47,37,76,33,39,4,73,54,19,0,0,25,12,13
"2021","Doncaster 031C","E01007573",649,255,90,165,364,36,121,40,50,31,95,32,52,11,111,76,35,1,1,30,20,10
"2021","Doncaster 031D","E01007574",627,223,70,153,379,29,134,56,48,30,96,45,40,11,114,80,34,6,6,25,10,15
"2021","Doncaster 031E","E01007576",651,217,74,143,410,44,182,88,55,39,102,51,42,9,75,47,28,7,7,24,14,10
"2021","Doncaster 031F","E01007577",692,322,73,249,347,28,110,48,40,22,109,51,51,7,92,71,21,8,8,23,4,19
"2021","Doncaster 032A","E01007536",870,319,90,229,525,67,224,110,81,33,130,73,52,5,101,66,35,3,3,26,11,15
"2021","Doncaster 032B","E01007542",944,362,125,237,532,53,187,80,73,34,151,80,62,9,138,96,42,3,3,50,29,21
"2021","Doncaster 032C","E01007543",673,265,147,118,379,66,158,73,47,38,67,27,32,8,82,48,34,6,6,29,13,16
"2021","Doncaster 032D","E01007544",753,312,136,176,419,44,142,65,54,23,97,33,58,6,132,89,43,4,4,22,10,12
"2021","Doncaster 033A","E01007546",604,190,86,104,389,47,171,91,54,26,72,38,27,7,95,68,27,4,4,25,12,13
"2021","Doncaster 033B","E01007551",712,198,96,102,497,100,241,88,99,54,97,45,46,6,58,29,29,1,1,17,9,8
"2021","Doncaster 033C","E01007552",599,186,100,86,395,78,184,73,66,45,76,37,33,6,56,36,20,1,1,18,7,11
"2021","Doncaster 033D","E01007613",696,167,99,68,494,107,277,139,88,50,70,38,25,7,36,14,22,4,4,35,18,17
"2021","Doncaster 034A","E01007545",602,205,64,141,378,34,186,97,60,29,89,50,32,7,69,50,19,0,0,19,6,13
"2021","Doncaster 034B","E01007547",639,215,63,152,399,40,155,55,54,46,93,45,43,5,108,79,29,3,3,25,12,13
"2021","Doncaster 034C","E01007548",756,181,48,133,534,19,230,85,120,25,153,77,71,5,128,99,29,4,4,41,31,10
"2021","Doncaster 034D","E01007549",704,310,155,155,355,56,146,73,39,34,72,29,37,6,77,41,36,4,4,39,20,19
"2021","Doncaster 034E","E01007550",689,184,118,66,477,57,218,77,84,57,80,31,42,7,114,62,52,8,8,28,21,7
"2021","Doncaster 035A","E01007537",693,197,85,112,472,72,228,97,82,49,84,37,39,8,86,54,32,2,2,24,10,14
"2021","Doncaster 035B","E01007538",598,141,77,64,430,42,215,75,70,70,91,26,56,9,80,45,35,2,2,27,11,16
"2021","Doncaster 035C","E01007539",558,153,51,102,378,25,154,52,63,39,81,29,42,10,115,90,25,3,3,27,13,14
"2021","Doncaster 035D","E01007540",651,157,64,93,465,64,223,87,97,39,92,27,56,9,82,58,24,4,4,29,13,16
"2021","Doncaster 035E","E01007541",683,229,113,116,426,62,150,62,57,31,86,35,43,8,123,89,34,5,5,28,13,15
"2021","Doncaster 036A","E01007591",613,173,90,83,411,55,192,82,71,39,77,30,41,6,81,50,31,6,6,29,13,16
"2021","Doncaster 036B","E01007594",838,209,72,137,596,78,311,131,143,37,121,69,45,7,82,57,25,4,4,33,17,16
"2021","Doncaster 036C","E01007596",507,103,65,38,384,113,206,97,62,47,45,27,16,2,20,6,14,0,0,20,10,10
"2021","Doncaster 036D","E01007598",683,187,101,86,471,118,206,112,62,32,89,43,42,4,54,33,21,4,4,25,9,16
"2021","Doncaster 037A","E01007590",488,122,46,76,336,34,148,59,58,31,82,28,43,11,71,39,32,1,1,30,12,18
"2021","Doncaster 037B","E01007592",662,196,85,111,423,37,146,54,60,32,100,38,55,7,138,94,44,2,2,43,22,21
"2021","Doncaster 037C","E01007593",808,196,62,134,559,31,214,77,102,35,180,99,75,6,127,72,55,7,7,53,22,31
"2021","Doncaster 037D","E01007595",631,209,98,111,390,51,155,71,48,36,101,41,56,4,81,44,37,2,2,32,12,20
"2021","Doncaster 037E","E01007597",675,233,108,125,422,30,149,62,64,23,119,31,81,7,124,90,34,0,0,20,13,7
"2021","Doncaster 038B","E01007609",1019,338,170,168,637,105,310,128,126,56,126,79,41,6,91,48,43,5,5,44,15,29
"2021","Doncaster 038C","E01007610",852,314,196,118,518,139,258,99,106,53,73,36,31,6,46,28,18,2,2,20,7,13
"2021","Doncaster 038D","E01034244",450,123,14,109,305,7,141,38,79,24,86,46,36,4,67,50,17,4,4,22,12,10
"2021","Doncaster 038E","E01034245",693,104,14,90,564,18,292,68,193,31,162,94,66,2,92,68,24,0,0,25,14,11
"2021","Doncaster 039A","E01007611",582,169,101,68,386,96,184,79,59,46,68,38,25,5,38,21,17,0,0,27,12,15
"2021","Doncaster 039B","E01007612",629,184,115,69,423,116,211,101,74,36,60,37,20,3,33,21,12,3,3,22,7,15
"2021","Doncaster 039C","E01007614",565,158,80,78,402,96,221,91,93,37,57,23,33,1,28,15,13,0,0,5,5,0
"2021","Doncaster 039D","E01007615",627,226,140,86,390,128,167,75,65,27,50,29,18,3,44,26,18,1,1,11,5,6
"2021","Doncaster 039E","E01007616",579,208,151,57,363,118,156,68,53,35,51,37,12,2,37,19,18,1,1,8,5,3
"2021","Rotherham 001B","E01007694",772,218,97,121,518,51,227,90,87,50,128,54,62,12,109,77,32,3,3,36,15,21
"2021","Rotherham 001C","E01007695",1110,260,103,157,820,86,428,130,230,68,185,88,81,16,115,85,30,6,6,30,11,19
"2021","Rotherham 001D","E01007697",700,228,123,105,444,45,171,65,67,39,114,39,60,15,110,72,38,4,4,28,10,18
"2021","Rotherham 001E","E01007698",647,194,79,115,432,68,211,96,66,49,88,51,29,8,60,38,22,5,5,21,12,9
"2021","Rotherham 001F","E01034246",779,252,84,168,502,55,205,74,79,52,126,57,61,8,109,76,33,7,7,25,15,10
"2021","Rotherham 001G","E01034247",752,120,11,109,600,15,333,91,216,26,159,63,90,6,90,69,21,3,3,32,19,13
"2021","Rotherham 002A","E01007816",727,223,92,131,477,74,225,72,98,55,90,39,41,10,88,59,29,0,0,27,11,16
"2021","Rotherham 002B","E01007817",639,191,108,83,426,68,195,76,87,32,86,33,44,9,76,43,33,1,1,22,9,13
"2021","Rotherham 002C","E01007819",629,158,115,43,441,82,222,75,88,59,71,22,44,5,60,39,21,6,6,30,11,19
"2021","Rotherham 002D","E01007820",765,240,69,171,488,41,213,73,95,45,118,60,50,8,112,85,27,4,4,37,18,19
"2021","Rotherham 002E","E01007821",681,227,120,107,425,71,205,82,73,50,84,35,46,3,64,43,21,1,1,29,12,17
"2021","Rotherham 002F","E01007822",840,274,147,127,532,67,206,82,85,39,101,47,45,9,152,113,39,6,6,34,20,14
"2021","Rotherham 003A","E01007796",559,221,119,102,316,45,87,33,37,17,81,29,44,8,100,65,35,3,3,22,8,14
"2021","Rotherham 003B","E01007797",575,177,72,105,388,83,162,71,54,37,64,26,35,3,79,50,29,0,0,10,3,7
"2021","Rotherham 003C","E01007798",703,171,95,76,518,111,240,102,83,55,123,84,36,3,44,23,21,0,0,14,8,6
"2021","Rotherham 003D","E01007799",647,204,115,89,418,82,157,63,61,33,96,30,51,15,79,55,24,4,4,25,12,13
"2021","Rotherham 003E","E01007800",742,311,105,206,399,59,163,70,60,33,91,44,34,13,82,55,27,4,4,32,11,21
"2021","Rotherham 003F","E01007818",670,162,84,78,489,106,246,88,117,41,86,32,46,8,48,28,20,3,3,19,9,10
"2021","Rotherham 004A","E01007777",890,217,87,130,639,50,263,96,127,40,212,106,93,13,109,83,26,5,5,34,16,18
"2021","Rotherham 004B","E01007793",642,228,93,135,389,63,183,72,63,48,73,29,36,8,68,39,29,2,2,25,8,17
"2021","Rotherham 004C","E01007794",545,142,69,73,376,51,148,56,59,33,80,31,41,8,91,66,25,6,6,27,13,14
"2021","Rotherham 004D","E01007795",635,165,88,77,460,111,254,145,57,52,64,41,22,1,30,16,14,1,1,10,2,8
"2021","Rotherham 005A","E01007778",588,131,76,55,446,81,255,118,70,67,69,24,36,9,41,20,21,0,0,11,7,4
"2021","Rotherham 005B","E01007779",850,263,86,177,548,65,225,77,114,34,159,81,68,10,98,62,36,1,1,39,18,21
"2021","Rotherham 005C","E01007780",610,168,85,83,424,73,196,84,70,42,80,35,41,4,72,42,30,3,3,18,10,8
"2021","Rotherham 005D","E01007781",660,221,94,127,422,55,171,67,68,36,87,29,47,11,106,67,39,3,3,17,10,7
"2021","Rotherham 005E","E01007782",600,151,70,81,410,50,143,57,51,35,98,34,43,21,115,71,44,4,4,39,18,21
"2021","Rotherham 006A","E01007771",604,165,84,81,422,74,189,92,63,34,88,48,32,8,66,39,27,5,5,17,6,11
"2021","Rotherham 006B","E01007772",567,152,50,102,387,43,164,62,70,32,96,38,52,6,79,56,23,5,5,28,15,13
"2021","Rotherham 006C","E01007773",607,188,80,108,397,26,173,73,69,31,105,43,53,9,92,59,33,1,1,22,12,10
"2021","Rotherham 006D","E01007774",608,161,52,109,419,41,173,64,77,32,113,48,58,7,91,60,31,1,1,28,14,14
"2021","Rotherham 007A","E01007696",662,217,118,99,427,92,216,106,63,47,70,45,21,4,48,25,23,1,1,18,9,9
"2021","Rotherham 007B","E01007801",623,149,78,71,454,73,255,101,99,55,75,38,33,4,46,26,20,5,5,20,12,8
"2021","Rotherham 007C","E01007802",570,155,81,74,403,87,208,96,66,46,80,41,30,9,28,14,14,0,0,12,7,5
"2021","Rotherham 007D","E01007803",548,148,65,83,375,69,158,66,59,33,77,39,32,6,70,40,30,1,1,25,9,16
"2021","Rotherham 007E","E01007808",587,135,79,56,442,82,258,125,83,50,71,45,24,2,29,11,18,2,2,10,3,7
"2021","Rotherham 008A","E01007775",547,160,69,91,359,26,119,41,53,25,89,29,52,8,121,94,27,4,4,28,14,14
"2021","Rotherham 008B","E01007776",692,233,85,148,441,56,183,76,74,33,89,38,40,11,108,75,33,5,5,18,8,10
"2021","Rotherham 008C","E01007783",893,421,174,247,442,74,176,86,55,35,93,43,44,6,96,64,32,3,3,30,18,12
"2021","Rotherham 008D","E01007784",788,328,61,267,430,36,178,77,75,26,115,64,45,6,97,64,33,4,4,30,12,18
"2021","Rotherham 009A","E01007728",497,141,82,59,331,67,134,59,47,28,72,25,36,11,51,25,26,7,7,25,13,12
"2021","Rotherham 009B","E01007729",846,412,125,287,410,67,134,76,31,27,94,46,39,9,109,62,47,6,6,24,10,14
"2021","Rotherham 009C","E01007730",703,308,94,214,373,51,140,67,41,32,78,39,38,1,96,63,33,8,8,22,10,12
"2021","Rotherham 009D","E01007731",573,212,97,115,344,65,152,86,35,31,75,54,18,3,49,35,14,3,3,17,10,7
"2021","Rotherham 009E","E01007732",721,374,125,249,329,60,108,43,36,29,72,35,28,9,83,45,38,6,6,18,5,13
"2021","Rotherham 009F","E01007733",610,259,85,174,327,60,110,45,33,32,74,29,40,5,78,45,33,5,5,24,10,14
"2021","Rotherham 010A","E01007719",529,161,70,91,349,41,115,38,45,32,87,41,37,9,103,62,41,3,3,19,9,10
"2021","Rotherham 010B","E01007720",667,193,87,106,451,79,193,84,68,41,106,52,47,7,69,37,32,4,4,23,10,13
"2021","Rotherham 010C","E01007721",751,265,94,171,451,41,156,67,53,36,120,54,60,6,126,84,42,8,8,35,20,15
"2021","Rotherham 010D","E01007727",678,283,127,156,370,54,162,71,52,39,75,27,37,11,75,40,35,4,4,25,13,12
"2021","Rotherham 011A","E01007740",609,150,71,79,437,45,188,76,78,34,85,36,40,9,111,67,44,8,8,22,10,12
"2021","Rotherham 011B","E01007804",651,253,114,139,375,36,142,57,52,33,79,30,44,5,112,76,36,6,6,23,10,13
"2021","Rotherham 011C","E01007805",661,257,113,144,380,43,143,41,56,46,68,25,34,9,119,77,42,7,7,24,13,11
"2021","Rotherham 011D","E01007806",527,127,53,74,376,31,161,50,75,36,78,18,54,6,102,68,34,4,4,24,15,9
"2021","Rotherham 011E","E01007807",599,151,82,69,425,53,163,63,67,33,106,39,57,10,99,66,33,4,4,23,10,13
"2021","Rotherham 012A","E01007681",567,149,96,53,411,126,174,84,55,35,60,26,27,7,51,30,21,0,0,7,4,3
"2021","Rotherham 012B","E01007691",889,220,149,71,639,148,336,152,129,55,100,50,46,4,53,29,24,2,2,30,13,17
"2021","Rotherham 012C","E01007692",715,217,107,110,483,87,260,122,95,43,83,47,34,2,53,34,19,0,0,15,5,10
"2021","Rotherham 012E","E01032926",651,129,27,102,491,15,265,63,159,43,121,56,56,9,88,59,29,2,2,31,18,13
"2021","Rotherham 012F","E01032927",629,200,73,127,407,47,192,73,94,25,86,36,46,4,74,47,27,8,8,22,12,10
"2021","Rotherham 013A","E01007723",595,195,59,136,368,48,132,46,57,29,83,30,47,6,101,67,34,4,4,32,16,16
"2021","Rotherham 013B","E01007735",576,163,64,99,388,23,147,51,66,30,81,29,43,9,131,94,37,6,6,25,13,12
"2021","Rotherham 013C","E01007737",616,177,48,129,395,23,118,35,54,29,98,29,61,8,153,107,46,3,3,44,26,18
"2021","Rotherham 013D","E01007738",579,152,48,104,387,29,136,42,56,38,90,39,45,6,125,94,31,7,7,40,23,17
"2021","Rotherham 013E","E01007739",609,220,107,113,342,26,164,43,76,45,51,13,31,7,98,52,46,3,3,47,26,21
"2021","Rotherham 014A","E01007736",681,259,79,180,380,27,150,46,84,20,90,44,39,7,107,86,21,6,6,42,24,18
"2021","Rotherham 014B","E01007765",633,220,64,156,370,52,150,62,63,25,82,40,35,7,83,55,28,3,3,43,22,21
"2021","Rotherham 014C","E01007766",508,103,49,54,365,33,154,42,66,46,73,14,50,9,99,64,35,6,6,40,29,11
"2021","Rotherham 014D","E01007768",819,361,90,271,398,25,187,56,102,29,70,25,40,5,99,62,37,17,17,60,34,26
"2021","Rotherham 014E","E01007770",620,153,64,89,406,38,192,51,102,39,77,27,43,7,97,45,52,2,2,61,35,26
"2021","Rotherham 015A","E01007741",694,207,123,84,463,129,218,112,60,46,66,39,20,7,46,22,24,4,4,24,10,14
"2021","Rotherham 015B","E01007742",608,176,90,86,410,72,191,60,77,54,75,37,35,3,72,49,23,0,0,22,10,12
"2021","Rotherham 015C","E01007743",496,103,52,51,378,85,191,77,60,54,70,33,28,9,29,16,13,3,3,15,8,7
"2021","Rotherham 015D","E01007744",702,277,103,174,396,64,170,86,52,32,95,50,38,7,64,40,24,3,3,29,11,18
"2021","Rotherham 015E","E01007745",704,224,83,141,450,53,177,62,73,42,107,44,53,10,111,85,26,2,2,30,15,15
"2021","Rotherham 015F","E01007746",578,114,54,60,442,56,214,91,80,43,94,39,45,10,77,45,32,1,1,22,15,7
"2021","Rotherham 016A","E01007715",647,194,38,156,381,6,160,31,109,20,74,33,41,0,123,95,28,18,18,72,50,22
"2021","Rotherham 016B","E01007716",765,324,95,229,362,27,161,49,85,27,58,32,26,0,110,72,38,6,6,79,48,31
"2021","Rotherham 016C","E01007717",837,328,93,235,484,51,208,82,80,46,116,65,39,12,99,67,32,10,10,25,12,13
"2021","Rotherham 016D","E01007718",697,268,64,204,388,21,137,52,65,20,94,36,47,11,130,87,43,6,6,41,19,22
"2021","Rotherham 017A","E01007677",695,216,63,153,429,22,146,39,79,28,106,41,62,3,147,122,25,8,8,50,32,18
"2021","Rotherham 017B","E01007714",1147,634,94,540,425,31,163,59,86,18,132,88,40,4,84,64,20,15,15,88,32,56
"2021","Rotherham 017C","E01007767",625,263,56,207,316,45,147,59,61,27,63,41,21,1,55,31,24,6,6,46,32,14
"2021","Rotherham 017D","E01007769",601,188,30,158,341,1,166,39,110,17,73,21,48,4,86,67,19,15,15,72,53,19
"2021","Rotherham 018A","E01007685",598,148,78,70,431,87,212,96,76,40,80,46,25,9,50,23,27,2,2,19,10,9
"2021","Rotherham 018B","E01007754",522,98,31,67,404,46,248,98,90,60,72,39,24,9,38,24,14,0,0,20,7,13
"2021","Rotherham 018C","E01007755",583,163,68,95,405,77,207,88,74,45,72,42,21,9,47,33,14,2,2,15,6,9
"2021","Rotherham 018D","E01007756",596,150,86,64,431,90,241,102,84,55,65,36,23,6,35,21,14,0,0,15,9,6
"2021","Rotherham 018E","E01007761",697,221,121,100,451,57,182,72,72,38,110,43,59,8,99,59,40,3,3,25,12,13
"2021","Rotherham 018F","E01007762",598,170,101,69,412,85,182,75,62,45,91,48,37,6,50,29,21,4,4,16,10,6
"2021","Rotherham 019A","E01007682",554,142,69,73,388,50,178,77,69,32,73,29,42,2,82,50,32,5,5,24,8,16
"2021","Rotherham 019B","E01007683",585,162,85,77,412,106,186,72,70,44,69,32,32,5,50,31,19,1,1,11,5,6
"2021","Rotherham 019C","E01007686",741,298,222,76,433,158,186,76,64,46,49,27,15,7,38,21,17,2,2,10,4,6
"2021","Rotherham 019D","E01007688",657,181,130,51,456,113,205,72,89,44,69,26,36,7,66,39,27,3,3,20,10,10
"2021","Rotherham 019E","E01007725",494,119,49,70,358,44,215,86,83,46,56,23,30,3,43,27,16,0,0,17,8,9
"2021","Rotherham 019F","E01007726",724,289,146,143,410,44,151,62,61,28,94,48,41,5,116,85,31,5,5,25,13,12
"2021","Rotherham 020A","E01007757",680,179,98,81,474,88,220,94,62,64,98,33,56,9,66,33,33,2,2,27,11,16
"2021","Rotherham 020B","E01007758",622,184,80,104,414,53,170,51,80,39,108,41,56,11,78,45,33,5,5,24,10,14
"2021","Rotherham 020C","E01007759",673,232,101,131,418,65,146,70,46,30,100,38,51,11,105,66,39,2,2,23,11,12
"2021","Rotherham 020D","E01007760",735,268,59,209,444,34,133,45,52,36,108,52,47,9,165,121,44,4,4,23,13,10
"2021","Rotherham 020E","E01007763",698,284,106,178,384,47,136,47,46,43,97,47,42,8,99,70,29,5,5,30,15,15
"2021","Rotherham 020F","E01007764",719,202,89,113,484,42,161,58,65,38,114,37,68,9,165,132,33,2,2,33,17,16
"2021","Rotherham 021A","E01007708",748,273,135,138,442,54,178,60,83,35,90,37,47,6,117,68,49,3,3,33,15,18
"2021","Rotherham 021B","E01007709",608,138,95,43,449,98,226,73,113,40,87,37,40,10,38,18,20,0,0,21,8,13
"2021","Rotherham 021C","E01007710",649,151,97,54,471,120,225,80,103,42,80,43,31,6,41,19,22,5,5,27,18,9
"2021","Rotherham 021D","E01007711",673,138,83,55,497,99,281,95,140,46,75,46,25,4,41,20,21,1,1,38,16,22
"2021","Rotherham 021E","E01007724",591,129,76,53,442,87,220,84,97,39,70,33,31,6,63,41,22,2,2,20,6,14
"2021","Rotherham 021F","E01007734",771,289,153,136,449,44,158,56,65,37,95,35,50,10,147,91,56,5,5,33,20,13
"2021","Rotherham 023A","E01007675",684,181,82,99,426,54,228,52,129,47,74,34,34,6,66,25,41,4,4,77,50,27
"2021","Rotherham 023B","E01007678",610,151,99,52,413,123,227,72,113,42,35,17,11,7,23,9,14,5,5,46,29,17
"2021","Rotherham 023C","E01007679",761,254,105,149,440,59,230,70,113,47,60,32,27,1,89,48,41,2,2,67,38,29
"2021","Rotherham 023D","E01007680",708,254,84,170,377,46,198,55,106,37,61,43,16,2,68,46,22,4,4,77,57,20
"2021","Rotherham 023E","E01007712",746,179,93,86,523,96,305,79,162,64,73,37,34,2,47,29,18,2,2,44,33,11
"2021","Rotherham 023F","E01007713",632,153,116,37,443,127,232,71,111,50,47,28,16,3,36,16,20,1,1,36,24,12
"2021","Rotherham 025A","E01007676",742,211,102,109,501,101,182,85,57,40,97,50,42,5,116,70,46,5,5,30,18,12
"2021","Rotherham 025B","E01007702",698,175,75,100,489,54,200,77,81,42,118,53,57,8,113,79,34,4,4,34,21,13
"2021","Rotherham 025C","E01007703",496,113,80,33,369,71,179,60,69,50,68,27,33,8,49,24,25,2,2,14,10,4
"2021","Rotherham 025D","E01007704",731,257,107,150,451,68,224,96,95,33,102,47,47,8,52,30,22,5,5,23,6,17
"2021","Rotherham 025E","E01007705",610,145,84,61,442,84,216,77,85,54,85,49,30,6,56,28,28,1,1,23,13,10
"2021","Rotherham 025F","E01007707",662,185,116,69,462,127,215,95,66,54,68,26,30,12,50,29,21,2,2,15,11,4
"2021","Rotherham 026A","E01007666",577,139,72,67,426,103,211,112,59,40,70,39,25,6,40,19,21,2,2,12,8,4
"2021","Rotherham 026B","E01007809",752,281,108,173,449,55,154,65,53,36,100,32,59,9,135,92,43,5,5,22,12,10
"2021","Rotherham 026C","E01007810",1188,285,137,148,849,97,415,155,192,68,205,80,112,13,128,86,42,4,4,54,27,27
"2021","Rotherham 026D","E01007815",687,197,74,123,451,43,187,78,68,41,104,45,50,9,106,64,42,11,11,39,17,22
"2021","Rotherham 027B","E01007699",1099,252,70,182,811,59,379,130,207,42,248,125,100,23,120,94,26,5,5,36,19,17
"2021","Rotherham 027C","E01007700",800,203,74,129,570,55,309,102,160,47,122,67,48,7,83,54,29,1,1,27,9,18
"2021","Rotherham 027D","E01007701",710,233,93,140,461,61,194,61,89,44,97,42,46,9,107,64,43,2,2,16,5,11
"2021","Rotherham 027E","E01007706",559,125,39,86,409,73,186,80,68,38,74,35,34,5,72,38,34,4,4,25,10,15
"2021","Rotherham 027F","E01034248",587,92,9,83,482,5,267,70,186,11,163,103,60,0,44,39,5,3,3,13,10,3
"2021","Rotherham 027G","E01034249",599,118,48,70,467,49,240,74,125,41,144,84,56,4,32,19,13,2,2,14,10,4
"2021","Rotherham 027H","E01034250",407,88,29,59,300,31,142,44,74,24,74,36,30,8,50,25,25,3,3,19,10,9
"2021","Rotherham 028B","E01007788",698,212,95,117,465,91,202,88,67,47,103,58,37,8,69,49,20,0,0,21,9,12
"2021","Rotherham 028C","E01007789",754,306,130,176,421,58,162,85,48,29,109,50,51,8,89,64,25,3,3,27,12,15
"2021","Rotherham 028D","E01007792",486,78,44,34,385,60,235,98,74,63,57,23,28,6,32,16,16,1,1,23,8,15
"2021","Rotherham 028E","E01034251",489,125,70,55,345,93,158,80,44,34,61,36,23,2,33,14,19,0,0,19,8,11
"2021","Rotherham 028F","E01034252",876,234,68,166,618,48,284,97,148,39,168,86,72,10,112,86,26,6,6,24,16,8
"2021","Rotherham 029A","E01007657",585,126,70,56,438,89,216,93,82,41,73,38,30,5,57,31,26,3,3,21,6,15
"2021","Rotherham 029B","E01007659",480,133,66,67,330,75,149,54,60,35,63,32,24,7,42,20,22,1,1,17,8,9
"2021","Rotherham 029C","E01007785",551,128,72,56,397,57,177,69,65,43,95,39,41,15,64,42,22,4,4,26,15,11
"2021","Rotherham 029D","E01007786",490,129,71,58,348,92,149,50,67,32,62,25,33,4,45,31,14,0,0,13,5,8
"2021","Rotherham 029E","E01007790",763,321,116,205,413,43,120,44,57,19,114,43,61,10,131,96,35,5,5,29,22,7
"2021","Rotherham 029F","E01007791",559,163,65,98,364,33,150,50,51,49,95,30,59,6,83,55,28,3,3,32,18,14
"2021","Rotherham 030A","E01007667",637,172,72,100,445,46,204,73,90,41,110,45,59,6,84,63,21,1,1,20,8,12
"2021","Rotherham 030B","E01007668",677,229,110,119,421,45,144,53,59,32,96,35,55,6,134,83,51,2,2,27,13,14
"2021","Rotherham 030C","E01007669",644,185,124,61,446,121,197,74,75,48,78,35,35,8,46,30,16,4,4,13,7,6
"2021","Rotherham 030D","E01007670",614,145,92,53,439,102,228,89,94,45,77,39,31,7,30,18,12,2,2,30,19,11
"2021","Rotherham 030E","E01007672",582,134,83,51,432,102,215,81,96,38,77,30,38,9,37,16,21,1,1,16,6,10
"2021","Rotherham 030F","E01007673",673,214,113,101,434,59,164,63,67,34,105,46,48,11,103,77,26,3,3,25,16,9
"2021","Rotherham 031A","E01007671",831,193,81,112,622,90,321,104,155,62,115,45,58,12,94,59,35,2,2,16,14,2
"2021","Rotherham 031B","E01007674",887,227,118,109,639,106,341,100,176,65,124,68,47,9,66,40,26,2,2,21,10,11
"2021","Rotherham 031C","E01007747",555,170,88,82,361,53,155,56,62,37,73,22,45,6,75,45,30,5,5,24,15,9
"2021","Rotherham 031D","E01007750",682,152,93,59,505,120,239,100,86,53,86,46,37,3,59,34,25,1,1,25,12,13
"2021","Rotherham 032A","E01007658",608,133,66,67,449,68,231,90,98,43,99,52,45,2,51,27,24,0,0,26,10,16
"2021","Rotherham 032B","E01007660",509,115,82,33,385,87,196,88,65,43,57,28,28,1,44,18,26,1,1,9,4,5
"2021","Rotherham 032C","E01007661",611,129,86,43,465,110,224,82,105,37,78,27,43,8,51,31,20,2,2,17,10,7
"2021","Rotherham 032D","E01007662",487,171,93,78,300,46,99,29,40,30,60,23,32,5,94,60,34,1,1,16,6,10
"2021","Rotherham 032E","E01007663",673,184,122,62,478,143,219,92,76,51,60,30,26,4,55,35,20,1,1,11,6,5
"2021","Rotherham 032F","E01007664",838,238,160,78,579,183,265,114,95,56,77,42,30,5,53,27,26,1,1,21,11,10
"2021","Rotherham 033A","E01007748",654,176,114,62,464,147,216,96,78,42,52,24,21,7,48,25,23,1,1,14,3,11
"2021","Rotherham 033B","E01007749",785,225,107,118,530,92,282,101,137,44,84,39,40,5,70,41,29,2,2,30,14,16
"2021","Rotherham 033C","E01007751",974,283,114,169,660,65,299,105,157,37,169,79,83,7,122,83,39,5,5,31,17,14
"2021","Rotherham 033D","E01007752",634,153,90,63,469,107,249,91,102,56,75,40,30,5,36,23,13,2,2,12,7,5
"2021","Rotherham 033E","E01007753",683,180,113,67,488,98,242,102,93,47,91,39,39,13,55,27,28,2,2,15,12,3
"2021","Rotherham 034A","E01007684",763,212,73,139,522,59,253,80,116,57,111,50,55,6,96,59,37,3,3,29,13,16
"2021","Rotherham 034C","E01007687",705,210,118,92,478,108,251,97,101,53,71,25,40,6,47,30,17,1,1,17,8,9
"2021","Rotherham 034B","E01007689",661,182,111,71,454,71,268,95,121,52,67,30,30,7,48,28,20,0,0,25,12,13
"2021","Rotherham 034E","E01007690",753,206,128,78,526,156,268,99,104,65,61,31,25,5,40,28,12,1,1,21,12,9
"2021","Rotherham 034D","E01007811",574,166,99,67,388,75,201,92,69,40,69,40,28,1,42,21,21,1,1,20,10,10
"2021","Rotherham 034F","E01007812",530,175,87,88,331,47,144,51,59,34,62,23,31,8,74,39,35,4,4,24,12,12
"2021","Rotherham 034G","E01034253",1056,338,176,162,688,141,342,146,125,71,129,77,42,10,74,47,27,2,2,30,18,12
"2021","Sheffield 001A","E01008144",844,244,111,133,570,102,260,104,119,37,129,80,45,4,76,53,23,3,3,30,9,21
"2021","Sheffield 001B","E01008145",646,230,118,112,395,84,174,73,56,45,64,27,32,5,68,44,24,5,5,21,9,12
"2021","Sheffield 001C","E01008148",640,164,96,68,456,86,181,65,78,38,78,24,43,11,105,74,31,6,6,20,11,9
"2021","Sheffield 001D","E01008149",640,160,78,82,468,102,206,98,68,40,106,65,36,5,53,33,20,1,1,12,5,7
"2021","Sheffield 001E","E01008150",668,265,130,135,389,75,166,54,82,30,99,49,43,7,48,28,20,1,1,14,8,6
"2021","Sheffield 002A","E01008142",622,184,74,110,417,40,185,71,76,38,104,38,55,11,84,59,25,4,4,21,12,9
"2021","Sheffield 002B","E01008143",767,283,85,198,464,70,218,99,80,39,106,68,33,5,70,47,23,0,0,20,6,14
"2021","Sheffield 002C","E01008146",521,121,72,49,391,84,223,87,91,45,61,30,27,4,23,13,10,0,0,9,3,6
"2021","Sheffield 002D","E01008147",628,160,98,62,452,145,204,83,77,44,59,35,20,4,44,17,27,0,0,16,8,8
"2021","Sheffield 003A","E01007888",561,101,39,62,457,89,236,96,89,51,86,36,44,6,43,27,16,3,3,3,1,2
"2021","Sheffield 003B","E01007892",665,253,144,109,391,54,140,51,58,31,83,33,45,5,110,75,35,4,4,21,10,11
"2021","Sheffield 003C","E01007893",627,147,85,62,460,111,232,91,85,56,71,45,21,5,44,25,19,2,2,20,9,11
"2021","Sheffield 003D","E01007898",631,166,67,99,446,61,256,111,93,52,84,42,38,4,45,28,17,0,0,19,7,12
"2021","Sheffield 003E","E01007899",629,169,107,62,435,132,215,76,79,60,54,26,22,6,34,13,21,0,0,25,13,12
"2021","Sheffield 003F","E01007900",775,263,145,118,484,66,173,74,62,37,117,56,51,10,123,91,32,5,5,28,15,13
"2021","Sheffield 003G","E01007901",644,237,125,112,381,53,145,51,60,34,63,27,32,4,119,81,38,1,1,26,13,13
"2021","Sheffield 004A","E01007887",605,173,103,70,411,54,208,84,92,32,69,40,24,5,74,36,38,6,6,21,9,12
"2021","Sheffield 004B","E01007889",1087,253,118,135,799,108,467,152,229,86,142,70,63,9,77,45,32,5,5,35,10,25
"2021","Sheffield 004C","E01007890",582,133,71,62,435,123,220,82,92,46,59,36,21,2,33,17,16,0,0,14,4,10
"2021","Sheffield 004D","E01007891",664,168,127,41,480,151,238,101,91,46,58,30,24,4,33,11,22,0,0,16,2,14
"2021","Sheffield 004E","E01007894",636,214,91,123,402,72,180,63,77,40,96,60,34,2,53,34,19,1,1,20,6,14
"2021","Sheffield 004F","E01007895",645,207,111,96,409,93,157,62,47,48,75,39,22,14,83,43,40,1,1,29,6,23
"2021","Sheffield 004G","E01007896",553,137,93,44,403,98,205,82,68,55,55,33,19,3,45,20,25,0,0,13,7,6
"2021","Sheffield 005A","E01007897",623,177,113,64,439,153,193,75,65,53,63,35,23,5,29,13,16,1,1,7,5,2
"2021","Sheffield 005B","E01008134",600,204,123,81,373,95,177,75,59,43,70,40,23,7,30,18,12,1,1,23,10,13
"2021","Sheffield 005C","E01008135",763,260,109,151,475,99,220,110,71,39,105,48,49,8,49,34,15,2,2,28,8,20
"2021","Sheffield 005D","E01008137",631,167,94,73,451,134,218,98,76,44,68,44,20,4,30,14,16,1,1,13,3,10
"2021","Sheffield 005E","E01008141",666,171,101,70,465,118,240,99,98,43,70,43,24,3,37,16,21,0,0,30,17,13
"2021","Sheffield 006A","E01008053",570,192,73,119,347,56,138,51,59,28,80,37,40,3,69,43,26,4,4,31,14,17
"2021","Sheffield 006B","E01008056",594,170,70,100,406,52,177,63,74,40,87,30,48,9,84,56,28,6,6,18,11,7
"2021","Sheffield 006C","E01008058",744,218,119,99,499,63,238,82,107,49,113,49,53,11,81,37,44,4,4,27,14,13
"2021","Sheffield 006D","E01008138",628,295,185,110,311,56,152,48,63,41,54,22,27,5,47,22,25,2,2,22,4,18
"2021","Sheffield 006E","E01008139",696,238,100,138,439,91,183,56,82,45,86,49,36,1,78,39,39,1,1,19,8,11
"2021","Sheffield 007A","E01007856",544,156,60,96,359,24,132,49,51,32,87,39,41,7,111,71,40,5,5,29,12,17
"2021","Sheffield 007B","E01008054",553,149,60,89,378,25,138,42,61,35,80,29,49,2,130,90,40,5,5,26,16,10
"2021","Sheffield 007C","E01008055",628,177,55,122,429,29,137,50,59,28,86,23,53,10,170,132,38,7,7,22,10,12
"2021","Sheffield 007D","E01008057",608,161,69,92,423,26,167,42,86,39,113,24,77,12,112,83,29,5,5,24,12,12
"2021","Sheffield 008A","E01008126",659,139,89,50,511,131,267,100,121,46,68,35,28,5,43,24,19,2,2,9,3,6
"2021","Sheffield 008C","E01008128",734,163,73,90,538,106,320,128,140,52,80,41,33,6,31,21,10,1,1,33,12,21
"2021","Sheffield 008D","E01008136",582,152,76,76,410,70,193,62,96,35,71,33,31,7,74,47,27,2,2,20,8,12
"2021","Sheffield 008E","E01008140",852,295,124,171,524,80,260,94,129,37,102,53,44,5,79,47,32,3,3,33,15,18
"2021","Sheffield 008F","E01033275",670,204,57,147,445,48,244,76,137,31,93,50,40,3,58,38,20,2,2,21,7,14
"2021","Sheffield 008G","E01033280",604,113,53,60,472,66,285,107,143,35,82,41,32,9,38,25,13,1,1,19,5,14
"2021","Sheffield 009A","E01008085",583,199,82,117,371,31,117,40,45,32,108,37,58,13,113,77,36,2,2,13,9,4
"2021","Sheffield 009B","E01008086",590,166,66,100,397,39,117,40,49,28,113,45,57,11,126,91,35,2,2,27,13,14
"2021","Sheffield 009C","E01008116",536,165,78,87,339,20,125,44,52,29,87,29,39,19,105,64,41,2,2,32,18,14
"2021","Sheffield 009D","E01008117",773,256,83,173,475,29,180,61,90,29,148,66,77,5,113,75,38,5,5,42,18,24
"2021","Sheffield 009E","E01008118",613,211,102,109,382,43,136,55,49,32,92,28,54,10,109,78,31,2,2,20,10,10
"2021","Sheffield 009F","E01008119",513,133,49,84,354,31,135,53,59,23,95,28,57,10,88,59,29,5,5,26,15,11
"2021","Sheffield 009G","E01008125",615,160,83,77,432,67,194,66,89,39,81,27,41,13,85,52,33,5,5,23,10,13
"2021","Sheffield 010A","E01007849",871,302,103,199,526,46,241,53,133,55,89,45,38,6,144,84,60,6,6,43,21,22
"2021","Sheffield 010B","E01007857",683,197,87,110,456,50,185,60,93,32,71,23,39,9,146,91,55,4,4,30,18,12
"2021","Sheffield 010C","E01008059",648,172,67,105,449,37,194,55,106,33,88,35,47,6,130,84,46,0,0,27,11,16
"2021","Sheffield 010D","E01008060",630,165,77,88,437,34,142,43,71,28,97,40,50,7,156,116,40,8,8,28,14,14
"2021","Sheffield 011A","E01008061",650,184,80,104,437,30,193,59,106,28,84,37,37,10,122,81,41,8,8,29,18,11
"2021","Sheffield 011B","E01008063",685,303,93,210,361,60,186,67,72,47,56,35,17,4,56,36,20,3,3,21,8,13
"2021","Sheffield 011E","E01033277",1170,296,95,201,804,49,263,76,143,44,175,55,107,13,303,240,63,14,14,70,39,31
"2021","Sheffield 012A","E01008087",684,242,103,139,412,66,196,78,73,45,98,61,31,6,46,28,18,6,6,30,13,17
"2021","Sheffield 012B","E01008088",652,213,90,123,410,71,160,73,48,39,104,70,31,3,69,44,25,6,6,29,11,18
"2021","Sheffield 012C","E01008090",692,208,81,127,459,40,137,37,73,27,94,36,50,8,179,130,49,9,9,25,19,6
"2021","Sheffield 012D","E01008092",715,347,109,238,336,47,117,51,42,24,61,21,32,8,104,77,27,7,7,32,14,18
"2021","Sheffield 012E","E01008122",634,152,58,94,453,28,142,37,72,33,112,26,63,23,167,129,38,4,4,29,17,12
"2021","Sheffield 012F","E01008124",620,216,70,146,382,23,106,31,52,23,115,48,59,8,133,109,24,5,5,22,11,11
"2021","Sheffield 013A","E01007848",704,212,91,121,448,39,184,49,79,56,82,36,37,9,138,86,52,5,5,44,21,23
"2021","Sheffield 013B","E01007851",531,144,43,101,344,38,165,37,92,36,45,21,19,5,91,55,36,5,5,43,28,15
"2021","Sheffield 013C","E01007947",793,429,166,263,327,35,105,32,59,14,65,40,22,3,117,79,38,5,5,37,16,21
"2021","Sheffield 013D","E01007948",601,202,86,116,355,22,187,33,117,37,39,20,12,7,103,71,32,4,4,44,26,18
"2021","Sheffield 013E","E01008062",592,169,80,89,390,27,159,32,100,27,55,25,21,9,141,87,54,8,8,33,26,7
"2021","Sheffield 014A","E01007847",648,293,107,186,320,59,120,50,45,25,57,37,15,5,79,51,28,5,5,35,12,23
"2021","Sheffield 014B","E01007850",616,175,85,90,409,90,187,86,58,43,72,39,27,6,57,31,26,3,3,32,15,17
"2021","Sheffield 014C","E01007852",654,197,59,138,415,49,190,83,72,35,95,57,33,5,78,48,30,3,3,42,23,19
"2021","Sheffield 014D","E01007853",808,268,118,150,512,85,220,91,85,44,114,67,42,5,91,51,40,2,2,28,10,18
"2021","Sheffield 014E","E01007854",580,188,40,148,352,25,186,69,71,46,60,32,22,6,79,57,22,2,2,40,25,15
"2021","Sheffield 014F","E01007855",779,261,57,204,479,38,232,73,133,26,97,53,41,3,100,71,29,12,12,39,23,16
"2021","Sheffield 015A","E01007941",679,199,99,100,451,78,179,62,77,40,61,28,23,10,129,89,40,4,4,29,12,17
"2021","Sheffield 015B","E01007945",734,230,97,133,463,43,171,58,65,48,79,26,40,13,164,120,44,6,6,41,14,27
"2021","Sheffield 015C","E01007946",624,157,46,111,440,25,142,47,67,28,99,25,68,6,169,129,40,5,5,27,14,13
"2021","Sheffield 015D","E01007950",628,178,91,87,410,25,139,39,66,34,102,37,55,10,141,104,37,3,3,40,10,30
"2021","Sheffield 015E","E01008123",539,147,54,93,358,28,117,39,53,25,83,28,46,9,128,95,33,2,2,34,18,16
"2021","Sheffield 016A","E01007987",597,149,44,105,421,42,246,101,95,50,76,34,37,5,54,28,26,3,3,27,8,19
"2021","Sheffield 016B","E01007988",639,173,96,77,450,96,256,93,113,50,65,36,24,5,29,13,16,4,4,16,7,9
"2021","Sheffield 016C","E01007989",626,188,71,117,410,52,195,73,85,37,109,63,39,7,50,33,17,4,4,28,9,19
"2021","Sheffield 016D","E01007991",680,211,112,99,447,80,160,63,62,35,83,33,35,15,121,84,37,3,3,22,11,11
"2021","Sheffield 017A","E01007995",745,275,62,213,432,25,174,73,81,20,148,101,38,9,80,47,33,5,5,38,8,30
"2021","Sheffield 017B","E01008089",700,258,91,167,404,45,161,50,77,34,88,46,37,5,106,72,34,4,4,38,19,19
"2021","Sheffield 017C","E01008091",637,194,55,139,410,36,195,85,68,42,118,77,36,5,57,36,21,4,4,33,10,23
"2021","Sheffield 017D","E01008093",783,380,118,262,367,46,140,52,59,29,122,93,22,7,56,35,21,3,3,36,6,30
"2021","Sheffield 018A","E01007903",576,166,73,93,353,44,208,55,122,31,26,11,14,1,69,39,30,6,6,57,43,14
"2021","Sheffield 018B","E01007904",630,203,82,121,377,50,180,33,111,36,43,26,12,5,98,62,36,6,6,50,35,15
"2021","Sheffield 018C","E01007913",479,121,58,63,267,10,157,31,109,17,28,10,18,0,62,38,24,10,10,91,64,27
"2021","Sheffield 018D","E01007914",457,82,31,51,298,14,182,27,130,25,24,10,12,2,69,44,25,9,9,77,53,24
"2021","Sheffield 019A","E01007870",722,302,63,239,362,35,171,56,91,24,61,29,29,3,85,54,31,10,10,58,27,31
"2021","Sheffield 019B","E01007871",820,377,111,266,401,33,192,56,113,23,58,33,22,3,110,66,44,8,8,42,25,17
"2021","Sheffield 019C","E01007943",778,308,127,181,427,28,155,52,75,28,68,23,38,7,169,122,47,7,7,43,27,16
"2021","Sheffield 019D","E01008094",501,136,58,78,338,42,122,47,53,22,63,20,37,6,108,77,31,3,3,27,13,14
"2021","Sheffield 020A","E01007869",521,141,49,92,313,16,162,36,103,23,37,22,12,3,64,38,26,34,34,67,44,23
"2021","Sheffield 020B","E01007872",620,203,98,105,329,35,184,43,110,31,42,17,19,6,64,42,22,4,4,88,38,50
"2021","Sheffield 020C","E01007873",704,213,52,161,401,17,236,35,176,25,33,13,20,0,104,71,33,11,11,90,53,37
"2021","Sheffield 020D","E01007942",521,111,27,84,313,12,191,23,135,33,31,21,6,4,67,37,30,12,12,97,69,28
"2021","Sheffield 020E","E01007949",490,128,38,90,278,14,171,29,123,19,28,8,15,5,57,40,17,8,8,84,59,25
"2021","Sheffield 021A","E01007990",654,214,136,78,421,83,188,74,79,35,89,48,34,7,60,38,22,1,1,19,7,12
"2021","Sheffield 021B","E01007992",696,233,82,151,434,51,215,94,87,34,116,76,35,5,52,29,23,0,0,29,6,23
"2021","Sheffield 021C","E01007993",693,206,94,112,454,61,186,63,86,37,97,45,38,14,107,70,37,3,3,33,16,17
"2021","Sheffield 021D","E01007994",601,170,49,121,408,55,202,85,83,34,112,60,46,6,37,22,15,2,2,23,8,15
"2021","Sheffield 021E","E01007996",750,248,125,123,472,60,215,84,96,35,123,73,41,9,70,34,36,4,4,30,13,17
"2021","Sheffield 022A","E01007874",691,263,88,175,384,22,189,33,140,16,32,13,14,5,132,73,59,9,9,44,25,19
"2021","Sheffield 022B","E01007875",560,166,48,118,297,10,152,23,98,31,42,17,25,0,82,60,22,11,11,97,52,45
"2021","Sheffield 022E","E01007940",590,168,51,117,331,17,159,32,113,14,44,15,26,3,99,71,28,12,12,91,56,35
"2021","Sheffield 022G","E01033269",664,228,44,184,375,1,162,21,125,16,29,12,13,4,160,121,39,23,23,61,34,27
"2021","Sheffield 022H","E01033270",916,467,28,439,380,4,125,52,68,5,180,169,10,1,48,34,14,23,23,69,8,61
"2021","Sheffield 022I","E01034842",928,220,53,167,575,32,330,37,256,37,83,26,54,3,113,69,44,17,17,133,96,37
"2021","Sheffield 023A","E01008129",662,137,73,64,489,90,252,94,118,40,92,48,40,4,53,33,20,2,2,36,13,23
"2021","Sheffield 023B","E01008130",670,179,123,56,468,112,242,82,117,43,67,35,25,7,47,18,29,0,0,23,9,14
"2021","Sheffield 023C","E01008131",671,154,87,67,502,106,269,84,129,56,72,40,27,5,53,23,30,2,2,15,10,5
"2021","Sheffield 023D","E01008132",559,127,85,42,422,84,248,95,92,61,58,36,19,3,31,15,16,1,1,10,7,3
"2021","Sheffield 023E","E01008133",747,289,197,92,439,115,222,81,99,42,69,48,16,5,32,12,20,1,1,19,5,14
"2021","Sheffield 024A","E01008151",713,258,60,198,373,32,163,53,96,14,131,109,22,0,40,22,18,7,7,82,8,74
"2021","Sheffield 024B","E01008153",835,325,78,247,471,44,195,84,87,24,168,128,34,6,61,37,24,3,3,39,6,33
"2021","Sheffield 024C","E01008154",817,310,116,194,476,61,191,79,87,25,123,98,20,5,94,51,43,7,7,31,7,24
"2021","Sheffield 024D","E01008155",716,272,76,196,382,28,146,66,61,19,147,111,33,3,55,32,23,6,6,62,7,55
"2021","Sheffield 024E","E01008156",693,194,84,110,472,72,239,121,86,32,111,76,31,4,46,19,27,4,4,27,5,22
"2021","Sheffield 024F","E01008160",648,228,112,116,391,53,172,77,66,29,118,83,29,6,41,27,14,7,7,29,9,20
"2021","Sheffield 025A","E01007997",673,174,110,64,487,95,252,84,120,48,84,38,35,11,53,32,21,3,3,12,7,5
"2021","Sheffield 025B","E01007998",817,435,189,246,366,74,145,43,63,39,66,36,22,8,72,51,21,9,9,16,9,7
"2021","Sheffield 025C","E01008152",660,221,100,121,423,71,203,85,86,32,85,48,32,5,64,43,21,0,0,16,7,9
"2021","Sheffield 025D","E01008158",719,246,110,136,451,95,144,58,55,31,83,36,43,4,123,81,42,6,6,22,7,15
"2021","Sheffield 026A","E01008065",981,514,122,392,393,14,210,51,135,24,63,41,18,4,94,69,25,12,12,74,18,56
"2021","Sheffield 026B","E01008068",688,310,52,258,295,8,136,19,101,16,42,24,15,3,95,60,35,14,14,83,17,66
"2021","Sheffield 026C","E01008072",728,298,87,211,378,33,183,70,99,14,74,59,15,0,80,46,34,8,8,52,10,42
"2021","Sheffield 026D","E01008157",866,444,212,232,374,56,142,60,59,23,84,57,21,6,86,41,45,6,6,48,15,33
"2021","Sheffield 026E","E01008161",812,289,79,210,462,52,195,78,77,40,141,104,35,2,69,44,25,5,5,61,14,47
"2021","Sheffield 027A","E01007883",580,131,41,90,380,12,199,27,146,26,38,14,19,5,123,91,32,8,8,69,48,21
"2021","Sheffield 027B","E01007902",687,274,115,159,357,45,181,41,123,17,43,20,20,3,77,49,28,11,11,56,34,22
"2021","Sheffield 027C","E01007905",581,115,16,99,384,7,218,23,170,25,42,12,28,2,107,71,36,10,10,82,56,26
"2021","Sheffield 027D","E01007906",828,181,71,110,537,24,324,36,242,46,45,19,23,3,134,95,39,10,10,110,78,32
"2021","Sheffield 028A","E01008064",626,168,51,117,289,20,122,52,58,12,108,87,19,2,35,20,15,4,4,169,3,166
"2021","Sheffield 028B","E01008066",447,100,19,81,135,17,51,16,28,7,45,34,8,3,17,7,10,5,5,212,3,209
"2021","Sheffield 028C","E01008069",539,119,38,81,210,18,86,37,37,12,80,62,18,0,16,8,8,10,10,210,2,208
"2021","Sheffield 028D","E01008074",537,121,42,79,322,25,140,42,82,16,118,98,20,0,34,24,10,5,5,94,5,89
"2021","Sheffield 029A","E01007951",692,210,121,89,427,51,210,64,117,29,109,69,33,7,51,34,17,6,6,55,6,49
"2021","Sheffield 029B","E01007960",682,193,79,114,398,51,170,53,92,25,123,83,35,5,49,33,16,5,5,91,9,82
"2021","Sheffield 029C","E01007962",583,214,81,133,249,29,98,33,57,8,89,75,12,2,29,17,12,4,4,120,7,113
"2021","Sheffield 029D","E01008159",766,293,96,197,420,46,161,69,81,11,157,129,24,4,53,30,23,3,3,53,6,47
"2021","Sheffield 030A","E01007866",606,199,51,148,229,23,132,42,80,10,56,45,11,0,15,10,5,3,3,178,11,167
"2021","Sheffield 030B","E01007867",647,178,47,131,174,16,70,19,42,9,61,49,12,0,23,17,6,4,4,295,10,285
"2021","Sheffield 030C","E01007868",553,218,79,139,283,43,146,49,84,13,65,56,8,1,27,18,9,2,2,52,9,43
"2021","Sheffield 030D","E01008067",522,162,19,143,106,5,35,12,20,3,43,38,4,1,14,9,5,9,9,254,6,248
"2021","Sheffield 030E","E01008073",686,274,68,206,288,22,143,44,76,23,79,56,21,2,39,25,14,5,5,124,9,115
"2021","Sheffield 032A","E01007907",575,142,52,90,369,47,201,45,124,32,54,27,24,3,63,42,21,4,4,64,40,24
"2021","Sheffield 032B","E01007908",640,216,73,143,399,53,164,69,57,38,113,67,42,4,69,37,32,0,0,25,11,14
"2021","Sheffield 032C","E01007909",1125,350,109,241,730,77,340,110,174,56,202,129,61,12,109,64,45,2,2,45,12,33
"2021","Sheffield 032D","E01007911",589,147,90,57,426,91,222,85,90,47,77,29,38,10,36,17,19,0,0,16,6,10
"2021","Sheffield 032E","E01008014",691,236,128,108,409,43,219,57,128,34,64,31,23,10,79,57,22,4,4,46,25,21
"2021","Sheffield 032F","E01008016",622,194,93,101,396,54,175,58,84,33,81,37,36,8,83,50,33,3,3,32,14,18
"2021","Sheffield 033A","E01007952",648,150,102,48,489,96,294,101,150,43,57,32,22,3,42,24,18,0,0,9,5,4
"2021","Sheffield 033B","E01007953",794,362,194,168,416,117,202,83,85,34,46,23,19,4,45,26,19,6,6,16,7,9
"2021","Sheffield 033C","E01007954",647,130,84,46,503,101,300,102,151,47,64,36,24,4,38,23,15,0,0,14,4,10
"2021","Sheffield 033D","E01007961",588,120,77,43,453,76,295,89,168,38,45,19,23,3,36,16,20,1,1,15,5,10
"2021","Sheffield 036C","E01007863",609,207,75,132,320,49,167,59,85,23,74,52,19,3,25,13,12,5,5,82,6,76
"2021","Sheffield 036D","E01007864",494,72,23,49,122,12,39,12,20,7,49,39,7,3,11,7,4,11,11,300,3,297
"2021","Sheffield 036E","E01008104",483,158,61,97,212,29,101,38,44,19,44,38,6,0,29,14,15,9,9,113,13,100
"2021","Sheffield 036F","E01034843",911,377,109,268,378,47,200,82,101,17,104,87,15,2,22,15,7,5,5,156,11,145
"2021","Sheffield 037A","E01007910",769,271,116,155,475,63,197,63,100,34,92,40,47,5,122,87,35,1,1,23,13,10
"2021","Sheffield 037B","E01007912",685,237,130,107,429,97,211,82,83,46,74,48,18,8,44,23,21,3,3,19,7,12
"2021","Sheffield 037C","E01007971",617,184,88,96,419,61,180,57,84,39,93,30,55,8,83,52,31,2,2,14,7,7
"2021","Sheffield 037D","E01007973",637,156,109,47,464,83,236,86,106,44,84,39,36,9,61,32,29,0,0,17,8,9
"2021","Sheffield 038A","E01007858",652,271,85,186,363,46,196,65,102,29,76,60,13,3,45,29,16,0,0,18,7,11
"2021","Sheffield 038B","E01007861",709,234,123,111,452,95,267,102,134,31,69,40,27,2,21,12,9,0,0,23,9,14
"2021","Sheffield 038C","E01007862",443,176,68,108,248,65,127,48,64,15,42,29,11,2,14,8,6,0,0,19,8,11
"2021","Sheffield 038D","E01007865",769,233,114,119,491,68,254,87,137,30,106,66,36,4,62,42,20,1,1,45,13,32
"2021","Sheffield 039A","E01008011",758,227,79,148,495,27,149,50,74,25,133,59,63,11,171,134,37,15,15,36,24,12
"2021","Sheffield 039B","E01008012",1026,366,108,258,597,27,205,58,123,24,169,91,69,9,181,143,38,15,15,63,30,33
"2021","Sheffield 039C","E01008013",809,229,58,171,515,11,228,58,131,39,165,102,52,11,104,83,21,7,7,65,30,35
"2021","Sheffield 039D","E01008015",745,321,83,238,396,30,163,74,61,28,76,30,35,11,119,78,41,8,8,28,8,20
"2021","Sheffield 039E","E01008017",702,282,116,166,372,34,160,42,73,45,53,20,19,14,119,85,34,6,6,48,23,25
"2021","Sheffield 039F","E01008018",654,216,71,145,397,23,146,51,63,32,83,40,36,7,140,98,42,5,5,41,21,20
"2021","Sheffield 040A","E01008105",654,251,28,223,236,11,105,27,68,10,62,47,12,3,40,22,18,18,18,167,24,143
"2021","Sheffield 040C","E01008107",601,238,52,186,254,5,103,24,68,11,52,31,18,3,80,46,34,14,14,109,24,85
"2021","Sheffield 040D","E01008111",594,209,37,172,200,13,94,25,47,22,62,56,4,2,24,10,14,7,7,185,6,179
"2021","Sheffield 040E","E01033271",818,398,48,350,357,4,172,81,88,3,73,59,12,2,87,66,21,21,21,63,7,56
"2021","Sheffield 040F","E01033272",852,459,40,419,255,6,79,35,41,3,140,129,11,0,15,8,7,15,15,138,11,127
"2021","Sheffield 041A","E01007955",542,97,62,35,423,117,256,72,148,36,28,8,19,1,21,9,12,1,1,22,13,9
"2021","Sheffield 041B","E01007956",891,218,152,66,645,159,374,124,183,67,65,38,26,1,45,23,22,2,2,28,7,21
"2021","Sheffield 041C","E01007957",634,141,98,43,471,96,285,77,172,36,53,17,34,2,36,25,11,1,1,22,11,11
"2021","Sheffield 041D","E01007958",622,161,103,58,439,127,237,75,122,40,36,21,15,0,39,20,19,0,0,22,12,10
"2021","Sheffield 041E","E01007959",593,135,89,46,440,111,261,79,148,34,37,19,15,3,30,16,14,1,1,18,6,12
"2021","Sheffield 042A","E01008108",710,240,21,219,294,7,114,35,65,14,103,86,15,2,51,30,21,19,19,176,36,140
"2021","Sheffield 042B","E01008109",755,285,84,201,265,22,113,33,55,25,65,47,16,2,46,25,21,19,19,205,18,187
"2021","Sheffield 042D","E01008112",597,166,33,133,273,19,155,18,118,19,52,42,9,1,40,27,13,7,7,158,38,120
"2021","Sheffield 042E","E01008113",651,180,51,129,355,22,173,51,102,20,105,80,25,0,47,34,13,8,8,116,25,91
"2021","Sheffield 042F","E01033273",571,184,17,167,189,7,60,14,38,8,60,51,7,2,48,26,22,14,14,198,15,183
"2021","Sheffield 042G","E01033274",428,232,3,229,138,0,25,16,9,0,92,86,6,0,14,4,10,7,7,58,2,56
"2021","Sheffield 043A","E01008095",770,276,81,195,445,18,174,67,80,27,152,116,34,2,91,72,19,10,10,49,14,35
"2021","Sheffield 043B","E01008096",1035,368,114,254,592,43,210,74,112,24,147,89,49,9,179,112,67,13,13,75,22,53
"2021","Sheffield 043C","E01008097",635,251,90,161,362,30,132,51,53,28,82,39,34,9,110,85,25,8,8,22,13,9
"2021","Sheffield 043D","E01008101",820,297,89,208,473,48,177,60,92,25,115,63,44,8,125,79,46,8,8,50,16,34
"2021","Sheffield 044A","E01007965",781,256,198,58,493,77,188,62,79,47,73,22,42,9,151,97,54,4,4,32,23,9
"2021","Sheffield 044B","E01007969",696,201,92,109,458,80,205,78,74,53,98,62,34,2,74,44,30,1,1,37,10,27
"2021","Sheffield 044C","E01007972",612,159,97,62,446,99,215,81,89,45,91,45,42,4,41,16,25,0,0,7,4,3
"2021","Sheffield 044D","E01007974",553,108,52,56,424,48,239,97,89,53,87,44,33,10,50,29,21,0,0,21,6,15
"2021","Sheffield 045A","E01007963",716,294,130,164,405,73,171,65,70,36,87,47,32,8,66,40,26,8,8,17,6,11
"2021","Sheffield 045B","E01007967",761,223,88,135,520,57,170,49,78,43,138,56,69,13,150,112,38,5,5,18,11,7
"2021","Sheffield 045C","E01007999",550,142,84,58,399,79,218,102,68,48,62,30,24,8,39,17,22,1,1,9,3,6
"2021","Sheffield 045D","E01008008",727,247,103,144,454,68,163,48,84,31,95,40,47,8,122,82,40,6,6,26,12,14
"2021","Sheffield 045E","E01008009",599,134,39,95,434,25,131,37,64,30,96,34,59,3,180,131,49,2,2,31,20,11
"2021","Sheffield 046A","E01008043",671,157,73,84,480,76,283,96,154,33,78,48,27,3,41,26,15,2,2,34,18,16
"2021","Sheffield 046B","E01008044",622,146,90,56,439,70,263,67,164,32,67,38,27,2,36,20,16,3,3,37,20,17
"2021","Sheffield 046C","E01008047",583,182,43,139,250,16,98,36,50,12,98,78,18,2,28,15,13,10,10,151,6,145
"2021","Sheffield 046D","E01008048",588,149,53,96,299,35,151,48,90,13,72,52,18,2,36,21,15,5,5,140,13,127
"2021","Sheffield 046E","E01008050",621,161,47,114,352,15,160,54,93,13,120,93,26,1,47,29,18,10,10,108,6,102
"2021","Sheffield 047A","E01007931",617,124,90,34,480,119,279,80,161,38,56,23,31,2,26,15,11,0,0,13,5,8
"2021","Sheffield 047B","E01007934",600,141,64,77,447,65,264,67,161,36,76,43,30,3,42,24,18,0,0,12,5,7
"2021","Sheffield 047C","E01007935",561,121,37,84,375,26,215,60,135,20,87,58,27,2,40,27,13,7,7,65,3,62
"2021","Sheffield 047D","E01007936",679,160,48,112,447,12,220,58,148,14,143,104,34,5,66,43,23,6,6,72,12,60
"2021","Sheffield 047E","E01007937",605,168,94,74,419,63,245,59,156,30,62,32,24,6,48,22,26,1,1,18,12,6
"2021","Sheffield 047F","E01007938",585,119,74,45,449,83,274,67,171,36,61,25,33,3,30,14,16,1,1,17,7,10
"2021","Sheffield 048A","E01008098",624,184,58,126,404,22,158,66,56,36,65,22,34,9,154,101,53,5,5,36,13,23
"2021","Sheffield 048B","E01008100",539,160,50,110,352,39,105,42,37,26,68,15,43,10,137,95,42,3,3,27,16,11
"2021","Sheffield 048C","E01008102",618,244,118,126,352,28,116,43,44,29,68,24,38,6,137,106,31,3,3,22,14,8
"2021","Sheffield 048D","E01008103",463,130,52,78,301,14,106,42,42,22,59,18,33,8,117,88,29,5,5,32,14,18
"2021","Sheffield 049A","E01007964",731,305,108,197,399,60,174,72,68,34,89,60,25,4,76,48,28,0,0,27,11,16
"2021","Sheffield 049B","E01007966",647,200,72,128,419,56,206,77,79,50,82,42,34,6,71,41,30,4,4,28,12,16
"2021","Sheffield 049C","E01007968",630,222,140,82,382,42,163,72,54,37,77,39,29,9,96,66,30,4,4,26,15,11
"2021","Sheffield 049D","E01007970",875,520,175,345,339,42,83,43,28,12,70,46,21,3,135,101,34,9,9,16,5,11
"2021","Sheffield 050A","E01008042",710,256,74,182,348,34,175,44,103,28,95,73,21,1,40,20,20,4,4,106,49,57
"2021","Sheffield 050B","E01008045",522,161,61,100,310,35,177,52,99,26,64,43,18,3,31,17,14,3,3,51,26,25
"2021","Sheffield 050C","E01008046",686,220,46,174,397,22,176,51,101,24,128,101,26,1,69,44,25,2,2,69,18,51
"2021","Sheffield 050D","E01008049",783,339,180,159,391,66,189,65,88,36,98,68,25,5,35,22,13,3,3,53,6,47
"2021","Sheffield 050E","E01008051",628,199,47,152,340,30,169,40,102,27,99,70,24,5,39,25,14,3,3,89,48,41
"2021","Sheffield 050F","E01008052",793,305,83,222,424,44,223,84,115,24,117,83,30,4,35,24,11,5,5,64,12,52
"2021","Sheffield 051A","E01007975",772,351,141,210,371,39,142,55,58,29,89,61,24,4,92,57,35,9,9,50,17,33
"2021","Sheffield 051B","E01007976",637,224,92,132,374,50,151,61,67,23,85,52,29,4,84,52,32,4,4,39,13,26
"2021","Sheffield 051C","E01007977",803,403,140,263,357,36,124,52,53,19,71,36,27,8,115,83,32,11,11,43,6,37
"2021","Sheffield 051D","E01007979",673,204,88,116,427,23,111,29,65,17,70,20,42,8,219,168,51,4,4,42,26,16
"2021","Sheffield 051E","E01008099",642,180,40,140,396,29,173,55,85,33,134,100,32,2,56,30,26,4,4,66,8,58
"2021","Sheffield 052A","E01008000",681,292,134,158,365,64,155,67,51,37,91,47,38,6,53,35,18,2,2,24,8,16
"2021","Sheffield 052B","E01008001",654,192,74,118,445,67,161,65,62,34,101,49,41,11,112,74,38,4,4,17,5,12
"2021","Sheffield 052C","E01008004",720,256,137,119,439,72,177,63,77,37,102,49,44,9,82,46,36,6,6,25,14,11
"2021","Sheffield 052D","E01008005",727,242,135,107,466,94,203,96,58,49,112,60,42,10,54,32,22,3,3,19,5,14
"2021","Sheffield 052E","E01008010",582,152,69,83,399,45,160,54,59,47,95,45,46,4,99,72,27,0,0,31,10,21
"2021","Sheffield 053A","E01007978",741,275,67,208,378,12,148,70,61,17,146,104,38,4,68,41,27,4,4,88,14,74
"2021","Sheffield 053B","E01007980",651,207,53,154,394,25,160,56,90,14,150,91,53,6,55,40,15,4,4,50,12,38
"2021","Sheffield 053C","E01007981",597,173,42,131,384,29,186,61,111,14,121,72,41,8,47,29,18,1,1,40,15,25
"2021","Sheffield 053D","E01007983",636,189,36,153,422,23,190,78,79,33,141,100,36,5,66,51,15,2,2,25,3,22
"2021","Sheffield 053E","E01007985",657,213,87,126,419,55,207,63,106,38,112,69,42,1,42,24,18,3,3,25,5,20
"2021","Sheffield 054A","E01007982",795,267,92,175,485,57,165,63,68,34,87,46,34,7,168,124,44,8,8,43,25,18
"2021","Sheffield 054B","E01008002",702,186,112,74,486,113,230,95,88,47,97,55,34,8,46,24,22,0,0,30,11,19
"2021","Sheffield 054C","E01008003",618,182,102,80,416,83,192,86,64,42,82,44,35,3,54,24,30,5,5,20,9,11
"2021","Sheffield 054D","E01008006",695,231,130,101,451,105,199,88,67,44,91,56,29,6,53,22,31,3,3,13,6,7
"2021","Sheffield 055A","E01007927",645,142,112,30,494,138,276,90,140,46,48,19,26,3,31,16,15,1,1,9,3,6
"2021","Sheffield 055B","E01007928",701,166,121,45,511,133,316,95,178,43,34,11,19,4,28,20,8,0,0,24,6,18
"2021","Sheffield 055C","E01007929",808,210,128,82,561,99,327,93,187,47,84,50,28,6,49,28,21,2,2,37,16,21
"2021","Sheffield 055D","E01007930",539,97,73,24,428,82,293,88,154,51,32,12,17,3,21,7,14,0,0,14,8,6
"2021","Sheffield 055E","E01007932",626,187,121,66,424,94,245,63,137,45,51,25,23,3,29,17,12,5,5,15,7,8
"2021","Sheffield 055F","E01007939",680,172,111,61,487,95,288,99,143,46,56,25,27,4,45,20,25,3,3,21,8,13
"2021","Sheffield 056A","E01008028",636,171,65,106,437,52,204,86,86,32,100,41,54,5,80,43,37,1,1,28,11,17
"2021","Sheffield 056B","E01008029",591,144,64,80,424,46,178,44,76,58,93,30,54,9,105,69,36,2,2,23,12,11
"2021","Sheffield 056C","E01008032",627,215,93,122,383,52,148,60,54,34,104,54,46,4,78,55,23,1,1,29,9,20
"2021","Sheffield 056D","E01008034",681,202,82,120,455,43,239,97,80,62,86,44,37,5,83,46,37,4,4,24,12,12
"2021","Sheffield 059A","E01007828",756,235,86,149,486,53,218,73,109,36,117,58,47,12,91,49,42,7,7,35,16,19
"2021","Sheffield 059B","E01007829",749,271,82,189,435,40,183,70,79,34,147,109,29,9,58,29,29,7,7,43,13,30
"2021","Sheffield 059C","E01007831",704,236,102,134,446,41,213,92,101,20,120,80,39,1,64,44,20,8,8,22,10,12
"2021","Sheffield 059D","E01007832",698,225,88,137,445,45,222,81,99,42,113,72,36,5,60,36,24,5,5,28,11,17
"2021","Sheffield 059E","E01007986",646,216,57,159,395,38,157,61,75,21,133,92,38,3,64,44,20,3,3,35,8,27
"2021","Sheffield 060A","E01008007",795,365,121,244,409,50,150,53,64,33,83,35,41,7,118,71,47,8,8,21,13,8
"2021","Sheffield 060B","E01008075",591,188,56,132,370,25,122,36,60,26,58,19,33,6,160,127,33,5,5,33,19,14
"2021","Sheffield 060C","E01008076",599,220,87,133,363,36,112,25,55,32,72,25,41,6,141,100,41,2,2,16,5,11
"2021","Sheffield 060D","E01008077",708,264,116,148,417,49,162,55,62,45,92,44,40,8,110,74,36,4,4,27,12,15
"2021","Sheffield 061A","E01008031",620,192,109,83,408,62,198,79,64,55,81,35,40,6,64,38,26,3,3,20,4,16
"2021","Sheffield 061B","E01008033",588,194,100,94,381,120,187,94,45,48,49,29,15,5,22,11,11,3,3,13,8,5
"2021","Sheffield 061C","E01008038",734,276,191,85,439,155,207,104,53,50,58,32,20,6,19,5,14,0,0,19,7,12
"2021","Sheffield 061D","E01008040",679,179,76,103,485,64,270,91,118,61,87,48,30,9,63,27,36,1,1,15,3,12
"2021","Sheffield 062A","E01007835",595,180,97,83,393,71,185,75,73,37,78,34,41,3,58,34,24,1,1,22,6,16
"2021","Sheffield 062B","E01007836",696,207,123,84,470,102,220,77,83,60,92,44,38,10,56,31,25,0,0,19,6,13
"2021","Sheffield 062C","E01007843",761,261,109,152,472,61,155,48,68,39,143,80,53,10,107,80,27,6,6,28,16,12
"2021","Sheffield 062D","E01007846",654,235,131,104,403,72,193,81,72,40,96,52,37,7,41,24,17,1,1,16,5,11
"2021","Sheffield 063A","E01008030",565,135,61,74,406,48,216,79,87,50,78,41,32,5,63,49,14,1,1,24,10,14
"2021","Sheffield 063B","E01008035",468,81,49,32,368,76,211,83,86,42,53,28,23,2,28,13,15,0,0,19,6,13
"2021","Sheffield 063C","E01008036",588,165,62,103,409,49,224,97,82,45,87,50,33,4,49,27,22,0,0,14,5,9
"2021","Sheffield 063D","E01008041",535,108,44,64,413,55,264,102,101,61,59,31,25,3,35,21,14,0,0,14,5,9
"2021","Sheffield 064A","E01007827",857,240,128,112,592,91,286,127,127,32,143,91,51,1,71,49,22,1,1,25,10,15
"2021","Sheffield 064B","E01007830",657,224,138,86,414,94,211,87,86,38,69,38,23,8,36,24,12,4,4,19,6,13
"2021","Sheffield 064C","E01007833",778,257,176,81,500,134,244,86,113,45,65,43,21,1,53,26,27,4,4,21,6,15
"2021","Sheffield 064D","E01007984",581,134,69,65,437,74,230,90,105,35,102,42,53,7,28,14,14,3,3,10,5,5
"2021","Sheffield 064E","E01008078",697,251,127,124,422,109,213,82,86,45,59,33,25,1,39,21,18,2,2,24,13,11
"2021","Sheffield 064F","E01008079",487,103,68,35,372,78,208,80,98,30,58,32,23,3,26,15,11,2,2,12,6,6
"2021","Sheffield 065A","E01008019",718,172,73,99,505,68,216,79,87,50,108,43,51,14,111,71,40,2,2,41,23,18
"2021","Sheffield 065B","E01008020",591,183,82,101,396,88,202,94,57,51,67,37,21,9,37,24,13,2,2,12,7,5
"2021","Sheffield 065C","E01008022",725,337,83,254,367,40,107,42,43,22,86,44,36,6,126,87,39,8,8,21,12,9
"2021","Sheffield 065D","E01008027",669,254,111,143,398,58,173,59,74,40,81,47,27,7,86,53,33,0,0,17,8,9
"2021","Sheffield 065E","E01008037",707,304,181,123,374,116,140,62,43,35,44,30,11,3,73,33,40,1,1,29,14,15
"2021","Sheffield 065F","E01008039",601,205,115,90,386,137,156,84,44,28,47,22,19,6,45,27,18,1,1,10,5,5
"2021","Sheffield 066A","E01007824",564,134,89,45,418,84,229,85,109,35,71,43,21,7,33,17,16,1,1,12,6,6
"2021","Sheffield 066B","E01007825",615,167,116,51,432,100,238,92,107,39,59,36,18,5,33,22,11,2,2,16,5,11
"2021","Sheffield 066C","E01007826",600,126,80,46,452,80,280,85,138,57,61,37,20,4,31,13,18,0,0,22,12,10
"2021","Sheffield 066D","E01007834",750,252,164,88,479,104,252,95,110,47,71,41,29,1,49,27,22,3,3,19,8,11
"2021","Sheffield 068A","E01007920",722,190,124,66,509,147,274,85,145,44,58,34,23,1,27,14,13,3,3,23,9,14
"2021","Sheffield 068B","E01007921",793,270,177,93,507,146,252,89,138,25,52,32,16,4,57,39,18,0,0,16,9,7
"2021","Sheffield 068C","E01007923",809,254,143,111,541,116,294,80,166,48,67,34,30,3,63,41,22,1,1,14,4,10
"2021","Sheffield 068D","E01007925",780,263,133,130,498,81,279,68,172,39,67,42,23,2,68,42,26,3,3,19,6,13
"2021","Sheffield 068E","E01007926",717,161,107,54,521,157,268,98,121,49,55,30,23,2,38,20,18,3,3,35,17,18
"2021","Sheffield 068F","E01007933",645,122,83,39,508,121,327,119,165,43,33,20,11,2,26,13,13,1,1,15,7,8
"2021","Sheffield 069A","E01007823",809,314,155,159,480,87,224,76,95,53,94,45,44,5,72,42,30,3,3,15,5,10
"2021","Sheffield 069B","E01007916",710,275,87,188,412,32,128,22,80,26,63,22,35,6,182,140,42,7,7,23,15,8
"2021","Sheffield 069C","E01007919",755,286,73,213,444,26,125,35,62,28,110,41,62,7,180,128,52,3,3,25,12,13
"2021","Sheffield 069D","E01008080",662,236,117,119,407,73,182,70,87,25,77,49,25,3,75,46,29,0,0,19,5,14
"2021","Sheffield 070A","E01008081",773,362,105,257,384,29,129,46,55,28,89,29,55,5,124,77,47,13,13,27,12,15
"2021","Sheffield 070B","E01008082",812,363,150,213,413,58,118,42,49,27,108,62,41,5,125,84,41,4,4,36,10,26
"2021","Sheffield 070C","E01008083",704,300,78,222,377,25,141,45,71,25,79,26,42,11,130,99,31,2,2,27,9,18
"2021","Sheffield 070D","E01008084",765,310,86,224,412,28,119,38,65,16,94,35,54,5,165,126,39,6,6,43,24,19
"2021","Sheffield 071A","E01007915",608,147,104,43,452,98,251,79,128,44,72,41,28,3,31,16,15,0,0,9,5,4
"2021","Sheffield 071B","E01007917",683,238,152,86,427,113,193,78,85,30,51,30,17,4,66,36,30,4,4,18,6,12
"2021","Sheffield 071C","E01007918",766,260,120,140,486,101,283,87,163,33,53,30,19,4,48,32,16,1,1,20,10,10
"2021","Sheffield 071D","E01007922",587,133,86,47,442,109,246,92,126,28,60,36,22,2,26,14,12,1,1,12,6,6
"2021","Sheffield 071E","E01007924",713,255,123,132,448,68,222,77,118,27,71,31,38,2,83,53,30,4,4,10,2,8
"2021","Sheffield 072A","E01008021",552,95,59,36,446,85,266,104,98,64,67,30,30,7,25,13,12,3,3,11,2,9
"2021","Sheffield 072B","E01008023",1025,259,76,183,741,79,403,151,180,72,194,129,57,8,61,45,16,4,4,25,15,10
"2021","Sheffield 072C","E01008024",895,225,100,125,640,71,312,111,149,52,157,79,67,11,99,62,37,1,1,30,14,16
"2021","Sheffield 072D","E01008025",895,271,131,140,593,114,290,118,129,43,119,59,49,11,67,39,28,3,3,31,10,21
"2021","Sheffield 072E","E01032585",649,206,134,72,432,142,194,98,61,35,55,36,19,0,40,24,16,1,1,11,7,4
"2021","Sheffield 073A","E01033261",563,278,13,265,235,1,95,41,53,1,122,119,2,1,7,6,1,10,10,50,0,50
"2021","Sheffield 073B","E01033262",935,512,19,493,312,3,83,56,22,5,193,190,3,0,15,10,5,18,18,111,1,110
"2021","Sheffield 073C","E01033263",1056,531,24,507,409,2,118,39,75,4,226,213,11,2,54,35,19,9,9,116,14,102
"2021","Sheffield 073D","E01033264",908,484,9,475,328,1,116,88,27,1,170,170,0,0,11,7,4,30,30,96,2,94
"2021","Sheffield 073E","E01033276",592,376,3,373,139,0,39,28,11,0,83,83,0,0,4,4,0,13,13,77,4,73
"2021","Sheffield 074A","E01008114",831,402,34,368,276,6,130,36,87,7,51,42,7,2,80,43,37,9,9,153,17,136
"2021","Sheffield 074B","E01008115",487,161,28,133,120,6,52,20,28,4,30,24,6,0,24,11,13,8,8,206,15,191
"2021","Sheffield 074C","E01033265",665,390,15,375,182,0,64,36,25,3,90,85,4,1,19,4,15,9,9,93,1,92
"2021","Sheffield 074F","E01034844",723,372,13,359,198,2,84,30,51,3,78,74,4,0,22,13,9,12,12,153,4,149
"2021","Sheffield 075A","E01007878",559,169,70,99,365,30,124,44,55,25,56,20,32,4,150,95,55,5,5,25,9,16
"2021","Sheffield 075B","E01007879",674,290,111,179,280,45,120,59,38,23,63,53,5,5,43,30,13,9,9,104,16,88
"2021","Sheffield 075C","E01007881",689,248,101,147,402,41,154,69,49,36,105,60,38,7,98,52,46,4,4,39,10,29
"2021","Sheffield 075D","E01007882",602,161,49,112,364,42,177,67,73,37,84,64,16,4,55,20,35,6,6,77,25,52
"2021","Sheffield 075E","E01007885",821,274,47,227,507,14,187,47,122,18,84,36,40,8,215,173,42,7,7,40,16,24
"2021","Sheffield 075F","E01007886",656,173,76,97,445,31,132,42,62,28,74,23,47,4,198,156,42,10,10,38,16,22
"2021","Sheffield 075G","E01033268",1049,494,111,383,467,27,150,66,57,27,170,152,13,5,108,73,35,12,12,88,10,78
"2021","Sheffield 076A","E01007838",647,162,69,93,462,67,214,101,69,44,101,55,36,10,79,54,25,1,1,23,9,14
"2021","Sheffield 076B","E01007839",673,152,52,100,506,63,260,92,106,62,123,58,57,8,57,25,32,3,3,15,6,9
"2021","Sheffield 076C","E01007841",624,167,74,93,438,62,223,78,80,65,108,51,50,7,44,32,12,1,1,19,8,11
"2021","Sheffield 076D","E01007842",681,203,109,94,457,62,213,74,96,43,86,37,42,7,92,50,42,4,4,21,13,8
"2021","Sheffield 076F","E01033279",998,351,146,205,605,66,207,55,100,52,153,67,61,25,174,111,63,5,5,42,21,21
"2021","Sheffield 076G","E01034845",601,211,98,113,375,51,137,55,55,27,91,36,46,9,90,52,38,6,6,15,7,8
"2021","Sheffield 076H","E01034846",606,196,76,120,388,48,145,44,66,35,73,34,34,5,119,83,36,3,3,22,9,13
"2021","Bradford 001A","E01010646",671,246,175,71,408,132,186,80,76,30,52,36,15,1,37,23,14,1,1,17,9,8
"2021","Bradford 001B","E01010647",524,217,142,75,299,84,143,47,73,23,38,26,9,3,34,17,17,0,0,8,2,6
"2021","Bradford 001C","E01010648",656,199,122,77,439,144,210,103,82,25,53,34,17,2,32,25,7,0,0,18,6,12
"2021","Bradford 001D","E01010692",907,359,209,150,512,142,279,118,122,39,57,34,21,2,33,19,14,1,1,36,10,26
"2021","Bradford 002A","E01010691",677,178,136,42,486,124,276,96,134,46,47,27,20,0,38,19,19,1,1,13,8,5
"2021","Bradford 002B","E01010693",574,107,85,22,448,131,266,78,142,46,31,17,8,6,20,12,8,0,0,19,8,11
"2021","Bradford 002C","E01010694",629,129,90,39,475,168,239,86,117,36,32,19,12,1,35,17,18,1,1,25,12,13
"2021","Bradford 002D","E01010695",847,405,233,172,417,90,186,73,85,28,89,66,22,1,46,28,18,6,6,25,6,19
"2021","Bradford 002E","E01010696",622,132,77,55,475,98,290,74,162,54,56,25,29,2,30,13,17,1,1,15,10,5
"2021","Bradford 002F","E01010697",642,200,139,61,413,127,216,82,100,34,46,26,18,2,23,14,9,1,1,29,14,15
"2021","Bradford 002G","E01010698",962,399,213,186,528,91,229,79,114,36,111,73,33,5,92,61,31,5,5,35,8,27
"2021","Bradford 002H","E01010699",891,319,198,121,544,94,238,69,131,38,99,46,43,10,111,73,38,2,2,28,15,13
"2021","Bradford 003A","E01010767",636,218,136,82,402,83,218,66,111,41,57,19,37,1,41,27,14,3,3,16,5,11
"2021","Bradford 003B","E01010768",643,121,62,59,512,92,313,90,181,42,57,29,26,2,50,27,23,0,0,10,2,8
"2021","Bradford 003C","E01010769",745,285,127,158,452,65,203,72,102,29,103,57,38,8,81,56,25,0,0,8,3,5
"2021","Bradford 003D","E01010771",495,86,58,28,389,111,221,70,117,34,36,18,14,4,21,13,8,0,0,20,6,14
"2021","Bradford 005A","E01010770",676,113,67,46,541,99,362,119,189,54,46,18,25,3,33,23,10,1,1,22,12,10
"2021","Bradford 005B","E01010772",509,96,82,14,400,103,239,76,125,38,35,22,13,0,23,12,11,0,0,13,6,7
"2021","Bradford 005C","E01010773",681,201,98,103,458,85,254,90,131,33,74,43,27,4,44,25,19,1,1,22,11,11
"2021","Bradford 005D","E01010774",750,248,143,105,480,110,241,96,113,32,78,53,25,0,46,24,22,5,5,22,7,15
"2021","Bradford 006A","E01010706",705,222,111,111,467,88,240,102,97,41,88,54,26,8,51,38,13,0,0,16,9,7
"2021","Bradford 006B","E01010707",795,236,94,142,524,98,252,106,98,48,108,72,29,7,62,40,22,4,4,35,18,17
"2021","Bradford 006C","E01010708",640,154,69,85,446,59,239,95,111,33,73,41,24,8,72,52,20,3,3,40,26,14
"2021","Bradford 006D","E01010709",1056,252,141,111,753,128,421,140,215,66,126,65,55,6,77,51,26,1,1,51,29,22
"2021","Bradford 007A","E01010719",521,113,52,61,342,17,214,37,153,24,23,8,12,3,83,56,27,5,5,66,55,11
"2021","Bradford 007B","E01010727",751,265,105,160,425,93,203,95,68,40,72,41,22,9,52,28,24,5,5,61,30,31
"2021","Bradford 007C","E01010728",515,136,45,91,282,22,166,24,106,36,38,22,14,2,49,29,20,7,7,97,76,21
"2021","Bradford 007D","E01010729",492,84,51,33,357,71,210,55,119,36,29,17,11,1,44,24,20,3,3,51,40,11
"2021","Bradford 008A","E01010700",464,103,20,83,254,8,152,28,100,24,28,14,12,2,63,44,19,3,3,107,87,20
"2021","Bradford 008B","E01010701",432,115,53,62,262,5,163,19,125,19,22,7,11,4,66,36,30,6,6,55,44,11
"2021","Bradford 008C","E01010702",490,104,49,55,259,15,164,11,123,30,13,4,8,1,61,40,21,6,6,127,91,36
"2021","Bradford 008D","E01010703",651,178,73,105,439,45,198,66,101,31,69,38,29,2,123,82,41,4,4,34,20,14
"2021","Bradford 008E","E01010704",608,198,63,135,391,50,157,63,65,29,85,39,43,3,97,65,32,2,2,19,9,10
"2021","Bradford 008F","E01010705",676,164,96,68,486,102,217,75,96,46,93,41,44,8,72,45,27,2,2,26,10,16
"2021","Bradford 008G","E01010710",941,542,74,468,323,12,158,36,101,21,64,45,19,0,80,59,21,9,9,76,41,35
"2021","Bradford 009A","E01010712",474,120,26,94,301,9,201,21,157,23,34,13,21,0,54,42,12,3,3,53,39,14
"2021","Bradford 009B","E01010720",631,210,101,109,375,18,152,52,82,18,54,17,30,7,147,103,44,4,4,46,29,17
"2021","Bradford 009C","E01010721",810,256,70,186,502,41,206,84,87,35,103,50,48,5,148,107,41,4,4,52,31,21
"2021","Bradford 009D","E01010723",488,125,45,80,305,7,173,23,132,18,39,21,16,2,78,44,34,8,8,58,40,18
"2021","Bradford 009E","E01010724",609,223,86,137,360,36,152,53,70,29,61,32,20,9,111,76,35,0,0,26,14,12
"2021","Bradford 009F","E01010725",692,270,107,163,397,46,164,65,72,27,76,34,37,5,104,65,39,7,7,25,17,8
"2021","Bradford 010A","E01010579",639,158,103,55,450,129,234,95,99,40,58,30,22,6,27,9,18,2,2,31,17,14
"2021","Bradford 010B","E01010580",1051,279,154,125,747,142,420,140,225,55,107,59,44,4,78,57,21,0,0,25,9,16
"2021","Bradford 010C","E01010764",686,154,94,60,509,132,286,121,107,58,57,32,23,2,33,20,13,1,1,23,14,9
"2021","Bradford 010D","E01010765",1107,424,219,205,660,96,336,134,134,68,127,65,60,2,98,63,35,3,3,23,8,15
"2021","Bradford 010E","E01010766",536,138,88,50,387,95,215,86,88,41,47,27,17,3,30,16,14,0,0,11,3,8
"2021","Bradford 011A","E01010711",863,513,196,317,299,30,105,41,54,10,69,37,31,1,91,74,17,4,4,51,16,35
"2021","Bradford 011B","E01010713",659,188,80,108,436,47,135,56,60,19,87,38,43,6,161,126,35,6,6,35,14,21
"2021","Bradford 011C","E01010714",615,209,77,132,367,50,142,46,62,34,72,32,34,6,98,57,41,5,5,39,28,11
"2021","Bradford 011D","E01010716",947,369,107,262,537,53,212,110,68,34,129,63,60,6,138,105,33,5,5,41,17,24
"2021","Bradford 012A","E01010715",464,141,74,67,296,41,124,55,47,22,48,19,21,8,78,53,25,5,5,27,13,14
"2021","Bradford 012B","E01010717",689,213,92,121,443,38,170,64,76,30,94,43,43,8,137,97,40,4,4,33,16,17
"2021","Bradford 012C","E01010718",654,225,84,141,407,25,142,68,54,20,89,41,38,10,149,118,31,2,2,22,14,8
"2021","Bradford 012D","E01010726",611,167,88,79,414,95,220,93,79,48,63,30,28,5,36,20,16,0,0,30,19,11
"2021","Bradford 012E","E01010859",777,171,89,82,583,128,252,110,83,59,109,47,52,10,90,63,27,4,4,23,10,13
"2021","Bradford 013A","E01010573",819,215,124,91,584,103,360,153,162,45,68,46,18,4,51,30,21,2,2,20,9,11
"2021","Bradford 013B","E01010574",636,216,136,80,401,113,200,78,83,39,54,30,20,4,32,18,14,2,2,19,9,10
"2021","Bradford 013C","E01010575",759,279,177,102,454,113,221,97,76,48,56,30,25,1,61,39,22,3,3,26,12,14
"2021","Bradford 013D","E01010577",657,152,78,74,491,117,263,109,119,35,70,37,30,3,40,28,12,1,1,14,7,7
"2021","Bradford 014A","E01010722",649,180,64,116,431,60,194,85,78,31,86,46,34,6,86,72,14,5,5,38,21,17
"2021","Bradford 014B","E01010860",735,186,84,102,525,74,260,111,98,51,126,63,54,9,63,38,25,2,2,24,9,15
"2021","Bradford 014C","E01010862",716,218,95,123,472,58,231,93,99,39,108,56,45,7,73,49,24,2,2,26,7,19
"2021","Bradford 014D","E01010863",607,146,76,70,444,74,249,108,97,44,71,33,33,5,50,31,19,0,0,17,7,10
"2021","Bradford 015A","E01010578",772,313,100,213,434,73,200,89,69,42,89,58,24,7,71,31,40,1,1,25,13,12
"2021","Bradford 015B","E01010581",705,183,87,96,502,64,221,86,103,32,116,61,49,6,97,71,26,4,4,20,8,12
"2021","Bradford 015C","E01010582",745,263,96,167,445,35,202,66,103,33,123,71,45,7,75,53,22,10,10,37,11,26
"2021","Bradford 015D","E01010584",903,413,147,266,444,50,153,56,67,30,127,72,46,9,107,79,28,7,7,46,15,31
"2021","Bradford 015E","E01010585",1034,493,262,231,510,91,212,71,103,38,96,45,38,13,103,73,30,8,8,31,8,23
"2021","Bradford 016A","E01010568",823,298,156,142,497,100,223,94,91,38,88,45,39,4,85,63,22,1,1,28,9,19
"2021","Bradford 016B","E01010569",841,339,165,174,464,66,177,61,90,26,106,47,53,6,107,64,43,8,8,38,13,25
"2021","Bradford 016C","E01010571",937,377,137,240,517,61,180,63,90,27,133,81,49,3,136,109,27,7,7,43,9,34
"2021","Bradford 016D","E01010572",671,179,101,78,471,102,238,106,82,50,80,48,25,7,46,27,19,5,5,21,10,11
"2021","Bradford 016E","E01010576",668,193,95,98,459,93,242,112,93,37,74,45,24,5,49,29,20,1,1,16,6,10
"2021","Bradford 017A","E01010683",1038,304,86,218,706,65,385,160,168,57,185,128,49,8,63,35,28,8,8,28,10,18
"2021","Bradford 017B","E01010684",665,205,84,121,437,66,199,93,68,38,83,39,37,7,86,63,23,3,3,23,10,13
"2021","Bradford 017C","E01010685",778,264,126,138,489,83,253,115,109,29,86,44,35,7,61,40,21,6,6,25,12,13
"2021","Bradford 017D","E01010686",779,220,119,101,532,118,297,111,127,59,68,38,25,5,48,37,11,1,1,27,14,13
"2021","Bradford 018A","E01010570",584,104,71,33,458,120,253,93,109,51,48,24,20,4,35,17,18,2,2,22,8,14
"2021","Bradford 018B","E01010583",590,212,87,125,364,57,157,67,70,20,62,38,20,4,83,54,29,5,5,14,8,6
"2021","Bradford 018C","E01010784",778,308,91,217,437,38,156,53,83,20,133,94,37,2,107,69,38,3,3,33,13,20
"2021","Bradford 018D","E01010785",865,449,195,254,387,47,157,71,76,10,136,103,30,3,44,31,13,3,3,29,9,20
"2021","Bradford 018E","E01010786",554,142,92,50,377,78,216,61,123,32,42,19,22,1,39,25,14,2,2,35,20,15
"2021","Bradford 018F","E01010790",601,116,67,49,453,102,244,71,129,44,59,27,29,3,48,31,17,0,0,32,22,10
"2021","Bradford 019A","E01010680",853,334,100,234,479,33,124,50,49,25,109,44,62,3,208,173,35,5,5,40,13,27
"2021","Bradford 019B","E01010681",575,80,49,31,466,81,284,110,117,57,68,43,19,6,33,20,13,0,0,29,17,12
"2021","Bradford 019C","E01010682",681,285,137,148,366,43,145,53,58,34,67,29,35,3,107,73,34,4,4,30,14,16
"2021","Bradford 019D","E01010687",735,171,75,96,542,46,316,120,143,53,119,74,40,5,61,46,15,0,0,22,11,11
"2021","Bradford 019E","E01010688",850,316,79,237,507,47,222,83,101,38,135,75,51,9,98,67,31,5,5,27,11,16
"2021","Bradford 019F","E01010689",878,280,92,188,541,48,230,82,117,31,162,111,42,9,93,63,30,8,8,57,25,32
"2021","Bradford 019G","E01010690",853,347,175,172,476,72,241,95,95,51,101,49,44,8,62,37,25,0,0,30,17,13
"2021","Bradford 020B","E01010782",1097,509,110,399,542,24,183,71,86,26,150,85,56,9,171,133,38,14,14,46,19,27
"2021","Bradford 020C","E01010787",686,236,119,117,417,79,228,82,112,34,59,34,25,0,49,20,29,2,2,33,16,17
"2021","Bradford 020D","E01010788",581,212,76,136,326,38,169,56,93,20,66,49,16,1,49,27,22,4,4,43,26,17
"2021","Bradford 020E","E01033689",846,544,61,483,266,7,71,39,26,6,119,102,14,3,63,44,19,6,6,36,6,30
"2021","Bradford 020F","E01033694",570,255,55,200,295,21,113,50,50,13,98,78,18,2,58,37,21,5,5,20,5,15
"2021","Bradford 021A","E01010776",681,202,61,141,446,44,190,70,78,42,94,41,48,5,113,84,29,5,5,33,20,13
"2021","Bradford 021B","E01010777",777,382,84,298,369,26,118,42,53,23,101,67,30,4,121,90,31,3,3,26,9,17
"2021","Bradford 021C","E01010779",768,283,127,156,459,56,166,79,54,33,104,46,52,6,130,102,28,3,3,26,12,14
"2021","Bradford 021D","E01010781",621,197,51,146,388,30,165,66,67,32,88,35,49,4,102,76,26,3,3,36,23,13
"2021","Bradford 021E","E01010783",678,214,91,123,426,63,191,69,75,47,83,42,39,2,84,52,32,5,5,38,20,18
"2021","Bradford 022A","E01010586",742,217,121,96,502,123,256,113,106,37,69,42,22,5,52,29,23,2,2,23,7,16
"2021","Bradford 022B","E01010587",883,264,102,162,576,80,307,121,145,41,111,54,47,10,77,60,17,1,1,43,22,21
"2021","Bradford 022C","E01010588",677,190,98,92,446,70,225,87,103,35,72,43,23,6,74,44,30,5,5,41,18,23
"2021","Bradford 022D","E01010589",646,206,111,95,423,109,209,96,67,46,60,31,24,5,42,18,24,3,3,17,8,9
"2021","Bradford 022E","E01010591",707,228,132,96,455,74,183,62,88,33,81,32,39,10,110,77,33,7,7,24,14,10
"2021","Bradford 022F","E01010593",780,235,129,106,523,89,235,93,89,53,84,58,18,8,113,58,55,2,2,22,13,9
"2021","Bradford 022G","E01010596",634,169,107,62,449,96,253,95,109,49,54,25,25,4,44,27,17,2,2,16,10,6
"2021","Bradford 023A","E01010854",850,342,139,203,484,53,207,89,85,33,131,76,46,9,90,63,27,3,3,24,7,17
"2021","Bradford 023B","E01010855",734,213,119,94,487,85,251,131,71,49,93,54,29,10,53,29,24,5,5,34,9,25
"2021","Bradford 023C","E01010856",753,309,108,201,430,53,186,93,69,24,104,76,26,2,86,67,19,1,1,14,5,9
"2021","Bradford 023D","E01010857",740,208,106,102,506,128,237,108,94,35,89,51,28,10,49,31,18,3,3,26,12,14
"2021","Bradford 023E","E01010858",732,243,94,149,464,69,251,115,109,27,95,56,32,7,48,31,17,1,1,25,9,16
"2021","Bradford 023F","E01010861",768,199,92,107,545,110,289,124,109,56,103,62,35,6,43,27,16,0,0,24,13,11
"2021","Bradford 024A","E01010603",636,161,90,71,426,59,214,60,101,53,86,36,43,7,66,39,27,1,1,49,22,27
"2021","Bradford 024B","E01010604",768,224,155,69,499,113,261,105,99,57,68,29,33,6,53,28,25,4,4,45,26,19
"2021","Bradford 024C","E01010605",648,221,95,126,378,21,152,53,72,27,73,24,44,5,128,83,45,4,4,49,30,19
"2021","Bradford 024D","E01010775",701,151,77,74,508,69,263,90,113,60,90,41,42,7,83,49,34,3,3,42,22,20
"2021","Bradford 024E","E01010778",808,218,64,154,533,41,205,65,107,33,106,43,54,9,175,123,52,6,6,57,27,30
"2021","Bradford 025A","E01010789",680,251,80,171,354,27,187,42,109,36,58,27,27,4,78,44,34,4,4,75,47,28
"2021","Bradford 025B","E01010791",524,134,41,93,290,30,181,35,111,35,27,13,12,2,51,31,20,1,1,100,70,30
"2021","Bradford 025C","E01010792",599,186,39,147,329,18,211,31,138,42,21,10,10,1,74,53,21,5,5,84,59,25
"2021","Bradford 025D","E01010793",585,184,41,143,315,15,187,31,100,56,27,13,13,1,81,51,30,5,5,86,64,22
"2021","Bradford 026A","E01010652",797,314,174,140,449,85,172,70,64,38,111,59,47,5,77,48,29,4,4,34,14,20
"2021","Bradford 026B","E01010653",838,264,105,159,541,29,180,70,88,22,104,47,48,9,214,165,49,14,14,33,18,15
"2021","Bradford 026C","E01010655",582,119,35,84,432,29,112,41,52,19,79,24,46,9,202,160,42,10,10,31,18,13
"2021","Bradford 026D","E01010656",614,182,123,59,388,58,207,79,84,44,59,26,29,4,61,38,23,3,3,44,27,17
"2021","Bradford 026E","E01010657",662,220,67,153,414,50,165,71,61,33,90,50,39,1,105,77,28,4,4,28,9,19
"2021","Bradford 027A","E01010649",665,247,72,175,384,42,160,68,60,32,96,44,42,10,80,55,25,6,6,34,18,16
"2021","Bradford 027B","E01010650",734,145,36,109,551,18,241,50,168,23,116,35,72,9,171,141,30,5,5,38,24,14
"2021","Bradford 027C","E01010654",672,208,67,141,426,17,157,54,68,35,101,34,55,12,145,110,35,6,6,38,26,12
"2021","Bradford 027D","E01010826",529,131,47,84,367,7,181,35,118,28,36,9,24,3,137,109,28,6,6,31,18,13
"2021","Bradford 028A","E01010597",620,176,79,97,412,43,214,71,99,44,65,34,22,9,87,58,29,3,3,32,11,21
"2021","Bradford 028B","E01010598",640,178,92,86,409,71,213,75,96,42,54,29,20,5,66,37,29,5,5,53,38,15
"2021","Bradford 028C","E01010599",459,94,34,60,307,20,162,46,85,31,52,22,26,4,72,47,25,1,1,58,40,18
"2021","Bradford 028D","E01010600",479,105,46,59,328,38,181,34,111,36,30,13,13,4,65,43,22,14,14,46,31,15
"2021","Bradford 028E","E01010602",656,211,74,137,400,35,202,52,108,42,59,35,22,2,100,67,33,4,4,45,27,18
"2021","Bradford 029A","E01010670",458,99,23,76,267,15,164,30,90,44,22,7,14,1,65,43,22,1,1,92,77,15
"2021","Bradford 029B","E01010671",507,126,62,64,307,27,202,22,145,35,17,7,9,1,59,38,21,2,2,74,57,17
"2021","Bradford 029C","E01010673",488,95,37,58,261,9,178,25,133,20,14,7,6,1,54,31,23,6,6,132,99,33
"2021","Bradford 029D","E01010675",642,184,96,88,357,48,238,38,147,53,24,15,9,0,45,25,20,2,2,101,82,19
"2021","Bradford 030A","E01010669",650,130,63,67,459,30,317,51,228,38,27,7,17,3,79,56,23,6,6,61,49,12
"2021","Bradford 030B","E01010674",638,117,21,96,464,16,298,42,228,28,29,11,16,2,115,88,27,6,6,57,43,14
"2021","Bradford 030D","E01010805",510,129,36,93,301,20,188,26,130,32,18,7,11,0,72,56,16,3,3,80,61,19
"2021","Bradford 030E","E01033898",456,73,33,40,325,12,199,27,153,19,20,4,15,1,88,55,33,6,6,58,44,14
"2021","Bradford 030F","E01033899",472,44,4,40,403,4,196,16,169,11,22,3,18,1,180,154,26,1,1,25,16,9
"2021","Bradford 031A","E01010590",932,233,103,130,664,105,364,156,151,57,111,54,48,9,78,48,30,6,6,35,19,16
"2021","Bradford 031B","E01010592",781,261,156,105,499,108,218,87,89,42,92,57,29,6,81,56,25,0,0,21,10,11
"2021","Bradford 031C","E01010594",709,171,85,86,500,81,243,108,81,54,85,47,28,10,89,65,24,2,2,38,19,19
"2021","Bradford 031D","E01010595",955,337,133,204,588,56,258,92,112,54,138,71,63,4,126,98,28,10,10,30,16,14
"2021","Bradford 032A","E01010601",769,281,98,183,461,44,225,71,126,28,89,47,35,7,100,78,22,3,3,27,17,10
"2021","Bradford 032B","E01010651",637,159,74,85,431,48,219,75,102,42,84,36,42,6,70,51,19,10,10,47,36,11
"2021","Bradford 032C","E01010825",573,158,60,98,370,36,198,60,110,28,62,38,21,3,71,44,27,3,3,45,27,18
"2021","Bradford 032D","E01010827",558,159,59,100,363,37,195,51,111,33,68,24,40,4,59,45,14,4,4,36,18,18
"2021","Bradford 033A","E01010804",477,43,19,24,274,13,200,30,118,52,8,1,7,0,52,18,34,1,1,160,122,38
"2021","Bradford 033B","E01010806",498,133,45,88,288,15,167,27,108,32,22,11,11,0,79,66,13,5,5,77,54,23
"2021","Bradford 033C","E01010807",860,377,78,299,388,12,215,35,144,36,69,57,12,0,85,53,32,7,7,95,69,26
"2021","Bradford 033D","E01010808",552,55,13,42,411,8,291,39,212,40,6,3,3,0,98,54,44,8,8,86,71,15
"2021","Bradford 033E","E01010809",490,66,16,50,287,15,181,7,127,47,8,1,7,0,80,32,48,3,3,137,106,31
"2021","Bradford 034A","E01010676",564,96,36,60,330,5,230,26,153,51,20,6,8,6,66,39,27,9,9,138,108,30
"2021","Bradford 034B","E01010679",611,221,34,187,298,19,167,24,110,33,15,7,7,1,86,61,25,11,11,92,73,19
"2021","Bradford 034C","E01010824",746,363,63,300,313,7,152,34,102,16,61,36,22,3,85,62,23,8,8,70,51,19
"2021","Bradford 034D","E01010840",541,175,97,78,279,12,174,18,129,27,17,6,11,0,71,46,25,5,5,87,72,15
"2021","Bradford 034E","E01010841",488,155,26,129,207,11,144,15,94,35,11,3,7,1,38,18,20,3,3,126,92,34
"2021","Bradford 035A","E01010828",729,317,138,179,370,41,165,49,90,26,71,42,24,5,87,61,26,6,6,42,23,19
"2021","Bradford 035B","E01010829",603,219,73,146,317,18,157,31,102,24,59,17,36,6,74,47,27,9,9,67,38,29
"2021","Bradford 035C","E01010830",768,208,57,151,485,13,289,43,223,23,40,18,18,4,135,100,35,8,8,75,30,45
"2021","Bradford 035D","E01010831",632,204,24,180,330,10,204,31,137,36,20,11,9,0,90,56,34,6,6,98,77,21
"2021","Bradford 035E","E01010832",578,97,34,63,390,11,242,26,182,34,32,6,24,2,99,82,17,6,6,91,74,17
"2021","Bradford 036A","E01010672",555,164,65,99,353,42,190,56,95,39,66,41,22,3,52,38,14,3,3,38,27,11
"2021","Bradford 036B","E01010678",556,177,69,108,337,63,187,51,108,28,35,19,10,6,51,30,21,1,1,42,27,15
"2021","Bradford 036C","E01010799",662,219,94,125,402,52,205,75,100,30,57,35,18,4,85,62,23,3,3,41,26,15
"2021","Bradford 036D","E01010800",703,215,77,138,435,30,167,47,98,22,69,21,43,5,162,125,37,7,7,53,35,18
"2021","Bradford 036E","E01010801",646,186,75,111,381,26,235,46,152,37,37,17,20,0,80,56,24,3,3,79,61,18
"2021","Bradford 036F","E01010802",782,208,62,146,530,27,234,59,149,26,97,51,43,3,165,129,36,7,7,44,28,16
"2021","Bradford 037A","E01010803",574,113,20,93,390,12,250,43,171,36,31,7,24,0,82,53,29,15,15,71,43,28
"2021","Bradford 037B","E01010810",558,77,34,43,389,22,275,29,202,44,13,3,7,3,69,53,16,10,10,92,74,18
"2021","Bradford 037C","E01010811",585,107,17,90,385,4,279,33,212,34,22,3,18,1,73,53,20,7,7,93,70,23
"2021","Bradford 037D","E01010813",527,128,43,85,317,9,206,33,148,25,20,8,10,2,75,52,23,7,7,82,59,23
"2021","Bradford 038A","E01010618",519,120,34,86,319,10,179,26,127,26,23,8,12,3,102,64,38,5,5,80,62,18
"2021","Bradford 038B","E01010619",524,67,22,45,340,7,253,23,181,49,11,0,9,2,58,29,29,11,11,117,88,29
"2021","Bradford 038C","E01010625",514,95,33,62,362,9,205,17,154,34,20,5,14,1,125,84,41,3,3,57,44,13
"2021","Bradford 038D","E01010626",525,55,15,40,372,4,264,30,193,41,14,4,9,1,88,50,38,2,2,98,64,34
"2021","Bradford 038E","E01010627",534,112,34,78,366,21,190,49,105,36,39,10,24,5,110,63,47,6,6,56,37,19
"2021","Bradford 040A","E01010628",673,177,90,87,440,67,211,63,107,41,49,22,24,3,110,67,43,3,3,56,43,13
"2021","Bradford 040B","E01010629",640,114,54,60,443,42,268,51,170,47,39,15,22,2,85,59,26,9,9,83,60,23
"2021","Bradford 040C","E01010630",673,181,91,90,455,33,268,47,198,23,61,26,32,3,83,57,26,10,10,37,29,8
"2021","Bradford 040D","E01010631",552,125,52,73,385,13,172,46,97,29,44,12,27,5,149,107,42,7,7,42,29,13
"2021","Bradford 040E","E01010632",560,158,31,127,361,12,145,39,92,14,36,17,17,2,163,118,45,5,5,41,26,15
"2021","Bradford 041A","E01010658",615,119,36,83,434,33,249,47,171,31,34,8,22,4,107,77,30,11,11,62,43,19
"2021","Bradford 041B","E01010812",614,142,32,110,401,4,246,40,171,35,37,14,21,2,100,74,26,14,14,71,60,11
"2021","Bradford 041C","E01010833",595,209,35,174,287,12,133,23,84,26,38,15,18,5,92,67,25,12,12,99,63,36
"2021","Bradford 041D","E01010843",451,55,13,42,281,7,188,14,137,37,9,2,6,1,71,45,26,6,6,115,89,26
"2021","Bradford 042A","E01010620",557,131,38,93,343,10,242,43,173,26,22,7,14,1,61,37,24,8,8,83,56,27
"2021","Bradford 042B","E01010621",537,53,12,41,369,8,260,25,191,44,11,1,8,2,79,49,30,11,11,115,95,20
"2021","Bradford 042C","E01010622",662,123,23,100,421,6,300,42,225,33,20,7,13,0,87,51,36,8,8,118,89,29
"2021","Bradford 042D","E01010623",564,196,85,111,303,9,173,27,113,33,25,7,18,0,90,55,35,6,6,65,53,12
"2021","Bradford 042E","E01010624",583,133,26,107,339,10,220,31,152,37,23,8,11,4,73,37,36,13,13,111,81,30
"2021","Bradford 043A","E01010794",799,238,122,116,513,97,254,79,131,44,66,30,26,10,86,60,26,10,10,48,29,19
"2021","Bradford 043B","E01010795",842,264,100,164,546,53,250,96,112,42,141,80,55,6,96,68,28,6,6,32,16,16
"2021","Bradford 043C","E01010796",716,230,102,128,449,72,191,68,92,31,89,33,47,9,92,67,25,5,5,37,17,20
"2021","Bradford 043D","E01010797",581,106,44,62,456,63,261,113,98,50,78,48,28,2,53,34,19,1,1,19,14,5
"2021","Bradford 043E","E01010798",718,297,97,200,400,48,143,57,57,29,89,44,40,5,116,83,33,4,4,21,8,13
"2021","Bradford 044A","E01010834",775,495,17,478,181,0,86,26,51,9,52,46,5,1,34,19,15,9,9,99,45,54
"2021","Bradford 044C","E01010836",548,148,13,135,293,3,172,25,116,31,28,9,19,0,62,43,19,28,28,107,70,37
"2021","Bradford 044D","E01010837",506,62,22,40,333,16,236,17,160,59,10,1,9,0,64,33,31,7,7,111,78,33
"2021","Bradford 044E","E01010838",573,111,22,89,363,10,229,22,173,34,36,8,27,1,84,64,20,4,4,99,73,26
"2021","Bradford 044F","E01010839",531,173,41,132,270,8,155,22,108,25,22,7,12,3,81,61,20,4,4,88,66,22
"2021","Bradford 044G","E01033900",409,74,22,52,259,16,165,16,120,29,3,0,3,0,58,42,16,17,17,76,59,17
"2021","Bradford 044H","E01033901",402,45,17,28,269,12,170,24,105,41,7,4,3,0,77,52,25,3,3,88,62,26
"2021","Bradford 045A","E01010608",480,100,35,65,303,3,188,28,137,23,15,5,10,0,92,39,53,5,5,77,52,25
"2021","Bradford 045B","E01010613",698,297,77,220,343,31,162,54,85,23,71,27,40,4,76,55,21,3,3,58,28,30
"2021","Bradford 045C","E01010730",662,357,96,261,246,8,80,28,47,5,56,34,19,3,94,67,27,8,8,59,21,38
"2021","Bradford 045D","E01010734",490,113,19,94,325,11,133,22,82,29,82,12,61,9,95,73,22,4,4,52,34,18
"2021","Bradford 046A","E01010609",696,252,108,144,414,36,170,54,85,31,74,30,34,10,130,97,33,4,4,30,18,12
"2021","Bradford 046B","E01010610",885,315,76,239,523,19,163,45,91,27,95,34,57,4,235,189,46,11,11,47,29,18
"2021","Bradford 046C","E01010611",898,287,99,188,549,24,190,64,100,26,110,40,65,5,214,159,55,11,11,62,31,31
"2021","Bradford 046D","E01010614",606,174,51,123,391,27,142,46,67,29,69,27,35,7,148,96,52,5,5,41,17,24
"2021","Bradford 047A","E01010633",677,237,106,131,407,60,183,65,81,37,57,31,22,4,106,82,24,1,1,33,18,15
"2021","Bradford 047B","E01010634",656,170,75,95,448,70,211,93,71,47,95,45,44,6,71,47,24,1,1,38,14,24
"2021","Bradford 047C","E01010635",658,268,115,153,359,29,134,41,60,33,49,17,24,8,134,90,44,13,13,31,15,16
"2021","Bradford 047D","E01010636",739,241,119,122,458,80,216,94,74,48,93,51,30,12,69,47,22,0,0,40,22,18
"2021","Bradford 047E","E01010637",574,143,38,105,394,29,183,54,97,32,81,34,41,6,96,66,30,5,5,37,16,21
"2021","Bradford 048A","E01010731",633,323,60,263,222,4,119,27,82,10,16,6,10,0,72,61,11,11,11,88,47,41
"2021","Bradford 048B","E01010732",453,104,14,90,285,4,152,13,115,24,16,6,8,2,107,83,24,6,6,64,50,14
"2021","Bradford 048C","E01010733",579,236,76,160,276,7,159,19,112,28,25,14,9,2,77,45,32,8,8,67,52,15
"2021","Bradford 048D","E01010736",623,144,26,118,419,6,221,28,174,19,55,11,43,1,128,112,16,9,9,60,38,22
"2021","Bradford 048E","E01010737",518,149,58,91,301,3,166,25,108,33,27,5,22,0,95,76,19,10,10,68,53,15
"2021","Bradford 049A","E01010659",619,149,60,89,406,19,202,35,138,29,33,8,23,2,143,107,36,9,9,64,51,13
"2021","Bradford 049D","E01010662",497,96,39,57,360,42,201,49,112,40,37,16,16,5,75,53,22,5,5,41,25,16
"2021","Bradford 049E","E01010664",530,129,72,57,345,46,195,49,109,37,29,9,17,3,67,45,22,8,8,56,35,21
"2021","Bradford 049G","E01010761",680,218,95,123,420,65,201,61,96,44,52,25,25,2,96,56,40,6,6,42,32,10
"2021","Bradford 049H","E01033695",738,143,27,116,557,22,302,76,174,52,100,40,49,11,129,94,35,4,4,38,28,10
"2021","Bradford 049I","E01033696",696,209,61,148,468,61,215,73,99,43,113,62,41,10,72,50,22,7,7,19,8,11
"2021","Bradford 049J","E01033697",791,133,33,100,534,21,336,53,228,55,19,7,10,2,146,93,53,12,12,124,88,36
"2021","Bradford 050A","E01010663",673,265,77,188,335,12,169,22,128,19,54,24,28,2,90,55,35,10,10,73,43,30
"2021","Bradford 050B","E01010665",630,147,48,99,414,36,226,43,140,43,61,32,27,2,82,48,34,9,9,69,53,16
"2021","Bradford 050C","E01010666",688,287,88,199,367,21,152,36,106,10,78,24,50,4,109,81,28,7,7,34,25,9
"2021","Bradford 050D","E01010667",595,123,39,84,427,23,234,42,169,23,46,14,29,3,119,85,34,5,5,45,32,13
"2021","Bradford 051A","E01010735",551,128,30,98,375,5,192,15,146,31,32,3,25,4,117,82,35,29,29,48,34,14
"2021","Bradford 051B","E01010738",573,117,20,97,378,9,254,33,185,36,25,5,19,1,85,62,23,5,5,78,55,23
"2021","Bradford 051C","E01010739",631,118,48,70,462,11,200,23,152,25,40,12,26,2,203,166,37,8,8,51,35,16
"2021","Bradford 051D","E01010740",537,103,42,61,339,16,211,32,154,25,13,5,8,0,96,67,29,3,3,95,63,32
"2021","Bradford 051E","E01010744",466,52,14,38,326,9,209,24,155,30,27,10,15,2,73,45,28,8,8,88,65,23
"2021","Bradford 052A","E01010612",595,234,41,193,329,6,88,30,45,13,52,12,36,4,182,142,40,1,1,32,22,10
"2021","Bradford 052B","E01010819",658,278,88,190,341,13,116,37,47,32,62,23,34,5,133,108,25,17,17,39,23,16
"2021","Bradford 052C","E01010820",616,233,112,121,350,28,111,36,60,15,63,17,37,9,124,88,36,24,24,33,12,21
"2021","Bradford 052D","E01010821",786,254,54,200,488,12,151,43,88,20,122,54,65,3,197,154,43,6,6,44,26,18
"2021","Bradford 052E","E01010822",544,202,69,133,322,16,103,32,51,20,75,20,44,11,124,95,29,4,4,20,11,9
"2021","Bradford 053A","E01010615",539,154,58,96,343,45,162,58,77,27,60,29,21,10,71,49,22,5,5,42,23,19
"2021","Bradford 053B","E01010616",606,137,57,80,406,30,212,37,145,30,43,16,21,6,115,76,39,6,6,63,46,17
"2021","Bradford 053C","E01010742",576,128,36,92,376,7,238,31,175,32,34,11,21,2,86,65,21,11,11,72,47,25
"2021","Bradford 053D","E01010743",627,248,47,201,330,8,190,43,104,43,34,19,14,1,93,73,20,5,5,49,34,15
"2021","Bradford 054A","E01010847",693,228,90,138,438,47,193,60,89,44,92,43,38,11,103,70,33,3,3,27,16,11
"2021","Bradford 054B","E01010848",666,233,100,133,391,48,191,60,97,34,63,34,24,5,82,49,33,7,7,42,24,18
"2021","Bradford 054C","E01010852",706,204,90,114,444,41,249,54,166,29,55,23,27,5,87,54,33,12,12,58,39,19
"2021","Bradford 054D","E01010853",494,107,50,57,352,45,193,55,106,32,48,22,22,4,59,46,13,7,7,35,27,8
"2021","Bradford 055A","E01010668",498,110,59,51,350,50,211,54,116,41,33,13,17,3,47,29,18,9,9,38,27,11
"2021","Bradford 055B","E01010755",734,163,38,125,514,21,168,44,98,26,136,50,80,6,184,142,42,5,5,57,39,18
"2021","Bradford 055C","E01010762",609,207,70,137,359,32,168,49,88,31,67,34,23,10,88,65,23,4,4,43,29,14
"2021","Bradford 055D","E01010763",647,167,73,94,451,65,197,74,87,36,86,34,44,8,91,56,35,12,12,29,15,14
"2021","Bradford 055E","E01010846",859,247,90,157,564,53,245,87,103,55,102,48,48,6,154,107,47,10,10,48,33,15
"2021","Bradford 056A","E01010745",613,122,34,88,437,17,222,35,151,36,60,25,30,5,128,91,37,10,10,54,26,28
"2021","Bradford 056B","E01010747",647,224,101,123,378,38,182,62,89,31,57,31,21,5,91,54,37,10,10,45,31,14
"2021","Bradford 056C","E01010748",701,261,136,125,407,26,139,47,63,29,90,35,42,13,147,105,42,5,5,33,18,15
"2021","Bradford 056D","E01010749",637,243,103,140,371,36,122,47,48,27,76,39,31,6,133,95,38,4,4,23,12,11
"2021","Bradford 057A","E01010814",795,359,111,248,392,41,159,69,62,28,89,49,29,11,97,70,27,6,6,44,18,26
"2021","Bradford 057B","E01010815",973,252,74,178,654,19,298,81,165,52,134,52,74,8,195,148,47,8,8,67,39,28
"2021","Bradford 057C","E01010816",793,212,89,123,537,70,280,116,103,61,123,62,55,6,63,42,21,1,1,44,22,22
"2021","Bradford 057D","E01010817",983,283,114,169,637,25,269,72,156,41,136,40,85,11,195,153,42,12,12,63,47,16
"2021","Bradford 057E","E01010818",793,203,93,110,540,53,312,110,149,53,93,38,39,16,77,49,28,5,5,50,33,17
"2021","Bradford 058A","E01010752",949,335,81,254,574,55,251,97,119,35,132,74,53,5,132,98,34,4,4,40,25,15
"2021","Bradford 058B","E01010753",612,185,102,83,416,106,171,79,49,43,77,40,33,4,61,36,25,1,1,11,4,7
"2021","Bradford 058C","E01010754",682,218,91,127,431,42,221,77,96,48,100,60,37,3,67,49,18,1,1,33,17,16
"2021","Bradford 058D","E01010756",751,206,63,143,513,42,237,79,105,53,136,64,63,9,97,67,30,1,1,32,13,19
"2021","Bradford 058E","E01010758",505,93,43,50,388,39,257,107,101,49,64,28,32,4,24,14,10,4,4,24,12,12
"2021","Bradford 058F","E01010759",733,292,125,167,415,47,189,69,81,39,76,31,42,3,99,69,30,4,4,26,12,14
"2021","Bradford 058G","E01010760",742,135,51,84,576,81,334,126,154,54,93,40,49,4,66,38,28,2,2,31,12,19
"2021","Bradford 059A","E01010741",653,236,95,141,389,52,171,72,67,32,83,43,33,7,80,53,27,3,3,28,11,17
"2021","Bradford 059B","E01010845",851,301,138,163,502,21,204,58,114,32,82,29,46,7,172,136,36,23,23,48,30,18
"2021","Bradford 059C","E01010849",608,176,91,85,408,78,196,65,87,44,73,37,29,7,54,32,22,7,7,24,10,14
"2021","Bradford 059D","E01010850",503,123,30,93,333,8,106,37,49,20,78,26,44,8,139,108,31,2,2,47,24,23
"2021","Bradford 059E","E01010851",641,199,77,122,411,49,179,85,66,28,83,39,39,5,98,60,38,2,2,31,16,15
"2021","Bradford 059F","E01010864",520,153,47,106,351,20,155,66,52,37,72,28,36,8,102,80,22,2,2,16,12,4
"2021","Bradford 059G","E01010867",697,189,52,137,483,35,204,66,107,31,124,58,57,9,115,86,29,5,5,25,12,13
"2021","Bradford 059H","E01010874",607,214,89,125,354,22,125,36,63,26,97,31,57,9,108,91,17,2,2,39,22,17
"2021","Bradford 060A","E01010746",814,216,106,110,544,105,269,100,122,47,94,39,44,11,75,43,32,1,1,54,38,16
"2021","Bradford 060B","E01010750",685,203,103,100,450,85,199,80,76,43,84,40,40,4,76,46,30,6,6,32,15,17
"2021","Bradford 060C","E01010751",679,256,120,136,401,77,159,72,51,36,84,34,39,11,78,43,35,3,3,22,10,12
"2021","Bradford 060D","E01010865",727,230,100,130,468,74,199,91,78,30,94,42,35,17,95,60,35,6,6,29,11,18
"2021","Bradford 060E","E01010866",616,216,63,153,377,56,158,71,52,35,83,47,30,6,75,53,22,5,5,23,7,16
"2021","Bradford 061A","E01010868",696,229,71,158,427,32,154,58,62,34,68,24,35,9,166,105,61,7,7,40,24,16
"2021","Bradford 061B","E01010869",776,243,100,143,497,78,175,74,71,30,97,56,40,1,143,92,51,4,4,36,19,17
"2021","Bradford 061C","E01010870",674,239,133,106,408,83,191,86,72,33,85,36,40,9,45,25,20,4,4,27,11,16
"2021","Bradford 061D","E01010871",804,284,87,197,486,46,215,96,73,46,124,64,48,12,95,58,37,6,6,34,17,17
"2021","Bradford 061E","E01010872",725,218,104,114,469,38,191,55,100,36,115,34,78,3,123,92,31,2,2,38,21,17
"2021","Bradford 061F","E01010873",507,128,73,55,363,74,161,65,59,37,83,35,41,7,44,18,26,1,1,16,9,7
"2021","Bradford 062A","E01010638",689,249,113,136,415,104,203,95,63,45,67,35,28,4,40,23,17,1,1,25,5,20
"2021","Bradford 062B","E01010642",893,177,120,57,693,174,345,168,118,59,108,67,34,7,65,41,24,1,1,23,7,16
"2021","Bradford 062E","E01010643",668,266,65,201,389,55,166,81,52,33,111,71,30,10,54,38,16,3,3,13,8,5
"2021","Bradford 062D","E01010644",827,213,80,133,591,85,309,101,161,47,110,45,56,9,83,49,34,4,4,23,7,16
"2021","Bradford 062C","E01010645",744,161,90,71,561,100,333,136,153,44,92,50,32,10,35,16,19,1,1,22,9,13
"2021","Bradford 063C","E01010639",987,402,169,233,561,105,240,103,93,44,137,70,62,5,78,54,24,1,1,24,10,14
"2021","Bradford 063A","E01010640",830,323,103,220,486,57,188,81,75,32,129,74,47,8,108,69,39,4,4,21,6,15
"2021","Bradford 063B","E01010641",643,184,109,75,438,99,224,89,94,41,66,34,26,6,49,29,20,0,0,21,8,13
"2021","Bradford 064E","E01010606",591,177,51,126,336,4,221,28,161,32,32,14,15,3,74,50,24,5,5,78,47,31
"2021","Bradford 064C","E01010607",627,165,25,140,364,8,237,38,164,35,36,11,21,4,77,45,32,6,6,98,78,20
"2021","Bradford 064B","E01010617",612,220,48,172,344,15,175,39,121,15,32,16,14,2,117,77,40,5,5,48,35,13
"2021","Bradford 064D","E01033692",612,345,17,328,234,0,110,36,68,6,60,53,7,0,55,35,20,9,9,33,11,22
"2021","Bradford 064A","E01033693",934,348,20,328,437,7,238,40,169,29,78,63,13,2,100,69,31,14,14,149,101,48
"2021","Bradford 065A","E01010842",630,188,47,141,351,6,213,18,162,33,22,11,11,0,106,60,46,4,4,91,68,23
"2021","Bradford 065C","E01033690",1054,609,11,598,394,1,198,64,131,3,113,102,11,0,63,49,14,19,19,51,10,41
"2021","Bradford 065B","E01033691",1008,516,60,456,382,5,186,43,129,14,70,52,18,0,76,60,16,45,45,110,63,47
"2021","Calderdale 001A","E01010911",738,189,83,106,517,100,251,95,109,47,87,47,36,4,78,47,31,1,1,32,12,20
"2021","Calderdale 001B","E01010912",694,263,137,126,417,58,157,58,65,34,88,36,43,9,114,79,35,0,0,14,7,7
"2021","Calderdale 001C","E01010913",567,134,90,44,415,107,188,81,48,59,66,26,32,8,51,26,25,3,3,18,8,10
"2021","Calderdale 001D","E01010915",643,188,74,114,433,54,223,71,101,51,80,36,36,8,74,43,31,2,2,22,7,15
"2021","Calderdale 002A","E01010914",691,217,91,126,449,50,199,81,84,34,95,30,51,14,100,69,31,5,5,25,15,10
"2021","Calderdale 002B","E01010924",545,244,58,186,291,24,83,32,34,17,69,44,21,4,111,83,28,4,4,10,4,6
"2021","Calderdale 002C","E01010925",593,151,52,99,405,39,137,60,44,33,93,31,56,6,131,101,30,5,5,37,19,18
"2021","Calderdale 002D","E01010926",426,80,33,47,315,9,81,30,33,18,75,12,52,11,146,114,32,4,4,31,12,19
"2021","Calderdale 003A","E01010931",633,185,95,90,436,83,216,84,85,47,84,42,42,0,53,32,21,0,0,12,4,8
"2021","Calderdale 003B","E01010932",685,182,97,85,476,103,227,99,78,50,82,40,31,11,57,32,25,7,7,27,9,18
"2021","Calderdale 003C","E01010933",732,195,88,107,511,95,257,107,99,51,99,54,37,8,60,42,18,0,0,26,13,13
"2021","Calderdale 003D","E01010935",674,228,126,102,432,111,203,82,74,47,73,34,35,4,45,23,22,0,0,14,7,7
"2021","Calderdale 003E","E01010936",874,270,151,119,574,96,309,104,150,55,96,37,48,11,72,51,21,1,1,30,13,17
"2021","Calderdale 003F","E01010937",682,222,94,128,452,86,214,91,92,31,89,38,40,11,63,38,25,0,0,8,5,3
"2021","Calderdale 004A","E01010881",708,228,98,130,450,63,185,80,77,28,120,56,56,8,75,49,26,7,7,30,14,16
"2021","Calderdale 004B","E01010882",629,251,134,117,355,56,176,74,77,25,77,39,33,5,46,31,15,0,0,23,11,12
"2021","Calderdale 004C","E01010883",645,145,72,73,453,75,258,116,105,37,87,54,29,4,29,16,13,4,4,47,17,30
"2021","Calderdale 004D","E01010887",697,236,115,121,437,71,219,118,63,38,100,66,23,11,45,23,22,2,2,24,13,11
"2021","Calderdale 004E","E01010888",817,405,143,262,387,50,154,79,56,19,106,64,38,4,76,54,22,1,1,25,5,20
"2021","Calderdale 004F","E01010923",786,307,96,211,439,48,179,84,78,17,122,84,35,3,84,64,20,6,6,40,16,24
"2021","Calderdale 005A","E01010916",614,166,82,84,409,37,143,49,62,32,86,27,49,10,135,98,37,8,8,39,24,15
"2021","Calderdale 005B","E01010939",722,191,97,94,500,74,247,103,98,46,112,59,43,10,64,38,26,3,3,31,13,18
"2021","Calderdale 005C","E01010941",541,133,60,73,368,32,137,46,52,39,68,22,36,10,125,88,37,6,6,40,21,19
"2021","Calderdale 005D","E01010942",849,364,113,251,448,36,156,61,60,35,128,59,60,9,121,80,41,7,7,37,17,20
"2021","Calderdale 005E","E01010944",617,220,90,130,365,32,116,48,43,25,83,25,50,8,132,103,29,2,2,32,17,15
"2021","Calderdale 006A","E01010938",634,196,63,133,415,27,124,36,60,28,85,32,50,3,171,134,37,8,8,23,13,10
"2021","Calderdale 006B","E01010940",665,244,89,155,407,45,169,81,54,34,95,49,34,12,96,72,24,2,2,14,6,8
"2021","Calderdale 006C","E01010943",590,158,52,106,399,26,119,33,55,31,84,25,52,7,166,130,36,4,4,33,18,15
"2021","Calderdale 006D","E01010961",523,177,40,137,325,25,110,50,44,16,82,37,40,5,102,79,23,6,6,21,6,15
"2021","Calderdale 007A","E01010917",871,316,154,162,534,98,233,115,84,34,119,64,46,9,83,56,27,1,1,21,10,11
"2021","Calderdale 007B","E01010918",728,204,108,96,493,93,253,94,108,51,72,38,31,3,73,47,26,2,2,31,13,18
"2021","Calderdale 007C","E01010919",785,346,163,183,413,60,166,73,51,42,87,41,41,5,99,66,33,1,1,26,12,14
"2021","Calderdale 007D","E01010920",751,226,74,152,498,98,259,139,77,43,94,60,33,1,47,25,22,0,0,27,14,13
"2021","Calderdale 007E","E01010921",738,262,99,163,448,58,211,85,84,42,86,42,38,6,91,63,28,2,2,28,15,13
"2021","Calderdale 008A","E01010934",937,341,130,211,565,98,254,111,100,43,118,65,43,10,93,54,39,2,2,31,15,16
"2021","Calderdale 008D","E01010967",824,427,108,319,375,22,123,59,48,16,96,56,36,4,128,93,35,6,6,22,7,15
"2021","Calderdale 008F","E01032923",1118,520,153,367,548,43,175,82,53,40,145,68,64,13,181,125,56,4,4,50,23,27
"2021","Calderdale 008G","E01034582",829,555,124,431,235,19,110,37,64,9,61,46,14,1,42,28,14,3,3,39,12,27
"2021","Calderdale 008H","E01034583",551,339,84,255,188,22,100,39,56,5,36,28,6,2,25,18,7,5,5,24,9,15
"2021","Calderdale 009A","E01010927",919,208,102,106,677,114,371,151,162,58,118,58,53,7,72,43,29,2,2,34,20,14
"2021","Calderdale 009B","E01010928",631,193,74,119,414,33,150,61,62,27,81,34,44,3,144,110,34,6,6,24,14,10
"2021","Calderdale 009C","E01010997",637,188,112,76,414,109,206,89,86,31,71,44,21,6,25,16,9,3,3,35,24,11
"2021","Calderdale 009D","E01010999",625,165,75,90,440,67,229,86,106,37,82,39,40,3,60,36,24,2,2,20,12,8
"2021","Calderdale 010A","E01010929",926,222,59,163,635,24,342,78,231,33,106,44,55,7,150,113,37,13,13,69,41,28
"2021","Calderdale 010B","E01010930",746,279,102,177,430,35,168,52,84,32,75,34,34,7,144,116,28,8,8,37,19,18
"2021","Calderdale 010C","E01010998",716,233,101,132,430,45,197,54,114,29,59,29,27,3,126,87,39,3,3,53,28,25
"2021","Calderdale 010D","E01011000",620,110,29,81,424,21,250,40,181,29,41,6,33,2,103,84,19,9,9,86,69,17
"2021","Calderdale 011A","E01010904",693,181,77,104,498,93,233,95,103,35,96,41,46,9,76,54,22,0,0,14,8,6
"2021","Calderdale 011B","E01010906",594,147,101,46,427,106,224,63,113,48,62,34,24,4,35,21,14,0,0,20,9,11
"2021","Calderdale 011C","E01010907",637,172,72,100,441,66,222,90,91,41,85,51,26,8,68,42,26,0,0,24,8,16
"2021","Calderdale 011D","E01010909",788,280,122,158,482,73,211,80,97,34,96,48,45,3,101,74,27,1,1,26,13,13
"2021","Calderdale 012A","E01010960",458,101,31,70,289,4,176,31,119,26,31,15,12,4,75,51,24,3,3,68,50,18
"2021","Calderdale 012B","E01010964",539,193,59,134,275,17,154,29,113,12,27,8,18,1,70,47,23,7,7,71,47,24
"2021","Calderdale 012C","E01010965",489,227,79,148,178,15,100,14,65,21,15,11,4,0,43,25,18,5,5,84,66,18
"2021","Calderdale 012D","E01010966",497,130,25,105,276,13,176,19,123,34,16,7,9,0,68,48,20,3,3,91,66,25
"2021","Calderdale 012E","E01010995",418,119,18,101,220,2,146,25,90,31,16,9,6,1,50,34,16,6,6,79,52,27
"2021","Calderdale 013A","E01010982",609,188,89,99,387,62,170,68,64,38,90,56,27,7,63,45,18,2,2,34,12,22
"2021","Calderdale 013B","E01010983",771,365,137,228,349,51,128,46,61,21,89,55,27,7,74,52,22,7,7,57,21,36
"2021","Calderdale 013C","E01010985",642,200,69,131,424,42,186,91,75,20,109,57,45,7,83,57,26,4,4,18,6,12
"2021","Calderdale 013D","E01010986",778,296,78,218,447,40,166,56,83,27,113,51,53,9,123,94,29,5,5,35,15,20
"2021","Calderdale 013E","E01010987",791,263,116,147,498,69,208,67,98,43,116,61,46,9,101,76,25,4,4,30,16,14
"2021","Calderdale 013F","E01010988",641,208,97,111,404,61,154,66,59,29,91,38,44,9,91,71,20,7,7,29,12,17
"2021","Calderdale 014A","E01010996",440,97,32,65,270,11,157,26,96,35,27,11,13,3,70,58,12,5,5,73,52,21
"2021","Calderdale 014B","E01011001",472,92,22,70,312,6,199,31,146,22,32,13,18,1,68,46,22,7,7,68,39,29
"2021","Calderdale 014C","E01011002",633,175,41,134,400,30,228,49,149,30,44,26,15,3,93,72,21,5,5,58,47,11
"2021","Calderdale 014D","E01011003",593,249,63,186,300,10,148,35,98,15,49,27,20,2,89,68,21,4,4,44,26,18
"2021","Calderdale 015A","E01010878",874,406,134,272,456,50,162,72,57,33,123,73,43,7,117,83,34,4,4,12,5,7
"2021","Calderdale 015B","E01010879",804,244,132,112,530,103,273,110,121,42,104,64,33,7,47,22,25,3,3,30,13,17
"2021","Calderdale 015C","E01010905",809,203,91,112,586,87,322,119,153,50,119,60,50,9,58,32,26,0,0,20,14,6
"2021","Calderdale 015D","E01010908",988,330,133,197,636,105,288,103,134,51,138,80,54,4,103,72,31,2,2,22,10,12
"2021","Calderdale 015E","E01010910",574,202,85,117,344,50,161,64,66,31,57,24,27,6,74,54,20,2,2,28,12,16
"2021","Calderdale 016A","E01010969",766,262,117,145,469,83,221,74,114,33,86,55,26,5,73,49,24,6,6,35,19,16
"2021","Calderdale 016B","E01010970",900,352,128,224,514,76,231,88,107,36,106,74,29,3,96,63,33,5,5,34,18,16
"2021","Calderdale 016C","E01010974",632,263,107,156,313,35,144,37,77,30,49,31,16,2,83,56,27,2,2,56,30,26
"2021","Calderdale 016D","E01010977",822,239,103,136,552,84,249,106,106,37,139,72,63,4,80,51,29,0,0,31,13,18
"2021","Calderdale 017A","E01010975",729,280,183,97,432,117,187,78,66,43,70,42,21,7,57,39,18,1,1,17,6,11
"2021","Calderdale 017B","E01010976",798,206,115,91,557,95,282,120,110,52,107,58,45,4,72,41,31,1,1,35,13,22
"2021","Calderdale 017C","E01010978",613,188,43,145,397,41,164,65,67,32,102,50,39,13,89,60,29,1,1,28,11,17
"2021","Calderdale 017D","E01010979",773,417,102,315,322,28,107,42,45,20,97,59,33,5,79,51,28,11,11,34,8,26
"2021","Calderdale 017E","E01010980",692,261,78,183,399,28,149,59,62,28,102,54,45,3,118,88,30,2,2,32,10,22
"2021","Calderdale 017F","E01010981",741,315,73,242,396,35,143,64,54,25,114,75,35,4,98,64,34,6,6,30,10,20
"2021","Calderdale 018A","E01010989",732,305,106,199,395,67,171,72,68,31,96,65,28,3,56,29,27,5,5,32,16,16
"2021","Calderdale 018B","E01010990",738,244,95,149,473,70,201,92,73,36,110,62,39,9,92,59,33,0,0,21,11,10
"2021","Calderdale 018C","E01010991",669,209,110,99,436,84,177,86,51,40,109,62,40,7,65,46,19,1,1,24,9,15
"2021","Calderdale 018D","E01010992",780,273,93,180,470,49,209,88,93,28,125,64,51,10,83,53,30,4,4,37,16,21
"2021","Calderdale 018E","E01010993",737,246,106,140,453,33,192,76,88,28,86,36,43,7,136,105,31,6,6,38,16,22
"2021","Calderdale 019A","E01010875",773,230,142,88,524,143,264,111,111,42,63,28,28,7,53,40,13,1,1,19,11,8
"2021","Calderdale 019B","E01010876",696,193,99,94,488,86,249,109,83,57,92,52,28,12,61,40,21,0,0,15,8,7
"2021","Calderdale 019C","E01010877",785,369,125,244,400,67,142,69,58,15,109,65,37,7,80,52,28,2,2,16,8,8
"2021","Calderdale 019D","E01010880",694,309,91,218,359,38,122,54,49,19,78,37,37,4,118,87,31,3,3,26,18,8
"2021","Calderdale 019E","E01010949",775,326,137,189,422,59,172,66,70,36,86,49,32,5,101,62,39,4,4,27,9,18
"2021","Calderdale 020A","E01010922",813,241,85,156,553,56,273,114,112,47,122,78,37,7,100,62,38,2,2,19,7,12
"2021","Calderdale 020B","E01010956",702,195,80,115,469,67,231,92,96,43,104,59,35,10,66,44,22,1,1,38,23,15
"2021","Calderdale 020C","E01010958",589,216,118,98,342,48,136,49,57,30,70,30,38,2,85,59,26,3,3,31,16,15
"2021","Calderdale 020D","E01010959",696,167,86,81,506,70,219,93,90,36,103,39,54,10,112,75,37,2,2,23,11,12
"2021","Calderdale 021A","E01010968",783,277,98,179,472,75,254,91,113,50,80,48,27,5,58,38,20,5,5,34,14,20
"2021","Calderdale 021B","E01010971",824,262,122,140,531,90,270,75,149,46,92,43,43,6,79,59,20,0,0,31,26,5
"2021","Calderdale 021C","E01010972",674,213,126,87,425,72,225,71,107,47,63,30,24,9,65,51,14,0,0,36,21,15
"2021","Calderdale 021D","E01010973",799,270,184,86,513,114,262,94,127,41,67,30,33,4,69,51,18,1,1,16,6,10
"2021","Calderdale 022A","E01010884",781,293,163,130,456,76,211,101,79,31,85,44,34,7,81,55,26,3,3,32,15,17
"2021","Calderdale 022B","E01010885",702,243,102,141,433,71,186,71,78,37,96,59,32,5,78,49,29,2,2,26,6,20
"2021","Calderdale 022C","E01010886",505,170,85,85,319,61,146,56,62,28,68,37,26,5,41,31,10,3,3,16,7,9
"2021","Calderdale 022D","E01010984",617,219,70,149,357,35,138,59,55,24,85,42,38,5,94,69,25,5,5,41,14,27
"2021","Calderdale 023A","E01010946",550,131,105,26,402,133,215,77,102,36,35,16,17,2,19,8,11,0,0,17,12,5
"2021","Calderdale 023B","E01010947",649,188,117,71,442,93,239,75,109,55,68,35,29,4,41,23,18,1,1,19,12,7
"2021","Calderdale 023C","E01010950",691,294,89,205,371,48,155,56,68,31,86,44,36,6,78,59,19,4,4,26,13,13
"2021","Calderdale 023D","E01010951",677,215,71,144,443,60,169,70,63,36,110,63,40,7,98,74,24,6,6,19,8,11
"2021","Calderdale 024A","E01010891",806,287,124,163,498,67,195,69,78,48,111,60,42,9,123,84,39,2,2,21,8,13
"2021","Calderdale 024B","E01010892",753,168,87,81,546,69,305,116,143,46,101,43,49,9,66,45,21,5,5,39,23,16
"2021","Calderdale 024C","E01010895",631,234,108,126,376,56,171,66,71,34,70,34,33,3,78,52,26,1,1,21,11,10
"2021","Calderdale 024D","E01010945",676,183,85,98,464,95,210,77,99,34,85,40,39,6,73,45,28,1,1,29,13,16
"2021","Calderdale 024E","E01010948",660,242,121,121,401,81,182,69,75,38,71,40,25,6,65,41,24,2,2,17,7,10
"2021","Calderdale 025A","E01010889",859,392,162,230,437,70,141,65,45,31,87,48,35,4,136,92,44,3,3,30,15,15
"2021","Calderdale 025B","E01010890",846,312,92,220,499,45,189,91,63,35,149,85,57,7,111,81,30,5,5,35,13,22
"2021","Calderdale 025C","E01010893",618,195,96,99,398,50,182,66,77,39,72,29,37,6,94,70,24,0,0,25,10,15
"2021","Calderdale 025D","E01010894",787,272,76,196,482,38,170,65,73,32,111,57,49,5,161,127,34,2,2,33,15,18
"2021","Calderdale 025E","E01010901",816,241,121,120,549,107,284,113,133,38,95,48,40,7,61,38,23,2,2,26,16,10
"2021","Calderdale 025F","E01010903",729,221,109,112,484,92,233,81,103,49,81,37,40,4,76,44,32,2,2,24,11,13
"2021","Calderdale 026A","E01010896",678,158,71,87,502,78,287,118,131,38,83,44,34,5,53,34,19,1,1,18,6,12
"2021","Calderdale 026B","E01010897",727,209,69,140,494,75,277,109,104,64,78,51,23,4,63,42,21,1,1,24,12,12
"2021","Calderdale 026C","E01010898",827,358,136,222,442,51,157,71,59,27,129,83,43,3,103,76,27,2,2,27,10,17
"2021","Calderdale 026D","E01010899",568,135,73,62,417,68,190,70,83,37,83,44,39,0,72,51,21,4,4,16,9,7
"2021","Calderdale 026E","E01010900",668,168,75,93,485,102,253,98,116,39,90,50,36,4,39,31,8,1,1,15,4,11
"2021","Calderdale 026F","E01010902",650,178,61,117,453,40,198,64,92,42,100,43,50,7,111,79,32,4,4,19,7,12
"2021","Calderdale 027A","E01010952",753,244,123,121,489,90,238,94,105,39,94,65,29,0,66,49,17,1,1,20,6,14
"2021","Calderdale 027B","E01010953",622,140,72,68,454,88,247,102,101,44,72,41,27,4,46,33,13,1,1,28,9,19
"2021","Calderdale 027C","E01010954",978,200,68,132,748,88,446,147,241,58,129,62,56,11,84,59,25,1,1,30,12,18
"2021","Calderdale 027D","E01010955",575,139,59,80,413,65,230,93,101,36,70,48,19,3,46,28,18,2,2,23,12,11
"2021","Calderdale 027E","E01010957",654,183,78,105,451,81,235,95,96,44,85,48,31,6,49,30,19,1,1,20,6,14
"2021","Kirklees 001A","E01011051",736,200,107,93,519,69,255,91,123,41,126,70,51,5,68,46,22,1,1,17,8,9
"2021","Kirklees 001B","E01011055",547,144,73,71,382,62,205,81,84,40,60,32,25,3,54,35,19,1,1,21,10,11
"2021","Kirklees 001C","E01011056",712,203,119,84,495,88,234,82,106,46,103,45,55,3,67,43,24,3,3,14,6,8
"2021","Kirklees 001D","E01011057",709,212,88,124,468,72,231,78,122,31,105,63,38,4,60,41,19,0,0,29,15,14
"2021","Kirklees 001E","E01011058",504,124,74,50,362,61,169,48,87,34,71,27,40,4,61,40,21,0,0,18,9,9
"2021","Kirklees 002A","E01011048",868,418,154,264,422,56,170,85,51,34,99,61,34,4,92,66,26,5,5,28,12,16
"2021","Kirklees 002B","E01011049",731,205,78,127,494,70,214,83,93,38,126,58,56,12,77,48,29,7,7,32,11,21
"2021","Kirklees 002C","E01011050",619,132,68,64,465,101,244,105,106,33,74,35,33,6,43,23,20,3,3,22,9,13
"2021","Kirklees 002D","E01011052",707,217,75,142,468,54,214,79,101,34,105,47,49,9,92,70,22,3,3,22,9,13
"2021","Kirklees 002E","E01011053",624,183,85,98,422,89,193,79,67,47,74,32,36,6,63,48,15,3,3,19,9,10
"2021","Kirklees 002F","E01011059",697,189,52,137,479,24,173,59,90,24,123,49,70,4,151,115,36,8,8,29,18,11
"2021","Kirklees 003A","E01011062",818,228,91,137,550,55,278,107,129,42,144,84,53,7,69,42,27,4,4,40,15,25
"2021","Kirklees 003B","E01011064",717,200,84,116,496,76,198,60,99,39,90,45,37,8,128,94,34,4,4,21,11,10
"2021","Kirklees 003C","E01011068",714,202,95,107,490,73,250,104,96,50,111,59,38,14,56,37,19,0,0,22,11,11
"2021","Kirklees 003D","E01011069",632,187,102,85,430,104,206,81,85,40,86,46,31,9,33,15,18,1,1,15,6,9
"2021","Kirklees 004A","E01011241",642,153,76,77,466,93,271,95,128,48,70,38,26,6,32,18,14,0,0,23,12,11
"2021","Kirklees 004B","E01011242",699,207,107,100,451,56,190,74,78,38,93,41,39,13,106,69,37,6,6,41,20,21
"2021","Kirklees 004C","E01011243",743,216,117,99,512,106,248,112,93,43,83,46,29,8,69,43,26,6,6,15,9,6
"2021","Kirklees 004D","E01011244",820,219,93,126,577,77,265,78,142,45,124,61,55,8,105,63,42,6,6,24,13,11
"2021","Kirklees 005A","E01011060",774,312,144,168,443,78,194,63,88,43,96,48,42,6,69,47,22,6,6,19,12,7
"2021","Kirklees 005B","E01011061",918,485,181,304,409,47,142,57,52,33,103,63,33,7,112,89,23,5,5,24,12,12
"2021","Kirklees 005C","E01011063",1001,375,157,218,589,73,222,86,101,35,147,65,78,4,139,111,28,8,8,37,16,21
"2021","Kirklees 005D","E01011065",706,219,59,160,455,44,203,74,91,38,116,58,50,8,86,59,27,6,6,32,20,12
"2021","Kirklees 005E","E01011066",661,182,96,86,450,100,200,72,80,48,95,44,42,9,54,31,23,1,1,29,18,11
"2021","Kirklees 006A","E01011027",522,139,63,76,364,42,168,57,82,29,75,32,38,5,77,55,22,2,2,19,9,10
"2021","Kirklees 006B","E01011028",648,241,72,169,372,35,165,59,83,23,89,49,34,6,77,55,22,6,6,35,18,17
"2021","Kirklees 006C","E01011030",598,124,38,86,438,26,173,49,92,32,91,31,51,9,146,102,44,2,2,36,16,20
"2021","Kirklees 006D","E01011031",766,177,92,85,553,93,291,103,133,55,98,41,51,6,66,47,19,5,5,36,20,16
"2021","Kirklees 006E","E01011054",590,156,93,63,417,100,211,78,97,36,69,36,26,7,35,18,17,2,2,17,8,9
"2021","Kirklees 007A","E01011013",609,157,96,61,422,101,224,71,105,48,60,32,19,9,35,21,14,2,2,30,13,17
"2021","Kirklees 007B","E01011014",621,190,46,144,387,28,197,57,105,35,87,48,32,7,72,52,20,3,3,44,21,23
"2021","Kirklees 007C","E01011023",634,161,56,105,431,48,268,70,162,36,61,32,24,5,52,30,22,2,2,42,30,12
"2021","Kirklees 007D","E01011024",685,166,56,110,471,34,247,64,147,36,79,33,39,7,108,72,36,3,3,48,28,20
"2021","Kirklees 008A","E01011067",702,175,91,84,508,99,232,83,101,48,104,51,49,4,69,43,26,4,4,19,9,10
"2021","Kirklees 008B","E01011247",665,177,75,102,471,73,214,88,84,42,110,52,49,9,70,42,28,4,4,17,10,7
"2021","Kirklees 008C","E01011249",717,182,88,94,506,81,229,75,107,47,81,35,43,3,110,86,24,5,5,29,14,15
"2021","Kirklees 008D","E01011251",710,237,98,139,435,39,158,48,77,33,110,42,65,3,122,89,33,6,6,38,23,15
"2021","Kirklees 009A","E01011245",603,133,68,65,438,77,201,72,88,41,73,30,36,7,85,61,24,2,2,32,18,14
"2021","Kirklees 009B","E01011246",642,213,65,148,390,25,167,76,68,23,81,26,49,6,110,74,36,7,7,39,23,16
"2021","Kirklees 009C","E01011248",683,258,150,108,416,72,199,85,84,30,74,35,31,8,68,43,25,3,3,9,3,6
"2021","Kirklees 009D","E01011250",896,398,102,296,475,42,146,68,55,23,136,66,65,5,143,107,36,8,8,23,11,12
"2021","Kirklees 010A","E01011015",564,213,91,122,295,32,192,38,109,45,13,3,9,1,51,27,24,7,7,56,34,22
"2021","Kirklees 010B","E01011029",686,287,96,191,373,19,175,40,112,23,56,31,20,5,117,79,38,6,6,26,13,13
"2021","Kirklees 010C","E01011032",925,367,77,290,505,23,237,51,147,39,113,82,27,4,127,98,29,5,5,53,28,25
"2021","Kirklees 010D","E01011034",457,91,45,46,300,18,211,35,132,44,22,9,11,2,43,28,15,6,6,66,44,22
"2021","Kirklees 011A","E01011157",595,164,46,118,376,37,215,56,120,39,52,27,24,1,71,44,27,1,1,55,36,19
"2021","Kirklees 011B","E01011161",536,130,53,77,383,64,191,68,78,45,72,36,28,8,55,36,19,1,1,23,12,11
"2021","Kirklees 011C","E01011163",623,253,128,125,346,47,148,55,65,28,54,22,26,6,96,62,34,1,1,24,15,9
"2021","Kirklees 011D","E01011164",719,191,104,87,500,78,234,78,117,39,104,42,50,12,80,46,34,4,4,28,9,19
"2021","Kirklees 011E","E01011165",567,111,37,74,389,29,239,48,144,47,60,29,29,2,58,43,15,3,3,67,45,22
"2021","Kirklees 011F","E01011166",661,237,72,165,372,38,212,59,124,29,64,30,26,8,55,39,16,3,3,52,34,18
"2021","Kirklees 011G","E01011167",720,261,94,167,384,45,207,53,122,32,57,32,19,6,69,41,28,6,6,75,48,27
"2021","Kirklees 012A","E01011033",659,187,73,114,437,46,259,68,146,45,64,31,31,2,63,41,22,5,5,35,20,15
"2021","Kirklees 012B","E01011035",481,116,37,79,293,18,209,28,123,58,15,9,5,1,43,24,19,8,8,72,49,23
"2021","Kirklees 012C","E01011036",581,151,53,98,383,16,230,44,159,27,48,17,23,8,84,52,32,5,5,47,35,12
"2021","Kirklees 012D","E01011037",842,226,62,164,560,41,319,96,189,34,95,46,47,2,97,67,30,8,8,56,36,20
"2021","Kirklees 013A","E01011016",519,154,38,116,306,30,160,41,86,33,61,34,21,6,52,29,23,3,3,59,28,31
"2021","Kirklees 013B","E01011017",453,85,50,35,309,26,212,41,99,72,15,3,11,1,48,19,29,8,8,59,45,14
"2021","Kirklees 013C","E01011018",422,83,40,43,297,19,203,35,123,45,24,9,14,1,48,20,28,3,3,42,30,12
"2021","Kirklees 013D","E01011019",508,130,47,83,337,47,199,53,86,60,37,15,18,4,48,20,28,6,6,41,27,14
"2021","Kirklees 013E","E01011020",440,130,38,92,271,4,195,20,144,31,19,10,8,1,48,28,20,5,5,39,25,14
"2021","Kirklees 014A","E01011021",667,186,87,99,455,70,240,78,101,61,81,35,39,7,61,35,26,3,3,26,13,13
"2021","Kirklees 014B","E01011022",583,147,77,70,405,67,207,77,95,35,66,22,39,5,61,40,21,4,4,31,18,13
"2021","Kirklees 014C","E01011126",876,336,133,203,514,54,232,89,100,43,110,52,48,10,114,91,23,4,4,26,12,14
"2021","Kirklees 014D","E01011127",579,164,81,83,395,64,199,67,88,44,72,42,25,5,58,33,25,2,2,20,7,13
"2021","Kirklees 015A","E01011156",676,233,140,93,419,80,207,69,94,44,83,45,30,8,48,32,16,1,1,24,11,13
"2021","Kirklees 015B","E01011158",772,206,70,136,523,61,251,81,126,44,118,50,57,11,91,60,31,2,2,43,22,21
"2021","Kirklees 015C","E01011159",716,185,101,84,501,109,249,87,111,51,88,47,34,7,54,33,21,1,1,30,9,21
"2021","Kirklees 015D","E01011160",532,119,56,63,393,57,220,82,95,43,81,31,45,5,35,27,8,0,0,20,9,11
"2021","Kirklees 015E","E01011162",677,213,114,99,444,88,194,72,85,37,93,43,43,7,68,42,26,1,1,20,9,11
"2021","Kirklees 016A","E01011025",573,150,55,95,392,39,194,53,123,18,57,17,35,5,99,73,26,3,3,31,15,16
"2021","Kirklees 016B","E01011026",555,169,63,106,335,26,215,55,110,50,42,24,15,3,48,36,12,4,4,51,29,22
"2021","Kirklees 016C","E01011136",639,218,98,120,387,40,196,43,122,31,49,17,29,3,92,65,27,10,10,34,24,10
"2021","Kirklees 016D","E01011137",629,207,62,145,392,15,189,65,95,29,72,33,34,5,111,80,31,5,5,30,16,14
"2021","Kirklees 017A","E01011128",761,298,68,230,405,17,241,45,158,38,67,45,22,0,73,48,25,7,7,58,36,22
"2021","Kirklees 017B","E01011130",967,471,114,357,431,25,197,58,118,21,99,58,39,2,102,69,33,8,8,65,37,28
"2021","Kirklees 017F","E01034584",616,205,68,137,362,51,197,43,119,35,56,23,26,7,54,32,22,4,4,49,30,19
"2021","Kirklees 017G","E01034585",408,91,26,65,260,13,183,29,109,45,30,13,15,2,29,15,14,5,5,57,36,21
"2021","Kirklees 018A","E01011121",728,191,53,138,504,26,204,79,93,32,134,53,75,6,135,104,31,5,5,33,16,17
"2021","Kirklees 018B","E01011122",495,95,45,50,374,19,136,44,62,30,87,20,51,16,125,86,39,7,7,26,16,10
"2021","Kirklees 018C","E01011123",682,274,101,173,372,43,185,59,95,31,71,41,24,6,69,40,29,4,4,36,27,9
"2021","Kirklees 018D","E01011124",865,288,108,180,548,60,250,96,118,36,143,80,55,8,91,56,35,4,4,29,13,16
"2021","Kirklees 018E","E01011125",840,215,97,118,588,62,257,75,141,41,150,69,73,8,116,82,34,3,3,37,24,13
"2021","Kirklees 018F","E01011129",487,112,50,62,345,43,184,68,74,42,60,22,29,9,56,33,23,2,2,30,13,17
"2021","Kirklees 019A","E01011138",637,192,48,144,370,17,216,51,138,27,37,18,16,3,92,71,21,8,8,75,58,17
"2021","Kirklees 019B","E01011139",487,78,36,42,359,28,200,41,124,35,63,25,31,7,64,36,28,4,4,50,37,13
"2021","Kirklees 019C","E01011140",493,81,28,53,345,11,182,20,144,18,50,11,29,10,101,71,30,1,1,67,42,25
"2021","Kirklees 019D","E01011141",527,103,26,77,361,14,250,48,166,36,30,13,15,2,63,48,15,4,4,63,41,22
"2021","Kirklees 020A","E01011132",627,141,97,44,466,117,264,87,120,57,50,20,26,4,35,16,19,0,0,20,11,9
"2021","Kirklees 020B","E01011142",679,190,97,93,456,87,213,82,90,41,85,42,37,6,69,46,23,2,2,33,9,24
"2021","Kirklees 020C","E01011217",721,204,134,70,505,133,222,106,75,41,81,47,27,7,69,39,30,0,0,12,5,7
"2021","Kirklees 020D","E01011218",732,237,124,113,467,73,218,77,108,33,95,46,42,7,79,59,20,2,2,28,11,17
"2021","Kirklees 021A","E01011216",603,154,91,63,434,80,239,94,98,47,70,30,39,1,42,28,14,3,3,15,9,6
"2021","Kirklees 021B","E01011219",711,208,104,104,490,107,252,94,110,48,70,36,31,3,59,32,27,2,2,13,4,9
"2021","Kirklees 021C","E01011220",731,233,98,135,471,42,192,63,99,30,105,41,57,7,128,88,40,4,4,27,17,10
"2021","Kirklees 021D","E01011221",712,185,113,72,505,103,239,75,108,56,94,41,45,8,67,36,31,2,2,22,6,16
"2021","Kirklees 022A","E01011046",530,97,54,43,404,105,242,76,104,62,34,10,21,3,20,6,14,3,3,29,13,16
"2021","Kirklees 022B","E01011100",684,263,119,144,390,51,147,63,63,21,59,27,24,8,124,81,43,9,9,31,17,14
"2021","Kirklees 022C","E01011102",508,107,47,60,370,57,213,66,98,49,46,22,16,8,54,33,21,0,0,31,13,18
"2021","Kirklees 022D","E01011108",635,205,78,127,400,68,180,81,64,35,89,54,31,4,60,35,25,3,3,30,19,11
"2021","Kirklees 023A","E01011133",468,102,30,72,297,13,192,23,141,28,26,12,10,4,55,37,18,11,11,69,56,13
"2021","Kirklees 023B","E01011134",588,118,16,102,386,14,224,29,167,28,38,14,23,1,102,66,36,8,8,84,61,23
"2021","Kirklees 023C","E01011143",541,121,22,99,360,4,221,41,156,24,46,16,30,0,85,67,18,4,4,60,47,13
"2021","Kirklees 023D","E01011144",518,164,50,114,261,10,168,29,120,19,21,11,10,0,57,38,19,5,5,93,73,20
"2021","Kirklees 023E","E01011260",523,136,38,98,354,32,205,44,136,25,47,24,20,3,67,47,20,3,3,33,24,9
"2021","Kirklees 024A","E01011257",489,54,31,23,297,22,235,30,136,69,9,3,6,0,27,7,20,4,4,138,101,37
"2021","Kirklees 024B","E01011258",413,25,15,10,256,31,186,37,97,52,2,1,0,1,36,13,23,1,1,132,96,36
"2021","Kirklees 024C","E01011259",628,131,53,78,427,22,277,65,181,31,28,14,12,2,89,57,32,11,11,70,47,23
"2021","Kirklees 024D","E01011261",426,94,23,71,288,10,219,34,157,28,22,8,13,1,34,23,11,3,3,44,37,7
"2021","Kirklees 024E","E01011262",555,151,58,93,363,17,229,33,163,33,26,16,10,0,86,53,33,5,5,41,33,8
"2021","Kirklees 024F","E01011263",668,184,94,90,436,52,233,75,122,36,67,35,26,6,81,49,32,3,3,48,24,24
"2021","Kirklees 025A","E01011101",731,237,56,181,453,26,142,39,79,24,89,21,61,7,188,143,45,8,8,41,24,17
"2021","Kirklees 025B","E01011103",628,250,93,157,349,39,111,42,49,20,62,26,29,7,128,94,34,9,9,29,17,12
"2021","Kirklees 025C","E01011104",753,315,108,207,413,48,173,56,93,24,67,34,27,6,118,75,43,7,7,25,21,4
"2021","Kirklees 025D","E01011105",892,210,68,142,630,21,263,55,174,34,122,54,58,10,217,152,65,7,7,52,33,19
"2021","Kirklees 026A","E01011212",766,304,170,134,438,76,182,70,74,38,79,35,34,10,95,50,45,6,6,24,13,11
"2021","Kirklees 026B","E01011213",655,161,112,49,473,124,251,93,110,48,56,27,24,5,41,24,17,1,1,21,9,12
"2021","Kirklees 026C","E01011214",669,212,81,131,444,74,220,87,96,37,84,53,29,2,62,44,18,4,4,13,8,5
"2021","Kirklees 026D","E01011215",1159,498,210,288,626,119,250,91,112,47,160,101,54,5,93,72,21,4,4,35,16,19
"2021","Kirklees 027A","E01011039",662,190,90,100,406,69,214,65,113,36,45,24,19,2,73,40,33,5,5,66,49,17
"2021","Kirklees 027B","E01011042",634,193,69,124,397,46,245,85,127,33,48,27,18,3,51,33,18,7,7,44,30,14
"2021","Kirklees 027C","E01011047",643,158,91,67,454,127,227,105,75,47,65,37,25,3,31,14,17,4,4,31,18,13
"2021","Kirklees 027D","E01011210",880,256,84,172,584,74,313,107,145,61,114,63,45,6,79,60,19,4,4,40,20,20
"2021","Kirklees 028A","E01011252",496,114,59,55,352,86,173,93,54,26,74,45,16,13,19,9,10,0,0,30,15,15
"2021","Kirklees 028B","E01011253",511,135,63,72,343,40,119,54,41,24,70,25,36,9,110,73,37,4,4,33,22,11
"2021","Kirklees 028C","E01011254",651,181,109,72,453,98,263,114,99,50,53,28,21,4,39,16,23,0,0,17,7,10
"2021","Kirklees 028D","E01011255",613,198,73,125,387,33,141,60,55,26,96,26,49,21,114,78,36,3,3,28,17,11
"2021","Kirklees 028E","E01011256",586,208,83,125,364,51,132,47,56,29,91,41,43,7,84,63,21,6,6,14,6,8
"2021","Kirklees 029A","E01011038",706,247,101,146,410,20,173,25,119,29,45,20,20,5,167,116,51,5,5,49,20,29
"2021","Kirklees 029B","E01011041",657,249,53,196,370,25,167,54,84,29,57,38,18,1,115,71,44,6,6,38,22,16
"2021","Kirklees 029C","E01011106",709,247,44,203,430,21,116,26,65,25,93,41,42,10,192,151,41,8,8,32,16,16
"2021","Kirklees 029D","E01011107",885,407,44,363,367,4,144,27,104,13,91,57,33,1,114,80,34,14,14,111,25,86
"2021","Kirklees 030A","E01011201",895,450,225,225,423,70,190,76,97,17,84,49,33,2,78,52,26,1,1,22,12,10
"2021","Kirklees 030B","E01011203",788,208,114,94,556,100,304,112,144,48,80,40,39,1,67,43,24,5,5,24,8,16
"2021","Kirklees 030D","E01011211",794,193,113,80,570,119,292,92,149,51,95,49,44,2,58,42,16,6,6,31,17,14
"2021","Kirklees 030E","E01034586",635,157,91,66,462,98,234,90,93,51,73,31,37,5,56,32,24,1,1,16,7,9
"2021","Kirklees 030F","E01034587",578,78,12,66,484,18,258,73,172,13,131,74,56,1,75,61,14,2,2,16,6,10
"2021","Kirklees 031A","E01011040",655,186,34,152,395,13,207,43,130,34,60,33,24,3,105,74,31,10,10,74,47,27
"2021","Kirklees 031B","E01011043",949,288,52,236,543,15,311,70,201,40,84,49,33,2,120,77,43,13,13,118,58,60
"2021","Kirklees 031C","E01011044",548,130,44,86,354,29,195,38,130,27,50,19,28,3,78,37,41,2,2,64,39,25
"2021","Kirklees 031D","E01011045",709,294,85,209,330,11,196,27,130,39,33,14,18,1,81,52,29,9,9,85,55,30
"2021","Kirklees 032A","E01011089",579,204,97,107,353,63,155,65,61,29,62,30,29,3,70,51,19,3,3,22,10,12
"2021","Kirklees 032B","E01011091",571,140,74,66,405,79,205,88,79,38,71,29,31,11,50,31,19,0,0,26,20,6
"2021","Kirklees 032C","E01011092",570,153,95,58,404,107,201,88,74,39,60,39,17,4,35,13,22,1,1,13,7,6
"2021","Kirklees 032D","E01011200",878,211,77,134,622,79,333,104,180,49,118,62,53,3,92,63,29,0,0,45,21,24
"2021","Kirklees 033A","E01011204",554,119,64,55,408,95,240,75,123,42,39,13,25,1,29,19,10,5,5,27,17,10
"2021","Kirklees 033B","E01011206",779,330,113,217,431,38,219,87,107,25,78,50,27,1,90,55,35,6,6,18,10,8
"2021","Kirklees 033C","E01011208",795,326,105,221,433,36,171,69,78,24,97,59,33,5,125,87,38,4,4,36,12,24
"2021","Kirklees 033D","E01011240",791,270,115,155,490,48,232,78,125,29,100,54,41,5,105,60,45,5,5,31,15,16
"2021","Kirklees 034A","E01011231",728,319,105,214,386,47,148,64,60,24,92,52,35,5,93,68,25,6,6,23,10,13
"2021","Kirklees 034B","E01011236",840,503,42,461,231,4,97,29,49,19,80,68,12,0,34,20,14,16,16,106,28,78
"2021","Kirklees 034C","E01011238",807,370,92,278,367,47,180,64,89,27,88,70,14,4,48,23,25,4,4,70,15,55
"2021","Kirklees 034D","E01011239",673,228,82,146,402,52,206,69,104,33,70,41,25,4,67,41,26,7,7,43,22,21
"2021","Kirklees 035A","E01011093",671,264,76,188,388,21,127,41,66,20,75,26,42,7,160,121,39,5,5,19,8,11
"2021","Kirklees 035B","E01011094",659,256,117,139,373,23,150,37,82,31,53,16,31,6,140,77,63,7,7,30,20,10
"2021","Kirklees 035C","E01011096",622,182,80,102,396,58,198,69,73,56,58,32,23,3,79,49,30,3,3,44,22,22
"2021","Kirklees 035D","E01011098",714,253,57,196,372,30,136,47,68,21,109,59,48,2,92,63,29,5,5,89,20,69
"2021","Kirklees 036A","E01011146",688,196,89,107,483,70,256,108,96,52,88,41,40,7,66,39,27,3,3,9,6,3
"2021","Kirklees 036B","E01011151",655,170,75,95,464,84,244,111,94,39,88,52,33,3,48,23,25,0,0,21,8,13
"2021","Kirklees 036C","E01011202",716,275,164,111,416,81,209,85,83,41,64,30,27,7,60,40,20,2,2,25,17,8
"2021","Kirklees 036D","E01011205",696,192,77,115,470,73,251,106,87,58,85,53,24,8,58,38,20,3,3,34,13,21
"2021","Kirklees 037A","E01011090",672,240,104,136,413,59,173,79,61,33,82,41,33,8,94,70,24,5,5,19,11,8
"2021","Kirklees 037B","E01011095",629,236,114,122,372,60,162,60,66,36,87,41,38,8,61,39,22,2,2,21,12,9
"2021","Kirklees 037C","E01011097",716,263,106,157,406,52,175,54,81,40,82,35,35,12,92,59,33,5,5,47,23,24
"2021","Kirklees 037D","E01011099",619,183,87,96,408,72,170,64,76,30,70,29,31,10,95,65,30,1,1,28,17,11
"2021","Kirklees 038A","E01011150",741,239,77,162,471,47,199,94,72,33,124,62,54,8,98,67,31,3,3,31,15,16
"2021","Kirklees 038B","E01011155",1013,361,99,262,634,88,269,99,132,38,185,120,57,8,85,59,26,7,7,18,6,12
"2021","Kirklees 038C","E01011207",621,149,83,66,449,82,205,70,95,40,94,55,33,6,67,44,23,1,1,23,15,8
"2021","Kirklees 038D","E01011234",685,265,74,191,391,28,170,65,68,37,63,27,31,5,128,88,40,2,2,29,16,13
"2021","Kirklees 039A","E01011232",645,267,79,188,306,26,155,47,80,28,54,36,16,2,67,48,19,4,4,72,38,34
"2021","Kirklees 039B","E01011233",657,177,65,112,449,49,239,73,128,38,93,45,46,2,62,38,24,6,6,31,21,10
"2021","Kirklees 039C","E01011235",824,432,97,335,275,31,126,35,72,19,48,39,9,0,61,36,25,9,9,117,36,81
"2021","Kirklees 039D","E01011237",635,210,51,159,375,28,168,32,114,22,77,41,35,1,95,76,19,7,7,50,26,24
"2021","Kirklees 040A","E01011004",650,310,129,181,319,39,125,54,46,25,56,21,34,1,98,59,39,1,1,21,11,10
"2021","Kirklees 040B","E01011006",638,199,101,98,416,75,174,66,66,42,89,51,34,4,74,53,21,4,4,23,13,10
"2021","Kirklees 040C","E01011008",668,242,61,181,371,27,124,64,41,19,116,66,46,4,98,71,27,6,6,55,10,45
"2021","Kirklees 040D","E01011012",668,219,79,140,414,44,170,60,78,32,81,33,44,4,114,86,28,5,5,35,17,18
"2021","Kirklees 041A","E01011145",644,196,103,93,440,80,200,79,75,46,85,35,43,7,75,53,22,0,0,8,2,6
"2021","Kirklees 041B","E01011147",707,205,61,144,485,55,223,93,95,35,121,60,57,4,83,56,27,3,3,17,7,10
"2021","Kirklees 041C","E01011148",759,294,134,160,433,42,148,58,61,29,86,32,47,7,153,107,46,4,4,32,18,14
"2021","Kirklees 041D","E01011152",811,300,67,233,490,55,221,94,88,39,142,94,41,7,70,47,23,2,2,21,5,16
"2021","Kirklees 042A","E01011007",673,238,70,168,369,40,165,65,72,28,92,54,30,8,61,37,24,11,11,66,11,55
"2021","Kirklees 042B","E01011223",733,213,76,137,474,33,171,68,77,26,109,46,53,10,154,106,48,7,7,46,19,27
"2021","Kirklees 042C","E01011225",717,206,55,151,426,31,138,51,71,16,101,67,29,5,146,100,46,10,10,85,9,76
"2021","Kirklees 042D","E01011229",819,462,80,382,253,12,110,26,67,17,68,49,16,3,40,25,15,23,23,104,27,77
"2021","Kirklees 043A","E01011080",760,244,56,188,434,23,210,36,134,40,72,40,25,7,115,89,26,14,14,82,48,34
"2021","Kirklees 043B","E01011081",716,297,70,227,343,22,172,36,116,20,66,39,25,2,74,51,23,9,9,76,45,31
"2021","Kirklees 043C","E01011082",470,71,20,51,287,4,189,28,130,31,23,11,11,1,60,39,21,11,11,112,83,29
"2021","Kirklees 043D","E01011230",549,123,26,97,331,6,210,21,159,30,24,14,9,1,86,66,20,5,5,95,65,30
"2021","Kirklees 044A","E01011005",642,183,116,67,440,108,193,73,72,48,82,33,45,4,56,32,24,1,1,19,7,12
"2021","Kirklees 044B","E01011009",610,221,120,101,364,78,171,73,67,31,53,25,21,7,58,42,16,4,4,25,12,13
"2021","Kirklees 044C","E01011010",648,192,88,104,423,33,144,45,70,29,87,41,39,7,158,106,52,1,1,33,18,15
"2021","Kirklees 044D","E01011011",684,216,134,82,441,115,215,95,79,41,70,37,27,6,38,17,21,3,3,27,12,15
"2021","Kirklees 045A","E01011077",728,253,77,176,447,43,206,90,78,38,116,61,47,8,79,55,24,3,3,28,10,18
"2021","Kirklees 045B","E01011149",915,444,79,365,427,19,155,68,64,23,127,71,49,7,115,78,37,11,11,44,20,24
"2021","Kirklees 045C","E01011153",772,279,108,171,454,56,191,75,82,34,114,51,48,15,88,50,38,5,5,39,17,22
"2021","Kirklees 045D","E01011154",659,183,62,121,448,47,199,74,92,33,97,40,50,7,102,71,31,3,3,28,14,14
"2021","Kirklees 046A","E01011191",660,169,97,72,468,95,209,75,88,46,94,52,29,13,68,45,23,2,2,23,11,12
"2021","Kirklees 046B","E01011192",719,240,119,121,447,72,203,85,81,37,88,43,35,10,82,49,33,2,2,32,13,19
"2021","Kirklees 046C","E01011193",933,191,83,108,708,102,361,129,172,60,158,102,50,6,83,57,26,4,4,34,16,18
"2021","Kirklees 046D","E01011194",603,161,110,51,429,133,196,92,66,38,71,31,28,12,29,9,20,0,0,13,4,9
"2021","Kirklees 047A","E01011079",893,396,131,265,442,36,203,69,104,30,91,51,36,4,107,77,30,5,5,55,33,22
"2021","Kirklees 047B","E01011083",721,222,119,103,461,58,252,93,105,54,68,32,31,5,79,53,26,4,4,38,23,15
"2021","Kirklees 047C","E01011084",660,165,46,119,435,12,189,30,138,21,77,17,56,4,148,118,30,9,9,60,32,28
"2021","Kirklees 047D","E01011085",692,205,110,95,453,72,218,77,105,36,69,33,33,3,87,48,39,7,7,34,19,15
"2021","Kirklees 048A","E01011224",802,328,78,250,415,26,144,60,66,18,96,53,36,7,143,97,46,6,6,59,10,49
"2021","Kirklees 048B","E01011226",648,188,99,89,427,84,210,94,78,38,80,43,31,6,51,35,16,2,2,33,19,14
"2021","Kirklees 048C","E01011227",786,381,147,234,379,54,116,46,49,21,76,38,34,4,129,91,38,4,4,26,18,8
"2021","Kirklees 048D","E01011228",642,216,101,115,401,92,172,86,53,33,73,42,26,5,64,46,18,0,0,25,9,16
"2021","Kirklees 049A","E01011071",827,203,87,116,588,94,270,111,114,45,133,68,56,9,88,59,29,3,3,36,20,16
"2021","Kirklees 049B","E01011072",690,197,75,122,469,52,243,89,108,46,102,50,44,8,71,43,28,1,1,24,8,16
"2021","Kirklees 049C","E01011073",702,248,76,172,426,50,175,60,77,38,111,68,37,6,88,63,25,2,2,28,13,15
"2021","Kirklees 049D","E01011078",866,326,127,199,510,67,224,84,121,19,123,74,45,4,93,69,24,3,3,30,9,21
"2021","Kirklees 050A","E01011086",696,215,148,67,452,110,223,83,94,46,73,40,29,4,46,32,14,0,0,29,14,15
"2021","Kirklees 050B","E01011087",742,290,108,182,434,72,192,84,74,34,64,37,26,1,105,73,32,1,1,18,5,13
"2021","Kirklees 050C","E01011088",592,163,118,45,415,127,199,84,74,41,51,24,24,3,37,19,18,1,1,14,7,7
"2021","Kirklees 050D","E01011222",906,477,120,357,402,60,151,76,51,24,136,80,53,3,54,36,18,1,1,27,9,18
"2021","Kirklees 051A","E01011190",728,231,97,134,479,116,245,102,92,51,66,40,25,1,52,32,20,0,0,18,8,10
"2021","Kirklees 051B","E01011195",494,129,78,51,360,82,215,89,92,34,34,18,12,4,28,21,7,1,1,5,2,3
"2021","Kirklees 051C","E01011196",782,187,111,76,572,102,321,105,166,50,94,46,42,6,55,33,22,0,0,23,16,7
"2021","Kirklees 051D","E01011197",666,220,108,112,431,79,206,80,80,46,63,29,31,3,80,44,36,3,3,15,9,6
"2021","Kirklees 052A","E01011070",695,151,79,72,510,88,262,111,103,48,107,56,49,2,51,27,24,2,2,34,14,20
"2021","Kirklees 052B","E01011074",839,262,131,131,557,100,254,108,104,42,114,64,42,8,88,56,32,1,1,20,5,15
"2021","Kirklees 052C","E01011075",644,196,99,97,431,69,206,90,81,35,86,50,32,4,68,38,30,2,2,17,7,10
"2021","Kirklees 052D","E01011076",626,174,78,96,434,73,209,93,89,27,79,39,30,10,69,42,27,4,4,18,8,10
"2021","Kirklees 053A","E01011169",612,164,93,71,425,99,223,82,96,45,54,33,17,4,48,32,16,1,1,23,10,13
"2021","Kirklees 053B","E01011170",791,190,111,79,574,120,299,113,126,60,98,49,45,4,56,33,23,1,1,27,14,13
"2021","Kirklees 053E","E01011173",521,143,102,41,373,77,215,67,96,52,47,25,20,2,33,17,16,1,1,5,3,2
"2021","Kirklees 053F","E01011176",590,156,76,80,407,72,204,88,87,29,63,28,30,5,66,37,29,2,2,27,12,15
"2021","Kirklees 053G","E01034588",1125,438,248,190,657,110,292,113,130,49,120,67,46,7,129,81,48,6,6,30,14,16
"2021","Kirklees 054A","E01011109",800,208,84,124,568,79,277,96,130,51,130,67,53,10,82,60,22,0,0,24,9,15
"2021","Kirklees 054B","E01011113",721,226,128,98,480,142,222,93,85,44,66,33,26,7,50,25,25,0,0,15,6,9
"2021","Kirklees 054C","E01011114",738,249,135,114,459,75,248,91,102,55,65,28,33,4,70,43,27,1,1,30,12,18
"2021","Kirklees 054D","E01011119",654,195,117,78,448,109,226,92,85,49,65,37,25,3,48,28,20,0,0,11,7,4
"2021","Kirklees 055A","E01011168",699,183,108,75,502,93,262,101,116,45,96,48,39,9,48,28,20,3,3,14,5,9
"2021","Kirklees 055B","E01011174",736,161,92,69,563,134,303,129,119,55,88,49,31,8,37,27,10,1,1,12,7,5
"2021","Kirklees 055C","E01011175",703,176,81,95,505,53,198,63,100,35,115,45,64,6,136,98,38,3,3,22,13,9
"2021","Kirklees 055D","E01011177",852,219,98,121,598,117,295,119,129,47,122,71,50,1,61,36,25,3,3,35,12,23
"2021","Kirklees 055E","E01011178",889,347,176,171,514,81,225,85,101,39,109,66,37,6,96,64,32,3,3,28,10,18
"2021","Kirklees 056A","E01011118",624,138,65,73,456,70,255,94,115,46,77,42,32,3,53,38,15,1,1,30,14,16
"2021","Kirklees 056B","E01011120",572,110,58,52,451,86,267,89,132,46,64,34,28,2,33,22,11,1,1,11,5,6
"2021","Kirklees 056C","E01011198",660,158,102,56,483,100,257,84,132,41,79,45,29,5,46,25,21,1,1,19,7,12
"2021","Kirklees 056D","E01011199",606,150,80,70,441,86,239,86,110,43,59,25,31,3,54,36,18,3,3,15,6,9
"2021","Kirklees 057A","E01011110",621,155,81,74,442,83,238,95,100,43,66,43,17,6,55,35,20,0,0,24,11,13
"2021","Kirklees 057B","E01011111",729,156,77,79,554,92,287,88,139,60,100,48,45,7,75,46,29,0,0,19,7,12
"2021","Kirklees 057C","E01011112",682,183,91,92,470,92,249,97,115,37,79,30,39,10,48,33,15,2,2,29,17,12
"2021","Kirklees 057D","E01011115",782,231,112,119,537,91,292,124,128,40,90,44,40,6,63,39,24,1,1,14,4,10
"2021","Kirklees 057E","E01011116",699,186,116,70,497,106,253,102,109,42,71,40,25,6,64,31,33,3,3,16,5,11
"2021","Kirklees 057F","E01011117",744,175,87,88,542,120,292,119,126,47,76,44,30,2,53,37,16,1,1,27,11,16
"2021","Kirklees 058A","E01011180",803,197,91,106,584,110,312,120,139,53,100,48,46,6,57,39,18,5,5,22,9,13
"2021","Kirklees 058B","E01011182",756,230,96,134,507,90,275,120,118,37,84,54,27,3,57,30,27,1,1,19,4,15
"2021","Kirklees 058C","E01011186",791,231,122,109,534,118,271,111,123,37,77,43,27,7,67,41,26,1,1,26,14,12
"2021","Kirklees 058D","E01011188",713,191,92,99,502,116,247,98,106,43,71,39,30,2,64,41,23,4,4,20,12,8
"2021","Kirklees 059A","E01011179",753,209,90,119,520,110,271,116,107,48,83,44,33,6,55,33,22,1,1,24,10,14
"2021","Kirklees 059B","E01011181",840,285,100,185,527,75,249,119,99,31,118,76,37,5,82,56,26,3,3,28,7,21
"2021","Kirklees 059C","E01011183",919,198,83,115,686,88,375,137,162,76,145,75,66,4,74,51,23,4,4,35,17,18
"2021","Kirklees 059D","E01011184",579,140,76,64,417,56,173,73,65,35,77,35,33,9,109,58,51,2,2,22,11,11
"2021","Kirklees 059E","E01011185",722,219,111,108,488,94,227,86,106,35,89,49,37,3,78,53,25,0,0,15,4,11
"2021","Kirklees 059F","E01011187",690,162,80,82,509,102,261,93,125,43,81,37,41,3,64,35,29,1,1,19,9,10
"2021","Kirklees 059G","E01011189",770,167,97,70,575,117,297,120,124,53,104,54,41,9,54,27,27,3,3,28,13,15
"2021","Leeds 001A","E01011698",633,163,103,60,453,96,224,88,99,37,59,28,27,4,69,35,34,5,5,17,7,10
"2021","Leeds 001B","E01011699",579,146,88,58,415,121,211,86,92,33,44,30,13,1,38,21,17,1,1,18,5,13
"2021","Leeds 001C","E01011701",596,148,91,57,434,98,225,95,97,33,55,30,21,4,55,30,25,1,1,14,5,9
"2021","Leeds 001D","E01011702",664,132,70,62,506,123,306,105,160,41,47,27,19,1,28,15,13,2,2,26,11,15
"2021","Leeds 001E","E01011703",565,135,108,27,416,181,190,86,70,34,30,19,6,5,11,5,6,4,4,14,4,10
"2021","Leeds 002A","E01011697",689,183,101,82,486,109,247,89,129,29,69,40,26,3,57,35,22,4,4,20,3,17
"2021","Leeds 002B","E01011700",604,206,137,69,370,105,181,56,87,38,53,29,21,3,31,12,19,0,0,28,8,20
"2021","Leeds 002C","E01011704",1146,500,275,225,614,151,234,96,104,34,135,90,40,5,87,55,32,7,7,32,8,24
"2021","Leeds 002D","E01011705",642,220,130,90,396,71,148,65,53,30,93,46,42,5,79,44,35,5,5,26,10,16
"2021","Leeds 003A","E01011581",731,205,124,81,512,114,257,91,121,45,77,44,29,4,61,32,29,3,3,14,7,7
"2021","Leeds 003B","E01011582",741,280,132,148,448,59,188,65,87,36,96,39,51,6,100,62,38,5,5,13,7,6
"2021","Leeds 003C","E01011583",646,143,80,63,477,100,236,84,105,47,69,27,37,5,71,46,25,1,1,26,9,17
"2021","Leeds 003D","E01011584",762,243,134,109,500,111,245,79,127,39,77,43,27,7,64,40,24,3,3,19,9,10
"2021","Leeds 004A","E01011569",900,404,191,213,472,93,214,90,84,40,107,66,39,2,52,32,20,6,6,24,11,13
"2021","Leeds 004B","E01011571",758,257,140,117,479,86,222,107,89,26,112,64,40,8,57,31,26,2,2,22,5,17
"2021","Leeds 004C","E01011572",830,285,128,157,523,84,252,99,109,44,103,56,40,7,83,51,32,1,1,22,7,15
"2021","Leeds 004D","E01011573",542,128,77,51,395,70,212,84,95,33,64,28,33,3,48,25,23,1,1,19,12,7
"2021","Leeds 004E","E01011574",692,297,186,111,374,90,163,62,74,27,71,50,18,3,46,28,18,4,4,21,7,14
"2021","Leeds 005A","E01011707",592,200,144,56,375,93,181,59,91,31,51,31,19,1,49,26,23,1,1,17,8,9
"2021","Leeds 005B","E01011709",846,225,145,80,604,155,318,83,190,45,86,49,33,4,44,35,9,1,1,17,11,6
"2021","Leeds 005C","E01011710",625,187,100,87,419,86,232,85,116,31,54,32,20,2,47,33,14,0,0,19,5,14
"2021","Leeds 005D","E01011711",658,226,135,91,417,103,209,75,105,29,60,40,15,5,45,22,23,0,0,15,5,10
"2021","Leeds 005E","E01011712",613,156,76,80,432,79,239,89,110,40,58,31,25,2,54,34,20,2,2,25,11,14
"2021","Leeds 006A","E01011561",526,147,69,78,359,77,202,82,89,31,55,35,16,4,25,13,12,0,0,20,10,10
"2021","Leeds 006B","E01011696",658,170,124,46,465,110,274,97,131,46,42,24,12,6,35,22,13,4,4,23,9,14
"2021","Leeds 006C","E01011706",618,109,60,49,493,142,265,93,128,44,56,31,22,3,30,18,12,0,0,16,6,10
"2021","Leeds 006D","E01011708",626,156,86,70,445,103,255,85,120,50,46,31,14,1,40,27,13,1,1,25,7,18
"2021","Leeds 006E","E01011713",709,134,86,48,548,145,339,121,175,43,39,17,20,2,25,14,11,0,0,27,15,12
"2021","Leeds 007A","E01011570",961,250,150,100,678,118,383,118,213,52,106,60,40,6,67,46,21,4,4,33,13,20
"2021","Leeds 007C","E01011576",580,117,78,39,445,84,286,106,136,44,58,30,23,5,16,8,8,1,1,18,7,11
"2021","Leeds 007E","E01032503",613,176,100,76,406,93,241,84,121,36,40,25,14,1,31,17,14,1,1,31,16,15
"2021","Leeds 007F","E01032504",750,205,147,58,517,136,289,81,169,39,54,33,18,3,38,20,18,0,0,28,13,15
"2021","Leeds 008A","E01011266",1141,311,96,215,799,121,443,151,226,66,159,100,52,7,74,52,22,2,2,31,7,24
"2021","Leeds 008B","E01011270",680,127,88,39,527,140,318,108,160,50,51,19,28,4,15,3,12,3,3,26,10,16
"2021","Leeds 008C","E01011279",578,174,96,78,384,69,192,71,91,30,69,41,25,3,50,35,15,4,4,20,7,13
"2021","Leeds 008D","E01011280",841,170,80,90,637,104,353,120,178,55,122,72,47,3,56,40,16,2,2,34,11,23
"2021","Leeds 009A","E01011265",911,343,171,172,537,72,251,80,147,24,142,98,40,4,70,47,23,2,2,31,11,20
"2021","Leeds 009B","E01011267",724,217,137,80,485,80,199,61,99,39,98,40,54,4,103,73,30,5,5,22,12,10
"2021","Leeds 009C","E01011271",891,212,115,97,645,124,349,105,200,44,102,56,44,2,68,44,24,2,2,34,13,21
"2021","Leeds 009D","E01011272",565,108,66,42,436,87,257,73,139,45,60,35,21,4,32,20,12,0,0,21,8,13
"2021","Leeds 010A","E01011268",630,229,88,141,368,30,137,59,57,21,98,47,43,8,99,68,31,4,4,33,14,19
"2021","Leeds 010B","E01011273",725,276,110,166,408,55,180,72,77,31,119,79,36,4,54,39,15,0,0,41,9,32
"2021","Leeds 010C","E01011274",668,276,130,146,371,52,127,53,44,30,76,39,35,2,112,82,30,4,4,21,6,15
"2021","Leeds 010D","E01011275",609,169,82,87,420,68,191,69,92,30,82,39,38,5,79,57,22,0,0,20,6,14
"2021","Leeds 011A","E01011264",570,161,98,63,386,79,171,75,55,41,77,41,31,5,55,28,27,4,4,23,11,12
"2021","Leeds 011B","E01011269",754,293,171,122,433,68,205,84,82,39,95,56,34,5,65,44,21,0,0,28,11,17
"2021","Leeds 011C","E01011276",794,240,128,112,516,87,245,102,110,33,121,78,40,3,61,37,24,2,2,38,12,26
"2021","Leeds 011D","E01011578",620,230,113,117,369,89,169,74,65,30,65,37,24,4,45,28,17,1,1,21,10,11
"2021","Leeds 012A","E01011554",588,142,79,63,430,89,248,72,136,40,50,25,24,1,42,25,17,1,1,16,6,10
"2021","Leeds 012B","E01011562",625,135,88,47,444,127,261,78,130,53,20,9,9,2,34,16,18,2,2,46,15,31
"2021","Leeds 012C","E01011563",611,190,127,63,397,127,205,61,101,43,39,19,16,4,22,12,10,4,4,24,10,14
"2021","Leeds 012D","E01011564",604,135,88,47,454,84,277,72,165,40,56,30,19,7,35,23,12,2,2,15,9,6
"2021","Leeds 012E","E01011567",559,119,74,45,407,62,254,65,153,36,48,26,17,5,41,23,18,2,2,33,19,14
"2021","Leeds 013A","E01011376",678,138,95,43,513,107,299,103,139,57,68,44,21,3,37,24,13,2,2,27,12,15
"2021","Leeds 013B","E01011377",605,165,121,44,411,99,238,87,112,39,44,21,19,4,30,14,16,0,0,29,11,18
"2021","Leeds 013C","E01011378",698,332,85,247,337,46,126,42,60,24,67,32,31,4,95,54,41,3,3,29,16,13
"2021","Leeds 013D","E01011382",745,235,145,90,489,78,234,98,109,27,117,78,35,4,57,38,19,3,3,21,9,12
"2021","Leeds 014A","E01011277",640,142,59,83,477,44,267,78,141,48,108,64,42,2,55,32,23,3,3,21,12,9
"2021","Leeds 014B","E01011278",740,229,105,124,494,85,261,90,128,43,91,66,20,5,57,39,18,0,0,17,7,10
"2021","Leeds 014C","E01011579",520,97,53,44,403,49,211,61,116,34,84,44,38,2,57,30,27,2,2,20,8,12
"2021","Leeds 014D","E01011580",621,192,113,79,423,77,242,97,110,35,58,33,23,2,45,23,22,1,1,6,1,5
"2021","Leeds 015A","E01011556",793,310,107,203,448,50,230,65,132,33,74,52,20,2,87,53,34,7,7,35,13,22
"2021","Leeds 015B","E01011557",609,202,118,84,383,82,244,74,115,55,27,15,11,1,29,13,16,1,1,24,18,6
"2021","Leeds 015C","E01011565",596,150,91,59,426,74,263,75,142,46,31,18,12,1,58,33,25,0,0,20,16,4
"2021","Leeds 015D","E01011566",560,178,93,85,355,57,220,50,133,37,41,28,11,2,37,15,22,0,0,27,12,15
"2021","Leeds 015E","E01011568",911,365,206,159,512,104,302,99,151,52,52,32,18,2,47,30,17,7,7,34,19,15
"2021","Leeds 016A","E01011380",677,195,102,93,461,114,254,80,134,40,51,25,19,7,39,24,15,3,3,21,6,15
"2021","Leeds 016B","E01011381",567,123,74,49,421,80,239,87,110,42,52,28,20,4,46,21,25,4,4,23,11,12
"2021","Leeds 016C","E01011385",533,132,68,64,376,84,212,72,99,41,33,19,11,3,27,17,10,20,20,25,9,16
"2021","Leeds 016D","E01011386",745,198,76,122,506,78,314,84,178,52,68,47,20,1,42,30,12,4,4,41,15,26
"2021","Leeds 017A","E01011379",759,315,111,204,423,46,180,54,98,28,87,53,33,1,107,72,35,3,3,21,12,9
"2021","Leeds 017B","E01011384",667,206,92,114,436,70,230,80,115,35,71,38,31,2,61,36,25,4,4,25,11,14
"2021","Leeds 017E","E01032501",511,130,72,58,370,63,194,78,88,28,72,55,14,3,40,23,17,1,1,11,5,6
"2021","Leeds 017F","E01032502",850,339,111,228,477,18,192,53,101,38,121,63,53,5,138,94,44,8,8,34,12,22
"2021","Leeds 018A","E01011555",566,145,77,68,398,76,231,72,115,44,39,17,19,3,49,27,22,3,3,23,10,13
"2021","Leeds 018B","E01011558",740,242,72,170,460,17,185,48,115,22,65,29,31,5,190,128,62,3,3,38,16,22
"2021","Leeds 018C","E01011559",590,210,97,113,346,18,169,39,105,25,50,19,25,6,108,71,37,1,1,34,23,11
"2021","Leeds 018D","E01011560",865,342,114,228,483,35,212,63,132,17,52,27,23,2,173,118,55,11,11,40,21,19
"2021","Leeds 019A","E01011383",751,276,151,125,446,77,216,57,120,39,85,48,32,5,63,31,32,5,5,29,11,18
"2021","Leeds 019B","E01011388",732,255,126,129,455,70,241,85,123,33,80,65,12,3,59,35,24,5,5,22,9,13
"2021","Leeds 019C","E01011684",649,175,76,99,438,76,232,71,131,30,76,47,26,3,53,31,22,1,1,36,12,24
"2021","Leeds 019D","E01011695",727,283,94,189,415,16,181,38,102,41,77,44,28,5,137,96,41,4,4,29,8,21
"2021","Leeds 020A","E01011650",600,156,65,91,419,75,248,70,140,38,61,42,19,0,32,16,16,3,3,25,15,10
"2021","Leeds 020B","E01011651",640,180,69,111,435,47,211,67,115,29,89,50,37,2,87,55,32,1,1,25,7,18
"2021","Leeds 020C","E01011653",629,232,91,141,343,43,176,52,104,20,88,76,11,1,32,21,11,4,4,54,9,45
"2021","Leeds 020D","E01011655",725,302,142,160,391,87,185,67,104,14,71,59,9,3,43,31,12,5,5,32,13,19
"2021","Leeds 021A","E01011455",475,101,71,30,363,79,226,58,131,37,31,11,20,0,24,14,10,3,3,11,8,3
"2021","Leeds 021B","E01011456",672,170,135,35,483,113,260,62,162,36,61,25,34,2,48,29,19,1,1,19,9,10
"2021","Leeds 021C","E01011459",769,250,122,128,480,89,222,77,113,32,121,97,21,3,45,30,15,3,3,39,7,32
"2021","Leeds 021D","E01011461",611,125,105,20,466,114,282,78,157,47,43,16,26,1,27,19,8,0,0,20,9,11
"2021","Leeds 022A","E01011311",483,74,39,35,393,85,247,76,128,43,30,18,11,1,30,17,13,1,1,16,13,3
"2021","Leeds 022B","E01011649",653,174,90,84,461,104,270,82,152,36,61,34,23,4,26,12,14,0,0,18,6,12
"2021","Leeds 022C","E01011715",581,144,77,67,412,92,191,70,75,46,87,42,39,6,38,23,15,4,4,25,9,16
"2021","Leeds 022D","E01011719",629,165,116,49,452,116,230,90,103,37,62,32,27,3,44,20,24,0,0,12,5,7
"2021","Leeds 023A","E01011509",641,252,155,97,364,68,198,58,104,36,64,40,21,3,30,17,13,4,4,25,12,13
"2021","Leeds 023B","E01011511",531,149,89,60,326,43,194,51,107,36,54,34,20,0,33,15,18,2,2,56,29,27
"2021","Leeds 023C","E01011512",719,228,94,134,446,49,246,66,143,37,84,64,19,1,63,38,25,4,4,45,20,25
"2021","Leeds 023D","E01011515",665,238,82,156,377,57,206,52,121,33,84,63,16,5,28,13,15,2,2,50,21,29
"2021","Leeds 023E","E01011516",660,129,66,63,488,45,285,80,152,53,89,58,29,2,62,26,36,7,7,43,26,17
"2021","Leeds 024A","E01011508",474,69,39,30,365,39,232,45,134,53,48,27,21,0,46,23,23,0,0,40,22,18
"2021","Leeds 024B","E01011517",750,253,79,174,463,41,231,58,131,42,101,59,34,8,89,56,33,1,1,34,18,16
"2021","Leeds 024C","E01011652",561,159,79,80,361,46,216,58,116,42,61,34,24,3,35,18,17,3,3,41,15,26
"2021","Leeds 024D","E01011654",534,88,47,41,424,58,268,66,171,31,55,19,32,4,40,26,14,3,3,22,11,11
"2021","Leeds 025A","E01011505",653,181,101,80,419,60,229,56,134,39,68,35,27,6,58,30,28,4,4,53,37,16
"2021","Leeds 025B","E01011506",523,100,46,54,375,38,223,46,135,42,58,36,20,2,55,18,37,1,1,48,26,22
"2021","Leeds 025C","E01011507",664,154,72,82,466,48,248,83,135,30,122,69,48,5,46,23,23,2,2,44,19,25
"2021","Leeds 025D","E01011510",836,482,216,266,330,43,139,44,74,21,55,20,32,3,86,52,34,7,7,24,13,11
"2021","Leeds 025E","E01011514",647,140,55,85,459,58,272,65,165,42,78,51,24,3,46,26,20,5,5,48,26,22
"2021","Leeds 027A","E01011452",657,149,89,60,493,92,288,63,178,47,79,53,26,0,33,17,16,1,1,15,5,10
"2021","Leeds 027B","E01011454",685,180,61,119,484,57,241,64,146,31,126,90,34,2,57,37,20,3,3,21,4,17
"2021","Leeds 027C","E01011457",615,149,83,66,438,80,253,75,129,49,68,31,37,0,35,21,14,2,2,28,11,17
"2021","Leeds 027D","E01011458",1017,174,74,100,806,94,471,137,298,36,162,94,64,4,77,56,21,2,2,37,22,15
"2021","Leeds 027E","E01011465",836,310,139,171,507,66,221,65,137,19,132,94,35,3,83,60,23,5,5,19,4,15
"2021","Leeds 028A","E01011453",705,222,115,107,465,98,213,63,120,30,113,81,27,5,40,20,20,1,1,18,5,13
"2021","Leeds 028B","E01011460",655,209,71,138,406,40,177,55,104,18,105,68,37,0,82,60,22,2,2,40,17,23
"2021","Leeds 028C","E01011462",725,225,115,110,465,49,230,59,130,41,91,47,35,9,93,53,40,2,2,35,16,19
"2021","Leeds 028D","E01011463",757,262,139,123,465,45,193,64,95,34,96,48,40,8,126,85,41,5,5,30,14,16
"2021","Leeds 028E","E01011464",900,330,79,251,517,55,191,71,94,26,200,157,41,2,63,53,10,8,8,53,13,40
"2021","Leeds 029A","E01011714",773,183,99,84,560,96,274,90,124,60,121,50,63,8,65,44,21,4,4,30,15,15
"2021","Leeds 029B","E01011716",621,150,80,70,430,75,233,72,121,40,60,33,25,2,59,37,22,3,3,41,18,23
"2021","Leeds 029C","E01011717",724,252,132,120,436,60,205,72,97,36,80,41,34,5,90,52,38,1,1,36,17,19
"2021","Leeds 029D","E01011718",825,253,85,168,530,39,224,57,121,46,146,75,62,9,116,86,30,5,5,42,18,24
"2021","Leeds 029E","E01011720",696,256,108,148,415,57,147,55,65,27,92,37,48,7,110,72,38,9,9,25,10,15
"2021","Leeds 030A","E01011296",778,239,155,84,528,164,261,112,109,40,63,32,28,3,40,16,24,0,0,11,7,4
"2021","Leeds 030B","E01011297",706,162,90,72,517,84,287,94,148,45,96,59,32,5,48,34,14,2,2,27,14,13
"2021","Leeds 030C","E01011309",662,184,93,91,459,92,223,87,99,37,86,52,25,9,56,32,24,2,2,19,9,10
"2021","Leeds 030D","E01011310",731,230,132,98,484,107,249,81,127,41,75,52,20,3,53,32,21,0,0,17,7,10
"2021","Leeds 031A","E01011513",966,280,99,181,656,53,357,101,210,46,154,120,29,5,89,58,31,3,3,30,7,23
"2021","Leeds 031B","E01011688",610,127,42,85,439,33,199,70,102,27,116,77,35,4,85,54,31,6,6,44,23,21
"2021","Leeds 031C","E01011689",802,294,121,173,480,63,180,72,92,16,171,129,41,1,59,30,29,7,7,28,10,18
"2021","Leeds 031D","E01011691",687,259,93,166,354,32,126,48,66,12,96,65,27,4,95,58,37,5,5,74,9,65
"2021","Leeds 032A","E01011504",749,331,78,253,386,11,145,51,72,22,90,42,45,3,129,92,37,11,11,32,13,19
"2021","Leeds 032B","E01011641",616,137,65,72,447,62,265,60,167,38,73,47,24,2,46,22,24,1,1,32,13,19
"2021","Leeds 032C","E01011642",493,114,46,68,347,37,207,48,125,34,61,31,28,2,39,24,15,3,3,32,18,14
"2021","Leeds 032D","E01011645",615,202,68,134,373,35,207,54,125,28,83,53,27,3,45,32,13,3,3,40,15,25
"2021","Leeds 033A","E01011484",668,213,67,146,419,26,157,47,83,27,78,35,38,5,150,100,50,8,8,36,14,22
"2021","Leeds 033B","E01011485",759,316,95,221,399,35,163,59,87,17,88,58,27,3,111,78,33,2,2,44,18,26
"2021","Leeds 033E","E01011686",804,402,122,280,377,26,156,58,80,18,73,40,30,3,113,64,49,9,9,25,13,12
"2021","Leeds 033F","E01032493",642,194,70,124,414,54,178,75,67,36,125,93,28,4,50,27,23,7,7,34,9,25
"2021","Leeds 033G","E01032494",723,203,77,126,449,16,168,52,81,35,109,55,42,12,141,86,55,15,15,71,32,39
"2021","Leeds 034A","E01011350",680,216,86,130,423,50,204,66,93,45,132,93,34,5,34,13,21,3,3,41,10,31
"2021","Leeds 034B","E01011351",907,377,110,267,462,49,188,89,76,23,177,143,33,1,42,24,18,6,6,68,7,61
"2021","Leeds 034C","E01011352",964,433,128,305,400,26,124,49,54,21,175,156,17,2,63,37,26,12,12,131,10,121
"2021","Leeds 034D","E01011353",846,213,66,147,573,53,281,99,137,45,162,124,37,1,69,40,29,8,8,60,12,48
"2021","Leeds 035A","E01011656",640,211,43,168,398,22,153,41,69,43,76,34,35,7,143,115,28,4,4,31,18,13
"2021","Leeds 035B","E01011657",603,243,67,176,323,29,95,34,42,19,82,39,39,4,116,85,31,1,1,37,20,17
"2021","Leeds 035C","E01011659",663,258,80,178,375,26,131,43,57,31,89,52,32,5,127,98,29,2,2,30,15,15
"2021","Leeds 035D","E01011661",878,485,201,284,357,31,103,49,30,24,79,36,31,12,134,80,54,10,10,36,17,19
"2021","Leeds 037A","E01011643",635,223,142,81,386,75,215,51,123,41,49,28,19,2,44,24,20,3,3,26,8,18
"2021","Leeds 037B","E01011644",562,187,77,110,347,61,173,48,103,22,41,23,16,2,70,50,20,2,2,28,16,12
"2021","Leeds 037C","E01011646",651,162,81,81,422,43,225,53,136,36,77,50,24,3,72,38,34,5,5,67,41,26
"2021","Leeds 037D","E01011647",540,107,45,62,328,32,184,33,112,39,41,26,13,2,66,38,28,5,5,105,72,33
"2021","Leeds 037E","E01011648",579,104,52,52,403,44,229,29,131,69,41,19,17,5,84,40,44,5,5,72,47,25
"2021","Leeds 038A","E01011354",652,219,39,180,389,18,114,33,62,19,85,30,47,8,166,117,49,6,6,44,24,20
"2021","Leeds 038B","E01011355",610,182,75,107,377,22,137,36,75,26,104,62,33,9,111,62,49,3,3,51,26,25
"2021","Leeds 038C","E01011357",910,401,111,290,450,14,175,46,104,25,73,32,30,11,176,103,73,12,12,59,32,27
"2021","Leeds 038D","E01011450",520,146,50,96,325,24,149,49,74,26,66,40,21,5,83,46,37,3,3,49,15,34
"2021","Leeds 039A","E01011588",706,161,71,90,516,52,259,76,146,37,134,78,51,5,67,45,22,4,4,29,13,16
"2021","Leeds 039B","E01011589",701,225,101,124,454,50,249,80,136,33,99,66,31,2,53,37,16,3,3,22,10,12
"2021","Leeds 039C","E01011590",662,140,83,57,499,100,278,80,158,40,77,44,30,3,44,23,21,0,0,23,12,11
"2021","Leeds 039D","E01011592",799,315,134,181,469,70,213,68,99,46,131,85,41,5,51,27,24,4,4,15,4,11
"2021","Leeds 039E","E01011593",853,209,82,127,623,99,318,114,154,50,127,91,32,4,75,50,25,4,4,21,11,10
"2021","Leeds 040A","E01011421",598,186,87,99,374,30,165,45,93,27,63,24,29,10,107,59,48,9,9,38,19,19
"2021","Leeds 040B","E01011425",603,174,80,94,385,43,193,55,98,40,72,34,30,8,69,42,27,8,8,44,30,14
"2021","Leeds 040C","E01011658",747,277,107,170,429,26,138,35,77,26,100,50,42,8,162,112,50,3,3,41,27,14
"2021","Leeds 040D","E01011660",755,239,63,176,471,31,180,69,89,22,135,56,66,13,119,90,29,6,6,45,23,22
"2021","Leeds 040E","E01011662",516,178,34,144,297,5,98,27,52,19,68,18,42,8,119,83,36,7,7,41,18,23
"2021","Leeds 041A","E01011721",616,168,68,100,409,37,120,26,61,33,100,29,55,16,147,110,37,5,5,39,17,22
"2021","Leeds 041B","E01011722",907,299,106,193,554,37,206,66,107,33,145,63,76,6,162,120,42,4,4,54,21,33
"2021","Leeds 041C","E01011723",714,211,114,97,475,54,139,44,64,31,112,31,73,8,164,111,53,6,6,28,16,12
"2021","Leeds 041D","E01011724",842,296,110,186,504,26,198,87,75,36,114,47,58,9,161,112,49,5,5,42,18,24
"2021","Leeds 042A","E01011356",937,415,81,334,430,42,166,50,75,41,124,99,22,3,87,42,45,11,11,92,31,61
"2021","Leeds 042B","E01011358",716,298,99,199,364,25,136,37,73,26,70,37,24,9,126,73,53,7,7,54,24,30
"2021","Leeds 042C","E01011359",835,380,58,322,359,14,136,40,73,23,100,59,37,4,100,54,46,9,9,96,42,54
"2021","Leeds 042D","E01011360",756,265,61,204,375,10,184,19,138,27,45,29,14,2,119,64,55,17,17,116,68,48
"2021","Leeds 042E","E01011361",1141,485,91,394,522,9,208,48,133,27,63,44,18,1,222,123,99,20,20,134,62,72
"2021","Leeds 044A","E01011435",607,145,15,130,102,1,25,11,9,5,55,52,2,1,11,6,5,10,10,360,2,358
"2021","Leeds 044D","E01011440",660,220,55,165,168,17,42,20,17,5,69,56,13,0,28,16,12,12,12,272,3,269
"2021","Leeds 044E","E01011441",688,198,24,174,192,15,78,27,36,15,68,49,19,0,15,6,9,16,16,298,12,286
"2021","Leeds 044G","E01035040",537,129,9,120,81,3,37,12,15,10,21,15,5,1,10,3,7,10,10,327,12,315
"2021","Leeds 044H","E01035041",448,150,45,105,128,17,53,16,29,8,42,36,4,2,7,2,5,9,9,170,8,162
"2021","Leeds 045A","E01011477",920,397,85,312,444,37,172,67,85,20,142,107,30,5,82,61,21,11,11,79,10,69
"2021","Leeds 045B","E01011480",643,152,57,95,390,64,178,68,78,32,96,68,25,3,44,18,26,8,8,101,22,79
"2021","Leeds 045C","E01011488",701,237,53,184,350,18,95,39,43,13,159,129,23,7,73,52,21,5,5,114,9,105
"2021","Leeds 045D","E01011489",862,358,145,213,424,36,141,44,76,21,142,117,22,3,98,73,25,7,7,80,16,64
"2021","Leeds 046A","E01011324",549,184,31,153,328,11,95,34,51,10,86,27,49,10,133,114,19,3,3,37,25,12
"2021","Leeds 046B","E01011325",749,245,73,172,465,41,206,84,89,33,131,76,49,6,80,62,18,7,7,39,12,27
"2021","Leeds 046C","E01011326",629,174,74,100,414,30,122,48,51,23,110,66,40,4,144,91,53,8,8,41,22,19
"2021","Leeds 046D","E01011332",694,255,71,184,399,26,137,38,76,23,94,46,40,8,138,108,30,4,4,40,19,21
"2021","Leeds 047A","E01011423",604,146,62,84,406,27,200,39,124,37,59,22,32,5,114,75,39,6,6,52,32,20
"2021","Leeds 047B","E01011424",575,106,23,83,400,21,228,34,164,30,39,11,22,6,108,75,33,4,4,69,51,18
"2021","Leeds 047C","E01011427",583,143,47,96,350,2,193,29,132,32,39,12,22,5,110,69,41,6,6,90,78,12
"2021","Leeds 047D","E01011431",831,308,47,261,469,13,208,48,130,30,89,43,40,6,149,97,52,10,10,54,27,27
"2021","Leeds 048A","E01011422",545,180,31,149,294,6,156,25,107,24,44,27,14,3,69,34,35,19,19,71,38,33
"2021","Leeds 048B","E01011426",496,133,26,107,291,6,173,15,136,22,18,5,10,3,86,49,37,8,8,72,46,26
"2021","Leeds 048C","E01011428",648,173,43,130,359,4,207,24,163,20,51,22,25,4,72,49,23,25,25,116,78,38
"2021","Leeds 048D","E01011429",737,304,60,244,353,17,176,30,121,25,26,15,8,3,122,75,47,12,12,80,53,27
"2021","Leeds 050A","E01011663",590,113,17,96,430,9,150,44,90,16,103,38,64,1,158,130,28,10,10,47,20,27
"2021","Leeds 050B","E01011664",579,197,91,106,353,23,135,56,51,28,98,46,48,4,97,61,36,0,0,29,15,14
"2021","Leeds 050C","E01011665",647,252,79,173,363,49,150,64,55,31,74,36,30,8,84,58,26,6,6,32,18,14
"2021","Leeds 050D","E01011667",541,114,36,78,372,11,98,16,62,20,78,17,52,9,183,136,47,2,2,55,37,18
"2021","Leeds 051A","E01011323",611,241,120,121,344,52,141,54,50,37,85,44,36,5,63,41,22,3,3,26,9,17
"2021","Leeds 051B","E01011329",697,208,87,121,468,69,228,88,82,58,118,83,30,5,50,27,23,3,3,21,8,13
"2021","Leeds 051C","E01011330",583,163,69,94,392,47,166,60,73,33,89,56,28,5,86,61,25,4,4,28,15,13
"2021","Leeds 051D","E01011333",634,227,104,123,379,43,160,71,65,24,87,40,37,10,87,62,25,2,2,28,6,22
"2021","Leeds 052A","E01011327",655,265,64,201,363,31,153,76,52,25,80,44,31,5,98,68,30,1,1,27,16,11
"2021","Leeds 052B","E01011328",706,229,92,137,449,42,177,66,80,31,110,67,36,7,114,80,34,6,6,28,15,13
"2021","Leeds 052C","E01011335",814,277,89,188,502,51,196,90,68,38,136,91,39,6,118,83,35,1,1,35,13,22
"2021","Leeds 052D","E01011591",833,295,76,219,500,60,171,75,76,20,211,163,42,6,56,36,20,2,2,38,6,32
"2021","Leeds 053A","E01011430",486,119,28,91,300,6,185,20,138,27,23,9,13,1,80,62,18,6,6,67,41,26
"2021","Leeds 053B","E01011432",564,144,34,110,341,3,128,25,90,13,67,32,34,1,125,94,31,18,18,79,38,41
"2021","Leeds 053C","E01011433",690,207,28,179,414,3,180,42,126,12,76,43,32,1,122,95,27,33,33,69,45,24
"2021","Leeds 053D","E01011434",656,203,33,170,374,3,172,40,119,13,51,22,29,0,135,108,27,13,13,79,39,40
"2021","Leeds 054A","E01011445",477,57,3,54,69,3,25,8,13,4,22,21,1,0,5,5,0,14,14,351,7,344
"2021","Leeds 054B","E01011446",512,116,10,106,81,5,28,4,12,12,24,18,6,0,12,6,6,12,12,315,24,291
"2021","Leeds 054C","E01011447",435,86,13,73,78,2,22,10,9,3,30,27,3,0,15,8,7,9,9,271,15,256
"2021","Leeds 054D","E01011448",478,113,15,98,110,3,32,12,18,2,25,18,5,2,44,30,14,6,6,255,13,242
"2021","Leeds 054E","E01011449",615,149,18,131,173,0,48,7,38,3,67,61,4,2,37,24,13,21,21,293,6,287
"2021","Leeds 055A","E01011670",779,291,95,196,350,22,134,27,94,13,40,25,9,6,139,98,41,15,15,138,31,107
"2021","Leeds 055B","E01011671",640,216,54,162,348,12,146,24,104,18,47,21,26,0,134,73,61,9,9,76,27,49
"2021","Leeds 055F","E01033002",1016,445,101,344,468,9,205,50,150,5,131,115,16,0,96,80,16,27,27,103,12,91
"2021","Leeds 055G","E01033003",1182,623,37,586,458,2,189,50,130,9,94,81,13,0,154,133,21,19,19,101,39,62
"2021","Leeds 055I","E01035042",467,223,43,180,164,7,77,24,49,4,29,25,3,1,41,21,20,10,10,80,5,75
"2021","Leeds 055J","E01035043",435,180,15,165,110,0,37,10,23,4,19,16,2,1,39,21,18,15,15,145,18,127
"2021","Leeds 056A","E01011478",805,308,56,252,269,15,64,26,32,6,117,99,17,1,60,32,28,13,13,228,15,213
"2021","Leeds 056B","E01011479",618,179,13,166,148,6,33,23,7,3,76,68,8,0,18,11,7,15,15,291,4,287
"2021","Leeds 056C","E01011481",711,248,27,221,238,9,87,24,52,11,78,71,7,0,54,41,13,10,10,225,17,208
"2021","Leeds 056D","E01011482",872,309,58,251,354,14,95,36,54,5,189,167,22,0,43,28,15,13,13,209,3,206
"2021","Leeds 056E","E01011483",699,283,59,224,232,10,91,27,46,18,61,45,11,5,54,30,24,16,16,184,21,163
"2021","Leeds 057A","E01011406",585,172,88,84,383,70,192,73,71,48,84,39,39,6,36,14,22,1,1,30,18,12
"2021","Leeds 057B","E01011407",665,223,119,104,421,65,189,78,66,45,93,50,38,5,69,47,22,5,5,21,10,11
"2021","Leeds 057C","E01011408",765,301,185,116,432,136,177,84,57,36,73,46,25,2,43,16,27,3,3,32,14,18
"2021","Leeds 057D","E01011409",663,238,69,169,390,72,171,72,62,37,95,50,32,13,51,32,19,1,1,35,11,24
"2021","Leeds 057E","E01011410",777,241,139,102,512,110,263,116,101,46,73,48,19,6,66,46,20,0,0,24,10,14
"2021","Leeds 057F","E01011412",795,220,126,94,551,107,286,97,146,43,92,57,29,6,65,41,24,1,1,24,9,15
"2021","Leeds 058A","E01011331",632,232,84,148,361,41,145,61,58,26,104,67,35,2,66,41,25,5,5,39,7,32
"2021","Leeds 058B","E01011334",686,283,63,220,355,21,114,50,40,24,119,77,32,10,90,65,25,11,11,48,8,40
"2021","Leeds 058C","E01011336",828,403,166,237,399,39,134,50,54,30,106,68,27,11,118,76,42,2,2,26,5,21
"2021","Leeds 058D","E01011337",566,115,31,84,401,12,144,28,84,32,86,18,57,11,155,124,31,4,4,50,30,20
"2021","Leeds 059A","E01011281",901,269,67,202,560,42,228,70,121,37,163,100,59,4,123,89,34,4,4,72,13,59
"2021","Leeds 059B","E01011282",616,233,62,171,343,20,112,39,54,19,99,43,48,8,105,73,32,7,7,40,13,27
"2021","Leeds 059C","E01011283",633,192,49,143,401,33,135,35,74,26,77,33,43,1,151,125,26,5,5,40,21,19
"2021","Leeds 059D","E01011286",587,182,56,126,376,40,161,76,59,26,105,64,39,2,67,48,19,3,3,29,15,14
"2021","Leeds 059E","E01011295",750,244,52,192,470,17,162,56,74,32,119,59,53,7,147,115,32,25,25,36,10,26
"2021","Leeds 060A","E01011339",863,351,121,230,447,42,195,45,121,29,83,41,34,8,120,82,38,7,7,65,46,19
"2021","Leeds 060B","E01011340",674,197,80,117,443,32,185,38,121,26,63,25,30,8,156,91,65,7,7,34,20,14
"2021","Leeds 060C","E01011342",662,136,38,98,486,20,197,59,108,30,88,48,32,8,178,141,37,3,3,40,24,16
"2021","Leeds 060D","E01011346",788,273,98,175,469,45,170,65,88,17,98,46,42,10,131,87,44,25,25,46,29,17
"2021","Leeds 061A","E01011341",876,223,77,146,607,45,232,83,107,42,161,78,74,9,165,120,45,4,4,46,25,21
"2021","Leeds 061B","E01011343",932,340,86,254,548,38,243,96,96,51,158,106,43,9,96,57,39,13,13,44,17,27
"2021","Leeds 061C","E01011345",672,260,106,154,357,36,114,36,55,23,77,39,30,8,126,83,43,4,4,55,31,24
"2021","Leeds 061D","E01011666",594,146,78,68,422,60,221,85,77,59,86,43,39,4,52,20,32,3,3,26,12,14
"2021","Leeds 062A","E01011585",670,250,109,141,400,39,172,71,76,25,93,48,39,6,85,49,36,11,11,20,4,16
"2021","Leeds 062B","E01011587",796,277,76,201,489,40,242,84,127,31,138,76,55,7,60,40,20,9,9,30,11,19
"2021","Leeds 062C","E01011594",629,173,86,87,432,47,222,64,124,34,89,41,39,9,71,47,24,3,3,24,11,13
"2021","Leeds 062D","E01011596",781,264,95,169,497,71,251,106,113,32,116,69,44,3,57,36,21,2,2,20,2,18
"2021","Leeds 062E","E01011598",755,264,77,187,470,54,201,83,93,25,159,123,32,4,53,36,17,3,3,21,5,16
"2021","Leeds 063B","E01011678",858,392,33,359,245,3,70,37,28,5,98,94,3,1,43,28,15,31,31,221,6,215
"2021","Leeds 063D","E01011681",644,263,31,232,237,7,91,22,59,10,40,32,6,2,82,55,27,17,17,144,18,126
"2021","Leeds 063F","E01035044",650,326,18,308,149,0,46,31,12,3,65,62,3,0,18,10,8,20,20,175,5,170
"2021","Leeds 063G","E01035045",621,336,8,328,131,4,47,19,26,2,60,57,3,0,13,6,7,7,7,154,5,149
"2021","Leeds 064A","E01011338",806,303,66,237,459,11,221,70,110,41,42,17,15,10,174,126,48,11,11,44,25,19
"2021","Leeds 064B","E01011673",783,281,49,232,428,7,170,40,123,7,46,18,26,2,167,113,54,38,38,74,24,50
"2021","Leeds 064D","E01011677",784,382,75,307,344,16,149,46,91,12,59,27,27,5,101,61,40,19,19,58,26,32
"2021","Leeds 064E","E01033031",867,425,52,373,351,13,147,43,92,12,112,102,8,2,45,34,11,34,34,91,5,86
"2021","Leeds 064F","E01033035",770,363,26,337,374,4,178,22,147,9,44,16,27,1,141,116,25,7,7,33,27,6
"2021","Leeds 065A","E01011344",839,301,66,235,464,5,164,35,111,18,97,34,58,5,178,155,23,20,20,74,28,46
"2021","Leeds 065B","E01011347",781,260,38,222,437,14,155,36,107,12,82,47,35,0,168,145,23,18,18,84,25,59
"2021","Leeds 065C","E01011348",680,221,65,156,423,18,156,28,100,28,54,21,29,4,181,107,74,14,14,36,18,18
"2021","Leeds 065D","E01011349",919,473,128,345,403,31,171,49,100,22,64,37,16,11,126,91,35,11,11,43,25,18
"2021","Leeds 066A","E01011586",698,166,82,84,484,70,243,64,137,42,86,47,37,2,82,46,36,3,3,48,29,19
"2021","Leeds 066B","E01011595",803,220,63,157,492,67,272,69,134,69,85,74,10,1,62,37,25,6,6,91,65,26
"2021","Leeds 066C","E01011597",563,128,55,73,384,30,217,48,130,39,54,30,19,5,78,47,31,5,5,51,34,17
"2021","Leeds 066D","E01011599",706,209,113,96,471,48,249,83,119,47,102,59,39,4,72,38,34,0,0,26,13,13
"2021","Leeds 067B","E01011287",649,189,78,111,435,61,181,81,71,29,111,70,39,2,80,55,25,2,2,25,7,18
"2021","Leeds 067G","E01032499",701,191,72,119,474,69,261,101,102,58,78,53,21,4,60,29,31,6,6,36,14,22
"2021","Leeds 067H","E01032500",644,273,47,226,289,14,73,34,30,9,109,60,43,6,78,62,16,15,15,82,13,69
"2021","Leeds 067I","E01032606",924,282,74,208,596,66,251,89,98,64,150,61,79,10,122,85,37,7,7,46,12,34
"2021","Leeds 067J","E01032607",646,306,80,226,294,28,115,43,55,17,96,71,22,3,47,35,12,8,8,46,8,38
"2021","Leeds 067K","E01032608",518,221,50,171,247,17,101,32,47,22,76,58,16,2,47,27,20,6,6,50,11,39
"2021","Leeds 068A","E01011608",593,193,112,81,371,46,163,73,57,33,86,39,40,7,75,51,24,1,1,29,16,13
"2021","Leeds 068B","E01011609",656,257,86,171,372,36,168,66,78,24,73,31,35,7,87,62,25,8,8,27,14,13
"2021","Leeds 068C","E01011610",693,224,93,131,428,65,211,79,87,45,96,68,25,3,52,35,17,4,4,41,13,28
"2021","Leeds 068D","E01011611",622,173,56,117,409,34,161,63,59,39,80,24,49,7,127,95,32,7,7,40,16,24
"2021","Leeds 068E","E01011614",854,274,92,182,544,89,236,92,99,45,146,101,38,7,70,39,31,3,3,36,18,18
"2021","Leeds 069A","E01011413",597,135,67,68,434,63,232,70,102,60,77,49,25,3,57,27,30,5,5,28,15,13
"2021","Leeds 069B","E01011415",735,217,79,138,468,78,220,95,93,32,112,65,38,9,53,37,16,5,5,50,16,34
"2021","Leeds 069C","E01011416",617,154,78,76,442,51,236,87,106,43,89,45,36,8,64,39,25,2,2,21,11,10
"2021","Leeds 069D","E01011417",738,281,166,115,435,112,201,66,87,48,75,40,27,8,45,22,23,2,2,22,4,18
"2021","Leeds 069E","E01011420",627,182,133,49,421,144,205,95,63,47,46,26,19,1,25,13,12,1,1,24,14,10
"2021","Leeds 070A","E01011615",652,177,69,108,432,41,183,65,77,41,86,39,40,7,116,78,38,6,6,43,21,22
"2021","Leeds 070B","E01011617",687,175,68,107,476,31,163,55,79,29,103,47,51,5,171,110,61,8,8,36,13,23
"2021","Leeds 070C","E01011618",712,233,57,176,424,29,141,46,66,29,91,46,41,4,156,118,38,7,7,55,22,33
"2021","Leeds 070D","E01011621",597,141,54,87,422,33,159,57,65,37,74,19,46,9,150,120,30,6,6,34,21,13
"2021","Leeds 071A","E01011284",1094,483,44,439,493,5,155,46,99,10,190,124,58,8,122,98,24,21,21,118,24,94
"2021","Leeds 071B","E01011292",959,468,123,345,428,17,162,68,78,16,80,40,35,5,152,115,37,17,17,63,23,40
"2021","Leeds 071C","E01011293",851,331,61,270,444,22,160,47,93,20,114,56,51,7,129,99,30,19,19,76,30,46
"2021","Leeds 071D","E01011294",486,197,40,157,259,12,89,27,53,9,50,21,29,0,87,52,35,21,21,30,13,17
"2021","Leeds 071E","E01011363",861,306,73,233,479,16,154,47,86,21,116,55,39,22,166,119,47,27,27,76,26,50
"2021","Leeds 072A","E01011616",700,235,87,148,426,45,156,51,68,37,84,28,46,10,140,100,40,1,1,39,22,17
"2021","Leeds 072B","E01011620",496,92,42,50,367,37,135,40,67,28,66,18,42,6,125,94,31,4,4,37,23,14
"2021","Leeds 072C","E01011622",703,214,53,161,445,13,136,34,78,24,80,30,49,1,204,143,61,12,12,44,21,23
"2021","Leeds 072D","E01011624",725,235,102,133,440,21,143,37,79,27,89,25,51,13,184,141,43,3,3,50,30,20
"2021","Leeds 073A","E01011411",734,179,75,104,535,74,277,104,113,60,123,64,51,8,58,27,31,3,3,20,8,12
"2021","Leeds 073B","E01011414",644,161,72,89,459,86,222,80,91,51,98,58,38,2,52,27,25,1,1,24,10,14
"2021","Leeds 073C","E01011418",624,178,75,103,429,64,227,95,76,56,75,49,20,6,57,35,22,6,6,17,6,11
"2021","Leeds 073D","E01011419",494,122,73,49,361,91,212,96,74,42,40,24,14,2,18,9,9,0,0,11,2,9
"2021","Leeds 074A","E01011396",896,330,146,184,505,60,212,75,103,34,121,83,34,4,103,69,34,9,9,61,14,47
"2021","Leeds 074B","E01011399",619,161,85,76,428,70,202,64,92,46,71,44,21,6,81,45,36,4,4,30,19,11
"2021","Leeds 074C","E01011400",605,169,93,76,408,78,181,62,80,39,84,46,36,2,62,32,30,3,3,28,14,14
"2021","Leeds 074D","E01011403",667,253,173,80,395,121,187,70,82,35,54,33,17,4,32,15,17,1,1,19,9,10
"2021","Leeds 075B","E01011623",704,223,52,171,406,22,137,42,75,20,71,25,40,6,160,132,28,16,16,75,26,49
"2021","Leeds 075C","E01011625",733,252,36,216,409,28,136,38,73,25,64,25,35,4,170,138,32,11,11,72,30,42
"2021","Leeds 075D","E01011626",1171,511,101,410,561,23,178,61,94,23,161,125,34,2,190,164,26,9,9,99,18,81
"2021","Leeds 075E","E01033021",1079,526,116,410,479,16,148,53,81,14,182,150,26,6,118,88,30,15,15,74,18,56
"2021","Leeds 075F","E01033033",655,290,41,249,287,15,113,35,73,5,114,106,6,2,30,10,20,15,15,78,4,74
"2021","Leeds 075G","E01033034",915,433,10,423,355,3,74,46,27,1,263,256,7,0,5,5,0,10,10,127,0,127
"2021","Leeds 076A","E01011602",907,382,190,192,495,80,243,76,133,34,108,52,49,7,62,40,22,2,2,30,10,20
"2021","Leeds 076B","E01011603",708,223,108,115,472,80,237,79,106,52,102,58,35,9,52,38,14,1,1,13,6,7
"2021","Leeds 076C","E01011605",712,167,106,61,531,90,296,84,158,54,93,48,37,8,50,30,20,2,2,14,3,11
"2021","Leeds 076D","E01011606",762,163,73,90,536,72,264,81,126,57,89,34,42,13,104,69,35,7,7,63,40,23
"2021","Leeds 076E","E01011613",698,165,59,106,508,41,245,73,141,31,109,43,59,7,109,78,31,4,4,25,9,16
"2021","Leeds 077A","E01011397",610,135,77,58,452,80,236,76,107,53,75,36,36,3,61,36,25,0,0,23,10,13
"2021","Leeds 077B","E01011398",493,107,51,56,370,58,213,85,82,46,58,41,14,3,40,22,18,1,1,16,5,11
"2021","Leeds 077C","E01011401",713,148,90,58,538,98,276,78,144,54,111,52,48,11,52,33,19,1,1,27,9,18
"2021","Leeds 077D","E01011404",544,105,69,36,421,80,238,71,114,53,67,31,33,3,36,23,13,0,0,18,10,8
"2021","Leeds 077E","E01011405",659,167,129,38,474,165,220,84,103,33,54,31,18,5,35,17,18,0,0,18,6,12
"2021","Leeds 078A","E01011725",674,263,52,211,379,12,110,34,49,27,83,32,46,5,165,131,34,9,9,32,16,16
"2021","Leeds 078B","E01011729",799,363,96,267,373,24,113,36,56,21,111,56,49,6,117,83,34,8,8,63,23,40
"2021","Leeds 078C","E01011730",680,218,38,180,426,17,130,46,61,23,110,52,51,7,164,130,34,5,5,36,17,19
"2021","Leeds 078D","E01011735",710,241,92,149,438,36,138,37,67,34,108,47,51,10,154,105,49,2,2,31,16,15
"2021","Leeds 079A","E01011600",688,238,110,128,441,63,223,76,95,52,105,66,31,8,50,32,18,0,0,9,3,6
"2021","Leeds 079B","E01011601",663,180,57,123,449,44,196,60,106,30,115,56,48,11,91,63,28,3,3,34,17,17
"2021","Leeds 079C","E01011604",621,193,77,116,407,49,186,73,84,29,108,68,37,3,63,41,22,1,1,21,9,12
"2021","Leeds 079D","E01011607",714,197,72,125,492,55,228,75,120,33,110,51,53,6,97,65,32,2,2,25,13,12
"2021","Leeds 079E","E01011612",743,387,184,203,322,62,126,54,52,20,91,61,25,5,40,21,19,3,3,34,10,24
"2021","Leeds 080A","E01011726",659,225,89,136,411,22,157,56,65,36,98,44,53,1,130,97,33,4,4,23,14,9
"2021","Leeds 080B","E01011727",679,198,69,129,439,59,202,85,89,28,111,61,45,5,64,40,24,3,3,42,19,23
"2021","Leeds 080C","E01011728",614,179,101,78,402,87,188,73,71,44,80,46,29,5,45,23,22,2,2,33,14,19
"2021","Leeds 080D","E01011739",739,297,89,208,406,32,140,66,51,23,102,43,52,7,125,81,44,7,7,36,19,17
"2021","Leeds 081A","E01011362",1031,545,104,441,432,19,135,52,64,19,134,77,52,5,133,96,37,11,11,54,21,33
"2021","Leeds 081B","E01011731",599,158,88,70,417,78,197,72,81,44,91,36,42,13,50,31,19,1,1,24,15,9
"2021","Leeds 081C","E01011732",805,200,75,125,556,59,265,103,108,54,133,77,49,7,94,52,42,5,5,49,24,25
"2021","Leeds 081D","E01011733",729,256,123,133,443,64,201,91,79,31,105,59,40,6,66,43,23,7,7,30,16,14
"2021","Leeds 082A","E01011366",784,319,81,238,398,15,146,49,84,13,93,47,43,3,129,97,32,15,15,67,23,44
"2021","Leeds 082C","E01011368",720,294,43,251,359,10,142,47,78,17,77,40,33,4,119,98,21,11,11,67,31,36
"2021","Leeds 082D","E01011370",685,279,48,231,324,21,133,47,61,25,78,41,33,4,87,65,22,5,5,82,34,48
"2021","Leeds 082E","E01033013",719,317,73,244,323,8,99,23,65,11,116,99,15,2,73,53,20,27,27,79,16,63
"2021","Leeds 082G","E01035046",763,429,1,428,251,0,88,53,34,1,151,148,3,0,1,0,1,11,11,83,2,81
"2021","Leeds 082H","E01035047",635,238,29,209,323,7,103,36,58,9,129,115,14,0,73,63,10,11,11,74,10,64
"2021","Leeds 083A","E01011734",1191,317,70,247,822,59,403,146,213,44,251,154,86,11,99,64,35,10,10,52,19,33
"2021","Leeds 083B","E01011736",642,203,99,104,410,60,188,80,71,37,90,46,36,8,67,42,25,5,5,29,9,20
"2021","Leeds 083C","E01011737",763,344,146,198,376,27,111,40,44,27,107,59,38,10,127,91,36,4,4,43,7,36
"2021","Leeds 083D","E01011738",655,180,73,107,458,80,234,93,96,45,84,42,36,6,58,35,23,2,2,17,7,10
"2021","Leeds 085A","E01011364",877,327,72,255,463,21,226,77,137,12,87,55,26,6,120,85,35,9,9,87,27,60
"2021","Leeds 085B","E01011371",755,372,128,244,323,24,138,25,94,19,42,17,20,5,109,75,34,10,10,60,35,25
"2021","Leeds 085C","E01011373",590,211,25,186,325,14,138,29,92,17,44,18,22,4,117,82,35,12,12,54,28,26
"2021","Leeds 085D","E01011374",593,252,33,219,303,18,114,43,56,15,74,45,26,3,89,66,23,8,8,38,15,23
"2021","Leeds 086A","E01011312",752,302,38,264,364,4,147,18,114,15,64,24,38,2,131,105,26,18,18,86,51,35
"2021","Leeds 086B","E01011316",694,229,23,206,365,8,168,35,112,21,57,25,29,3,118,101,17,14,14,100,60,40
"2021","Leeds 086C","E01011372",584,194,30,164,319,4,154,20,114,20,45,19,25,1,102,80,22,14,14,71,39,32
"2021","Leeds 086D","E01011375",690,207,28,179,378,4,175,29,130,16,46,21,23,2,142,109,33,11,11,105,59,46
"2021","Leeds 087A","E01011390",598,174,83,91,406,60,180,77,61,42,87,45,34,8,78,42,36,1,1,18,10,8
"2021","Leeds 087B","E01011391",720,231,156,75,464,109,196,83,65,48,81,44,33,4,73,36,37,5,5,25,9,16
"2021","Leeds 087C","E01011392",813,190,107,83,598,117,275,94,133,48,118,56,59,3,86,64,22,2,2,25,11,14
"2021","Leeds 087D","E01011402",887,266,175,91,588,132,291,105,132,54,103,51,45,7,62,36,26,0,0,33,14,19
"2021","Leeds 088A","E01011298",704,235,97,138,434,49,152,61,61,30,120,76,39,5,103,71,32,10,10,35,17,18
"2021","Leeds 088B","E01011299",1164,296,104,192,818,93,407,131,218,58,207,99,100,8,109,85,24,2,2,50,22,28
"2021","Leeds 088C","E01011302",780,179,109,70,589,166,254,106,95,53,118,68,42,8,49,29,20,2,2,12,4,8
"2021","Leeds 088D","E01011303",492,141,84,57,327,68,146,58,51,37,61,21,32,8,50,32,18,2,2,24,12,12
"2021","Leeds 089A","E01011300",619,162,83,79,433,68,180,69,83,28,99,43,47,9,86,54,32,0,0,24,8,16
"2021","Leeds 089B","E01011301",553,138,68,70,403,92,228,93,92,43,62,39,21,2,19,11,8,2,2,12,1,11
"2021","Leeds 089C","E01011304",705,260,116,144,409,42,189,73,75,41,87,35,47,5,91,63,28,0,0,36,16,20
"2021","Leeds 089D","E01011305",652,166,66,100,459,58,229,99,87,43,102,58,37,7,67,46,21,3,3,27,8,19
"2021","Leeds 089E","E01011306",546,110,55,55,414,80,212,75,90,47,69,42,26,1,52,33,19,1,1,22,9,13
"2021","Leeds 090A","E01011315",657,189,63,126,419,48,201,77,89,35,64,25,26,13,95,60,35,11,11,49,25,24
"2021","Leeds 090B","E01011317",882,423,157,266,411,27,148,52,73,23,95,47,40,8,133,94,39,8,8,48,20,28
"2021","Leeds 090C","E01011318",642,223,45,178,374,19,146,40,89,17,67,24,37,6,136,102,34,6,6,45,24,21
"2021","Leeds 090D","E01011321",664,194,55,139,421,24,201,65,100,36,71,24,40,7,121,80,41,4,4,49,26,23
"2021","Leeds 090E","E01011369",739,268,129,139,429,51,166,72,66,28,100,57,35,8,102,64,38,10,10,42,17,25
"2021","Leeds 091A","E01011313",650,192,37,155,398,23,190,54,102,34,66,28,35,3,110,81,29,9,9,60,29,31
"2021","Leeds 091B","E01011314",676,243,85,158,369,22,162,64,82,16,97,46,46,5,80,54,26,8,8,64,25,39
"2021","Leeds 091C","E01011319",617,182,52,130,387,43,192,46,121,25,66,34,26,6,84,47,37,2,2,48,25,23
"2021","Leeds 091D","E01011320",691,198,80,118,428,59,215,57,112,46,62,26,32,4,79,45,34,13,13,65,36,29
"2021","Leeds 091E","E01011322",685,197,91,106,453,60,203,79,85,39,80,32,40,8,108,76,32,2,2,35,22,13
"2021","Leeds 092A","E01011471",661,216,82,134,395,31,149,52,70,27,68,26,37,5,141,92,49,6,6,50,28,22
"2021","Leeds 092B","E01011472",709,271,102,169,406,30,138,45,60,33,96,38,47,11,140,91,49,2,2,32,16,16
"2021","Leeds 092C","E01011473",613,187,53,134,389,5,129,37,65,27,79,32,41,6,171,135,36,5,5,37,14,23
"2021","Leeds 092D","E01011474",655,198,81,117,409,15,139,46,66,27,81,36,38,7,162,111,51,12,12,48,22,26
"2021","Leeds 093A","E01011518",1004,270,70,200,691,60,304,114,137,53,203,138,60,5,117,78,39,7,7,43,21,22
"2021","Leeds 093B","E01011524",557,166,76,90,362,66,194,82,65,47,65,41,19,5,35,25,10,2,2,29,5,24
"2021","Leeds 093C","E01011526",488,74,29,45,395,60,259,96,120,43,54,28,25,1,21,14,7,1,1,19,8,11
"2021","Leeds 093D","E01011531",772,245,168,77,505,137,231,93,88,50,82,52,27,3,54,33,21,1,1,22,6,16
"2021","Leeds 094A","E01011466",635,223,95,128,375,42,168,57,67,44,72,28,40,4,88,51,37,5,5,37,23,14
"2021","Leeds 094B","E01011469",631,177,89,88,421,56,206,101,66,39,87,43,35,9,71,43,28,1,1,33,15,18
"2021","Leeds 094C","E01011475",693,212,50,162,453,20,131,43,56,32,99,39,53,7,196,153,43,7,7,28,13,15
"2021","Leeds 094D","E01011476",494,154,78,76,307,20,106,36,45,25,79,20,52,7,100,75,25,2,2,33,21,12
"2021","Leeds 095A","E01011519",679,228,85,143,421,47,179,70,79,30,108,52,48,8,81,55,26,6,6,30,16,14
"2021","Leeds 095B","E01011522",592,145,88,57,429,96,216,82,87,47,78,43,31,4,39,20,19,0,0,18,9,9
"2021","Leeds 095C","E01011525",691,229,72,157,434,62,175,67,84,24,124,70,48,6,72,51,21,1,1,28,8,20
"2021","Leeds 095D","E01011528",618,128,55,73,465,45,281,92,136,53,90,59,28,3,48,34,14,1,1,25,8,17
"2021","Leeds 095E","E01011532",707,244,103,141,433,37,177,53,85,39,124,57,58,9,88,55,33,7,7,30,16,14
"2021","Leeds 096A","E01011520",675,201,104,97,462,105,234,96,87,51,85,45,34,6,38,25,13,0,0,12,5,7
"2021","Leeds 096B","E01011521",998,313,136,177,645,110,310,129,138,43,131,80,49,2,90,52,38,4,4,40,19,21
"2021","Leeds 096C","E01011523",815,262,127,135,526,52,226,81,115,30,138,85,50,3,104,60,44,6,6,27,12,15
"2021","Leeds 096D","E01011527",771,233,117,116,510,130,229,87,98,44,90,43,37,10,61,29,32,0,0,28,14,14
"2021","Leeds 096E","E01011529",585,163,58,105,405,61,171,66,64,41,84,37,42,5,83,57,26,6,6,17,8,9
"2021","Leeds 097B","E01011635",775,262,102,160,487,75,246,88,114,44,102,51,42,9,54,34,20,10,10,26,12,14
"2021","Leeds 097C","E01011637",727,192,57,135,498,64,259,93,124,42,110,73,32,5,63,52,11,2,2,37,17,20
"2021","Leeds 097D","E01011638",622,182,109,73,419,81,216,82,93,41,67,37,30,0,51,28,23,4,4,21,9,12
"2021","Leeds 097F","E01032487",459,147,82,65,292,43,112,39,50,23,58,25,27,6,77,51,26,2,2,20,11,9
"2021","Leeds 097G","E01032488",758,181,113,68,548,118,282,88,138,56,95,46,41,8,53,24,29,0,0,29,13,16
"2021","Leeds 098A","E01011627",585,177,109,68,379,65,159,58,67,34,77,30,42,5,75,47,28,3,3,29,14,15
"2021","Leeds 098B","E01011628",586,191,122,69,381,87,186,85,69,32,63,41,15,7,43,25,18,2,2,14,6,8
"2021","Leeds 098C","E01011629",623,215,91,124,391,55,162,65,77,20,97,54,37,6,77,39,38,0,0,17,9,8
"2021","Leeds 098D","E01011632",599,198,87,111,380,24,130,47,69,14,86,32,45,9,134,96,38,6,6,21,9,12
"2021","Leeds 098E","E01011633",643,178,90,88,449,91,223,73,102,48,80,47,29,4,54,26,28,1,1,16,7,9
"2021","Leeds 099C","E01011502",584,177,74,103,377,41,167,67,61,39,85,36,41,8,81,54,27,3,3,30,13,17
"2021","Leeds 099E","E01032497",633,168,55,113,422,24,169,53,88,28,78,35,38,5,148,111,37,3,3,43,25,18
"2021","Leeds 099F","E01032498",719,211,105,106,467,104,206,85,74,47,90,36,50,4,63,38,25,4,4,41,17,24
"2021","Leeds 099G","E01035048",782,219,56,163,526,32,286,94,160,32,124,61,55,8,78,51,27,6,6,37,16,21
"2021","Leeds 099H","E01035049",697,265,41,224,398,22,216,84,113,19,106,65,37,4,50,36,14,4,4,34,15,19
"2021","Leeds 100A","E01011496",604,128,40,88,466,36,255,76,132,47,114,74,33,7,59,40,19,2,2,10,3,7
"2021","Leeds 100B","E01011630",892,248,93,155,611,77,283,124,119,40,148,85,55,8,97,63,34,6,6,33,14,19
"2021","Leeds 100C","E01011634",677,195,99,96,454,78,212,68,96,48,88,44,37,7,75,55,20,1,1,28,17,11
"2021","Leeds 100D","E01011636",841,261,150,111,551,106,308,112,160,36,90,51,33,6,45,24,21,2,2,29,12,17
"2021","Leeds 100E","E01011639",637,177,95,82,442,63,165,66,65,34,110,52,52,6,99,59,40,5,5,18,8,10
"2021","Leeds 101A","E01011491",607,192,46,146,384,24,123,42,59,22,76,27,40,9,156,107,49,5,5,31,19,12
"2021","Leeds 101B","E01011492",663,185,85,100,430,25,142,41,68,33,93,31,57,5,166,127,39,4,4,48,31,17
"2021","Leeds 101C","E01011493",663,189,63,126,426,13,143,44,74,25,87,34,47,6,177,131,46,6,6,48,17,31
"2021","Leeds 101D","E01011494",625,146,47,99,426,28,160,39,87,34,76,20,49,7,148,109,39,14,14,53,32,21
"2021","Leeds 101E","E01011497",678,181,76,105,451,20,160,50,77,33,81,29,47,5,185,144,41,5,5,46,27,19
"2021","Leeds 102B","E01011540",874,248,88,160,595,57,234,81,122,31,161,84,70,7,140,97,43,3,3,31,11,20
"2021","Leeds 102F","E01032489",981,333,74,259,609,41,260,101,117,42,211,146,57,8,89,65,24,8,8,39,12,27
"2021","Leeds 102G","E01032490",580,143,48,95,411,45,216,61,117,38,106,71,29,6,42,34,8,2,2,26,11,15
"2021","Leeds 102H","E01032491",489,106,38,68,373,45,210,85,92,33,69,30,31,8,48,32,16,1,1,10,6,4
"2021","Leeds 102I","E01032492",1063,445,93,352,566,31,175,78,75,22,194,149,36,9,155,104,51,11,11,52,18,34
"2021","Leeds 103A","E01011307",651,175,72,103,444,73,179,73,61,45,91,34,48,9,97,57,40,4,4,32,16,16
"2021","Leeds 103B","E01011308",660,195,107,88,447,90,205,66,91,48,84,41,40,3,68,52,16,0,0,18,10,8
"2021","Leeds 103C","E01011393",902,239,109,130,630,65,341,119,177,45,149,85,59,5,71,52,19,4,4,33,14,19
"2021","Leeds 103D","E01011394",494,138,77,61,341,65,170,69,71,30,67,32,33,2,39,23,16,0,0,15,11,4
"2021","Leeds 103E","E01011395",462,99,34,65,341,28,170,55,93,22,84,42,34,8,55,40,15,4,4,22,11,11
"2021","Leeds 104A","E01011533",750,344,102,242,376,40,148,72,54,22,123,72,46,5,62,44,18,3,3,30,9,21
"2021","Leeds 104B","E01011541",1182,627,232,395,507,86,190,98,64,28,140,106,34,0,83,49,34,8,8,48,2,46
"2021","Leeds 104C","E01011545",666,246,85,161,394,42,158,66,56,36,106,67,35,4,85,61,24,3,3,26,8,18
"2021","Leeds 104D","E01011547",935,364,121,243,524,52,223,79,105,39,149,88,58,3,96,65,31,4,4,47,18,29
"2021","Leeds 105D","E01011500",688,200,115,85,463,85,238,95,90,53,81,40,36,5,57,31,26,2,2,25,10,15
"2021","Leeds 105F","E01032496",953,264,92,172,661,61,363,121,187,55,137,84,45,8,98,75,23,2,2,28,12,16
"2021","Leeds 105G","E01035050",610,128,31,97,450,22,217,59,135,23,121,54,60,7,87,72,15,3,3,32,20,12
"2021","Leeds 105H","E01035051",607,109,18,91,470,18,269,98,137,34,114,62,46,6,65,48,17,4,4,28,19,9
"2021","Leeds 105I","E01035052",594,174,35,139,396,20,170,52,96,22,120,67,51,2,82,55,27,4,4,24,7,17
"2021","Leeds 105J","E01035053",659,157,41,116,474,19,262,59,174,29,117,58,54,5,68,59,9,8,8,28,12,16
"2021","Leeds 106A","E01011530",634,189,82,107,428,79,212,94,87,31,86,48,30,8,48,27,21,3,3,17,6,11
"2021","Leeds 106B","E01011534",1018,301,94,207,670,42,325,90,201,34,184,114,65,5,118,88,30,1,1,47,17,30
"2021","Leeds 106C","E01011546",782,279,113,166,477,56,206,83,89,34,121,71,48,2,92,59,33,2,2,26,11,15
"2021","Leeds 106D","E01011548",640,177,103,74,439,83,202,73,88,41,81,27,48,6,69,39,30,4,4,24,11,13
"2021","Leeds 106E","E01011550",563,140,61,79,401,68,213,74,94,45,73,39,27,7,45,27,18,2,2,22,14,8
"2021","Leeds 107A","E01011537",969,343,164,179,601,131,277,118,97,62,110,64,39,7,78,55,23,5,5,25,12,13
"2021","Leeds 107B","E01011538",691,212,109,103,441,59,175,72,73,30,122,62,49,11,82,47,35,3,3,38,18,20
"2021","Leeds 107C","E01011551",730,183,51,132,520,28,247,89,115,43,143,80,55,8,101,71,30,1,1,27,15,12
"2021","Leeds 107D","E01011552",600,162,82,80,406,42,159,45,82,32,85,28,44,13,113,69,44,7,7,32,18,14
"2021","Leeds 108A","E01011535",688,145,77,68,506,100,283,101,125,57,72,35,31,6,49,32,17,2,2,37,14,23
"2021","Leeds 108B","E01011536",707,172,87,85,505,88,259,106,114,39,94,51,33,10,63,43,20,1,1,30,15,15
"2021","Leeds 108C","E01011549",516,54,20,34,441,33,323,128,116,79,53,20,31,2,31,20,11,1,1,21,11,10
"2021","Leeds 108D","E01011553",613,158,78,80,441,68,221,96,88,37,95,54,35,6,56,26,30,1,1,14,10,4
"2021","Leeds 109A","E01011685",851,263,81,182,482,69,237,78,132,27,117,91,25,1,54,37,17,5,5,106,15,91
"2021","Leeds 109B","E01011687",587,159,79,80,381,63,219,64,118,37,60,36,20,4,37,21,16,2,2,47,24,23
"2021","Leeds 109C","E01011690",666,269,133,136,312,56,145,48,82,15,85,67,16,2,21,8,13,5,5,85,4,81
"2021","Leeds 109D","E01011692",718,261,60,201,394,56,173,62,86,25,123,96,23,4,36,22,14,6,6,63,3,60
"2021","Leeds 109E","E01011693",760,289,51,238,333,13,111,45,59,7,161,145,15,1,34,24,10,14,14,138,6,132
"2021","Leeds 109F","E01011694",732,202,43,159,353,43,181,58,103,20,89,68,19,2,34,15,19,6,6,177,21,156
"2021","Leeds 109G","E01032876",624,131,56,75,465,73,260,75,148,37,83,53,26,4,44,26,18,5,5,28,9,19
"2021","Leeds 110A","E01011442",624,208,16,192,121,1,40,15,20,5,54,52,2,0,17,5,12,9,9,295,7,288
"2021","Leeds 110B","E01011443",720,305,21,284,181,1,55,21,31,3,102,98,4,0,11,5,6,12,12,234,11,223
"2021","Leeds 110C","E01011444",622,209,17,192,86,0,29,11,14,4,42,37,4,1,12,8,4,3,3,327,12,315
"2021","Leeds 110D","E01011451",528,264,60,204,187,15,67,27,34,6,81,68,13,0,16,8,8,8,8,77,6,71
"2021","Leeds 110E","E01011668",597,217,16,201,137,4,48,16,27,5,51,43,4,4,24,15,9,10,10,243,17,226
"2021","Leeds 110F","E01011669",526,174,12,162,179,6,56,19,29,8,63,48,12,3,47,37,10,7,7,173,10,163
"2021","Leeds 110G","E01032946",830,304,104,200,291,28,110,65,40,5,112,101,8,3,24,15,9,17,17,235,11,224
"2021","Leeds 111A","E01033008",596,406,2,404,132,0,37,25,10,2,75,74,1,0,4,2,2,16,16,58,0,58
"2021","Leeds 111B","E01033010",765,516,5,511,169,1,37,31,5,1,99,99,0,0,6,4,2,26,26,80,1,79
"2021","Leeds 111C","E01033011",746,388,11,377,276,1,68,45,22,1,190,190,0,0,2,1,1,15,15,82,0,82
"2021","Leeds 111D","E01033015",934,427,5,422,334,1,87,64,21,2,213,206,7,0,9,4,5,24,24,173,3,170
"2021","Leeds 111E","E01033016",702,415,16,399,227,1,59,38,20,1,146,144,2,0,11,7,4,10,10,60,2,58
"2021","Leeds 112A","E01011467",815,289,83,206,459,20,193,60,111,22,134,102,28,4,105,78,27,7,7,67,22,45
"2021","Leeds 112B","E01011468",919,343,86,257,503,35,186,64,90,32,120,71,43,6,155,108,47,7,7,73,27,46
"2021","Leeds 112C","E01011470",600,213,67,146,353,39,129,67,38,24,87,44,36,7,96,67,29,2,2,34,14,20
"2021","Leeds 112F","E01035054",1378,659,7,652,516,1,121,75,45,1,357,353,4,0,15,9,6,22,22,203,3,200
"2021","Wakefield 001A","E01011740",685,190,81,109,477,40,178,75,69,34,101,35,61,5,154,110,44,4,4,18,10,8
"2021","Wakefield 001B","E01011741",633,166,99,67,452,104,211,98,59,54,79,32,36,11,55,27,28,3,3,15,4,11
"2021","Wakefield 001C","E01011742",728,239,121,118,465,50,170,67,64,39,122,39,68,15,116,80,36,7,7,24,10,14
"2021","Wakefield 001D","E01011745",686,165,63,102,494,42,176,73,78,25,115,31,70,14,154,118,36,7,7,27,16,11
"2021","Wakefield 001E","E01011746",929,191,66,125,682,35,256,83,126,47,213,97,102,14,173,126,47,5,5,56,33,23
"2021","Wakefield 002A","E01011752",820,325,85,240,459,45,183,79,74,30,116,64,45,7,110,75,35,5,5,36,14,22
"2021","Wakefield 002B","E01011753",643,223,95,128,396,62,171,72,58,41,88,53,26,9,70,43,27,5,5,24,9,15
"2021","Wakefield 002C","E01011756",720,343,147,196,355,41,104,48,37,19,99,55,35,9,110,62,48,1,1,22,6,16
"2021","Wakefield 002E","E01011762",744,274,86,188,451,56,181,75,62,44,116,69,41,6,94,59,35,4,4,19,3,16
"2021","Wakefield 002F","E01034260",628,177,32,145,418,15,169,70,84,15,161,107,50,4,66,45,21,7,7,33,14,19
"2021","Wakefield 002G","E01034261",593,226,78,148,325,31,121,64,37,20,86,44,35,7,78,53,25,9,9,42,9,33
"2021","Wakefield 003A","E01011743",595,114,82,32,464,116,251,107,79,65,72,35,31,6,24,7,17,1,1,17,8,9
"2021","Wakefield 003B","E01011744",683,152,83,69,515,91,276,117,109,50,96,47,34,15,51,28,23,1,1,16,6,10
"2021","Wakefield 003C","E01011747",735,222,76,146,482,33,170,64,73,33,132,57,68,7,136,92,44,11,11,31,14,17
"2021","Wakefield 003D","E01011750",608,162,71,91,400,31,157,55,68,34,95,23,67,5,113,71,42,4,4,46,21,25
"2021","Wakefield 003E","E01011754",649,181,108,73,441,63,201,79,73,49,95,38,49,8,78,51,27,4,4,27,18,9
"2021","Wakefield 004A","E01011757",975,239,91,148,700,75,355,123,178,54,168,93,67,8,99,68,31,3,3,36,11,25
"2021","Wakefield 004B","E01011759",885,289,115,174,565,53,213,86,87,40,152,74,68,10,145,96,49,2,2,31,17,14
"2021","Wakefield 004C","E01011761",964,312,107,205,618,94,264,94,118,52,160,87,57,16,94,68,26,6,6,34,14,20
"2021","Wakefield 004D","E01011763",726,310,135,175,388,44,161,80,45,36,91,41,43,7,86,59,27,6,6,28,10,18
"2021","Wakefield 004E","E01011764",809,316,101,215,452,40,184,72,69,43,124,67,51,6,97,60,37,7,7,41,21,20
"2021","Wakefield 005A","E01011748",663,158,81,77,469,87,234,114,68,52,74,44,26,4,74,40,34,0,0,36,16,20
"2021","Wakefield 005C","E01011751",530,113,52,61,394,56,209,95,66,48,89,48,36,5,40,22,18,0,0,23,13,10
"2021","Wakefield 005D","E01011755",685,168,80,88,488,89,254,125,80,49,95,49,37,9,48,31,17,2,2,29,13,16
"2021","Wakefield 005E","E01034262",626,209,56,153,390,24,153,55,66,32,127,69,58,0,83,60,23,3,3,27,5,22
"2021","Wakefield 005F","E01034263",642,160,39,121,445,22,190,74,88,28,175,106,63,6,56,37,19,2,2,37,20,17
"2021","Wakefield 006A","E01011873",885,236,70,166,623,40,313,99,170,44,168,95,64,9,100,61,39,2,2,26,12,14
"2021","Wakefield 006B","E01011877",544,134,68,66,392,72,215,76,83,56,45,27,15,3,58,31,27,2,2,18,6,12
"2021","Wakefield 006C","E01011894",550,134,71,63,389,77,217,84,86,47,54,32,16,6,38,23,15,3,3,27,10,17
"2021","Wakefield 006D","E01011895",579,150,72,78,401,50,204,76,86,42,75,35,32,8,69,40,29,3,3,28,13,15
"2021","Wakefield 007A","E01011875",664,246,101,145,387,46,168,69,67,32,103,51,46,6,67,46,21,3,3,31,15,16
"2021","Wakefield 007B","E01011876",1008,243,77,166,726,69,323,116,169,38,219,124,87,8,108,71,37,7,7,39,19,20
"2021","Wakefield 007C","E01011878",666,186,88,98,455,82,245,89,102,54,73,37,32,4,53,25,28,2,2,25,7,18
"2021","Wakefield 007D","E01011880",701,205,67,138,472,76,236,90,99,47,104,63,36,5,55,33,22,1,1,24,10,14
"2021","Wakefield 008A","E01011881",674,248,107,141,411,73,191,91,71,29,84,50,33,1,59,37,22,4,4,15,4,11
"2021","Wakefield 008B","E01011887",986,184,79,105,745,66,420,121,234,65,178,90,77,11,80,46,34,1,1,57,32,25
"2021","Wakefield 008C","E01011893",593,145,77,68,436,68,254,114,89,51,67,41,19,7,44,22,22,3,3,12,8,4
"2021","Wakefield 008D","E01011896",669,210,123,87,430,78,183,68,69,46,76,40,31,5,89,52,37,4,4,29,16,13
"2021","Wakefield 008E","E01011897",760,322,173,149,417,62,145,43,71,31,93,50,36,7,113,75,38,4,4,21,11,10
"2021","Wakefield 009A","E01011874",669,157,88,69,496,105,260,105,103,52,81,46,30,5,48,24,24,2,2,16,8,8
"2021","Wakefield 009B","E01011879",653,201,73,128,431,61,202,89,58,55,102,49,46,7,63,41,22,3,3,21,7,14
"2021","Wakefield 009C","E01011882",635,173,118,55,446,114,219,80,90,49,74,36,28,10,37,18,19,2,2,16,3,13
"2021","Wakefield 009D","E01011883",691,231,126,105,439,64,217,86,85,46,98,58,32,8,56,36,20,4,4,21,13,8
"2021","Wakefield 010A","E01011805",650,280,122,158,335,36,149,59,58,32,70,34,31,5,75,40,35,5,5,35,14,21
"2021","Wakefield 010B","E01011807",655,246,85,161,383,41,173,86,55,32,75,30,39,6,85,50,35,9,9,26,10,16
"2021","Wakefield 010C","E01011808",867,283,132,151,545,85,238,97,98,43,119,51,62,6,100,66,34,3,3,39,20,19
"2021","Wakefield 010D","E01011810",568,114,62,52,428,52,206,101,68,37,86,36,45,5,79,50,29,5,5,26,17,9
"2021","Wakefield 011A","E01011803",853,259,63,196,550,33,194,88,77,29,214,104,106,4,102,72,30,7,7,44,21,23
"2021","Wakefield 011B","E01011804",698,221,105,116,453,86,182,83,70,29,95,48,37,10,88,62,26,2,2,24,7,17
"2021","Wakefield 011C","E01011806",631,187,84,103,417,66,210,93,63,54,83,46,34,3,55,30,25,3,3,27,9,18
"2021","Wakefield 011D","E01011809",743,320,130,190,386,62,147,55,50,42,88,50,29,9,86,45,41,3,3,37,15,22
"2021","Wakefield 011E","E01011811",680,195,79,116,453,32,140,58,57,25,112,32,76,4,164,132,32,5,5,32,18,14
"2021","Wakefield 012A","E01011835",949,224,97,127,710,112,336,154,124,58,197,121,70,6,64,34,30,1,1,15,7,8
"2021","Wakefield 012B","E01011836",605,140,51,89,446,46,212,98,80,34,118,58,52,8,68,41,27,2,2,19,10,9
"2021","Wakefield 012C","E01011839",1032,217,92,125,795,99,331,140,146,45,218,108,96,14,139,101,38,8,8,20,13,7
"2021","Wakefield 012D","E01011843",681,147,62,85,507,48,235,83,111,41,123,61,52,10,97,65,32,4,4,27,17,10
"2021","Wakefield 012E","E01011844",801,170,51,119,614,73,355,136,165,54,129,73,53,3,55,41,14,2,2,17,8,9
"2021","Wakefield 013A","E01011758",1062,287,73,214,708,51,256,94,121,41,259,128,109,22,136,102,34,6,6,67,30,37
"2021","Wakefield 013B","E01011812",1004,213,96,117,753,111,439,157,201,81,123,71,45,7,75,48,27,5,5,38,24,14
"2021","Wakefield 013C","E01011820",660,198,83,115,441,51,200,79,75,46,125,73,46,6,62,37,25,3,3,21,7,14
"2021","Wakefield 013D","E01011821",614,188,106,82,406,70,203,92,77,34,74,36,33,5,58,31,27,1,1,20,11,9
"2021","Wakefield 014A","E01011885",652,190,112,78,442,83,243,88,97,58,70,43,23,4,45,31,14,1,1,20,11,9
"2021","Wakefield 014B","E01011886",886,216,103,113,644,109,321,100,170,51,118,54,55,9,91,61,30,5,5,26,6,20
"2021","Wakefield 014C","E01011888",623,156,94,62,447,119,211,94,70,47,80,37,37,6,37,27,10,0,0,20,6,14
"2021","Wakefield 014D","E01011890",571,112,56,56,439,58,236,86,96,54,76,41,32,3,64,34,30,5,5,20,9,11
"2021","Wakefield 014E","E01011891",731,285,151,134,425,72,195,77,81,37,87,44,33,10,69,43,26,2,2,21,8,13
"2021","Wakefield 015A","E01011834",784,171,59,112,581,44,271,94,125,52,153,72,68,13,111,77,34,2,2,32,17,15
"2021","Wakefield 015B","E01011837",755,267,61,206,441,57,194,67,91,36,113,58,46,9,74,48,26,3,3,47,20,27
"2021","Wakefield 015C","E01011838",1093,581,153,428,464,35,163,74,61,28,153,114,35,4,106,68,38,7,7,48,17,31
"2021","Wakefield 015D","E01011841",985,307,132,175,646,87,311,111,152,48,165,96,59,10,73,41,32,10,10,32,6,26
"2021","Wakefield 015E","E01011842",672,292,120,172,353,45,111,40,44,27,87,38,39,10,104,82,22,6,6,27,13,14
"2021","Wakefield 016A","E01011813",731,226,125,101,475,41,190,64,102,24,111,37,66,8,131,101,30,2,2,30,19,11
"2021","Wakefield 016B","E01011814",813,268,70,198,496,36,190,76,69,45,122,62,52,8,141,106,35,7,7,49,14,35
"2021","Wakefield 016C","E01011815",679,235,114,121,408,76,182,94,56,32,77,39,33,5,73,45,28,0,0,36,14,22
"2021","Wakefield 016D","E01011816",637,213,100,113,392,49,156,63,51,42,98,40,49,9,82,54,28,7,7,32,12,20
"2021","Wakefield 016E","E01011819",788,273,83,190,466,55,220,95,80,45,117,65,47,5,61,32,29,13,13,49,20,29
"2021","Wakefield 016F","E01011822",649,201,72,129,403,39,168,69,64,35,93,41,43,9,95,65,30,8,8,45,14,31
"2021","Wakefield 017A","E01011884",1130,331,73,258,736,81,397,114,219,64,147,95,48,4,100,70,30,11,11,63,24,39
"2021","Wakefield 017B","E01011912",813,379,95,284,337,34,159,47,88,24,78,58,17,3,49,28,21,17,17,97,43,54
"2021","Wakefield 017C","E01011913",599,132,43,89,355,17,216,54,123,39,39,20,17,2,67,36,31,16,16,112,76,36
"2021","Wakefield 017E","E01034264",709,403,56,347,238,12,90,30,46,14,87,66,21,0,40,24,16,9,9,68,28,40
"2021","Wakefield 017F","E01034265",759,458,139,319,271,19,92,45,40,7,94,84,10,0,50,22,28,16,16,30,4,26
"2021","Wakefield 018A","E01011840",806,283,110,173,496,54,223,88,89,46,128,58,61,9,88,63,25,3,3,27,16,11
"2021","Wakefield 018B","E01011850",639,171,86,85,432,44,171,58,61,52,80,22,46,12,132,104,28,5,5,36,20,16
"2021","Wakefield 018C","E01011852",687,174,83,91,493,53,185,53,83,49,109,42,60,7,143,101,42,3,3,20,9,11
"2021","Wakefield 018D","E01011853",579,169,99,70,387,52,168,64,62,42,84,31,44,9,80,49,31,3,3,23,8,15
"2021","Wakefield 019A","E01011920",1000,434,76,358,469,26,188,78,82,28,154,116,37,1,82,61,21,19,19,97,36,61
"2021","Wakefield 019B","E01011923",771,271,82,189,457,76,236,97,107,32,93,58,33,2,50,34,16,2,2,43,16,27
"2021","Wakefield 019C","E01011924",738,223,72,151,475,66,229,94,106,29,104,56,37,11,71,36,35,5,5,40,16,24
"2021","Wakefield 019D","E01011925",696,172,64,108,471,32,194,61,108,25,120,41,66,13,115,77,38,10,10,53,29,24
"2021","Wakefield 020A","E01011909",594,166,89,77,404,86,200,85,85,30,63,32,27,4,50,24,26,5,5,24,12,12
"2021","Wakefield 020B","E01011910",729,346,148,198,344,38,165,58,80,27,73,30,37,6,67,36,31,1,1,39,17,22
"2021","Wakefield 020C","E01011911",629,170,60,110,425,25,195,58,105,32,75,26,35,14,126,87,39,4,4,34,18,16
"2021","Wakefield 020D","E01011914",683,232,59,173,411,39,182,57,92,33,89,42,36,11,96,67,29,5,5,40,24,16
"2021","Wakefield 020E","E01011915",627,194,45,149,378,32,182,49,101,32,71,34,33,4,83,51,32,10,10,55,34,21
"2021","Wakefield 021A","E01011823",668,246,109,137,400,77,183,81,68,34,86,47,33,6,52,38,14,2,2,22,11,11
"2021","Wakefield 021B","E01011824",690,206,101,105,455,29,179,55,93,31,116,44,65,7,127,90,37,4,4,29,13,16
"2021","Wakefield 021C","E01011825",795,219,90,129,549,65,260,98,117,45,127,64,52,11,92,65,27,5,5,27,14,13
"2021","Wakefield 021D","E01011826",631,160,97,63,450,95,233,82,110,41,68,34,30,4,52,30,22,2,2,21,10,11
"2021","Wakefield 021E","E01011827",533,140,95,45,381,98,187,85,63,39,62,31,26,5,34,14,20,0,0,12,4,8
"2021","Wakefield 021F","E01011828",673,208,76,132,452,84,200,83,81,36,98,53,42,3,70,45,25,0,0,13,5,8
"2021","Wakefield 022A","E01011889",652,142,55,87,491,52,276,103,128,45,101,59,40,2,61,37,24,1,1,19,5,14
"2021","Wakefield 022B","E01011892",788,220,95,125,521,64,248,85,117,46,120,48,57,15,86,60,26,3,3,47,18,29
"2021","Wakefield 022C","E01011919",831,289,77,212,496,36,202,74,102,26,147,64,70,13,104,64,40,7,7,46,22,24
"2021","Wakefield 022D","E01011921",630,167,65,102,440,69,220,83,96,41,81,38,36,7,68,47,21,2,2,23,9,14
"2021","Wakefield 022E","E01011926",660,221,56,165,383,20,190,43,113,34,64,29,30,5,98,65,33,11,11,56,33,23
"2021","Wakefield 022F","E01011927",595,192,88,104,367,40,149,62,60,27,85,35,42,8,91,59,32,2,2,36,16,20
"2021","Wakefield 023A","E01011845",806,208,142,66,583,155,296,125,120,51,73,36,32,5,55,33,22,4,4,15,5,10
"2021","Wakefield 023B","E01011846",598,166,86,80,413,78,204,87,71,46,70,32,27,11,61,37,24,0,0,19,11,8
"2021","Wakefield 023C","E01011847",612,151,97,54,443,98,247,90,107,50,58,32,20,6,39,23,16,1,1,18,9,9
"2021","Wakefield 023D","E01011848",609,159,107,52,442,93,229,91,95,43,67,33,28,6,50,28,22,3,3,8,7,1
"2021","Wakefield 023E","E01011851",708,291,143,148,380,60,157,66,60,31,80,44,31,5,81,50,31,2,2,37,22,15
"2021","Wakefield 024B","E01011776",657,168,82,86,441,63,186,74,79,33,89,40,39,10,103,69,34,0,0,48,29,19
"2021","Wakefield 024C","E01011777",638,207,89,118,407,77,157,66,56,35,102,58,39,5,68,37,31,3,3,24,9,15
"2021","Wakefield 024D","E01011778",701,217,82,135,459,64,191,93,60,38,109,49,53,7,90,66,24,5,5,25,9,16
"2021","Wakefield 024E","E01011817",630,173,72,101,439,34,217,93,83,41,85,37,36,12,99,69,30,4,4,18,12,6
"2021","Wakefield 024F","E01011818",614,188,96,92,405,82,178,74,64,40,74,36,35,3,68,45,23,3,3,21,11,10
"2021","Wakefield 024G","E01034266",627,101,9,92,498,21,265,85,159,21,162,82,75,5,48,38,10,2,2,28,13,15
"2021","Wakefield 024H","E01034267",593,145,30,115,433,34,207,71,112,24,135,78,55,2,53,39,14,4,4,15,6,9
"2021","Wakefield 024I","E01034268",528,119,58,61,390,49,196,75,90,31,79,38,34,7,64,40,24,2,2,19,9,10
"2021","Wakefield 025A","E01011829",614,187,73,114,403,70,197,84,87,26,77,41,32,4,56,37,19,3,3,24,11,13
"2021","Wakefield 025B","E01011830",727,345,191,154,366,81,173,56,80,37,57,28,28,1,52,27,25,3,3,16,6,10
"2021","Wakefield 025C","E01011831",799,300,119,181,474,59,226,91,96,39,93,50,39,4,93,59,34,3,3,25,10,15
"2021","Wakefield 025D","E01011832",660,222,116,106,421,66,179,69,77,33,82,36,38,8,92,68,24,2,2,17,8,9
"2021","Wakefield 025E","E01011833",661,207,101,106,437,90,227,84,108,35,70,39,27,4,49,37,12,1,1,17,8,9
"2021","Wakefield 026A","E01011899",593,117,50,67,432,39,172,52,80,40,99,40,51,8,114,83,31,8,8,44,34,10
"2021","Wakefield 026B","E01011900",751,351,149,202,376,40,153,64,67,22,82,42,37,3,98,56,42,3,3,24,13,11
"2021","Wakefield 026C","E01011901",592,138,68,70,418,30,169,29,109,31,89,16,62,11,127,78,49,3,3,36,19,17
"2021","Wakefield 026D","E01011904",562,85,40,45,435,37,187,42,110,35,75,21,48,6,133,88,45,3,3,42,23,19
"2021","Wakefield 026E","E01011918",940,224,78,146,673,58,304,95,175,34,163,67,81,15,142,96,46,6,6,43,26,17
"2021","Wakefield 026F","E01011922",633,233,85,148,374,31,142,57,55,30,96,42,44,10,102,70,32,3,3,26,20,6
"2021","Wakefield 027A","E01011779",610,148,75,73,436,61,192,73,70,49,86,35,43,8,91,67,24,6,6,26,10,16
"2021","Wakefield 027B","E01011780",844,336,178,158,465,38,183,66,76,41,101,46,46,9,135,79,56,8,8,43,29,14
"2021","Wakefield 027C","E01011781",1086,344,117,227,701,74,255,103,106,46,227,116,101,10,139,90,49,6,6,41,21,20
"2021","Wakefield 027D","E01011782",689,184,98,86,477,93,230,99,82,49,99,42,53,4,53,34,19,2,2,28,17,11
"2021","Wakefield 027E","E01011783",770,245,72,173,493,45,203,81,87,35,156,88,62,6,84,54,30,5,5,32,14,18
"2021","Wakefield 028A","E01011902",658,229,117,112,398,94,174,69,66,39,83,53,24,6,45,26,19,2,2,31,14,17
"2021","Wakefield 028B","E01011903",621,234,113,121,361,94,165,80,56,29,59,37,17,5,42,17,25,1,1,26,9,17
"2021","Wakefield 028C","E01011905",712,184,123,61,503,116,266,111,96,59,74,37,29,8,44,26,18,3,3,25,10,15
"2021","Wakefield 028D","E01011907",917,398,141,257,458,45,206,83,90,33,135,91,35,9,64,35,29,8,8,61,30,31
"2021","Wakefield 029A","E01011793",748,208,140,68,510,128,227,102,94,31,89,50,34,5,64,31,33,2,2,30,10,20
"2021","Wakefield 029B","E01011794",599,172,82,90,407,55,174,67,68,39,85,38,42,5,93,62,31,0,0,20,11,9
"2021","Wakefield 029C","E01011795",598,199,110,89,376,76,149,62,65,22,67,28,37,2,82,54,28,2,2,23,8,15
"2021","Wakefield 029D","E01011796",675,160,76,84,497,80,263,90,131,42,98,46,46,6,56,33,23,0,0,18,5,13
"2021","Wakefield 029E","E01011799",748,317,184,133,413,72,176,71,72,33,77,32,42,3,85,56,29,3,3,18,7,11
"2021","Wakefield 029F","E01011800",748,255,108,147,473,76,219,82,98,39,102,50,43,9,74,38,36,2,2,20,7,13
"2021","Wakefield 030A","E01011898",734,286,47,239,398,31,131,58,52,21,154,98,47,9,75,54,21,7,7,50,19,31
"2021","Wakefield 030B","E01011906",689,219,71,148,424,28,155,52,73,30,106,31,57,18,127,80,47,8,8,46,28,18
"2021","Wakefield 030C","E01011908",1019,303,97,206,617,51,290,89,153,48,159,95,54,10,97,61,36,20,20,99,50,49
"2021","Wakefield 030D","E01011917",794,338,58,280,378,22,151,46,85,20,93,52,38,3,89,50,39,23,23,78,35,43
"2021","Wakefield 030E","E01011944",593,177,51,126,366,32,152,49,73,30,108,57,43,8,64,43,21,10,10,50,22,28
"2021","Wakefield 031A","E01011797",768,176,102,74,580,105,337,114,163,60,78,33,41,4,59,40,19,1,1,12,5,7
"2021","Wakefield 031B","E01011798",681,275,106,169,392,53,168,72,63,33,93,61,28,4,77,50,27,1,1,14,6,8
"2021","Wakefield 031C","E01011801",642,186,83,103,431,55,187,74,70,43,105,49,47,9,83,52,31,1,1,25,13,12
"2021","Wakefield 031D","E01011802",649,194,96,98,450,98,212,98,70,44,75,39,34,2,63,34,29,2,2,5,1,4
"2021","Wakefield 032A","E01011765",818,208,91,117,576,85,274,89,132,53,108,48,52,8,103,70,33,6,6,34,17,17
"2021","Wakefield 032B","E01011766",671,159,70,89,489,65,260,94,114,52,81,46,29,6,83,47,36,0,0,23,11,12
"2021","Wakefield 032C","E01011773",611,130,92,38,464,118,258,115,85,58,51,22,21,8,36,17,19,1,1,17,8,9
"2021","Wakefield 032D","E01011774",644,184,106,78,436,74,209,74,96,39,90,46,37,7,63,35,28,0,0,24,13,11
"2021","Wakefield 033A","E01011939",635,143,97,46,482,135,246,95,113,38,58,31,21,6,40,22,18,3,3,10,5,5
"2021","Wakefield 033B","E01011945",664,208,123,85,441,117,241,105,97,39,49,23,26,0,31,18,13,3,3,15,6,9
"2021","Wakefield 033C","E01011947",680,179,129,50,481,168,255,98,110,47,33,21,9,3,25,10,15,0,0,20,11,9
"2021","Wakefield 033D","E01011948",695,170,108,62,508,137,287,116,114,57,55,26,25,4,28,14,14,1,1,17,9,8
"2021","Wakefield 034A","E01011767",764,176,104,72,553,129,302,124,119,59,83,40,41,2,39,21,18,0,0,35,19,16
"2021","Wakefield 034B","E01011768",596,174,103,71,397,77,216,88,84,44,68,35,30,3,33,18,15,3,3,25,6,19
"2021","Wakefield 034D","E01011770",817,245,129,116,542,89,261,122,97,42,102,45,47,10,90,55,35,0,0,30,17,13
"2021","Wakefield 034E","E01011849",726,205,120,85,482,155,235,114,77,44,58,39,14,5,32,20,12,2,2,39,16,23
"2021","Wakefield 034F","E01011857",729,177,123,54,538,134,298,140,106,52,69,35,31,3,35,14,21,2,2,14,10,4
"2021","Wakefield 034G","E01034269",662,176,76,100,466,63,234,88,108,38,112,69,35,8,57,40,17,0,0,20,13,7
"2021","Wakefield 034H","E01034270",715,180,32,148,508,27,254,79,154,21,151,101,48,2,73,59,14,3,3,27,14,13
"2021","Wakefield 035A","E01011928",642,218,121,97,405,86,175,72,66,37,75,39,31,5,68,41,27,1,1,19,8,11
"2021","Wakefield 035B","E01011931",624,183,112,71,429,77,217,102,74,41,85,38,39,8,48,31,17,2,2,12,4,8
"2021","Wakefield 035C","E01011932",612,157,76,81,425,90,215,102,76,37,71,46,18,7,49,29,20,0,0,30,14,16
"2021","Wakefield 035D","E01011938",596,144,78,66,434,72,250,99,97,54,66,40,23,3,46,29,17,0,0,18,7,11
"2021","Wakefield 036A","E01011929",968,294,149,145,644,126,299,131,121,47,150,89,54,7,69,45,24,0,0,30,12,18
"2021","Wakefield 036B","E01011930",730,203,82,121,507,89,269,107,108,54,97,54,35,8,49,27,22,3,3,20,6,14
"2021","Wakefield 036C","E01011933",686,177,81,96,480,89,224,105,82,37,94,40,47,7,71,43,28,2,2,29,11,18
"2021","Wakefield 036D","E01011937",614,183,101,82,417,89,220,104,76,40,62,35,23,4,45,25,20,1,1,14,7,7
"2021","Wakefield 037A","E01011934",701,180,96,84,488,82,261,110,100,51,88,52,30,6,56,21,35,1,1,33,20,13
"2021","Wakefield 037B","E01011936",670,188,96,92,464,58,202,74,95,33,92,32,52,8,108,78,30,4,4,18,7,11
"2021","Wakefield 037C","E01011940",680,168,72,96,485,46,194,65,92,37,119,49,60,10,120,79,41,6,6,27,19,8
"2021","Wakefield 037D","E01011943",949,311,126,185,607,37,251,93,110,48,140,74,61,5,169,129,40,10,10,31,14,17
"2021","Wakefield 038A","E01011935",821,170,66,104,624,100,339,124,177,38,117,65,50,2,67,44,23,1,1,27,12,15
"2021","Wakefield 038B","E01011941",700,215,152,63,474,120,234,99,93,42,63,35,24,4,57,37,20,0,0,11,5,6
"2021","Wakefield 038C","E01011942",582,147,81,66,416,132,202,101,72,29,51,30,19,2,31,19,12,0,0,19,11,8
"2021","Wakefield 038D","E01011946",629,158,93,65,442,119,220,101,82,37,63,41,18,4,39,21,18,1,1,29,8,21
"2021","Wakefield 039A","E01011785",919,213,68,145,666,48,287,117,125,45,201,82,106,13,127,85,42,3,3,40,17,23
"2021","Wakefield 039B","E01011789",561,145,62,83,390,40,158,57,61,40,98,40,50,8,91,61,30,3,3,26,14,12
"2021","Wakefield 039C","E01011791",634,189,100,89,420,43,191,82,60,49,89,40,40,9,94,59,35,3,3,25,11,14
"2021","Wakefield 039D","E01011792",619,207,93,114,376,40,118,45,49,24,95,32,57,6,115,71,44,8,8,36,20,16
"2021","Wakefield 040A","E01011771",605,227,114,113,365,56,157,54,72,31,84,35,31,18,67,50,17,1,1,13,6,7
"2021","Wakefield 040B","E01011772",725,210,80,130,485,69,238,121,87,30,105,51,50,4,73,45,28,0,0,30,14,16
"2021","Wakefield 040C","E01011784",772,237,110,127,505,107,215,97,69,49,98,40,44,14,83,58,25,2,2,30,20,10
"2021","Wakefield 040D","E01011786",632,157,72,85,433,33,202,69,74,59,97,47,47,3,96,67,29,5,5,42,17,25
"2021","Wakefield 041A","E01011854",664,181,57,124,458,30,182,70,78,34,140,69,64,7,106,86,20,0,0,25,16,9
"2021","Wakefield 041B","E01011855",643,171,89,82,452,68,233,92,88,53,90,53,30,7,58,35,23,3,3,20,6,14
"2021","Wakefield 041C","E01011856",602,163,63,100,411,64,179,78,69,32,93,44,39,10,73,49,24,2,2,28,11,17
"2021","Wakefield 041D","E01011858",729,170,78,92,515,56,274,107,114,53,116,63,46,7,69,50,19,0,0,44,19,25
"2021","Wakefield 042A","E01011787",764,253,105,148,489,107,203,95,69,39,93,39,47,7,81,48,33,5,5,22,10,12
"2021","Wakefield 042B","E01011788",748,200,108,92,527,127,256,123,82,51,83,48,30,5,55,29,26,6,6,21,8,13
"2021","Wakefield 042C","E01011790",774,297,112,185,446,68,185,87,61,37,95,52,36,7,96,66,30,2,2,31,11,20
"2021","Wakefield 042D","E01011865",736,256,156,100,449,65,187,77,73,37,85,27,48,10,108,52,56,4,4,31,19,12
"2021","Wakefield 042E","E01011867",684,207,91,116,447,55,190,64,77,49,94,37,50,7,106,60,46,2,2,30,13,17
"2021","Wakefield 043A","E01011859",674,274,170,104,377,68,163,80,53,30,57,20,33,4,80,56,24,9,9,23,8,15
"2021","Wakefield 043B","E01011869",658,262,69,193,357,20,103,45,36,22,99,53,38,8,124,80,44,11,11,39,15,24
"2021","Wakefield 043C","E01011870",635,215,117,98,403,109,186,79,57,50,67,30,30,7,41,22,19,0,0,17,10,7
"2021","Wakefield 043D","E01011871",666,211,68,143,423,63,197,85,68,44,76,34,37,5,80,48,32,7,7,32,11,21
"2021","Wakefield 044A","E01011860",645,174,89,85,432,80,219,95,70,54,77,33,35,9,53,22,31,3,3,39,17,22
"2021","Wakefield 044B","E01011861",823,228,102,126,567,69,284,96,110,78,98,41,48,9,109,69,40,7,7,28,16,12
"2021","Wakefield 044C","E01011862",933,255,102,153,629,43,287,117,122,48,178,76,94,8,115,85,30,6,6,49,22,27
"2021","Wakefield 044D","E01011863",648,197,81,116,409,28,167,62,66,39,82,24,51,7,123,88,35,9,9,42,25,17
"2021","Wakefield 045A","E01011864",668,181,87,94,454,40,193,69,77,47,100,29,65,6,120,80,40,1,1,33,16,17
"2021","Wakefield 045B","E01011866",700,211,107,104,452,58,209,77,94,38,97,35,55,7,82,60,22,6,6,37,16,21
"2021","Wakefield 045C","E01011868",867,239,89,150,584,62,274,98,121,55,139,56,76,7,105,69,36,4,4,44,20,24
"2021","Wakefield 045D","E01011872",632,167,77,90,433,46,197,76,82,39,83,23,54,6,105,69,36,2,2,32,16,16
"2021","Derby 001A","E01013461",736,189,124,65,532,153,281,90,141,50,56,37,18,1,40,22,18,2,2,15,8,7
"2021","Derby 001B","E01013462",623,148,83,65,449,62,254,75,129,50,72,39,29,4,59,36,23,2,2,26,11,15
"2021","Derby 001C","E01013463",613,134,74,60,470,114,253,66,136,51,50,25,21,4,51,29,22,2,2,9,2,7
"2021","Derby 001D","E01013464",627,190,139,51,428,114,216,71,100,45,49,25,22,2,47,19,28,2,2,9,5,4
"2021","Derby 002A","E01013465",691,192,129,63,484,128,250,70,132,48,54,21,28,5,47,24,23,5,5,15,9,6
"2021","Derby 002B","E01013466",641,163,107,56,461,111,263,89,107,67,50,31,17,2,35,19,16,2,2,17,7,10
"2021","Derby 002C","E01013467",593,164,106,58,412,102,214,60,109,45,58,30,24,4,38,21,17,0,0,17,6,11
"2021","Derby 002D","E01013468",689,205,149,56,469,116,266,91,117,58,51,22,26,3,36,14,22,0,0,15,4,11
"2021","Derby 002E","E01013469",707,335,211,124,351,143,133,61,51,21,47,32,15,0,26,7,19,2,2,21,5,16
"2021","Derby 003A","E01013574",764,144,69,75,579,85,301,125,123,53,119,73,44,2,73,50,23,1,1,41,17,24
"2021","Derby 003B","E01013575",647,180,63,117,435,49,224,95,95,34,106,75,25,6,53,31,22,3,3,32,14,18
"2021","Derby 003C","E01013576",563,118,40,78,429,67,230,96,80,54,86,52,29,5,41,20,21,5,5,16,5,11
"2021","Derby 003D","E01013577",603,141,46,95,433,48,290,106,124,60,68,40,26,2,21,11,10,6,6,29,13,16
"2021","Derby 003E","E01013578",560,132,41,91,403,42,225,96,96,33,91,55,32,4,43,29,14,2,2,25,11,14
"2021","Derby 003F","E01013579",630,204,79,125,401,64,187,68,69,50,103,66,34,3,44,26,18,3,3,25,9,16
"2021","Derby 003G","E01013580",716,267,81,186,429,59,181,88,74,19,134,101,31,2,51,29,22,4,4,20,3,17
"2021","Derby 004A","E01013530",732,185,70,115,512,34,218,78,103,37,154,95,52,7,101,67,34,5,5,35,8,27
"2021","Derby 004B","E01013531",610,167,82,85,415,49,164,61,72,31,90,44,39,7,108,72,36,4,4,28,11,17
"2021","Derby 004C","E01013532",612,182,74,108,394,40,163,56,69,38,102,44,46,12,86,54,32,3,3,36,10,26
"2021","Derby 004D","E01013581",613,167,65,102,417,30,158,47,77,34,111,48,53,10,111,82,29,7,7,29,19,10
"2021","Derby 005A","E01013526",744,256,111,145,466,112,231,67,129,35,68,49,16,3,49,24,25,6,6,22,7,15
"2021","Derby 005B","E01013527",659,175,91,84,467,100,269,98,138,33,56,24,28,4,40,21,19,2,2,17,8,9
"2021","Derby 005C","E01013528",734,312,136,176,386,59,209,63,113,33,73,48,21,4,43,30,13,2,2,36,11,25
"2021","Derby 005D","E01013529",1037,432,201,231,510,61,227,74,127,26,131,83,43,5,84,64,20,7,7,95,15,80
"2021","Derby 006A","E01013505",615,154,60,94,439,61,231,84,101,46,91,42,42,7,52,23,29,4,4,22,4,18
"2021","Derby 006B","E01013506",688,237,147,90,422,128,181,66,68,47,52,25,19,8,57,33,24,4,4,29,8,21
"2021","Derby 006C","E01013513",515,115,66,49,368,47,147,46,68,33,81,32,40,9,90,42,48,3,3,32,18,14
"2021","Derby 006D","E01013534",671,183,83,100,464,57,192,61,82,49,120,53,52,15,92,56,36,3,3,24,10,14
"2021","Derby 006E","E01013582",687,236,125,111,430,58,165,61,67,37,112,60,41,11,93,58,35,2,2,21,7,14
"2021","Derby 007A","E01013533",693,245,96,149,420,36,136,41,66,29,100,35,59,6,144,110,34,4,4,28,13,15
"2021","Derby 007B","E01013535",537,88,20,68,402,13,145,35,86,24,100,22,68,10,139,109,30,5,5,47,26,21
"2021","Derby 007C","E01013536",681,262,60,202,378,20,126,52,56,18,83,36,39,8,135,106,29,14,14,41,23,18
"2021","Derby 007D","E01013537",741,241,111,130,464,69,200,96,74,30,107,62,38,7,84,50,34,4,4,36,19,17
"2021","Derby 007E","E01013538",628,208,78,130,369,31,148,66,53,29,87,52,25,10,92,51,41,11,11,51,15,36
"2021","Derby 008A","E01013522",933,476,132,344,316,31,100,40,42,18,87,74,11,2,92,62,30,6,6,141,14,127
"2021","Derby 008B","E01013523",1040,561,146,415,412,63,125,66,42,17,128,104,21,3,76,47,29,20,20,67,7,60
"2021","Derby 008C","E01013524",621,322,54,268,225,11,62,27,23,12,95,74,18,3,44,24,20,13,13,74,10,64
"2021","Derby 008D","E01013525",1018,445,101,344,520,32,173,71,86,16,216,169,44,3,94,68,26,5,5,53,8,45
"2021","Derby 009A","E01013548",740,243,140,103,452,69,201,82,79,40,85,37,44,4,96,68,28,1,1,45,14,31
"2021","Derby 009B","E01013549",646,190,95,95,430,47,187,67,83,37,85,43,36,6,107,80,27,4,4,26,9,17
"2021","Derby 009C","E01013552",733,231,121,110,469,50,163,53,70,40,92,28,56,8,131,90,41,33,33,33,15,18
"2021","Derby 009D","E01013553",632,165,83,82,426,51,188,71,73,44,75,30,39,6,104,72,32,8,8,41,22,19
"2021","Derby 009E","E01013555",1006,213,75,138,725,46,353,110,191,52,171,83,82,6,144,100,44,11,11,68,29,39
"2021","Derby 010A","E01013592",654,219,119,100,417,91,198,63,85,50,73,46,19,8,54,34,20,1,1,18,7,11
"2021","Derby 010B","E01013594",615,221,157,64,381,104,191,73,78,40,54,29,20,5,31,19,12,1,1,13,4,9
"2021","Derby 010C","E01013596",699,222,138,84,449,118,198,81,85,32,77,41,32,4,55,28,27,1,1,28,15,13
"2021","Derby 010D","E01013599",644,191,130,61,439,115,212,84,96,32,68,37,28,3,41,23,18,3,3,14,7,7
"2021","Derby 011A","E01013547",845,328,61,267,325,22,93,38,41,14,121,91,27,3,74,46,28,15,15,192,11,181
"2021","Derby 011B","E01013550",525,153,54,99,327,27,127,42,54,31,73,39,28,6,97,61,36,3,3,45,13,32
"2021","Derby 011C","E01013551",659,221,38,183,287,13,74,32,31,11,119,75,37,7,68,46,22,13,13,151,10,141
"2021","Derby 011D","E01013554",799,350,72,278,331,11,96,44,41,11,120,83,32,5,83,52,31,21,21,118,10,108
"2021","Derby 012A","E01013507",647,174,98,76,436,79,206,84,85,37,87,50,31,6,58,30,28,6,6,37,13,24
"2021","Derby 012B","E01013508",490,118,57,61,343,27,141,37,69,35,78,28,42,8,91,61,30,6,6,29,14,15
"2021","Derby 012C","E01013509",703,200,90,110,465,72,213,83,85,45,94,58,31,5,82,52,30,4,4,38,15,23
"2021","Derby 012D","E01013510",618,161,74,87,426,33,173,48,87,38,95,27,55,13,121,72,49,4,4,31,14,17
"2021","Derby 012E","E01013511",649,164,106,58,463,109,231,78,95,58,74,33,37,4,46,22,24,3,3,22,9,13
"2021","Derby 012F","E01013512",624,188,61,127,405,66,140,58,57,25,87,32,43,12,110,77,33,2,2,31,11,20
"2021","Derby 013A","E01013453",1131,548,91,457,435,15,134,56,62,16,143,93,42,8,121,83,38,22,22,148,30,118
"2021","Derby 013B","E01013454",548,188,46,142,301,19,119,39,62,18,67,31,31,5,93,62,31,3,3,59,26,33
"2021","Derby 013C","E01013456",931,444,87,357,383,10,134,50,69,15,110,68,37,5,115,76,39,14,14,104,11,93
"2021","Derby 013D","E01013457",824,283,72,211,460,25,147,58,66,23,154,100,50,4,117,80,37,17,17,81,20,61
"2021","Derby 013E","E01013460",875,354,33,321,384,13,119,40,66,13,149,118,30,1,73,56,17,30,30,137,12,125
"2021","Derby 013G","E01034256",711,464,40,424,196,0,75,39,33,3,80,76,4,0,27,18,9,14,14,51,4,47
"2021","Derby 013H","E01034257",832,468,19,449,273,5,97,57,33,7,115,84,26,5,42,25,17,14,14,91,20,71
"2021","Derby 014A","E01013593",612,141,98,43,448,107,178,74,68,36,90,45,33,12,73,45,28,0,0,23,11,12
"2021","Derby 014B","E01013595",1048,352,124,228,648,72,291,99,143,49,153,86,57,10,129,84,45,3,3,48,15,33
"2021","Derby 014C","E01013597",725,262,136,126,433,67,168,58,64,46,93,38,47,8,101,56,45,4,4,30,11,19
"2021","Derby 014D","E01013598",632,183,87,96,415,47,177,59,79,39,97,42,49,6,90,50,40,4,4,34,21,13
"2021","Derby 015A","E01013556",612,167,102,65,432,106,198,74,91,33,70,40,27,3,57,31,26,1,1,13,6,7
"2021","Derby 015B","E01013557",607,190,144,46,388,107,209,86,80,43,48,26,19,3,23,4,19,1,1,29,12,17
"2021","Derby 015C","E01013558",1053,270,115,155,737,104,403,138,210,55,109,53,53,3,117,76,41,4,4,46,20,26
"2021","Derby 015D","E01013559",576,147,74,73,414,90,192,67,82,43,74,34,38,2,56,36,20,2,2,15,6,9
"2021","Derby 015E","E01013564",1068,237,113,124,795,145,388,157,157,74,164,101,60,3,93,67,26,5,5,36,14,22
"2021","Derby 016A","E01013480",1077,610,94,516,360,14,134,55,65,14,100,75,24,1,89,55,34,23,23,107,42,65
"2021","Derby 016B","E01013483",639,208,47,161,323,13,196,38,128,30,45,25,17,3,57,32,25,12,12,108,65,43
"2021","Derby 016C","E01013485",639,141,32,109,359,7,225,38,138,49,41,18,22,1,76,55,21,10,10,139,96,43
"2021","Derby 016D","E01013565",539,111,28,83,326,11,208,29,154,25,25,10,13,2,73,36,37,9,9,102,81,21
"2021","Derby 016E","E01013566",734,179,53,126,425,5,259,88,136,35,44,10,33,1,97,68,29,20,20,130,63,67
"2021","Derby 017A","E01013455",820,278,92,186,481,46,219,79,88,52,95,60,28,7,114,64,50,7,7,61,24,37
"2021","Derby 017B","E01013458",571,156,75,81,320,50,171,56,68,47,30,17,13,0,62,32,30,7,7,95,61,34
"2021","Derby 017C","E01013542",960,286,102,184,586,76,305,115,159,31,99,72,21,6,98,65,33,8,8,88,25,63
"2021","Derby 017D","E01013546",658,167,94,73,444,94,255,100,118,37,41,20,15,6,49,28,21,5,5,47,25,22
"2021","Derby 018A","E01013481",569,129,35,94,330,14,203,38,123,42,28,9,19,0,77,52,25,8,8,110,71,39
"2021","Derby 018C","E01013484",722,219,66,153,409,12,229,37,166,26,38,11,23,4,78,47,31,52,52,94,61,33
"2021","Derby 018D","E01013486",602,138,33,105,348,7,187,21,135,31,47,17,26,4,100,58,42,7,7,116,77,39
"2021","Derby 018E","E01013487",814,173,40,133,524,10,279,66,192,21,89,22,58,9,133,95,38,13,13,117,66,51
"2021","Derby 018F","E01033166",673,339,57,282,299,9,100,47,47,6,113,86,26,1,71,46,25,6,6,35,8,27
"2021","Derby 018G","E01033167",564,280,69,211,218,9,74,25,39,10,64,46,17,1,64,39,25,7,7,66,37,29
"2021","Derby 019A","E01013540",657,186,106,80,436,81,263,73,136,54,51,21,24,6,39,18,21,2,2,35,24,11
"2021","Derby 019B","E01013560",577,131,84,47,428,101,254,98,93,63,37,16,18,3,36,16,20,0,0,18,6,12
"2021","Derby 019C","E01013561",667,181,120,61,466,128,227,100,81,46,65,35,26,4,45,23,22,1,1,20,10,10
"2021","Derby 019D","E01013562",703,338,208,130,348,85,164,73,60,31,45,29,14,2,52,28,24,2,2,17,6,11
"2021","Derby 019E","E01013563",615,195,93,102,400,79,217,94,84,39,53,32,15,6,47,27,20,4,4,20,6,14
"2021","Derby 020A","E01013459",588,103,45,58,403,30,241,37,149,55,42,11,27,4,79,44,35,11,11,82,62,20
"2021","Derby 020B","E01013567",636,142,22,120,355,10,215,32,151,32,41,10,27,4,78,50,28,11,11,139,107,32
"2021","Derby 020C","E01013568",735,185,41,144,409,12,225,43,152,30,42,14,25,3,121,74,47,9,9,141,102,39
"2021","Derby 020D","E01013569",542,123,41,82,334,17,198,25,141,32,37,11,22,4,76,47,29,6,6,85,61,24
"2021","Derby 021A","E01013539",716,69,26,43,560,45,435,91,231,113,34,15,16,3,44,25,19,2,2,87,59,28
"2021","Derby 021B","E01013541",658,165,38,127,458,25,222,48,134,40,61,27,30,4,142,104,38,8,8,35,21,14
"2021","Derby 021C","E01013543",623,115,61,54,471,83,294,78,168,48,45,20,21,4,46,29,17,3,3,37,21,16
"2021","Derby 021D","E01013544",677,127,59,68,497,106,312,66,169,77,33,20,10,3,43,24,19,3,3,53,37,16
"2021","Derby 021E","E01013545",706,242,109,133,425,62,230,63,121,46,41,21,19,1,88,59,29,4,4,39,23,16
"2021","Derby 022A","E01013488",577,143,88,55,382,85,206,63,90,53,47,20,23,4,40,17,23,4,4,52,26,26
"2021","Derby 022B","E01013489",627,165,112,53,423,93,222,75,88,59,52,28,17,7,54,26,28,2,2,39,26,13
"2021","Derby 022C","E01013490",589,132,81,51,411,82,223,64,88,71,45,24,19,2,59,35,24,2,2,46,23,23
"2021","Derby 022D","E01013491",580,138,77,61,382,55,232,49,135,48,42,19,23,0,53,29,24,0,0,60,33,27
"2021","Derby 023A","E01013570",686,166,50,116,404,8,231,32,161,38,43,10,31,2,112,66,46,10,10,116,89,27
"2021","Derby 023B","E01013571",670,158,55,103,426,26,216,41,139,36,63,22,35,6,105,67,38,16,16,86,39,47
"2021","Derby 023C","E01013572",682,226,114,112,395,56,218,60,115,43,38,18,19,1,76,35,41,7,7,61,44,17
"2021","Derby 023D","E01013573",869,316,110,206,501,30,210,48,128,34,72,28,37,7,179,122,57,10,10,52,29,23
"2021","Derby 024A","E01013470",595,195,91,104,377,62,160,61,63,36,85,40,39,6,66,44,22,4,4,23,13,10
"2021","Derby 024B","E01013474",731,306,127,179,396,49,173,78,63,32,87,43,36,8,80,53,27,7,7,29,7,22
"2021","Derby 024C","E01013476",725,301,110,191,396,63,187,110,45,32,100,71,27,2,43,20,23,3,3,28,10,18
"2021","Derby 024E","E01033171",786,289,78,211,451,42,173,87,69,17,127,88,36,3,101,78,23,8,8,46,16,30
"2021","Derby 024F","E01033172",707,300,41,259,365,11,136,59,68,9,105,67,36,2,101,78,23,12,12,42,11,31
"2021","Derby 025A","E01013471",848,325,115,210,461,25,178,59,92,27,133,70,59,4,113,77,36,12,12,62,19,43
"2021","Derby 025B","E01013473",702,260,97,163,397,36,144,42,76,26,102,55,40,7,102,64,38,13,13,45,14,31
"2021","Derby 025C","E01013475",583,116,44,72,410,8,186,52,105,29,77,19,48,10,133,94,39,6,6,57,34,23
"2021","Derby 025D","E01013477",772,245,91,154,481,60,194,87,71,36,105,53,48,4,113,78,35,9,9,46,10,36
"2021","Derby 025E","E01013502",613,204,96,108,381,40,188,53,101,34,87,35,46,6,64,35,29,2,2,28,15,13
"2021","Derby 025F","E01013503",618,149,64,85,433,43,219,77,92,50,101,42,55,4,68,38,30,2,2,36,15,21
"2021","Derby 026A","E01013472",988,378,137,241,548,30,181,62,90,29,90,37,43,10,180,122,58,67,67,62,35,27
"2021","Derby 026B","E01013497",644,149,60,89,438,37,181,51,88,42,114,28,79,7,105,72,33,1,1,57,37,20
"2021","Derby 026C","E01013504",711,174,61,113,498,34,214,63,116,35,93,35,52,6,139,98,41,18,18,39,21,18
"2021","Derby 026D","E01013583",577,123,35,88,398,18,177,48,102,27,79,22,51,6,116,79,37,8,8,56,39,17
"2021","Derby 026E","E01013590",777,158,41,117,530,11,209,46,123,40,127,53,62,12,168,111,57,15,15,89,55,34
"2021","Derby 026F","E01013591",840,231,44,187,546,23,163,45,84,34,152,50,91,11,192,140,52,16,16,63,32,31
"2021","Derby 027A","E01013492",588,139,80,59,396,75,228,57,112,59,35,20,12,3,56,26,30,2,2,53,29,24
"2021","Derby 027B","E01013493",634,212,112,100,369,57,177,56,79,42,49,26,19,4,82,38,44,4,4,53,34,19
"2021","Derby 027C","E01013494",798,255,139,116,503,48,196,60,102,34,109,53,48,8,143,96,47,7,7,40,23,17
"2021","Derby 027D","E01013495",703,193,85,108,453,52,223,70,104,49,81,39,38,4,93,61,32,4,4,57,32,25
"2021","Derby 028A","E01013496",665,232,85,147,403,63,119,47,47,25,82,32,42,8,135,99,36,4,4,30,14,16
"2021","Derby 028B","E01013498",612,166,103,63,416,76,170,58,69,43,88,38,42,8,79,42,37,3,3,30,15,15
"2021","Derby 028C","E01013499",646,210,104,106,387,46,179,63,78,38,65,26,33,6,92,55,37,5,5,49,23,26
"2021","Derby 028D","E01013500",715,189,117,72,500,105,218,70,91,57,87,39,43,5,86,46,40,4,4,26,8,18
"2021","Derby 028E","E01013501",639,211,127,84,402,80,186,63,79,44,86,37,43,6,48,24,24,2,2,26,10,16
"2021","Derby 029A","E01013584",632,130,47,83,444,12,187,28,130,29,73,21,42,10,166,98,68,6,6,58,36,22
"2021","Derby 029B","E01013585",728,181,55,126,488,20,226,63,127,36,76,31,39,6,160,70,90,6,6,59,35,24
"2021","Derby 029C","E01013586",693,194,40,154,459,29,133,35,75,23,112,26,82,4,182,114,68,3,3,40,27,13
"2021","Derby 029D","E01013587",591,139,70,69,398,66,232,44,141,47,54,14,35,5,46,24,22,0,0,54,35,19
"2021","Derby 029E","E01013588",652,229,102,127,369,60,153,55,70,28,55,20,27,8,97,54,43,4,4,54,39,15
"2021","Derby 029F","E01013589",684,174,74,100,459,86,234,79,95,60,88,54,27,7,49,22,27,2,2,51,27,24
"2021","Derby 030B","E01013517",659,225,125,100,390,110,147,59,55,33,71,37,31,3,59,32,27,3,3,44,6,38
"2021","Derby 030C","E01013518",669,198,108,90,443,82,216,92,75,49,89,58,23,8,52,31,21,4,4,28,9,19
"2021","Derby 030D","E01013521",704,354,176,178,324,43,128,48,49,31,63,31,30,2,71,52,19,19,19,26,14,12
"2021","Derby 030E","E01033168",486,90,39,51,375,45,212,54,129,29,61,27,29,5,55,27,28,2,2,21,11,10
"2021","Derby 030F","E01033169",565,89,14,75,435,16,321,50,233,38,52,24,25,3,46,33,13,0,0,41,28,13
"2021","Derby 030G","E01033170",577,213,106,107,345,48,173,44,110,19,68,42,23,3,54,42,12,2,2,19,11,8
"2021","Derby 031A","E01013514",680,230,102,128,433,72,230,87,102,41,72,38,27,7,56,31,25,3,3,17,11,6
"2021","Derby 031B","E01013515",805,219,106,113,548,52,290,82,154,54,100,40,49,11,105,69,36,1,1,38,23,15
"2021","Derby 031C","E01013519",603,116,30,86,466,19,233,72,120,41,97,37,52,8,115,78,37,2,2,21,9,12
"2021","Derby 031D","E01013520",822,196,84,112,613,101,342,122,159,61,94,53,37,4,76,50,26,0,0,13,6,7
"2021","Leicester 001A","E01013615",636,111,34,77,477,33,289,88,139,62,83,40,37,6,69,36,33,3,3,48,31,17
"2021","Leicester 001B","E01013616",665,210,52,158,413,42,181,56,87,38,84,38,42,4,102,71,31,4,4,42,22,20
"2021","Leicester 001C","E01013618",690,236,72,164,403,37,199,71,88,40,82,40,35,7,81,51,30,4,4,51,35,16
"2021","Leicester 001D","E01013619",646,182,53,129,405,36,158,28,104,26,55,14,37,4,147,104,43,9,9,59,38,21
"2021","Leicester 002A","E01013733",716,166,43,123,491,34,300,59,196,45,69,39,26,4,82,51,31,6,6,59,38,21
"2021","Leicester 002B","E01013734",518,101,65,36,348,61,228,71,84,73,17,5,9,3,38,11,27,4,4,69,38,31
"2021","Leicester 002C","E01013735",461,102,59,43,305,82,171,41,53,77,8,1,5,2,37,12,25,7,7,54,33,21
"2021","Leicester 002D","E01013736",893,297,124,173,519,65,277,85,150,42,83,41,36,6,92,48,44,2,2,77,45,32
"2021","Leicester 002E","E01013737",457,75,30,45,300,44,202,45,81,76,15,4,6,5,34,9,25,5,5,82,45,37
"2021","Leicester 003A","E01013600",754,201,77,124,484,12,195,35,125,35,94,38,38,18,176,111,65,7,7,69,48,21
"2021","Leicester 003B","E01013601",642,167,79,88,397,21,196,38,116,42,51,7,35,9,122,70,52,7,7,78,53,25
"2021","Leicester 003C","E01013602",791,281,79,202,451,19,199,39,114,46,92,38,40,14,132,98,34,9,9,59,33,26
"2021","Leicester 003D","E01013603",751,304,79,225,400,18,170,45,107,18,56,18,28,10,145,105,40,11,11,47,29,18
"2021","Leicester 003E","E01013604",615,133,46,87,417,21,195,26,138,31,72,25,36,11,122,87,35,7,7,65,40,25
"2021","Leicester 003F","E01013605",800,235,69,166,462,39,227,63,113,51,87,49,29,9,102,57,45,7,7,103,60,43
"2021","Leicester 004A","E01013617",977,227,37,190,639,42,346,82,182,82,92,36,46,10,145,75,70,14,14,111,49,62
"2021","Leicester 004B","E01013620",659,191,54,137,408,21,153,33,94,26,65,16,42,7,159,127,32,10,10,60,43,17
"2021","Leicester 004C","E01013621",838,207,51,156,556,12,236,47,149,40,108,37,66,5,193,138,55,7,7,75,49,26
"2021","Leicester 004D","E01013622",669,235,49,186,388,28,149,33,89,27,85,20,63,2,116,86,30,10,10,46,31,15
"2021","Leicester 004E","E01013623",792,150,59,91,563,64,323,81,180,62,66,34,27,5,104,55,49,6,6,79,50,29
"2021","Leicester 005A","E01013732",792,147,64,83,523,36,340,80,189,71,46,14,24,8,87,49,38,14,14,122,82,40
"2021","Leicester 005B","E01013739",573,176,75,101,338,58,188,47,76,65,9,6,1,2,75,35,40,8,8,59,33,26
"2021","Leicester 005C","E01013740",498,90,58,32,331,42,212,49,94,69,13,4,6,3,55,20,35,9,9,77,42,35
"2021","Leicester 005D","E01013741",533,69,39,30,383,43,254,34,135,85,18,7,9,2,64,27,37,4,4,81,54,27
"2021","Leicester 006A","E01013625",682,196,75,121,360,34,226,36,131,59,20,9,11,0,70,28,42,10,10,126,89,37
"2021","Leicester 006B","E01013628",681,209,89,120,423,35,244,82,118,44,42,21,18,3,91,49,42,11,11,49,30,19
"2021","Leicester 006C","E01013715",449,84,60,24,269,44,164,36,69,59,8,1,3,4,52,12,40,1,1,96,65,31
"2021","Leicester 006E","E01013738",472,84,61,23,313,60,195,48,77,70,5,2,1,2,48,13,35,5,5,75,41,34
"2021","Leicester 006F","E01034008",484,74,44,30,280,25,187,19,109,59,21,12,4,5,44,21,23,3,3,130,103,27
"2021","Leicester 006G","E01034009",546,165,79,86,283,26,183,41,95,47,19,14,5,0,50,20,30,5,5,98,74,24
"2021","Leicester 007A","E01013624",553,121,85,36,343,24,193,33,109,51,45,4,33,8,75,34,41,6,6,89,58,31
"2021","Leicester 007B","E01013626",591,89,48,41,371,29,228,26,119,83,12,3,6,3,96,44,52,6,6,131,90,41
"2021","Leicester 007C","E01013627",401,53,30,23,258,35,183,44,56,83,5,1,3,1,30,10,20,5,5,90,60,30
"2021","Leicester 007D","E01013629",546,94,46,48,344,22,233,46,107,80,15,2,10,3,66,31,35,8,8,108,73,35
"2021","Leicester 007E","E01013630",581,84,38,46,381,30,263,30,158,75,13,5,6,2,62,23,39,13,13,116,77,39
"2021","Leicester 008A","E01013606",670,142,96,46,440,63,273,57,149,67,38,18,16,4,64,35,29,2,2,88,48,40
"2021","Leicester 008C","E01013680",818,200,68,132,524,54,275,86,140,49,90,39,45,6,92,55,37,13,13,94,36,58
"2021","Leicester 008D","E01013685",615,155,74,81,419,71,223,70,107,46,58,29,24,5,64,36,28,3,3,41,20,21
"2021","Leicester 008E","E01013686",704,177,112,65,457,75,231,56,126,49,61,29,27,5,80,31,49,10,10,70,32,38
"2021","Leicester 008F","E01034010",608,133,65,68,391,39,236,46,116,74,32,14,13,5,76,34,42,8,8,84,47,37
"2021","Leicester 008G","E01034011",664,237,19,218,341,5,161,51,99,11,93,82,10,1,64,46,18,18,18,86,32,54
"2021","Leicester 008H","E01034012",611,320,6,314,229,16,76,20,53,3,93,85,8,0,27,22,5,17,17,62,14,48
"2021","Leicester 010A","E01013713",521,98,56,42,295,24,201,30,98,73,10,5,4,1,57,12,45,3,3,128,93,35
"2021","Leicester 010B","E01013714",507,71,47,24,295,32,211,32,98,81,10,1,7,2,34,6,28,8,8,141,90,51
"2021","Leicester 010C","E01013717",503,92,39,53,317,28,192,37,96,59,26,6,17,3,68,33,35,3,3,94,64,30
"2021","Leicester 010D","E01013718",562,110,65,45,315,22,209,32,99,78,14,6,5,3,68,21,47,2,2,137,100,37
"2021","Leicester 010E","E01013719",541,67,40,27,337,40,233,29,120,84,8,1,6,1,52,20,32,4,4,137,98,39
"2021","Leicester 010F","E01013720",651,227,150,77,319,40,165,36,82,47,17,10,6,1,93,22,71,4,4,105,82,23
"2021","Leicester 011A","E01013651",672,165,63,102,421,20,272,38,195,39,26,8,18,0,94,55,39,9,9,86,57,29
"2021","Leicester 011B","E01013652",604,97,44,53,423,14,243,38,162,43,47,16,22,9,113,71,42,6,6,84,58,26
"2021","Leicester 011C","E01013653",877,179,71,108,560,24,308,49,201,58,61,19,33,9,153,95,58,14,14,138,89,49
"2021","Leicester 011D","E01013655",743,173,47,126,400,17,271,39,182,50,28,7,18,3,80,45,35,4,4,170,113,57
"2021","Leicester 012A","E01013721",661,220,108,112,389,56,184,47,97,40,66,28,28,10,78,45,33,5,5,52,24,28
"2021","Leicester 012B","E01013723",460,75,34,41,332,18,136,28,85,23,73,24,39,10,103,70,33,2,2,53,35,18
"2021","Leicester 012C","E01013725",573,161,57,104,366,14,166,25,115,26,70,31,36,3,111,78,33,5,5,46,22,24
"2021","Leicester 012D","E01013726",846,351,111,240,458,27,128,26,86,16,83,27,55,1,209,163,46,11,11,37,20,17
"2021","Leicester 012E","E01013728",549,79,41,38,408,24,163,29,101,33,71,17,46,8,146,91,55,4,4,62,36,26
"2021","Leicester 013A","E01013694",819,201,65,136,557,34,280,58,175,47,86,28,50,8,148,108,40,9,9,61,39,22
"2021","Leicester 013B","E01013700",600,180,96,84,370,37,218,58,104,56,50,17,27,6,61,29,32,4,4,50,30,20
"2021","Leicester 013C","E01013770",539,146,83,63,350,49,215,51,108,56,28,15,10,3,54,29,25,4,4,43,29,14
"2021","Leicester 013D","E01013771",514,97,55,42,345,32,236,45,123,68,21,5,12,4,53,19,34,3,3,72,50,22
"2021","Leicester 013E","E01013773",557,170,82,88,348,45,191,48,99,44,49,16,26,7,59,35,24,4,4,39,28,11
"2021","Leicester 016A","E01013681",830,258,41,217,480,13,189,43,126,20,120,54,57,9,141,106,35,17,17,92,38,54
"2021","Leicester 016B","E01013682",767,218,45,173,476,12,194,63,108,23,133,66,64,3,128,98,30,9,9,73,33,40
"2021","Leicester 016C","E01013683",971,282,46,236,550,9,220,56,143,21,138,78,54,6,153,111,42,30,30,139,55,84
"2021","Leicester 016D","E01013684",922,343,63,280,431,13,183,50,119,14,108,69,38,1,107,77,30,20,20,148,48,100
"2021","Leicester 017A","E01013654",819,214,100,114,463,34,312,51,203,58,18,10,8,0,87,47,40,12,12,142,98,44
"2021","Leicester 017B","E01013656",520,64,31,33,301,11,225,29,136,60,15,4,10,1,44,18,26,6,6,155,113,42
"2021","Leicester 017C","E01013657",526,91,54,37,315,14,233,31,139,63,16,6,7,3,47,16,31,5,5,120,92,28
"2021","Leicester 017D","E01013658",636,65,22,43,364,18,268,35,188,45,20,5,11,4,52,23,29,6,6,207,158,49
"2021","Leicester 017E","E01013659",609,96,46,50,385,18,286,51,174,61,16,7,8,1,55,33,22,10,10,128,93,35
"2021","Leicester 017F","E01013743",489,60,23,37,269,10,205,28,110,67,8,3,5,0,42,16,26,4,4,160,130,30
"2021","Leicester 017G","E01013745",426,48,28,20,270,17,197,28,117,52,9,0,7,2,41,16,25,6,6,108,67,41
"2021","Leicester 018A","E01013742",456,58,23,35,278,19,207,22,118,67,6,4,0,2,42,16,26,4,4,120,77,43
"2021","Leicester 018B","E01013744",459,43,17,26,298,17,233,43,113,77,5,0,5,0,39,9,30,4,4,118,88,30
"2021","Leicester 018C","E01013746",664,219,76,143,374,18,256,50,161,45,19,9,9,1,74,37,37,7,7,71,53,18
"2021","Leicester 018D","E01013748",575,156,61,95,340,21,217,38,138,41,14,6,8,0,83,38,45,5,5,79,47,32
"2021","Leicester 018E","E01013754",729,182,64,118,466,16,288,31,225,32,30,14,16,0,128,86,42,4,4,81,53,28
"2021","Leicester 018F","E01013755",727,151,54,97,495,12,319,37,244,38,24,9,12,3,132,94,38,8,8,81,59,22
"2021","Leicester 019A","E01013660",639,146,51,95,394,18,263,34,177,52,28,7,16,5,81,43,38,4,4,99,69,30
"2021","Leicester 019B","E01013661",618,139,35,104,411,21,214,29,138,47,24,9,10,5,143,93,50,9,9,68,46,22
"2021","Leicester 019C","E01013664",737,267,97,170,407,18,231,44,142,45,34,14,17,3,120,68,52,4,4,63,39,24
"2021","Leicester 019D","E01013665",716,161,70,91,455,39,307,56,175,76,27,14,13,0,77,50,27,5,5,100,69,31
"2021","Leicester 019E","E01013667",664,272,100,172,353,44,193,39,111,43,27,13,12,2,83,33,50,6,6,39,23,16
"2021","Leicester 019F","E01013668",498,180,99,81,276,30,179,29,115,35,20,10,9,1,44,20,24,3,3,42,26,16
"2021","Leicester 020A","E01013729",533,149,77,72,342,42,163,58,73,32,89,45,32,12,45,29,16,3,3,42,21,21
"2021","Leicester 020B","E01013780",634,160,61,99,441,68,252,83,121,48,69,39,27,3,48,26,22,4,4,33,16,17
"2021","Leicester 020C","E01013783",608,143,61,82,423,59,224,73,107,44,75,36,33,6,59,39,20,6,6,42,21,21
"2021","Leicester 020D","E01013785",543,99,48,51,405,59,223,72,109,42,76,35,34,7,42,19,23,5,5,39,24,15
"2021","Leicester 020E","E01013786",735,277,76,201,391,33,185,59,85,41,88,48,38,2,76,44,32,9,9,67,25,42
"2021","Leicester 021A","E01013662",545,68,38,30,366,28,235,36,135,64,18,8,8,2,79,13,66,6,6,111,80,31
"2021","Leicester 021B","E01013663",507,56,36,20,352,38,237,32,140,65,11,2,7,2,57,26,31,9,9,99,57,42
"2021","Leicester 021C","E01013747",526,66,33,33,350,24,257,45,150,62,10,2,8,0,50,23,27,9,9,110,81,29
"2021","Leicester 021D","E01013749",427,59,36,23,297,17,215,28,126,61,13,3,10,0,48,19,29,4,4,71,49,22
"2021","Leicester 021E","E01013750",407,48,18,30,259,24,185,25,114,46,7,1,4,2,39,18,21,4,4,100,71,29
"2021","Leicester 021F","E01013758",425,55,35,20,297,28,210,23,131,56,14,6,7,1,37,11,26,8,8,73,50,23
"2021","Leicester 022A","E01013751",518,70,32,38,350,33,257,26,170,61,8,3,4,1,44,19,25,8,8,98,72,26
"2021","Leicester 022B","E01013752",443,62,40,22,297,31,204,20,121,63,13,2,8,3,43,21,22,6,6,84,59,25
"2021","Leicester 022C","E01013753",513,107,30,77,331,12,232,30,160,42,9,3,3,3,69,28,41,9,9,75,54,21
"2021","Leicester 022D","E01013760",674,249,37,212,294,6,159,40,96,23,50,33,17,0,71,41,30,8,8,131,50,81
"2021","Leicester 022E","E01013761",587,103,28,75,399,9,242,24,187,31,28,10,17,1,101,72,29,19,19,85,55,30
"2021","Leicester 022F","E01013762",553,142,55,87,316,32,216,35,126,55,16,7,9,0,45,29,16,7,7,95,53,42
"2021","Leicester 023A","E01013774",737,211,29,182,350,16,156,32,108,16,84,57,25,2,71,37,34,23,23,176,33,143
"2021","Leicester 023B","E01013776",681,224,33,191,302,13,137,32,97,8,76,55,18,3,55,37,18,21,21,155,26,129
"2021","Leicester 023D","E01013779",906,326,40,286,375,6,132,40,81,11,154,114,32,8,67,51,16,16,16,205,23,182
"2021","Leicester 023E","E01013781",769,353,76,277,286,7,92,40,43,9,97,70,21,6,73,56,17,17,17,130,21,109
"2021","Leicester 023F","E01013782",665,265,96,169,327,31,125,48,60,17,96,63,26,7,63,48,15,12,12,73,20,53
"2021","Leicester 023G","E01013784",527,181,51,130,242,26,94,27,45,22,69,43,20,6,37,21,16,16,16,104,10,94
"2021","Leicester 023H","E01034013",467,233,41,192,179,7,82,34,43,5,51,40,11,0,31,19,12,8,8,55,12,43
"2021","Leicester 023I","E01034014",439,128,9,119,227,3,99,36,60,3,59,42,16,1,50,37,13,16,16,84,14,70
"2021","Leicester 025A","E01013666",581,129,96,33,373,77,229,51,103,75,20,8,9,3,44,12,32,3,3,79,51,28
"2021","Leicester 025B","E01013669",469,72,50,22,331,61,224,28,100,96,11,3,6,2,35,7,28,0,0,66,43,23
"2021","Leicester 025C","E01013670",713,207,113,94,423,71,263,57,134,72,27,11,13,3,50,18,32,12,12,83,50,33
"2021","Leicester 025D","E01013671",592,110,54,56,412,43,264,47,157,60,23,13,8,2,76,28,48,6,6,70,52,18
"2021","Leicester 025E","E01013672",512,107,76,31,331,66,206,52,95,59,15,2,11,2,42,15,27,2,2,74,41,33
"2021","Leicester 026A","E01013631",543,95,38,57,391,26,167,43,98,26,69,16,46,7,126,73,53,3,3,57,36,21
"2021","Leicester 026B","E01013632",722,279,112,167,379,19,133,38,71,24,87,25,50,12,133,93,40,7,7,64,39,25
"2021","Leicester 026C","E01013638",673,226,127,99,404,14,157,46,77,34,83,27,37,19,143,97,46,7,7,43,29,14
"2021","Leicester 026D","E01013640",670,115,39,76,506,9,186,50,113,23,99,18,69,12,204,156,48,8,8,49,32,17
"2021","Leicester 027A","E01013756",661,168,57,111,386,38,252,43,156,53,32,22,7,3,52,24,28,12,12,107,46,61
"2021","Leicester 027B","E01013757",484,82,47,35,328,44,235,34,126,75,12,5,7,0,31,19,12,6,6,74,51,23
"2021","Leicester 027C","E01013759",528,67,41,26,376,39,281,42,167,72,13,4,8,1,40,17,23,3,3,85,54,31
"2021","Leicester 027D","E01013763",855,356,53,303,364,11,226,43,158,25,38,26,10,2,77,37,40,12,12,135,44,91
"2021","Leicester 027E","E01013764",464,67,42,25,318,40,223,27,113,83,6,1,4,1,43,23,20,6,6,79,54,25
"2021","Leicester 027F","E01013765",567,134,29,105,331,9,217,40,137,40,18,4,13,1,68,37,31,19,19,102,42,60
"2021","Leicester 027G","E01013766",495,56,25,31,326,23,243,28,149,66,20,7,11,2,37,12,25,3,3,113,86,27
"2021","Leicester 028A","E01013633",655,201,74,127,398,24,173,38,104,31,75,28,38,9,116,69,47,10,10,56,28,28
"2021","Leicester 028B","E01013634",598,202,113,89,348,27,152,36,82,34,66,30,26,10,99,52,47,4,4,48,26,22
"2021","Leicester 028C","E01013637",770,260,93,167,458,22,206,57,105,44,89,30,46,13,130,84,46,11,11,52,36,16
"2021","Leicester 028D","E01013639",524,92,28,64,375,15,146,37,88,21,84,29,43,12,127,82,45,3,3,57,38,19
"2021","Leicester 028E","E01013641",597,171,43,128,316,15,135,45,68,22,81,44,30,7,73,42,31,12,12,110,36,74
"2021","Leicester 029A","E01013635",587,150,63,87,360,41,192,41,93,58,57,34,18,5,63,24,39,7,7,77,36,41
"2021","Leicester 029B","E01013636",498,95,42,53,339,63,173,62,57,54,55,25,23,7,42,12,30,6,6,64,37,27
"2021","Leicester 029D","E01013777",754,200,33,167,426,15,193,70,106,17,115,63,46,6,80,59,21,23,23,128,43,85
"2021","Leicester 029E","E01034015",448,150,2,148,220,6,117,52,60,5,61,47,11,3,27,21,6,9,9,78,8,70
"2021","Leicester 029F","E01034016",731,210,39,171,369,7,174,38,121,15,85,56,28,1,83,57,26,20,20,152,44,108
"2021","Leicester 030A","E01013642",782,318,70,248,343,30,145,52,75,18,119,93,22,4,39,20,19,10,10,121,5,116
"2021","Leicester 030B","E01013643",730,187,41,146,355,22,142,47,70,25,117,95,19,3,60,30,30,14,14,188,10,178
"2021","Leicester 030C","E01013649",675,320,81,239,274,36,100,38,51,11,105,89,12,4,25,15,10,8,8,81,4,77
"2021","Leicester 030D","E01013650",727,189,55,134,292,8,120,62,49,9,123,105,17,1,33,17,16,8,8,246,2,244
"2021","Leicester 030E","E01013702",630,167,83,84,373,38,224,66,114,44,59,40,17,2,46,28,18,6,6,90,21,69
"2021","Leicester 030F","E01013710",692,337,108,229,308,38,169,65,90,14,58,42,14,2,37,23,14,6,6,47,19,28
"2021","Leicester 030G","E01013711",719,334,96,238,326,48,173,68,79,26,67,55,10,2,28,17,11,10,10,59,27,32
"2021","Leicester 031A","E01013613",866,305,43,262,503,23,162,64,78,20,147,79,62,6,159,125,34,12,12,58,13,45
"2021","Leicester 031B","E01013614",769,252,71,181,468,42,174,59,82,33,112,63,43,6,133,99,34,7,7,49,13,36
"2021","Leicester 031C","E01013687",732,264,36,228,377,13,111,38,56,17,123,71,48,4,87,59,28,43,43,91,22,69
"2021","Leicester 031D","E01013688",878,297,56,241,496,15,163,62,85,16,147,85,54,8,165,121,44,6,6,85,24,61
"2021","Leicester 032A","E01013703",520,130,62,68,356,68,203,58,103,42,53,25,24,4,32,21,11,0,0,34,12,22
"2021","Leicester 032B","E01013704",624,208,80,128,346,51,188,62,92,34,61,45,14,2,43,24,19,3,3,70,13,57
"2021","Leicester 032C","E01013706",645,135,65,70,477,78,312,93,176,43,53,36,16,1,32,15,17,2,2,33,23,10
"2021","Leicester 032D","E01013707",595,133,65,68,428,56,258,70,149,39,55,21,30,4,54,34,20,5,5,34,15,19
"2021","Leicester 032E","E01013712",556,211,123,88,299,62,163,50,88,25,43,34,5,4,29,15,14,2,2,46,16,30
"2021","Leicester 034A","E01013608",612,145,76,69,424,67,200,51,101,48,93,40,47,6,59,34,25,5,5,43,26,17
"2021","Leicester 034B","E01013609",728,250,117,133,439,69,213,98,82,33,97,62,32,3,56,28,28,4,4,39,16,23
"2021","Leicester 034C","E01013610",726,238,95,143,451,42,196,72,88,36,98,40,52,6,113,84,29,2,2,37,20,17
"2021","Leicester 034D","E01013611",627,177,84,93,408,56,185,57,87,41,78,36,38,4,84,56,28,5,5,42,23,19
"2021","Leicester 034E","E01013612",750,237,77,160,468,59,220,77,105,38,107,58,39,10,73,43,30,9,9,45,15,30
"2021","Leicester 035A","E01013678",669,173,83,90,432,35,179,49,90,40,98,43,45,10,114,71,43,6,6,64,37,27
"2021","Leicester 035B","E01013679",508,90,31,59,377,11,159,24,105,30,62,13,35,14,135,84,51,10,10,41,24,17
"2021","Leicester 035C","E01013691",597,149,56,93,396,19,154,36,84,34,65,20,33,12,158,105,53,0,0,52,29,23
"2021","Leicester 035D","E01013692",491,110,40,70,349,14,133,30,76,27,63,13,41,9,133,82,51,6,6,32,22,10
"2021","Leicester 035E","E01013693",526,133,64,69,331,16,110,17,68,25,67,13,38,16,130,69,61,8,8,62,46,16
"2021","Leicester 036A","E01013673",616,178,82,96,385,25,151,37,79,35,83,30,44,9,121,73,48,5,5,53,34,19
"2021","Leicester 036B","E01013674",739,349,174,175,341,39,113,43,51,19,75,22,42,11,106,70,36,8,8,49,20,29
"2021","Leicester 036C","E01013675",670,177,93,84,440,37,174,54,87,33,84,30,47,7,141,107,34,4,4,53,28,25
"2021","Leicester 036D","E01013676",822,219,86,133,553,25,210,53,120,37,141,54,75,12,169,121,48,8,8,50,28,22
"2021","Leicester 036E","E01013677",688,257,78,179,406,33,115,34,62,19,106,51,48,7,147,102,45,5,5,25,10,15
"2021","Leicester 037B","E01013698",571,120,72,48,396,29,207,41,120,46,56,22,28,6,99,64,35,5,5,55,35,20
"2021","Leicester 037C","E01013767",550,112,66,46,350,39,211,47,106,58,34,8,18,8,59,26,33,7,7,88,49,39
"2021","Leicester 037D","E01013768",718,275,146,129,382,67,191,59,99,33,52,18,27,7,70,38,32,2,2,61,48,13
"2021","Leicester 037E","E01013772",590,135,65,70,415,25,187,34,123,30,71,27,35,9,123,90,33,9,9,40,23,17
"2021","Leicester 037F","E01032597",668,279,99,180,362,33,150,32,95,23,53,14,32,7,121,89,32,5,5,27,15,12
"2021","Leicester 037G","E01034017",527,66,31,35,410,14,272,60,182,30,35,13,19,3,77,48,29,12,12,51,36,15
"2021","Leicester 037H","E01034018",495,95,35,60,358,26,162,31,96,35,52,11,35,6,110,77,33,8,8,42,27,15
"2021","Leicester 038A","E01013689",532,171,38,133,232,5,103,30,61,12,63,39,22,2,43,20,23,18,18,129,13,116
"2021","Leicester 038B","E01013690",892,297,49,248,484,21,188,63,97,28,126,64,55,7,142,100,42,7,7,111,31,80
"2021","Leicester 038C","E01013705",648,214,84,130,386,55,207,53,106,48,61,30,24,7,62,38,24,1,1,48,32,16
"2021","Leicester 038D","E01013709",551,99,58,41,393,47,269,68,144,57,21,9,10,2,52,23,29,4,4,59,38,21
"2021","Leicester 038E","E01032599",575,117,65,52,410,61,251,54,138,59,35,18,14,3,57,31,26,6,6,48,29,19
"2021","Leicester 039A","E01013722",614,127,58,69,408,32,192,35,104,53,67,10,50,7,110,76,34,7,7,79,51,28
"2021","Leicester 039B","E01013727",641,185,76,109,406,35,162,31,110,21,85,29,49,7,117,77,40,7,7,50,26,24
"2021","Leicester 039C","E01013730",738,285,61,224,412,17,140,32,94,14,100,33,61,6,146,106,40,9,9,41,18,23
"2021","Leicester 039D","E01013731",633,163,39,124,427,33,147,47,77,23,87,42,39,6,154,94,60,6,6,43,21,22
"2021","Leicester 039E","E01032602",604,139,68,71,403,24,171,38,99,34,80,18,56,6,117,84,33,11,11,62,42,20
"2021","Leicester 040C","E01013648",769,181,29,152,342,6,154,49,91,14,58,40,16,2,102,75,27,22,22,246,29,217
"2021","Leicester 040E","E01034019",706,344,43,301,236,4,86,41,41,4,70,66,3,1,58,25,33,18,18,126,18,108
"2021","Leicester 040F","E01034020",975,527,86,441,275,3,97,41,46,10,54,43,10,1,95,66,29,26,26,173,24,149
"2021","Leicester 040G","E01034021",404,200,12,188,139,2,45,27,16,2,50,47,3,0,36,10,26,6,6,65,8,57
"2021","Leicester 041B","E01032868",504,194,7,187,169,0,35,21,13,1,68,63,5,0,12,8,4,54,54,141,4,137
"2021","Leicester 041C","E01032872",772,444,10,434,263,2,98,72,24,2,125,118,7,0,28,20,8,10,10,65,3,62
"2021","Leicester 041D","E01032873",947,608,52,556,246,6,65,35,27,3,95,92,3,0,51,34,17,29,29,93,5,88
"2021","Leicester 041E","E01034022",732,342,20,322,295,2,82,40,36,6,113,101,11,1,70,19,51,28,28,95,15,80
"2021","Leicester 041F","E01034023",720,353,16,337,286,1,76,35,37,4,118,107,11,0,53,30,23,38,38,81,5,76
"2021","Leicester 042B","E01032862",737,137,22,115,503,8,291,57,192,42,76,36,36,4,123,87,36,5,5,97,67,30
"2021","Leicester 042C","E01032863",785,148,22,126,563,20,368,64,253,51,54,26,24,4,113,87,26,8,8,74,49,25
"2021","Leicester 042A","E01032865",691,119,27,92,493,21,324,63,192,69,52,26,22,4,91,57,34,5,5,79,52,27
"2021","Leicester 043D","E01013696",828,143,58,85,596,50,354,71,193,90,48,10,33,5,141,81,60,3,3,89,54,35
"2021","Leicester 043C","E01013699",678,162,91,71,440,51,256,56,138,62,31,11,16,4,69,31,38,33,33,76,50,26
"2021","Leicester 043A","E01034024",636,164,37,127,403,19,239,46,149,44,38,18,16,4,101,73,28,6,6,69,47,22
"2021","Leicester 043B","E01034025",660,143,74,69,444,48,300,51,163,86,27,14,10,3,59,32,27,10,10,73,48,25
"2021","Rutland 001A","E01013788",1085,243,143,100,809,155,492,166,282,44,97,54,37,6,61,44,17,4,4,33,10,23
"2021","Rutland 001B","E01013789",626,175,111,64,434,122,224,104,79,41,52,31,19,2,34,17,17,2,2,17,6,11
"2021","Rutland 001C","E01013790",604,129,63,66,440,91,259,113,98,48,54,31,19,4,36,22,14,0,0,35,11,24
"2021","Rutland 001D","E01013796",564,131,66,65,418,82,242,91,106,45,52,30,22,0,42,24,18,0,0,15,7,8
"2021","Rutland 002A","E01013793",638,185,110,75,425,131,215,94,93,28,48,35,9,4,31,13,18,0,0,28,12,16
"2021","Rutland 002B","E01013800",646,165,106,59,454,101,234,90,95,49,65,36,25,4,52,27,25,2,2,27,10,17
"2021","Rutland 002D","E01013809",535,102,60,42,409,113,214,98,75,41,42,30,10,2,38,20,18,2,2,24,8,16
"2021","Rutland 002E","E01035102",606,121,35,86,453,52,262,68,174,20,88,52,34,2,49,42,7,2,2,32,16,16
"2021","Rutland 002F","E01035103",532,179,64,115,323,38,131,41,74,16,98,60,35,3,54,43,11,2,2,30,14,16
"2021","Rutland 002G","E01035104",596,210,89,121,358,54,160,59,86,15,78,42,32,4,62,42,20,4,4,28,8,20
"2021","Rutland 003A","E01013798",580,144,79,65,423,95,224,88,105,31,63,36,23,4,41,22,19,0,0,13,4,9
"2021","Rutland 003B","E01013799",625,284,118,166,314,56,125,51,50,24,71,39,28,4,58,43,15,4,4,27,9,18
"2021","Rutland 003D","E01013803",1020,295,182,113,699,196,340,125,146,69,95,55,37,3,68,45,23,0,0,26,12,14
"2021","Rutland 003E","E01035105",634,205,116,89,409,106,196,80,72,44,48,35,10,3,57,34,23,2,2,20,5,15
"2021","Rutland 003F","E01035106",650,251,170,81,385,141,169,74,69,26,37,30,6,1,37,21,16,1,1,14,3,11
"2021","Rutland 004A","E01013791",497,159,105,54,321,82,170,53,82,35,39,25,10,4,29,14,15,1,1,17,7,10
"2021","Rutland 004B","E01013792",714,191,117,74,499,141,277,113,125,39,39,23,15,1,42,23,19,0,0,24,14,10
"2021","Rutland 004C","E01013797",754,196,102,94,525,128,280,124,114,42,85,57,25,3,31,22,9,1,1,33,9,24
"2021","Rutland 004D","E01013804",687,173,94,79,488,112,255,107,99,49,69,36,30,3,50,23,27,2,2,26,11,15
"2021","Rutland 004E","E01013805",539,146,84,62,377,87,202,69,98,35,46,26,18,2,41,27,14,1,1,16,8,8
"2021","Rutland 005A","E01013787",573,163,86,77,388,93,210,100,78,32,48,31,12,5,35,15,20,2,2,22,7,15
"2021","Rutland 005B","E01013794",604,130,65,65,464,138,232,111,87,34,61,36,18,7,31,14,17,2,2,10,2,8
"2021","Rutland 005C","E01013795",518,139,85,54,363,97,195,105,53,37,49,35,12,2,20,9,11,2,2,16,7,9
"2021","Rutland 005D","E01013806",513,187,82,105,302,66,144,60,57,27,47,28,12,7,43,30,13,2,2,24,11,13
"2021","Rutland 005E","E01013807",617,229,134,95,375,83,181,77,81,23,60,26,27,7,48,29,19,3,3,13,6,7
"2021","Rutland 005F","E01013808",746,255,129,126,468,92,227,87,110,30,68,35,31,2,79,49,30,2,2,23,8,15
"2021","Nottingham 001A","E01013887",650,155,98,57,455,119,221,75,80,66,55,18,32,5,55,29,26,5,5,40,12,28
"2021","Nottingham 001B","E01013892",595,151,93,58,407,115,207,85,67,55,44,24,13,7,41,10,31,0,0,37,15,22
"2021","Nottingham 001C","E01013893",618,171,43,128,409,17,114,39,51,24,89,30,54,5,185,136,49,4,4,38,13,25
"2021","Nottingham 001D","E01013894",651,184,108,76,421,102,192,70,71,51,69,35,30,4,52,29,23,6,6,46,21,25
"2021","Nottingham 002A","E01013879",569,181,73,108,361,16,130,50,49,31,91,44,41,6,122,98,24,2,2,27,16,11
"2021","Nottingham 002B","E01013880",668,228,98,130,408,44,153,66,57,30,82,27,50,5,123,87,36,6,6,32,18,14
"2021","Nottingham 002C","E01013881",638,186,82,104,421,33,156,78,52,26,94,31,53,10,135,95,40,3,3,31,13,18
"2021","Nottingham 002D","E01013882",637,214,87,127,377,33,139,48,59,32,76,39,28,9,121,83,38,8,8,46,12,34
"2021","Nottingham 002E","E01013885",781,311,104,207,419,23,134,60,55,19,89,51,30,8,163,124,39,10,10,51,22,29
"2021","Nottingham 004A","E01013886",649,221,90,131,402,49,153,68,51,34,80,29,47,4,117,89,28,3,3,26,6,20
"2021","Nottingham 004B","E01013888",712,246,93,153,428,69,165,61,68,36,108,56,44,8,78,55,23,8,8,38,16,22
"2021","Nottingham 004C","E01013889",721,214,120,94,458,91,214,96,74,44,72,39,27,6,76,51,25,5,5,49,17,32
"2021","Nottingham 004D","E01013890",657,193,63,130,429,55,158,65,56,37,113,45,61,7,101,64,37,2,2,35,13,22
"2021","Nottingham 004E","E01013891",772,275,91,184,456,35,144,61,62,21,101,43,51,7,172,124,48,4,4,41,22,19
"2021","Nottingham 005A","E01013875",515,125,72,53,365,70,198,72,73,53,57,25,28,4,39,24,15,1,1,25,13,12
"2021","Nottingham 005B","E01013876",729,262,87,175,418,27,141,54,61,26,101,54,38,9,140,103,37,9,9,49,20,29
"2021","Nottingham 005C","E01013877",697,294,73,221,367,24,104,40,49,15,74,23,44,7,157,134,23,8,8,36,22,14
"2021","Nottingham 005D","E01013878",519,131,47,84,358,22,110,45,48,17,78,26,42,10,147,102,45,1,1,30,21,9
"2021","Nottingham 005E","E01013883",662,233,80,153,403,52,146,72,46,28,89,31,40,18,108,77,31,8,8,26,9,17
"2021","Nottingham 005F","E01013884",631,269,82,187,324,29,117,46,48,23,72,39,27,6,104,67,37,2,2,38,9,29
"2021","Nottingham 006A","E01013853",649,207,93,114,417,41,188,80,75,33,89,41,46,2,92,56,36,7,7,25,11,14
"2021","Nottingham 006B","E01013854",605,185,58,127,366,39,129,35,56,38,85,41,41,3,109,69,40,4,4,54,30,24
"2021","Nottingham 006C","E01013855",609,129,46,83,436,23,135,33,79,23,89,27,48,14,182,144,38,7,7,44,31,13
"2021","Nottingham 006D","E01013856",622,166,56,110,413,18,170,58,75,37,106,44,48,14,114,82,32,5,5,43,26,17
"2021","Nottingham 006F","E01033397",740,170,45,125,497,16,191,50,112,29,109,61,39,9,170,115,55,11,11,73,27,46
"2021","Nottingham 006G","E01033398",624,308,31,277,282,7,111,45,56,10,73,45,27,1,79,50,29,12,12,34,15,19
"2021","Nottingham 007A","E01013963",675,254,122,132,392,35,160,53,66,41,73,35,35,3,116,91,25,8,8,29,10,19
"2021","Nottingham 007B","E01013964",702,140,64,76,513,57,241,82,120,39,99,56,35,8,110,67,43,6,6,49,21,28
"2021","Nottingham 007C","E01013965",612,196,93,103,370,27,141,42,58,41,86,47,33,6,114,52,62,2,2,46,19,27
"2021","Nottingham 007D","E01013966",545,160,56,104,345,26,145,39,78,28,81,42,35,4,86,53,33,7,7,40,12,28
"2021","Nottingham 007E","E01013967",537,168,62,106,308,38,134,51,68,15,84,48,34,2,48,35,13,4,4,61,15,46
"2021","Nottingham 008A","E01013827",590,177,70,107,377,23,148,50,67,31,90,42,35,13,114,78,36,2,2,36,19,17
"2021","Nottingham 008B","E01013828",818,282,76,206,467,39,205,91,84,30,121,69,45,7,93,64,29,9,9,69,23,46
"2021","Nottingham 008C","E01013834",635,176,81,95,432,33,140,39,63,38,99,46,46,7,157,120,37,3,3,27,17,10
"2021","Nottingham 008D","E01013835",729,272,91,181,421,38,140,48,68,24,82,33,43,6,157,111,46,4,4,36,21,15
"2021","Nottingham 008E","E01013836",906,341,124,217,506,20,166,58,88,20,118,66,43,9,188,135,53,14,14,59,29,30
"2021","Nottingham 009A","E01013829",796,303,91,212,456,33,183,59,103,21,94,58,31,5,137,97,40,9,9,37,13,24
"2021","Nottingham 009B","E01013830",649,172,86,86,431,69,187,62,88,37,79,35,40,4,95,50,45,1,1,46,26,20
"2021","Nottingham 009C","E01013831",664,202,99,103,436,68,188,77,68,43,100,60,33,7,78,44,34,2,2,26,17,9
"2021","Nottingham 009D","E01013832",759,329,79,250,371,37,154,53,67,34,79,52,23,4,94,63,31,7,7,59,27,32
"2021","Nottingham 009E","E01013833",541,154,49,105,356,21,149,51,78,20,57,29,23,5,122,76,46,7,7,31,17,14
"2021","Nottingham 010A","E01013935",713,248,118,130,410,80,158,87,47,24,106,60,39,7,64,33,31,2,2,55,14,41
"2021","Nottingham 010B","E01013968",666,301,186,115,335,80,162,66,68,28,58,32,22,4,33,15,18,2,2,30,9,21
"2021","Nottingham 010C","E01013969",810,313,70,243,400,27,155,63,75,17,134,101,32,1,76,50,26,8,8,97,31,66
"2021","Nottingham 010D","E01013970",695,239,45,194,381,22,154,50,90,14,139,91,47,1,61,38,23,5,5,75,16,59
"2021","Nottingham 010E","E01013971",789,376,70,306,367,24,147,59,75,13,122,79,43,0,69,44,25,5,5,46,15,31
"2021","Nottingham 011A","E01013817",641,174,91,83,423,22,142,31,87,24,90,22,62,6,159,136,23,10,10,44,27,17
"2021","Nottingham 011B","E01013818",535,91,27,64,378,12,129,28,78,23,70,19,39,12,155,118,37,12,12,66,49,17
"2021","Nottingham 011C","E01013822",629,118,43,75,461,13,188,37,125,26,79,18,50,11,172,126,46,9,9,50,37,13
"2021","Nottingham 011D","E01013825",695,130,31,99,485,20,181,55,98,28,90,35,42,13,179,130,49,15,15,80,50,30
"2021","Nottingham 011E","E01013826",661,131,38,93,477,12,141,31,83,27,80,15,50,15,219,163,56,25,25,53,30,23
"2021","Nottingham 012A","E01013837",733,197,55,142,464,43,228,80,112,36,112,76,29,7,76,47,29,5,5,72,41,31
"2021","Nottingham 012B","E01013838",700,195,65,130,447,41,245,76,136,33,95,60,33,2,62,35,27,4,4,58,24,34
"2021","Nottingham 012C","E01013839",913,350,86,264,477,10,177,67,98,12,125,83,36,6,150,116,34,15,15,86,25,61
"2021","Nottingham 012D","E01013840",996,325,75,250,573,24,289,107,142,40,144,98,44,2,100,73,27,16,16,98,52,46
"2021","Nottingham 012E","E01013841",703,224,36,188,409,14,139,49,78,12,98,65,29,4,146,109,37,12,12,70,22,48
"2021","Nottingham 013A","E01013819",711,211,82,129,442,35,163,43,88,32,84,28,49,7,157,109,48,3,3,58,28,30
"2021","Nottingham 013B","E01013820",648,158,39,119,456,12,163,44,89,30,86,27,44,15,185,146,39,10,10,34,15,19
"2021","Nottingham 013C","E01013821",630,129,34,95,451,20,147,23,89,35,87,29,52,6,193,152,41,4,4,50,31,19
"2021","Nottingham 013D","E01013823",641,157,52,105,423,21,166,41,95,30,80,27,40,13,148,98,50,8,8,61,42,19
"2021","Nottingham 013E","E01013824",590,111,26,85,432,16,189,38,130,21,67,22,36,9,151,113,38,9,9,47,29,18
"2021","Nottingham 014A","E01013864",890,220,26,194,622,35,238,72,135,31,143,72,67,4,194,151,43,12,12,48,21,27
"2021","Nottingham 014B","E01013865",705,301,159,142,362,37,155,47,71,37,73,23,41,9,80,53,27,17,17,42,18,24
"2021","Nottingham 014C","E01013866",599,210,107,103,345,32,138,53,52,33,60,18,29,13,101,71,30,14,14,44,23,21
"2021","Nottingham 014D","E01013867",569,118,49,69,412,15,143,39,71,33,87,28,45,14,161,116,45,6,6,39,30,9
"2021","Nottingham 015A","E01013937",769,238,67,171,472,57,202,81,93,28,126,83,34,9,79,60,19,8,8,59,21,38
"2021","Nottingham 015B","E01013938",698,278,79,199,356,43,190,75,89,26,87,59,22,6,32,18,14,4,4,64,20,44
"2021","Nottingham 015C","E01013941",881,442,97,345,349,33,141,66,52,23,122,101,17,4,41,23,18,12,12,90,11,79
"2021","Nottingham 015D","E01013943",831,403,47,356,307,12,125,60,55,10,103,88,14,1,52,38,14,15,15,121,17,104
"2021","Nottingham 015E","E01013972",707,283,78,205,354,28,134,54,64,16,106,79,24,3,81,46,35,5,5,70,12,58
"2021","Nottingham 016A","E01013936",1053,418,96,322,566,48,208,101,80,27,199,137,56,6,104,51,53,7,7,69,29,40
"2021","Nottingham 016B","E01013939",740,319,96,223,402,52,167,74,63,30,91,67,22,2,82,46,36,10,10,19,7,12
"2021","Nottingham 016C","E01013940",803,265,44,221,498,14,171,50,90,31,154,105,45,4,150,111,39,9,9,40,19,21
"2021","Nottingham 016D","E01013942",908,290,67,223,552,19,215,58,138,19,112,55,51,6,198,155,43,8,8,66,28,38
"2021","Nottingham 017A","E01013843",788,306,55,251,313,15,130,41,70,19,103,79,20,4,52,39,13,13,13,169,59,110
"2021","Nottingham 017B","E01013844",665,225,67,158,341,6,144,57,77,10,86,44,36,6,95,63,32,10,10,99,31,68
"2021","Nottingham 017C","E01013845",633,137,27,110,390,9,200,42,146,12,59,30,28,1,107,73,34,15,15,106,57,49
"2021","Nottingham 017D","E01013847",439,98,19,79,194,5,116,21,74,21,44,24,17,3,18,8,10,11,11,147,70,77
"2021","Nottingham 018A","E01013810",644,149,46,103,368,9,189,35,137,17,50,22,25,3,109,80,29,11,11,127,56,71
"2021","Nottingham 018B","E01013811",523,209,38,171,203,4,96,16,68,12,38,25,13,0,51,30,21,14,14,111,24,87
"2021","Nottingham 018C","E01013812",551,157,27,130,296,9,140,17,106,17,59,30,25,4,78,53,25,10,10,98,47,51
"2021","Nottingham 018D","E01013842",700,197,30,167,356,7,159,26,123,10,83,51,29,3,96,67,29,11,11,147,36,111
"2021","Nottingham 018E","E01013846",655,236,39,197,278,3,162,48,93,21,42,33,7,2,59,39,20,12,12,141,37,104
"2021","Nottingham 019A","E01013930",688,184,54,130,427,24,236,44,157,35,45,26,17,2,111,68,43,11,11,77,45,32
"2021","Nottingham 019B","E01013931",741,199,120,79,455,72,265,49,155,61,47,25,22,0,59,34,25,12,12,87,54,33
"2021","Nottingham 019C","E01013932",896,216,94,122,604,63,380,88,236,56,77,51,22,4,72,35,37,12,12,76,44,32
"2021","Nottingham 019D","E01013933",715,189,58,131,424,18,179,50,110,19,66,24,33,9,147,92,55,14,14,102,48,54
"2021","Nottingham 019E","E01013934",627,216,110,106,354,57,194,52,104,38,43,22,17,4,55,31,24,5,5,57,38,19
"2021","Nottingham 020A","E01013859",714,269,149,120,417,68,192,69,86,37,77,43,26,8,70,33,37,10,10,28,9,19
"2021","Nottingham 020B","E01013861",694,277,154,123,375,50,160,48,78,34,57,27,25,5,100,55,45,8,8,42,23,19
"2021","Nottingham 020C","E01013868",594,218,134,84,331,41,135,37,61,37,41,14,20,7,108,64,44,6,6,45,31,14
"2021","Nottingham 020D","E01013929",752,217,87,130,475,42,256,62,134,60,75,37,35,3,93,59,34,9,9,60,27,33
"2021","Nottingham 021A","E01013954",824,270,88,182,484,21,201,51,128,22,103,52,45,6,150,107,43,9,9,70,24,46
"2021","Nottingham 021B","E01013959",802,292,96,196,461,27,178,25,130,23,70,24,39,7,168,115,53,18,18,49,24,25
"2021","Nottingham 021C","E01013960",844,385,76,309,393,11,152,47,87,18,92,18,70,4,129,89,40,9,9,66,23,43
"2021","Nottingham 021D","E01013962",885,300,94,206,523,21,212,46,132,34,120,82,34,4,155,107,48,15,15,62,24,38
"2021","Nottingham 022A","E01013813",574,295,44,251,186,6,63,24,28,11,33,19,14,0,75,49,26,9,9,93,8,85
"2021","Nottingham 022B","E01013814",712,267,16,251,189,4,70,18,44,8,64,56,6,2,25,16,9,26,26,256,13,243
"2021","Nottingham 022C","E01013815",605,205,16,189,118,4,39,21,17,1,46,43,2,1,21,8,13,8,8,282,10,272
"2021","Nottingham 022D","E01013816",778,259,49,210,229,12,53,29,18,6,92,69,17,6,49,29,20,23,23,290,17,273
"2021","Nottingham 023C","E01013958",775,305,100,205,394,24,134,37,74,23,69,35,29,5,154,108,46,13,13,76,31,45
"2021","Nottingham 023D","E01013961",881,284,64,220,284,11,91,28,47,16,74,54,16,4,91,63,28,17,17,313,20,293
"2021","Nottingham 023E","E01033399",458,233,47,186,151,8,60,26,24,10,36,31,3,2,39,29,10,8,8,74,14,60
"2021","Nottingham 023H","E01033409",486,377,58,319,84,8,26,18,5,3,35,33,0,2,11,5,6,4,4,25,1,24
"2021","Nottingham 023I","E01033411",573,310,70,240,227,13,83,20,51,12,43,19,21,3,83,53,30,5,5,36,6,30
"2021","Nottingham 023J","E01035500",1022,578,24,554,320,6,94,53,31,10,141,127,14,0,47,28,19,32,32,124,12,112
"2021","Nottingham 024A","E01013913",669,178,88,90,427,60,210,62,96,52,64,31,26,7,87,41,46,6,6,64,37,27
"2021","Nottingham 024B","E01013914",614,151,75,76,417,69,233,54,121,58,58,31,25,2,54,23,31,3,3,46,33,13
"2021","Nottingham 024C","E01013915",652,204,109,95,412,65,191,72,77,42,84,44,34,6,71,36,35,1,1,36,16,20
"2021","Nottingham 024D","E01013916",588,149,45,104,401,22,146,29,84,33,72,20,45,7,154,100,54,7,7,38,17,21
"2021","Nottingham 024E","E01013917",766,280,62,218,409,15,185,57,102,26,95,47,41,7,105,68,37,9,9,77,44,33
"2021","Nottingham 025A","E01013858",570,159,80,79,366,30,147,43,76,28,67,28,32,7,91,50,41,31,31,45,34,11
"2021","Nottingham 025B","E01013860",710,259,148,111,388,55,162,63,67,32,72,38,29,5,92,37,55,7,7,63,30,33
"2021","Nottingham 025C","E01013862",605,215,74,141,345,19,151,40,85,26,68,25,35,8,104,66,38,3,3,45,22,23
"2021","Nottingham 025D","E01013863",584,162,73,89,385,39,192,62,83,47,80,44,30,6,73,41,32,1,1,37,21,16
"2021","Nottingham 026A","E01013944",637,176,75,101,367,31,231,45,159,27,35,18,15,2,58,34,24,12,12,94,42,52
"2021","Nottingham 026B","E01013945",643,286,46,240,247,2,124,32,82,10,38,17,18,3,69,51,18,14,14,110,20,90
"2021","Nottingham 026D","E01013947",642,201,46,155,316,5,136,44,74,18,64,25,38,1,97,64,33,14,14,125,24,101
"2021","Nottingham 026E","E01013948",680,349,58,291,267,5,102,47,48,7,35,13,21,1,91,58,33,34,34,64,12,52
"2021","Nottingham 026F","E01013953",583,84,10,74,165,7,67,21,37,9,53,44,9,0,22,8,14,16,16,334,11,323
"2021","Nottingham 026G","E01033395",430,138,4,134,111,1,51,19,25,7,23,17,6,0,19,15,4,17,17,181,4,177
"2021","Nottingham 026H","E01033396",513,216,38,178,207,11,59,22,32,5,42,25,11,6,87,64,23,8,8,90,7,83
"2021","Nottingham 028E","E01032520",1030,404,87,317,455,46,182,107,58,17,172,158,13,1,34,23,11,21,21,171,5,166
"2021","Nottingham 028F","E01032522",1037,411,66,345,460,53,202,108,72,22,168,159,6,3,21,16,5,16,16,166,3,163
"2021","Nottingham 028H","E01035501",810,348,38,310,213,1,76,31,39,6,68,62,6,0,60,52,8,8,8,249,40,209
"2021","Nottingham 028I","E01035502",573,27,9,18,63,5,32,2,20,10,9,4,5,0,12,8,4,5,5,483,15,468
"2021","Nottingham 029A","E01013918",740,207,40,167,430,12,182,35,132,15,100,67,26,7,123,96,27,13,13,103,37,66
"2021","Nottingham 029B","E01013919",814,288,36,252,374,9,155,42,92,21,107,77,23,7,80,53,27,23,23,152,27,125
"2021","Nottingham 029C","E01013920",1147,559,145,414,464,32,140,66,63,11,138,104,31,3,121,68,53,33,33,124,33,91
"2021","Nottingham 029D","E01013921",816,285,80,205,397,4,156,37,102,17,89,49,35,5,135,113,22,13,13,134,69,65
"2021","Nottingham 029E","E01013957",647,200,45,155,382,9,147,33,90,24,93,50,38,5,128,88,40,5,5,65,24,41
"2021","Nottingham 030A","E01013980",669,148,90,58,486,87,282,84,163,35,67,37,26,4,48,27,21,2,2,35,17,18
"2021","Nottingham 030B","E01013982",632,116,77,39,480,101,299,87,155,57,41,22,19,0,39,16,23,0,0,36,21,15
"2021","Nottingham 030C","E01013983",607,262,63,199,322,30,151,30,99,22,47,24,21,2,89,55,34,5,5,23,10,13
"2021","Nottingham 030D","E01013984",624,181,146,35,421,131,232,70,124,38,27,11,16,0,31,17,14,0,0,22,13,9
"2021","Nottingham 030E","E01013985",697,193,148,45,462,106,255,71,139,45,48,26,17,5,50,19,31,3,3,42,22,20
"2021","Nottingham 031G","E01013928",528,111,13,98,167,7,67,19,41,7,47,41,3,3,33,23,10,13,13,250,6,244
"2021","Nottingham 031I","E01033410",815,193,68,125,190,21,77,30,39,8,50,45,3,2,26,13,13,16,16,432,14,418
"2021","Nottingham 031J","E01035503",413,53,20,33,79,8,32,11,13,8,22,18,3,1,13,8,5,4,4,281,12,269
"2021","Nottingham 031K","E01035504",562,174,33,141,168,4,69,27,32,10,44,31,11,2,45,27,18,6,6,220,5,215
"2021","Nottingham 031L","E01035505",974,279,79,200,289,16,96,38,49,9,66,50,12,4,92,72,20,19,19,406,21,385
"2021","Nottingham 034A","E01013895",635,170,108,62,443,96,224,99,80,45,74,35,32,7,47,21,26,2,2,22,8,14
"2021","Nottingham 034B","E01013896",567,236,86,150,293,25,103,40,37,26,78,33,39,6,80,54,26,7,7,38,16,22
"2021","Nottingham 034C","E01013901",630,156,58,98,448,64,254,76,144,34,81,59,18,4,46,28,18,3,3,26,10,16
"2021","Nottingham 034D","E01013902",846,260,123,137,549,81,272,110,121,41,140,92,48,0,54,32,22,2,2,37,17,20
"2021","Nottingham 035A","E01013897",617,196,81,115,384,35,163,49,68,46,86,43,29,14,91,64,27,9,9,37,11,26
"2021","Nottingham 035B","E01013898",415,119,40,79,254,21,99,36,44,19,69,34,29,6,58,37,21,7,7,42,14,28
"2021","Nottingham 035C","E01013899",492,107,47,60,339,30,150,62,50,38,67,16,45,6,87,51,36,5,5,46,19,27
"2021","Nottingham 035D","E01013900",658,201,67,134,423,38,162,64,66,32,89,52,28,9,124,90,34,10,10,34,18,16
"2021","Nottingham 035E","E01013903",497,113,67,46,351,59,155,63,52,40,70,32,29,9,64,39,25,3,3,33,14,19
"2021","Nottingham 035F","E01013907",736,319,144,175,377,49,137,50,54,33,83,38,41,4,102,72,30,6,6,40,20,20
"2021","Nottingham 036A","E01013905",618,192,86,106,381,42,145,44,68,33,92,44,40,8,99,69,30,3,3,45,14,31
"2021","Nottingham 036B","E01013908",687,270,180,90,372,51,134,49,49,36,85,34,38,13,97,64,33,5,5,45,15,30
"2021","Nottingham 036C","E01013909",745,319,172,147,378,74,112,58,31,23,77,39,32,6,108,86,22,7,7,48,13,35
"2021","Nottingham 036D","E01013912",629,161,87,74,427,63,226,116,70,40,74,38,30,6,58,34,24,6,6,41,14,27
"2021","Nottingham 037A","E01013904",603,143,75,68,410,37,176,68,78,30,87,41,39,7,108,74,34,2,2,50,11,39
"2021","Nottingham 037B","E01013906",680,179,78,101,456,38,190,55,85,50,102,39,55,8,121,74,47,5,5,45,18,27
"2021","Nottingham 037C","E01013910",639,187,72,115,401,31,169,64,66,39,85,39,39,7,112,83,29,4,4,51,18,33
"2021","Nottingham 037D","E01013911",683,249,114,135,386,38,154,63,61,30,97,42,48,7,89,54,35,8,8,48,25,23
"2021","Nottingham 038A","E01013849",674,257,119,138,381,40,115,36,49,30,70,22,41,7,151,93,58,5,5,36,22,14
"2021","Nottingham 038B","E01013850",684,307,138,169,345,27,131,48,57,26,87,41,38,8,90,54,36,10,10,32,17,15
"2021","Nottingham 038C","E01013851",718,334,126,208,351,32,92,35,42,15,82,27,52,3,143,102,41,2,2,33,14,19
"2021","Nottingham 038D","E01013852",756,324,131,193,397,44,162,41,82,39,94,55,31,8,91,59,32,6,6,35,17,18
"2021","Nottingham 038E","E01032621",681,269,113,156,373,47,139,57,48,34,78,33,37,8,103,63,40,6,6,39,17,22
"2021","Nottingham 039A","E01013874",778,280,69,211,404,32,147,57,75,15,130,94,31,5,81,52,29,14,14,94,24,70
"2021","Nottingham 039B","E01033400",977,431,38,393,402,12,142,56,73,13,159,133,26,0,59,35,24,30,30,144,9,135
"2021","Nottingham 039C","E01033402",658,331,7,324,239,2,80,48,32,0,128,122,6,0,16,6,10,13,13,88,0,88
"2021","Nottingham 039F","E01033407",645,295,12,283,204,2,42,27,13,2,130,127,3,0,22,13,9,8,8,146,2,144
"2021","Nottingham 039G","E01035506",1127,571,30,541,309,4,66,43,20,3,172,158,11,3,30,18,12,37,37,247,2,245
"2021","Nottingham 040A","E01013870",1086,487,120,367,507,28,187,55,104,28,128,96,27,5,156,113,43,8,8,92,31,61
"2021","Nottingham 040B","E01013871",831,384,162,222,402,20,158,55,83,20,76,48,25,3,141,93,48,7,7,45,14,31
"2021","Nottingham 040C","E01013872",776,267,76,191,421,19,186,47,105,34,76,46,27,3,127,90,37,13,13,88,48,40
"2021","Nottingham 040D","E01013873",627,164,29,135,367,5,144,25,95,24,83,48,30,5,116,72,44,19,19,96,25,71
"2021","Nottingham 041D","E01013977",747,197,124,73,504,84,299,85,168,46,75,45,27,3,42,26,16,4,4,46,20,26
"2021","Nottingham 041A","E01013978",673,185,102,83,399,37,231,57,140,34,59,37,17,5,66,36,30,6,6,89,52,37
"2021","Nottingham 041C","E01013979",605,98,49,49,461,68,292,75,171,46,59,39,19,1,38,22,16,4,4,46,27,19
"2021","Nottingham 041B","E01013981",695,158,75,83,502,93,303,84,162,57,53,31,21,1,51,35,16,2,2,35,15,20
"2021","Nottingham 041E","E01035507",1008,303,181,122,535,106,261,81,122,58,61,43,14,4,89,34,55,18,18,170,34,136
"2021","Nottingham 041F","E01035508",992,329,110,219,565,22,220,77,118,25,149,92,45,12,161,112,49,13,13,98,18,80
"2021","North Northamptonshire 002A","E01026971",734,214,117,97,452,59,213,86,76,51,98,42,46,10,77,52,25,5,5,68,27,41
"2021","North Northamptonshire 002B","E01026979",669,146,80,66,495,87,275,119,116,40,70,40,25,5,63,36,27,0,0,28,14,14
"2021","North Northamptonshire 002C","E01026980",695,157,87,70,520,104,291,136,100,55,84,49,28,7,38,23,15,3,3,18,11,7
"2021","North Northamptonshire 002D","E01026982",885,205,77,128,586,50,234,73,118,43,135,56,70,9,152,112,40,15,15,94,42,52
"2021","North Northamptonshire 003A","E01026969",793,306,180,126,431,69,191,59,89,43,88,35,47,6,74,38,36,9,9,56,28,28
"2021","North Northamptonshire 003B","E01026970",661,138,52,86,475,35,234,83,102,49,94,40,47,7,107,57,50,5,5,48,27,21
"2021","North Northamptonshire 003C","E01026972",756,194,64,130,511,33,210,72,95,43,135,62,66,7,123,64,59,10,10,51,22,29
"2021","North Northamptonshire 003D","E01026976",631,152,49,103,416,28,193,56,85,52,88,30,47,11,100,64,36,7,7,63,28,35
"2021","North Northamptonshire 003E","E01026981",503,119,70,49,345,56,161,59,64,38,59,35,19,5,59,26,33,10,10,39,18,21
"2021","North Northamptonshire 003F","E01026983",451,133,48,85,258,38,98,30,47,21,61,22,32,7,54,35,19,7,7,60,14,46
"2021","North Northamptonshire 006A","E01026957",843,293,115,178,492,44,167,71,62,34,121,63,54,4,151,100,51,9,9,58,22,36
"2021","North Northamptonshire 006B","E01026958",778,172,58,114,526,27,205,69,107,29,127,61,51,15,149,93,56,18,18,80,34,46
"2021","North Northamptonshire 006C","E01035393",635,110,7,103,493,8,258,83,164,11,181,101,72,8,44,34,10,2,2,32,19,13
"2021","North Northamptonshire 006D","E01035394",637,125,8,117,451,16,209,61,139,9,164,109,52,3,57,45,12,5,5,61,35,26
"2021","North Northamptonshire 006E","E01035395",563,111,46,65,417,46,246,82,127,37,80,48,29,3,40,27,13,5,5,35,18,17
"2021","North Northamptonshire 006F","E01035396",516,106,41,65,384,31,169,62,96,11,139,72,64,3,44,30,14,1,1,26,11,15
"2021","North Northamptonshire 006G","E01035397",733,160,17,143,527,18,251,69,155,27,155,79,74,2,98,83,15,5,5,46,24,22
"2021","North Northamptonshire 006H","E01035398",794,168,103,65,582,127,330,150,122,58,85,51,30,4,36,18,18,4,4,44,16,28
"2021","North Northamptonshire 004A","E01026962",596,146,74,72,395,42,168,69,62,37,75,32,36,7,98,61,37,12,12,55,20,35
"2021","North Northamptonshire 004B","E01026973",591,146,89,57,389,50,173,61,73,39,78,26,44,8,80,48,32,8,8,56,22,34
"2021","North Northamptonshire 004C","E01026974",481,108,62,46,347,86,160,70,55,35,48,21,22,5,52,25,27,1,1,26,5,21
"2021","North Northamptonshire 004D","E01026975",646,246,117,129,365,35,138,56,49,33,94,40,47,7,94,62,32,4,4,35,12,23
"2021","North Northamptonshire 004E","E01026984",807,255,108,147,480,54,210,80,84,46,98,41,47,10,114,68,46,4,4,72,27,45
"2021","North Northamptonshire 004F","E01026985",851,206,91,115,591,95,220,69,102,49,123,60,54,9,149,107,42,4,4,54,23,31
"2021","North Northamptonshire 005A","E01026949",647,210,86,124,387,41,154,67,53,34,83,40,36,7,92,65,27,17,17,50,22,28
"2021","North Northamptonshire 005B","E01026950",638,183,64,119,357,20,148,48,64,36,69,27,34,8,103,67,36,17,17,98,40,58
"2021","North Northamptonshire 005C","E01026951",517,125,48,77,336,18,143,43,71,29,59,19,33,7,103,64,39,13,13,56,22,34
"2021","North Northamptonshire 005D","E01026952",616,164,66,98,408,52,211,93,87,31,69,32,31,6,72,35,37,4,4,44,20,24
"2021","North Northamptonshire 007A","E01026959",643,183,69,114,397,44,161,62,61,38,95,45,45,5,89,56,33,8,8,63,27,36
"2021","North Northamptonshire 007B","E01026960",624,195,72,123,345,26,122,40,52,30,80,33,41,6,107,66,41,10,10,84,32,52
"2021","North Northamptonshire 007C","E01026961",497,117,37,80,313,25,121,33,55,33,57,20,29,8,102,65,37,8,8,67,23,44
"2021","North Northamptonshire 007D","E01026965",598,161,47,114,347,18,141,43,75,23,78,28,48,2,105,76,29,5,5,90,32,58
"2021","North Northamptonshire 007E","E01026966",575,135,66,69,382,62,170,62,58,50,52,19,25,8,89,57,32,9,9,58,33,25
"2021","North Northamptonshire 007F","E01026967",722,187,83,104,453,56,190,61,100,29,97,43,37,17,103,68,35,7,7,82,32,50
"2021","North Northamptonshire 007G","E01026968",696,207,58,149,407,30,142,47,75,20,107,42,61,4,124,93,31,4,4,82,33,49
"2021","North Northamptonshire 001A","E01027033",840,214,111,103,597,104,318,139,131,48,101,57,33,11,70,34,36,4,4,29,12,17
"2021","North Northamptonshire 001B","E01027043",975,226,115,111,699,149,369,139,172,58,92,49,38,5,87,45,42,2,2,50,26,24
"2021","North Northamptonshire 001C","E01027050",935,228,129,99,671,174,360,161,145,54,80,50,27,3,56,31,25,1,1,36,16,20
"2021","North Northamptonshire 010A","E01027031",876,183,93,90,645,141,371,164,144,63,94,58,31,5,38,14,24,1,1,48,16,32
"2021","North Northamptonshire 010B","E01027044",921,202,118,84,687,157,398,160,177,61,79,45,28,6,53,27,26,0,0,32,11,21
"2021","North Northamptonshire 010C","E01027046",682,174,69,105,489,90,264,87,146,31,68,38,26,4,64,47,17,3,3,19,9,10
"2021","North Northamptonshire 010D","E01027047",589,186,107,79,384,87,192,69,78,45,50,21,23,6,51,25,26,4,4,19,7,12
"2021","North Northamptonshire 010E","E01027048",686,273,135,138,401,102,205,81,93,31,47,35,9,3,46,24,22,1,1,12,2,10
"2021","North Northamptonshire 010F","E01027049",521,202,129,73,309,83,155,66,71,18,29,24,3,2,41,31,10,1,1,10,4,6
"2021","North Northamptonshire 011A","E01027032",813,240,138,102,547,123,303,119,128,56,69,43,21,5,51,30,21,1,1,26,11,15
"2021","North Northamptonshire 011B","E01027045",889,244,124,120,603,120,331,148,125,58,92,48,37,7,55,25,30,5,5,42,16,26
"2021","North Northamptonshire 011C","E01027075",801,184,88,96,579,80,334,115,158,61,105,53,44,8,60,36,24,0,0,38,14,24
"2021","North Northamptonshire 011D","E01027076",976,319,172,147,609,106,286,115,125,46,120,75,38,7,89,51,38,8,8,48,19,29
"2021","North Northamptonshire 011E","E01035407",601,123,46,77,438,42,259,95,130,34,80,40,31,9,57,37,20,0,0,40,19,21
"2021","North Northamptonshire 011F","E01035408",619,125,37,88,476,44,226,70,129,27,158,102,53,3,47,37,10,1,1,18,5,13
"2021","North Northamptonshire 024A","E01027057",954,208,84,124,698,131,340,132,154,54,140,80,53,7,81,58,23,6,6,48,23,25
"2021","North Northamptonshire 024B","E01027074",875,185,105,80,662,160,352,144,144,64,81,44,35,2,67,40,27,2,2,28,10,18
"2021","North Northamptonshire 024C","E01027078",914,229,137,92,657,143,333,168,104,61,108,54,43,11,72,44,28,1,1,28,8,20
"2021","North Northamptonshire 025A","E01027051",924,291,125,166,586,82,233,104,92,37,175,96,74,5,94,59,35,2,2,47,27,20
"2021","North Northamptonshire 025B","E01027052",623,164,68,96,429,68,212,69,96,47,103,63,34,6,43,31,12,3,3,30,12,18
"2021","North Northamptonshire 025C","E01027053",911,207,80,127,669,104,338,143,136,59,149,86,54,9,76,53,23,2,2,35,18,17
"2021","North Northamptonshire 025D","E01027054",508,135,86,49,359,99,171,75,55,41,52,28,17,7,35,16,19,2,2,14,9,5
"2021","North Northamptonshire 025E","E01027055",553,135,79,56,398,66,179,82,76,21,95,52,36,7,55,37,18,3,3,20,10,10
"2021","North Northamptonshire 025F","E01027056",639,185,83,102,405,58,168,60,75,33,89,33,48,8,85,55,30,5,5,49,22,27
"2021","North Northamptonshire 027A","E01027038",826,215,85,130,559,78,224,75,102,47,143,86,49,8,112,69,43,2,2,52,22,30
"2021","North Northamptonshire 027B","E01027039",870,247,80,167,581,81,241,90,118,33,141,67,63,11,112,77,35,6,6,42,19,23
"2021","North Northamptonshire 027C","E01027040",789,257,105,152,500,75,250,102,100,48,110,63,43,4,65,39,26,0,0,32,19,13
"2021","North Northamptonshire 027D","E01027041",757,268,120,148,449,54,166,72,76,18,101,51,43,7,124,89,35,4,4,40,17,23
"2021","North Northamptonshire 027E","E01027042",715,156,60,96,521,60,294,110,137,47,111,60,43,8,51,35,16,5,5,38,21,17
"2021","North Northamptonshire 035A","E01027034",752,295,174,121,426,87,190,75,84,31,72,34,30,8,77,46,31,0,0,31,12,19
"2021","North Northamptonshire 035B","E01027035",640,166,76,90,438,64,174,77,55,42,91,39,49,3,104,66,38,5,5,36,15,21
"2021","North Northamptonshire 035C","E01027037",977,202,96,106,729,109,414,132,207,75,135,58,68,9,66,45,21,5,5,46,24,22
"2021","North Northamptonshire 035D","E01033244",1052,205,91,114,791,113,400,115,221,64,173,88,76,9,101,64,37,4,4,56,33,23
"2021","North Northamptonshire 035E","E01033245",490,150,50,100,319,44,158,73,58,27,68,44,23,1,46,30,16,3,3,21,8,13
"2021","North Northamptonshire 034A","E01027061",1108,273,85,188,764,75,329,125,162,42,210,110,91,9,140,83,57,10,10,71,38,33
"2021","North Northamptonshire 034B","E01027062",1012,336,128,208,618,81,267,95,120,52,130,66,54,10,132,93,39,8,8,58,24,34
"2021","North Northamptonshire 034C","E01027063",763,172,106,66,550,114,283,113,114,56,95,46,38,11,56,30,26,2,2,41,25,16
"2021","North Northamptonshire 034D","E01027064",672,166,93,73,486,110,239,101,96,42,85,30,50,5,50,25,25,2,2,20,7,13
"2021","North Northamptonshire 034E","E01027072",646,138,57,81,463,36,179,54,92,33,110,31,72,7,136,102,34,2,2,45,20,25
"2021","North Northamptonshire 034F","E01027073",905,276,154,122,588,89,265,109,110,46,142,66,68,8,85,54,31,7,7,41,17,24
"2021","North Northamptonshire 037A","E01027058",731,199,97,102,484,63,210,86,99,25,106,36,64,6,102,68,34,3,3,48,25,23
"2021","North Northamptonshire 037B","E01027059",805,302,112,190,462,53,178,64,82,32,141,69,61,11,82,52,30,8,8,41,20,21
"2021","North Northamptonshire 037C","E01027060",1029,419,124,295,539,39,167,59,86,22,167,88,72,7,153,117,36,13,13,71,34,37
"2021","North Northamptonshire 037D","E01027065",916,362,112,250,496,49,181,72,77,32,143,77,57,9,112,73,39,11,11,58,19,39
"2021","North Northamptonshire 037E","E01027069",892,425,152,273,429,65,158,72,57,29,113,65,41,7,89,63,26,4,4,38,17,21
"2021","North Northamptonshire 039A","E01027066",792,145,85,60,599,130,353,131,150,72,73,41,28,4,43,22,21,0,0,48,20,28
"2021","North Northamptonshire 039B","E01027067",755,202,148,54,533,158,241,87,103,51,82,35,37,10,49,20,29,3,3,20,12,8
"2021","North Northamptonshire 039C","E01027070",674,193,110,83,450,92,232,87,97,48,83,45,36,2,40,15,25,3,3,31,13,18
"2021","North Northamptonshire 039D","E01027071",600,138,71,67,440,96,212,70,81,61,84,39,36,9,47,19,28,1,1,22,13,9
"2021","North Northamptonshire 039E","E01035409",576,121,36,85,426,59,234,69,113,52,79,31,42,6,53,31,22,1,1,29,17,12
"2021","North Northamptonshire 039F","E01035410",699,168,71,97,499,63,279,119,122,38,99,47,46,6,56,35,21,2,2,32,13,19
"2021","North Northamptonshire 012A","E01027090",712,163,87,76,513,98,256,114,102,40,107,63,35,9,48,22,26,4,4,36,8,28
"2021","North Northamptonshire 012B","E01027103",720,181,106,75,516,119,254,107,110,37,72,39,29,4,70,35,35,1,1,23,9,14
"2021","North Northamptonshire 012C","E01027129",996,240,134,106,723,173,386,179,141,66,100,64,33,3,61,25,36,3,3,33,15,18
"2021","North Northamptonshire 013A","E01027094",668,194,125,69,451,119,221,98,78,45,73,33,37,3,37,16,21,1,1,23,8,15
"2021","North Northamptonshire 013B","E01027095",668,158,81,77,479,69,233,93,93,47,116,55,56,5,60,36,24,1,1,31,17,14
"2021","North Northamptonshire 013C","E01027107",583,176,90,86,378,66,166,73,62,31,85,42,41,2,59,39,20,2,2,29,13,16
"2021","North Northamptonshire 013D","E01027108",543,117,87,30,409,117,217,82,85,50,47,24,17,6,26,8,18,2,2,17,9,8
"2021","North Northamptonshire 013E","E01027109",502,101,49,52,377,82,179,83,68,28,62,33,26,3,51,33,18,3,3,24,9,15
"2021","North Northamptonshire 013F","E01032969",602,107,17,90,464,30,243,76,139,28,105,48,52,5,85,67,18,1,1,31,13,18
"2021","North Northamptonshire 013G","E01032970",789,177,55,122,573,60,284,81,162,41,148,59,81,8,80,59,21,1,1,39,20,19
"2021","North Northamptonshire 013H","E01032971",561,251,78,173,284,28,113,43,62,8,91,47,40,4,49,33,16,3,3,26,5,21
"2021","North Northamptonshire 014A","E01027123",673,164,95,69,473,99,232,98,94,40,78,30,41,7,63,40,23,1,1,36,17,19
"2021","North Northamptonshire 014B","E01027125",745,163,85,78,547,122,301,118,120,63,79,45,30,4,44,22,22,1,1,35,15,20
"2021","North Northamptonshire 014C","E01027126",1115,388,147,241,687,109,261,100,119,42,190,95,84,11,120,86,34,7,7,40,20,20
"2021","North Northamptonshire 014D","E01035411",678,251,71,180,394,53,126,52,51,23,119,56,53,10,90,66,24,6,6,33,14,19
"2021","North Northamptonshire 014E","E01035412",569,183,70,113,347,35,145,59,59,27,90,55,29,6,73,54,19,4,4,39,16,23
"2021","North Northamptonshire 015A","E01027079",781,227,88,139,491,70,226,79,99,48,95,44,45,6,94,65,29,6,6,63,30,33
"2021","North Northamptonshire 015B","E01027080",761,153,98,55,563,106,286,104,124,58,96,46,41,9,71,27,44,4,4,45,18,27
"2021","North Northamptonshire 015C","E01027087",494,136,71,65,337,66,162,51,72,39,72,41,28,3,34,16,18,3,3,21,8,13
"2021","North Northamptonshire 015D","E01027088",480,86,34,52,380,44,219,65,97,57,74,38,34,2,39,22,17,4,4,14,5,9
"2021","North Northamptonshire 015E","E01027089",849,184,93,91,611,106,351,123,162,66,88,43,37,8,62,33,29,4,4,54,28,26
"2021","North Northamptonshire 016A","E01027081",621,158,69,89,417,40,168,48,95,25,111,42,63,6,98,67,31,0,0,46,15,31
"2021","North Northamptonshire 016B","E01027082",791,254,54,200,481,38,177,51,100,26,137,57,69,11,123,90,33,6,6,56,28,28
"2021","North Northamptonshire 016C","E01027083",661,209,79,130,422,44,155,51,80,24,107,40,56,11,109,73,36,7,7,30,12,18
"2021","North Northamptonshire 016D","E01027127",804,248,90,158,509,41,196,65,94,37,99,39,44,16,162,109,53,11,11,47,26,21
"2021","North Northamptonshire 016E","E01027128",671,142,52,90,484,50,208,53,111,44,91,36,47,8,132,87,45,3,3,45,21,24
"2021","North Northamptonshire 017A","E01027105",1114,422,66,356,538,15,197,59,115,23,169,95,67,7,133,93,40,24,24,154,50,104
"2021","North Northamptonshire 017B","E01027106",902,299,58,241,502,21,187,66,97,24,157,78,73,6,124,88,36,13,13,101,40,61
"2021","North Northamptonshire 017C","E01027111",952,334,67,267,531,23,233,94,104,35,139,72,60,7,111,79,32,25,25,87,29,58
"2021","North Northamptonshire 017D","E01027112",1003,326,74,252,592,43,249,75,143,31,141,66,65,10,149,94,55,10,10,85,39,46
"2021","North Northamptonshire 018A","E01027104",1147,476,142,334,570,62,226,77,126,23,157,76,78,3,108,75,33,17,17,101,36,65
"2021","North Northamptonshire 018B","E01027113",1005,391,149,242,547,69,264,81,140,43,114,67,45,2,92,53,39,8,8,67,29,38
"2021","North Northamptonshire 018C","E01027115",799,191,100,91,572,82,293,91,150,52,111,64,46,1,80,60,20,6,6,36,23,13
"2021","North Northamptonshire 018D","E01027116",799,144,42,102,604,47,372,100,217,55,119,62,50,7,62,48,14,4,4,51,29,22
"2021","North Northamptonshire 018E","E01027117",614,200,106,94,379,64,217,80,106,31,49,28,17,4,42,28,14,7,7,35,15,20
"2021","North Northamptonshire 018F","E01035413",595,350,135,215,218,26,71,34,33,4,71,40,29,2,47,33,14,3,3,27,6,21
"2021","North Northamptonshire 018G","E01035414",645,370,145,225,241,15,83,36,40,7,65,44,19,2,64,41,23,14,14,34,9,25
"2021","North Northamptonshire 019A","E01027096",457,101,60,41,331,68,166,54,76,36,59,33,25,1,37,22,15,1,1,25,13,12
"2021","North Northamptonshire 019B","E01027097",621,143,77,66,441,110,205,68,99,38,69,25,42,2,57,37,20,0,0,37,19,18
"2021","North Northamptonshire 019C","E01027098",480,132,67,65,320,42,184,67,86,31,52,23,24,5,40,24,16,2,2,28,15,13
"2021","North Northamptonshire 019D","E01027099",664,189,132,57,451,115,206,77,91,38,77,43,29,5,51,21,30,2,2,24,16,8
"2021","North Northamptonshire 019E","E01027122",503,134,92,42,346,93,159,51,68,40,55,19,29,7,37,17,20,2,2,23,12,11
"2021","North Northamptonshire 022A","E01027100",772,250,162,88,481,88,229,83,108,38,81,36,41,4,79,51,28,4,4,41,5,36
"2021","North Northamptonshire 022B","E01027114",694,192,79,113,468,79,231,73,103,55,83,40,35,8,74,48,26,1,1,34,13,21
"2021","North Northamptonshire 022C","E01027130",786,211,99,112,533,94,242,83,117,42,91,40,40,11,97,70,27,9,9,42,18,24
"2021","North Northamptonshire 022D","E01027131",1027,411,140,271,561,30,213,75,92,46,157,85,61,11,155,105,50,6,6,55,18,37
"2021","North Northamptonshire 021A","E01027084",943,224,132,92,697,116,354,98,186,70,145,63,76,6,79,49,30,3,3,22,13,9
"2021","North Northamptonshire 021B","E01027085",640,159,102,57,453,92,193,63,98,32,92,35,45,12,75,44,31,1,1,28,11,17
"2021","North Northamptonshire 021C","E01027086",836,181,105,76,619,113,319,107,157,55,122,59,56,7,64,44,20,1,1,36,20,16
"2021","North Northamptonshire 021D","E01027120",523,126,42,84,376,44,224,83,85,56,72,35,33,4,36,20,16,0,0,21,10,11
"2021","North Northamptonshire 021E","E01027121",877,134,51,83,700,126,387,133,200,54,134,66,58,10,52,37,15,1,1,43,27,16
"2021","North Northamptonshire 026A","E01027326",744,256,141,115,466,110,210,91,67,52,92,58,29,5,54,38,16,0,0,22,11,11
"2021","North Northamptonshire 026B","E01027327",731,266,122,144,437,65,179,71,64,44,94,60,27,7,96,58,38,3,3,28,14,14
"2021","North Northamptonshire 026C","E01027328",652,206,94,112,426,69,176,60,78,38,92,48,36,8,88,52,36,1,1,20,9,11
"2021","North Northamptonshire 026D","E01027338",1020,234,124,110,748,158,414,184,160,70,113,66,38,9,61,41,20,2,2,38,13,25
"2021","North Northamptonshire 028A","E01027330",670,155,59,96,446,36,186,54,94,38,92,42,46,4,128,82,46,4,4,69,43,26
"2021","North Northamptonshire 028B","E01027331",643,216,91,125,368,47,143,47,71,25,79,35,41,3,93,65,28,6,6,59,25,34
"2021","North Northamptonshire 028C","E01027332",646,163,116,47,433,107,238,88,100,50,58,34,19,5,28,3,25,2,2,50,27,23
"2021","North Northamptonshire 028D","E01027333",854,152,62,90,648,95,394,131,181,82,94,40,46,8,61,31,30,4,4,54,25,29
"2021","North Northamptonshire 028E","E01027334",512,117,28,89,348,7,116,20,74,22,63,17,40,6,157,111,46,5,5,47,29,18
"2021","North Northamptonshire 029A","E01027343",613,174,96,78,401,81,201,79,69,53,69,30,39,0,49,33,16,1,1,38,15,23
"2021","North Northamptonshire 029B","E01027344",646,189,109,80,412,100,203,82,86,35,61,36,20,5,45,23,22,3,3,45,21,24
"2021","North Northamptonshire 029C","E01027345",489,80,49,31,379,61,244,85,98,61,27,11,15,1,46,18,28,1,1,30,16,14
"2021","North Northamptonshire 029D","E01027346",580,130,45,85,400,47,229,75,99,55,80,37,39,4,41,25,16,3,3,50,25,25
"2021","North Northamptonshire 029E","E01027347",745,146,79,67,558,121,302,105,127,70,72,29,41,2,61,34,27,2,2,41,18,23
"2021","North Northamptonshire 030A","E01027313",672,174,63,111,376,34,198,48,101,49,76,46,24,6,60,31,29,8,8,122,56,66
"2021","North Northamptonshire 030B","E01027314",962,349,95,254,478,32,196,72,100,24,128,66,55,7,104,61,43,18,18,135,49,86
"2021","North Northamptonshire 030C","E01027316",915,240,71,169,569,47,266,75,149,42,137,67,64,6,110,68,42,9,9,106,59,47
"2021","North Northamptonshire 030D","E01035429",656,201,30,171,424,8,173,60,100,13,160,106,48,6,74,57,17,9,9,31,14,17
"2021","North Northamptonshire 030E","E01035430",907,255,83,172,584,33,259,75,142,42,160,88,66,6,111,71,40,21,21,68,24,44
"2021","North Northamptonshire 031A","E01027339",554,142,58,84,381,19,131,33,71,27,78,24,51,3,150,111,39,3,3,31,18,13
"2021","North Northamptonshire 031B","E01027340",650,178,91,87,425,72,178,57,82,39,75,29,40,6,94,60,34,6,6,47,21,26
"2021","North Northamptonshire 031C","E01027341",657,175,69,106,425,29,155,45,75,35,100,39,53,8,137,101,36,4,4,57,27,30
"2021","North Northamptonshire 031D","E01027342",725,266,112,154,407,36,150,47,80,23,119,60,54,5,101,76,25,1,1,52,29,23
"2021","North Northamptonshire 032A","E01027350",699,251,93,158,405,64,183,69,78,36,77,32,41,4,77,37,40,4,4,43,18,25
"2021","North Northamptonshire 032B","E01027351",768,307,127,180,421,55,170,67,72,31,85,34,45,6,98,58,40,13,13,40,19,21
"2021","North Northamptonshire 032C","E01027352",631,224,96,128,336,41,143,46,67,30,76,41,30,5,70,35,35,6,6,71,34,37
"2021","North Northamptonshire 032D","E01035431",675,288,59,229,322,18,125,44,63,18,97,76,18,3,71,50,21,11,11,65,19,46
"2021","North Northamptonshire 032E","E01035432",589,285,76,209,276,28,73,29,33,11,66,46,18,2,105,83,22,4,4,28,12,16
"2021","North Northamptonshire 033A","E01027309",653,168,102,66,445,111,207,86,75,46,77,41,32,4,46,19,27,4,4,40,19,21
"2021","North Northamptonshire 033B","E01027310",598,165,48,117,361,15,128,38,72,18,76,22,50,4,139,94,45,3,3,72,40,32
"2021","North Northamptonshire 033C","E01027311",519,133,90,43,343,66,185,64,79,42,45,24,19,2,43,21,22,4,4,43,17,26
"2021","North Northamptonshire 033D","E01027312",642,192,89,103,411,58,178,55,80,43,89,42,45,2,83,56,27,3,3,39,27,12
"2021","North Northamptonshire 036A","E01027317",660,214,107,107,396,60,180,70,83,27,73,25,43,5,79,55,24,4,4,50,26,24
"2021","North Northamptonshire 036B","E01027318",597,132,45,87,432,18,143,53,63,27,84,32,43,9,180,148,32,7,7,33,15,18
"2021","North Northamptonshire 036C","E01027319",617,147,62,85,428,37,198,73,88,37,99,40,52,7,92,57,35,2,2,42,22,20
"2021","North Northamptonshire 036D","E01027320",803,179,82,97,560,42,271,80,148,43,132,57,67,8,106,74,32,9,9,64,42,22
"2021","North Northamptonshire 036E","E01027321",654,117,35,82,493,33,295,95,145,55,93,48,37,8,70,44,26,2,2,44,19,25
"2021","North Northamptonshire 038A","E01027322",556,179,95,84,363,70,188,79,76,33,69,40,27,2,36,20,16,0,0,14,5,9
"2021","North Northamptonshire 038B","E01027323",832,196,79,117,608,75,295,112,148,35,144,64,74,6,90,60,30,4,4,28,12,16
"2021","North Northamptonshire 038C","E01027324",500,121,78,43,366,106,187,80,82,25,39,17,18,4,33,15,18,1,1,13,5,8
"2021","North Northamptonshire 038D","E01027325",839,248,104,144,561,83,253,94,120,39,127,78,42,7,97,69,28,1,1,30,14,16
"2021","North Northamptonshire 038E","E01027329",810,240,146,94,539,150,256,117,94,45,77,43,30,4,54,30,24,2,2,31,13,18
"2021","North Northamptonshire 038F","E01027353",986,287,161,126,662,162,337,188,110,39,102,66,26,10,59,26,33,2,2,37,11,26
"2021","North Northamptonshire 040A","E01027335",635,148,90,58,462,134,215,86,71,58,63,32,26,5,44,21,23,6,6,25,13,12
"2021","North Northamptonshire 040B","E01027336",695,238,123,115,424,60,190,62,86,42,93,44,44,5,76,49,27,5,5,33,16,17
"2021","North Northamptonshire 040C","E01027337",796,243,108,135,519,91,252,106,99,47,107,52,45,10,67,39,28,2,2,34,18,16
"2021","North Northamptonshire 040D","E01027348",950,264,137,127,649,130,321,153,125,43,112,62,41,9,82,50,32,4,4,37,9,28
"2021","North Northamptonshire 040E","E01027354",1071,320,151,169,702,84,361,138,159,64,134,74,54,6,119,81,38,4,4,49,22,27
"2021","North Northamptonshire 040F","E01027355",680,153,88,65,501,122,259,92,118,49,68,34,29,5,52,33,19,0,0,26,16,10
"2021","North Northamptonshire 009A","E01026953",604,150,87,63,420,105,194,84,58,52,68,31,30,7,51,25,26,2,2,34,17,17
"2021","North Northamptonshire 009B","E01026954",578,119,47,72,396,37,149,57,56,36,87,28,46,13,118,71,47,5,5,63,29,34
"2021","North Northamptonshire 009C","E01026955",566,98,54,44,439,92,260,110,92,58,60,28,30,2,23,13,10,4,4,29,9,20
"2021","North Northamptonshire 009D","E01026956",921,252,102,150,598,44,279,98,137,44,134,68,60,6,137,83,54,4,4,71,42,29
"2021","North Northamptonshire 008A","E01026963",545,138,48,90,368,17,159,47,78,34,86,41,40,5,101,77,24,5,5,39,23,16
"2021","North Northamptonshire 008B","E01032963",626,135,44,91,459,25,255,102,110,43,103,61,33,9,69,49,20,7,7,32,12,20
"2021","North Northamptonshire 008C","E01032964",650,94,26,68,481,24,273,78,159,36,99,35,59,5,80,59,21,5,5,75,42,33
"2021","North Northamptonshire 008D","E01032965",631,90,17,73,477,25,285,69,197,19,103,43,57,3,59,48,11,5,5,64,37,27
"2021","North Northamptonshire 008E","E01032966",894,103,19,84,691,23,416,93,275,48,147,70,77,0,95,68,27,10,10,100,59,41
"2021","North Northamptonshire 008F","E01032967",833,87,17,70,652,19,407,77,290,40,128,54,68,6,89,63,26,9,9,94,49,45
"2021","North Northamptonshire 020A","E01027119",749,208,132,76,521,105,262,120,99,43,99,50,43,6,50,28,22,5,5,20,5,15
"2021","North Northamptonshire 020B","E01032972",649,145,79,66,482,87,270,126,111,33,87,57,25,5,35,13,22,3,3,22,9,13
"2021","North Northamptonshire 020C","E01032973",593,88,28,60,480,36,321,82,206,33,71,36,35,0,50,39,11,2,2,25,16,9
"2021","North Northamptonshire 020D","E01032974",587,129,49,80,442,58,258,88,128,42,80,51,27,2,46,32,14,0,0,16,5,11
"2021","North Northamptonshire 023A","E01027091",799,213,104,109,545,86,233,79,105,49,108,47,56,5,110,69,41,8,8,41,15,26
"2021","North Northamptonshire 023B","E01027092",758,178,99,79,538,92,253,96,111,46,110,54,55,1,79,59,20,4,4,42,23,19
"2021","North Northamptonshire 023C","E01027102",803,207,111,96,559,103,251,91,103,57,118,50,60,8,83,47,36,4,4,37,14,23
"2021","North Northamptonshire 023D","E01035415",1001,168,46,122,797,47,431,141,243,47,194,106,80,8,119,92,27,6,6,36,21,15
"2021","North Northamptonshire 023E","E01035416",886,284,105,179,561,50,265,94,130,41,130,65,62,3,113,81,32,3,3,41,16,25
"2021","West Northamptonshire 001A","E01027005",920,195,108,87,694,119,419,155,182,82,86,50,30,6,66,37,29,4,4,31,11,20
"2021","West Northamptonshire 001B","E01027026",879,189,100,89,654,127,382,156,165,61,84,46,29,9,57,28,29,4,4,36,19,17
"2021","West Northamptonshire 001C","E01027030",779,188,117,71,544,93,312,132,121,59,89,62,24,3,47,21,26,3,3,47,11,36
"2021","West Northamptonshire 002A","E01027000",641,199,108,91,412,64,212,71,105,36,68,33,25,10,63,34,29,5,5,30,9,21
"2021","West Northamptonshire 002B","E01027001",761,125,49,76,611,57,394,129,195,70,98,44,49,5,61,48,13,1,1,25,13,12
"2021","West Northamptonshire 002C","E01027002",673,130,67,63,519,111,302,128,127,47,72,43,25,4,30,21,9,4,4,24,16,8
"2021","West Northamptonshire 002D","E01027003",640,199,86,113,409,76,188,72,89,27,80,41,33,6,62,40,22,3,3,32,14,18
"2021","West Northamptonshire 002E","E01027022",771,183,121,62,562,118,290,111,122,57,102,60,39,3,51,33,18,1,1,26,13,13
"2021","West Northamptonshire 004A","E01026994",519,134,82,52,364,76,191,93,74,24,66,46,17,3,28,14,14,3,3,21,6,15
"2021","West Northamptonshire 004B","E01026999",821,223,131,92,568,151,269,121,107,41,75,43,26,6,73,42,31,0,0,30,13,17
"2021","West Northamptonshire 004C","E01027006",1031,234,120,114,747,114,443,158,216,69,117,60,52,5,72,52,20,1,1,50,21,29
"2021","West Northamptonshire 004D","E01035399",547,124,86,38,397,118,192,73,84,35,55,36,16,3,32,16,16,0,0,26,12,14
"2021","West Northamptonshire 004E","E01035400",422,104,60,44,301,71,141,56,57,28,50,27,16,7,36,24,12,3,3,17,6,11
"2021","West Northamptonshire 005A","E01026998",986,199,79,120,733,118,410,167,182,61,136,79,49,8,66,49,17,3,3,54,19,35
"2021","West Northamptonshire 005B","E01027015",598,136,92,44,439,92,219,92,92,35,74,42,27,5,53,34,19,1,1,23,13,10
"2021","West Northamptonshire 005C","E01027016",638,171,85,86,436,75,250,98,99,53,72,34,35,3,36,21,15,3,3,31,10,21
"2021","West Northamptonshire 005D","E01027021",795,193,108,85,576,143,310,121,129,60,75,45,21,9,47,29,18,1,1,26,8,18
"2021","West Northamptonshire 005E","E01027027",1070,226,119,107,801,101,463,152,234,77,134,66,57,11,102,72,30,1,1,43,21,22
"2021","West Northamptonshire 003A","E01027018",1014,198,104,94,770,128,403,143,185,75,160,85,71,4,76,45,31,3,3,46,16,30
"2021","West Northamptonshire 003B","E01027019",855,230,119,111,589,69,269,82,142,45,144,74,60,10,103,69,34,4,4,36,17,19
"2021","West Northamptonshire 003C","E01027020",739,197,115,82,519,84,263,89,125,49,100,56,40,4,68,35,33,4,4,23,11,12
"2021","West Northamptonshire 003D","E01027023",884,208,111,97,641,136,342,132,148,62,86,52,31,3,72,44,28,5,5,35,12,23
"2021","West Northamptonshire 003E","E01035401",641,121,57,64,489,100,290,115,126,49,58,33,21,4,41,24,17,0,0,31,17,14
"2021","West Northamptonshire 003F","E01035402",511,96,28,68,392,12,171,40,117,14,161,102,57,2,46,42,4,2,2,23,12,11
"2021","West Northamptonshire 010A","E01026987",514,126,83,43,358,80,194,81,66,47,48,26,17,5,31,16,15,5,5,30,12,18
"2021","West Northamptonshire 010B","E01026989",610,180,53,127,397,36,195,73,80,42,85,49,31,5,75,47,28,6,6,33,9,24
"2021","West Northamptonshire 010C","E01027012",982,246,103,143,671,99,314,114,151,49,144,75,63,6,107,76,31,7,7,65,28,37
"2021","West Northamptonshire 010D","E01035403",639,177,29,148,402,13,183,59,105,19,124,76,42,6,74,59,15,8,8,60,19,41
"2021","West Northamptonshire 010E","E01035404",588,88,44,44,466,60,284,102,130,52,76,38,32,6,44,23,21,2,2,34,20,14
"2021","West Northamptonshire 010F","E01035405",700,145,24,121,520,31,253,83,145,25,168,104,55,9,64,45,19,4,4,35,19,16
"2021","West Northamptonshire 010G","E01035406",721,173,46,127,511,65,268,103,120,45,119,70,42,7,58,37,21,1,1,37,15,22
"2021","West Northamptonshire 016A","E01026986",1157,287,94,193,783,72,395,119,210,66,165,76,76,13,143,94,49,8,8,87,47,40
"2021","West Northamptonshire 016B","E01026988",619,155,62,93,406,24,169,48,77,44,95,47,39,9,113,75,38,5,5,58,25,33
"2021","West Northamptonshire 016C","E01026991",775,273,179,94,475,181,197,101,57,39,63,42,19,2,33,13,20,1,1,27,10,17
"2021","West Northamptonshire 016D","E01026992",1027,496,187,309,471,74,185,71,78,36,120,72,45,3,85,54,31,7,7,60,23,37
"2021","West Northamptonshire 016E","E01027010",534,116,74,42,392,91,205,73,96,36,58,34,22,2,37,15,22,1,1,26,12,14
"2021","West Northamptonshire 022A","E01027007",659,149,47,102,445,52,209,59,109,41,96,34,53,9,82,54,28,6,6,65,33,32
"2021","West Northamptonshire 022B","E01027008",905,282,102,180,576,96,293,142,110,41,119,74,38,7,59,31,28,9,9,47,20,27
"2021","West Northamptonshire 022C","E01027009",631,168,74,94,403,29,179,45,104,30,91,37,52,2,98,63,35,6,6,60,34,26
"2021","West Northamptonshire 022D","E01027013",699,194,66,128,441,25,146,31,78,37,110,30,69,11,151,97,54,9,9,64,37,27
"2021","West Northamptonshire 027A","E01027011",946,242,127,115,656,147,349,159,129,61,105,58,43,4,54,37,17,1,1,48,22,26
"2021","West Northamptonshire 027B","E01027017",859,284,133,151,536,80,257,89,123,45,100,63,33,4,92,59,33,7,7,39,18,21
"2021","West Northamptonshire 027C","E01027024",749,170,87,83,546,123,295,132,113,50,81,52,24,5,46,27,19,1,1,33,16,17
"2021","West Northamptonshire 027D","E01027025",811,285,123,162,495,82,221,84,100,37,102,51,47,4,86,55,31,4,4,31,13,18
"2021","West Northamptonshire 042A","E01026993",875,212,117,95,611,141,350,167,120,63,77,51,16,10,39,19,20,4,4,52,14,38
"2021","West Northamptonshire 042B","E01027004",832,222,121,101,562,121,303,137,116,50,76,49,21,6,57,29,28,5,5,48,18,30
"2021","West Northamptonshire 042C","E01027028",937,260,120,140,644,105,347,147,129,71,113,72,33,8,74,41,33,5,5,33,17,16
"2021","West Northamptonshire 042D","E01027029",988,265,94,171,679,56,342,127,158,57,179,83,85,11,100,74,26,2,2,44,23,21
"2021","West Northamptonshire 006A","E01027145",609,138,82,56,415,83,185,52,89,44,74,41,25,8,64,36,28,9,9,56,27,29
"2021","West Northamptonshire 006B","E01027148",582,121,65,56,431,74,228,70,100,58,78,34,36,8,49,18,31,2,2,30,13,17
"2021","West Northamptonshire 006C","E01027149",603,183,87,96,393,99,178,72,78,28,65,37,25,3,47,29,18,4,4,27,15,12
"2021","West Northamptonshire 006D","E01027232",847,209,70,139,567,49,250,81,135,34,156,86,59,11,104,73,31,8,8,71,33,38
"2021","West Northamptonshire 007A","E01027218",717,245,146,99,430,110,203,84,73,46,70,38,29,3,44,20,24,3,3,42,19,23
"2021","West Northamptonshire 007B","E01027219",819,245,158,87,530,134,233,92,83,58,98,55,34,9,58,27,31,7,7,44,17,27
"2021","West Northamptonshire 007C","E01027221",803,233,130,103,529,102,260,91,118,51,78,45,30,3,85,53,32,4,4,41,16,25
"2021","West Northamptonshire 007D","E01027222",492,102,62,40,374,68,204,83,81,40,59,31,23,5,42,25,17,1,1,16,8,8
"2021","West Northamptonshire 008A","E01027143",652,162,75,87,454,76,202,75,93,34,118,44,68,6,57,38,19,1,1,36,18,18
"2021","West Northamptonshire 008B","E01027144",646,154,109,45,466,145,225,76,91,58,50,27,20,3,45,15,30,1,1,26,10,16
"2021","West Northamptonshire 008C","E01027146",665,188,108,80,440,101,225,72,95,58,69,34,30,5,42,21,21,3,3,37,15,22
"2021","West Northamptonshire 008D","E01027147",941,377,180,197,512,86,212,72,115,25,114,56,50,8,92,61,31,8,8,52,28,24
"2021","West Northamptonshire 011A","E01027195",656,188,39,149,382,15,158,33,90,35,69,28,37,4,130,87,43,10,10,86,44,42
"2021","West Northamptonshire 011B","E01027245",681,183,65,118,438,46,200,67,92,41,84,30,43,11,105,84,21,3,3,60,31,29
"2021","West Northamptonshire 011C","E01027247",673,156,53,103,442,34,247,60,137,50,78,32,42,4,77,46,31,6,6,75,45,30
"2021","West Northamptonshire 011D","E01027248",579,116,45,71,390,16,141,41,74,26,96,27,61,8,131,99,32,6,6,73,36,37
"2021","West Northamptonshire 011E","E01027249",667,145,51,94,437,32,159,33,102,24,97,32,57,8,143,95,48,6,6,85,37,48
"2021","West Northamptonshire 009A","E01027174",521,100,63,37,394,94,210,84,77,49,56,24,23,9,33,17,16,1,1,27,13,14
"2021","West Northamptonshire 009B","E01027175",624,140,48,92,417,25,193,61,95,37,95,50,40,5,97,59,38,7,7,67,41,26
"2021","West Northamptonshire 009C","E01027178",785,189,55,134,524,20,185,45,110,30,124,47,67,10,184,138,46,11,11,72,39,33
"2021","West Northamptonshire 009D","E01027200",591,149,51,98,386,26,146,49,80,17,91,37,44,10,121,80,41,2,2,56,29,27
"2021","West Northamptonshire 009E","E01027246",747,189,59,130,474,32,189,53,106,30,95,42,48,5,144,102,42,14,14,84,42,42
"2021","West Northamptonshire 012A","E01027171",732,287,134,153,400,64,204,62,100,42,56,24,30,2,71,43,28,5,5,45,18,27
"2021","West Northamptonshire 012B","E01027172",668,178,104,74,441,94,221,61,120,40,71,30,32,9,54,31,23,1,1,49,25,24
"2021","West Northamptonshire 012C","E01027182",602,165,114,51,407,99,198,62,87,49,50,25,24,1,54,28,26,6,6,30,14,16
"2021","West Northamptonshire 012D","E01027183",715,206,126,80,471,120,212,86,82,44,69,36,26,7,67,46,21,3,3,38,17,21
"2021","West Northamptonshire 014A","E01027196",538,82,57,25,347,51,158,47,72,39,48,16,26,6,82,60,22,8,8,109,66,43
"2021","West Northamptonshire 014B","E01027197",595,140,74,66,403,30,192,57,91,44,79,34,40,5,97,64,33,5,5,52,31,21
"2021","West Northamptonshire 014C","E01027198",737,237,62,175,419,17,170,46,90,34,102,30,65,7,126,91,35,4,4,81,38,43
"2021","West Northamptonshire 014D","E01027199",498,124,50,74,310,21,127,31,73,23,46,13,29,4,110,75,35,6,6,64,39,25
"2021","West Northamptonshire 013A","E01027190",781,318,174,144,423,81,194,79,79,36,88,60,23,5,54,31,23,6,6,40,23,17
"2021","West Northamptonshire 013B","E01027191",922,326,79,247,531,38,239,72,124,43,130,81,46,3,113,71,42,11,11,65,22,43
"2021","West Northamptonshire 013C","E01027193",637,156,84,72,453,96,231,87,95,49,81,45,31,5,44,24,20,1,1,28,10,18
"2021","West Northamptonshire 013D","E01027194",624,193,125,68,401,100,194,66,80,48,62,25,32,5,45,17,28,0,0,30,14,16
"2021","West Northamptonshire 015A","E01027192",575,149,46,103,339,21,146,44,82,20,102,47,50,5,59,41,18,11,11,87,23,64
"2021","West Northamptonshire 015B","E01027229",636,147,55,92,403,31,155,42,85,28,65,29,32,4,136,92,44,16,16,86,44,42
"2021","West Northamptonshire 015C","E01027230",691,153,43,110,474,15,187,56,105,26,105,42,50,13,163,124,39,4,4,64,22,42
"2021","West Northamptonshire 015D","E01027231",830,313,104,209,444,27,186,55,94,37,77,38,34,5,142,93,49,12,12,73,35,38
"2021","West Northamptonshire 018A","E01027179",817,198,90,108,542,49,296,80,164,52,106,44,53,9,84,47,37,7,7,77,44,33
"2021","West Northamptonshire 018B","E01027180",822,245,139,106,527,95,257,76,140,41,89,41,43,5,78,48,30,8,8,50,27,23
"2021","West Northamptonshire 018C","E01027181",803,281,187,94,484,122,230,74,114,42,80,45,32,3,49,23,26,3,3,38,14,24
"2021","West Northamptonshire 026A","E01027140",667,205,74,131,383,34,163,67,67,29,87,38,41,8,94,61,33,5,5,79,34,45
"2021","West Northamptonshire 026B","E01027142",633,185,93,92,401,72,188,61,90,37,65,30,32,3,71,45,26,5,5,47,27,20
"2021","West Northamptonshire 026C","E01027176",599,165,85,80,387,59,200,74,83,43,73,36,34,3,54,26,28,1,1,47,24,23
"2021","West Northamptonshire 026D","E01027177",692,198,76,122,431,34,169,48,93,28,100,38,54,8,124,83,41,4,4,63,41,22
"2021","West Northamptonshire 017A","E01027168",763,266,80,186,437,25,172,30,109,33,76,24,41,11,162,114,48,2,2,60,33,27
"2021","West Northamptonshire 017B","E01027169",559,120,55,65,377,51,203,55,104,44,67,33,29,5,53,29,24,3,3,62,32,30
"2021","West Northamptonshire 017C","E01027170",635,171,61,110,406,16,158,37,97,24,87,35,40,12,135,88,47,10,10,58,34,24
"2021","West Northamptonshire 017D","E01027173",615,119,40,79,427,25,210,41,111,58,67,19,41,7,110,70,40,15,15,69,34,35
"2021","West Northamptonshire 019A","E01027136",754,276,55,221,388,17,179,47,99,33,108,69,35,4,68,47,21,16,16,90,24,66
"2021","West Northamptonshire 019B","E01027186",663,141,61,80,445,61,247,74,123,50,78,39,35,4,55,33,22,4,4,77,27,50
"2021","West Northamptonshire 019C","E01027188",767,198,66,132,503,40,218,65,113,40,98,30,60,8,135,87,48,12,12,66,32,34
"2021","West Northamptonshire 019D","E01027220",605,193,136,57,378,94,178,65,65,48,58,23,29,6,43,16,27,5,5,34,11,23
"2021","West Northamptonshire 023A","E01027208",614,157,70,87,439,71,237,83,111,43,89,59,24,6,41,28,13,1,1,18,5,13
"2021","West Northamptonshire 023B","E01027209",547,177,46,131,354,38,189,76,79,34,80,49,27,4,44,29,15,3,3,16,5,11
"2021","West Northamptonshire 023C","E01027211",641,202,131,71,414,130,175,71,69,35,65,34,27,4,43,17,26,1,1,25,15,10
"2021","West Northamptonshire 023D","E01027212",622,146,47,99,450,55,237,89,105,43,90,40,48,2,66,45,21,2,2,26,16,10
"2021","West Northamptonshire 025A","E01027184",659,253,84,169,331,18,147,48,78,21,98,58,32,8,58,40,18,10,10,75,17,58
"2021","West Northamptonshire 025B","E01027185",549,219,70,149,273,18,129,46,60,23,65,31,31,3,54,35,19,7,7,57,29,28
"2021","West Northamptonshire 025C","E01027187",606,224,62,162,298,24,133,61,54,18,75,55,14,6,48,26,22,18,18,84,25,59
"2021","West Northamptonshire 025D","E01027189",755,224,94,130,453,47,192,82,81,29,117,61,54,2,85,57,28,12,12,78,37,41
"2021","West Northamptonshire 024A","E01027137",636,176,86,90,389,30,177,46,92,39,73,29,34,10,96,61,35,13,13,71,38,33
"2021","West Northamptonshire 024B","E01027138",634,163,74,89,426,76,219,76,99,44,65,33,27,5,60,36,24,6,6,45,19,26
"2021","West Northamptonshire 024C","E01027139",663,203,56,147,405,29,215,61,100,54,79,42,31,6,78,41,37,4,4,55,26,29
"2021","West Northamptonshire 024D","E01027141",774,132,49,83,575,80,341,119,156,66,89,50,34,5,62,38,24,3,3,67,40,27
"2021","West Northamptonshire 024E","E01027259",607,105,50,55,440,91,232,73,100,59,58,28,28,2,54,31,23,5,5,62,31,31
"2021","West Northamptonshire 021A","E01027239",681,218,80,138,399,16,183,41,118,24,76,28,40,8,114,82,32,10,10,64,48,16
"2021","West Northamptonshire 021B","E01027241",716,206,50,156,395,18,168,42,94,32,84,40,29,15,109,83,26,16,16,115,48,67
"2021","West Northamptonshire 021C","E01027242",618,143,59,84,405,30,203,49,116,38,76,31,35,10,92,59,33,4,4,70,45,25
"2021","West Northamptonshire 021D","E01027243",705,202,64,138,434,22,179,50,110,19,95,33,56,6,128,84,44,10,10,69,40,29
"2021","West Northamptonshire 021E","E01027244",684,223,41,182,420,21,141,28,98,15,89,24,55,10,162,121,41,7,7,41,28,13
"2021","West Northamptonshire 020A","E01027213",709,229,76,153,445,70,206,61,111,34,82,38,38,6,80,49,31,7,7,35,15,20
"2021","West Northamptonshire 020B","E01027214",738,250,97,153,432,70,159,54,80,25,97,49,41,7,100,70,30,6,6,56,30,26
"2021","West Northamptonshire 020C","E01027216",913,300,155,145,570,108,295,110,150,35,98,46,43,9,64,41,23,5,5,43,25,18
"2021","West Northamptonshire 020D","E01027240",509,140,70,70,320,42,145,49,66,30,48,20,24,4,84,52,32,1,1,49,28,21
"2021","West Northamptonshire 028A","E01027207",610,167,118,49,411,103,194,70,83,41,69,31,31,7,44,19,25,1,1,32,16,16
"2021","West Northamptonshire 028B","E01027210",458,94,67,27,334,60,147,48,64,35,71,29,38,4,51,29,22,5,5,30,17,13
"2021","West Northamptonshire 028C","E01027215",614,145,87,58,439,76,219,79,91,49,69,30,31,8,75,38,37,0,0,30,11,19
"2021","West Northamptonshire 028D","E01027217",1060,322,179,143,692,120,343,137,163,43,136,77,52,7,87,59,28,6,6,46,19,27
"2021","West Northamptonshire 029A","E01027255",627,138,85,53,459,100,248,76,123,49,62,25,30,7,46,30,16,3,3,30,16,14
"2021","West Northamptonshire 029B","E01027256",630,176,121,55,434,88,255,79,115,61,50,24,25,1,38,23,15,3,3,20,11,9
"2021","West Northamptonshire 029C","E01027258",498,76,30,46,395,57,251,74,114,63,44,25,15,4,41,18,23,2,2,27,17,10
"2021","West Northamptonshire 029D","E01027260",641,163,115,48,437,113,245,77,106,62,40,19,16,5,37,19,18,2,2,41,19,22
"2021","West Northamptonshire 032A","E01027152",780,230,49,181,418,6,173,58,90,25,114,68,39,7,97,67,30,28,28,132,43,89
"2021","West Northamptonshire 032B","E01027153",1165,589,110,479,460,4,205,97,95,13,121,84,34,3,104,82,22,26,26,116,30,86
"2021","West Northamptonshire 032C","E01027154",843,216,49,167,482,16,185,57,106,22,142,73,56,13,113,76,37,26,26,145,48,97
"2021","West Northamptonshire 032D","E01032978",839,368,46,322,408,6,179,57,112,10,88,43,42,3,117,84,33,18,18,63,15,48
"2021","West Northamptonshire 032E","E01032979",777,356,38,318,368,14,119,48,62,9,102,68,30,4,113,83,30,20,20,53,21,32
"2021","West Northamptonshire 030A","E01027132",960,344,70,274,475,11,175,53,97,25,162,114,40,8,107,77,30,20,20,141,37,104
"2021","West Northamptonshire 030B","E01027133",824,275,100,175,409,31,162,50,87,25,118,77,40,1,79,47,32,19,19,140,59,81
"2021","West Northamptonshire 030C","E01027134",719,214,51,163,370,17,154,46,78,30,116,65,44,7,64,44,20,19,19,135,51,84
"2021","West Northamptonshire 030D","E01027135",756,224,82,142,459,53,227,77,118,32,95,58,32,5,73,52,21,11,11,73,24,49
"2021","West Northamptonshire 031A","E01027155",1062,344,71,273,532,15,215,78,127,10,137,89,43,5,126,91,35,39,39,186,61,125
"2021","West Northamptonshire 031B","E01027225",760,261,30,231,362,11,154,59,83,12,88,54,28,6,80,55,25,29,29,137,36,101
"2021","West Northamptonshire 031C","E01027227",742,219,35,184,369,10,174,54,102,18,103,68,32,3,66,43,23,16,16,154,59,95
"2021","West Northamptonshire 031D","E01027228",1027,341,54,287,502,5,217,88,104,25,169,119,48,2,79,52,27,32,32,184,55,129
"2021","West Northamptonshire 033A","E01027151",812,264,43,221,421,12,172,51,93,28,116,56,54,6,103,70,33,18,18,127,55,72
"2021","West Northamptonshire 033B","E01027236",700,235,128,107,429,98,180,79,68,33,91,55,28,8,57,23,34,3,3,36,16,20
"2021","West Northamptonshire 033C","E01027237",907,264,85,179,559,56,258,95,133,30,130,82,44,4,105,68,37,10,10,84,31,53
"2021","West Northamptonshire 033D","E01027238",961,362,100,262,478,21,214,81,114,19,134,86,45,3,92,61,31,17,17,121,39,82
"2021","West Northamptonshire 034A","E01027224",953,373,91,282,482,20,228,84,122,22,110,80,26,4,105,75,30,19,19,98,34,64
"2021","West Northamptonshire 034B","E01027226",953,369,76,293,437,18,171,60,92,19,142,89,49,4,91,68,23,15,15,147,42,105
"2021","West Northamptonshire 034C","E01027257",495,130,89,41,341,81,191,65,100,26,40,20,17,3,26,12,14,3,3,24,12,12
"2021","West Northamptonshire 034D","E01035417",749,382,31,351,286,5,112,55,50,7,115,90,20,5,39,24,15,15,15,81,10,71
"2021","West Northamptonshire 034E","E01035418",748,320,77,243,356,20,169,71,85,13,84,59,23,2,71,44,27,12,12,72,17,55
"2021","West Northamptonshire 036A","E01027233",489,80,24,56,357,10,153,38,89,26,81,30,48,3,108,82,26,5,5,52,31,21
"2021","West Northamptonshire 036B","E01027234",689,181,75,106,456,46,245,79,140,26,79,41,34,4,79,62,17,7,7,52,27,25
"2021","West Northamptonshire 036C","E01027235",656,205,68,137,386,24,163,52,82,29,79,35,33,11,113,78,35,7,7,65,33,32
"2021","West Northamptonshire 036D","E01027252",629,151,59,92,421,40,183,56,94,33,93,50,39,4,96,68,28,9,9,57,30,27
"2021","West Northamptonshire 038A","E01027156",504,124,56,68,318,21,142,38,77,27,58,22,24,12,91,57,34,6,6,62,27,35
"2021","West Northamptonshire 038B","E01027159",513,117,58,59,353,58,173,54,78,41,66,29,34,3,52,24,28,4,4,43,21,22
"2021","West Northamptonshire 038C","E01027160",743,136,36,100,545,41,318,107,155,56,115,61,50,4,65,43,22,6,6,62,32,30
"2021","West Northamptonshire 038D","E01027161",676,221,97,124,402,31,162,50,83,29,75,25,44,6,126,68,58,8,8,53,21,32
"2021","West Northamptonshire 037A","E01027158",649,185,75,110,378,35,163,50,90,23,85,42,41,2,85,59,26,10,10,86,21,65
"2021","West Northamptonshire 037B","E01027201",936,230,112,118,660,96,350,109,187,54,112,54,52,6,99,65,34,3,3,46,22,24
"2021","West Northamptonshire 037C","E01027202",676,172,95,77,477,87,246,90,115,41,75,41,27,7,64,34,30,5,5,27,10,17
"2021","West Northamptonshire 037D","E01032980",802,278,29,249,401,9,158,46,99,13,131,95,33,3,73,46,27,30,30,123,26,97
"2021","West Northamptonshire 037E","E01032981",729,171,41,130,395,24,162,53,89,20,106,65,34,7,84,57,27,19,19,163,53,110
"2021","West Northamptonshire 041A","E01027162",682,168,33,135,470,39,234,69,135,30,111,68,41,2,82,59,23,4,4,44,25,19
"2021","West Northamptonshire 041B","E01027163",567,131,83,48,400,85,237,83,108,46,47,28,18,1,30,16,14,1,1,36,20,16
"2021","West Northamptonshire 041C","E01027164",620,158,40,118,406,20,218,68,116,34,107,66,39,2,59,35,24,2,2,56,33,23
"2021","West Northamptonshire 041D","E01027165",488,78,28,50,386,44,249,86,124,39,59,30,26,3,29,18,11,5,5,24,12,12
"2021","West Northamptonshire 041E","E01027166",637,129,35,94,460,35,254,80,132,42,104,56,44,4,58,34,24,9,9,48,26,22
"2021","West Northamptonshire 041F","E01027167",589,148,80,68,410,57,234,84,101,49,65,39,21,5,51,29,22,3,3,31,15,16
"2021","West Northamptonshire 044A","E01027203",577,79,25,54,460,25,283,60,166,57,80,45,29,6,72,48,24,0,0,38,19,19
"2021","West Northamptonshire 044B","E01027204",653,139,71,68,470,57,255,75,140,40,69,26,37,6,87,55,32,2,2,44,30,14
"2021","West Northamptonshire 044C","E01027205",732,86,22,64,594,32,427,80,277,70,59,25,30,4,74,50,24,2,2,52,31,21
"2021","West Northamptonshire 044D","E01035419",637,82,41,41,520,60,339,59,223,57,69,29,33,7,50,34,16,2,2,35,23,12
"2021","West Northamptonshire 044E","E01035420",430,85,40,45,329,56,191,69,85,37,42,18,22,2,37,28,9,3,3,16,4,12
"2021","West Northamptonshire 040A","E01027282",738,153,82,71,546,88,280,81,149,50,85,38,39,8,91,53,38,2,2,39,17,22
"2021","West Northamptonshire 040B","E01027283",693,164,97,67,505,104,282,101,123,58,72,42,26,4,42,28,14,5,5,24,9,15
"2021","West Northamptonshire 040C","E01027285",750,179,102,77,534,117,259,106,109,44,89,51,32,6,66,40,26,3,3,37,23,14
"2021","West Northamptonshire 040D","E01027286",686,201,120,81,458,121,220,85,89,46,60,28,28,4,54,31,23,3,3,27,11,16
"2021","West Northamptonshire 040E","E01027287",735,196,117,79,515,124,268,99,116,53,64,34,29,1,58,32,26,1,1,24,8,16
"2021","West Northamptonshire 043A","E01027273",819,216,123,93,579,137,288,119,113,56,80,46,29,5,69,37,32,5,5,24,8,16
"2021","West Northamptonshire 043B","E01027274",987,160,64,96,790,104,444,143,240,61,143,60,74,9,97,72,25,2,2,37,22,15
"2021","West Northamptonshire 043C","E01027275",649,186,122,64,437,87,246,107,101,38,61,39,20,2,40,27,13,3,3,26,15,11
"2021","West Northamptonshire 043D","E01027308",712,206,114,92,479,98,260,113,100,47,71,47,20,4,49,26,23,1,1,27,13,14
"2021","West Northamptonshire 046A","E01027263",871,266,161,105,575,139,267,128,89,50,102,52,39,11,65,37,28,2,2,30,8,22
"2021","West Northamptonshire 046B","E01027279",958,291,153,138,625,104,291,114,133,44,119,62,52,5,110,66,44,1,1,42,17,25
"2021","West Northamptonshire 046C","E01027284",783,147,82,65,602,107,329,136,133,60,104,54,38,12,58,29,29,4,4,34,15,19
"2021","West Northamptonshire 046D","E01027294",796,165,85,80,604,76,331,112,161,58,110,63,41,6,82,51,31,5,5,27,9,18
"2021","West Northamptonshire 046E","E01032982",559,179,79,100,332,22,186,38,125,23,58,32,22,4,63,49,14,3,3,48,23,25
"2021","West Northamptonshire 046F","E01032983",533,66,18,48,425,20,286,51,191,44,63,22,35,6,54,39,15,2,2,42,18,24
"2021","West Northamptonshire 046G","E01032984",550,71,15,56,439,11,305,55,224,26,80,42,36,2,42,33,9,1,1,40,26,14
"2021","West Northamptonshire 046H","E01032985",927,175,70,105,710,100,369,132,186,51,177,95,74,8,61,39,22,3,3,42,20,22
"2021","West Northamptonshire 045A","E01027262",731,142,69,73,562,132,311,136,131,44,90,64,24,2,28,16,12,1,1,27,6,21
"2021","West Northamptonshire 045B","E01027277",775,187,83,104,557,120,294,128,116,50,91,52,32,7,49,28,21,3,3,31,13,18
"2021","West Northamptonshire 045C","E01027289",771,201,129,72,547,126,262,95,123,44,84,46,35,3,73,36,37,2,2,23,5,18
"2021","West Northamptonshire 045D","E01027300",613,113,56,57,474,62,302,107,145,50,71,41,29,1,36,19,17,3,3,26,10,16
"2021","West Northamptonshire 045E","E01027303",760,226,80,146,513,88,264,89,132,43,101,55,42,4,58,35,23,2,2,21,7,14
"2021","West Northamptonshire 047A","E01027297",758,173,93,80,549,123,309,120,132,57,70,38,28,4,44,24,20,3,3,36,11,25
"2021","West Northamptonshire 047B","E01027298",1194,207,64,143,948,111,479,168,249,62,279,192,83,4,74,48,26,5,5,39,20,19
"2021","West Northamptonshire 047C","E01027299",637,170,83,87,439,74,201,79,88,34,75,36,32,7,86,40,46,3,3,28,7,21
"2021","West Northamptonshire 047D","E01027301",997,342,117,225,623,63,327,115,158,54,155,96,53,6,72,41,31,6,6,32,10,22
"2021","West Northamptonshire 047E","E01027302",720,273,133,140,418,35,169,64,62,43,121,63,45,13,91,65,26,2,2,29,10,19
"2021","West Northamptonshire 048A","E01027291",713,155,98,57,530,106,303,98,155,50,57,29,25,3,61,35,26,3,3,28,16,12
"2021","West Northamptonshire 048B","E01027292",508,144,85,59,344,47,188,59,79,50,45,17,20,8,60,30,30,4,4,20,9,11
"2021","West Northamptonshire 048C","E01027293",554,137,73,64,408,72,220,74,107,39,56,26,22,8,58,33,25,2,2,9,4,5
"2021","West Northamptonshire 048D","E01027304",746,170,93,77,544,122,320,140,120,60,71,50,17,4,30,18,12,1,1,32,4,28
"2021","West Northamptonshire 048E","E01027305",797,201,107,94,569,120,312,120,142,50,83,51,30,2,51,31,20,3,3,27,8,19
"2021","West Northamptonshire 049A","E01027261",843,193,103,90,628,107,395,143,165,87,70,41,22,7,55,34,21,1,1,22,8,14
"2021","West Northamptonshire 049B","E01027295",1107,239,103,136,802,119,441,153,222,66,147,71,69,7,93,63,30,2,2,66,20,46
"2021","West Northamptonshire 049C","E01027306",781,190,96,94,568,127,337,169,116,52,67,45,18,4,34,20,14,3,3,23,8,15
"2021","West Northamptonshire 050A","E01027280",1062,201,81,120,822,113,499,161,261,77,129,68,55,6,79,52,27,2,2,39,16,23
"2021","West Northamptonshire 050B","E01027281",710,180,114,66,499,82,264,84,126,54,66,33,30,3,83,48,35,4,4,31,17,14
"2021","West Northamptonshire 050C","E01027307",934,215,132,83,676,139,360,137,154,69,88,58,25,5,86,50,36,3,3,43,19,24
"2021","West Northamptonshire 050D","E01035425",624,191,70,121,412,63,210,79,104,27,86,50,32,4,51,25,26,2,2,21,8,13
"2021","West Northamptonshire 050E","E01035426",666,132,56,76,509,85,277,85,160,32,91,48,40,3,55,37,18,1,1,25,8,17
"2021","West Northamptonshire 051A","E01027265",665,205,118,87,433,106,207,72,91,44,86,52,29,5,34,16,18,0,0,27,10,17
"2021","West Northamptonshire 051B","E01027270",584,79,23,56,485,56,314,103,156,55,81,40,35,6,33,19,14,1,1,20,6,14
"2021","West Northamptonshire 051C","E01027271",635,179,66,113,436,50,257,81,130,46,85,50,29,6,43,20,23,1,1,20,9,11
"2021","West Northamptonshire 051D","E01027272",596,120,54,66,440,63,243,84,103,56,88,54,30,4,45,25,20,1,1,36,15,21
"2021","West Northamptonshire 051E","E01035427",829,112,14,98,676,13,348,89,238,21,214,112,96,6,98,85,13,3,3,41,19,22
"2021","West Northamptonshire 051F","E01035428",867,156,64,92,687,87,400,125,207,68,145,81,58,6,51,28,23,4,4,24,8,16
"2021","West Northamptonshire 053A","E01027264",684,241,112,129,407,75,195,83,67,45,73,41,30,2,64,35,29,0,0,36,15,21
"2021","West Northamptonshire 053B","E01027267",533,218,107,111,292,33,138,59,51,28,75,47,23,5,44,34,10,2,2,23,8,15
"2021","West Northamptonshire 053C","E01027268",531,126,46,80,379,51,200,69,89,42,87,60,25,2,40,19,21,1,1,26,6,20
"2021","West Northamptonshire 053D","E01027269",766,296,106,190,432,59,186,69,87,30,100,56,37,7,81,55,26,6,6,38,16,22
"2021","West Northamptonshire 052A","E01027288",1001,256,140,116,708,123,349,151,151,47,130,69,56,5,100,57,43,6,6,37,14,23
"2021","West Northamptonshire 052B","E01027290",929,230,125,105,660,137,379,160,169,50,85,55,23,7,57,30,27,2,2,39,12,27
"2021","West Northamptonshire 052C","E01027296",878,217,113,104,621,123,340,160,113,67,90,51,37,2,64,42,22,4,4,40,14,26
"2021","West Northamptonshire 035A","E01032976",779,344,192,152,401,56,160,43,105,12,103,61,39,3,77,59,18,5,5,34,12,22
"2021","West Northamptonshire 035B","E01035421",630,94,21,73,494,22,283,68,189,26,93,36,50,7,89,71,18,7,7,42,25,17
"2021","West Northamptonshire 035C","E01035422",555,99,7,92,422,11,227,64,139,24,104,48,54,2,76,70,6,4,4,34,19,15
"2021","West Northamptonshire 035D","E01035423",939,238,48,190,582,10,263,67,182,14,148,84,63,1,153,137,16,8,8,119,62,57
"2021","West Northamptonshire 039A","E01027250",595,171,80,91,393,79,237,100,91,46,51,28,21,2,22,11,11,4,4,31,15,16
"2021","West Northamptonshire 039B","E01027253",736,161,76,85,527,116,280,87,140,53,80,39,36,5,47,31,16,4,4,48,17,31
"2021","West Northamptonshire 039C","E01027254",829,148,60,88,628,85,363,123,166,74,91,56,28,7,87,58,29,2,2,53,26,27
"2021","West Northamptonshire 039D","E01035424",841,154,15,139,617,9,292,73,198,21,170,90,79,1,139,114,25,7,7,70,37,33
"2021","Amber Valley 001A","E01019400",763,238,73,165,492,48,182,71,79,32,123,61,56,6,132,95,37,7,7,33,14,19
"2021","Amber Valley 001B","E01019401",832,349,191,158,446,58,198,83,72,43,99,50,40,9,84,45,39,7,7,37,15,22
"2021","Amber Valley 001C","E01019402",802,181,76,105,590,70,263,112,103,48,175,110,58,7,75,37,38,7,7,31,12,19
"2021","Amber Valley 001D","E01019404",927,335,131,204,561,96,279,112,111,56,105,74,24,7,76,45,31,5,5,31,11,20
"2021","Amber Valley 002A","E01019406",489,151,88,63,326,88,151,64,58,29,51,29,19,3,36,18,18,0,0,12,5,7
"2021","Amber Valley 002B","E01019423",687,164,81,83,495,115,255,119,99,37,80,58,19,3,40,22,18,5,5,28,6,22
"2021","Amber Valley 002C","E01019424",518,153,105,48,350,90,169,75,61,33,48,29,16,3,40,27,13,3,3,15,3,12
"2021","Amber Valley 002D","E01019477",1048,303,174,129,718,170,362,172,124,66,119,71,41,7,66,34,32,1,1,27,15,12
"2021","Amber Valley 003A","E01019403",649,248,135,113,377,44,151,59,53,39,85,38,40,7,92,61,31,5,5,24,13,11
"2021","Amber Valley 003B","E01019444",641,245,91,154,372,40,104,45,36,23,106,36,59,11,119,96,23,3,3,24,10,14
"2021","Amber Valley 003C","E01019468",654,192,71,121,431,61,182,85,66,31,114,63,42,9,67,40,27,7,7,31,10,21
"2021","Amber Valley 003D","E01019469",682,186,74,112,471,35,174,55,82,37,125,40,78,7,132,101,31,5,5,25,7,18
"2021","Amber Valley 003E","E01019471",658,266,89,177,354,29,126,52,50,24,98,46,45,7,94,68,26,7,7,38,14,24
"2021","Amber Valley 004A","E01019443",807,260,149,111,528,120,234,103,95,36,95,53,34,8,74,48,26,5,5,19,10,9
"2021","Amber Valley 004B","E01019470",742,225,97,128,491,59,216,86,89,41,127,57,62,8,85,50,35,4,4,26,10,16
"2021","Amber Valley 004C","E01019473",537,112,63,49,408,88,248,113,85,50,45,27,13,5,27,10,17,0,0,17,5,12
"2021","Amber Valley 004D","E01019474",534,142,62,80,382,81,169,74,45,50,89,45,39,5,43,27,16,0,0,10,4,6
"2021","Amber Valley 004E","E01019475",577,165,90,75,387,63,182,69,71,42,80,43,31,6,60,41,19,2,2,25,11,14
"2021","Amber Valley 004F","E01019476",621,190,147,43,421,143,195,77,76,42,53,32,18,3,29,15,14,1,1,10,2,8
"2021","Amber Valley 005A","E01019420",625,227,88,139,382,56,170,78,54,38,88,48,34,6,64,44,20,4,4,16,6,10
"2021","Amber Valley 005B","E01019442",659,186,88,98,454,95,200,102,57,41,99,49,42,8,58,32,26,2,2,19,8,11
"2021","Amber Valley 005C","E01019445",702,232,67,165,453,59,191,74,79,38,118,60,47,11,79,50,29,6,6,17,8,9
"2021","Amber Valley 005D","E01019455",657,271,110,161,363,50,153,80,44,29,99,60,35,4,58,34,24,3,3,23,9,14
"2021","Amber Valley 005E","E01019456",841,302,101,201,515,50,236,93,93,50,133,70,52,11,92,62,30,4,4,24,12,12
"2021","Amber Valley 005F","E01019457",618,169,69,100,424,88,187,69,73,45,90,46,33,11,56,33,23,3,3,25,9,16
"2021","Amber Valley 006A","E01019429",712,213,111,102,481,95,234,114,76,44,98,61,31,6,54,21,33,0,0,18,6,12
"2021","Amber Valley 006B","E01019454",614,185,116,69,422,122,208,95,65,48,46,25,17,4,44,21,23,2,2,7,3,4
"2021","Amber Valley 006C","E01019460",656,165,75,90,469,73,242,93,102,47,79,51,24,4,73,46,27,2,2,22,9,13
"2021","Amber Valley 006D","E01019461",651,242,150,92,384,79,177,81,61,35,75,40,31,4,51,30,21,2,2,25,8,17
"2021","Amber Valley 006E","E01019462",534,163,108,55,365,130,153,62,61,30,54,34,17,3,28,16,12,0,0,6,3,3
"2021","Amber Valley 007A","E01019405",658,161,106,55,461,135,254,123,79,52,53,39,11,3,17,11,6,2,2,36,16,20
"2021","Amber Valley 007B","E01019414",714,166,106,60,525,138,280,133,104,43,67,37,25,5,39,20,19,1,1,23,7,16
"2021","Amber Valley 007C","E01019428",634,201,113,88,418,87,209,81,73,55,66,28,33,5,53,30,23,3,3,15,6,9
"2021","Amber Valley 007D","E01019430",813,187,110,77,593,118,308,154,114,40,100,54,33,13,64,36,28,3,3,33,14,19
"2021","Amber Valley 008A","E01019421",915,250,130,120,643,111,270,99,113,58,151,81,57,13,106,69,37,5,5,22,7,15
"2021","Amber Valley 008B","E01019422",649,182,103,79,438,110,222,91,82,49,63,37,20,6,42,18,24,1,1,29,15,14
"2021","Amber Valley 008C","E01019432",853,227,136,91,588,108,263,117,91,55,135,81,44,10,79,50,29,3,3,38,13,25
"2021","Amber Valley 008D","E01019458",941,348,97,251,558,53,237,90,109,38,144,85,57,2,121,82,39,3,3,35,16,19
"2021","Amber Valley 008E","E01019459",594,203,94,109,368,59,175,72,68,35,62,30,30,2,72,42,30,0,0,23,6,17
"2021","Amber Valley 008F","E01019463",627,204,102,102,398,35,157,60,59,38,80,33,37,10,124,87,37,2,2,25,16,9
"2021","Amber Valley 009A","E01019408",738,207,92,115,517,77,245,87,120,38,107,60,40,7,82,47,35,6,6,14,4,10
"2021","Amber Valley 009B","E01019409",750,200,134,66,523,155,244,108,91,45,83,46,30,7,39,23,16,2,2,27,13,14
"2021","Amber Valley 009C","E01019412",695,110,51,59,563,67,341,111,171,59,86,44,34,8,68,42,26,1,1,22,10,12
"2021","Amber Valley 009D","E01019413",551,143,42,101,392,40,222,65,109,48,82,46,30,6,47,32,15,1,1,16,5,11
"2021","Amber Valley 009E","E01019416",642,208,119,89,412,110,216,80,82,54,52,31,20,1,33,14,19,1,1,22,8,14
"2021","Amber Valley 010A","E01019407",1045,468,158,310,544,82,256,123,92,41,140,103,32,5,63,36,27,3,3,33,8,25
"2021","Amber Valley 010B","E01019415",792,298,114,184,473,88,224,98,86,40,109,67,35,7,49,25,24,3,3,21,10,11
"2021","Amber Valley 010C","E01019417",931,354,161,193,547,84,231,99,99,33,132,73,43,16,94,64,30,6,6,30,10,20
"2021","Amber Valley 010D","E01019419",905,309,126,183,570,100,282,137,101,44,122,84,35,3,62,33,29,4,4,26,11,15
"2021","Amber Valley 011A","E01019410",631,185,69,116,431,74,233,88,92,53,80,47,29,4,44,24,20,0,0,15,4,11
"2021","Amber Valley 011B","E01019411",644,223,95,128,397,63,209,93,85,31,76,47,21,8,45,24,21,4,4,24,13,11
"2021","Amber Valley 011C","E01019418",732,186,85,101,519,65,262,101,111,50,111,63,42,6,81,63,18,0,0,27,11,16
"2021","Amber Valley 011D","E01019447",653,187,115,72,452,114,220,98,85,37,69,42,24,3,48,29,19,1,1,14,4,10
"2021","Amber Valley 011E","E01019449",792,230,93,137,542,74,265,110,100,55,114,63,42,9,85,57,28,4,4,20,3,17
"2021","Amber Valley 012A","E01019431",609,181,72,109,401,72,185,78,64,43,70,38,27,5,69,44,25,5,5,27,12,15
"2021","Amber Valley 012B","E01019433",816,239,100,139,548,83,264,102,110,52,97,42,49,6,99,65,34,5,5,29,10,19
"2021","Amber Valley 012C","E01019438",682,213,76,137,453,53,211,80,81,50,86,45,34,7,98,62,36,5,5,16,7,9
"2021","Amber Valley 012D","E01019451",921,267,101,166,608,71,304,134,114,56,158,92,58,8,72,53,19,3,3,46,23,23
"2021","Amber Valley 012E","E01019464",1032,209,93,116,791,120,447,173,210,64,145,71,67,7,73,45,28,6,6,32,11,21
"2021","Amber Valley 013A","E01019434",553,187,82,105,354,65,147,74,49,24,80,49,29,2,61,44,17,1,1,12,8,4
"2021","Amber Valley 013B","E01019435",715,198,53,145,494,41,234,97,97,40,139,78,54,7,80,57,23,0,0,23,10,13
"2021","Amber Valley 013C","E01019436",585,183,81,102,379,62,178,62,72,44,89,48,29,12,48,34,14,2,2,23,9,14
"2021","Amber Valley 013D","E01019439",652,174,71,103,446,55,223,80,97,46,117,70,43,4,49,25,24,2,2,32,10,22
"2021","Amber Valley 013E","E01019440",760,280,107,173,454,87,216,92,82,42,96,58,35,3,54,35,19,1,1,26,7,19
"2021","Amber Valley 015A","E01019446",506,112,58,54,381,94,194,88,68,38,48,28,17,3,42,26,16,3,3,13,5,8
"2021","Amber Valley 015B","E01019448",856,222,100,122,606,90,294,114,137,43,142,84,56,2,77,51,26,3,3,28,10,18
"2021","Amber Valley 015C","E01019450",670,227,93,134,423,61,182,70,79,33,87,45,38,4,89,62,27,4,4,20,11,9
"2021","Amber Valley 015D","E01019465",534,169,105,64,344,85,150,73,46,31,62,33,23,6,46,22,24,1,1,21,6,15
"2021","Amber Valley 015E","E01019467",680,191,102,89,467,114,207,83,84,40,89,50,36,3,56,32,24,1,1,22,13,9
"2021","Amber Valley 016A","E01019425",649,152,119,33,473,126,267,65,155,47,36,14,18,4,44,33,11,0,0,24,14,10
"2021","Amber Valley 016B","E01019426",700,256,165,91,423,103,233,78,120,35,38,16,18,4,48,32,16,1,1,21,7,14
"2021","Amber Valley 016C","E01019427",740,193,97,96,525,101,313,82,182,49,50,27,20,3,60,46,14,1,1,22,14,8
"2021","Amber Valley 016E","E01034254",1158,287,149,138,814,204,464,171,191,102,87,52,34,1,54,30,24,5,5,57,24,33
"2021","Amber Valley 016F","E01034255",508,100,6,94,398,10,196,52,134,10,125,82,41,2,66,54,12,1,1,10,5,5
"2021","Amber Valley 017A","E01019437",606,181,102,79,401,65,160,60,51,49,104,44,49,11,69,38,31,3,3,24,11,13
"2021","Amber Valley 017B","E01019441",776,316,110,206,418,42,145,59,58,28,106,62,43,1,122,79,43,3,3,42,20,22
"2021","Amber Valley 017C","E01019452",719,221,120,101,478,67,169,74,66,29,120,48,63,9,114,66,48,8,8,20,14,6
"2021","Amber Valley 017D","E01019453",952,360,95,265,534,31,165,70,65,30,155,84,63,8,180,141,39,3,3,58,23,35
"2021","Amber Valley 017E","E01032613",569,166,94,72,378,81,179,83,67,29,70,44,23,3,48,24,24,0,0,25,9,16
"2021","Bolsover 001A","E01019478",658,155,70,85,483,85,247,111,98,38,99,69,25,5,49,30,19,3,3,20,10,10
"2021","Bolsover 001B","E01019479",688,172,106,66,491,92,275,101,121,53,75,38,36,1,48,25,23,1,1,25,13,12
"2021","Bolsover 001C","E01019491",1078,343,116,227,702,99,321,124,141,56,180,104,67,9,97,69,28,5,5,33,12,21
"2021","Bolsover 001D","E01019493",675,162,84,78,495,106,241,110,74,57,83,51,30,2,64,33,31,1,1,18,6,12
"2021","Bolsover 001F","E01034644",597,203,120,83,374,80,181,80,81,20,68,32,28,8,42,32,10,3,3,20,10,10
"2021","Bolsover 001G","E01034645",617,173,61,112,419,64,217,88,97,32,92,56,33,3,43,28,15,3,3,25,10,15
"2021","Bolsover 002A","E01019492",788,230,123,107,538,83,236,90,93,53,127,56,57,14,88,51,37,4,4,20,8,12
"2021","Bolsover 002B","E01019495",707,216,117,99,467,97,208,89,72,47,87,40,40,7,72,38,34,3,3,24,10,14
"2021","Bolsover 002C","E01019524",623,186,98,88,413,86,207,99,60,48,80,47,28,5,39,22,17,1,1,24,9,15
"2021","Bolsover 002D","E01019525",665,209,104,105,439,62,220,100,78,42,89,44,42,3,68,40,28,0,0,17,7,10
"2021","Bolsover 003A","E01019496",625,188,82,106,416,59,172,77,69,26,107,51,56,0,75,49,26,3,3,21,10,11
"2021","Bolsover 003B","E01019497",796,304,142,162,464,88,183,80,65,38,114,55,49,10,76,48,28,3,3,28,12,16
"2021","Bolsover 003C","E01019498",810,224,52,172,545,36,183,74,82,27,173,86,80,7,149,122,27,4,4,41,23,18
"2021","Bolsover 003D","E01019523",528,206,66,140,300,46,119,59,44,16,78,39,38,1,53,40,13,4,4,22,12,10
"2021","Bolsover 004A","E01019483",847,236,84,152,572,50,264,107,99,58,136,61,66,9,116,75,41,6,6,39,15,24
"2021","Bolsover 004B","E01019484",985,265,134,131,680,105,309,140,115,54,171,94,72,5,94,58,36,1,1,40,16,24
"2021","Bolsover 004C","E01019485",597,201,114,87,374,77,174,74,73,27,67,41,26,0,48,34,14,8,8,22,8,14
"2021","Bolsover 004D","E01019488",675,236,68,168,408,36,155,60,73,22,105,45,54,6,110,78,32,2,2,31,9,22
"2021","Bolsover 005A","E01019486",449,131,70,61,312,51,165,72,53,40,73,45,21,7,22,10,12,1,1,6,2,4
"2021","Bolsover 005B","E01019487",787,293,169,124,471,56,193,76,81,36,119,59,55,5,98,55,43,5,5,23,12,11
"2021","Bolsover 005C","E01019489",572,188,102,86,378,97,176,79,62,35,68,34,26,8,37,10,27,0,0,6,4,2
"2021","Bolsover 005D","E01019490",477,121,56,65,335,61,172,81,50,41,61,29,29,3,39,26,13,2,2,21,9,12
"2021","Bolsover 005E","E01019502",706,212,134,78,467,97,233,111,87,35,96,52,36,8,37,17,20,4,4,27,7,20
"2021","Bolsover 005F","E01019504",625,205,103,102,409,76,183,84,72,27,80,46,31,3,61,33,28,9,9,11,3,8
"2021","Bolsover 006A","E01019508",843,278,146,132,519,67,230,87,100,43,118,46,60,12,96,63,33,8,8,46,24,22
"2021","Bolsover 006B","E01019509",538,148,74,74,366,32,145,44,79,22,83,21,50,12,102,64,38,4,4,24,12,12
"2021","Bolsover 006C","E01019510",576,184,111,73,363,50,148,55,57,36,73,27,42,4,90,53,37,2,2,29,18,11
"2021","Bolsover 006E","E01034646",661,172,82,90,447,41,214,78,87,49,100,42,53,5,88,47,41,4,4,42,21,21
"2021","Bolsover 006F","E01034647",645,148,47,101,463,41,219,77,104,38,152,98,51,3,46,31,15,5,5,34,13,21
"2021","Bolsover 007A","E01019503",1180,343,181,162,797,142,365,181,119,65,167,87,75,5,112,69,43,11,11,40,16,24
"2021","Bolsover 007B","E01019505",612,179,66,113,402,38,182,74,68,40,104,44,53,7,77,48,29,1,1,31,15,16
"2021","Bolsover 007C","E01019506",626,157,78,79,430,51,195,85,71,39,102,45,44,13,79,40,39,3,3,39,13,26
"2021","Bolsover 007D","E01019507",876,336,129,207,482,60,181,83,47,51,143,84,48,11,86,52,34,12,12,58,17,41
"2021","Bolsover 007E","E01019511",932,260,126,134,585,60,276,118,101,57,135,73,56,6,100,63,37,14,14,87,26,61
"2021","Bolsover 008A","E01019480",690,204,92,112,462,96,213,99,67,47,94,44,45,5,55,22,33,4,4,24,11,13
"2021","Bolsover 008B","E01019482",708,223,119,104,461,95,238,99,88,51,79,40,32,7,49,21,28,0,0,24,7,17
"2021","Bolsover 008C","E01019520",857,175,80,95,642,79,343,148,142,53,138,71,64,3,75,53,22,7,7,40,18,22
"2021","Bolsover 008D","E01019521",782,233,109,124,528,84,247,95,99,53,135,74,54,7,59,36,23,3,3,21,11,10
"2021","Bolsover 008E","E01019522",723,194,71,123,497,45,219,79,104,36,123,61,60,2,103,72,31,7,7,32,13,19
"2021","Bolsover 009A","E01019481",517,151,79,72,347,48,171,72,71,28,66,21,37,8,59,33,26,3,3,19,10,9
"2021","Bolsover 009B","E01019514",666,183,57,126,462,69,222,92,86,44,101,48,45,8,67,43,24,3,3,21,12,9
"2021","Bolsover 009C","E01019515",696,228,100,128,440,36,193,67,77,49,129,52,70,7,79,48,31,3,3,28,12,16
"2021","Bolsover 009D","E01019516",761,292,107,185,433,70,175,64,73,38,118,61,53,4,66,38,28,4,4,36,11,25
"2021","Bolsover 009E","E01019519",787,238,93,145,519,64,251,107,107,37,110,60,42,8,93,56,37,1,1,30,14,16
"2021","Bolsover 010A","E01019499",621,210,94,116,389,62,154,74,46,34,108,49,56,3,65,45,20,0,0,22,6,16
"2021","Bolsover 010B","E01019500",630,195,79,116,401,51,171,78,53,40,94,42,48,4,82,46,36,3,3,34,17,17
"2021","Bolsover 010C","E01019501",660,203,106,97,431,92,191,88,55,48,100,58,30,12,47,28,19,1,1,26,9,17
"2021","Bolsover 010D","E01019513",705,182,78,104,503,71,240,103,102,35,128,64,55,9,61,35,26,3,3,20,6,14
"2021","Bolsover 010E","E01019517",713,174,69,105,512,65,283,130,101,52,110,52,39,19,54,29,25,0,0,27,13,14
"2021","Bolsover 010F","E01019518",703,198,58,140,476,72,252,100,106,46,114,76,31,7,34,22,12,4,4,29,14,15
"2021","Chesterfield 001A","E01019526",628,236,71,165,377,48,160,74,50,36,85,51,27,7,84,57,27,0,0,15,5,10
"2021","Chesterfield 001B","E01019528",710,229,122,107,461,99,208,107,62,39,99,55,42,2,52,25,27,3,3,20,9,11
"2021","Chesterfield 001C","E01019572",642,270,91,179,365,41,134,45,64,25,74,36,29,9,114,81,33,2,2,7,6,1
"2021","Chesterfield 001D","E01019573",700,240,89,151,436,67,189,83,74,32,108,60,43,5,65,44,21,7,7,24,8,16
"2021","Chesterfield 001E","E01019574",628,237,123,114,372,85,154,67,57,30,74,31,35,8,58,37,21,1,1,19,9,10
"2021","Chesterfield 002A","E01019563",654,162,68,94,461,39,174,43,85,46,120,38,73,9,120,90,30,8,8,31,12,19
"2021","Chesterfield 002B","E01019564",712,191,108,83,499,100,244,97,99,48,97,57,39,1,54,36,18,4,4,22,11,11
"2021","Chesterfield 002C","E01019565",612,190,84,106,392,47,164,78,51,35,97,45,42,10,81,55,26,3,3,30,11,19
"2021","Chesterfield 002D","E01019566",784,316,76,240,436,37,162,53,68,41,107,45,56,6,126,94,32,4,4,32,16,16
"2021","Chesterfield 002E","E01019568",562,141,75,66,397,38,154,43,72,39,89,27,55,7,115,76,39,1,1,24,15,9
"2021","Chesterfield 003A","E01019527",656,258,75,183,375,42,145,67,51,27,90,46,35,9,95,66,29,3,3,23,14,9
"2021","Chesterfield 003B","E01019529",686,265,91,174,404,68,163,68,68,27,114,67,46,1,52,34,18,7,7,17,6,11
"2021","Chesterfield 003C","E01019530",725,310,78,232,388,43,158,72,62,24,112,55,52,5,69,51,18,6,6,27,6,21
"2021","Chesterfield 003D","E01019531",674,210,61,149,435,33,190,69,89,32,124,65,57,2,85,61,24,3,3,29,13,16
"2021","Chesterfield 003E","E01019553",808,225,77,148,550,52,284,98,142,44,137,79,51,7,76,47,29,1,1,33,11,22
"2021","Chesterfield 004A","E01019541",676,217,101,116,442,63,196,73,71,52,84,31,45,8,95,61,34,4,4,17,7,10
"2021","Chesterfield 004B","E01019542",865,428,94,334,417,47,160,71,63,26,108,65,36,7,98,60,38,4,4,20,5,15
"2021","Chesterfield 004C","E01019543",911,342,91,251,545,56,207,95,83,29,133,73,57,3,146,106,40,3,3,24,8,16
"2021","Chesterfield 004D","E01019544",717,275,160,115,419,96,172,69,74,29,89,31,49,9,62,40,22,0,0,23,15,8
"2021","Chesterfield 004E","E01019571",646,214,92,122,397,45,157,56,70,31,99,44,47,8,94,49,45,2,2,35,16,19
"2021","Chesterfield 005A","E01019532",539,161,75,86,358,55,166,82,47,37,75,35,35,5,61,43,18,1,1,20,7,13
"2021","Chesterfield 005B","E01019533",624,161,77,84,449,92,240,108,76,56,85,59,20,6,31,14,17,1,1,14,4,10
"2021","Chesterfield 005C","E01019534",621,210,147,63,391,102,201,98,54,49,51,38,10,3,35,23,12,2,2,20,8,12
"2021","Chesterfield 005D","E01019535",671,202,99,103,452,106,211,96,68,47,81,43,34,4,53,22,31,1,1,17,8,9
"2021","Chesterfield 005E","E01019536",855,317,136,181,514,50,230,89,106,35,121,54,61,6,109,77,32,4,4,24,12,12
"2021","Chesterfield 006A","E01019549",553,150,92,58,373,56,166,57,73,36,68,27,36,5,83,57,26,0,0,30,17,13
"2021","Chesterfield 006B","E01019550",674,194,116,78,453,88,202,75,89,38,90,39,44,7,72,43,29,1,1,27,14,13
"2021","Chesterfield 006C","E01019551",695,210,150,60,468,161,219,109,64,46,53,30,19,4,32,17,15,3,3,17,4,13
"2021","Chesterfield 006D","E01019552",515,138,60,78,363,39,179,63,76,40,90,45,45,0,52,38,14,3,3,14,8,6
"2021","Chesterfield 006E","E01019567",787,284,122,162,477,66,199,74,83,42,104,46,45,13,106,79,27,2,2,26,14,12
"2021","Chesterfield 007A","E01019537",698,180,106,74,510,85,282,108,116,58,83,48,30,5,59,33,26,1,1,8,3,5
"2021","Chesterfield 007B","E01019569",855,424,115,309,403,54,145,75,50,20,116,81,30,5,77,51,26,11,11,28,4,24
"2021","Chesterfield 007C","E01019570",595,198,120,78,384,85,177,70,69,38,69,39,23,7,53,32,21,0,0,13,5,8
"2021","Chesterfield 007D","E01019580",756,278,113,165,458,49,182,55,81,46,130,68,55,7,94,64,30,3,3,20,8,12
"2021","Chesterfield 007E","E01019581",646,295,97,198,332,33,150,45,76,29,76,47,25,4,71,37,34,2,2,19,7,12
"2021","Chesterfield 008A","E01019557",666,219,74,145,426,67,243,82,106,55,59,30,25,4,57,35,22,0,0,21,7,14
"2021","Chesterfield 008B","E01019558",572,138,78,60,424,94,229,100,74,55,62,37,19,6,38,18,20,1,1,10,3,7
"2021","Chesterfield 008C","E01019559",485,139,88,51,335,84,181,85,66,30,51,30,18,3,17,7,10,2,2,11,6,5
"2021","Chesterfield 008D","E01019560",620,227,97,130,375,73,161,57,69,35,74,35,34,5,67,47,20,0,0,18,7,11
"2021","Chesterfield 008E","E01019561",724,450,151,299,255,34,104,55,34,15,54,26,25,3,59,44,15,4,4,19,7,12
"2021","Chesterfield 008F","E01019562",622,295,99,196,315,56,133,57,55,21,72,31,36,5,53,28,25,1,1,12,2,10
"2021","Chesterfield 009A","E01019539",715,249,124,125,441,95,213,87,81,45,77,41,30,6,54,28,26,2,2,25,7,18
"2021","Chesterfield 009B","E01019540",645,186,89,97,444,89,217,89,87,41,110,64,40,6,28,13,15,0,0,15,9,6
"2021","Chesterfield 009C","E01019555",734,306,173,133,408,60,160,68,63,29,90,44,41,5,92,62,30,6,6,20,7,13
"2021","Chesterfield 009D","E01019590",861,277,160,117,569,167,266,111,103,52,86,52,32,2,48,22,26,2,2,15,5,10
"2021","Chesterfield 009E","E01019591",652,201,102,99,438,65,235,88,108,39,67,39,23,5,69,42,27,2,2,13,7,6
"2021","Chesterfield 010A","E01019538",978,441,121,320,482,58,216,81,106,29,119,80,38,1,83,42,41,6,6,55,12,43
"2021","Chesterfield 010B","E01019554",728,353,85,268,353,22,105,55,36,14,110,67,38,5,110,75,35,6,6,22,6,16
"2021","Chesterfield 010C","E01019556",724,331,96,235,359,25,136,57,56,23,102,58,39,5,93,61,32,3,3,34,15,19
"2021","Chesterfield 010D","E01019579",865,371,79,292,439,23,180,70,87,23,136,84,43,9,91,72,19,9,9,55,15,40
"2021","Chesterfield 010F","E01033387",660,336,37,299,294,14,107,48,47,12,110,76,29,5,60,39,21,3,3,30,5,25
"2021","Chesterfield 010G","E01033388",787,264,68,196,491,45,186,75,82,29,144,81,55,8,114,86,28,2,2,32,16,16
"2021","Chesterfield 011A","E01019586",639,216,126,90,414,92,196,85,77,34,70,39,24,7,54,22,32,2,2,9,3,6
"2021","Chesterfield 011B","E01019587",627,190,92,98,423,105,222,81,96,45,54,27,25,2,40,20,20,2,2,14,9,5
"2021","Chesterfield 011C","E01019588",614,166,124,42,432,143,221,104,79,38,45,21,22,2,23,8,15,0,0,16,4,12
"2021","Chesterfield 011D","E01019589",605,175,119,56,412,101,196,85,74,37,71,46,22,3,44,19,25,0,0,18,5,13
"2021","Chesterfield 011E","E01019592",705,166,128,38,519,145,275,102,126,47,59,29,25,5,38,26,12,2,2,20,6,14
"2021","Chesterfield 011F","E01019593",487,132,87,45,345,92,187,67,86,34,40,18,19,3,25,11,14,1,1,10,3,7
"2021","Chesterfield 012A","E01019545",624,192,98,94,410,107,193,78,68,47,48,27,16,5,59,35,24,3,3,22,8,14
"2021","Chesterfield 012B","E01019546",653,224,103,121,413,78,190,98,60,32,72,40,28,4,73,45,28,0,0,16,7,9
"2021","Chesterfield 012C","E01019547",648,270,95,175,346,34,118,47,46,25,92,41,48,3,95,62,33,7,7,32,16,16
"2021","Chesterfield 012D","E01019548",980,291,136,155,658,100,341,124,168,49,119,62,48,9,96,60,36,2,2,31,9,22
"2021","Chesterfield 012E","E01019582",673,193,81,112,459,73,220,101,80,39,102,59,39,4,60,33,27,4,4,21,8,13
"2021","Chesterfield 012F","E01019583",632,172,65,107,439,94,196,76,78,42,87,50,29,8,58,29,29,4,4,21,5,16
"2021","Chesterfield 012G","E01019585",1028,338,114,224,644,73,288,131,119,38,198,123,71,4,81,52,29,4,4,46,20,26
"2021","Chesterfield 013A","E01019575",695,204,61,143,463,32,165,54,66,45,116,35,73,8,142,110,32,8,8,28,18,10
"2021","Chesterfield 013B","E01019576",767,308,137,171,431,90,202,85,80,37,71,29,33,9,66,34,32,2,2,28,8,20
"2021","Chesterfield 013C","E01019577",745,286,100,186,435,90,208,104,65,39,74,39,33,2,62,37,25,1,1,24,10,14
"2021","Chesterfield 013D","E01019578",797,398,130,268,372,42,127,65,45,17,91,47,42,2,110,81,29,2,2,27,14,13
"2021","Derbyshire Dales 001A","E01019602",836,262,144,118,547,122,293,136,101,56,83,48,33,2,47,24,23,2,2,27,8,19
"2021","Derbyshire Dales 001B","E01019614",717,167,110,57,530,138,283,134,112,37,71,41,27,3,34,14,20,4,4,20,5,15
"2021","Derbyshire Dales 001C","E01019615",953,309,171,138,620,122,323,140,130,53,101,57,36,8,71,40,31,3,3,24,12,12
"2021","Derbyshire Dales 001D","E01019631",798,259,138,121,509,99,263,110,102,51,76,43,32,1,66,36,30,5,5,30,15,15
"2021","Derbyshire Dales 002A","E01019600",691,275,162,113,398,104,195,90,71,34,58,41,13,4,37,23,14,4,4,18,4,14
"2021","Derbyshire Dales 002B","E01019604",828,238,138,100,582,156,318,167,106,45,70,43,19,8,36,21,15,2,2,8,0,8
"2021","Derbyshire Dales 002C","E01019606",735,214,133,81,505,159,245,100,102,43,54,29,21,4,44,26,18,3,3,16,6,10
"2021","Derbyshire Dales 002D","E01019618",695,193,111,82,482,127,260,122,91,47,47,31,13,3,45,23,22,3,3,20,12,8
"2021","Derbyshire Dales 005A","E01019609",1186,374,225,149,782,215,358,151,151,56,123,72,42,9,86,51,35,0,0,30,7,23
"2021","Derbyshire Dales 005B","E01019621",613,166,90,76,429,79,228,92,101,35,60,36,20,4,59,38,21,3,3,18,4,14
"2021","Derbyshire Dales 005C","E01019622",678,223,115,108,438,90,225,108,79,38,85,52,32,1,36,22,14,2,2,17,4,13
"2021","Derbyshire Dales 005D","E01019624",567,168,71,97,388,106,182,75,72,35,59,32,23,4,40,26,14,1,1,11,4,7
"2021","Derbyshire Dales 005E","E01019627",523,127,78,49,376,106,177,90,54,33,60,27,27,6,32,16,16,1,1,20,6,14
"2021","Derbyshire Dales 005F","E01019628",663,169,93,76,476,98,244,107,104,33,76,45,30,1,55,36,19,3,3,18,11,7
"2021","Derbyshire Dales 006A","E01019619",683,238,117,121,427,121,189,94,67,28,71,40,24,7,46,21,25,0,0,18,7,11
"2021","Derbyshire Dales 006B","E01019620",640,184,94,90,433,89,234,106,79,49,80,39,32,9,28,11,17,2,2,23,9,14
"2021","Derbyshire Dales 006C","E01019623",734,392,152,240,328,55,154,61,63,30,74,42,29,3,40,21,19,5,5,14,5,9
"2021","Derbyshire Dales 006D","E01019625",702,264,149,115,413,42,166,51,73,42,87,34,47,6,109,75,34,9,9,25,13,12
"2021","Derbyshire Dales 006E","E01019626",682,241,132,109,426,108,200,96,62,42,78,43,33,2,37,19,18,3,3,15,9,6
"2021","Derbyshire Dales 006F","E01019632",743,234,130,104,491,129,256,134,76,46,65,34,26,5,41,19,22,0,0,18,10,8
"2021","Derbyshire Dales 007A","E01019633",677,195,91,104,458,82,200,76,81,43,87,34,40,13,84,43,41,5,5,24,13,11
"2021","Derbyshire Dales 007B","E01019634",696,203,111,92,471,105,230,109,81,40,76,48,23,5,58,32,26,2,2,22,11,11
"2021","Derbyshire Dales 007C","E01019635",556,188,110,78,354,111,153,69,55,29,54,33,18,3,34,18,16,2,2,14,4,10
"2021","Derbyshire Dales 007D","E01019636",775,296,155,141,457,79,208,103,79,26,99,52,43,4,68,37,31,3,3,22,4,18
"2021","Derbyshire Dales 008A","E01019595",925,340,149,191,553,135,294,143,107,44,77,43,27,7,45,27,18,2,2,32,11,21
"2021","Derbyshire Dales 008B","E01019605",780,210,107,103,538,115,311,149,103,59,70,39,26,5,39,19,20,3,3,32,13,19
"2021","Derbyshire Dales 008C","E01019611",705,198,119,79,468,95,270,149,67,54,64,33,22,9,37,23,14,2,2,39,16,23
"2021","Derbyshire Dales 008D","E01019616",817,199,118,81,589,173,303,132,113,58,70,44,22,4,42,22,20,1,1,29,17,12
"2021","Derbyshire Dales 009A","E01019594",798,266,144,122,511,73,231,85,96,50,102,33,57,12,102,67,35,3,3,21,6,15
"2021","Derbyshire Dales 009B","E01019596",870,308,156,152,548,124,279,113,119,47,89,53,32,4,52,31,21,4,4,14,4,10
"2021","Derbyshire Dales 009C","E01019597",854,181,87,94,658,105,311,104,158,49,142,67,66,9,97,72,25,3,3,15,9,6
"2021","Derbyshire Dales 009D","E01019598",813,296,123,173,481,59,211,82,98,31,100,62,34,4,109,70,39,2,2,36,13,23
"2021","Derbyshire Dales 010A","E01019603",872,219,101,118,629,139,343,147,143,53,103,63,35,5,44,28,16,0,0,24,10,14
"2021","Derbyshire Dales 010B","E01019607",788,168,100,68,591,151,312,130,116,66,87,51,32,4,41,16,25,0,0,29,17,12
"2021","Derbyshire Dales 010C","E01019612",935,268,142,126,631,126,343,145,144,54,109,62,39,8,53,34,19,0,0,36,16,20
"2021","Derbyshire Dales 010D","E01019629",708,155,89,66,508,94,311,133,115,63,61,38,17,6,42,19,23,0,0,45,22,23
"2021","Derbyshire Dales 011B","E01019599",638,191,122,69,434,136,218,100,78,40,43,22,18,3,36,22,14,1,1,13,6,7
"2021","Derbyshire Dales 011A","E01019601",711,279,189,90,410,112,175,67,68,40,61,29,28,4,61,32,29,1,1,22,6,16
"2021","Derbyshire Dales 011G","E01019608",815,279,155,124,516,118,199,93,62,44,87,41,44,2,106,67,39,6,6,20,6,14
"2021","Derbyshire Dales 011D","E01019610",682,180,112,68,486,138,248,123,85,40,68,40,22,6,30,15,15,2,2,16,6,10
"2021","Derbyshire Dales 011C","E01019613",703,160,97,63,507,121,270,134,85,51,66,36,25,5,47,22,25,3,3,36,18,18
"2021","Derbyshire Dales 011F","E01019617",709,232,132,100,454,113,220,98,81,41,85,46,32,7,33,16,17,3,3,23,8,15
"2021","Derbyshire Dales 011E","E01019630",789,191,103,88,557,92,305,143,113,49,87,43,41,3,70,37,33,3,3,41,13,28
"2021","Erewash 001A","E01019644",701,299,102,197,360,52,144,69,47,28,102,49,43,10,58,34,24,4,4,42,14,28
"2021","Erewash 001B","E01019646",627,178,57,121,422,42,141,64,46,31,104,43,57,4,133,91,42,2,2,27,10,17
"2021","Erewash 001C","E01019663",710,268,117,151,417,50,130,48,53,29,104,39,56,9,125,88,37,8,8,25,11,14
"2021","Erewash 001D","E01019664",486,114,63,51,344,38,123,40,53,30,91,28,53,10,91,61,30,1,1,28,23,5
"2021","Erewash 001E","E01019665",639,216,118,98,398,80,165,76,54,35,81,39,38,4,69,37,32,3,3,25,9,16
"2021","Erewash 003A","E01019657",878,297,119,178,540,55,182,71,78,33,155,74,69,12,142,99,43,6,6,41,18,23
"2021","Erewash 003B","E01019660",888,294,102,192,559,98,240,103,85,52,147,96,38,13,70,45,25,4,4,35,9,26
"2021","Erewash 003C","E01019661",658,249,75,174,379,44,140,68,50,22,105,67,31,7,87,52,35,3,3,30,8,22
"2021","Erewash 003D","E01019662",787,353,83,270,398,37,139,64,54,21,120,67,49,4,97,68,29,5,5,36,13,23
"2021","Erewash 003E","E01019672",794,300,99,201,449,45,187,87,65,35,124,71,45,8,91,56,35,2,2,45,17,28
"2021","Erewash 003F","E01019690",561,181,66,115,344,37,144,52,62,30,87,42,43,2,72,47,25,4,4,36,13,23
"2021","Erewash 004A","E01019670",735,161,83,78,557,123,296,95,141,60,88,53,29,6,50,32,18,0,0,17,7,10
"2021","Erewash 004B","E01019671",807,225,155,70,552,142,283,127,116,40,82,46,30,6,43,21,22,2,2,30,11,19
"2021","Erewash 004C","E01019701",977,293,173,120,646,128,325,127,133,65,111,59,41,11,82,39,43,0,0,38,19,19
"2021","Erewash 005A","E01019673",537,128,71,57,385,84,212,84,85,43,58,29,26,3,30,17,13,1,1,24,9,15
"2021","Erewash 005B","E01019702",760,196,127,69,545,131,294,132,103,59,75,47,22,6,41,22,19,4,4,19,4,15
"2021","Erewash 005C","E01019703",665,161,77,84,486,89,256,82,118,56,82,40,37,5,56,40,16,3,3,18,8,10
"2021","Erewash 005D","E01019704",639,178,115,63,441,114,223,100,68,55,68,38,20,10,36,8,28,0,0,20,5,15
"2021","Erewash 006A","E01019658",832,238,63,175,569,52,245,88,114,43,171,94,70,7,98,65,33,3,3,25,15,10
"2021","Erewash 006B","E01019659",983,220,64,156,722,78,338,125,167,46,213,133,72,8,91,62,29,2,2,41,23,18
"2021","Erewash 006C","E01019674",503,144,70,74,349,80,157,57,53,47,61,25,32,4,49,27,22,2,2,10,5,5
"2021","Erewash 006D","E01019688",636,224,65,159,388,55,133,59,42,32,116,54,56,6,80,60,20,4,4,24,8,16
"2021","Erewash 006E","E01019689",636,186,92,94,427,74,171,63,62,46,98,38,53,7,83,51,32,1,1,23,12,11
"2021","Erewash 007A","E01019666",600,162,81,81,412,32,159,50,71,38,114,44,59,11,101,56,45,6,6,26,13,13
"2021","Erewash 007B","E01019667",678,177,94,83,481,61,222,73,106,43,106,46,53,7,90,64,26,2,2,20,8,12
"2021","Erewash 007C","E01019668",643,282,146,136,343,53,139,49,49,41,84,37,43,4,63,35,28,4,4,18,5,13
"2021","Erewash 007D","E01019669",690,209,128,81,464,107,213,103,66,44,88,44,36,8,56,26,30,0,0,17,4,13
"2021","Erewash 008A","E01019656",503,132,87,45,340,58,193,79,74,40,70,49,14,7,18,10,8,1,1,31,13,18
"2021","Erewash 008B","E01019691",657,160,91,69,465,71,240,88,104,48,91,38,47,6,58,32,26,5,5,32,14,18
"2021","Erewash 008C","E01019692",661,205,84,121,434,50,175,63,73,39,95,39,49,7,111,74,37,3,3,22,14,8
"2021","Erewash 008D","E01019693",861,301,97,204,528,52,198,64,103,31,143,75,60,8,131,92,39,4,4,32,9,23
"2021","Erewash 008E","E01019694",503,122,84,38,369,100,192,91,66,35,49,24,21,4,25,10,15,3,3,12,5,7
"2021","Erewash 008F","E01019696",611,176,105,71,418,115,198,72,81,45,73,39,29,5,31,14,17,1,1,17,7,10
"2021","Erewash 009A","E01019683",537,122,72,50,398,90,202,72,89,41,62,29,32,1,41,19,22,3,3,17,9,8
"2021","Erewash 009B","E01019684",706,196,86,110,492,93,261,87,126,48,84,49,33,2,51,27,24,3,3,18,6,12
"2021","Erewash 009C","E01019685",686,234,130,104,435,80,216,86,92,38,82,55,23,4,54,32,22,3,3,17,11,6
"2021","Erewash 009D","E01019686",598,174,107,67,406,104,198,77,89,32,61,33,20,8,42,24,18,1,1,18,6,12
"2021","Erewash 009E","E01019687",620,195,122,73,404,67,181,63,76,42,66,22,36,8,86,50,36,4,4,21,10,11
"2021","Erewash 010A","E01019648",652,186,107,79,440,65,195,71,89,35,108,52,49,7,70,39,31,2,2,26,17,9
"2021","Erewash 010B","E01019649",789,263,72,191,486,33,204,77,95,32,156,82,66,8,91,55,36,2,2,40,11,29
"2021","Erewash 010C","E01019650",744,275,138,137,434,44,161,56,71,34,103,44,47,12,121,84,37,5,5,35,15,20
"2021","Erewash 010D","E01019651",617,171,88,83,423,73,195,62,87,46,92,50,35,7,62,37,25,1,1,23,10,13
"2021","Erewash 010E","E01019695",637,174,53,121,437,69,201,91,76,34,99,53,42,4,68,37,31,0,0,26,8,18
"2021","Erewash 011A","E01019641",638,162,116,46,465,125,257,107,105,45,55,24,23,8,28,15,13,0,0,11,2,9
"2021","Erewash 011B","E01019652",630,160,74,86,448,57,244,81,114,49,85,45,31,9,58,38,20,4,4,22,7,15
"2021","Erewash 011C","E01019653",590,165,88,77,409,120,214,83,87,44,50,26,19,5,24,15,9,1,1,16,7,9
"2021","Erewash 011D","E01019707",627,193,63,130,413,54,222,92,80,50,88,43,41,4,49,29,20,0,0,21,10,11
"2021","Erewash 011E","E01019708",735,162,84,78,543,102,307,113,145,49,85,36,46,3,48,30,18,1,1,30,17,13
"2021","Erewash 012A","E01019647",1047,452,160,292,548,42,177,84,75,18,174,112,52,10,137,91,46,18,18,47,8,39
"2021","Erewash 012B","E01019675",760,331,86,245,390,35,164,63,73,28,100,57,38,5,84,58,26,7,7,39,11,28
"2021","Erewash 012C","E01019679",758,230,64,166,491,49,164,61,75,28,168,101,54,13,109,71,38,1,1,37,12,25
"2021","Erewash 012D","E01019682",910,454,97,357,430,27,123,57,50,16,156,97,50,9,114,81,33,10,10,26,8,18
"2021","Erewash 013A","E01019642",639,214,128,86,400,83,191,75,78,38,69,38,22,9,53,24,29,4,4,25,8,17
"2021","Erewash 013B","E01019643",694,199,125,74,476,141,238,92,85,61,48,28,18,2,47,30,17,2,2,19,7,12
"2021","Erewash 013C","E01019654",720,259,117,142,436,90,208,90,81,37,83,53,26,4,52,30,22,3,3,25,13,12
"2021","Erewash 013D","E01019655",741,276,85,191,431,49,167,72,67,28,122,80,33,9,89,60,29,4,4,34,11,23
"2021","Erewash 014A","E01019676",669,233,85,148,408,60,170,61,76,33,89,51,36,2,88,51,37,1,1,28,12,16
"2021","Erewash 014B","E01019677",635,200,118,82,412,85,195,75,72,48,78,48,26,4,53,26,27,1,1,23,10,13
"2021","Erewash 014C","E01019678",764,230,74,156,513,56,243,98,108,37,153,92,50,11,60,36,24,1,1,21,8,13
"2021","Erewash 014D","E01019680",793,212,86,126,553,56,287,92,151,44,118,52,58,8,85,57,28,7,7,28,11,17
"2021","Erewash 014E","E01019681",688,200,108,92,465,119,208,91,66,51,89,60,24,5,48,24,24,1,1,23,8,15
"2021","Erewash 014F","E01019698",629,171,75,96,444,63,214,82,85,47,118,73,40,5,46,19,27,3,3,14,2,12
"2021","Erewash 015A","E01019697",616,159,93,66,438,96,208,80,83,45,66,37,25,4,67,40,27,1,1,19,8,11
"2021","Erewash 015B","E01019699",710,312,166,146,364,46,147,59,72,16,77,36,35,6,90,48,42,4,4,34,21,13
"2021","Erewash 015C","E01019700",1012,316,174,142,660,132,329,148,130,51,116,67,43,6,83,41,42,0,0,36,11,25
"2021","Erewash 015D","E01019705",804,240,95,145,533,60,247,105,101,41,129,79,45,5,93,48,45,4,4,31,12,19
"2021","Erewash 015E","E01019706",516,123,71,52,378,89,186,66,85,35,56,27,25,4,46,22,24,1,1,15,7,8
"2021","Erewash 015F","E01019709",524,131,49,82,372,36,158,53,78,27,87,37,42,8,88,53,35,3,3,21,10,11
"2021","Erewash 016A","E01019638",517,121,76,45,386,72,206,86,72,48,80,38,37,5,27,10,17,1,1,10,4,6
"2021","Erewash 016B","E01019639",635,150,54,96,458,48,192,71,89,32,127,63,53,11,88,66,22,3,3,27,11,16
"2021","Erewash 016C","E01019640",574,130,41,89,428,47,224,83,92,49,97,57,38,2,59,36,23,1,1,16,9,7
"2021","Erewash 016D","E01019645",802,258,107,151,515,79,197,92,71,34,124,63,52,9,112,83,29,3,3,29,9,20
"2021","Erewash 016E","E01032614",488,94,36,58,382,41,245,92,99,54,61,33,26,2,34,18,16,1,1,12,6,6
"2021","High Peak 001A","E01019733",668,235,106,129,410,62,175,67,69,39,74,34,32,8,97,63,34,2,2,23,15,8
"2021","High Peak 001B","E01019752",583,167,50,117,399,28,173,71,76,26,99,48,43,8,94,66,28,5,5,17,6,11
"2021","High Peak 001C","E01019753",625,194,73,121,407,46,222,110,84,28,89,60,24,5,45,30,15,5,5,24,8,16
"2021","High Peak 001D","E01019763",975,298,114,184,648,85,313,109,132,72,131,67,56,8,114,70,44,5,5,29,13,16
"2021","High Peak 002A","E01019728",508,202,89,113,297,19,103,35,44,24,71,18,46,7,101,71,30,3,3,9,4,5
"2021","High Peak 002B","E01019729",506,159,60,99,319,23,103,39,43,21,60,12,37,11,132,92,40,1,1,28,16,12
"2021","High Peak 002C","E01019730",866,317,122,195,522,41,203,88,80,35,136,64,62,10,136,84,52,6,6,27,8,19
"2021","High Peak 002D","E01019731",499,100,62,38,375,75,205,73,91,41,50,24,23,3,43,26,17,2,2,24,10,14
"2021","High Peak 002E","E01019732",628,164,90,74,437,67,191,67,82,42,99,45,45,9,78,55,23,2,2,27,12,15
"2021","High Peak 003A","E01019738",691,234,72,162,433,43,165,78,57,30,125,70,47,8,94,66,28,6,6,24,7,17
"2021","High Peak 003B","E01019739",1027,485,149,336,500,67,177,87,53,37,127,84,38,5,121,77,44,8,8,42,12,30
"2021","High Peak 003C","E01019740",555,189,69,120,352,41,141,58,53,30,100,67,28,5,63,35,28,7,7,14,5,9
"2021","High Peak 003D","E01019750",608,211,104,107,383,49,189,81,66,42,90,48,35,7,53,25,28,2,2,14,5,9
"2021","High Peak 003E","E01019751",927,225,100,125,664,87,401,130,199,72,112,60,49,3,64,38,26,0,0,38,17,21
"2021","High Peak 003F","E01019768",1056,441,185,256,580,64,230,103,86,41,138,79,51,8,144,92,52,4,4,35,10,25
"2021","High Peak 004A","E01019727",936,224,153,71,686,166,342,122,169,51,109,58,48,3,67,38,29,2,2,26,10,16
"2021","High Peak 004B","E01019749",485,98,63,35,370,88,219,98,78,43,37,21,13,3,26,12,14,0,0,17,3,14
"2021","High Peak 004C","E01019754",841,257,128,129,550,100,300,129,109,62,105,66,31,8,42,24,18,3,3,34,14,20
"2021","High Peak 004D","E01019756",649,94,58,36,529,84,339,98,178,63,58,20,33,5,47,20,27,1,1,26,11,15
"2021","High Peak 004E","E01019757",567,134,69,65,418,80,189,66,87,36,73,37,34,2,74,39,35,2,2,15,7,8
"2021","High Peak 004F","E01019758",600,120,59,61,454,82,250,86,119,45,82,47,29,6,38,22,16,2,2,26,14,12
"2021","High Peak 005A","E01019746",720,250,86,164,449,78,237,95,113,29,98,56,37,5,33,21,12,3,3,21,12,9
"2021","High Peak 005B","E01019747",513,143,78,65,344,72,174,77,65,32,69,43,23,3,29,12,17,0,0,26,13,13
"2021","High Peak 005C","E01019748",722,262,79,183,425,41,181,79,63,39,119,83,32,4,81,46,35,3,3,35,16,19
"2021","High Peak 005D","E01019755",831,237,120,117,565,121,286,125,104,57,95,57,36,2,60,28,32,3,3,29,11,18
"2021","High Peak 005E","E01019766",639,178,89,89,446,79,232,97,91,44,66,43,15,8,67,37,30,2,2,15,6,9
"2021","High Peak 006A","E01019711",606,194,98,96,391,60,188,87,71,30,87,47,32,8,53,28,25,3,3,21,14,7
"2021","High Peak 006B","E01019734",911,301,174,127,593,120,318,122,139,57,87,46,31,10,67,39,28,1,1,17,4,13
"2021","High Peak 006C","E01019743",653,218,96,122,404,47,147,59,54,34,98,36,53,9,109,78,31,3,3,31,15,16
"2021","High Peak 006D","E01019744",653,230,108,122,403,63,176,77,60,39,78,39,33,6,83,43,40,3,3,20,9,11
"2021","High Peak 006E","E01019745",499,171,75,96,313,30,154,62,68,24,72,39,29,4,52,34,18,5,5,15,5,10
"2021","High Peak 008A","E01019712",640,168,98,70,455,81,259,114,98,47,71,35,34,2,43,29,14,1,1,17,7,10
"2021","High Peak 008B","E01019713",702,137,72,65,535,99,276,116,119,41,94,44,41,9,63,47,16,3,3,30,10,20
"2021","High Peak 008C","E01019764",666,184,118,66,460,99,244,89,98,57,69,35,29,5,48,29,19,0,0,22,11,11
"2021","High Peak 008D","E01019765",854,312,99,213,515,73,235,106,86,43,129,75,48,6,76,44,32,2,2,27,8,19
"2021","High Peak 008E","E01019767",691,215,118,97,454,82,253,99,108,46,65,31,28,6,53,34,19,1,1,22,7,15
"2021","High Peak 010A","E01019710",870,384,143,241,443,62,182,91,58,33,112,68,35,9,87,49,38,0,0,43,11,32
"2021","High Peak 010B","E01019715",663,301,78,223,320,39,122,53,49,20,91,59,27,5,66,35,31,2,2,42,6,36
"2021","High Peak 010C","E01019717",674,435,175,260,218,37,78,38,30,10,59,44,12,3,41,24,17,3,3,21,4,17
"2021","High Peak 010D","E01019722",782,240,100,140,500,87,255,103,100,52,81,41,37,3,72,40,32,5,5,42,13,29
"2021","High Peak 010E","E01019723",873,393,223,170,461,146,195,106,57,32,61,37,22,2,58,33,25,1,1,19,7,12
"2021","High Peak 011A","E01019716",561,198,96,102,338,64,165,63,61,41,64,38,22,4,43,22,21,2,2,25,10,15
"2021","High Peak 011B","E01019724",501,161,68,93,319,38,130,46,62,22,67,27,37,3,83,51,32,1,1,21,10,11
"2021","High Peak 011C","E01019759",655,213,93,120,413,45,163,65,60,38,91,39,51,1,103,68,35,11,11,29,11,18
"2021","High Peak 011D","E01019760",614,200,90,110,389,46,188,79,73,36,90,47,36,7,65,38,27,0,0,25,9,16
"2021","High Peak 011E","E01019761",576,114,39,75,426,32,153,43,81,29,99,20,71,8,132,91,41,10,10,36,22,14
"2021","High Peak 012A","E01019714",1063,245,101,144,785,123,434,160,199,75,134,60,67,7,91,64,27,3,3,33,16,17
"2021","High Peak 012B","E01019725",644,174,83,91,457,68,251,98,89,64,81,39,37,5,56,32,24,1,1,13,4,9
"2021","High Peak 012C","E01019726",615,170,60,110,426,39,216,81,98,37,104,60,36,8,65,43,22,2,2,19,9,10
"2021","High Peak 012D","E01019762",793,242,152,90,533,165,291,120,117,54,51,28,20,3,26,16,10,0,0,18,6,12
"2021","High Peak 013E","E01019718",975,297,127,170,651,116,337,142,148,47,101,50,43,8,95,59,36,2,2,27,10,17
"2021","High Peak 013F","E01019719",885,276,127,149,587,71,275,106,131,38,118,51,61,6,120,78,42,3,3,22,14,8
"2021","High Peak 013G","E01019720",665,217,143,74,436,108,209,94,81,34,72,39,29,4,44,25,19,3,3,12,5,7
"2021","High Peak 013H","E01019721",642,153,85,68,467,100,229,104,81,44,81,40,37,4,56,33,23,1,1,22,9,13
"2021","High Peak 013A","E01019735",657,194,111,83,447,109,224,110,84,30,78,51,26,1,34,18,16,2,2,16,8,8
"2021","High Peak 013B","E01019736",467,122,61,61,324,82,177,90,48,39,37,27,9,1,28,14,14,0,0,21,8,13
"2021","High Peak 013C","E01019737",550,198,132,66,330,89,156,85,47,24,49,25,20,4,35,15,20,1,1,22,6,16
"2021","High Peak 013I","E01019741",498,139,67,72,343,59,154,62,65,27,92,48,41,3,37,18,19,1,1,16,8,8
"2021","High Peak 013D","E01019742",450,129,51,78,301,46,136,63,49,24,73,37,33,3,46,27,19,0,0,20,5,15
"2021","North East Derbyshire 001A","E01019801",504,136,51,85,349,54,164,65,54,45,63,38,19,6,63,39,24,5,5,19,9,10
"2021","North East Derbyshire 001B","E01019802",577,174,74,100,381,75,191,81,65,45,75,34,33,8,37,20,17,3,3,22,10,12
"2021","North East Derbyshire 001C","E01019803",517,110,66,44,377,60,160,65,63,32,76,28,41,7,79,44,35,2,2,30,15,15
"2021","North East Derbyshire 001D","E01019804",560,152,83,69,392,60,236,112,77,47,58,25,30,3,38,22,16,0,0,16,9,7
"2021","North East Derbyshire 001E","E01019805",564,149,87,62,397,73,212,76,89,47,71,34,32,5,41,28,13,0,0,18,6,12
"2021","North East Derbyshire 001F","E01019806",660,186,82,104,452,89,223,99,76,48,89,47,31,11,48,22,26,3,3,22,10,12
"2021","North East Derbyshire 001G","E01019807",608,187,99,88,398,40,162,51,67,44,78,22,48,8,114,87,27,4,4,23,12,11
"2021","North East Derbyshire 002A","E01019778",765,229,162,67,516,152,248,84,110,54,61,33,25,3,52,23,29,3,3,20,7,13
"2021","North East Derbyshire 002B","E01019779",772,278,186,92,477,154,226,91,90,45,57,29,22,6,39,19,20,1,1,17,6,11
"2021","North East Derbyshire 002C","E01019790",906,350,142,208,541,116,276,129,95,52,90,60,29,1,57,32,25,2,2,15,4,11
"2021","North East Derbyshire 002D","E01019816",786,229,128,101,514,114,267,115,101,51,71,46,15,10,62,35,27,0,0,43,16,27
"2021","North East Derbyshire 004A","E01019780",625,214,106,108,390,45,168,54,88,26,72,32,33,7,101,71,30,4,4,21,12,9
"2021","North East Derbyshire 004B","E01019781",671,239,128,111,415,94,199,73,99,27,70,47,20,3,52,31,21,0,0,17,9,8
"2021","North East Derbyshire 004C","E01019782",633,267,129,138,352,56,165,57,78,30,59,32,24,3,69,34,35,3,3,14,3,11
"2021","North East Derbyshire 004D","E01019786",748,299,121,178,435,63,194,75,91,28,92,49,37,6,83,39,44,3,3,14,5,9
"2021","North East Derbyshire 004E","E01019827",855,301,135,166,529,110,242,105,84,53,99,45,41,13,76,44,32,2,2,25,10,15
"2021","North East Derbyshire 005A","E01019770",854,231,119,112,581,151,300,127,124,49,77,43,32,2,53,33,20,0,0,42,22,20
"2021","North East Derbyshire 005B","E01019787",766,197,126,71,547,128,274,81,146,47,74,31,38,5,71,44,27,0,0,22,5,17
"2021","North East Derbyshire 005C","E01019788",718,170,122,48,533,154,295,109,136,50,48,35,9,4,36,23,13,0,0,15,8,7
"2021","North East Derbyshire 005D","E01019794",597,126,101,25,460,203,203,79,85,39,31,14,16,1,23,10,13,0,0,11,3,8
"2021","North East Derbyshire 006A","E01019783",522,126,88,38,383,83,206,62,112,32,46,13,32,1,48,23,25,0,0,13,4,9
"2021","North East Derbyshire 006B","E01019784",509,130,72,58,354,66,183,55,91,37,74,41,26,7,27,13,14,4,4,25,8,17
"2021","North East Derbyshire 006C","E01019785",517,98,64,34,409,121,220,71,102,47,41,20,18,3,25,16,9,2,2,10,6,4
"2021","North East Derbyshire 006D","E01019793",639,183,136,47,436,142,216,78,96,42,45,21,22,2,33,13,20,0,0,20,8,12
"2021","North East Derbyshire 006E","E01019795",985,291,188,103,673,121,347,97,184,66,121,66,54,1,83,56,27,1,1,21,11,10
"2021","North East Derbyshire 007A","E01019798",703,181,96,85,492,106,236,108,83,45,86,45,35,6,62,39,23,2,2,30,16,14
"2021","North East Derbyshire 007B","E01019821",614,211,112,99,394,96,180,90,49,41,76,47,24,5,41,25,16,1,1,9,4,5
"2021","North East Derbyshire 007C","E01019822",712,185,106,79,488,92,233,112,75,46,103,56,40,7,59,38,21,1,1,39,15,24
"2021","North East Derbyshire 007D","E01019823",532,228,109,119,294,49,123,46,53,24,68,36,30,2,53,35,18,1,1,10,8,2
"2021","North East Derbyshire 008A","E01019771",949,306,180,126,612,153,319,150,119,50,72,47,19,6,66,33,33,2,2,31,14,17
"2021","North East Derbyshire 008B","E01019772",643,130,90,40,490,107,275,126,101,48,62,42,16,4,43,24,19,3,3,23,8,15
"2021","North East Derbyshire 008C","E01019828",669,191,153,38,462,206,197,90,68,39,38,21,14,3,19,6,13,2,2,16,4,12
"2021","North East Derbyshire 008D","E01019829",605,167,103,64,425,102,221,94,80,47,59,36,18,5,43,18,25,0,0,13,3,10
"2021","North East Derbyshire 009A","E01019796",506,138,71,67,352,46,118,43,47,28,79,36,37,6,105,74,31,4,4,16,6,10
"2021","North East Derbyshire 009B","E01019797",828,287,84,203,517,51,223,89,89,45,147,64,76,7,92,51,41,4,4,24,8,16
"2021","North East Derbyshire 009C","E01019799",1156,462,123,339,653,66,247,113,98,36,197,109,80,8,134,93,41,9,9,41,17,24
"2021","North East Derbyshire 009D","E01019800",745,216,72,144,497,75,238,97,80,61,112,57,47,8,67,43,24,5,5,32,17,15
"2021","North East Derbyshire 009E","E01019808",739,250,113,137,462,48,172,71,67,34,110,42,58,10,130,96,34,2,2,27,15,12
"2021","North East Derbyshire 009F","E01019826",648,227,92,135,396,53,169,62,75,32,97,50,45,2,75,42,33,2,2,25,9,16
"2021","North East Derbyshire 010A","E01019769",851,232,125,107,565,148,310,147,110,53,77,35,35,7,28,15,13,2,2,54,24,30
"2021","North East Derbyshire 010B","E01019774",882,294,142,152,566,199,212,102,71,39,107,78,22,7,45,14,31,3,3,22,11,11
"2021","North East Derbyshire 010C","E01019824",808,221,100,121,565,76,245,93,107,45,156,102,47,7,85,51,34,3,3,22,13,9
"2021","North East Derbyshire 010D","E01019830",662,147,90,57,496,124,253,96,101,56,71,45,19,7,46,29,17,2,2,19,10,9
"2021","North East Derbyshire 010E","E01019831",608,177,98,79,419,83,218,93,92,33,77,43,32,2,39,18,21,2,2,12,4,8
"2021","North East Derbyshire 011A","E01019809",523,187,81,106,318,77,131,72,28,31,59,30,25,4,47,22,25,4,4,18,7,11
"2021","North East Derbyshire 011B","E01019810",750,321,81,240,417,50,191,93,57,41,104,56,43,5,71,43,28,1,1,12,4,8
"2021","North East Derbyshire 011C","E01019811",648,172,91,81,458,107,231,100,83,48,72,45,23,4,47,29,18,1,1,18,10,8
"2021","North East Derbyshire 011D","E01019812",813,224,86,138,565,100,278,124,98,56,123,74,45,4,62,38,24,2,2,24,9,15
"2021","North East Derbyshire 011E","E01019813",728,241,103,138,454,59,220,91,77,52,104,45,50,9,69,35,34,2,2,33,13,20
"2021","North East Derbyshire 011F","E01019825",594,162,96,66,413,74,214,99,73,42,69,36,29,4,55,25,30,1,1,19,10,9
"2021","North East Derbyshire 012B","E01019775",1068,393,135,258,646,63,283,102,137,44,165,92,69,4,129,93,36,6,6,29,15,14
"2021","North East Derbyshire 012C","E01019776",640,210,110,100,411,97,167,93,39,35,77,42,29,6,69,38,31,1,1,19,6,13
"2021","North East Derbyshire 012D","E01019777",1066,348,150,198,695,96,254,105,104,45,170,79,85,6,167,116,51,8,8,23,8,15
"2021","North East Derbyshire 012E","E01034648",608,177,73,104,411,57,210,68,103,39,80,42,31,7,63,43,20,1,1,20,10,10
"2021","North East Derbyshire 012F","E01034649",641,374,161,213,252,42,97,39,28,30,55,32,21,2,58,27,31,0,0,15,6,9
"2021","North East Derbyshire 013A","E01019814",830,235,113,122,576,131,295,124,117,54,90,46,36,8,59,30,29,1,1,19,9,10
"2021","North East Derbyshire 013B","E01019817",555,144,81,63,383,52,148,53,58,37,81,21,51,9,98,71,27,4,4,28,19,9
"2021","North East Derbyshire 013C","E01019818",718,214,93,121,486,61,217,94,75,48,114,65,44,5,88,66,22,6,6,18,10,8
"2021","North East Derbyshire 013D","E01019819",765,200,91,109,531,96,254,127,93,34,125,78,42,5,50,33,17,6,6,34,14,20
"2021","North East Derbyshire 013E","E01019820",679,191,91,100,468,127,218,94,79,45,80,47,32,1,39,24,15,4,4,20,7,13
"2021","North East Derbyshire 014A","E01019791",867,270,114,156,571,78,250,107,97,46,129,64,53,12,110,70,40,4,4,26,11,15
"2021","North East Derbyshire 014B","E01019792",919,314,140,174,578,68,260,100,103,57,119,51,53,15,130,90,40,1,1,27,9,18
"2021","North East Derbyshire 014C","E01019815",1135,340,122,218,766,79,343,123,154,66,191,93,83,15,149,93,56,4,4,29,20,9
"2021","North East Derbyshire 014D","E01032586",753,281,146,135,446,78,196,69,81,46,86,38,39,9,83,57,26,3,3,26,11,15
"2021","South Derbyshire 001A","E01019839",1112,216,64,152,848,79,476,167,230,79,194,122,66,6,95,77,18,4,4,48,19,29
"2021","South Derbyshire 001B","E01019845",563,173,62,111,373,62,179,75,82,22,81,48,27,6,49,27,22,2,2,17,8,9
"2021","South Derbyshire 001C","E01019846",596,193,99,94,386,52,165,69,67,29,102,48,44,10,65,37,28,2,2,17,11,6
"2021","South Derbyshire 001D","E01019866",858,199,94,105,617,127,376,159,153,64,73,35,33,5,40,15,25,1,1,42,19,23
"2021","South Derbyshire 002A","E01019840",745,220,126,94,506,106,258,91,136,31,76,33,38,5,66,51,15,0,0,19,5,14
"2021","South Derbyshire 002B","E01019841",790,201,116,85,556,128,288,104,137,47,82,53,25,4,57,40,17,1,1,33,13,20
"2021","South Derbyshire 002C","E01019847",609,182,105,77,412,81,215,85,82,48,69,37,29,3,46,26,20,1,1,15,3,12
"2021","South Derbyshire 002D","E01019848",1044,216,34,182,797,37,450,124,252,74,198,127,68,3,108,87,21,4,4,31,22,9
"2021","South Derbyshire 002F","E01033532",623,144,40,104,452,34,238,77,125,36,110,59,47,4,70,47,23,0,0,27,10,17
"2021","South Derbyshire 002G","E01033533",595,102,31,71,481,41,276,66,171,39,91,50,39,2,69,54,15,4,4,12,6,6
"2021","South Derbyshire 002H","E01033534",491,217,15,202,259,12,129,30,87,12,83,59,20,4,35,27,8,0,0,15,7,8
"2021","South Derbyshire 003A","E01019873",1037,283,63,220,698,47,351,98,193,60,174,107,57,10,117,83,34,9,9,56,33,23
"2021","South Derbyshire 003B","E01019874",572,139,79,60,411,85,226,88,78,60,58,28,24,6,41,17,24,1,1,22,13,9
"2021","South Derbyshire 003C","E01019875",480,90,21,69,332,41,200,58,67,75,47,21,21,5,41,24,17,3,3,58,39,19
"2021","South Derbyshire 003E","E01019882",894,291,145,146,568,110,249,120,96,33,119,71,39,9,89,63,26,1,1,35,16,19
"2021","South Derbyshire 003F","E01034650",939,193,13,180,708,9,378,86,272,20,189,126,60,3,131,110,21,1,1,38,17,21
"2021","South Derbyshire 003G","E01034651",566,141,90,51,412,119,219,82,88,49,43,22,19,2,28,11,17,3,3,13,5,8
"2021","South Derbyshire 004A","E01019832",785,234,107,127,536,104,266,147,82,37,114,74,33,7,50,20,30,2,2,15,6,9
"2021","South Derbyshire 004B","E01019833",910,240,173,67,632,170,337,121,161,55,78,43,30,5,47,29,18,0,0,38,13,25
"2021","South Derbyshire 004C","E01019834",1017,236,98,138,745,109,379,123,203,53,140,82,51,7,112,89,23,5,5,36,17,19
"2021","South Derbyshire 004E","E01034652",553,92,25,67,429,29,283,94,125,64,78,51,27,0,36,21,15,3,3,32,16,16
"2021","South Derbyshire 004F","E01034653",608,131,19,112,456,23,205,62,120,23,141,82,53,6,83,72,11,4,4,21,9,12
"2021","South Derbyshire 005A","E01019867",702,148,91,57,523,114,277,141,88,48,89,57,25,7,42,24,18,1,1,31,15,16
"2021","South Derbyshire 005B","E01019868",818,204,95,109,584,82,325,121,160,44,95,54,35,6,80,50,30,2,2,30,14,16
"2021","South Derbyshire 005C","E01019869",493,122,63,59,354,84,189,63,89,37,52,36,15,1,28,20,8,1,1,17,7,10
"2021","South Derbyshire 005D","E01019880",717,178,87,91,525,118,285,110,112,63,77,42,27,8,43,26,17,2,2,14,9,5
"2021","South Derbyshire 006A","E01019843",690,216,115,101,451,85,244,111,81,52,80,62,12,6,40,17,23,2,2,23,11,12
"2021","South Derbyshire 006B","E01019853",734,199,111,88,517,98,277,100,134,43,77,38,36,3,63,40,23,2,2,18,5,13
"2021","South Derbyshire 006C","E01019854",961,364,187,177,574,100,279,97,135,47,110,75,31,4,83,53,30,2,2,23,11,12
"2021","South Derbyshire 006D","E01019855",668,188,110,78,460,76,268,103,114,51,62,39,19,4,51,30,21,3,3,20,9,11
"2021","South Derbyshire 007A","E01019844",660,169,106,63,465,101,205,81,78,46,79,37,37,5,78,48,30,2,2,26,13,13
"2021","South Derbyshire 007B","E01019856",642,204,76,128,413,49,169,73,65,31,97,46,44,7,97,53,44,1,1,25,13,12
"2021","South Derbyshire 007C","E01019857",535,84,28,56,431,44,262,102,110,50,84,38,39,7,40,27,13,1,1,20,9,11
"2021","South Derbyshire 007D","E01019858",626,161,88,73,439,75,173,64,72,37,85,30,46,9,106,73,33,0,0,26,11,15
"2021","South Derbyshire 007E","E01019859",728,191,101,90,512,119,249,109,96,44,92,54,33,5,52,24,28,0,0,25,11,14
"2021","South Derbyshire 008A","E01019860",504,123,65,58,369,81,199,80,67,52,62,30,25,7,27,14,13,0,0,12,8,4
"2021","South Derbyshire 008B","E01019861",776,224,92,132,521,77,242,120,79,43,121,65,46,10,77,53,24,4,4,31,14,17
"2021","South Derbyshire 008C","E01019862",684,171,93,78,480,106,205,79,84,42,110,56,49,5,57,37,20,2,2,33,16,17
"2021","South Derbyshire 008D","E01019863",690,264,99,165,401,51,149,61,61,27,99,54,39,6,101,68,33,1,1,25,11,14
"2021","South Derbyshire 008E","E01019864",585,167,56,111,391,53,174,69,70,35,94,50,38,6,68,44,24,2,2,27,12,15
"2021","South Derbyshire 008F","E01019865",555,158,61,97,376,46,175,79,61,35,88,51,35,2,66,42,24,1,1,21,9,12
"2021","South Derbyshire 009A","E01019876",810,254,130,124,520,94,248,93,106,49,98,51,44,3,77,49,28,3,3,36,18,18
"2021","South Derbyshire 009B","E01019877",1038,485,217,268,518,62,190,78,85,27,149,80,66,3,115,74,41,2,2,35,14,21
"2021","South Derbyshire 009C","E01019878",646,194,102,92,426,84,199,86,73,40,78,43,30,5,65,41,24,0,0,26,13,13
"2021","South Derbyshire 009D","E01019879",895,204,100,104,673,113,346,147,127,72,145,83,56,6,68,37,31,1,1,18,9,9
"2021","South Derbyshire 011A","E01019850",973,194,102,92,750,127,416,172,175,69,130,81,46,3,75,40,35,2,2,29,10,19
"2021","South Derbyshire 011B","E01019851",725,213,91,122,483,79,198,86,74,38,117,51,57,9,84,41,43,5,5,29,17,12
"2021","South Derbyshire 011C","E01019852",857,221,78,143,600,87,283,103,124,56,131,59,62,10,96,56,40,3,3,36,22,14
"2021","South Derbyshire 011D","E01019870",687,189,95,94,477,108,217,97,77,43,88,49,34,5,64,43,21,0,0,21,10,11
"2021","South Derbyshire 011E","E01019871",744,210,119,91,504,102,262,111,106,45,92,53,36,3,46,25,21,2,2,30,14,16
"2021","South Derbyshire 011F","E01019872",904,238,98,140,629,104,313,140,105,68,144,84,48,12,64,36,28,4,4,37,18,19
"2021","South Derbyshire 012A","E01019837",893,285,72,213,583,64,267,113,115,39,140,63,69,8,107,72,35,5,5,25,12,13
"2021","South Derbyshire 012B","E01019838",697,258,101,157,415,65,162,55,68,39,97,51,37,9,88,58,30,3,3,24,12,12
"2021","South Derbyshire 012D","E01033536",770,212,53,159,528,46,243,84,119,40,133,66,62,5,103,80,23,3,3,30,11,19
"2021","South Derbyshire 012E","E01033537",714,198,93,105,491,74,209,97,81,31,114,57,47,10,88,60,28,6,6,25,9,16
"2021","South Derbyshire 012F","E01034654",733,161,24,137,554,21,306,105,167,34,174,105,65,4,49,37,12,4,4,18,12,6
"2021","South Derbyshire 012G","E01034655",683,179,36,143,488,20,256,105,131,20,127,67,54,6,81,61,20,4,4,16,7,9
"2021","South Derbyshire 013A","E01019842",665,156,81,75,475,53,197,75,77,45,104,46,48,10,119,76,43,2,2,34,20,14
"2021","South Derbyshire 013C","E01019885",710,192,63,129,496,61,234,102,88,44,139,89,45,5,60,37,23,2,2,22,10,12
"2021","South Derbyshire 013D","E01033535",548,110,37,73,413,32,268,92,126,50,68,25,35,8,43,28,15,2,2,25,15,10
"2021","South Derbyshire 013E","E01034656",748,286,84,202,428,29,179,67,77,35,103,55,45,3,112,83,29,5,5,34,16,18
"2021","South Derbyshire 013F","E01034657",675,149,31,118,498,28,251,91,131,29,155,77,72,6,62,51,11,2,2,28,17,11
"2021","Blaby 002A","E01025631",622,150,76,74,448,51,213,65,113,35,107,47,55,5,73,45,28,4,4,24,10,14
"2021","Blaby 002B","E01025632",495,69,22,47,389,31,256,83,111,62,52,26,21,5,50,30,20,0,0,37,18,19
"2021","Blaby 002C","E01025633",743,172,95,77,520,65,274,91,129,54,103,55,44,4,73,43,30,5,5,51,22,29
"2021","Blaby 002D","E01025635",482,110,65,45,345,67,176,64,74,38,63,24,34,5,36,21,15,3,3,27,16,11
"2021","Blaby 003A","E01025634",713,140,66,74,527,73,295,60,175,60,98,52,41,5,57,39,18,4,4,46,25,21
"2021","Blaby 003B","E01025638",645,176,118,58,453,156,238,84,106,48,32,18,12,2,25,9,16,2,2,16,8,8
"2021","Blaby 003C","E01025639",564,174,110,64,363,81,183,60,86,37,59,29,24,6,40,23,17,0,0,27,12,15
"2021","Blaby 003D","E01025640",668,185,100,85,459,88,252,81,138,33,70,41,28,1,47,26,21,2,2,24,16,8
"2021","Blaby 003E","E01025645",487,128,70,58,339,58,186,73,74,39,58,34,21,3,35,18,17,2,2,20,11,9
"2021","Blaby 004A","E01025666",651,201,86,115,401,50,192,64,86,42,82,30,43,9,74,44,30,3,3,49,27,22
"2021","Blaby 004B","E01025667",494,134,76,58,314,45,140,46,58,36,68,22,39,7,54,28,26,7,7,46,21,25
"2021","Blaby 004C","E01025668",908,218,63,155,627,37,331,99,185,47,152,85,62,5,98,68,30,9,9,63,31,32
"2021","Blaby 004D","E01025669",814,157,27,130,563,21,310,92,174,44,138,73,55,10,88,60,28,6,6,94,47,47
"2021","Blaby 005A","E01025636",603,224,138,86,331,64,170,66,62,42,45,18,23,4,46,26,20,6,6,48,25,23
"2021","Blaby 005B","E01025637",540,154,72,82,343,50,180,62,74,44,42,18,20,4,68,43,25,3,3,43,24,19
"2021","Blaby 005C","E01025652",506,98,58,40,350,55,179,65,75,39,49,19,22,8,63,38,25,4,4,58,34,24
"2021","Blaby 005D","E01025653",659,220,97,123,393,35,197,51,102,44,87,39,44,4,69,37,32,5,5,46,19,27
"2021","Blaby 005E","E01025654",509,125,89,36,360,52,187,41,97,49,73,37,32,4,42,24,18,6,6,24,9,15
"2021","Blaby 005F","E01025655",630,149,77,72,413,66,217,69,95,53,67,36,28,3,55,28,27,8,8,68,37,31
"2021","Blaby 005G","E01025656",496,107,56,51,327,39,188,47,81,60,37,16,20,1,58,27,31,5,5,62,34,28
"2021","Blaby 006A","E01025625",572,197,90,107,359,44,160,70,59,31,65,34,26,5,89,62,27,1,1,16,5,11
"2021","Blaby 006B","E01025626",1092,307,90,217,731,45,343,118,179,46,238,140,90,8,101,76,25,4,4,54,15,39
"2021","Blaby 006C","E01025627",980,255,99,156,684,90,321,98,159,64,132,58,59,15,137,90,47,4,4,41,19,22
"2021","Blaby 006D","E01025651",632,147,84,63,457,80,255,94,112,49,78,27,43,8,42,17,25,2,2,28,13,15
"2021","Blaby 006E","E01025657",852,266,153,113,544,85,266,94,120,52,124,55,55,14,65,39,26,4,4,42,17,25
"2021","Blaby 006F","E01025660",674,180,107,73,454,87,235,86,97,52,86,36,41,9,42,22,20,4,4,40,21,19
"2021","Blaby 007A","E01025641",870,281,139,142,565,101,243,89,103,51,131,73,51,7,89,63,26,1,1,24,12,12
"2021","Blaby 007B","E01025642",834,287,131,156,515,72,246,89,119,38,118,63,52,3,78,41,37,1,1,32,15,17
"2021","Blaby 007C","E01025643",663,163,76,87,479,63,233,65,120,48,103,56,43,4,75,35,40,5,5,21,12,9
"2021","Blaby 007D","E01025649",763,179,104,75,552,122,287,96,144,47,83,48,33,2,58,37,21,2,2,32,13,19
"2021","Blaby 007E","E01025650",564,109,47,62,435,58,256,84,115,57,65,37,22,6,53,25,28,3,3,20,11,9
"2021","Blaby 008A","E01025610",667,198,103,95,439,64,192,63,79,50,104,48,47,9,76,44,32,3,3,30,12,18
"2021","Blaby 008B","E01025611",665,163,100,63,483,98,213,75,92,46,101,49,43,9,71,47,24,0,0,19,8,11
"2021","Blaby 008C","E01025612",923,269,167,102,616,125,248,86,113,49,132,61,63,8,108,73,35,3,3,38,12,26
"2021","Blaby 008D","E01025658",731,171,66,105,522,76,253,88,118,47,121,60,44,17,70,42,28,2,2,38,18,20
"2021","Blaby 008E","E01025659",933,363,176,187,533,136,199,78,81,40,115,69,44,2,81,47,34,2,2,37,14,23
"2021","Blaby 009A","E01025615",852,116,39,77,705,77,437,130,224,83,115,47,59,9,74,56,18,2,2,31,13,18
"2021","Blaby 009B","E01025646",722,242,107,135,451,69,179,66,67,46,105,60,37,8,93,59,34,5,5,29,13,16
"2021","Blaby 009C","E01025647",715,242,116,126,456,86,170,62,73,35,100,49,46,5,100,62,38,0,0,17,10,7
"2021","Blaby 009D","E01025648",800,134,53,81,635,72,364,106,188,70,124,54,61,9,74,45,29,1,1,31,11,20
"2021","Blaby 010A","E01025613",685,215,117,98,440,94,191,75,81,35,80,33,43,4,75,46,29,0,0,30,11,19
"2021","Blaby 010B","E01025614",690,165,90,75,506,91,263,90,117,56,81,49,23,9,70,48,22,1,1,19,8,11
"2021","Blaby 010C","E01025620",509,132,75,57,352,64,174,70,63,41,69,25,35,9,42,29,13,3,3,25,13,12
"2021","Blaby 010D","E01025621",548,121,66,55,406,94,203,93,81,29,78,42,32,4,31,19,12,0,0,21,13,8
"2021","Blaby 010E","E01025644",707,154,64,90,525,92,231,88,107,36,109,38,64,7,90,60,30,3,3,28,12,16
"2021","Blaby 011A","E01025616",769,151,82,69,600,101,347,107,169,71,100,57,41,2,50,30,20,2,2,18,9,9
"2021","Blaby 011B","E01025617",883,190,117,73,671,161,299,117,134,48,115,58,47,10,95,57,38,1,1,22,12,10
"2021","Blaby 011C","E01025618",757,260,141,119,470,102,218,85,83,50,89,46,40,3,59,36,23,2,2,27,12,15
"2021","Blaby 011D","E01025619",920,228,122,106,672,131,308,106,138,64,132,60,64,8,99,66,33,2,2,20,12,8
"2021","Blaby 012A","E01025661",969,182,65,117,746,84,379,122,202,55,165,92,65,8,118,91,27,0,0,41,17,24
"2021","Blaby 012B","E01025662",834,235,93,142,580,89,271,96,135,40,130,71,50,9,85,55,30,5,5,19,5,14
"2021","Blaby 012C","E01025663",677,160,92,68,498,113,249,99,111,39,84,43,38,3,44,27,17,8,8,19,6,13
"2021","Blaby 012D","E01025664",600,151,92,59,433,101,215,80,93,42,64,34,24,6,50,27,23,3,3,16,5,11
"2021","Blaby 012E","E01025665",818,218,122,96,576,136,266,130,99,37,108,55,44,9,63,36,27,3,3,24,11,13
"2021","Blaby 013A","E01025622",755,235,129,106,478,108,203,72,84,47,79,41,33,5,83,43,40,5,5,42,13,29
"2021","Blaby 013B","E01025623",764,232,143,89,495,98,247,91,106,50,81,44,30,7,68,46,22,1,1,37,15,22
"2021","Blaby 013C","E01025624",952,170,74,96,734,100,416,125,209,82,132,64,56,12,83,55,28,3,3,48,26,22
"2021","Blaby 013D","E01025629",655,176,105,71,445,102,192,53,88,51,74,30,38,6,73,45,28,4,4,34,16,18
"2021","Blaby 013E","E01025630",706,163,105,58,494,105,281,78,146,57,66,26,35,5,38,18,20,4,4,49,25,24
"2021","Blaby 013F","E01032603",659,203,142,61,411,125,171,59,57,55,59,30,25,4,53,21,32,3,3,45,13,32
"2021","Charnwood 001B","E01025692",844,219,81,138,575,72,307,108,127,72,97,59,30,8,94,50,44,5,5,50,25,25
"2021","Charnwood 001C","E01025693",1062,292,136,156,740,146,347,139,161,47,151,91,56,4,94,51,43,2,2,30,15,15
"2021","Charnwood 001E","E01033386",908,271,112,159,587,102,276,112,100,64,103,55,39,9,100,54,46,6,6,50,26,24
"2021","Charnwood 002A","E01025699",853,501,115,386,305,11,103,39,48,16,102,77,23,2,80,51,29,9,9,47,21,26
"2021","Charnwood 002B","E01025700",953,339,42,297,520,12,217,70,121,26,152,107,43,2,126,92,34,13,13,94,30,64
"2021","Charnwood 002C","E01025701",748,284,82,202,387,29,162,55,83,24,105,73,29,3,81,48,33,10,10,77,28,49
"2021","Charnwood 002D","E01025703",862,368,57,311,369,31,173,54,85,34,94,75,18,1,63,32,31,8,8,125,41,84
"2021","Charnwood 002E","E01025704",685,265,99,166,333,39,158,63,59,36,62,34,23,5,68,37,31,6,6,87,19,68
"2021","Charnwood 002F","E01025705",634,192,29,163,366,8,155,39,101,15,102,67,34,1,90,64,26,11,11,76,24,52
"2021","Charnwood 002G","E01025706",784,279,83,196,449,24,236,85,114,37,91,49,32,10,94,57,37,4,4,56,20,36
"2021","Charnwood 003A","E01025720",716,226,40,186,202,15,94,30,46,18,46,33,11,2,35,29,6,12,12,288,11,277
"2021","Charnwood 003B","E01025721",623,153,63,90,228,37,110,47,45,18,43,32,10,1,32,17,15,6,6,242,12,230
"2021","Charnwood 003C","E01025722",422,100,52,48,271,64,126,50,33,43,46,25,17,4,32,13,19,3,3,51,13,38
"2021","Charnwood 003D","E01025723",673,136,43,93,277,24,112,32,57,23,65,39,23,3,61,44,17,15,15,260,19,241
"2021","Charnwood 003E","E01025724",631,129,26,103,162,11,59,20,33,6,49,32,16,1,31,17,14,12,12,340,12,328
"2021","Charnwood 003F","E01025725",579,254,99,155,290,41,106,33,47,26,55,26,23,6,84,57,27,4,4,35,16,19
"2021","Charnwood 004A","E01025695",635,196,81,115,416,103,212,96,67,49,60,42,17,1,38,20,18,3,3,23,6,17
"2021","Charnwood 004B","E01025696",541,119,60,59,399,84,222,82,82,58,52,23,25,4,39,14,25,2,2,23,12,11
"2021","Charnwood 004C","E01025697",680,330,184,146,318,85,135,58,45,32,54,28,25,1,41,22,19,3,3,32,10,22
"2021","Charnwood 004D","E01025698",640,172,98,74,434,100,221,83,90,48,61,28,30,3,46,21,25,6,6,34,9,25
"2021","Charnwood 005A","E01025744",1102,220,92,128,842,136,435,152,194,89,170,93,72,5,99,65,34,2,2,40,11,29
"2021","Charnwood 005B","E01025745",645,188,113,75,441,98,206,84,75,47,81,41,37,3,53,26,27,3,3,16,8,8
"2021","Charnwood 005C","E01025746",895,295,126,169,566,78,270,111,118,41,111,51,53,7,101,65,36,6,6,34,15,19
"2021","Charnwood 005D","E01025747",786,251,113,138,505,74,216,81,94,41,126,67,54,5,80,55,25,9,9,30,11,19
"2021","Charnwood 006A","E01025740",714,255,92,163,434,77,207,99,70,38,92,53,32,7,55,31,24,3,3,25,8,17
"2021","Charnwood 006B","E01025741",648,199,99,100,435,95,247,103,90,54,67,38,27,2,25,14,11,1,1,14,4,10
"2021","Charnwood 006C","E01025742",670,210,83,127,434,73,194,64,88,42,78,29,48,1,88,48,40,1,1,26,9,17
"2021","Charnwood 006D","E01025743",1028,324,111,213,673,85,312,111,145,56,176,96,73,7,97,72,25,3,3,31,10,21
"2021","Charnwood 007A","E01025689",797,189,96,93,444,52,176,57,85,34,93,45,45,3,109,68,41,14,14,164,26,138
"2021","Charnwood 007B","E01025690",537,139,39,100,298,19,125,31,60,34,60,19,33,8,87,50,37,7,7,100,14,86
"2021","Charnwood 007C","E01025707",552,161,94,67,336,70,209,56,119,34,30,12,14,4,25,12,13,2,2,55,8,47
"2021","Charnwood 007D","E01025709",473,99,61,38,320,63,195,55,95,45,30,18,10,2,27,10,17,5,5,54,7,47
"2021","Charnwood 008A","E01025760",563,126,77,49,405,93,230,95,99,36,49,31,15,3,33,16,17,0,0,32,14,18
"2021","Charnwood 008B","E01025761",750,165,92,73,553,82,345,112,179,54,84,52,29,3,40,24,16,2,2,32,10,22
"2021","Charnwood 008C","E01025768",600,146,83,63,430,99,251,99,115,37,48,29,16,3,30,20,10,2,2,24,10,14
"2021","Charnwood 008D","E01025769",611,135,82,53,448,87,269,97,113,59,56,34,16,6,33,20,13,3,3,28,11,17
"2021","Charnwood 009A","E01025702",529,145,53,92,358,60,188,84,57,47,73,48,24,1,36,15,21,1,1,26,9,17
"2021","Charnwood 009B","E01025715",643,192,80,112,416,34,173,66,68,39,80,32,37,11,124,78,46,5,5,35,22,13
"2021","Charnwood 009C","E01025716",612,153,81,72,408,45,189,62,82,45,80,32,39,9,86,49,37,8,8,51,19,32
"2021","Charnwood 009E","E01025718",558,273,93,180,238,30,96,39,45,12,59,36,22,1,48,25,23,5,5,47,7,40
"2021","Charnwood 009F","E01025719",618,158,77,81,390,68,207,73,107,27,71,34,34,3,42,20,22,2,2,70,14,56
"2021","Charnwood 009G","E01034002",595,120,54,66,421,26,179,44,92,43,85,22,57,6,129,76,53,2,2,54,31,23
"2021","Charnwood 009H","E01034003",595,106,12,94,458,18,242,74,143,25,140,81,53,6,57,48,9,1,1,31,12,19
"2021","Charnwood 010A","E01025708",538,107,88,19,409,111,231,78,117,36,27,14,11,2,36,18,18,4,4,22,10,12
"2021","Charnwood 010B","E01025710",501,139,96,43,326,75,195,73,92,30,33,20,8,5,22,13,9,1,1,36,13,23
"2021","Charnwood 010C","E01025711",633,172,130,42,436,118,255,100,114,41,36,19,16,1,25,10,15,2,2,25,9,16
"2021","Charnwood 010D","E01025712",655,169,132,37,457,123,227,67,108,52,54,29,24,1,50,24,26,3,3,29,9,20
"2021","Charnwood 010E","E01025713",509,116,61,55,352,74,200,65,98,37,43,25,16,2,34,13,21,1,1,41,7,34
"2021","Charnwood 010G","E01034004",691,156,17,139,499,20,292,87,183,22,109,65,43,1,73,59,14,5,5,36,11,25
"2021","Charnwood 010H","E01034005",583,122,40,82,432,50,271,94,125,52,64,41,18,5,45,26,19,2,2,29,11,18
"2021","Charnwood 011A","E01025674",858,264,101,163,557,101,243,109,100,34,137,76,57,4,75,48,27,1,1,37,14,23
"2021","Charnwood 011B","E01025675",691,210,93,117,454,100,203,87,76,40,94,56,35,3,54,34,20,3,3,27,12,15
"2021","Charnwood 011C","E01025676",997,224,100,124,735,127,407,119,226,62,118,58,57,3,81,59,22,2,2,38,15,23
"2021","Charnwood 011D","E01025677",677,235,115,120,418,72,208,81,89,38,71,35,29,7,65,42,23,2,2,24,11,13
"2021","Charnwood 012A","E01025732",813,217,78,139,561,99,317,121,155,41,61,38,17,6,81,46,35,3,3,35,10,25
"2021","Charnwood 012B","E01025733",810,251,111,140,544,115,260,95,135,30,97,61,30,6,70,43,27,2,2,15,6,9
"2021","Charnwood 012C","E01025734",708,170,123,47,517,125,304,95,151,58,50,23,22,5,36,21,15,2,2,21,10,11
"2021","Charnwood 012D","E01025735",889,333,118,215,526,88,232,107,95,30,123,86,33,4,78,48,30,5,5,30,11,19
"2021","Charnwood 013A","E01025748",977,317,111,206,620,72,280,121,114,45,147,87,53,7,115,66,49,6,6,40,10,30
"2021","Charnwood 013B","E01025749",829,169,84,85,613,39,308,101,158,49,147,70,68,9,113,71,42,6,6,47,17,30
"2021","Charnwood 013C","E01025750",796,182,89,93,586,104,266,94,121,51,134,63,67,4,77,52,25,5,5,28,16,12
"2021","Charnwood 013D","E01025751",940,292,108,184,609,53,257,93,117,47,177,82,86,9,117,79,38,5,5,39,10,29
"2021","Charnwood 014A","E01025726",847,267,70,197,556,61,269,102,125,42,129,78,44,7,97,60,37,0,0,24,6,18
"2021","Charnwood 014B","E01025727",685,234,88,146,414,42,181,65,81,35,100,57,32,11,88,64,24,3,3,37,17,20
"2021","Charnwood 014C","E01025728",876,241,117,124,614,104,280,102,133,45,135,75,54,6,95,62,33,0,0,21,13,8
"2021","Charnwood 014D","E01025729",660,168,90,78,476,66,264,113,96,55,87,50,34,3,59,35,24,0,0,16,8,8
"2021","Charnwood 014E","E01025737",1178,269,119,150,867,93,427,143,227,57,197,109,78,10,145,110,35,5,5,42,18,24
"2021","Charnwood 014F","E01025739",988,252,121,131,707,127,338,108,189,41,148,91,53,4,88,58,30,6,6,29,12,17
"2021","Charnwood 015A","E01025685",536,141,82,59,370,90,154,50,67,37,66,25,35,6,59,31,28,1,1,25,10,15
"2021","Charnwood 015B","E01025686",600,105,59,46,473,79,270,72,136,62,81,35,39,7,43,24,19,0,0,22,7,15
"2021","Charnwood 015C","E01025730",1150,234,115,119,853,118,485,158,243,84,147,84,55,8,99,75,24,4,4,63,34,29
"2021","Charnwood 015D","E01025731",755,163,116,47,541,126,284,102,109,73,78,32,39,7,51,25,26,2,2,51,23,28
"2021","Charnwood 016A","E01025687",672,156,86,70,478,141,270,100,110,60,42,26,13,3,24,11,13,1,1,38,12,26
"2021","Charnwood 016B","E01025688",681,202,117,85,460,80,255,88,139,28,78,44,31,3,43,26,17,4,4,19,8,11
"2021","Charnwood 016C","E01025736",625,139,98,41,466,121,244,120,78,46,66,38,24,4,34,18,16,1,1,20,8,12
"2021","Charnwood 016D","E01025738",617,125,87,38,468,110,282,83,133,66,51,33,14,4,25,13,12,0,0,24,7,17
"2021","Charnwood 017A","E01025756",872,325,121,204,506,47,207,82,91,34,142,79,54,9,107,78,29,3,3,41,16,25
"2021","Charnwood 017B","E01025757",548,132,43,89,392,54,205,72,81,52,63,29,31,3,67,40,27,3,3,24,10,14
"2021","Charnwood 017C","E01025758",654,153,80,73,458,60,296,101,107,88,45,20,21,4,56,35,21,1,1,43,28,15
"2021","Charnwood 017D","E01025759",709,326,169,157,361,85,150,64,54,32,65,34,25,6,61,34,27,0,0,22,12,10
"2021","Charnwood 018A","E01025752",1148,248,112,136,850,111,431,135,230,66,160,60,91,9,143,98,45,5,5,50,32,18
"2021","Charnwood 018B","E01025753",696,239,119,120,428,57,195,47,97,51,89,41,43,5,82,56,26,5,5,29,12,17
"2021","Charnwood 018C","E01025754",524,121,77,44,393,93,187,73,62,52,71,28,40,3,41,25,16,1,1,10,4,6
"2021","Charnwood 018D","E01025755",626,171,94,77,422,86,199,73,78,48,83,50,28,5,52,27,25,2,2,33,14,19
"2021","Charnwood 019B","E01025680",648,132,86,46,485,110,273,72,124,77,42,28,11,3,53,29,24,7,7,31,20,11
"2021","Charnwood 019C","E01025681",705,202,138,64,450,108,264,92,106,66,41,18,18,5,33,14,19,4,4,53,28,25
"2021","Charnwood 019D","E01025682",621,193,137,56,401,116,188,57,74,57,45,10,34,1,52,26,26,0,0,27,11,16
"2021","Charnwood 019E","E01034006",871,176,22,154,625,21,380,95,240,45,114,62,48,4,104,66,38,6,6,70,39,31
"2021","Charnwood 019F","E01034007",712,162,117,45,513,107,313,94,138,81,47,14,27,6,42,14,28,4,4,37,14,23
"2021","Charnwood 020A","E01025678",671,142,87,55,484,81,305,93,134,78,52,24,25,3,44,13,31,2,2,45,18,27
"2021","Charnwood 020B","E01025683",664,190,98,92,438,54,240,68,120,52,72,29,38,5,71,35,36,1,1,36,22,14
"2021","Charnwood 020C","E01025684",759,191,101,90,523,73,261,85,112,64,79,35,33,11,101,48,53,9,9,45,22,23
"2021","Charnwood 021A","E01025762",703,244,110,134,429,67,211,88,76,47,73,28,41,4,75,51,24,3,3,30,15,15
"2021","Charnwood 021B","E01025763",734,249,118,131,435,88,229,80,93,56,56,26,23,7,62,44,18,0,0,50,22,28
"2021","Charnwood 021C","E01025764",512,112,71,41,355,56,214,58,96,60,32,11,14,7,51,21,30,2,2,45,26,19
"2021","Charnwood 021D","E01025765",596,132,82,50,409,92,224,56,81,87,35,19,14,2,49,15,34,9,9,55,32,23
"2021","Charnwood 021E","E01025766",860,276,98,178,537,55,217,68,98,51,119,44,63,12,142,96,46,4,4,47,26,21
"2021","Charnwood 021F","E01025767",627,175,89,86,414,64,244,84,99,61,44,21,18,5,57,27,30,5,5,38,22,16
"2021","Charnwood 022A","E01025670",514,140,94,46,343,64,155,53,67,35,62,20,36,6,62,33,29,0,0,31,17,14
"2021","Charnwood 022B","E01025671",1024,259,117,142,729,109,332,121,154,57,182,106,66,10,99,74,25,7,7,36,15,21
"2021","Charnwood 022C","E01025672",951,220,121,99,698,121,350,113,183,54,122,69,42,11,102,67,35,3,3,33,17,16
"2021","Charnwood 022D","E01025673",846,329,151,178,489,97,215,80,81,54,115,67,36,12,61,35,26,1,1,28,7,21
"2021","Harborough 002A","E01025770",805,219,111,108,552,121,309,134,123,52,65,36,25,4,53,34,19,4,4,34,13,21
"2021","Harborough 002B","E01025809",959,238,137,101,672,140,405,158,174,73,70,36,29,5,54,34,20,3,3,49,19,30
"2021","Harborough 002C","E01025815",895,199,102,97,654,145,369,136,159,74,83,50,32,1,53,26,27,4,4,42,18,24
"2021","Harborough 003A","E01025781",671,186,93,93,426,59,255,77,124,54,47,27,18,2,60,38,22,5,5,59,35,24
"2021","Harborough 003B","E01025782",623,206,118,88,397,92,182,64,83,35,75,39,29,7,45,22,23,3,3,20,10,10
"2021","Harborough 003C","E01025783",903,180,86,94,673,129,382,114,196,72,77,38,33,6,80,56,24,5,5,50,31,19
"2021","Harborough 003E","E01025786",935,254,149,105,658,111,324,98,179,47,120,56,58,6,101,69,32,2,2,23,13,10
"2021","Harborough 003F","E01025787",730,200,120,80,508,155,267,100,117,50,47,24,20,3,38,17,21,1,1,22,5,17
"2021","Harborough 003G","E01035084",728,193,57,136,505,64,265,75,157,33,95,47,41,7,80,52,28,1,1,30,12,18
"2021","Harborough 003H","E01035085",668,184,79,105,459,44,220,63,119,38,116,69,43,4,79,54,25,0,0,25,12,13
"2021","Harborough 004A","E01025772",940,227,65,162,681,70,333,122,153,58,160,78,75,7,114,85,29,4,4,32,14,18
"2021","Harborough 004B","E01025773",561,81,34,47,448,59,279,70,153,56,76,40,30,6,34,21,13,0,0,32,13,19
"2021","Harborough 004C","E01025774",651,112,42,70,522,68,272,95,122,55,117,69,40,8,62,46,16,3,3,17,9,8
"2021","Harborough 004D","E01025775",954,261,142,119,668,120,320,117,146,57,142,77,54,11,83,50,33,3,3,25,7,18
"2021","Harborough 004E","E01025776",786,179,91,88,578,109,310,113,115,82,94,45,37,12,62,40,22,3,3,29,17,12
"2021","Harborough 005B","E01025778",833,250,133,117,556,76,301,89,156,56,96,57,33,6,81,56,25,2,2,27,16,11
"2021","Harborough 005C","E01025779",626,168,92,76,439,71,242,93,95,54,66,33,26,7,59,37,22,1,1,19,9,10
"2021","Harborough 005D","E01025780",606,124,72,52,458,92,242,91,102,49,70,36,28,6,54,32,22,0,0,24,11,13
"2021","Harborough 005E","E01025784",567,126,66,60,399,90,245,92,103,50,47,31,13,3,16,12,4,1,1,42,15,27
"2021","Harborough 005F","E01025788",549,131,59,72,390,86,217,90,93,34,54,37,14,3,33,21,12,0,0,28,9,19
"2021","Harborough 005G","E01035086",645,125,62,63,478,91,271,105,124,42,65,33,27,5,47,29,18,4,4,42,29,13
"2021","Harborough 005H","E01035087",594,137,57,80,425,73,208,79,97,32,89,57,31,1,54,28,26,1,1,32,11,21
"2021","Harborough 006A","E01025777",945,207,118,89,690,152,375,151,168,56,96,52,39,5,62,30,32,5,5,48,11,37
"2021","Harborough 006B","E01025808",1195,253,128,125,869,139,507,198,222,87,153,95,50,8,68,34,34,2,2,73,33,40
"2021","Harborough 006C","E01025810",960,187,115,72,721,167,416,195,151,70,87,56,24,7,48,24,24,3,3,52,27,25
"2021","Harborough 006D","E01025816",1045,239,118,121,748,137,414,164,177,73,120,77,40,3,75,42,33,2,2,58,24,34
"2021","Harborough 007A","E01025789",613,155,71,84,431,76,220,88,99,33,90,62,22,6,41,18,23,4,4,27,6,21
"2021","Harborough 007B","E01025794",736,149,80,69,554,116,312,112,159,41,77,45,28,4,46,30,16,3,3,33,11,22
"2021","Harborough 007C","E01025797",906,217,118,99,667,142,348,106,186,56,101,54,44,3,76,46,30,0,0,22,8,14
"2021","Harborough 007D","E01025802",634,214,134,80,396,129,197,69,88,40,44,28,14,2,26,16,10,0,0,24,6,18
"2021","Harborough 007E","E01025803",700,116,59,57,566,104,346,117,169,60,77,42,35,0,34,21,13,5,5,18,10,8
"2021","Harborough 007G","E01035088",711,194,117,77,491,101,266,102,122,42,85,46,33,6,39,29,10,0,0,26,11,15
"2021","Harborough 007H","E01035089",585,138,36,102,424,42,211,67,119,25,106,74,31,1,63,49,14,2,2,23,4,19
"2021","Harborough 008A","E01025795",837,358,201,157,452,94,199,86,77,36,91,58,28,5,64,36,28,4,4,27,8,19
"2021","Harborough 008B","E01025796",890,316,149,167,526,56,219,80,102,37,123,70,43,10,120,67,53,8,8,48,14,34
"2021","Harborough 008C","E01025801",603,259,111,148,308,49,114,46,47,21,76,53,21,2,63,34,29,6,6,36,9,27
"2021","Harborough 008D","E01025806",726,283,180,103,418,57,176,70,77,29,84,37,40,7,96,55,41,5,5,25,9,16
"2021","Harborough 009A","E01025798",1065,345,176,169,698,137,352,127,183,42,114,61,48,5,86,52,34,9,9,22,8,14
"2021","Harborough 009B","E01025799",788,120,52,68,647,64,420,110,255,55,100,52,39,9,60,36,24,3,3,21,7,14
"2021","Harborough 009C","E01025800",707,266,115,151,425,106,188,84,79,25,92,64,22,6,37,22,15,2,2,16,6,10
"2021","Harborough 009D","E01025804",886,277,174,103,577,129,278,104,122,52,104,67,30,7,66,37,29,0,0,32,9,23
"2021","Harborough 009E","E01025807",607,177,51,126,398,36,165,61,82,22,108,65,40,3,84,65,19,5,5,32,10,22
"2021","Harborough 010A","E01025790",1039,230,136,94,773,147,438,150,209,79,121,71,41,9,64,40,24,3,3,36,15,21
"2021","Harborough 010B","E01025791",1137,276,153,123,797,174,368,103,198,67,127,64,56,7,125,82,43,3,3,64,40,24
"2021","Harborough 010C","E01025792",1092,452,228,224,605,133,276,117,111,48,105,70,33,2,84,56,28,7,7,35,11,24
"2021","Harborough 010E","E01035090",641,107,36,71,508,77,284,94,153,37,86,43,42,1,58,40,18,3,3,26,13,13
"2021","Harborough 010F","E01035091",652,172,60,112,453,55,195,62,94,39,101,47,43,11,100,62,38,2,2,27,11,16
"2021","Harborough 011A","E01025812",734,196,125,71,496,113,266,87,116,63,54,31,19,4,58,35,23,5,5,42,20,22
"2021","Harborough 011B","E01025813",786,142,76,66,572,118,321,107,143,71,66,36,24,6,67,35,32,0,0,72,33,39
"2021","Harborough 011C","E01025814",698,161,103,58,508,128,279,87,132,60,58,30,22,6,41,19,22,2,2,29,20,9
"2021","Harborough 011E","E01035092",703,197,52,145,467,30,247,84,125,38,99,52,43,4,88,73,15,3,3,39,26,13
"2021","Harborough 011F","E01035093",581,121,83,38,414,86,233,63,104,66,52,31,18,3,42,28,14,1,1,46,21,25
"2021","Hinckley and Bosworth 001A","E01025868",689,249,137,112,419,98,182,90,56,36,83,48,30,5,56,25,31,0,0,21,9,12
"2021","Hinckley and Bosworth 001B","E01025869",746,309,197,112,412,119,179,86,62,31,62,43,19,0,50,28,22,2,2,25,9,16
"2021","Hinckley and Bosworth 001C","E01025870",708,182,133,49,498,107,256,103,104,49,72,31,37,4,60,37,23,3,3,28,13,15
"2021","Hinckley and Bosworth 001D","E01025871",612,127,63,64,459,79,194,69,80,45,114,57,52,5,71,52,19,1,1,26,13,13
"2021","Hinckley and Bosworth 001F","E01035094",462,69,23,46,366,21,195,51,118,26,84,33,47,4,66,59,7,0,0,27,12,15
"2021","Hinckley and Bosworth 001G","E01035095",690,158,83,75,500,92,260,103,104,53,89,48,36,5,59,31,28,0,0,32,16,16
"2021","Hinckley and Bosworth 002A","E01025846",855,205,122,83,621,116,338,102,173,63,88,36,44,8,77,43,34,2,2,29,16,13
"2021","Hinckley and Bosworth 002B","E01025847",671,133,50,83,519,83,286,97,132,57,80,31,40,9,68,39,29,2,2,19,11,8
"2021","Hinckley and Bosworth 002C","E01025848",723,209,112,97,484,119,203,84,73,46,82,41,32,9,76,42,34,4,4,30,12,18
"2021","Hinckley and Bosworth 003A","E01025845",656,163,108,55,481,152,245,90,93,62,53,22,28,3,31,16,15,0,0,12,3,9
"2021","Hinckley and Bosworth 003B","E01025877",760,232,102,130,495,86,221,93,93,35,99,52,40,7,88,67,21,1,1,33,15,18
"2021","Hinckley and Bosworth 003C","E01025879",526,138,66,72,369,62,156,66,64,26,75,38,28,9,73,45,28,3,3,19,9,10
"2021","Hinckley and Bosworth 003D","E01025880",702,171,90,81,508,106,255,91,120,44,76,38,35,3,69,44,25,2,2,23,10,13
"2021","Hinckley and Bosworth 004A","E01025819",732,201,111,90,498,105,247,98,93,56,75,40,26,9,69,40,29,2,2,33,13,20
"2021","Hinckley and Bosworth 004B","E01025820",674,159,89,70,493,86,262,114,98,50,78,42,28,8,66,43,23,1,1,22,9,13
"2021","Hinckley and Bosworth 004C","E01025837",908,224,124,100,655,142,365,139,172,54,87,45,38,4,60,40,20,1,1,29,12,17
"2021","Hinckley and Bosworth 004D","E01025838",662,188,122,66,450,156,211,87,89,35,48,25,19,4,34,24,10,1,1,24,11,13
"2021","Hinckley and Bosworth 004E","E01025882",717,159,94,65,522,117,302,116,133,53,60,30,22,8,41,23,18,2,2,36,18,18
"2021","Hinckley and Bosworth 005A","E01025872",667,166,112,54,479,156,231,102,76,53,54,31,16,7,37,9,28,1,1,22,14,8
"2021","Hinckley and Bosworth 005B","E01025873",658,151,73,78,480,105,256,119,98,39,80,50,24,6,37,18,19,2,2,27,8,19
"2021","Hinckley and Bosworth 005C","E01025874",846,204,119,85,615,109,305,96,160,49,97,41,56,0,104,70,34,0,0,27,14,13
"2021","Hinckley and Bosworth 005D","E01025875",736,211,108,103,487,63,233,80,114,39,108,47,51,10,80,56,24,3,3,38,19,19
"2021","Hinckley and Bosworth 005E","E01025876",771,191,108,83,542,124,302,107,153,42,69,42,22,5,46,20,26,1,1,38,22,16
"2021","Hinckley and Bosworth 006A","E01025839",732,209,69,140,489,69,225,103,78,44,126,78,43,5,67,45,22,2,2,34,20,14
"2021","Hinckley and Bosworth 006B","E01025840",759,236,93,143,491,90,243,102,90,51,89,56,29,4,66,43,23,3,3,32,19,13
"2021","Hinckley and Bosworth 006C","E01025841",816,198,127,71,580,139,288,126,112,50,94,47,43,4,53,35,18,6,6,38,17,21
"2021","Hinckley and Bosworth 006D","E01025842",815,216,71,145,567,56,245,87,119,39,141,80,55,6,119,82,37,6,6,32,13,19
"2021","Hinckley and Bosworth 006E","E01025843",801,259,80,179,506,86,206,91,66,49,128,76,41,11,79,50,29,7,7,36,15,21
"2021","Hinckley and Bosworth 006F","E01025844",730,259,87,172,444,52,177,60,81,36,110,60,46,4,102,60,42,3,3,27,10,17
"2021","Hinckley and Bosworth 007A","E01025821",872,356,86,270,487,61,195,91,77,27,136,84,41,11,87,49,38,8,8,29,5,24
"2021","Hinckley and Bosworth 007B","E01025822",668,211,113,98,427,80,163,53,74,36,92,41,43,8,84,47,37,8,8,30,13,17
"2021","Hinckley and Bosworth 007C","E01025823",689,191,84,107,473,58,205,74,88,43,103,46,53,4,106,68,38,1,1,25,9,16
"2021","Hinckley and Bosworth 007D","E01025824",625,176,84,92,419,74,193,79,80,34,90,46,36,8,59,40,19,3,3,30,8,22
"2021","Hinckley and Bosworth 007E","E01025825",615,146,72,74,449,107,192,91,65,36,85,39,36,10,64,38,26,1,1,20,13,7
"2021","Hinckley and Bosworth 007F","E01025826",601,168,75,93,415,48,231,101,89,41,93,58,29,6,41,28,13,2,2,18,6,12
"2021","Hinckley and Bosworth 008A","E01025817",987,234,131,103,711,175,355,150,144,61,104,72,29,3,74,43,31,3,3,42,17,25
"2021","Hinckley and Bosworth 008B","E01025818",585,144,70,74,409,73,226,111,81,34,75,43,27,5,33,21,12,2,2,32,13,19
"2021","Hinckley and Bosworth 008C","E01025864",844,158,60,98,652,57,387,120,210,57,119,58,52,9,87,50,37,2,2,34,17,17
"2021","Hinckley and Bosworth 008D","E01025881",611,147,101,46,433,140,216,99,85,32,49,32,13,4,26,9,17,2,2,31,11,20
"2021","Hinckley and Bosworth 009A","E01025859",665,150,93,57,491,93,278,119,104,55,82,34,40,8,33,18,15,5,5,24,7,17
"2021","Hinckley and Bosworth 009B","E01025860",554,95,54,41,429,77,261,109,97,55,56,28,25,3,34,18,16,1,1,30,13,17
"2021","Hinckley and Bosworth 009C","E01025861",782,227,109,118,528,94,254,91,118,45,108,61,41,6,72,42,30,0,0,27,10,17
"2021","Hinckley and Bosworth 009D","E01025862",841,217,129,88,582,168,270,97,116,57,91,54,33,4,52,26,26,1,1,42,17,25
"2021","Hinckley and Bosworth 010A","E01025850",657,212,80,132,411,49,170,57,69,44,109,61,43,5,80,50,30,3,3,34,15,19
"2021","Hinckley and Bosworth 010B","E01025852",1013,477,123,354,460,39,162,62,83,17,153,88,59,6,99,65,34,7,7,76,13,63
"2021","Hinckley and Bosworth 010C","E01025858",1081,457,113,344,573,56,240,105,101,34,151,83,64,4,110,67,43,16,16,51,12,39
"2021","Hinckley and Bosworth 010D","E01025863",761,227,128,99,507,85,220,100,82,38,107,56,41,10,90,57,33,5,5,27,15,12
"2021","Hinckley and Bosworth 010E","E01025865",783,246,99,147,507,59,209,85,96,28,137,77,53,7,100,67,33,2,2,30,13,17
"2021","Hinckley and Bosworth 011B","E01025854",926,238,77,161,649,77,294,96,151,47,187,109,72,6,90,57,33,1,1,39,22,17
"2021","Hinckley and Bosworth 011C","E01025855",627,167,70,97,429,50,221,101,79,41,93,61,27,5,64,43,21,1,1,31,10,21
"2021","Hinckley and Bosworth 011D","E01025866",828,253,117,136,529,72,213,84,86,43,140,69,66,5,95,66,29,9,9,46,14,32
"2021","Hinckley and Bosworth 011E","E01025867",659,206,85,121,427,106,204,82,85,37,80,39,37,4,35,13,22,2,2,26,9,17
"2021","Hinckley and Bosworth 011F","E01035096",647,151,58,93,476,68,236,88,114,34,95,53,37,5,76,46,30,1,1,20,9,11
"2021","Hinckley and Bosworth 011G","E01035097",626,170,25,145,431,23,194,58,123,13,139,76,60,3,71,47,24,4,4,25,13,12
"2021","Hinckley and Bosworth 012A","E01025849",1020,385,123,262,580,61,258,93,130,35,155,90,59,6,98,72,26,8,8,55,20,35
"2021","Hinckley and Bosworth 012B","E01025851",554,117,72,45,416,80,192,61,84,47,95,50,38,7,44,28,16,5,5,21,9,12
"2021","Hinckley and Bosworth 012C","E01025856",640,272,137,135,346,58,123,46,53,24,78,37,37,4,82,57,25,5,5,22,6,16
"2021","Hinckley and Bosworth 012D","E01025857",603,131,49,82,447,53,225,96,87,42,113,59,49,5,53,29,24,3,3,25,6,19
"2021","Hinckley and Bosworth 013A","E01025827",694,251,158,93,415,127,155,67,56,32,66,36,24,6,67,40,27,0,0,28,7,21
"2021","Hinckley and Bosworth 013B","E01025828",648,156,99,57,468,119,230,85,102,43,78,39,34,5,41,18,23,0,0,24,12,12
"2021","Hinckley and Bosworth 013C","E01025829",661,223,117,106,403,36,175,56,80,39,90,46,39,5,101,62,39,1,1,35,13,22
"2021","Hinckley and Bosworth 013D","E01025830",695,247,106,141,424,71,214,86,102,26,72,42,27,3,63,39,24,4,4,24,6,18
"2021","Hinckley and Bosworth 014A","E01025831",602,220,137,83,365,89,172,74,74,24,65,41,22,2,38,23,15,1,1,17,5,12
"2021","Hinckley and Bosworth 014B","E01025832",773,144,58,86,596,75,351,119,176,56,110,66,34,10,59,34,25,1,1,33,15,18
"2021","Hinckley and Bosworth 014C","E01025833",871,201,88,113,644,100,331,131,160,40,131,86,36,9,80,58,22,2,2,26,13,13
"2021","Hinckley and Bosworth 014D","E01025834",649,171,75,96,459,90,262,90,130,42,67,34,30,3,38,26,12,2,2,19,9,10
"2021","Hinckley and Bosworth 014E","E01025835",1102,286,147,139,794,169,404,158,180,66,154,78,72,4,66,41,25,1,1,22,4,18
"2021","Hinckley and Bosworth 014F","E01025836",560,170,114,56,368,101,183,88,61,34,49,30,14,5,35,17,18,0,0,22,6,16
"2021","Melton 001A","E01025885",827,161,108,53,648,166,341,138,148,55,76,41,32,3,64,40,24,1,1,18,10,8
"2021","Melton 001B","E01025886",813,289,184,105,511,116,259,99,109,51,81,42,31,8,53,34,19,2,2,13,5,8
"2021","Melton 001C","E01025887",771,171,85,86,565,110,321,144,100,77,97,62,26,9,35,21,14,2,2,35,16,19
"2021","Melton 001D","E01025890",566,143,80,63,395,62,207,83,81,43,71,42,23,6,51,31,20,4,4,28,12,16
"2021","Melton 001E","E01025891",546,157,93,64,378,85,212,87,95,30,40,23,15,2,39,25,14,2,2,11,9,2
"2021","Melton 001F","E01025892",682,161,79,82,497,91,289,120,121,48,66,46,16,4,50,29,21,1,1,24,11,13
"2021","Melton 002A","E01025901",943,299,195,104,619,163,272,109,114,49,97,53,38,6,85,52,33,2,2,25,13,12
"2021","Melton 002B","E01025902",697,181,117,64,493,143,249,110,87,52,56,31,23,2,44,27,17,1,1,23,9,14
"2021","Melton 002C","E01025903",845,317,77,240,475,41,197,80,83,34,125,72,50,3,105,73,32,7,7,53,15,38
"2021","Melton 002D","E01025904",915,205,128,77,681,121,352,121,170,61,121,53,60,8,84,59,25,3,3,29,9,20
"2021","Melton 002E","E01025906",655,120,56,64,515,71,313,126,130,57,85,38,45,2,46,25,21,0,0,20,4,16
"2021","Melton 003A","E01025883",858,238,115,123,584,123,268,140,94,34,113,60,47,6,76,53,23,4,4,36,12,24
"2021","Melton 003B","E01025884",776,270,126,144,482,51,204,62,105,37,127,62,57,8,94,61,33,6,6,24,6,18
"2021","Melton 003C","E01025888",797,176,88,88,590,128,330,168,110,52,86,59,22,5,43,19,24,3,3,31,12,19
"2021","Melton 003D","E01025909",832,208,108,100,587,117,327,141,128,58,86,57,26,3,55,31,24,2,2,37,15,22
"2021","Melton 004A","E01025896",719,172,93,79,518,134,247,109,90,48,95,51,34,10,42,21,21,0,0,29,11,18
"2021","Melton 004B","E01025897",1022,369,157,212,606,63,240,95,107,38,161,81,73,7,135,98,37,7,7,47,21,26
"2021","Melton 004C","E01025898",563,150,81,69,396,69,183,67,86,30,79,39,36,4,59,44,15,6,6,17,5,12
"2021","Melton 004D","E01025899",546,168,45,123,347,41,142,57,64,21,91,41,43,7,67,44,23,6,6,31,11,20
"2021","Melton 004E","E01025900",611,181,87,94,404,39,155,62,67,26,95,34,56,5,111,67,44,4,4,26,12,14
"2021","Melton 004F","E01025905",697,224,119,105,445,74,172,55,81,36,77,25,47,5,116,77,39,6,6,28,11,17
"2021","Melton 005A","E01025893",857,221,119,102,607,132,310,127,108,75,103,52,49,2,60,25,35,2,2,29,13,16
"2021","Melton 005B","E01025894",863,422,174,248,395,58,151,70,56,25,101,60,37,4,83,56,27,2,2,46,15,31
"2021","Melton 005C","E01025895",752,239,76,163,481,77,230,102,98,30,103,61,36,6,66,34,32,5,5,32,9,23
"2021","Melton 005D","E01025907",730,191,84,107,496,66,233,95,82,56,85,35,45,5,109,66,43,3,3,43,20,23
"2021","Melton 005E","E01025908",779,207,111,96,552,120,294,118,129,47,79,48,27,4,50,26,24,9,9,20,4,16
"2021","Melton 006A","E01025889",744,199,119,80,517,124,287,115,108,64,70,42,24,4,33,18,15,3,3,28,14,14
"2021","Melton 006B","E01025910",782,181,83,98,563,110,332,161,109,62,72,49,21,2,48,24,24,1,1,38,12,26
"2021","Melton 006C","E01025911",726,177,90,87,522,109,270,123,111,36,82,50,31,1,58,38,20,3,3,27,8,19
"2021","Melton 006D","E01025912",699,169,77,92,506,104,267,143,82,42,75,39,33,3,57,35,22,3,3,24,8,16
"2021","North West Leicestershire 001A","E01025924",491,136,63,73,338,58,189,86,75,28,65,54,10,1,25,14,11,1,1,17,8,9
"2021","North West Leicestershire 001C","E01025926",1094,243,101,142,815,122,410,140,203,67,190,125,63,2,89,61,28,4,4,36,21,15
"2021","North West Leicestershire 001D","E01025927",678,208,106,102,436,74,202,67,89,46,85,33,43,9,72,40,32,3,3,34,15,19
"2021","North West Leicestershire 001E","E01025928",619,154,79,75,437,104,228,86,104,38,69,46,22,1,36,17,19,0,0,28,8,20
"2021","North West Leicestershire 001F","E01035098",539,187,54,133,328,56,176,92,55,29,71,44,19,8,24,16,8,1,1,24,6,18
"2021","North West Leicestershire 001G","E01035099",669,275,116,159,360,46,158,67,62,29,93,61,27,5,60,30,30,3,3,34,10,24
"2021","North West Leicestershire 002A","E01025923",627,153,88,65,452,106,221,98,76,47,85,49,31,5,40,17,23,0,0,22,9,13
"2021","North West Leicestershire 002B","E01025944",732,187,92,95,502,91,267,103,123,41,88,44,28,16,51,31,20,5,5,43,9,34
"2021","North West Leicestershire 002C","E01025945",722,210,103,107,412,76,184,79,71,34,90,42,44,4,60,32,28,2,2,100,11,89
"2021","North West Leicestershire 002D","E01025946",888,303,123,180,435,60,182,67,85,30,108,68,35,5,75,47,28,10,10,150,16,134
"2021","North West Leicestershire 003A","E01025915",552,194,108,86,334,82,181,67,85,29,38,24,12,2,31,16,15,2,2,24,13,11
"2021","North West Leicestershire 003B","E01025916",775,223,90,133,537,85,289,106,138,45,97,70,22,5,63,36,27,3,3,15,5,10
"2021","North West Leicestershire 003D","E01025918",755,253,114,139,473,80,190,71,89,30,99,46,47,6,99,70,29,5,5,29,12,17
"2021","North West Leicestershire 003E","E01035100",786,222,73,149,538,57,241,91,134,16,145,81,58,6,92,65,27,3,3,26,13,13
"2021","North West Leicestershire 003F","E01035101",781,194,47,147,564,57,301,85,174,42,120,68,44,8,79,56,23,7,7,23,8,15
"2021","North West Leicestershire 004A","E01025960",638,166,93,73,451,120,203,97,69,37,79,40,32,7,48,28,20,1,1,21,8,13
"2021","North West Leicestershire 004B","E01025961",666,199,109,90,449,124,203,94,68,41,78,47,25,6,44,22,22,0,0,18,8,10
"2021","North West Leicestershire 004C","E01025962",721,220,116,104,471,67,181,66,81,34,114,52,55,7,105,78,27,4,4,30,11,19
"2021","North West Leicestershire 004D","E01025965",561,149,71,78,400,81,210,101,65,44,72,40,26,6,35,17,18,2,2,12,5,7
"2021","North West Leicestershire 005A","E01025955",784,174,97,77,585,110,327,128,151,48,97,49,46,2,50,30,20,1,1,25,10,15
"2021","North West Leicestershire 005B","E01025956",552,148,72,76,378,70,177,74,70,33,82,44,34,4,49,32,17,0,0,26,14,12
"2021","North West Leicestershire 005C","E01025963",679,150,83,67,500,90,265,109,116,40,83,44,30,9,62,41,21,0,0,29,11,18
"2021","North West Leicestershire 005D","E01025964",683,136,81,55,524,99,323,143,113,67,63,46,16,1,39,22,17,0,0,23,9,14
"2021","North West Leicestershire 006A","E01025914",534,106,71,35,412,103,240,87,113,40,43,22,15,6,26,18,8,0,0,16,6,10
"2021","North West Leicestershire 006B","E01025919",614,175,104,71,423,73,211,68,108,35,68,26,32,10,70,40,30,1,1,16,5,11
"2021","North West Leicestershire 006C","E01025920",808,235,135,100,547,86,281,80,158,43,97,49,43,5,79,58,21,4,4,26,10,16
"2021","North West Leicestershire 006D","E01025921",934,320,166,154,600,131,311,119,141,51,90,56,28,6,66,36,30,2,2,14,6,8
"2021","North West Leicestershire 007A","E01025966",643,190,82,108,423,69,195,87,64,44,78,40,32,6,79,48,31,2,2,30,9,21
"2021","North West Leicestershire 007B","E01025967",730,214,150,64,492,127,244,112,71,61,77,44,29,4,41,15,26,3,3,24,9,15
"2021","North West Leicestershire 007C","E01025968",806,218,108,110,572,107,299,118,120,61,103,57,37,9,62,35,27,1,1,16,9,7
"2021","North West Leicestershire 007D","E01025969",811,312,117,195,469,60,216,95,87,34,114,66,43,5,78,42,36,1,1,30,11,19
"2021","North West Leicestershire 008A","E01025950",917,271,96,175,607,60,267,88,134,45,172,84,76,12,108,72,36,0,0,39,9,30
"2021","North West Leicestershire 008B","E01025951",852,200,87,113,612,89,317,124,129,64,126,78,41,7,80,51,29,0,0,40,22,18
"2021","North West Leicestershire 008C","E01025952",751,192,102,90,543,132,269,135,85,49,74,44,26,4,65,33,32,3,3,16,4,12
"2021","North West Leicestershire 008D","E01025953",540,131,57,74,379,42,181,68,84,29,97,50,40,7,57,33,24,2,2,30,17,13
"2021","North West Leicestershire 008E","E01025954",634,152,60,92,462,54,270,103,124,43,80,41,29,10,55,35,20,3,3,20,7,13
"2021","North West Leicestershire 009A","E01025932",548,129,60,69,381,23,152,48,72,32,84,20,57,7,114,74,40,8,8,38,23,15
"2021","North West Leicestershire 009B","E01025933",555,131,79,52,396,61,187,82,64,41,79,41,34,4,66,37,29,3,3,28,17,11
"2021","North West Leicestershire 009C","E01025934",777,210,70,140,523,61,203,77,88,38,122,62,52,8,134,86,48,3,3,44,25,19
"2021","North West Leicestershire 009D","E01025935",544,140,108,32,395,142,191,89,52,50,37,22,12,3,25,9,16,0,0,9,3,6
"2021","North West Leicestershire 009E","E01025936",576,218,112,106,338,77,149,59,51,39,70,32,28,10,37,25,12,5,5,20,10,10
"2021","North West Leicestershire 010A","E01025929",793,204,73,131,543,56,277,104,118,55,120,49,60,11,81,47,34,9,9,46,18,28
"2021","North West Leicestershire 010B","E01025930",823,316,82,234,462,31,173,64,75,34,136,63,61,12,112,74,38,10,10,45,15,30
"2021","North West Leicestershire 010C","E01025931",859,293,106,187,520,52,196,71,86,39,139,53,73,13,127,91,36,6,6,46,25,21
"2021","North West Leicestershire 010D","E01025957",900,255,86,169,594,41,271,79,132,60,162,76,76,10,116,84,32,4,4,51,26,25
"2021","North West Leicestershire 011B","E01025937",992,230,100,130,725,85,342,135,152,55,215,133,65,17,75,50,25,8,8,37,13,24
"2021","North West Leicestershire 011C","E01025958",898,210,90,120,652,79,318,117,141,60,156,75,71,10,96,65,31,3,3,36,14,22
"2021","North West Leicestershire 011D","E01025959",1110,312,138,174,755,102,378,146,157,75,196,102,84,10,76,40,36,3,3,43,21,22
"2021","North West Leicestershire 011E","E01033102",679,190,60,130,455,29,230,88,113,29,117,61,53,3,77,54,23,2,2,34,10,24
"2021","North West Leicestershire 011F","E01033103",862,148,44,104,675,76,387,132,180,75,168,94,65,9,43,22,21,1,1,39,17,22
"2021","North West Leicestershire 012A","E01025913",1028,232,118,114,756,144,455,180,189,86,99,65,27,7,57,37,20,1,1,40,17,23
"2021","North West Leicestershire 012B","E01025947",905,231,131,100,647,155,303,123,120,60,120,66,53,1,67,35,32,2,2,27,9,18
"2021","North West Leicestershire 012C","E01025948",742,205,52,153,500,43,252,96,107,49,114,62,47,5,86,55,31,5,5,37,15,22
"2021","North West Leicestershire 012D","E01025949",705,255,96,159,418,53,167,66,71,30,95,56,34,5,99,64,35,4,4,32,12,20
"2021","North West Leicestershire 013A","E01025938",551,173,82,91,362,71,170,66,78,26,71,41,28,2,46,21,25,4,4,16,4,12
"2021","North West Leicestershire 013B","E01025939",880,234,92,142,612,78,289,102,147,40,140,52,76,12,103,70,33,2,2,34,10,24
"2021","North West Leicestershire 013C","E01025940",870,254,102,152,593,84,271,113,110,48,143,71,61,11,89,55,34,6,6,23,13,10
"2021","North West Leicestershire 013D","E01025941",844,208,109,99,605,98,295,111,129,55,139,75,60,4,68,47,21,5,5,31,10,21
"2021","North West Leicestershire 013E","E01025942",1133,226,103,123,882,113,469,174,215,80,182,83,90,9,114,82,32,4,4,25,10,15
"2021","North West Leicestershire 013F","E01025943",829,291,132,159,509,72,195,80,69,46,131,75,39,17,104,60,44,7,7,29,16,13
"2021","Oadby and Wigston 003A","E01025970",624,125,84,41,451,76,263,65,139,59,38,17,20,1,71,47,24,3,3,48,33,15
"2021","Oadby and Wigston 003B","E01025971",476,136,100,36,309,61,196,49,94,53,13,8,4,1,39,19,20,0,0,31,14,17
"2021","Oadby and Wigston 003C","E01025972",456,99,64,35,324,56,202,35,120,47,20,11,8,1,46,28,18,0,0,33,20,13
"2021","Oadby and Wigston 003D","E01025976",579,223,110,113,320,44,160,31,93,36,28,10,15,3,83,42,41,5,5,36,20,16
"2021","Oadby and Wigston 003E","E01025977",674,251,166,85,389,92,197,57,104,36,53,28,22,3,43,25,18,4,4,34,20,14
"2021","Oadby and Wigston 003F","E01025978",741,283,138,145,414,68,216,67,107,42,59,35,20,4,66,37,29,5,5,44,19,25
"2021","Oadby and Wigston 005A","E01025992",843,363,188,175,459,67,164,76,57,31,112,57,47,8,112,71,41,4,4,21,10,11
"2021","Oadby and Wigston 005B","E01025994",690,205,92,113,444,44,178,44,97,37,105,42,53,10,108,63,45,9,9,41,19,22
"2021","Oadby and Wigston 005C","E01025997",586,151,89,62,398,37,187,53,95,39,85,28,46,11,85,50,35,4,4,37,19,18
"2021","Oadby and Wigston 005D","E01025999",650,218,88,130,408,67,169,49,82,38,69,28,34,7,98,72,26,5,5,24,7,17
"2021","Oadby and Wigston 005E","E01026005",699,229,122,107,431,75,221,84,101,36,65,30,30,5,70,37,33,0,0,39,22,17
"2021","Oadby and Wigston 006A","E01025985",585,192,146,46,368,118,158,67,44,47,52,25,22,5,40,17,23,0,0,25,16,9
"2021","Oadby and Wigston 006B","E01025986",624,155,106,49,442,114,195,73,70,52,86,38,37,11,46,18,28,1,1,27,10,17
"2021","Oadby and Wigston 006C","E01025987",742,260,83,177,443,29,151,48,66,37,122,54,61,7,139,106,33,2,2,39,13,26
"2021","Oadby and Wigston 006D","E01025988",817,253,64,189,523,28,193,54,111,28,167,80,75,12,127,93,34,8,8,41,19,22
"2021","Oadby and Wigston 006E","E01025989",805,309,92,217,462,32,155,49,76,30,139,66,69,4,133,88,45,3,3,34,16,18
"2021","Oadby and Wigston 007A","E01025990",604,200,125,75,381,116,181,63,75,43,51,26,18,7,31,11,20,2,2,23,8,15
"2021","Oadby and Wigston 007B","E01025991",597,145,94,51,419,112,204,79,70,55,48,25,19,4,55,30,25,0,0,33,16,17
"2021","Oadby and Wigston 007C","E01025993",586,146,102,44,406,98,184,65,77,42,65,23,33,9,58,32,26,1,1,34,18,16
"2021","Oadby and Wigston 007D","E01025998",956,255,90,165,664,91,365,132,172,61,123,78,42,3,81,58,23,4,4,37,12,25
"2021","Oadby and Wigston 007E","E01026000",535,136,87,49,377,119,177,74,61,42,45,18,22,5,36,15,21,0,0,22,8,14
"2021","Oadby and Wigston 007F","E01026001",630,207,103,104,405,94,185,67,64,54,68,34,29,5,57,29,28,1,1,18,6,12
"2021","Oadby and Wigston 008A","E01025995",594,158,91,67,384,66,208,58,100,50,48,18,26,4,60,27,33,2,2,52,31,21
"2021","Oadby and Wigston 008B","E01026003",653,176,99,77,450,94,220,70,95,55,71,28,34,9,63,40,23,2,2,27,9,18
"2021","Oadby and Wigston 008C","E01026004",685,152,99,53,489,106,275,82,136,57,55,14,35,6,53,23,30,0,0,44,26,18
"2021","Oadby and Wigston 008D","E01032600",815,207,131,76,560,95,295,90,131,74,76,39,34,3,88,44,44,6,6,48,28,20
"2021","Oadby and Wigston 008E","E01032601",578,138,92,46,400,58,232,75,105,52,47,15,29,3,60,29,31,3,3,40,13,27
"2021","Oadby and Wigston 010C","E01025973",480,63,33,30,296,46,218,48,90,80,9,2,6,1,20,6,14,3,3,121,80,41
"2021","Oadby and Wigston 010A","E01025974",600,164,65,99,394,51,209,50,106,53,56,28,21,7,74,44,30,4,4,42,20,22
"2021","Oadby and Wigston 010D","E01025975",495,107,69,38,321,62,211,60,99,52,12,4,6,2,34,15,19,2,2,67,47,20
"2021","Oadby and Wigston 010B","E01025980",456,80,59,21,316,66,205,32,104,69,9,6,3,0,36,17,19,0,0,60,32,28
"2021","Oadby and Wigston 011C","E01025979",494,97,63,34,360,46,246,52,142,52,22,9,13,0,43,21,22,3,3,37,18,19
"2021","Oadby and Wigston 011E","E01025981",612,136,86,50,433,78,273,58,151,64,24,7,12,5,54,24,30,4,4,43,27,16
"2021","Oadby and Wigston 011B","E01025982",656,88,48,40,526,61,371,79,196,96,23,13,8,2,67,44,23,4,4,42,23,19
"2021","Oadby and Wigston 011D","E01025983",503,138,66,72,334,59,174,42,91,41,25,9,16,0,74,42,32,2,2,31,23,8
"2021","Oadby and Wigston 011A","E01025984",489,94,68,26,347,53,242,50,118,74,14,8,3,3,37,11,26,1,1,48,33,15
"2021","Boston 001A","E01026007",488,119,72,47,346,86,185,100,51,34,45,22,19,4,28,21,7,2,2,23,11,12
"2021","Boston 001B","E01026008",563,152,105,47,381,92,194,92,55,47,51,23,23,5,42,26,16,2,2,30,14,16
"2021","Boston 001C","E01026009",514,120,74,46,359,89,181,87,60,34,48,26,16,6,39,19,20,2,2,35,17,18
"2021","Boston 001D","E01026023",603,151,102,49,411,118,189,98,57,34,64,42,16,6,38,24,14,2,2,41,16,25
"2021","Boston 001E","E01026024",925,229,139,90,633,119,326,146,114,66,101,51,45,5,85,54,31,2,2,63,28,35
"2021","Boston 002A","E01026010",751,213,67,146,475,18,169,55,87,27,136,44,84,8,144,113,31,8,8,63,32,31
"2021","Boston 002C","E01026030",1119,391,216,175,621,68,203,67,107,29,148,53,81,14,178,140,38,24,24,107,52,55
"2021","Boston 002D","E01026032",771,209,93,116,418,35,161,68,59,34,90,41,42,7,109,73,36,23,23,144,69,75
"2021","Boston 002E","E01026037",689,234,97,137,397,34,138,49,69,20,87,42,36,9,129,97,32,9,9,58,29,29
"2021","Boston 002F","E01034679",554,127,39,88,341,40,144,62,55,27,85,39,42,4,67,47,20,5,5,86,44,42
"2021","Boston 002G","E01034680",565,120,51,69,357,17,138,36,77,25,94,38,50,6,100,65,35,8,8,88,48,40
"2021","Boston 003B","E01026021",797,265,128,137,479,87,225,71,110,44,88,47,35,6,74,48,26,5,5,53,24,29
"2021","Boston 003C","E01026025",1085,387,84,303,580,32,237,81,121,35,153,85,59,9,136,100,36,22,22,118,46,72
"2021","Boston 003D","E01026036",651,205,67,138,342,31,128,53,55,20,94,50,43,1,74,52,22,15,15,104,44,60
"2021","Boston 003E","E01034681",600,212,37,175,307,10,108,41,52,15,100,50,49,1,80,57,23,9,9,81,33,48
"2021","Boston 003F","E01034682",657,195,37,158,341,16,105,46,44,15,130,61,62,7,71,54,17,19,19,121,54,67
"2021","Boston 004A","E01026012",534,181,120,61,335,85,118,53,39,26,54,20,31,3,75,51,24,3,3,18,9,9
"2021","Boston 004B","E01026015",698,172,72,100,478,48,184,77,77,30,144,69,65,10,96,71,25,6,6,48,24,24
"2021","Boston 004C","E01026026",899,268,137,131,529,49,231,63,127,41,116,39,69,8,130,86,44,3,3,102,59,43
"2021","Boston 004D","E01026027",748,195,100,95,477,67,209,75,104,30,113,54,51,8,79,50,29,9,9,76,40,36
"2021","Boston 004E","E01026028",858,330,174,156,456,66,198,77,85,36,95,44,41,10,91,60,31,6,6,72,31,41
"2021","Boston 006A","E01026016",1030,252,155,97,727,156,339,161,113,65,138,69,56,13,89,50,39,5,5,51,20,31
"2021","Boston 006B","E01026033",1006,234,112,122,701,133,324,151,114,59,161,104,51,6,79,53,26,4,4,71,32,39
"2021","Boston 006C","E01026034",837,271,138,133,538,117,250,112,95,43,96,54,35,7,74,49,25,1,1,28,14,14
"2021","Boston 007A","E01026017",699,177,113,64,482,91,235,113,75,47,82,52,27,3,71,34,37,3,3,40,17,23
"2021","Boston 007B","E01026018",734,183,111,72,512,134,273,148,83,42,54,36,13,5,46,21,25,5,5,39,16,23
"2021","Boston 007C","E01026019",1153,324,177,147,746,91,325,125,142,58,150,58,79,13,173,129,44,7,7,83,38,45
"2021","Boston 007D","E01026020",1184,282,125,157,845,148,361,136,149,76,212,112,89,11,118,90,28,6,6,57,24,33
"2021","Boston 007E","E01026041",613,229,121,108,361,51,160,66,74,20,68,20,43,5,78,64,14,4,4,23,16,7
"2021","Boston 008A","E01026013",620,156,108,48,429,114,215,98,80,37,64,27,30,7,36,15,21,0,0,35,13,22
"2021","Boston 008B","E01026014",780,158,97,61,579,104,295,123,117,55,102,52,43,7,74,54,20,4,4,43,18,25
"2021","Boston 008C","E01026022",918,223,161,62,627,161,320,114,157,49,86,48,32,6,56,29,27,4,4,68,36,32
"2021","Boston 008D","E01026038",654,185,93,92,436,80,190,92,71,27,103,59,35,9,60,37,23,3,3,33,18,15
"2021","Boston 008E","E01026040",678,146,57,89,480,59,229,85,103,41,119,59,54,6,72,54,18,1,1,52,21,31
"2021","Boston 009B","E01026031",700,186,116,70,465,130,203,89,71,43,70,31,34,5,62,41,21,0,0,49,19,30
"2021","Boston 009C","E01026035",1071,264,154,110,748,158,367,142,155,70,147,76,60,11,74,39,35,2,2,59,28,31
"2021","Boston 009D","E01026039",510,125,92,33,358,78,176,87,46,43,57,16,37,4,44,28,16,3,3,27,12,15
"2021","Boston 009E","E01034683",573,110,54,56,420,68,201,70,96,35,84,38,42,4,64,41,23,3,3,43,11,32
"2021","Boston 009F","E01034684",563,112,43,69,411,31,199,63,107,29,112,52,52,8,65,50,15,4,4,40,26,14
"2021","East Lindsey 001A","E01026045",881,243,149,94,600,187,272,150,74,48,81,46,28,7,57,35,22,3,3,38,12,26
"2021","East Lindsey 001B","E01026061",501,112,69,43,369,93,182,97,53,32,54,28,24,2,38,24,14,2,2,20,10,10
"2021","East Lindsey 001C","E01026062",520,167,83,84,329,63,168,70,60,38,49,23,21,5,47,34,13,2,2,24,13,11
"2021","East Lindsey 001D","E01026063",693,172,107,65,501,132,238,110,89,39,82,52,29,1,47,32,15,2,2,20,8,12
"2021","East Lindsey 001E","E01026080",903,231,151,80,639,186,312,168,87,57,83,49,29,5,56,40,16,2,2,33,16,17
"2021","East Lindsey 001F","E01026106",528,126,75,51,384,94,190,93,55,42,56,33,19,4,43,20,23,1,1,18,7,11
"2021","East Lindsey 001G","E01026107",503,103,43,60,377,68,198,93,70,35,65,33,29,3,43,26,17,3,3,23,11,12
"2021","East Lindsey 002A","E01026058",1017,246,145,101,729,165,369,184,132,53,123,64,52,7,71,41,30,1,1,42,15,27
"2021","East Lindsey 002B","E01026076",973,220,130,90,697,184,367,198,103,66,87,47,36,4,58,30,28,1,1,56,24,32
"2021","East Lindsey 002C","E01026079",866,229,152,77,573,155,258,132,68,58,102,53,42,7,56,31,25,2,2,64,23,41
"2021","East Lindsey 003A","E01026077",651,160,88,72,461,80,191,86,74,31,80,34,41,5,110,78,32,0,0,30,11,19
"2021","East Lindsey 003B","E01026078",475,171,81,90,291,45,136,55,56,25,52,24,25,3,56,40,16,2,2,13,5,8
"2021","East Lindsey 003C","E01026087",629,188,78,110,427,42,163,59,81,23,123,49,64,10,99,80,19,0,0,14,5,9
"2021","East Lindsey 003D","E01026088",626,187,104,83,417,106,189,93,73,23,75,42,27,6,46,26,20,1,1,22,6,16
"2021","East Lindsey 003E","E01026090",622,212,135,77,392,98,170,78,52,40,59,27,30,2,61,36,25,4,4,18,10,8
"2021","East Lindsey 003F","E01026091",500,134,71,63,347,62,172,69,82,21,69,35,32,2,44,32,12,0,0,19,6,13
"2021","East Lindsey 003G","E01026108",1093,369,150,219,685,85,297,118,138,41,140,69,57,14,151,91,60,12,12,39,17,22
"2021","East Lindsey 004A","E01026081",1192,521,228,293,647,107,253,121,97,35,149,81,59,9,133,87,46,5,5,24,9,15
"2021","East Lindsey 004C","E01026089",995,364,212,152,602,156,272,128,90,54,90,57,27,6,80,46,34,4,4,29,9,20
"2021","East Lindsey 004D","E01032986",597,277,103,174,301,58,113,72,32,9,66,45,17,4,62,37,25,2,2,19,6,13
"2021","East Lindsey 004E","E01032987",706,286,134,152,396,52,146,63,64,19,94,54,36,4,103,85,18,1,1,24,6,18
"2021","East Lindsey 005A","E01026072",1013,325,188,137,623,163,214,110,61,43,116,39,72,5,124,78,46,6,6,65,25,40
"2021","East Lindsey 005B","E01026073",960,390,214,176,506,138,201,124,45,32,82,50,29,3,77,43,34,8,8,64,29,35
"2021","East Lindsey 005C","E01026074",1057,336,210,126,678,197,268,166,52,50,104,60,37,7,100,46,54,9,9,43,16,27
"2021","East Lindsey 005D","E01026099",900,229,143,86,615,170,294,160,76,58,94,59,30,5,55,27,28,2,2,56,23,33
"2021","East Lindsey 006A","E01026103",1002,367,261,106,590,231,237,159,39,39,60,38,19,3,58,27,31,4,4,45,17,28
"2021","East Lindsey 006B","E01026104",1077,286,226,60,753,321,290,200,36,54,74,35,33,6,66,37,29,2,2,38,9,29
"2021","East Lindsey 006C","E01026109",1116,405,251,154,665,260,263,199,33,31,83,62,17,4,57,21,36,2,2,46,13,33
"2021","East Lindsey 007A","E01026071",953,231,132,99,679,176,354,191,88,75,87,53,33,1,57,29,28,5,5,43,14,29
"2021","East Lindsey 007B","E01026082",1034,249,161,88,735,219,368,184,107,77,95,57,28,10,51,22,29,2,2,50,18,32
"2021","East Lindsey 007C","E01026121",1157,340,177,163,774,177,350,162,128,60,151,91,53,7,83,51,32,13,13,43,21,22
"2021","East Lindsey 008A","E01026042",770,253,120,133,484,81,181,81,76,24,108,45,56,7,108,76,32,6,6,33,11,22
"2021","East Lindsey 008B","E01026043",812,261,131,130,523,108,229,112,77,40,98,42,51,5,86,53,33,2,2,28,15,13
"2021","East Lindsey 008C","E01026044",612,156,104,52,422,129,210,108,52,50,46,28,17,1,35,12,23,2,2,34,14,20
"2021","East Lindsey 008D","E01026113",921,260,160,100,612,186,290,165,78,47,79,46,21,12,54,24,30,3,3,49,21,28
"2021","East Lindsey 008E","E01026117",870,230,142,88,587,172,282,163,75,44,83,45,25,13,45,16,29,5,5,53,20,33
"2021","East Lindsey 009A","E01026060",574,136,85,51,414,111,218,125,60,33,54,36,17,1,27,12,15,4,4,24,12,12
"2021","East Lindsey 009B","E01026068",948,227,131,96,669,167,309,169,89,51,125,81,36,8,68,40,28,0,0,52,21,31
"2021","East Lindsey 009C","E01026070",949,221,125,96,678,154,350,167,125,58,106,69,33,4,66,42,24,2,2,50,14,36
"2021","East Lindsey 009D","E01026105",996,244,155,89,713,189,367,212,113,42,92,62,28,2,61,32,29,4,4,39,15,24
"2021","East Lindsey 010A","E01026048",784,269,161,108,482,142,193,121,39,33,78,43,33,2,63,34,29,6,6,33,12,21
"2021","East Lindsey 010B","E01026049",749,237,155,82,476,131,220,134,43,43,82,45,32,5,39,18,21,4,4,36,13,23
"2021","East Lindsey 010C","E01026050",818,259,192,67,518,211,195,124,32,39,63,43,14,6,43,16,27,6,6,41,14,27
"2021","East Lindsey 010D","E01026069",1061,347,197,150,668,184,267,170,46,51,110,59,46,5,103,68,35,4,4,46,11,35
"2021","East Lindsey 011A","E01026064",711,211,88,123,487,53,209,80,91,38,100,43,53,4,121,83,38,4,4,13,4,9
"2021","East Lindsey 011B","E01026065",893,289,186,103,571,163,254,123,95,36,88,49,35,4,62,40,22,4,4,33,9,24
"2021","East Lindsey 011C","E01026066",966,265,160,105,670,177,317,161,117,39,114,71,38,5,60,41,19,2,2,31,11,20
"2021","East Lindsey 011D","E01026067",974,438,182,256,505,78,202,100,73,29,119,66,46,7,102,63,39,4,4,31,13,18
"2021","East Lindsey 012A","E01026084",711,225,110,115,438,76,166,63,62,41,106,56,46,4,82,51,31,8,8,48,19,29
"2021","East Lindsey 012C","E01026115",821,287,186,101,494,119,202,111,56,35,91,53,32,6,77,42,35,5,5,40,17,23
"2021","East Lindsey 012D","E01026116",728,197,89,108,486,92,221,105,67,49,96,43,45,8,75,48,27,2,2,45,20,25
"2021","East Lindsey 012E","E01034685",643,214,154,60,410,163,164,113,24,27,53,37,14,2,28,12,16,2,2,19,6,13
"2021","East Lindsey 012F","E01034686",747,209,93,116,498,69,179,87,61,31,155,75,79,1,90,70,20,5,5,40,22,18
"2021","East Lindsey 013A","E01026046",595,164,92,72,407,83,184,93,63,28,84,41,37,6,54,37,17,2,2,24,13,11
"2021","East Lindsey 013B","E01026047",627,177,123,54,430,163,170,86,51,33,49,32,15,2,43,24,19,5,5,20,8,12
"2021","East Lindsey 013C","E01026055",493,114,74,40,349,83,199,109,53,37,47,27,14,6,20,7,13,0,0,30,15,15
"2021","East Lindsey 013D","E01026059",493,115,73,42,345,85,187,100,54,33,46,24,20,2,24,11,13,3,3,33,14,19
"2021","East Lindsey 013E","E01026100",845,268,114,154,558,103,204,95,79,30,150,72,71,7,99,70,29,2,2,19,7,12
"2021","East Lindsey 013F","E01026101",615,248,145,103,340,63,139,47,67,25,70,25,41,4,65,44,21,3,3,27,11,16
"2021","East Lindsey 014A","E01026092",645,239,86,153,363,38,156,63,67,26,97,44,49,4,66,48,18,6,6,43,18,25
"2021","East Lindsey 014B","E01026093",919,467,142,325,380,42,138,71,43,24,122,69,47,6,66,43,23,12,12,72,27,45
"2021","East Lindsey 014C","E01026095",596,258,99,159,304,54,136,61,45,30,70,40,25,5,44,31,13,0,0,34,20,14
"2021","East Lindsey 014D","E01026114",782,317,126,191,410,68,147,77,47,23,110,57,48,5,81,46,35,4,4,55,23,32
"2021","East Lindsey 015A","E01026083",789,280,144,136,467,70,170,69,68,33,86,31,49,6,139,89,50,2,2,42,20,22
"2021","East Lindsey 015B","E01026094",1069,393,222,171,645,119,218,111,68,39,141,50,85,6,166,134,32,1,1,31,11,20
"2021","East Lindsey 015C","E01026096",618,124,70,54,461,95,241,108,96,37,68,37,26,5,54,37,17,3,3,33,13,20
"2021","East Lindsey 015D","E01026097",751,297,198,99,417,110,152,67,53,32,80,51,26,3,72,36,36,3,3,37,13,24
"2021","East Lindsey 016A","E01026051",611,165,77,88,421,85,209,95,79,35,76,38,34,4,49,32,17,2,2,25,10,15
"2021","East Lindsey 016B","E01026052",844,219,98,121,601,127,312,125,150,37,100,53,46,1,59,43,16,3,3,24,10,14
"2021","East Lindsey 016C","E01026053",777,153,66,87,585,82,337,126,176,35,99,44,48,7,65,44,21,2,2,39,16,23
"2021","East Lindsey 016D","E01026054",713,249,104,145,434,81,187,71,83,33,64,37,25,2,97,61,36,5,5,30,16,14
"2021","East Lindsey 016E","E01026118",853,227,175,52,601,227,268,136,90,42,63,32,26,5,43,19,24,0,0,25,4,21
"2021","East Lindsey 016F","E01026119",511,139,110,29,356,143,174,89,62,23,29,20,8,1,8,1,7,2,2,16,7,9
"2021","East Lindsey 016G","E01026120",736,299,176,123,410,104,183,78,71,34,56,41,13,2,65,45,20,2,2,27,10,17
"2021","East Lindsey 017A","E01026056",518,103,63,40,373,90,187,83,59,45,73,39,28,6,22,8,14,1,1,42,23,19
"2021","East Lindsey 017B","E01026110",689,200,127,73,454,126,208,113,49,46,77,39,32,6,42,30,12,1,1,35,16,19
"2021","East Lindsey 017C","E01026111",672,173,105,68,455,117,216,102,61,53,61,28,28,5,56,33,23,5,5,44,19,25
"2021","East Lindsey 017D","E01026112",499,153,74,79,314,32,137,57,52,28,70,33,33,4,73,55,18,2,2,32,17,15
"2021","East Lindsey 018A","E01026057",868,241,129,112,582,126,303,157,91,55,95,59,29,7,55,26,29,3,3,45,27,18
"2021","East Lindsey 018B","E01026075",953,229,131,98,678,181,337,172,114,51,101,63,29,9,55,33,22,4,4,46,17,29
"2021","East Lindsey 018C","E01026098",903,240,153,87,627,148,319,143,118,58,89,53,33,3,68,36,32,3,3,36,20,16
"2021","East Lindsey 018D","E01026102",992,247,134,113,672,165,316,165,91,60,115,69,36,10,71,40,31,5,5,73,27,46
"2021","Lincoln 001A","E01026149",781,286,107,179,456,50,195,83,83,29,98,52,39,7,110,73,37,3,3,39,13,26
"2021","Lincoln 001B","E01026150",857,373,102,271,449,30,143,55,66,22,113,60,49,4,149,112,37,14,14,35,10,25
"2021","Lincoln 001C","E01026166",603,189,74,115,365,38,126,44,55,27,73,26,45,2,118,80,38,10,10,49,17,32
"2021","Lincoln 001D","E01026168",694,204,43,161,456,28,147,42,68,37,117,42,69,6,154,111,43,10,10,34,11,23
"2021","Lincoln 002A","E01026153",1096,362,150,212,666,82,327,121,156,50,170,92,71,7,81,51,30,6,6,68,23,45
"2021","Lincoln 002B","E01026155",813,236,85,151,541,61,267,109,121,37,135,86,42,7,76,56,20,2,2,36,12,24
"2021","Lincoln 002C","E01026157",641,222,105,117,397,73,136,69,43,24,80,29,46,5,104,70,34,4,4,22,6,16
"2021","Lincoln 002D","E01026165",832,330,160,170,469,55,161,71,58,32,136,74,59,3,111,78,33,6,6,33,12,21
"2021","Lincoln 003A","E01026125",519,166,45,121,313,34,124,46,55,23,88,68,16,4,57,38,19,10,10,40,14,26
"2021","Lincoln 003B","E01026144",885,265,74,191,396,20,194,60,106,28,96,70,22,4,79,55,24,7,7,224,12,212
"2021","Lincoln 003C","E01026147",1069,314,119,195,668,79,324,131,157,36,183,135,47,1,72,41,31,10,10,87,20,67
"2021","Lincoln 003D","E01026148",973,432,142,290,419,40,124,68,40,16,145,115,28,2,97,58,39,13,13,122,8,114
"2021","Lincoln 003E","E01026151",965,341,165,176,558,79,221,81,109,31,159,107,46,6,89,64,25,10,10,66,22,44
"2021","Lincoln 003F","E01026164",565,159,91,68,373,71,215,86,91,38,50,26,21,3,34,18,16,3,3,33,5,28
"2021","Lincoln 003G","E01026167",809,312,148,164,442,101,226,113,86,27,87,70,17,0,26,15,11,2,2,55,13,42
"2021","Lincoln 004A","E01026122",804,324,56,268,350,22,141,61,61,19,119,93,21,5,54,36,18,14,14,130,17,113
"2021","Lincoln 004B","E01026123",1056,346,74,272,624,35,272,80,163,29,143,71,66,6,164,126,38,10,10,86,35,51
"2021","Lincoln 004C","E01026124",749,237,45,192,386,13,136,53,68,15,136,87,43,6,84,62,22,17,17,126,25,101
"2021","Lincoln 004D","E01026126",917,429,91,338,362,23,107,46,44,17,116,79,33,4,101,69,32,15,15,126,21,105
"2021","Lincoln 004E","E01026152",569,137,50,87,389,14,123,31,69,23,92,21,62,9,156,104,52,4,4,43,21,22
"2021","Lincoln 004F","E01026154",528,118,49,69,373,37,162,49,77,36,72,26,34,12,95,61,34,7,7,37,16,21
"2021","Lincoln 004G","E01026156",489,109,47,62,345,26,147,49,68,30,76,30,39,7,96,53,43,0,0,35,17,18
"2021","Lincoln 005A","E01026132",779,377,73,304,271,15,83,44,32,7,114,101,13,0,45,27,18,14,14,131,10,121
"2021","Lincoln 005C","E01026145",656,213,57,156,300,33,139,67,54,18,88,67,18,3,37,22,15,3,3,143,12,131
"2021","Lincoln 005D","E01026146",736,293,106,187,187,11,50,19,19,12,75,59,13,3,40,29,11,11,11,256,7,249
"2021","Lincoln 005E","E01034687",462,138,31,107,169,13,74,28,33,13,60,54,6,0,15,10,5,7,7,155,2,153
"2021","Lincoln 005F","E01034688",434,191,27,164,150,17,54,32,18,4,54,50,3,1,17,10,7,8,8,93,6,87
"2021","Lincoln 006A","E01026134",941,394,101,293,413,11,144,65,61,18,167,117,45,5,71,42,29,20,20,134,23,111
"2021","Lincoln 006B","E01026176",1014,471,63,408,354,12,98,37,53,8,149,103,42,4,66,46,20,29,29,189,28,161
"2021","Lincoln 006C","E01026177",816,203,34,169,361,10,120,36,71,13,125,75,44,6,85,62,23,21,21,252,52,200
"2021","Lincoln 006D","E01026178",801,257,68,189,357,26,124,49,57,18,118,90,22,6,74,40,34,15,15,187,29,158
"2021","Lincoln 007A","E01026127",632,215,87,128,386,23,117,43,49,25,102,50,44,8,140,109,31,4,4,31,19,12
"2021","Lincoln 007C","E01026129",723,219,44,175,461,16,141,47,69,25,120,47,58,15,182,142,40,2,2,43,12,31
"2021","Lincoln 007D","E01026131",604,180,86,94,391,68,170,65,56,49,85,35,45,5,65,45,20,3,3,33,11,22
"2021","Lincoln 007E","E01034689",520,142,38,104,353,30,127,54,62,11,114,67,41,6,82,61,21,0,0,25,10,15
"2021","Lincoln 007F","E01034690",694,211,96,115,445,69,185,75,81,29,111,65,39,7,78,43,35,2,2,38,21,17
"2021","Lincoln 008B","E01026135",758,189,105,84,538,107,273,109,107,57,92,56,30,6,66,34,32,0,0,31,10,21
"2021","Lincoln 008C","E01026136",786,217,104,113,535,85,237,95,94,48,130,80,39,11,79,49,30,4,4,34,17,17
"2021","Lincoln 008D","E01026174",659,243,44,199,355,17,134,54,55,25,124,73,48,3,69,42,27,11,11,61,17,44
"2021","Lincoln 008E","E01034691",456,166,25,141,258,22,84,30,41,13,70,45,24,1,67,57,10,15,15,32,8,24
"2021","Lincoln 008F","E01034692",640,213,66,147,322,23,108,44,49,15,109,74,33,2,71,50,21,11,11,105,15,90
"2021","Lincoln 009A","E01026130",625,168,108,60,436,113,202,98,71,33,70,34,34,2,48,22,26,3,3,21,9,12
"2021","Lincoln 009B","E01026158",657,209,124,85,425,122,181,81,56,44,77,50,22,5,43,21,22,2,2,23,10,13
"2021","Lincoln 009C","E01026159",657,209,77,132,425,42,194,84,76,34,102,57,40,5,85,65,20,2,2,23,11,12
"2021","Lincoln 009D","E01026160",611,173,69,104,420,87,188,84,72,32,91,56,32,3,53,29,24,1,1,18,7,11
"2021","Lincoln 009E","E01026162",643,192,107,85,418,85,193,87,72,34,74,21,49,4,61,35,26,5,5,33,17,16
"2021","Lincoln 009F","E01026163",602,177,64,113,407,69,190,85,69,36,104,62,37,5,41,26,15,3,3,18,8,10
"2021","Lincoln 010A","E01026161",659,281,98,183,348,35,135,71,47,17,69,37,29,3,100,74,26,9,9,30,16,14
"2021","Lincoln 010B","E01026170",646,160,70,90,459,52,190,90,68,32,111,51,54,6,103,71,32,3,3,27,12,15
"2021","Lincoln 010C","E01026172",643,196,75,121,398,26,189,62,86,41,88,29,58,1,91,65,26,4,4,49,24,25
"2021","Lincoln 010D","E01026173",695,256,67,189,403,16,115,35,61,19,94,25,59,10,173,116,57,5,5,36,19,17
"2021","Lincoln 010E","E01026175",933,405,85,320,432,17,122,51,53,18,172,111,59,2,112,85,27,9,9,96,31,65
"2021","Lincoln 011A","E01026137",479,122,57,65,331,45,182,65,69,48,57,24,29,4,46,26,20,1,1,26,11,15
"2021","Lincoln 011B","E01026138",624,157,94,63,445,92,215,95,75,45,85,33,47,5,53,32,21,0,0,22,13,9
"2021","Lincoln 011C","E01026139",568,120,73,47,425,77,208,84,97,27,83,42,35,6,56,37,19,1,1,23,7,16
"2021","Lincoln 011D","E01026140",626,232,86,146,368,34,152,65,57,30,94,54,36,4,87,60,27,1,1,26,9,17
"2021","Lincoln 011E","E01026141",594,103,51,52,464,61,261,80,126,55,81,28,48,5,61,32,29,0,0,27,10,17
"2021","Lincoln 011F","E01026142",506,138,61,77,339,48,149,58,61,30,65,36,22,7,75,55,20,2,2,29,10,19
"2021","Lincoln 011G","E01026169",724,204,117,87,473,106,225,86,83,56,74,41,29,4,67,30,37,1,1,47,24,23
"2021","Lincoln 011H","E01026171",694,208,134,74,459,123,213,92,81,40,77,41,30,6,45,16,29,1,1,27,9,18
"2021","North Kesteven 001A","E01026186",740,186,107,79,523,122,262,125,95,42,69,43,25,1,65,47,18,5,5,31,13,18
"2021","North Kesteven 001B","E01026187",774,168,53,115,578,48,334,121,144,69,119,76,43,0,73,52,21,4,4,28,9,19
"2021","North Kesteven 001C","E01026189",818,215,141,74,583,175,285,148,95,42,70,47,22,1,50,24,26,3,3,20,7,13
"2021","North Kesteven 001D","E01026203",888,261,164,97,601,190,273,106,123,44,87,51,32,4,47,26,21,4,4,26,11,15
"2021","North Kesteven 001E","E01026204",753,207,135,72,530,169,251,126,83,42,62,32,25,5,46,24,22,2,2,16,8,8
"2021","North Kesteven 001F","E01026206",777,188,111,77,565,112,316,115,141,60,84,49,30,5,49,30,19,4,4,24,7,17
"2021","North Kesteven 003B","E01026182",633,170,80,90,438,91,241,85,105,51,61,35,26,0,44,27,17,1,1,25,11,14
"2021","North Kesteven 003C","E01026193",647,132,75,57,492,106,282,126,106,50,72,50,18,4,30,15,15,2,2,23,5,18
"2021","North Kesteven 003D","E01026199",1081,256,141,115,779,169,424,168,166,90,109,62,42,5,75,42,33,2,2,46,17,29
"2021","North Kesteven 003E","E01026225",742,209,91,118,503,65,265,100,118,47,92,51,36,5,77,49,28,4,4,30,16,14
"2021","North Kesteven 003F","E01026226",834,227,168,59,580,175,297,154,88,55,62,34,25,3,44,24,20,2,2,27,8,19
"2021","North Kesteven 003H","E01032994",668,168,74,94,477,79,221,100,82,39,97,65,27,5,79,59,20,1,1,23,10,13
"2021","North Kesteven 003I","E01034693",677,119,17,102,538,27,294,81,191,22,155,82,68,5,57,50,7,5,5,20,10,10
"2021","North Kesteven 003J","E01034694",710,148,15,133,534,22,290,83,191,16,138,80,51,7,84,66,18,0,0,28,13,15
"2021","North Kesteven 004A","E01026184",584,95,39,56,479,31,329,95,218,16,84,53,29,2,31,21,10,4,4,10,6,4
"2021","North Kesteven 004B","E01026185",993,315,175,140,643,111,325,137,126,62,134,76,50,8,71,38,33,2,2,35,12,23
"2021","North Kesteven 004C","E01026188",1032,371,185,186,621,84,285,118,127,40,137,67,63,7,109,75,34,6,6,40,15,25
"2021","North Kesteven 004D","E01026190",815,242,136,106,550,101,244,88,120,36,106,60,40,6,95,77,18,4,4,23,12,11
"2021","North Kesteven 004E","E01026237",511,133,86,47,345,88,169,80,55,34,58,30,26,2,28,18,10,2,2,33,12,21
"2021","North Kesteven 004F","E01026238",628,148,72,76,461,57,239,86,103,50,113,51,57,5,51,37,14,1,1,19,6,13
"2021","North Kesteven 005A","E01026191",792,183,93,90,580,94,302,123,125,54,117,65,48,4,66,45,21,1,1,29,15,14
"2021","North Kesteven 005B","E01026205",738,215,131,84,498,106,223,96,97,30,90,44,37,9,75,45,30,4,4,25,16,9
"2021","North Kesteven 005C","E01026211",810,158,74,84,630,110,351,151,150,50,112,65,41,6,57,36,21,0,0,22,9,13
"2021","North Kesteven 005D","E01026212",660,185,102,83,450,95,227,95,88,44,83,46,34,3,43,28,15,2,2,25,12,13
"2021","North Kesteven 005E","E01026213",808,284,187,97,508,124,215,101,72,42,96,46,46,4,72,38,34,1,1,16,7,9
"2021","North Kesteven 006A","E01026192",529,137,70,67,368,86,197,91,69,37,60,30,28,2,25,19,6,0,0,24,9,15
"2021","North Kesteven 006B","E01026194",930,255,149,106,656,161,322,124,140,58,98,51,46,1,72,41,31,3,3,19,6,13
"2021","North Kesteven 006C","E01026195",829,198,120,78,599,156,326,145,118,63,76,41,29,6,40,22,18,1,1,32,10,22
"2021","North Kesteven 006D","E01026196",656,183,113,70,453,122,237,106,82,49,63,39,21,3,31,12,19,0,0,20,8,12
"2021","North Kesteven 007A","E01026180",617,157,83,74,430,98,234,109,91,34,53,32,15,6,44,22,22,1,1,30,12,18
"2021","North Kesteven 007B","E01026183",1190,354,180,174,786,158,390,191,128,71,127,53,65,9,109,80,29,2,2,50,25,25
"2021","North Kesteven 007C","E01026210",1031,244,123,121,739,157,378,182,125,71,133,76,51,6,68,43,25,3,3,48,25,23
"2021","North Kesteven 007D","E01026224",794,242,155,87,521,86,235,92,94,49,94,45,36,13,104,74,30,2,2,31,11,20
"2021","North Kesteven 008A","E01026179",417,71,30,41,338,44,231,79,137,15,36,19,16,1,26,17,9,1,1,8,3,5
"2021","North Kesteven 008B","E01026197",639,171,74,97,446,102,248,114,101,33,57,33,23,1,36,25,11,3,3,22,6,16
"2021","North Kesteven 008C","E01026198",467,98,9,89,357,12,242,70,152,20,59,43,16,0,42,35,7,2,2,12,4,8
"2021","North Kesteven 008D","E01026223",914,252,141,111,634,150,326,153,105,68,87,53,28,6,64,37,27,7,7,28,12,16
"2021","North Kesteven 009A","E01026209",971,282,192,90,669,209,344,178,99,67,58,32,21,5,55,26,29,3,3,20,7,13
"2021","North Kesteven 009B","E01026221",1096,281,146,135,770,150,434,215,151,68,104,60,38,6,79,53,26,3,3,45,18,27
"2021","North Kesteven 009C","E01026222",876,290,175,115,557,177,236,104,84,48,96,55,34,7,44,22,22,4,4,29,9,20
"2021","North Kesteven 010A","E01026227",813,399,158,241,372,32,128,50,57,21,101,46,49,6,99,64,35,12,12,42,11,31
"2021","North Kesteven 010B","E01026230",764,235,77,158,492,55,198,63,108,27,130,70,57,3,106,81,25,3,3,37,12,25
"2021","North Kesteven 010C","E01026231",1173,306,121,185,822,127,417,162,175,80,167,88,74,5,109,77,32,2,2,45,20,25
"2021","North Kesteven 010D","E01026232",1023,419,203,216,581,109,271,114,116,41,110,74,34,2,88,61,27,3,3,23,8,15
"2021","North Kesteven 010E","E01026235",773,293,120,173,446,71,164,61,80,23,87,45,39,3,118,85,33,6,6,34,15,19
"2021","North Kesteven 011A","E01026228",730,175,53,122,524,57,247,94,117,36,119,76,42,1,94,72,22,7,7,31,11,20
"2021","North Kesteven 011B","E01026229",759,193,74,119,543,63,288,117,134,37,95,42,47,6,95,71,24,2,2,23,11,12
"2021","North Kesteven 011C","E01026233",723,171,95,76,524,103,299,116,136,47,75,45,30,0,46,29,17,1,1,28,14,14
"2021","North Kesteven 011E","E01026236",537,189,120,69,334,93,148,66,61,21,56,25,22,9,35,25,10,2,2,14,6,8
"2021","North Kesteven 011F","E01034695",747,162,28,134,537,28,336,99,213,24,113,56,50,7,54,42,12,6,6,48,23,25
"2021","North Kesteven 011G","E01034696",623,132,80,52,473,106,297,113,119,65,36,20,13,3,34,18,16,0,0,18,7,11
"2021","North Kesteven 012A","E01026200",813,237,106,131,542,114,273,146,76,51,92,56,30,6,57,41,16,6,6,34,12,22
"2021","North Kesteven 012B","E01026201",894,212,128,84,651,176,320,149,113,58,87,43,34,10,67,38,29,1,1,31,9,22
"2021","North Kesteven 012C","E01026202",919,312,211,101,585,178,264,127,87,50,82,40,36,6,58,37,21,3,3,22,11,11
"2021","North Kesteven 012D","E01026207",549,143,87,56,376,96,185,82,61,42,60,36,21,3,35,18,17,0,0,30,9,21
"2021","North Kesteven 012E","E01026208",690,150,82,68,510,95,292,148,104,40,79,43,28,8,42,25,17,2,2,30,14,16
"2021","North Kesteven 013A","E01026220",1039,316,220,96,687,214,294,148,93,53,91,48,34,9,85,47,38,3,3,36,14,22
"2021","North Kesteven 013B","E01032988",798,212,82,130,557,47,255,95,126,34,139,78,53,8,113,71,42,3,3,29,9,20
"2021","North Kesteven 013C","E01032989",812,171,14,157,612,19,315,86,197,32,167,106,59,2,109,92,17,2,2,29,12,17
"2021","North Kesteven 013D","E01032993",1050,253,118,135,764,122,432,153,221,58,130,67,59,4,79,54,25,1,1,33,11,22
"2021","North Kesteven 014A","E01026214",514,159,84,75,345,64,172,82,67,23,53,31,17,5,56,32,24,0,0,10,4,6
"2021","North Kesteven 014B","E01026215",460,124,101,23,325,84,169,71,60,38,44,19,21,4,26,19,7,2,2,11,2,9
"2021","North Kesteven 014C","E01026218",581,208,128,80,354,118,151,80,44,27,47,33,12,2,37,17,20,1,1,19,7,12
"2021","North Kesteven 014D","E01026219",510,148,108,40,352,87,167,67,66,34,61,26,32,3,35,17,18,2,2,10,5,5
"2021","North Kesteven 014E","E01032991",935,244,107,137,641,87,311,104,172,35,151,81,63,7,88,59,29,4,4,50,18,32
"2021","North Kesteven 014F","E01032992",687,239,133,106,427,85,207,84,79,44,78,45,28,5,54,41,13,3,3,21,4,17
"2021","South Holland 001A","E01026242",777,205,109,96,551,113,251,112,97,42,96,46,43,7,86,53,33,5,5,21,8,13
"2021","South Holland 001B","E01026243",593,173,101,72,387,64,179,74,73,32,65,33,27,5,78,58,20,1,1,33,17,16
"2021","South Holland 001C","E01026244",554,120,83,37,396,98,210,111,69,30,51,25,23,3,34,21,13,3,3,38,13,25
"2021","South Holland 001D","E01026247",843,248,153,95,546,123,274,145,75,54,86,43,36,7,60,30,30,3,3,49,23,26
"2021","South Holland 001E","E01026276",981,205,128,77,710,157,381,196,111,74,99,61,29,9,71,41,30,2,2,66,28,38
"2021","South Holland 002A","E01026246",981,239,126,113,685,153,334,159,102,73,117,62,46,9,80,40,40,1,1,57,26,31
"2021","South Holland 002B","E01026248",945,202,95,107,674,109,371,198,109,64,115,61,46,8,75,32,43,4,4,69,27,42
"2021","South Holland 002C","E01026257",970,273,198,75,659,191,282,125,100,57,99,49,43,7,85,60,25,2,2,38,10,28
"2021","South Holland 003A","E01026250",1003,368,151,217,572,71,219,87,99,33,147,77,63,7,126,96,30,9,9,63,32,31
"2021","South Holland 003B","E01026251",815,235,150,85,543,145,262,112,97,53,83,40,36,7,51,26,25,2,2,37,14,23
"2021","South Holland 003C","E01026252",825,289,184,105,491,123,234,105,84,45,82,37,40,5,49,29,20,3,3,45,19,26
"2021","South Holland 003D","E01026253",894,291,162,129,562,95,243,118,74,51,126,43,70,13,96,62,34,2,2,41,26,15
"2021","South Holland 004A","E01026281",585,137,81,56,425,81,242,125,82,35,62,37,19,6,37,23,14,3,3,23,14,9
"2021","South Holland 004B","E01026282",760,186,123,63,533,120,260,114,102,44,87,40,38,9,60,41,19,6,6,41,20,21
"2021","South Holland 004C","E01026283",748,184,107,77,532,122,284,120,106,58,73,42,23,8,50,33,17,3,3,32,14,18
"2021","South Holland 004D","E01026285",619,140,84,56,454,110,224,118,72,34,76,42,25,9,42,17,25,2,2,25,14,11
"2021","South Holland 004E","E01026286",528,133,76,57,358,76,178,76,66,36,59,36,20,3,45,23,22,0,0,37,16,21
"2021","South Holland 005A","E01026241",752,133,55,78,563,68,314,139,135,40,111,46,55,10,67,43,24,3,3,56,27,29
"2021","South Holland 005B","E01026258",975,236,140,96,689,157,327,138,130,59,133,68,63,2,68,41,27,4,4,50,23,27
"2021","South Holland 005C","E01026259",715,142,66,76,526,97,261,118,88,55,104,61,37,6,59,32,27,5,5,47,15,32
"2021","South Holland 005D","E01026260",859,264,150,114,559,121,235,87,104,44,110,53,49,8,91,64,27,2,2,36,19,17
"2021","South Holland 006B","E01026266",1066,389,139,250,553,43,208,84,97,27,185,115,62,8,98,65,33,19,19,124,37,87
"2021","South Holland 006C","E01026273",738,190,136,54,504,122,255,95,116,44,78,41,33,4,42,19,23,7,7,44,25,19
"2021","South Holland 006E","E01026275",1114,286,152,134,700,82,312,102,164,46,185,98,81,6,111,76,35,10,10,128,50,78
"2021","South Holland 006F","E01032995",726,318,135,183,319,50,99,44,45,10,96,54,40,2,67,45,22,7,7,89,23,66
"2021","South Holland 006G","E01032996",570,129,74,55,396,90,196,82,79,35,59,26,25,8,45,26,19,6,6,45,19,26
"2021","South Holland 006H","E01034697",650,165,76,89,440,57,210,74,106,30,98,46,49,3,66,50,16,9,9,45,22,23
"2021","South Holland 006I","E01034698",632,96,21,75,459,36,253,68,156,29,96,42,51,3,65,55,10,9,9,77,45,32
"2021","South Holland 007A","E01026268",878,296,164,132,513,93,190,73,90,27,116,61,51,4,107,68,39,7,7,69,36,33
"2021","South Holland 007B","E01026269",943,255,151,104,633,170,288,119,118,51,103,58,37,8,64,35,29,8,8,55,27,28
"2021","South Holland 007C","E01026270",726,179,68,111,452,54,171,49,80,42,110,47,58,5,110,71,39,7,7,95,44,51
"2021","South Holland 007D","E01026271",760,251,129,122,418,42,170,64,76,30,96,42,46,8,104,69,35,6,6,91,38,53
"2021","South Holland 007E","E01026272",604,187,86,101,355,64,164,67,62,35,69,38,24,7,54,29,25,4,4,62,25,37
"2021","South Holland 008A","E01026254",862,303,192,111,517,145,246,123,74,49,74,36,27,11,52,24,28,0,0,42,18,24
"2021","South Holland 008B","E01026255",905,296,136,160,565,140,233,105,80,48,105,57,43,5,82,49,33,5,5,44,18,26
"2021","South Holland 008C","E01026256",725,195,126,69,494,112,227,103,75,49,87,44,35,8,64,40,24,4,4,36,13,23
"2021","South Holland 008D","E01026277",717,247,112,135,424,62,168,60,79,29,107,40,62,5,85,63,22,2,2,46,25,21
"2021","South Holland 008E","E01026278",634,156,94,62,437,83,206,100,69,37,86,44,34,8,55,30,25,7,7,41,17,24
"2021","South Holland 008F","E01026279",623,207,119,88,386,74,162,85,45,32,80,33,41,6,66,41,25,4,4,30,11,19
"2021","South Holland 009A","E01026262",643,151,80,71,454,121,220,106,75,39,66,32,32,2,37,18,19,10,10,38,16,22
"2021","South Holland 009B","E01026263",971,247,126,121,653,76,312,112,161,39,169,84,82,3,88,61,27,8,8,71,41,30
"2021","South Holland 009C","E01026264",654,157,85,72,419,57,174,64,76,34,103,48,46,9,74,47,27,11,11,78,34,44
"2021","South Holland 009D","E01026265",538,127,65,62,371,82,174,71,63,40,69,31,32,6,42,26,16,4,4,40,15,25
"2021","South Holland 009F","E01034699",548,128,43,85,348,36,154,57,83,14,80,32,44,4,74,54,20,4,4,72,33,39
"2021","South Holland 009G","E01034700",667,222,115,107,408,107,172,76,68,28,67,40,25,2,58,30,28,4,4,37,18,19
"2021","South Holland 010A","E01026245",1076,289,176,113,725,194,322,155,104,63,139,85,44,10,66,38,28,4,4,62,21,41
"2021","South Holland 010B","E01026249",857,182,96,86,621,144,300,159,84,57,116,75,36,5,56,32,24,5,5,54,26,28
"2021","South Holland 010C","E01026280",1116,258,141,117,780,138,407,201,122,84,148,80,67,1,81,45,36,6,6,78,39,39
"2021","South Holland 011A","E01026239",918,282,113,169,602,94,298,115,126,57,135,75,53,7,70,49,21,5,5,34,13,21
"2021","South Holland 011B","E01026240",1143,249,133,116,853,158,419,171,168,80,180,103,69,8,96,63,33,0,0,41,20,21
"2021","South Holland 011C","E01026284",972,211,106,105,714,129,356,162,135,59,163,87,66,10,62,45,17,4,4,47,14,33
"2021","South Kesteven 001A","E01026313",628,158,113,45,449,99,267,106,112,49,52,30,18,4,30,14,16,1,1,21,8,13
"2021","South Kesteven 001B","E01026314",588,161,98,63,404,76,204,96,80,28,68,36,29,3,51,33,18,5,5,23,9,14
"2021","South Kesteven 001C","E01026329",804,212,132,80,572,144,289,122,113,54,72,46,23,3,66,39,27,1,1,20,6,14
"2021","South Kesteven 001D","E01026333",1079,227,120,107,809,151,468,232,158,78,123,75,37,11,66,39,27,1,1,43,21,22
"2021","South Kesteven 002A","E01026291",893,255,170,85,620,162,329,128,140,61,91,52,35,4,38,22,16,0,0,18,8,10
"2021","South Kesteven 002B","E01026340",1005,304,190,114,667,161,339,143,140,56,87,52,31,4,78,49,29,2,2,34,11,23
"2021","South Kesteven 002C","E01026355",1109,298,192,106,772,211,406,161,179,66,84,48,29,7,68,44,24,3,3,39,10,29
"2021","South Kesteven 002D","E01026365",1023,233,161,72,750,246,384,198,129,57,77,48,24,5,40,20,20,3,3,40,19,21
"2021","South Kesteven 003A","E01026325",621,147,79,68,434,40,218,78,97,43,80,22,51,7,91,51,40,5,5,40,19,21
"2021","South Kesteven 003B","E01026326",621,180,118,62,412,78,199,77,81,41,70,33,33,4,65,45,20,0,0,29,11,18
"2021","South Kesteven 003C","E01026327",618,174,92,82,424,79,195,90,64,41,66,29,32,5,81,50,31,3,3,20,11,9
"2021","South Kesteven 003D","E01026328",600,161,71,90,412,43,180,53,90,37,86,30,43,13,101,75,26,2,2,27,13,14
"2021","South Kesteven 003E","E01026352",561,158,118,40,383,114,199,70,97,32,39,23,15,1,29,13,16,2,2,20,11,9
"2021","South Kesteven 003F","E01026353",863,460,210,250,365,52,129,59,49,21,79,50,25,4,97,71,26,8,8,38,12,26
"2021","South Kesteven 003G","E01026354",488,109,79,30,368,114,175,76,72,27,35,14,14,7,41,23,18,3,3,11,5,6
"2021","South Kesteven 004B","E01026321",596,165,103,62,418,97,210,80,90,40,56,27,25,4,54,29,25,1,1,13,6,7
"2021","South Kesteven 004C","E01026322",591,197,98,99,370,84,156,77,53,26,82,49,33,0,42,31,11,6,6,24,10,14
"2021","South Kesteven 004D","E01026323",1060,538,161,377,488,81,213,89,91,33,102,63,35,4,90,61,29,2,2,34,12,22
"2021","South Kesteven 004E","E01026324",879,202,112,90,647,118,352,144,139,69,107,53,47,7,67,45,22,3,3,30,15,15
"2021","South Kesteven 004F","E01034701",602,111,25,86,474,18,223,66,145,12,158,86,70,2,72,60,12,3,3,17,6,11
"2021","South Kesteven 004G","E01034702",649,126,64,62,501,104,288,106,121,61,70,30,29,11,39,27,12,0,0,22,10,12
"2021","South Kesteven 005A","E01026308",624,118,37,81,472,17,166,51,85,30,83,18,60,5,202,171,31,4,4,34,20,14
"2021","South Kesteven 005B","E01026309",725,240,107,133,452,74,181,69,83,29,97,46,44,7,97,63,34,3,3,33,9,24
"2021","South Kesteven 005C","E01026310",450,105,55,50,319,60,135,48,63,24,62,21,36,5,60,42,18,2,2,26,14,12
"2021","South Kesteven 005D","E01026311",679,185,76,109,452,53,201,72,86,43,88,33,48,7,105,73,32,5,5,42,17,25
"2021","South Kesteven 005E","E01026312",449,69,31,38,348,10,146,42,70,34,71,9,46,16,115,82,33,6,6,32,16,16
"2021","South Kesteven 006A","E01026317",1120,428,80,348,625,28,248,93,123,32,217,137,67,13,117,86,31,15,15,67,22,45
"2021","South Kesteven 006B","E01026318",1022,364,87,277,590,29,204,78,99,27,178,99,67,12,173,120,53,6,6,68,26,42
"2021","South Kesteven 006C","E01026319",1110,332,131,201,728,112,337,123,159,55,161,86,71,4,112,75,37,6,6,50,22,28
"2021","South Kesteven 006D","E01026343",939,411,107,304,457,44,154,63,64,27,142,94,42,6,109,80,29,8,8,71,15,56
"2021","South Kesteven 006E","E01026344",666,205,71,134,417,52,182,75,78,29,94,47,39,8,84,60,24,5,5,44,17,27
"2021","South Kesteven 006F","E01026345",730,236,133,103,466,81,224,75,104,45,72,29,40,3,89,63,26,0,0,28,10,18
"2021","South Kesteven 007A","E01026292",632,177,85,92,439,106,208,95,69,44,65,40,20,5,58,32,26,2,2,16,10,6
"2021","South Kesteven 007B","E01026293",870,207,92,115,624,112,294,128,123,43,142,81,47,14,76,50,26,0,0,39,19,20
"2021","South Kesteven 007C","E01026294",657,142,54,88,489,53,268,107,124,37,107,57,43,7,61,45,16,0,0,26,13,13
"2021","South Kesteven 007D","E01026316",1060,239,141,98,781,194,413,192,154,67,105,60,35,10,65,34,31,4,4,40,14,26
"2021","South Kesteven 007E","E01026332",935,226,136,90,663,167,347,178,115,54,98,57,40,1,46,25,21,5,5,46,24,22
"2021","South Kesteven 008A","E01026290",938,208,112,96,672,178,345,169,110,66,92,46,41,5,52,33,19,5,5,58,17,41
"2021","South Kesteven 008B","E01026341",666,159,100,59,474,120,246,98,98,50,61,30,25,6,45,31,14,2,2,33,10,23
"2021","South Kesteven 008C","E01026342",586,146,56,90,419,62,253,93,105,55,64,32,30,2,37,19,18,3,3,21,11,10
"2021","South Kesteven 008D","E01026361",1180,347,170,177,792,168,399,186,146,67,142,85,49,8,79,42,37,4,4,41,21,20
"2021","South Kesteven 009A","E01026315",967,251,145,106,691,160,346,152,139,55,122,78,38,6,60,36,24,3,3,25,9,16
"2021","South Kesteven 009B","E01026331",1109,303,168,135,761,161,382,181,128,73,123,63,55,5,90,52,38,5,5,45,15,30
"2021","South Kesteven 009C","E01026338",541,128,69,59,394,74,212,109,77,26,68,31,30,7,39,23,16,1,1,19,7,12
"2021","South Kesteven 009D","E01026339",570,193,69,124,353,28,163,67,72,24,104,65,36,3,58,37,21,0,0,24,7,17
"2021","South Kesteven 010A","E01026299",746,258,154,104,454,78,205,72,86,47,77,34,39,4,90,64,26,4,4,34,14,20
"2021","South Kesteven 010B","E01026300",634,142,100,42,467,132,257,112,98,47,50,29,16,5,28,11,17,0,0,25,9,16
"2021","South Kesteven 010D","E01026302",493,133,67,66,339,60,169,66,71,32,57,25,26,6,51,30,21,2,2,21,11,10
"2021","South Kesteven 010E","E01034703",571,168,113,55,384,117,188,81,70,37,40,18,19,3,36,13,23,3,3,19,7,12
"2021","South Kesteven 010F","E01034704",552,123,16,107,395,19,185,51,125,9,124,67,56,1,62,53,9,5,5,34,16,18
"2021","South Kesteven 010G","E01034705",550,105,32,73,421,29,193,51,135,7,130,80,48,2,64,51,13,5,5,24,12,12
"2021","South Kesteven 011B","E01026296",660,152,105,47,484,147,249,113,84,52,49,19,27,3,39,16,23,0,0,24,11,13
"2021","South Kesteven 011C","E01026297",666,222,162,60,415,101,196,81,84,31,54,23,27,4,56,29,27,8,8,29,9,20
"2021","South Kesteven 011D","E01026298",1051,460,199,261,552,60,213,83,96,34,138,70,54,14,136,99,37,5,5,39,15,24
"2021","South Kesteven 011E","E01032997",492,111,33,78,359,33,172,55,97,20,75,41,33,1,78,64,14,1,1,22,9,13
"2021","South Kesteven 011F","E01032998",739,187,31,156,529,30,281,75,179,27,119,65,50,4,93,70,23,6,6,23,11,12
"2021","South Kesteven 011G","E01032999",569,163,97,66,380,94,169,65,72,32,63,33,27,3,50,30,20,4,4,26,8,18
"2021","South Kesteven 012A","E01026330",863,169,104,65,661,146,388,154,160,74,82,40,36,6,43,23,20,2,2,33,11,22
"2021","South Kesteven 012B","E01026360",918,217,120,97,662,154,368,155,148,65,73,36,35,2,64,36,28,3,3,39,16,23
"2021","South Kesteven 012C","E01026362",696,140,83,57,538,94,311,119,147,45,76,37,37,2,56,33,23,1,1,18,7,11
"2021","South Kesteven 012D","E01026363",862,232,107,125,602,148,338,195,98,45,81,58,15,8,35,18,17,0,0,28,4,24
"2021","South Kesteven 012E","E01026364",814,202,121,81,578,156,312,129,132,51,60,37,20,3,48,24,24,2,2,34,14,20
"2021","South Kesteven 013A","E01026334",641,114,64,50,500,95,312,141,118,53,50,30,19,1,40,21,19,3,3,27,3,24
"2021","South Kesteven 013B","E01026335",718,251,149,102,435,129,180,78,60,42,69,40,24,5,57,35,22,0,0,32,13,19
"2021","South Kesteven 013C","E01026336",808,287,123,164,491,77,213,96,84,33,102,56,43,3,94,60,34,5,5,30,16,14
"2021","South Kesteven 013D","E01026337",941,245,131,114,662,129,325,108,178,39,112,43,65,4,92,73,19,4,4,34,17,17
"2021","South Kesteven 014A","E01026303",526,124,53,71,385,53,208,82,90,36,77,44,33,0,44,29,15,3,3,17,6,11
"2021","South Kesteven 014B","E01026304",625,140,68,72,459,108,246,97,99,50,64,29,31,4,39,19,20,2,2,26,13,13
"2021","South Kesteven 014C","E01026305",607,178,44,134,419,52,240,119,88,33,80,53,24,3,46,29,17,1,1,10,4,6
"2021","South Kesteven 014D","E01026306",819,249,145,104,543,96,241,84,110,47,100,36,60,4,101,62,39,5,5,27,11,16
"2021","South Kesteven 014E","E01026307",555,144,78,66,391,100,182,77,77,28,63,37,22,4,44,25,19,2,2,20,9,11
"2021","South Kesteven 015A","E01026287",610,195,84,111,387,85,163,74,57,32,67,33,30,4,71,37,34,1,1,28,11,17
"2021","South Kesteven 015B","E01026288",746,262,112,150,445,55,162,63,69,30,103,58,42,3,118,85,33,7,7,39,14,25
"2021","South Kesteven 015C","E01026289",992,271,125,146,680,94,332,119,163,50,128,69,51,8,122,87,35,4,4,41,14,27
"2021","South Kesteven 015D","E01026346",517,141,64,77,354,56,165,61,73,31,74,42,27,5,57,32,25,2,2,22,6,16
"2021","South Kesteven 015E","E01026347",829,396,196,200,408,89,148,64,66,18,102,69,29,4,64,40,24,5,5,25,4,21
"2021","South Kesteven 015F","E01026348",485,94,47,47,365,38,170,59,77,34,88,38,39,11,66,43,23,3,3,26,8,18
"2021","South Kesteven 016A","E01026349",765,303,144,159,440,82,160,64,79,17,92,54,31,7,102,68,34,4,4,22,6,16
"2021","South Kesteven 016B","E01026350",989,494,234,260,470,109,189,95,69,25,100,70,23,7,67,50,17,5,5,25,7,18
"2021","South Kesteven 016C","E01026351",849,474,196,278,363,75,133,68,51,14,90,73,12,5,60,32,28,5,5,12,3,9
"2021","South Kesteven 016D","E01026356",587,132,49,83,442,52,249,85,122,42,83,43,34,6,58,36,22,0,0,13,5,8
"2021","South Kesteven 016E","E01026357",585,154,67,87,412,74,207,88,86,33,71,34,29,8,59,38,21,1,1,19,7,12
"2021","South Kesteven 016F","E01026358",633,168,91,77,455,120,220,102,82,36,66,42,22,2,46,25,21,3,3,10,3,7
"2021","South Kesteven 016G","E01026359",1040,231,111,120,776,133,402,154,209,39,150,84,62,4,88,75,13,3,3,33,13,20
"2021","West Lindsey 001A","E01026367",801,310,151,159,468,85,224,121,57,46,82,55,22,5,71,39,32,6,6,23,8,15
"2021","West Lindsey 001B","E01026368",840,222,110,112,587,110,272,116,119,37,102,50,49,3,100,73,27,3,3,31,19,12
"2021","West Lindsey 001C","E01026387",1142,252,127,125,832,169,482,239,171,72,118,69,40,9,60,35,25,3,3,58,29,29
"2021","West Lindsey 001D","E01026416",572,159,85,74,388,85,204,101,75,28,55,33,21,1,41,22,19,3,3,25,9,16
"2021","West Lindsey 001G","E01032683",1030,336,180,156,662,157,341,158,133,50,104,62,42,0,58,38,20,2,2,32,12,20
"2021","West Lindsey 002A","E01026380",1079,270,98,172,770,88,346,132,167,47,203,113,81,9,125,87,38,8,8,39,14,25
"2021","West Lindsey 002B","E01026401",654,132,81,51,499,115,287,126,106,55,60,29,25,6,36,23,13,1,1,23,11,12
"2021","West Lindsey 002C","E01026402",851,268,149,119,552,134,277,121,117,39,84,43,35,6,56,34,22,1,1,31,17,14
"2021","West Lindsey 002D","E01026403",557,124,70,54,404,86,217,102,81,34,72,36,26,10,27,14,13,2,2,29,15,14
"2021","West Lindsey 002E","E01026407",594,168,86,82,386,65,188,97,52,39,78,39,29,10,52,31,21,3,3,40,19,21
"2021","West Lindsey 002F","E01026408",600,173,99,74,410,104,200,96,68,36,66,34,28,4,36,20,16,4,4,17,8,9
"2021","West Lindsey 003A","E01026389",906,419,143,276,458,78,171,79,63,29,104,60,40,4,100,66,34,5,5,29,12,17
"2021","West Lindsey 003B","E01026390",874,323,177,146,524,110,217,111,66,40,93,44,42,7,102,62,40,2,2,27,6,21
"2021","West Lindsey 003C","E01026391",898,239,157,82,632,158,328,159,117,52,92,53,35,4,54,31,23,0,0,27,13,14
"2021","West Lindsey 003D","E01026392",1336,377,246,131,907,209,484,210,190,84,144,76,61,7,70,39,31,0,0,52,21,31
"2021","West Lindsey 003E","E01026415",493,156,64,92,314,63,142,78,47,17,70,31,33,6,38,30,8,1,1,23,10,13
"2021","West Lindsey 004A","E01026378",738,232,70,162,475,49,169,69,63,37,112,39,60,13,141,85,56,4,4,31,17,14
"2021","West Lindsey 004B","E01026379",820,280,99,181,508,52,207,88,77,42,116,49,63,4,129,92,37,4,4,32,15,17
"2021","West Lindsey 004C","E01026381",876,381,149,232,462,77,166,82,58,26,104,49,49,6,111,79,32,4,4,33,12,21
"2021","West Lindsey 004D","E01026382",784,269,114,155,492,67,217,105,69,43,105,55,45,5,100,71,29,3,3,23,9,14
"2021","West Lindsey 004E","E01026383",736,409,64,345,275,17,82,38,28,16,90,55,27,8,79,61,18,7,7,52,15,37
"2021","West Lindsey 004F","E01026384",1102,551,179,372,504,58,168,77,61,30,132,62,64,6,139,100,39,7,7,47,17,30
"2021","West Lindsey 005A","E01026385",496,133,83,50,345,87,181,88,59,34,44,30,13,1,30,16,14,3,3,18,7,11
"2021","West Lindsey 005B","E01026386",535,148,49,99,359,50,179,82,64,33,68,35,28,5,58,35,23,4,4,28,11,17
"2021","West Lindsey 005C","E01026399",654,164,80,84,467,97,247,115,91,41,77,45,31,1,44,28,16,2,2,23,11,12
"2021","West Lindsey 005D","E01026411",1101,293,145,148,761,162,412,215,126,71,117,61,48,8,67,35,32,3,3,47,18,29
"2021","West Lindsey 006A","E01026374",617,198,70,128,399,32,105,34,48,23,120,26,88,6,137,111,26,5,5,20,11,9
"2021","West Lindsey 006B","E01026375",846,245,114,131,559,59,213,96,81,36,129,57,66,6,153,111,42,5,5,42,26,16
"2021","West Lindsey 006C","E01026376",765,273,161,112,470,86,178,79,65,34,78,35,35,8,122,79,43,6,6,22,12,10
"2021","West Lindsey 006D","E01026377",918,241,110,131,649,71,289,124,113,52,139,57,71,11,144,106,38,6,6,28,13,15
"2021","West Lindsey 007A","E01026388",962,268,167,101,662,170,344,184,104,56,99,56,29,14,49,25,24,0,0,32,11,21
"2021","West Lindsey 007B","E01026404",1054,298,159,139,708,156,357,169,135,53,115,77,33,5,77,51,26,3,3,48,24,24
"2021","West Lindsey 007C","E01026409",564,140,69,71,405,92,212,119,62,31,74,46,23,5,26,22,4,1,1,19,7,12
"2021","West Lindsey 007D","E01026410",784,220,147,73,538,242,212,127,50,35,45,31,10,4,39,15,24,0,0,26,14,12
"2021","West Lindsey 008A","E01026372",1082,278,156,122,771,163,408,165,165,78,99,45,46,8,100,65,35,1,1,33,14,19
"2021","West Lindsey 008B","E01026412",847,255,147,108,570,102,290,100,146,44,91,43,45,3,87,61,26,0,0,22,11,11
"2021","West Lindsey 008C","E01026413",893,222,124,98,643,137,355,124,174,57,84,36,41,7,66,47,19,1,1,28,15,13
"2021","West Lindsey 008D","E01026414",811,197,101,96,579,111,298,115,131,52,98,54,40,4,69,45,24,3,3,35,14,21
"2021","West Lindsey 009A","E01026396",639,207,141,66,415,131,191,87,58,46,57,36,18,3,34,16,18,2,2,17,4,13
"2021","West Lindsey 009C","E01026398",785,290,171,119,473,111,208,105,70,33,72,47,22,3,80,56,24,2,2,22,3,19
"2021","West Lindsey 009D","E01026400",608,130,28,102,455,44,272,94,146,32,89,58,29,2,48,36,12,2,2,23,12,11
"2021","West Lindsey 009E","E01034706",648,128,47,81,508,75,260,91,128,41,105,58,42,5,67,45,22,1,1,12,2,10
"2021","West Lindsey 009F","E01034707",612,199,80,119,395,95,210,133,46,31,64,55,9,0,24,16,8,2,2,18,2,16
"2021","West Lindsey 010A","E01026393",689,176,137,39,498,149,249,102,96,51,60,31,22,7,38,19,19,2,2,15,7,8
"2021","West Lindsey 010B","E01026394",992,245,116,129,709,105,351,138,164,49,177,104,66,7,74,53,21,2,2,38,19,19
"2021","West Lindsey 010C","E01026395",749,264,190,74,469,166,202,87,84,31,63,38,23,2,36,23,13,2,2,16,5,11
"2021","West Lindsey 010D","E01026405",604,125,63,62,461,94,250,83,125,42,70,43,25,2,47,35,12,0,0,18,10,8
"2021","West Lindsey 010E","E01026406",518,123,79,44,382,103,210,83,92,35,41,19,18,4,27,9,18,1,1,13,7,6
"2021","West Lindsey 011A","E01026366",1073,288,118,170,747,159,354,168,132,54,128,75,45,8,106,64,42,0,0,38,16,22
"2021","West Lindsey 011B","E01026369",593,186,116,70,392,88,162,62,70,30,76,38,34,4,65,38,27,1,1,15,9,6
"2021","West Lindsey 011C","E01026370",1154,320,167,153,791,185,376,159,162,55,137,90,45,2,92,52,40,1,1,43,13,30
"2021","West Lindsey 011D","E01026371",528,134,91,43,370,103,185,70,85,30,56,26,25,5,25,15,10,1,1,24,12,12
"2021","West Lindsey 011E","E01026373",941,251,139,112,645,141,334,138,136,60,109,70,33,6,59,37,22,2,2,45,19,26
"2021","Ashfield 001A","E01027979",742,210,119,91,516,154,198,108,49,41,98,53,38,7,62,34,28,4,4,16,10,6
"2021","Ashfield 001B","E01027980",653,191,72,119,430,42,171,78,56,37,106,36,63,7,108,69,39,3,3,32,16,16
"2021","Ashfield 001C","E01027981",732,199,117,82,502,131,249,129,76,44,81,43,36,2,38,16,22,3,3,31,11,20
"2021","Ashfield 001D","E01027983",667,198,62,136,430,36,178,79,69,30,106,47,57,2,104,69,35,6,6,39,20,19
"2021","Ashfield 002A","E01027970",611,165,72,93,418,82,183,87,60,36,83,41,33,9,65,34,31,5,5,28,13,15
"2021","Ashfield 002B","E01027971",591,143,93,50,435,120,189,75,63,51,77,31,42,4,47,25,22,2,2,13,5,8
"2021","Ashfield 002C","E01027982",664,235,126,109,401,86,176,83,57,36,74,36,34,4,62,38,24,3,3,28,11,17
"2021","Ashfield 002D","E01027984",640,182,90,92,440,84,216,83,85,48,86,44,34,8,50,27,23,4,4,18,8,10
"2021","Ashfield 003A","E01027966",630,280,148,132,321,51,123,40,52,31,75,31,34,10,69,43,26,3,3,29,15,14
"2021","Ashfield 003B","E01027986",653,288,112,176,349,61,134,57,52,25,82,37,40,5,69,44,25,3,3,16,7,9
"2021","Ashfield 003C","E01027987",914,237,92,145,636,63,257,96,130,31,170,75,86,9,143,104,39,3,3,41,26,15
"2021","Ashfield 003D","E01027990",783,204,82,122,553,87,278,134,91,53,126,66,51,9,60,36,24,2,2,26,9,17
"2021","Ashfield 004A","E01027967",778,287,73,214,443,33,182,73,75,34,121,61,53,7,96,69,27,11,11,48,27,21
"2021","Ashfield 004B","E01027972",947,226,88,138,675,85,321,116,142,63,143,62,61,20,121,80,41,5,5,46,24,22
"2021","Ashfield 004C","E01027977",863,242,99,143,576,51,225,86,94,45,154,57,84,13,140,92,48,6,6,45,24,21
"2021","Ashfield 004D","E01027978",859,331,61,270,469,28,153,52,66,35,122,52,56,14,157,120,37,9,9,59,21,38
"2021","Ashfield 004E","E01027985",870,218,72,146,613,48,279,96,131,52,161,87,65,9,117,76,41,8,8,39,19,20
"2021","Ashfield 005A","E01027964",601,165,80,85,399,42,157,56,68,33,103,46,43,14,90,59,31,7,7,37,18,19
"2021","Ashfield 005B","E01027965",561,176,83,93,356,21,114,41,50,23,89,28,55,6,125,78,47,7,7,29,14,15
"2021","Ashfield 005C","E01027968",575,269,124,145,279,43,114,42,46,26,48,24,19,5,73,54,19,1,1,27,13,14
"2021","Ashfield 005D","E01027974",646,211,61,150,394,30,158,61,66,31,87,36,38,13,114,79,35,5,5,41,23,18
"2021","Ashfield 005E","E01027976",899,345,196,149,509,70,210,86,94,30,117,61,45,11,110,71,39,2,2,45,13,32
"2021","Ashfield 006A","E01027969",577,173,69,104,372,51,162,74,55,33,84,41,35,8,69,44,25,6,6,32,14,18
"2021","Ashfield 006B","E01027975",696,206,87,119,451,55,178,76,60,42,108,46,49,13,103,68,35,7,7,39,14,25
"2021","Ashfield 006C","E01027988",662,194,101,93,443,90,211,95,62,54,80,38,37,5,59,35,24,3,3,25,13,12
"2021","Ashfield 006D","E01027989",731,230,138,92,480,152,195,92,60,43,77,33,35,9,51,31,20,5,5,21,5,16
"2021","Ashfield 006E","E01027991",519,142,65,77,354,61,164,62,60,42,81,39,35,7,42,27,15,6,6,23,10,13
"2021","Ashfield 006F","E01027992",1016,154,56,98,838,70,500,186,232,82,175,89,70,16,92,56,36,1,1,24,10,14
"2021","Ashfield 007A","E01027949",647,201,88,113,419,71,202,93,64,45,75,40,31,4,67,42,25,4,4,27,9,18
"2021","Ashfield 007B","E01027951",658,212,68,144,422,45,146,48,64,34,86,28,54,4,139,103,36,6,6,24,16,8
"2021","Ashfield 007C","E01027953",637,149,95,54,455,116,213,89,72,52,77,24,42,11,49,33,16,0,0,33,16,17
"2021","Ashfield 007D","E01027954",677,193,48,145,453,40,166,69,63,34,145,64,73,8,100,73,27,2,2,31,9,22
"2021","Ashfield 007E","E01027973",637,128,81,47,485,108,275,107,117,51,78,39,33,6,21,15,6,3,3,24,12,12
"2021","Ashfield 008A","E01027952",817,297,129,168,477,44,189,69,79,41,118,54,53,11,125,87,38,1,1,43,24,19
"2021","Ashfield 008B","E01027955",542,166,46,120,354,35,130,50,53,27,104,46,52,6,84,63,21,1,1,22,12,10
"2021","Ashfield 008C","E01027956",667,239,129,110,397,54,146,55,61,30,90,33,46,11,103,69,34,4,4,31,13,18
"2021","Ashfield 008D","E01027958",598,176,73,103,393,32,163,49,82,32,91,19,66,6,104,62,42,3,3,29,14,15
"2021","Ashfield 009A","E01027947",708,202,107,95,461,76,219,77,94,48,108,56,45,7,55,31,24,3,3,45,23,22
"2021","Ashfield 009B","E01027948",937,268,107,161,630,97,298,113,119,66,130,69,54,7,100,61,39,5,5,39,17,22
"2021","Ashfield 009C","E01027950",1055,341,156,185,670,89,307,136,119,52,148,75,64,9,114,60,54,12,12,44,17,27
"2021","Ashfield 009D","E01027957",533,126,62,64,383,60,179,54,77,48,91,47,39,5,46,27,19,7,7,24,11,13
"2021","Ashfield 009E","E01027959",748,107,47,60,613,58,369,129,172,68,152,79,65,8,34,24,10,0,0,28,13,15
"2021","Ashfield 010A","E01027995",668,175,97,78,464,105,244,128,69,47,73,32,39,2,41,20,21,1,1,29,16,13
"2021","Ashfield 010B","E01027996",863,259,115,144,573,69,270,103,103,64,123,54,58,11,105,54,51,6,6,31,6,25
"2021","Ashfield 010C","E01027997",1031,248,115,133,737,129,358,160,132,66,164,96,60,8,79,53,26,7,7,46,24,22
"2021","Ashfield 010D","E01027998",835,271,135,136,534,116,213,90,79,44,111,55,43,13,91,58,33,3,3,30,12,18
"2021","Ashfield 011A","E01027960",739,267,108,159,449,82,188,80,67,41,94,45,40,9,80,54,26,5,5,23,10,13
"2021","Ashfield 011B","E01027961",811,205,118,87,590,139,293,117,96,80,91,47,35,9,66,36,30,1,1,16,4,12
"2021","Ashfield 011C","E01027962",637,170,87,83,441,66,217,101,73,43,96,50,42,4,61,36,25,1,1,26,15,11
"2021","Ashfield 011D","E01027963",641,163,100,63,457,67,207,71,88,48,76,24,41,11,105,63,42,2,2,21,9,12
"2021","Ashfield 012A","E01027945",754,239,110,129,484,76,227,92,84,51,101,52,46,3,77,48,29,3,3,31,9,22
"2021","Ashfield 012B","E01027946",626,169,94,75,432,75,205,111,61,33,86,49,31,6,64,34,30,2,2,25,10,15
"2021","Ashfield 012C","E01027993",658,192,96,96,439,93,212,89,78,45,83,53,25,5,49,30,19,2,2,27,13,14
"2021","Ashfield 012D","E01027994",655,217,129,88,418,109,201,92,68,41,56,28,21,7,49,23,26,3,3,20,9,11
"2021","Ashfield 013C","E01027934",565,155,78,77,402,63,211,71,102,38,69,34,27,8,56,31,25,3,3,8,5,3
"2021","Ashfield 013D","E01027935",501,128,45,83,355,37,163,75,58,30,87,39,41,7,66,42,24,2,2,18,9,9
"2021","Ashfield 013E","E01027936",648,175,118,57,454,154,211,80,83,48,52,34,16,2,35,13,22,2,2,19,8,11
"2021","Ashfield 013F","E01033778",476,56,14,42,389,24,218,61,135,22,84,43,40,1,60,52,8,3,3,31,18,13
"2021","Ashfield 013G","E01033779",500,88,33,55,396,26,236,71,146,19,92,47,40,5,39,27,12,3,3,16,3,13
"2021","Ashfield 013H","E01033781",591,260,68,192,312,27,117,65,37,15,99,63,30,6,64,49,15,5,5,19,7,12
"2021","Ashfield 013I","E01033782",611,180,95,85,404,67,176,75,68,33,85,43,37,5,76,50,26,0,0,27,16,11
"2021","Ashfield 013J","E01033783",592,152,49,103,419,41,210,87,105,18,102,56,38,8,64,47,17,2,2,21,10,11
"2021","Ashfield 014A","E01027927",994,394,149,245,569,78,235,101,92,42,155,96,53,6,101,62,39,0,0,31,13,18
"2021","Ashfield 014B","E01027928",963,369,117,252,556,37,208,79,79,50,168,94,68,6,137,91,46,6,6,38,15,23
"2021","Ashfield 014C","E01027932",973,285,96,189,629,61,250,99,108,43,162,80,76,6,145,111,34,11,11,59,23,36
"2021","Ashfield 014D","E01027933",690,241,74,167,406,45,147,43,75,29,107,63,40,4,103,64,39,4,4,43,13,30
"2021","Ashfield 014E","E01027937",662,293,120,173,342,42,122,53,47,22,80,40,37,3,90,59,31,8,8,27,8,19
"2021","Ashfield 015A","E01027925",862,180,99,81,637,114,332,93,157,82,116,56,54,6,72,47,25,3,3,45,23,22
"2021","Ashfield 015B","E01027938",502,108,49,59,380,59,228,102,81,45,58,26,27,5,35,21,14,0,0,14,11,3
"2021","Ashfield 015C","E01027940",559,124,72,52,417,105,190,80,70,40,63,25,34,4,56,31,25,3,3,18,8,10
"2021","Ashfield 015D","E01027943",623,178,90,88,418,78,173,76,48,49,101,47,42,12,66,46,20,0,0,27,14,13
"2021","Ashfield 015E","E01027944",645,178,112,66,453,105,240,98,87,55,62,27,28,7,43,19,24,3,3,14,8,6
"2021","Ashfield 016A","E01027926",676,189,97,92,462,103,188,95,48,45,93,46,43,4,76,43,33,2,2,25,8,17
"2021","Ashfield 016B","E01027930",797,283,79,204,476,29,172,68,72,32,131,61,58,12,139,100,39,5,5,38,17,21
"2021","Ashfield 016C","E01027939",606,190,100,90,380,40,120,36,59,25,95,35,51,9,118,82,36,7,7,36,21,15
"2021","Ashfield 016D","E01027941",577,180,80,100,374,75,150,66,41,43,76,44,31,1,69,44,25,4,4,23,11,12
"2021","Ashfield 016E","E01027942",1054,185,47,138,807,69,364,112,213,39,231,111,112,8,140,99,41,3,3,62,37,25
"2021","Bassetlaw 001A","E01028000",1039,307,149,158,702,174,367,164,130,73,122,80,35,7,36,24,12,3,3,30,18,12
"2021","Bassetlaw 001B","E01028024",915,285,130,155,601,96,300,137,115,48,122,63,52,7,76,46,30,7,7,29,11,18
"2021","Bassetlaw 001C","E01028025",625,199,71,128,400,28,179,91,55,33,112,52,50,10,77,51,26,4,4,26,11,15
"2021","Bassetlaw 001D","E01028026",682,226,106,120,427,76,158,63,60,35,101,46,49,6,90,63,27,2,2,29,12,17
"2021","Bassetlaw 001E","E01028027",733,211,85,126,498,65,201,88,72,41,122,53,55,14,106,71,35,4,4,24,14,10
"2021","Bassetlaw 001F","E01028028",980,300,114,186,647,66,249,98,118,33,170,78,86,6,161,127,34,1,1,33,12,21
"2021","Bassetlaw 002A","E01027999",1075,284,164,120,757,188,346,139,146,61,122,63,49,10,98,60,38,3,3,34,18,16
"2021","Bassetlaw 002B","E01028005",820,220,135,85,571,150,291,149,90,52,76,40,26,10,54,33,21,0,0,29,7,22
"2021","Bassetlaw 002C","E01028031",518,170,86,84,338,60,159,68,53,38,66,25,34,7,51,29,22,2,2,10,4,6
"2021","Bassetlaw 002D","E01028032",590,140,70,70,423,84,233,106,86,41,70,38,27,5,36,19,17,0,0,27,13,14
"2021","Bassetlaw 002E","E01028035",1017,237,126,111,748,173,371,162,150,59,142,73,60,9,59,41,18,3,3,32,15,17
"2021","Bassetlaw 003A","E01028023",1070,232,114,118,793,173,423,188,150,85,128,80,40,8,66,44,22,3,3,45,17,28
"2021","Bassetlaw 003B","E01028034",1056,287,175,112,736,171,365,157,152,56,115,57,47,11,80,48,32,5,5,33,11,22
"2021","Bassetlaw 003C","E01028036",897,237,120,117,632,146,328,164,100,64,104,76,19,9,54,34,20,0,0,28,8,20
"2021","Bassetlaw 004A","E01028001",585,216,115,101,340,45,126,55,52,19,83,25,53,5,85,65,20,1,1,29,18,11
"2021","Bassetlaw 004B","E01028002",610,173,98,75,420,110,204,92,71,41,59,32,20,7,45,27,18,2,2,17,7,10
"2021","Bassetlaw 004C","E01028003",647,196,109,87,433,77,209,87,71,51,91,46,44,1,56,30,26,0,0,18,11,7
"2021","Bassetlaw 004D","E01028004",704,180,111,69,495,148,242,117,73,52,66,35,27,4,38,21,17,1,1,29,16,13
"2021","Bassetlaw 004E","E01028029",627,224,101,123,385,60,152,62,63,27,89,34,47,8,81,48,33,3,3,18,11,7
"2021","Bassetlaw 004F","E01028030",496,118,54,64,356,40,162,60,58,44,78,32,41,5,70,47,23,6,6,22,10,12
"2021","Bassetlaw 005A","E01028013",879,304,195,109,553,124,260,120,103,37,100,58,36,6,68,43,25,1,1,22,6,16
"2021","Bassetlaw 005B","E01028014",748,340,168,172,386,68,155,72,51,32,91,37,50,4,72,44,28,0,0,22,9,13
"2021","Bassetlaw 005C","E01028015",706,179,81,98,509,82,236,102,81,53,120,63,44,13,68,42,26,3,3,18,5,13
"2021","Bassetlaw 005D","E01028016",660,235,149,86,416,106,163,73,51,39,77,41,28,8,70,44,26,0,0,9,4,5
"2021","Bassetlaw 006A","E01028046",684,204,81,123,452,86,189,71,73,45,92,50,35,7,84,50,34,1,1,28,15,13
"2021","Bassetlaw 006B","E01028047",1049,156,26,130,856,58,529,153,295,81,194,115,73,6,73,52,21,2,2,37,20,17
"2021","Bassetlaw 006C","E01028048",619,112,42,70,482,46,283,99,127,57,76,37,34,5,73,49,24,4,4,25,13,12
"2021","Bassetlaw 006D","E01028049",767,228,129,99,507,83,219,88,89,42,107,39,55,13,96,69,27,2,2,32,12,20
"2021","Bassetlaw 006E","E01028050",762,192,74,118,535,58,265,85,123,57,108,60,39,9,102,70,32,2,2,35,15,20
"2021","Bassetlaw 008A","E01028008",503,126,60,66,359,43,138,54,60,24,79,26,47,6,96,72,24,3,3,18,11,7
"2021","Bassetlaw 008B","E01028009",626,189,135,54,413,154,186,94,60,32,42,23,17,2,30,13,17,1,1,24,8,16
"2021","Bassetlaw 008C","E01028010",682,159,88,71,493,107,244,100,103,41,84,39,45,0,58,38,20,0,0,30,17,13
"2021","Bassetlaw 008D","E01028011",847,447,157,290,370,53,116,54,45,17,85,47,35,3,111,74,37,5,5,30,10,20
"2021","Bassetlaw 008E","E01028012",644,246,109,137,372,54,173,70,64,39,85,50,33,2,57,39,18,3,3,26,10,16
"2021","Bassetlaw 008F","E01028022",747,235,59,176,488,53,199,70,98,31,111,54,54,3,123,87,36,2,2,24,10,14
"2021","Bassetlaw 009A","E01028055",846,392,109,283,423,33,132,60,42,30,118,70,41,7,122,89,33,18,18,31,12,19
"2021","Bassetlaw 009B","E01028056",612,167,67,100,413,66,184,86,65,33,92,44,42,6,68,51,17,3,3,32,17,15
"2021","Bassetlaw 009C","E01028058",901,177,74,103,706,94,380,165,162,53,151,77,67,7,79,49,30,2,2,18,5,13
"2021","Bassetlaw 009D","E01028059",655,98,39,59,528,52,345,123,170,52,82,31,48,3,48,30,18,1,1,29,15,14
"2021","Bassetlaw 010A","E01028017",1074,329,151,178,713,76,318,123,155,40,157,79,74,4,156,125,31,6,6,32,17,15
"2021","Bassetlaw 010B","E01028018",642,189,90,99,436,93,211,109,61,41,67,31,30,6,63,37,26,2,2,17,7,10
"2021","Bassetlaw 010C","E01028019",626,217,83,134,387,44,163,62,65,36,75,30,39,6,102,70,32,3,3,22,13,9
"2021","Bassetlaw 010D","E01028020",911,441,114,327,428,33,169,73,64,32,113,62,49,2,112,72,40,1,1,42,14,28
"2021","Bassetlaw 010E","E01028021",774,244,142,102,510,82,254,99,125,30,105,56,41,8,68,40,28,1,1,20,13,7
"2021","Bassetlaw 012A","E01028057",632,255,46,209,332,20,114,43,49,22,94,45,45,4,89,68,21,15,15,45,16,29
"2021","Bassetlaw 012B","E01028065",736,234,99,135,458,30,162,50,75,37,107,32,64,11,144,116,28,15,15,44,23,21
"2021","Bassetlaw 012C","E01028066",698,220,85,135,418,20,178,59,88,31,93,44,38,11,122,88,34,5,5,60,26,34
"2021","Bassetlaw 012D","E01028068",879,378,119,259,440,43,166,67,72,27,125,73,45,7,95,62,33,11,11,61,22,39
"2021","Bassetlaw 013A","E01028060",829,193,132,61,611,168,303,110,130,63,83,45,31,7,55,30,25,2,2,25,11,14
"2021","Bassetlaw 013B","E01028061",625,167,85,82,443,64,242,118,86,38,93,56,33,4,43,25,18,1,1,15,10,5
"2021","Bassetlaw 013C","E01028062",1029,420,134,286,553,92,195,95,77,23,148,103,39,6,106,65,41,12,12,56,21,35
"2021","Bassetlaw 013D","E01028067",645,164,64,100,439,33,175,62,66,47,129,56,61,12,95,61,34,7,7,42,20,22
"2021","Bassetlaw 014C","E01028043",623,164,99,65,434,100,205,75,72,58,86,30,43,13,41,27,14,2,2,25,13,12
"2021","Bassetlaw 014D","E01028063",747,177,111,66,552,131,301,137,107,57,84,48,28,8,33,17,16,3,3,18,10,8
"2021","Bassetlaw 014E","E01028064",525,149,69,80,359,53,157,62,53,42,75,37,34,4,71,44,27,3,3,17,13,4
"2021","Bassetlaw 014F","E01033769",854,238,128,110,575,115,274,129,101,44,115,55,48,12,66,39,27,5,5,41,17,24
"2021","Bassetlaw 015A","E01028006",552,153,99,54,375,89,194,87,74,33,61,32,22,7,30,9,21,1,1,24,10,14
"2021","Bassetlaw 015B","E01028007",499,105,48,57,381,70,237,96,101,40,43,24,15,4,28,20,8,3,3,13,7,6
"2021","Bassetlaw 015C","E01028033",892,216,122,94,624,138,339,163,116,60,89,60,22,7,54,31,23,4,4,52,17,35
"2021","Bassetlaw 015D","E01028037",770,221,111,110,524,104,258,116,103,39,85,42,37,6,73,47,26,4,4,25,10,15
"2021","Bassetlaw 015E","E01028038",661,197,113,84,429,79,199,81,91,27,77,38,35,4,74,48,26,0,0,35,17,18
"2021","Bassetlaw 015F","E01028039",567,144,86,58,394,110,197,103,52,42,60,41,18,1,26,13,13,1,1,29,12,17
"2021","Bassetlaw 016E","E01028042",596,154,79,75,418,53,225,81,90,54,76,38,32,6,60,35,25,4,4,24,13,11
"2021","Bassetlaw 016F","E01028044",788,318,160,158,440,64,166,63,73,30,107,46,53,8,98,67,31,5,5,30,15,15
"2021","Bassetlaw 016G","E01028045",853,271,163,108,544,94,228,100,85,43,127,62,57,8,89,56,33,6,6,38,14,24
"2021","Bassetlaw 016A","E01028051",731,295,166,129,427,110,188,101,49,38,73,54,19,0,54,34,20,2,2,9,2,7
"2021","Bassetlaw 016B","E01028052",691,149,107,42,521,117,276,115,102,59,73,34,32,7,55,33,22,0,0,21,11,10
"2021","Bassetlaw 016C","E01028053",797,345,105,240,431,79,148,63,57,28,89,46,39,4,110,64,46,5,5,21,11,10
"2021","Bassetlaw 016D","E01028054",571,118,75,43,433,91,254,91,109,54,56,22,24,10,31,16,15,1,1,20,9,11
"2021","Broxtowe 001A","E01028092",520,127,62,65,375,67,172,75,68,29,80,35,35,10,54,26,28,2,2,18,7,11
"2021","Broxtowe 001B","E01028093",463,119,80,39,331,104,149,72,48,29,47,28,17,2,30,13,17,1,1,13,7,6
"2021","Broxtowe 001C","E01028107",639,144,69,75,484,82,235,104,76,55,99,57,34,8,68,39,29,0,0,11,6,5
"2021","Broxtowe 001D","E01028108",662,213,121,92,435,91,211,97,70,44,73,41,27,5,60,31,29,0,0,14,6,8
"2021","Broxtowe 001E","E01028114",677,222,107,115,438,79,187,82,63,42,89,55,30,4,80,58,22,3,3,17,3,14
"2021","Broxtowe 002A","E01028110",681,204,97,107,451,52,157,60,60,37,122,63,56,3,118,87,31,2,2,26,11,15
"2021","Broxtowe 002B","E01028111",681,210,94,116,456,110,189,85,59,45,94,40,47,7,61,42,19,2,2,15,7,8
"2021","Broxtowe 002C","E01028112",799,313,136,177,454,54,174,81,60,33,108,57,46,5,115,80,35,3,3,32,10,22
"2021","Broxtowe 002D","E01028113",619,200,91,109,383,49,157,56,67,34,91,45,41,5,85,57,28,1,1,36,14,22
"2021","Broxtowe 003A","E01028109",787,237,120,117,516,125,214,94,70,50,93,42,41,10,78,45,33,6,6,34,15,19
"2021","Broxtowe 003B","E01028115",727,192,120,72,519,144,235,84,87,64,84,50,31,3,52,34,18,4,4,16,5,11
"2021","Broxtowe 003C","E01028116",787,254,125,129,511,74,228,92,93,43,140,84,48,8,66,38,28,3,3,22,7,15
"2021","Broxtowe 003D","E01028117",631,122,42,80,488,69,268,105,121,42,100,57,38,5,49,31,18,2,2,21,8,13
"2021","Broxtowe 003E","E01028118",775,213,140,73,547,201,251,121,80,50,54,35,16,3,38,20,18,3,3,15,9,6
"2021","Broxtowe 004A","E01028102",586,168,78,90,397,57,183,86,62,35,90,46,38,6,64,43,21,3,3,21,12,9
"2021","Broxtowe 004B","E01028103",546,225,78,147,313,57,139,62,49,28,49,30,15,4,66,44,22,2,2,8,4,4
"2021","Broxtowe 004C","E01028104",703,196,87,109,482,73,231,84,98,49,102,58,33,11,75,50,25,1,1,25,5,20
"2021","Broxtowe 004D","E01028122",740,263,148,115,449,78,206,75,82,49,97,50,42,5,64,37,27,4,4,28,8,20
"2021","Broxtowe 004E","E01028123",763,154,85,69,575,110,322,105,157,60,77,48,26,3,63,33,30,3,3,34,16,18
"2021","Broxtowe 004F","E01028124",682,154,110,44,500,105,277,99,119,59,71,34,31,6,46,29,17,1,1,28,14,14
"2021","Broxtowe 007A","E01028087",713,213,129,84,466,115,248,99,109,40,55,30,21,4,46,25,21,2,2,34,10,24
"2021","Broxtowe 007B","E01028088",630,163,103,60,447,115,243,86,107,50,58,33,21,4,29,14,15,2,2,20,8,12
"2021","Broxtowe 007C","E01028089",538,104,81,23,409,116,216,78,104,34,41,22,18,1,33,14,19,3,3,25,13,12
"2021","Broxtowe 007D","E01028090",628,220,115,105,380,82,183,65,76,42,71,41,24,6,41,20,21,3,3,28,7,21
"2021","Broxtowe 007E","E01028091",619,141,84,57,446,117,239,94,119,26,46,31,11,4,42,20,22,2,2,32,13,19
"2021","Broxtowe 008A","E01028125",848,282,143,139,542,108,241,82,110,49,125,67,52,6,66,39,27,2,2,24,8,16
"2021","Broxtowe 008B","E01028126",573,180,76,104,371,48,164,64,66,34,77,37,36,4,79,41,38,3,3,22,8,14
"2021","Broxtowe 008C","E01028127",741,251,97,154,468,65,141,50,66,25,104,48,51,5,154,116,38,4,4,22,6,16
"2021","Broxtowe 008D","E01028134",647,214,74,140,408,41,151,54,74,23,131,76,50,5,82,60,22,3,3,25,11,14
"2021","Broxtowe 009A","E01028076",609,250,80,170,332,56,165,68,64,33,56,41,14,1,51,31,20,4,4,27,11,16
"2021","Broxtowe 009B","E01028077",593,185,76,109,340,45,157,57,69,31,67,44,18,5,62,39,23,9,9,68,18,50
"2021","Broxtowe 009C","E01028078",638,132,56,76,426,40,211,65,105,41,87,62,18,7,79,49,30,9,9,80,28,52
"2021","Broxtowe 009D","E01028079",535,157,62,95,284,41,130,46,62,22,65,45,20,0,34,18,16,14,14,94,14,80
"2021","Broxtowe 009E","E01028084",745,182,91,91,525,85,281,99,152,30,108,72,33,3,46,19,27,5,5,38,6,32
"2021","Broxtowe 010A","E01028128",741,177,97,80,537,118,274,101,104,69,91,52,33,6,52,30,22,2,2,27,8,19
"2021","Broxtowe 010B","E01028129",664,202,95,107,435,72,208,60,96,52,82,39,35,8,69,39,30,4,4,27,12,15
"2021","Broxtowe 010C","E01028130",901,346,147,199,521,40,214,77,106,31,133,75,52,6,131,85,46,3,3,34,14,20
"2021","Broxtowe 010D","E01028131",653,182,88,94,452,68,207,66,100,41,95,44,39,12,75,42,33,7,7,19,7,12
"2021","Broxtowe 010E","E01028132",436,107,43,64,293,31,130,35,65,30,59,26,30,3,72,55,17,1,1,36,15,21
"2021","Broxtowe 010F","E01028133",699,268,57,211,398,36,160,66,59,35,99,58,36,5,93,64,29,10,10,33,13,20
"2021","Broxtowe 011A","E01028073",809,403,219,184,305,46,138,75,47,16,84,64,15,5,30,14,16,7,7,101,8,93
"2021","Broxtowe 011B","E01028074",833,307,116,191,356,39,181,78,79,24,76,58,16,2,50,28,22,10,10,170,11,159
"2021","Broxtowe 011C","E01028075",709,208,69,139,346,18,163,73,72,18,102,75,23,4,55,37,18,8,8,155,8,147
"2021","Broxtowe 011D","E01028085",941,327,117,210,529,75,262,107,124,31,119,86,31,2,58,34,24,15,15,85,10,75
"2021","Broxtowe 011E","E01028086",753,281,91,190,423,53,200,102,75,23,122,88,31,3,42,24,18,6,6,49,6,43
"2021","Broxtowe 012A","E01028080",825,292,80,212,476,36,204,86,88,30,159,112,43,4,68,46,22,9,9,57,13,44
"2021","Broxtowe 012B","E01028081",555,214,106,108,320,59,137,73,44,20,76,50,22,4,47,25,22,1,1,21,5,16
"2021","Broxtowe 012C","E01028082",511,123,57,66,359,44,180,71,79,30,97,58,31,8,36,21,15,2,2,29,9,20
"2021","Broxtowe 012D","E01028083",641,279,58,221,289,26,115,49,44,22,82,61,18,3,54,38,16,12,12,73,8,65
"2021","Broxtowe 013A","E01028097",618,148,101,47,451,135,232,91,90,51,42,25,13,4,41,12,29,1,1,19,7,12
"2021","Broxtowe 013B","E01028098",678,211,82,129,435,43,221,72,129,20,64,30,27,7,106,77,29,1,1,32,9,23
"2021","Broxtowe 013C","E01028099",621,211,96,115,391,76,186,68,82,36,84,59,16,9,44,26,18,1,1,19,8,11
"2021","Broxtowe 013D","E01028100",792,272,169,103,485,95,233,85,106,42,91,58,26,7,62,32,30,4,4,35,15,20
"2021","Broxtowe 013E","E01028101",648,177,49,128,425,37,137,48,64,25,87,41,41,5,160,129,31,4,4,46,18,28
"2021","Broxtowe 014A","E01028069",519,160,73,87,342,62,165,63,75,27,74,42,28,4,38,19,19,3,3,17,5,12
"2021","Broxtowe 014B","E01028070",483,120,87,33,347,99,185,81,68,36,38,20,14,4,23,8,15,2,2,16,6,10
"2021","Broxtowe 014C","E01028094",741,232,121,111,474,81,245,94,111,40,69,48,20,1,76,46,30,3,3,35,13,22
"2021","Broxtowe 014D","E01028095",619,180,88,92,419,78,237,70,131,36,63,39,18,6,40,25,15,1,1,20,4,16
"2021","Broxtowe 014E","E01028096",848,233,120,113,583,119,303,115,144,44,95,52,35,8,63,32,31,3,3,32,9,23
"2021","Broxtowe 015A","E01028135",558,116,87,29,429,94,253,89,121,43,52,25,23,4,30,13,17,0,0,13,10,3
"2021","Broxtowe 015B","E01028136",669,159,99,60,490,90,304,86,154,64,58,23,33,2,36,24,12,2,2,20,10,10
"2021","Broxtowe 015C","E01028137",1007,277,75,202,693,65,417,151,210,56,126,93,24,9,82,51,31,3,3,37,12,25
"2021","Broxtowe 015D","E01028138",577,238,132,106,319,71,147,62,63,22,63,35,24,4,37,17,20,1,1,20,8,12
"2021","Broxtowe 015E","E01028139",586,139,71,68,416,69,233,82,102,49,56,33,21,2,53,37,16,5,5,31,11,20
"2021","Broxtowe 016A","E01028105",515,150,75,75,345,59,162,56,79,27,63,31,29,3,57,38,19,4,4,20,8,12
"2021","Broxtowe 016B","E01028106",659,218,113,105,418,82,182,82,59,41,91,52,32,7,60,30,30,3,3,23,10,13
"2021","Broxtowe 016C","E01028119",789,187,52,135,545,48,315,92,151,72,113,65,40,8,67,45,22,2,2,57,28,29
"2021","Broxtowe 016D","E01028120",653,137,93,44,489,122,263,87,130,46,62,36,23,3,41,17,24,1,1,27,14,13
"2021","Broxtowe 016E","E01028121",587,137,76,61,419,88,242,80,117,45,51,31,18,2,33,22,11,5,5,31,14,17
"2021","Broxtowe 016F","E01033412",1006,249,151,98,712,174,337,139,120,78,129,81,39,9,70,33,37,2,2,45,21,24
"2021","Broxtowe 016G","E01033413",979,306,132,174,636,115,273,115,102,56,151,80,58,13,93,57,36,4,4,37,17,20
"2021","Gedling 001A","E01028189",1096,256,101,155,769,108,384,153,166,65,169,96,60,13,107,66,41,1,1,71,29,42
"2021","Gedling 001B","E01028198",629,157,111,46,450,137,228,94,103,31,52,21,22,9,32,17,15,1,1,22,10,12
"2021","Gedling 001C","E01028199",659,162,122,40,475,177,227,102,86,39,44,16,23,5,26,12,14,1,1,22,8,14
"2021","Gedling 001D","E01028200",769,196,109,87,534,106,305,112,137,56,71,40,30,1,51,33,18,1,1,39,16,23
"2021","Gedling 001E","E01028201",497,111,78,33,376,100,205,75,97,33,39,19,17,3,31,13,18,1,1,10,2,8
"2021","Gedling 002A","E01028150",618,168,110,58,426,123,184,86,57,41,64,34,26,4,54,24,30,1,1,24,11,13
"2021","Gedling 002B","E01028151",464,113,66,47,338,83,175,61,80,34,47,20,22,5,30,20,10,3,3,13,2,11
"2021","Gedling 002C","E01028152",766,185,104,81,550,104,282,103,124,55,96,39,49,8,66,37,29,2,2,31,16,15
"2021","Gedling 002D","E01028153",589,184,107,77,391,34,159,69,55,35,82,29,43,10,116,69,47,0,0,14,9,5
"2021","Gedling 002E","E01028154",696,183,73,110,487,53,215,76,98,41,118,55,56,7,100,58,42,1,1,26,16,10
"2021","Gedling 002F","E01028213",917,307,138,169,590,210,281,130,114,37,61,35,20,6,35,16,19,3,3,20,13,7
"2021","Gedling 004A","E01028143",622,242,106,136,359,53,176,59,88,29,60,32,26,2,69,42,27,1,1,21,5,16
"2021","Gedling 004B","E01028205",708,143,72,71,544,79,263,92,125,46,87,41,41,5,113,81,32,2,2,21,8,13
"2021","Gedling 004C","E01028206",618,176,92,84,424,86,198,74,72,52,74,42,28,4,64,36,28,2,2,18,7,11
"2021","Gedling 004D","E01028207",675,148,85,63,495,104,251,81,127,43,87,43,35,9,52,25,27,1,1,32,15,17
"2021","Gedling 004E","E01028208",492,154,73,81,323,46,130,49,52,29,83,40,35,8,61,35,26,3,3,15,7,8
"2021","Gedling 005A","E01028173",439,174,77,97,238,17,88,21,46,21,55,15,39,1,76,52,24,2,2,27,21,6
"2021","Gedling 005B","E01028174",597,127,59,68,431,42,174,45,97,32,104,38,56,10,110,76,34,1,1,39,21,18
"2021","Gedling 005C","E01028175",791,248,106,142,508,92,221,83,94,44,112,48,55,9,81,47,34,2,2,35,11,24
"2021","Gedling 005D","E01028209",610,208,91,117,374,37,148,51,63,34,102,51,45,6,85,56,29,2,2,28,14,14
"2021","Gedling 006A","E01028144",650,211,70,141,413,32,170,68,75,27,96,39,49,8,111,72,39,4,4,26,12,14
"2021","Gedling 006B","E01028165",746,325,149,176,388,52,156,62,64,30,92,54,35,3,86,54,32,2,2,33,9,24
"2021","Gedling 006C","E01028166",738,217,84,133,493,57,192,53,88,51,98,34,49,15,144,84,60,2,2,28,15,13
"2021","Gedling 006D","E01028167",885,313,87,226,525,34,196,74,83,39,151,87,51,13,131,96,35,13,13,47,22,25
"2021","Gedling 007A","E01028179",591,145,85,60,425,79,197,73,76,48,85,48,35,2,64,38,26,0,0,21,7,14
"2021","Gedling 007B","E01028180",672,190,110,80,452,121,192,71,79,42,74,45,29,0,64,36,28,1,1,30,11,19
"2021","Gedling 007C","E01028181",696,245,103,142,427,55,204,80,89,35,111,75,32,4,57,36,21,0,0,24,7,17
"2021","Gedling 007D","E01028182",656,204,89,115,428,65,219,75,101,43,80,39,32,9,58,31,27,6,6,24,11,13
"2021","Gedling 007E","E01028183",603,201,127,74,393,117,161,73,63,25,60,28,29,3,55,26,29,0,0,9,5,4
"2021","Gedling 008A","E01028148",1057,258,173,85,765,177,372,140,180,52,151,88,58,5,62,39,23,3,3,34,18,16
"2021","Gedling 008B","E01028149",722,226,123,103,472,117,231,65,132,34,69,40,26,3,52,32,20,3,3,24,15,9
"2021","Gedling 008C","E01028178",1091,319,169,150,720,170,344,138,147,59,125,73,45,7,73,41,32,8,8,52,26,26
"2021","Gedling 009A","E01028176",629,166,89,77,436,104,221,79,96,46,61,32,28,1,49,30,19,1,1,27,16,11
"2021","Gedling 009B","E01028177",759,286,145,141,445,98,197,74,89,34,90,48,39,3,57,36,21,3,3,28,11,17
"2021","Gedling 009C","E01028214",629,200,119,81,409,98,208,70,100,38,61,32,25,4,42,25,17,0,0,20,7,13
"2021","Gedling 009D","E01028215",513,111,73,38,376,45,238,77,125,36,61,27,30,4,30,17,13,2,2,26,12,14
"2021","Gedling 009E","E01028216",514,86,53,33,414,93,238,86,105,47,49,27,20,2,33,15,18,1,1,14,5,9
"2021","Gedling 009F","E01028217",585,208,85,123,346,65,185,59,85,41,68,47,19,2,27,16,11,1,1,31,9,22
"2021","Gedling 009G","E01028218",666,166,100,66,477,136,250,77,120,53,61,35,22,4,27,18,9,3,3,23,10,13
"2021","Gedling 010A","E01028193",739,323,171,152,389,64,201,58,105,38,75,54,17,4,45,29,16,4,4,27,2,25
"2021","Gedling 010B","E01028194",636,197,70,127,406,50,202,75,98,29,108,62,39,7,43,16,27,3,3,33,6,27
"2021","Gedling 010C","E01028195",627,166,52,114,430,57,198,78,92,28,104,77,23,4,66,41,25,5,5,31,10,21
"2021","Gedling 010D","E01028196",574,129,71,58,431,66,233,80,115,38,79,47,27,5,53,28,25,0,0,14,1,13
"2021","Gedling 010E","E01028197",611,181,110,71,403,84,197,81,84,32,74,44,27,3,47,27,20,1,1,27,9,18
"2021","Gedling 010F","E01028204",584,148,71,77,422,80,193,73,84,36,83,45,34,4,61,27,34,5,5,14,6,8
"2021","Gedling 011A","E01028172",906,198,68,130,681,64,319,97,165,57,179,100,72,7,114,91,23,5,5,27,12,15
"2021","Gedling 011B","E01028190",646,154,65,89,464,58,233,92,85,56,98,58,31,9,73,45,28,2,2,28,21,7
"2021","Gedling 011C","E01028202",680,225,122,103,438,85,209,84,79,46,77,46,23,8,66,39,27,1,1,17,7,10
"2021","Gedling 011D","E01028203",609,194,77,117,394,61,149,63,65,21,91,48,37,6,90,54,36,3,3,21,11,10
"2021","Gedling 011E","E01028212",622,146,49,97,445,35,178,52,79,47,96,36,50,10,133,87,46,3,3,31,12,19
"2021","Gedling 012A","E01028168",558,146,86,60,390,87,197,77,75,45,60,30,25,5,44,26,18,2,2,22,7,15
"2021","Gedling 012B","E01028169",599,137,97,40,439,111,224,82,89,53,56,25,26,5,48,21,27,0,0,23,8,15
"2021","Gedling 012C","E01028170",642,188,110,78,420,67,204,70,96,38,83,40,35,8,60,31,29,6,6,34,15,19
"2021","Gedling 012D","E01028171",568,154,63,91,380,48,165,61,68,36,95,51,34,10,61,35,26,11,11,34,16,18
"2021","Gedling 012E","E01028191",727,191,76,115,503,55,197,73,91,33,140,58,77,5,109,71,38,2,2,33,13,20
"2021","Gedling 012F","E01028192",649,195,82,113,430,47,178,55,76,47,98,43,50,5,104,65,39,3,3,24,16,8
"2021","Gedling 013A","E01028160",669,221,87,134,416,43,188,77,78,33,109,72,30,7,72,46,26,4,4,32,12,20
"2021","Gedling 013B","E01028161",678,219,86,133,404,40,164,59,75,30,84,37,44,3,106,70,36,10,10,55,15,40
"2021","Gedling 013C","E01028162",652,161,62,99,457,36,172,63,77,32,122,62,51,9,124,84,40,3,3,34,10,24
"2021","Gedling 013D","E01028163",658,200,85,115,421,74,207,73,96,38,75,43,28,4,58,24,34,7,7,37,13,24
"2021","Gedling 013E","E01028211",592,203,111,92,354,71,175,71,67,37,57,33,18,6,49,34,15,2,2,35,15,20
"2021","Gedling 014A","E01028155",650,235,120,115,393,54,182,75,74,33,76,43,27,6,78,46,32,3,3,22,6,16
"2021","Gedling 014B","E01028156",666,293,107,186,349,51,164,67,62,35,71,44,19,8,57,33,24,6,6,24,14,10
"2021","Gedling 014C","E01028157",492,96,57,39,360,58,190,69,71,50,68,36,27,5,41,18,23,3,3,36,20,16
"2021","Gedling 014D","E01028158",874,421,127,294,430,46,176,73,69,34,113,61,41,11,83,49,34,12,12,23,7,16
"2021","Gedling 014E","E01028159",599,204,108,96,365,44,157,65,67,25,82,43,34,5,81,52,29,1,1,30,6,24
"2021","Gedling 014F","E01028164",565,182,64,118,358,33,164,62,61,41,78,34,35,9,80,47,33,3,3,25,10,15
"2021","Gedling 014G","E01028210",694,292,147,145,376,52,135,57,59,19,106,63,43,0,81,53,28,2,2,26,14,12
"2021","Gedling 015A","E01028184",486,132,50,82,338,51,169,65,66,38,79,42,31,6,35,22,13,4,4,16,7,9
"2021","Gedling 015B","E01028185",899,351,143,208,515,57,167,64,76,27,140,77,63,0,146,103,43,5,5,33,13,20
"2021","Gedling 015C","E01028186",798,362,96,266,397,21,131,53,53,25,129,65,54,10,110,86,24,6,6,39,13,26
"2021","Gedling 015D","E01028187",676,245,46,199,405,10,124,62,44,18,133,71,58,4,133,97,36,5,5,26,9,17
"2021","Gedling 015E","E01028188",638,179,33,146,430,31,173,65,84,24,123,77,44,2,100,63,37,3,3,29,8,21
"2021","Gedling 016A","E01028142",950,251,120,131,660,129,294,117,126,51,127,56,65,6,108,69,39,2,2,39,13,26
"2021","Gedling 016B","E01028146",648,193,72,121,435,52,222,109,74,39,92,49,35,8,66,34,32,3,3,20,11,9
"2021","Gedling 016C","E01028147",475,166,32,134,292,15,106,35,46,25,58,20,35,3,109,70,39,4,4,17,6,11
"2021","Gedling 016D","E01032622",545,110,61,49,411,80,236,105,78,53,58,24,28,6,37,20,17,0,0,24,11,13
"2021","Mansfield 001A","E01028224",638,195,117,78,425,100,187,69,78,40,76,37,31,8,58,30,28,4,4,18,10,8
"2021","Mansfield 001B","E01028257",624,147,57,90,445,37,203,77,84,42,94,40,43,11,108,69,39,3,3,32,23,9
"2021","Mansfield 001C","E01028258",707,226,136,90,442,80,221,101,71,49,74,28,40,6,64,32,32,3,3,39,21,18
"2021","Mansfield 001D","E01028259",678,150,63,87,487,34,209,84,81,44,137,55,69,13,104,70,34,3,3,41,20,21
"2021","Mansfield 002A","E01028223",602,198,84,114,367,35,192,64,94,34,83,41,36,6,54,34,20,3,3,37,16,21
"2021","Mansfield 002B","E01028225",658,168,104,64,462,75,230,111,81,38,82,34,44,4,73,40,33,2,2,28,11,17
"2021","Mansfield 002C","E01028226",610,168,55,113,404,34,153,64,58,31,99,36,56,7,116,87,29,2,2,38,21,17
"2021","Mansfield 002D","E01028260",792,211,109,102,549,111,268,153,77,38,94,51,42,1,69,38,31,7,7,32,16,16
"2021","Mansfield 003A","E01028251",650,152,88,64,473,92,273,117,99,57,71,33,32,6,37,18,19,0,0,25,10,15
"2021","Mansfield 003B","E01028252",816,221,107,114,564,83,254,100,95,59,110,48,57,5,116,71,45,1,1,31,18,13
"2021","Mansfield 003C","E01028253",702,175,123,52,514,129,256,98,109,49,89,36,47,6,40,26,14,0,0,13,6,7
"2021","Mansfield 003D","E01028277",623,168,107,61,437,121,214,105,75,34,64,31,29,4,38,23,15,0,0,18,7,11
"2021","Mansfield 003E","E01028278",633,195,108,87,419,78,175,81,44,50,90,36,47,7,74,44,30,2,2,19,11,8
"2021","Mansfield 004A","E01028271",822,320,108,212,458,35,186,76,73,37,123,63,54,6,110,75,35,4,4,44,18,26
"2021","Mansfield 004B","E01028279",699,247,127,120,427,63,177,68,61,48,103,48,49,6,83,39,44,1,1,25,10,15
"2021","Mansfield 004C","E01028280",546,159,83,76,352,40,152,57,49,46,79,16,55,8,78,42,36,3,3,35,16,19
"2021","Mansfield 004D","E01028281",587,185,69,116,367,20,157,50,78,29,90,27,54,9,100,67,33,0,0,35,23,12
"2021","Mansfield 004E","E01028283",951,240,97,143,665,106,315,109,152,54,135,72,59,4,99,64,35,10,10,46,15,31
"2021","Mansfield 005A","E01028242",736,265,101,164,443,92,200,111,56,33,101,60,34,7,49,25,24,1,1,28,10,18
"2021","Mansfield 005B","E01028250",619,165,86,79,424,84,201,95,59,47,76,37,33,6,59,34,25,4,4,30,17,13
"2021","Mansfield 005C","E01028272",803,283,98,185,472,65,198,86,80,32,102,44,52,6,102,65,37,5,5,48,24,24
"2021","Mansfield 005D","E01028273",629,159,67,92,435,76,212,90,71,51,83,48,29,6,63,39,24,1,1,35,13,22
"2021","Mansfield 006A","E01028229",704,287,159,128,397,86,187,108,49,30,66,35,27,4,56,30,26,2,2,20,9,11
"2021","Mansfield 006B","E01028232",653,181,110,71,440,105,195,95,66,34,79,40,36,3,59,34,25,2,2,32,14,18
"2021","Mansfield 006E","E01028267",839,176,65,111,614,52,255,77,121,57,161,65,82,14,141,90,51,5,5,49,27,22
"2021","Mansfield 006F","E01028282",551,188,80,108,342,48,132,59,49,24,99,51,41,7,60,46,14,3,3,21,10,11
"2021","Mansfield 006G","E01033392",1143,358,156,202,724,97,311,129,120,62,181,95,79,7,120,70,50,15,15,61,23,38
"2021","Mansfield 007A","E01028237",701,172,87,85,510,108,232,104,73,55,100,48,41,11,67,37,30,3,3,19,9,10
"2021","Mansfield 007B","E01028238",587,123,64,59,428,43,202,71,78,53,72,24,46,2,105,62,43,6,6,36,16,20
"2021","Mansfield 007C","E01028239",706,189,91,98,463,70,194,74,79,41,97,46,43,8,96,72,24,6,6,54,25,29
"2021","Mansfield 007D","E01028240",665,183,106,77,458,108,229,107,76,46,73,38,33,2,46,16,30,2,2,24,8,16
"2021","Mansfield 007F","E01028243",856,274,168,106,552,121,275,100,116,59,95,51,38,6,56,31,25,5,5,30,9,21
"2021","Mansfield 007G","E01033775",614,74,20,54,524,27,312,90,179,43,115,49,56,10,70,43,27,0,0,16,9,7
"2021","Mansfield 007H","E01033776",613,126,60,66,467,62,263,88,130,45,79,42,32,5,60,40,20,3,3,20,9,11
"2021","Mansfield 008A","E01028227",627,217,91,126,362,28,118,46,55,17,111,52,56,3,96,61,35,9,9,48,18,30
"2021","Mansfield 008B","E01028228",579,212,129,83,333,63,136,49,57,30,66,30,33,3,62,39,23,6,6,34,16,18
"2021","Mansfield 008C","E01028247",761,273,56,217,410,19,136,48,69,19,106,52,45,9,130,93,37,19,19,78,24,54
"2021","Mansfield 008D","E01028268",1005,365,64,301,544,17,203,88,88,27,180,112,62,6,116,82,34,28,28,96,35,61
"2021","Mansfield 008E","E01028269",789,277,53,224,438,26,167,62,76,29,140,87,45,8,96,68,28,9,9,74,26,48
"2021","Mansfield 008F","E01028284",821,339,142,197,414,42,185,77,77,31,102,59,39,4,79,49,30,6,6,68,21,47
"2021","Mansfield 009A","E01028233",861,280,75,205,504,41,212,82,82,48,121,64,49,8,117,85,32,13,13,77,31,46
"2021","Mansfield 009B","E01028234",792,303,124,179,452,39,177,65,76,36,117,52,60,5,118,86,32,1,1,37,13,24
"2021","Mansfield 009C","E01028274",737,322,74,248,380,29,177,75,70,32,105,81,20,4,55,31,24,14,14,35,10,25
"2021","Mansfield 009D","E01028275",677,201,60,141,434,27,149,57,60,32,107,41,61,5,144,108,36,7,7,42,23,19
"2021","Mansfield 009E","E01028276",763,333,104,229,386,35,130,57,47,26,87,37,39,11,130,93,37,4,4,44,16,28
"2021","Mansfield 010A","E01028230",600,149,70,79,407,31,180,54,80,46,92,33,50,9,101,76,25,3,3,44,19,25
"2021","Mansfield 010B","E01028231",633,207,111,96,390,38,171,52,72,47,73,26,40,7,103,73,30,5,5,36,22,14
"2021","Mansfield 010C","E01028244",731,266,85,181,438,93,215,90,86,39,84,44,34,6,45,24,21,1,1,27,6,21
"2021","Mansfield 010D","E01028245",611,212,95,117,373,42,165,78,59,28,82,35,39,8,79,59,20,5,5,26,15,11
"2021","Mansfield 010E","E01028246",750,198,105,93,520,109,274,123,88,63,86,50,33,3,47,24,23,4,4,32,12,20
"2021","Mansfield 010F","E01028248",662,180,82,98,426,42,205,70,90,45,93,48,37,8,76,43,33,10,10,56,26,30
"2021","Mansfield 010G","E01028249",571,139,75,64,399,62,192,78,70,44,88,28,58,2,53,32,21,4,4,33,16,17
"2021","Mansfield 011A","E01028235",684,178,97,81,471,83,245,115,87,43,89,50,29,10,51,27,24,3,3,35,15,20
"2021","Mansfield 011B","E01028236",743,195,79,116,491,71,254,94,108,52,101,50,40,11,63,40,23,2,2,57,26,31
"2021","Mansfield 011C","E01028262",617,158,88,70,426,101,207,99,68,40,85,42,36,7,33,15,18,0,0,33,17,16
"2021","Mansfield 011D","E01028264",811,207,119,88,578,129,307,137,107,63,95,48,36,11,45,27,18,2,2,26,13,13
"2021","Mansfield 012A","E01028254",576,163,85,78,379,86,153,72,47,34,82,40,30,12,55,33,22,3,3,34,18,16
"2021","Mansfield 012B","E01028256",842,370,65,305,427,27,160,57,74,29,124,62,56,6,112,79,33,4,4,45,18,27
"2021","Mansfield 012C","E01028261",665,200,67,133,426,51,186,67,81,38,73,30,32,11,112,75,37,4,4,39,25,14
"2021","Mansfield 012D","E01028263",749,333,117,216,376,30,119,51,49,19,95,41,46,8,126,83,43,6,6,40,18,22
"2021","Mansfield 013A","E01028219",667,194,115,79,457,120,235,95,104,36,66,40,21,5,35,21,14,1,1,16,9,7
"2021","Mansfield 013B","E01028220",803,239,85,154,523,71,238,92,106,40,124,58,58,8,83,55,28,7,7,41,18,23
"2021","Mansfield 013D","E01028222",1062,243,134,109,778,147,428,164,199,65,169,113,49,7,34,20,14,0,0,41,16,25
"2021","Mansfield 013E","E01028255",607,147,111,36,443,154,228,112,80,36,37,19,17,1,24,11,13,0,0,17,8,9
"2021","Mansfield 013F","E01028270",680,187,99,88,464,74,251,98,110,43,88,56,29,3,51,26,25,0,0,29,13,16
"2021","Mansfield 013G","E01033389",621,177,38,139,416,24,197,65,112,20,126,78,46,2,66,52,14,3,3,28,14,14
"2021","Mansfield 013H","E01033390",661,160,30,130,474,12,280,66,186,28,108,62,39,7,71,57,14,3,3,27,12,15
"2021","Mansfield 013I","E01033391",525,124,80,44,386,88,211,93,89,29,51,22,23,6,35,18,17,1,1,15,6,9
"2021","Newark and Sherwood 001A","E01028301",739,191,51,140,506,34,173,53,76,44,138,53,79,6,158,108,50,3,3,42,24,18
"2021","Newark and Sherwood 001B","E01028302",710,238,119,119,443,92,207,89,65,53,75,39,27,9,65,36,29,4,4,29,13,16
"2021","Newark and Sherwood 001C","E01028338",768,222,112,110,514,59,225,79,82,64,145,60,74,11,85,50,35,0,0,32,12,20
"2021","Newark and Sherwood 001D","E01028339",766,196,69,127,530,41,232,85,94,53,145,64,73,8,111,71,40,1,1,40,20,20
"2021","Newark and Sherwood 001E","E01028340",724,257,122,135,432,61,208,89,61,58,86,36,42,8,74,39,35,3,3,35,15,20
"2021","Newark and Sherwood 001G","E01033770",609,229,56,173,367,45,163,69,70,24,104,63,35,6,49,34,15,6,6,13,7,6
"2021","Newark and Sherwood 001H","E01033771",620,191,114,77,416,151,168,84,42,42,52,29,21,2,41,17,24,4,4,13,8,5
"2021","Newark and Sherwood 002A","E01028313",846,250,140,110,561,87,252,103,97,52,94,47,39,8,121,80,41,7,7,35,14,21
"2021","Newark and Sherwood 002C","E01028321",723,236,140,96,464,139,218,105,78,35,64,31,31,2,43,17,26,0,0,23,9,14
"2021","Newark and Sherwood 002D","E01028322",929,280,186,94,619,137,300,113,122,65,122,68,44,10,58,32,26,2,2,30,8,22
"2021","Newark and Sherwood 002E","E01028323",737,226,84,142,489,53,229,93,86,50,115,52,53,10,86,54,32,6,6,22,13,9
"2021","Newark and Sherwood 002F","E01033772",558,121,18,103,409,14,174,51,105,18,168,91,74,3,53,41,12,0,0,28,14,14
"2021","Newark and Sherwood 002G","E01033773",543,68,9,59,442,12,270,76,178,16,137,82,51,4,23,16,7,0,0,33,18,15
"2021","Newark and Sherwood 002H","E01033774",553,122,45,77,398,29,195,71,84,40,98,36,52,10,75,51,24,1,1,33,17,16
"2021","Newark and Sherwood 003A","E01028303",698,209,142,67,465,128,234,116,76,42,55,29,24,2,47,21,26,1,1,24,7,17
"2021","Newark and Sherwood 003B","E01028312",988,202,127,75,750,178,401,188,146,67,99,63,29,7,68,30,38,4,4,36,16,20
"2021","Newark and Sherwood 003C","E01028337",633,151,98,53,450,115,245,112,96,37,65,31,28,6,24,14,10,1,1,32,21,11
"2021","Newark and Sherwood 003D","E01028349",664,147,89,58,491,111,264,135,87,42,81,54,22,5,34,16,18,1,1,26,14,12
"2021","Newark and Sherwood 003E","E01028350",553,154,104,50,376,66,190,85,74,31,76,40,30,6,44,34,10,0,0,23,9,14
"2021","Newark and Sherwood 004A","E01028315",706,204,133,71,481,156,237,102,100,35,55,34,16,5,32,18,14,1,1,21,9,12
"2021","Newark and Sherwood 004B","E01028316",809,284,183,101,500,140,216,81,89,46,86,51,28,7,57,26,31,1,1,25,7,18
"2021","Newark and Sherwood 004C","E01028317",680,136,87,49,511,125,269,117,99,53,77,42,27,8,40,25,15,0,0,33,12,21
"2021","Newark and Sherwood 004D","E01028353",1186,298,176,122,844,207,423,192,165,66,125,59,58,8,87,50,37,2,2,44,22,22
"2021","Newark and Sherwood 005A","E01028295",844,189,106,83,623,146,315,160,106,49,100,59,33,8,61,34,27,1,1,32,13,19
"2021","Newark and Sherwood 005B","E01028297",852,254,116,138,560,75,226,100,76,50,132,52,65,15,124,84,40,3,3,38,20,18
"2021","Newark and Sherwood 005C","E01028327",833,208,113,95,598,115,316,103,138,75,94,45,43,6,69,42,27,4,4,27,12,15
"2021","Newark and Sherwood 005D","E01028328",798,218,144,74,567,165,269,93,132,44,78,36,36,6,55,30,25,0,0,13,5,8
"2021","Newark and Sherwood 005E","E01028329",646,136,75,61,486,106,297,127,119,51,51,30,16,5,32,16,16,0,0,24,7,17
"2021","Newark and Sherwood 006A","E01028296",755,215,87,128,513,60,229,89,105,35,112,55,50,7,108,75,33,4,4,27,15,12
"2021","Newark and Sherwood 006B","E01028298",655,193,92,101,432,52,221,100,73,48,86,48,32,6,73,45,28,0,0,30,12,18
"2021","Newark and Sherwood 006C","E01028299",542,138,54,84,374,28,167,64,70,33,100,46,43,11,75,53,22,4,4,30,15,15
"2021","Newark and Sherwood 006D","E01028300",662,256,121,135,386,51,149,60,59,30,97,37,46,14,88,61,27,1,1,20,3,17
"2021","Newark and Sherwood 006E","E01028342",635,180,57,123,430,26,193,72,79,42,109,55,50,4,98,74,24,4,4,25,14,11
"2021","Newark and Sherwood 006F","E01028343",1062,303,168,135,716,92,338,140,143,55,163,86,67,10,120,68,52,3,3,43,21,22
"2021","Newark and Sherwood 006G","E01028344",615,158,73,85,446,97,234,113,74,47,71,42,24,5,43,25,18,1,1,11,2,9
"2021","Newark and Sherwood 007A","E01028294",934,380,127,253,492,42,179,74,83,22,149,70,73,6,112,69,43,10,10,62,19,43
"2021","Newark and Sherwood 007B","E01028304",629,224,78,146,364,44,160,64,68,28,64,34,27,3,91,62,29,5,5,41,11,30
"2021","Newark and Sherwood 007C","E01028305",678,207,57,150,412,45,142,56,59,27,124,67,50,7,91,62,29,10,10,59,25,34
"2021","Newark and Sherwood 007D","E01028306",685,184,96,88,457,51,213,69,92,52,107,50,49,8,80,58,22,6,6,44,23,21
"2021","Newark and Sherwood 007E","E01028307",518,133,56,77,356,38,163,70,59,34,103,58,39,6,49,24,25,3,3,29,8,21
"2021","Newark and Sherwood 007F","E01028310",1187,574,145,429,520,48,191,95,75,21,165,114,45,6,102,63,39,14,14,93,22,71
"2021","Newark and Sherwood 007G","E01028311",907,488,174,314,371,50,137,57,62,18,120,83,33,4,61,38,23,3,3,48,10,38
"2021","Newark and Sherwood 008A","E01028345",1044,392,247,145,626,194,300,133,135,32,63,43,16,4,65,40,25,4,4,26,7,19
"2021","Newark and Sherwood 008B","E01028346",953,258,162,96,659,191,312,111,139,62,67,33,29,5,85,47,38,4,4,36,10,26
"2021","Newark and Sherwood 008C","E01028347",636,193,115,78,421,96,230,84,103,43,53,26,26,1,37,24,13,5,5,22,7,15
"2021","Newark and Sherwood 008D","E01028348",587,202,118,84,369,94,195,63,98,34,37,21,16,0,43,28,15,0,0,16,4,12
"2021","Newark and Sherwood 009A","E01028292",1130,264,97,167,823,143,454,176,214,64,148,85,55,8,76,54,22,2,2,43,25,18
"2021","Newark and Sherwood 009B","E01028293",873,262,104,158,576,87,245,95,124,26,139,81,52,6,100,63,37,5,5,35,11,24
"2021","Newark and Sherwood 009C","E01028333",636,180,77,103,425,60,187,89,65,33,106,51,49,6,63,41,22,9,9,31,10,21
"2021","Newark and Sherwood 009D","E01028334",627,166,98,68,414,39,160,55,75,30,89,25,58,6,119,81,38,7,7,47,23,24
"2021","Newark and Sherwood 009E","E01028335",958,438,149,289,467,50,191,89,76,26,129,85,40,4,87,59,28,10,10,53,19,34
"2021","Newark and Sherwood 010A","E01028308",745,244,145,99,470,121,223,109,66,48,68,42,23,3,57,26,31,1,1,31,10,21
"2021","Newark and Sherwood 010B","E01028309",638,176,108,68,439,104,222,118,61,43,76,48,26,2,36,18,18,1,1,23,3,20
"2021","Newark and Sherwood 010C","E01028318",607,162,84,78,400,41,163,73,59,31,90,28,58,4,102,62,40,4,4,45,26,19
"2021","Newark and Sherwood 010D","E01028319",843,274,116,158,526,53,198,75,84,39,132,60,58,14,139,93,46,4,4,43,19,24
"2021","Newark and Sherwood 010E","E01028320",753,280,129,151,431,30,155,52,67,36,101,31,65,5,136,106,30,9,9,42,23,19
"2021","Newark and Sherwood 011A","E01028285",535,157,59,98,355,49,162,72,61,29,64,36,24,4,78,49,29,2,2,23,13,10
"2021","Newark and Sherwood 011B","E01028286",623,219,137,82,392,90,163,63,69,31,64,27,30,7,72,35,37,3,3,12,6,6
"2021","Newark and Sherwood 011C","E01028287",679,208,130,78,448,97,207,68,88,51,79,38,37,4,61,32,29,4,4,23,7,16
"2021","Newark and Sherwood 011D","E01028288",695,221,114,107,458,115,214,95,84,35,77,44,27,6,51,34,17,1,1,16,6,10
"2021","Newark and Sherwood 011E","E01028289",641,223,109,114,404,93,165,73,58,34,100,59,37,4,45,19,26,1,1,14,5,9
"2021","Newark and Sherwood 011F","E01028290",627,176,110,66,420,97,192,70,89,33,57,33,18,6,71,42,29,3,3,31,10,21
"2021","Newark and Sherwood 011G","E01028291",835,188,65,123,602,61,257,91,120,46,176,100,65,11,104,52,52,4,4,45,20,25
"2021","Newark and Sherwood 012B","E01028325",539,104,66,38,412,104,226,110,85,31,49,25,22,2,30,15,15,3,3,23,11,12
"2021","Newark and Sherwood 012C","E01028326",594,179,121,58,392,89,188,81,73,34,63,34,24,5,49,24,25,3,3,23,6,17
"2021","Newark and Sherwood 012D","E01028336",507,134,81,53,363,67,193,93,72,28,65,39,24,2,37,15,22,1,1,10,2,8
"2021","Newark and Sherwood 012E","E01028352",474,97,68,29,357,87,211,86,91,34,32,21,9,2,24,12,12,3,3,20,8,12
"2021","Newark and Sherwood 012G","E01033394",627,165,95,70,439,108,198,97,67,34,97,62,34,1,34,17,17,2,2,23,13,10
"2021","Newark and Sherwood 012H","E01033777",598,162,22,140,411,19,200,59,123,18,105,56,46,3,83,67,16,4,4,25,13,12
"2021","Newark and Sherwood 012I","E01033780",612,129,26,103,458,34,278,86,153,39,83,52,29,2,61,50,11,2,2,25,15,10
"2021","Newark and Sherwood 013A","E01028330",685,173,115,58,493,137,247,102,90,55,72,38,31,3,35,19,16,2,2,19,3,16
"2021","Newark and Sherwood 013B","E01028331",635,189,112,77,429,97,237,92,87,58,56,25,23,8,37,17,20,2,2,17,6,11
"2021","Newark and Sherwood 013C","E01028332",691,170,108,62,495,108,313,137,120,56,45,23,18,4,28,17,11,1,1,26,10,16
"2021","Newark and Sherwood 013D","E01028351",515,108,66,42,387,99,225,83,108,34,36,12,21,3,27,14,13,0,0,20,6,14
"2021","Rushcliffe 001A","E01028371",914,203,124,79,677,147,368,166,148,54,94,55,34,5,65,43,22,3,3,34,13,21
"2021","Rushcliffe 001B","E01028403",970,303,181,122,631,165,321,129,137,55,77,35,31,11,64,33,31,4,4,36,11,25
"2021","Rushcliffe 001C","E01028411",892,172,92,80,682,152,384,172,142,70,93,53,32,8,52,27,25,1,1,38,13,25
"2021","Rushcliffe 002A","E01028357",633,173,126,47,443,147,230,73,118,39,35,17,16,2,29,17,12,2,2,17,6,11
"2021","Rushcliffe 002B","E01028358",634,241,134,107,374,100,145,47,76,22,58,35,18,5,67,38,29,4,4,19,3,16
"2021","Rushcliffe 002C","E01028359",762,162,81,81,586,98,322,80,201,41,84,54,27,3,80,62,18,2,2,14,7,7
"2021","Rushcliffe 002D","E01028360",1181,332,83,249,814,65,412,117,253,42,205,115,88,2,127,96,31,5,5,35,11,24
"2021","Rushcliffe 002E","E01028361",603,192,103,89,406,81,198,85,92,21,73,48,23,2,53,34,19,1,1,5,0,5
"2021","Rushcliffe 002F","E01028362",596,198,117,81,378,54,162,65,61,36,57,23,31,3,96,60,36,9,9,20,7,13
"2021","Rushcliffe 003A","E01028393",493,138,98,40,334,114,166,70,76,20,30,18,11,1,24,10,14,0,0,21,11,10
"2021","Rushcliffe 003B","E01028394",705,276,174,102,401,94,197,75,92,30,69,40,21,8,36,20,16,5,5,28,10,18
"2021","Rushcliffe 003C","E01028395",581,147,81,66,408,78,226,89,101,36,62,43,15,4,41,23,18,1,1,26,8,18
"2021","Rushcliffe 003D","E01028413",776,284,172,112,469,75,202,66,95,41,84,40,37,7,100,78,22,8,8,23,8,15
"2021","Rushcliffe 003E","E01028414",720,243,151,92,450,139,202,70,97,35,60,37,19,4,46,26,20,3,3,27,11,16
"2021","Rushcliffe 003F","E01028415",824,168,80,88,626,115,358,115,195,48,98,53,43,2,55,38,17,0,0,30,11,19
"2021","Rushcliffe 004A","E01028354",587,125,51,74,430,60,270,67,167,36,69,45,21,3,29,16,13,2,2,32,8,24
"2021","Rushcliffe 004B","E01028355",658,197,114,83,428,49,250,77,149,24,80,51,27,2,41,20,21,8,8,33,9,24
"2021","Rushcliffe 004C","E01028384",703,174,48,126,458,51,269,57,183,29,97,60,37,0,39,20,19,2,2,71,4,67
"2021","Rushcliffe 004D","E01028385",669,136,62,74,496,53,304,85,178,41,90,51,36,3,46,27,19,3,3,37,12,25
"2021","Rushcliffe 004E","E01028386",645,148,44,104,440,45,257,59,158,40,95,52,38,5,41,30,11,2,2,57,8,49
"2021","Rushcliffe 005A","E01028396",655,190,65,125,433,55,222,74,125,23,99,70,24,5,52,35,17,5,5,32,5,27
"2021","Rushcliffe 005B","E01028398",657,250,112,138,358,26,174,56,104,14,93,68,24,1,62,41,21,3,3,49,11,38
"2021","Rushcliffe 005C","E01028399",484,108,45,63,327,29,218,43,152,23,44,29,14,1,34,22,12,2,2,49,12,37
"2021","Rushcliffe 005D","E01028416",782,367,129,238,298,18,132,42,72,18,94,77,15,2,46,28,18,8,8,117,5,112
"2021","Rushcliffe 005E","E01028417",648,250,27,223,288,20,151,38,98,15,81,71,9,1,29,21,8,7,7,110,12,98
"2021","Rushcliffe 005F","E01028418",700,304,103,201,295,30,137,44,78,15,97,74,21,2,26,16,10,5,5,101,6,95
"2021","Rushcliffe 006A","E01028356",595,166,94,72,408,54,236,69,131,36,58,26,29,3,58,31,27,2,2,21,8,13
"2021","Rushcliffe 006B","E01028375",806,272,72,200,492,36,248,66,159,23,119,87,26,6,82,57,25,7,7,42,9,33
"2021","Rushcliffe 006C","E01028376",681,220,103,117,428,76,245,81,125,39,64,47,13,4,41,26,15,2,2,33,11,22
"2021","Rushcliffe 006D","E01028377",744,173,85,88,540,66,372,103,208,61,62,39,22,1,37,20,17,3,3,31,14,17
"2021","Rushcliffe 006E","E01028397",690,134,65,69,526,93,317,91,175,51,62,36,21,5,50,36,14,4,4,30,13,17
"2021","Rushcliffe 007A","E01028363",507,80,39,41,397,60,257,93,109,55,40,19,16,5,40,23,17,0,0,30,18,12
"2021","Rushcliffe 007B","E01028364",677,168,73,95,477,69,300,90,158,52,57,44,11,2,50,24,26,1,1,32,11,21
"2021","Rushcliffe 007C","E01028365",884,285,131,154,537,68,324,107,172,45,102,73,27,2,41,24,17,2,2,62,20,42
"2021","Rushcliffe 007D","E01028391",838,213,148,65,590,140,333,93,175,65,64,37,23,4,52,25,27,1,1,35,15,20
"2021","Rushcliffe 007E","E01028392",1004,393,195,198,563,87,280,81,167,32,88,57,27,4,97,63,34,11,11,48,18,30
"2021","Rushcliffe 008A","E01028372",564,200,101,99,341,56,175,52,88,35,42,18,22,2,65,46,19,3,3,23,15,8
"2021","Rushcliffe 008C","E01028374",578,206,133,73,342,70,185,55,103,27,38,24,9,5,48,31,17,1,1,30,12,18
"2021","Rushcliffe 008D","E01028400",579,113,58,55,434,89,276,66,165,45,39,21,18,0,28,16,12,2,2,32,13,19
"2021","Rushcliffe 008E","E01028401",484,106,47,59,359,61,226,63,129,34,42,21,19,2,30,16,14,0,0,19,9,10
"2021","Rushcliffe 008F","E01035509",547,116,78,38,408,120,231,74,114,43,34,16,17,1,22,14,8,1,1,23,14,9
"2021","Rushcliffe 008G","E01035510",699,159,19,140,520,16,262,61,185,16,154,102,49,3,87,72,15,1,1,20,6,14
"2021","Rushcliffe 009A","E01028366",523,140,66,74,352,27,155,56,66,33,82,32,46,4,87,60,27,1,1,31,11,20
"2021","Rushcliffe 009B","E01028367",1002,213,77,136,748,95,359,134,177,48,193,96,90,7,97,62,35,4,4,41,16,25
"2021","Rushcliffe 009C","E01028368",650,156,78,78,481,82,248,113,103,32,94,54,34,6,56,34,22,1,1,13,2,11
"2021","Rushcliffe 009D","E01028369",603,150,46,104,423,48,177,69,77,31,91,51,31,9,101,65,36,6,6,30,17,13
"2021","Rushcliffe 009E","E01028370",640,185,91,94,445,87,197,99,67,31,94,59,30,5,67,46,21,0,0,10,5,5
"2021","Rushcliffe 010A","E01028402",794,151,83,68,611,151,342,149,133,60,79,46,28,5,38,18,20,1,1,32,10,22
"2021","Rushcliffe 010B","E01028419",1106,317,168,149,751,188,342,131,155,56,125,74,47,4,94,62,32,2,2,38,20,18
"2021","Rushcliffe 010C","E01028420",587,150,73,77,427,101,237,96,101,40,60,40,11,9,27,15,12,2,2,10,3,7
"2021","Rushcliffe 011A","E01028404",694,194,104,90,475,103,238,80,117,41,91,65,21,5,42,22,20,1,1,25,6,19
"2021","Rushcliffe 011B","E01028405",1000,355,151,204,613,71,305,91,174,40,123,73,50,0,110,74,36,4,4,32,15,17
"2021","Rushcliffe 011C","E01028406",721,202,88,114,481,73,240,86,122,32,85,42,40,3,79,51,28,4,4,38,12,26
"2021","Rushcliffe 011D","E01028407",903,245,99,146,621,90,340,109,178,53,125,73,48,4,62,42,20,4,4,37,15,22
"2021","Rushcliffe 012A","E01028379",773,203,157,46,552,204,264,92,121,51,55,27,25,3,25,10,15,4,4,18,4,14
"2021","Rushcliffe 012B","E01028412",830,184,132,52,617,172,337,120,157,60,70,29,37,4,36,21,15,2,2,29,13,16
"2021","Rushcliffe 012C","E01028421",927,195,113,82,700,185,410,174,170,66,67,40,23,4,37,21,16,1,1,32,14,18
"2021","Rushcliffe 013A","E01028380",559,191,71,120,337,37,134,45,64,25,72,29,40,3,90,65,25,4,4,31,9,22
"2021","Rushcliffe 013B","E01028381",595,176,123,53,404,112,216,87,88,41,40,23,14,3,35,23,12,1,1,15,5,10
"2021","Rushcliffe 013C","E01028382",643,193,125,68,432,109,217,67,107,43,57,36,18,3,47,21,26,2,2,18,4,14
"2021","Rushcliffe 013D","E01028383",521,176,123,53,332,115,143,57,58,28,38,26,9,3,35,16,19,1,1,13,6,7
"2021","Rushcliffe 014A","E01028378",914,249,136,113,634,153,298,123,108,67,116,74,33,9,60,31,29,7,7,31,8,23
"2021","Rushcliffe 014B","E01028387",986,215,110,105,731,62,375,101,219,55,140,83,49,8,149,102,47,5,5,40,14,26
"2021","Rushcliffe 014C","E01028408",862,216,122,94,591,126,321,133,141,47,92,56,30,6,47,23,24,5,5,55,11,44
"2021","Rushcliffe 015A","E01028388",678,135,65,70,522,90,324,113,160,51,66,39,23,4,40,25,15,2,2,21,6,15
"2021","Rushcliffe 015B","E01028389",858,268,171,97,569,150,295,107,138,50,72,37,30,5,50,31,19,2,2,21,7,14
"2021","Rushcliffe 015C","E01028390",1074,229,121,108,816,147,377,127,194,56,194,116,72,6,94,69,25,4,4,29,15,14
"2021","Rushcliffe 015D","E01028409",525,120,75,45,383,90,204,82,82,40,58,32,24,2,31,18,13,0,0,22,10,12
"2021","Rushcliffe 015E","E01028410",551,121,69,52,405,101,204,68,93,43,69,43,23,3,31,17,14,0,0,25,5,20
"2021","Herefordshire 001A","E01013998",650,163,106,57,459,142,232,121,69,42,49,35,14,0,35,16,19,1,1,28,12,16
"2021","Herefordshire 001B","E01014051",790,229,129,100,533,128,256,106,98,52,100,50,47,3,47,28,19,2,2,28,13,15
"2021","Herefordshire 001C","E01014052",664,179,94,85,450,107,229,112,75,42,68,44,19,5,45,23,22,1,1,35,9,26
"2021","Herefordshire 001D","E01014096",671,162,95,67,478,122,245,124,74,47,73,47,15,11,37,19,18,1,1,31,9,22
"2021","Herefordshire 002A","E01014041",707,276,153,123,404,92,162,65,62,35,91,40,47,4,57,28,29,2,2,27,10,17
"2021","Herefordshire 002B","E01014042",674,229,96,133,418,41,149,46,72,31,110,45,57,8,115,84,31,3,3,27,13,14
"2021","Herefordshire 002C","E01014043",510,173,112,61,326,121,143,68,47,28,32,16,12,4,29,13,16,1,1,11,3,8
"2021","Herefordshire 002D","E01014044",625,142,71,71,458,61,225,95,86,44,92,35,53,4,78,57,21,2,2,25,10,15
"2021","Herefordshire 003A","E01014045",750,255,113,142,473,93,215,86,90,39,94,47,39,8,66,40,26,5,5,22,5,17
"2021","Herefordshire 003B","E01014046",654,176,114,62,450,111,206,89,82,35,75,31,36,8,56,27,29,2,2,28,14,14
"2021","Herefordshire 003C","E01014047",652,232,120,112,393,65,151,47,69,35,81,35,42,4,93,61,32,3,3,27,14,13
"2021","Herefordshire 003D","E01014048",876,476,156,320,361,41,134,61,50,23,98,68,25,5,84,57,27,4,4,39,15,24
"2021","Herefordshire 004A","E01013999",697,190,109,81,486,132,245,109,92,44,68,36,29,3,41,24,17,0,0,21,13,8
"2021","Herefordshire 004B","E01014017",639,141,97,44,464,122,210,104,71,35,77,46,29,2,54,29,25,1,1,34,15,19
"2021","Herefordshire 004C","E01014024",569,137,82,55,404,99,210,104,64,42,64,39,19,6,30,19,11,1,1,28,10,18
"2021","Herefordshire 004D","E01014025",653,166,115,51,448,117,228,109,80,39,57,38,17,2,43,25,18,3,3,39,20,19
"2021","Herefordshire 004E","E01014055",757,223,130,93,498,129,237,112,85,40,77,42,31,4,55,33,22,0,0,36,15,21
"2021","Herefordshire 004F","E01014097",599,160,108,52,411,114,202,103,51,48,58,41,12,5,33,10,23,4,4,28,10,18
"2021","Herefordshire 005A","E01014000",584,120,66,54,426,125,206,117,57,32,64,46,16,2,29,10,19,2,2,38,13,25
"2021","Herefordshire 005B","E01014001",745,187,92,95,522,132,272,143,83,46,61,45,11,5,53,23,30,4,4,36,15,21
"2021","Herefordshire 005C","E01014002",645,221,156,65,403,131,185,78,77,30,43,28,12,3,41,24,17,3,3,21,6,15
"2021","Herefordshire 005D","E01014003",648,165,86,79,456,87,208,75,88,45,91,34,50,7,67,46,21,3,3,27,11,16
"2021","Herefordshire 005E","E01014004",631,148,87,61,455,124,224,111,76,37,64,43,15,6,41,19,22,2,2,28,12,16
"2021","Herefordshire 005F","E01014005",903,417,183,234,456,67,159,82,51,26,108,62,40,6,112,78,34,10,10,30,12,18
"2021","Herefordshire 005G","E01014015",699,152,82,70,526,117,281,129,93,59,80,50,26,4,45,22,23,3,3,21,12,9
"2021","Herefordshire 006A","E01014008",717,197,106,91,490,121,259,129,85,45,70,39,30,1,40,24,16,0,0,30,16,14
"2021","Herefordshire 006B","E01014009",684,169,109,60,477,138,239,123,74,42,56,27,22,7,40,17,23,4,4,38,14,24
"2021","Herefordshire 006C","E01014033",834,292,159,133,516,140,230,108,80,42,80,47,24,9,63,32,31,3,3,26,11,15
"2021","Herefordshire 006D","E01014034",692,270,110,160,395,60,149,62,52,35,103,51,51,1,79,41,38,4,4,27,11,16
"2021","Herefordshire 006E","E01014056",629,168,97,71,435,102,246,122,81,43,61,31,26,4,24,14,10,2,2,26,8,18
"2021","Herefordshire 007A","E01014006",670,160,92,68,488,119,278,120,106,52,52,30,17,5,39,24,15,0,0,22,9,13
"2021","Herefordshire 007B","E01014012",721,208,126,82,489,111,268,105,104,59,65,32,30,3,43,21,22,2,2,24,4,20
"2021","Herefordshire 007C","E01014013",684,154,76,78,494,53,288,77,171,40,72,34,32,6,80,53,27,1,1,36,15,21
"2021","Herefordshire 007D","E01014016",719,241,170,71,445,121,209,98,77,34,64,26,33,5,50,30,20,1,1,33,13,20
"2021","Herefordshire 007E","E01014100",762,177,102,75,550,122,307,129,120,58,58,35,15,8,60,36,24,3,3,35,14,21
"2021","Herefordshire 007F","E01014101",443,112,69,43,309,87,166,78,65,23,28,19,6,3,25,11,14,3,3,22,8,14
"2021","Herefordshire 008A","E01014022",955,216,114,102,706,130,382,138,169,75,111,65,40,6,81,54,27,2,2,33,12,21
"2021","Herefordshire 008B","E01014023",818,182,77,105,594,90,311,123,129,59,105,66,37,2,84,51,33,4,4,42,22,20
"2021","Herefordshire 008C","E01014081",636,170,99,71,430,114,228,88,101,39,55,33,19,3,33,12,21,0,0,36,22,14
"2021","Herefordshire 008D","E01014082",772,227,141,86,507,109,239,95,97,47,85,41,40,4,72,32,40,2,2,38,17,21
"2021","Herefordshire 009A","E01014027",565,130,69,61,397,108,201,101,72,28,48,29,15,4,38,21,17,2,2,38,17,21
"2021","Herefordshire 009B","E01014028",653,162,97,65,463,145,228,113,67,48,56,41,14,1,32,13,19,2,2,28,7,21
"2021","Herefordshire 009C","E01014029",683,211,136,75,454,135,211,101,82,28,55,25,23,7,51,22,29,2,2,18,4,14
"2021","Herefordshire 009D","E01014030",630,152,82,70,453,136,220,116,71,33,60,35,20,5,33,20,13,4,4,25,10,15
"2021","Herefordshire 010A","E01014083",702,200,127,73,468,132,211,79,93,39,64,26,35,3,56,30,26,5,5,34,18,16
"2021","Herefordshire 010B","E01014084",752,312,154,158,394,47,187,68,87,32,97,55,33,9,57,26,31,6,6,46,12,34
"2021","Herefordshire 010C","E01014085",654,178,86,92,433,51,194,66,94,34,83,40,37,6,94,63,31,11,11,43,22,21
"2021","Herefordshire 010D","E01014087",719,304,107,197,390,48,193,95,63,35,95,61,30,4,49,28,21,5,5,25,9,16
"2021","Herefordshire 010E","E01014088",722,328,110,218,382,59,146,71,54,21,85,55,27,3,86,63,23,6,6,12,6,6
"2021","Herefordshire 010F","E01014089",577,132,64,68,414,70,207,76,94,37,53,28,23,2,79,42,37,5,5,31,12,19
"2021","Herefordshire 011A","E01013987",684,201,99,102,439,103,234,107,83,44,59,36,21,2,43,21,22,0,0,44,14,30
"2021","Herefordshire 011B","E01013988",934,427,230,197,472,118,229,108,77,44,70,46,18,6,53,29,24,2,2,35,10,25
"2021","Herefordshire 011D","E01014095",569,136,84,52,403,60,175,62,77,36,68,29,37,2,94,61,33,6,6,30,7,23
"2021","Herefordshire 011E","E01035055",637,145,64,81,454,70,257,88,112,57,87,54,30,3,40,20,20,0,0,38,17,21
"2021","Herefordshire 011F","E01035056",594,137,27,110,427,44,208,63,110,35,90,47,37,6,82,58,24,3,3,30,10,20
"2021","Herefordshire 012A","E01013986",738,267,106,161,422,49,199,72,88,39,92,49,37,6,77,50,27,5,5,49,18,31
"2021","Herefordshire 012B","E01013989",614,195,75,120,383,28,195,69,96,30,80,30,45,5,76,45,31,4,4,36,12,24
"2021","Herefordshire 012C","E01014010",1061,583,158,425,396,45,135,59,51,25,116,98,18,0,86,63,23,14,14,82,16,66
"2021","Herefordshire 012D","E01014011",665,257,99,158,361,27,163,54,84,25,83,38,36,9,81,53,28,7,7,47,11,36
"2021","Herefordshire 012E","E01014086",752,335,129,206,375,22,157,64,66,27,88,47,34,7,102,68,34,6,6,42,9,33
"2021","Herefordshire 012F","E01014092",895,378,145,233,463,68,208,81,87,40,111,82,24,5,69,42,27,7,7,54,8,46
"2021","Herefordshire 013A","E01014075",741,219,101,118,466,93,218,73,89,56,88,47,35,6,60,28,32,7,7,56,18,38
"2021","Herefordshire 013B","E01014076",1038,465,152,313,500,39,206,78,99,29,136,90,40,6,110,65,45,9,9,73,15,58
"2021","Herefordshire 013C","E01014077",732,258,146,112,447,103,198,73,91,34,97,49,42,6,46,19,27,3,3,27,11,16
"2021","Herefordshire 013D","E01014078",595,186,81,105,379,39,191,56,91,44,84,45,31,8,65,30,35,0,0,30,11,19
"2021","Herefordshire 014A","E01014090",597,141,91,50,431,96,236,74,116,46,47,25,19,3,48,27,21,4,4,25,8,17
"2021","Herefordshire 014B","E01014091",637,169,114,55,433,121,222,65,107,50,45,14,25,6,42,22,20,3,3,35,6,29
"2021","Herefordshire 014C","E01014093",610,197,108,89,401,93,215,78,94,43,40,18,20,2,52,28,24,1,1,12,4,8
"2021","Herefordshire 014D","E01014094",573,135,92,43,411,72,212,61,112,39,74,37,28,9,50,28,22,3,3,27,14,13
"2021","Herefordshire 015A","E01014068",593,151,84,67,408,63,205,83,74,48,67,24,34,9,66,35,31,7,7,34,18,16
"2021","Herefordshire 015B","E01014070",939,246,108,138,625,82,303,107,137,59,126,57,59,10,108,74,34,6,6,68,29,39
"2021","Herefordshire 015C","E01014072",821,243,118,125,540,71,239,78,112,49,98,43,44,11,125,86,39,7,7,38,21,17
"2021","Herefordshire 015D","E01014073",797,267,92,175,501,28,247,59,162,26,90,35,51,4,125,78,47,11,11,29,13,16
"2021","Herefordshire 015E","E01014074",740,336,133,203,360,41,134,46,61,27,77,46,27,4,104,64,40,4,4,44,21,23
"2021","Herefordshire 016A","E01013996",684,197,66,131,463,52,243,91,104,48,102,57,40,5,60,33,27,6,6,24,13,11
"2021","Herefordshire 016B","E01013997",820,243,90,153,544,62,291,102,134,55,121,73,43,5,68,41,27,2,2,33,17,16
"2021","Herefordshire 016C","E01014079",663,151,89,62,464,115,239,94,99,46,56,29,23,4,54,34,20,0,0,48,17,31
"2021","Herefordshire 016D","E01014080",679,204,127,77,456,109,218,96,90,32,61,34,25,2,61,38,23,7,7,19,9,10
"2021","Herefordshire 017A","E01013992",641,189,56,133,412,42,175,59,89,27,92,50,39,3,96,60,36,7,7,40,23,17
"2021","Herefordshire 017B","E01013993",606,156,83,73,412,50,168,49,74,45,77,18,46,13,112,71,41,5,5,38,18,20
"2021","Herefordshire 017C","E01013994",599,162,64,98,392,31,134,54,58,22,94,28,57,9,132,89,43,1,1,45,16,29
"2021","Herefordshire 017D","E01013995",782,249,60,189,486,34,190,54,117,19,101,32,61,8,157,116,41,4,4,47,20,27
"2021","Herefordshire 017E","E01014071",636,236,85,151,368,32,162,51,73,38,77,32,38,7,96,68,28,1,1,32,11,21
"2021","Herefordshire 018A","E01013990",886,241,128,113,617,153,301,119,127,55,86,55,31,0,74,51,23,3,3,28,10,18
"2021","Herefordshire 018B","E01013991",547,134,73,61,380,79,210,85,86,39,56,34,17,5,32,21,11,3,3,33,18,15
"2021","Herefordshire 018C","E01014014",770,177,104,73,539,118,298,133,107,58,61,35,18,8,59,24,35,3,3,54,21,33
"2021","Herefordshire 018D","E01014054",592,164,95,69,387,89,221,108,65,48,41,26,13,2,34,14,20,2,2,41,13,28
"2021","Herefordshire 019A","E01014035",839,355,184,171,454,69,206,84,82,40,85,53,26,6,90,53,37,4,4,30,10,20
"2021","Herefordshire 019B","E01014036",792,288,187,101,469,136,232,121,81,30,61,40,18,3,38,21,17,2,2,35,14,21
"2021","Herefordshire 019C","E01014037",733,271,205,66,448,167,170,79,52,39,52,30,18,4,57,27,30,2,2,14,6,8
"2021","Herefordshire 019D","E01014038",634,199,103,96,408,86,181,68,79,34,71,32,31,8,66,35,31,4,4,27,10,17
"2021","Herefordshire 019E","E01014039",729,211,107,104,507,101,251,81,130,40,81,49,29,3,73,45,28,1,1,11,4,7
"2021","Herefordshire 019F","E01014040",754,277,171,106,458,124,192,85,68,39,64,38,21,5,72,41,31,6,6,19,9,10
"2021","Herefordshire 020A","E01014018",659,170,102,68,457,124,232,115,84,33,68,32,36,0,32,20,12,1,1,32,14,18
"2021","Herefordshire 020B","E01014019",669,206,128,78,425,104,209,90,79,40,57,21,30,6,54,28,26,1,1,38,17,21
"2021","Herefordshire 020C","E01014020",652,170,109,61,448,95,259,91,103,65,51,25,22,4,40,23,17,3,3,34,13,21
"2021","Herefordshire 020D","E01014021",630,199,141,58,402,93,201,84,80,37,59,34,21,4,49,26,23,0,0,29,12,17
"2021","Herefordshire 021A","E01014026",884,222,119,103,610,146,328,156,122,50,83,51,27,5,49,22,27,4,4,52,15,37
"2021","Herefordshire 021B","E01014059",809,182,101,81,565,137,298,151,90,57,79,46,23,10,51,24,27,0,0,62,28,34
"2021","Herefordshire 021C","E01014060",674,173,99,74,471,117,240,97,98,45,64,42,21,1,47,29,18,3,3,30,14,16
"2021","Herefordshire 021D","E01014069",809,255,63,192,516,39,219,78,104,37,139,82,53,4,117,92,25,2,2,38,11,27
"2021","Herefordshire 021E","E01014098",670,152,71,81,493,83,243,89,100,54,87,40,45,2,77,54,23,3,3,25,13,12
"2021","Herefordshire 021F","E01014099",741,170,92,78,521,132,270,109,101,60,63,36,22,5,52,31,21,4,4,50,25,25
"2021","Herefordshire 022A","E01014061",822,242,170,72,552,160,250,103,97,50,75,29,44,2,67,38,29,0,0,28,10,18
"2021","Herefordshire 022B","E01014062",975,492,224,268,438,83,175,92,62,21,110,63,41,6,60,40,20,10,10,45,11,34
"2021","Herefordshire 022C","E01014063",781,246,160,86,510,129,207,88,86,33,94,43,44,7,77,42,35,3,3,25,7,18
"2021","Herefordshire 022D","E01014064",770,315,115,200,422,64,153,59,69,25,96,52,41,3,104,72,32,5,5,33,11,22
"2021","Herefordshire 022E","E01014065",652,185,86,99,441,76,209,79,85,45,79,43,30,6,75,46,29,2,2,26,13,13
"2021","Herefordshire 022F","E01014066",608,283,125,158,308,66,129,62,43,24,62,42,18,2,48,33,15,3,3,17,9,8
"2021","Herefordshire 022G","E01014067",594,165,127,38,401,100,222,86,88,48,48,22,23,3,31,19,12,0,0,28,14,14
"2021","Herefordshire 023A","E01014031",654,158,91,67,461,106,235,107,91,37,78,43,29,6,42,18,24,0,0,35,19,16
"2021","Herefordshire 023B","E01014032",667,174,114,60,462,114,243,121,80,42,67,42,20,5,35,17,18,3,3,31,10,21
"2021","Herefordshire 023C","E01014049",693,176,108,68,484,153,237,119,83,35,62,42,16,4,31,15,16,1,1,33,16,17
"2021","Herefordshire 023D","E01014050",739,156,91,65,534,117,308,138,112,58,72,42,24,6,36,16,20,1,1,49,24,25
"2021","Herefordshire 023E","E01014053",755,176,96,80,530,131,295,135,104,56,66,43,19,4,38,23,15,0,0,49,16,33
"2021","Herefordshire 023F","E01014057",852,237,132,105,575,141,266,131,90,45,95,56,34,5,70,48,22,3,3,40,11,29
"2021","Herefordshire 023G","E01014058",740,188,114,74,520,155,283,144,80,59,52,38,12,2,28,14,14,2,2,32,12,20
"2021","Telford and Wrekin 001A","E01014171",601,183,114,69,353,76,142,50,70,22,62,30,26,6,68,37,31,5,5,65,13,52
"2021","Telford and Wrekin 001B","E01014172",542,98,58,40,406,74,234,99,97,38,46,24,18,4,48,22,26,4,4,38,10,28
"2021","Telford and Wrekin 001C","E01014173",804,293,146,147,459,85,194,78,84,32,78,36,40,2,100,68,32,2,2,52,14,38
"2021","Telford and Wrekin 001D","E01014174",619,128,82,46,471,101,283,95,141,47,51,27,17,7,36,20,16,0,0,20,8,12
"2021","Telford and Wrekin 002A","E01014112",730,165,98,67,534,113,274,112,121,41,92,49,37,6,55,30,25,0,0,31,11,20
"2021","Telford and Wrekin 002B","E01014131",757,169,98,71,528,118,317,122,138,57,56,26,25,5,33,17,16,4,4,60,18,42
"2021","Telford and Wrekin 002C","E01014132",458,98,68,30,341,98,182,79,66,37,34,22,11,1,27,13,14,0,0,19,6,13
"2021","Telford and Wrekin 002D","E01014135",510,106,48,58,370,80,208,94,71,43,55,34,18,3,26,11,15,1,1,34,18,16
"2021","Telford and Wrekin 003A","E01014175",704,218,92,126,455,64,203,74,97,32,120,57,59,4,67,47,20,1,1,31,9,22
"2021","Telford and Wrekin 003B","E01014176",696,239,143,96,413,111,174,69,78,27,64,35,24,5,62,41,21,2,2,44,12,32
"2021","Telford and Wrekin 003C","E01014177",857,211,109,102,611,110,307,111,153,43,103,48,52,3,88,62,26,3,3,35,12,23
"2021","Telford and Wrekin 003D","E01014178",850,376,158,218,411,75,151,54,69,28,94,60,30,4,90,54,36,1,1,63,17,46
"2021","Telford and Wrekin 004A","E01014111",677,173,107,66,476,120,241,110,92,39,74,32,33,9,39,23,16,2,2,28,11,17
"2021","Telford and Wrekin 004B","E01014167",830,163,50,113,629,53,392,133,192,67,90,45,40,5,91,58,33,3,3,38,17,21
"2021","Telford and Wrekin 004C","E01014168",518,69,33,36,416,58,242,91,92,59,62,32,25,5,51,31,20,3,3,33,14,19
"2021","Telford and Wrekin 004D","E01014170",670,193,132,61,451,136,230,117,76,37,47,27,17,3,36,17,19,2,2,26,11,15
"2021","Telford and Wrekin 005A","E01014125",575,178,67,111,345,40,152,44,66,42,70,20,41,9,77,52,25,6,6,52,16,36
"2021","Telford and Wrekin 005B","E01014126",643,207,108,99,396,68,159,55,62,42,77,27,36,14,87,56,31,5,5,40,15,25
"2021","Telford and Wrekin 005C","E01014127",658,150,47,103,457,46,148,43,64,41,132,40,78,14,129,87,42,2,2,51,26,25
"2021","Telford and Wrekin 005D","E01014128",934,262,102,160,605,62,290,87,158,45,130,55,68,7,117,74,43,6,6,67,25,42
"2021","Telford and Wrekin 005E","E01014169",756,183,56,127,512,18,213,81,103,29,141,82,45,14,134,102,32,6,6,61,26,35
"2021","Telford and Wrekin 006A","E01014129",541,232,113,119,294,61,102,39,43,20,77,37,31,9,52,32,20,2,2,15,8,7
"2021","Telford and Wrekin 006B","E01014130",647,175,83,92,446,87,221,87,86,48,88,54,30,4,49,33,16,1,1,26,10,16
"2021","Telford and Wrekin 006C","E01014179",496,132,88,44,345,82,164,56,73,35,55,22,28,5,41,21,20,3,3,19,8,11
"2021","Telford and Wrekin 006D","E01014180",593,204,115,89,363,67,150,58,57,35,73,32,33,8,70,37,33,3,3,26,6,20
"2021","Telford and Wrekin 006E","E01014189",593,152,56,96,418,56,194,85,75,34,99,58,38,3,68,48,20,1,1,23,12,11
"2021","Telford and Wrekin 006F","E01014190",607,114,43,71,457,67,291,116,111,64,51,34,16,1,47,27,20,1,1,36,17,19
"2021","Telford and Wrekin 007A","E01014102",787,175,86,89,570,91,322,118,139,65,97,54,40,3,56,31,25,4,4,42,17,25
"2021","Telford and Wrekin 007B","E01014103",487,118,74,44,348,68,211,74,98,39,44,27,13,4,23,10,13,2,2,21,8,13
"2021","Telford and Wrekin 007C","E01014138",688,185,85,100,466,55,218,90,85,43,94,42,47,5,96,56,40,3,3,37,14,23
"2021","Telford and Wrekin 007D","E01014140",610,211,60,151,364,43,138,45,66,27,84,43,38,3,95,52,43,4,4,35,14,21
"2021","Telford and Wrekin 008A","E01014205",593,159,100,59,402,95,192,89,61,42,70,40,24,6,43,22,21,2,2,32,20,12
"2021","Telford and Wrekin 008B","E01014206",543,135,61,74,374,62,168,59,73,36,84,34,46,4,55,37,18,5,5,34,7,27
"2021","Telford and Wrekin 008C","E01014207",515,122,55,67,339,61,155,54,59,42,61,29,26,6,59,40,19,3,3,54,22,32
"2021","Telford and Wrekin 008D","E01014208",587,175,83,92,373,62,139,55,51,33,89,41,43,5,83,55,28,0,0,39,12,27
"2021","Telford and Wrekin 008E","E01014209",641,193,103,90,420,59,176,60,78,38,74,30,40,4,105,64,41,6,6,28,13,15
"2021","Telford and Wrekin 009A","E01014137",755,104,33,71,605,53,351,110,168,73,119,58,53,8,79,53,26,3,3,46,23,23
"2021","Telford and Wrekin 009B","E01014139",515,148,76,72,314,26,157,41,91,25,55,26,24,5,69,44,25,7,7,53,36,17
"2021","Telford and Wrekin 009D","E01014142",450,104,50,54,293,18,133,32,73,28,56,18,34,4,74,42,32,12,12,53,21,32
"2021","Telford and Wrekin 009E","E01014143",664,193,86,107,397,45,179,53,87,39,81,42,32,7,79,47,32,13,13,74,33,41
"2021","Telford and Wrekin 009F","E01035073",604,167,43,124,386,6,172,65,88,19,109,46,58,5,90,71,19,9,9,51,24,27
"2021","Telford and Wrekin 009G","E01035074",720,157,45,112,487,20,238,60,149,29,130,63,63,4,94,69,25,5,5,76,35,41
"2021","Telford and Wrekin 009H","E01035075",461,120,9,111,321,6,109,20,78,11,130,78,47,5,71,64,7,5,5,20,6,14
"2021","Telford and Wrekin 010A","E01014136",770,208,130,78,521,120,274,131,88,55,86,47,28,11,41,16,25,0,0,41,16,25
"2021","Telford and Wrekin 010B","E01014148",732,239,82,157,462,88,231,136,69,26,105,73,30,2,36,17,19,2,2,31,9,22
"2021","Telford and Wrekin 010C","E01014149",488,129,55,74,333,56,172,89,63,20,70,50,19,1,33,14,19,2,2,26,11,15
"2021","Telford and Wrekin 010D","E01014202",1084,200,71,129,821,130,423,155,183,85,157,88,60,9,109,70,39,2,2,63,25,38
"2021","Telford and Wrekin 010E","E01014203",657,142,93,49,482,106,259,98,93,68,65,34,27,4,51,24,27,1,1,33,16,17
"2021","Telford and Wrekin 010F","E01014204",819,191,104,87,594,122,337,126,139,72,86,50,32,4,47,28,19,2,2,34,9,25
"2021","Telford and Wrekin 011A","E01014104",653,143,61,82,449,51,227,81,106,40,77,40,30,7,88,49,39,6,6,61,31,30
"2021","Telford and Wrekin 011B","E01014105",813,171,61,110,573,35,272,73,155,44,128,47,73,8,132,89,43,6,6,69,45,24
"2021","Telford and Wrekin 011C","E01014113",739,315,95,220,333,19,171,56,85,30,55,34,15,6,71,45,26,17,17,91,46,45
"2021","Telford and Wrekin 011D","E01014114",670,242,107,135,402,119,186,81,61,44,54,40,11,3,38,16,22,5,5,26,7,19
"2021","Telford and Wrekin 012A","E01014133",958,330,135,195,581,105,253,99,113,41,128,70,52,6,92,64,28,3,3,47,26,21
"2021","Telford and Wrekin 012B","E01014134",744,235,175,60,483,127,241,104,93,44,86,59,24,3,28,9,19,1,1,26,7,19
"2021","Telford and Wrekin 012C","E01014144",792,251,109,142,498,68,208,80,82,46,114,54,53,7,107,56,51,1,1,43,19,24
"2021","Telford and Wrekin 012D","E01014145",1012,467,131,336,485,35,177,62,95,20,138,90,44,4,127,86,41,8,8,60,23,37
"2021","Telford and Wrekin 013A","E01014185",788,313,160,153,437,72,149,62,58,29,85,41,43,1,127,80,47,4,4,38,16,22
"2021","Telford and Wrekin 013B","E01014186",631,199,72,127,404,46,186,85,61,40,97,61,31,5,73,42,31,2,2,28,6,22
"2021","Telford and Wrekin 013C","E01014187",681,232,104,128,422,57,194,82,68,44,100,61,28,11,67,44,23,4,4,27,9,18
"2021","Telford and Wrekin 013D","E01014188",608,184,73,111,406,52,205,85,82,38,92,55,35,2,52,26,26,5,5,18,9,9
"2021","Telford and Wrekin 014A","E01014150",709,191,74,117,483,82,244,112,86,46,103,65,37,1,51,21,30,3,3,35,11,24
"2021","Telford and Wrekin 014B","E01014151",625,198,95,103,394,53,161,67,57,37,89,38,42,9,85,48,37,6,6,33,17,16
"2021","Telford and Wrekin 014C","E01014152",817,230,119,111,554,83,264,84,129,51,112,54,54,4,95,64,31,0,0,33,19,14
"2021","Telford and Wrekin 014D","E01014153",904,346,124,222,508,78,214,97,75,42,115,57,46,12,97,63,34,4,4,50,22,28
"2021","Telford and Wrekin 014E","E01014154",750,217,80,137,488,50,226,96,93,37,104,57,43,4,103,69,34,5,5,45,16,29
"2021","Telford and Wrekin 014F","E01014155",850,287,135,152,514,66,240,96,100,44,115,57,52,6,86,61,25,7,7,49,19,30
"2021","Telford and Wrekin 015A","E01014181",823,106,37,69,673,44,423,132,216,75,129,69,52,8,72,59,13,5,5,44,20,24
"2021","Telford and Wrekin 015B","E01014182",571,96,43,53,462,68,268,95,129,44,78,45,30,3,47,33,14,1,1,13,7,6
"2021","Telford and Wrekin 015C","E01014183",760,147,77,70,572,117,286,92,130,64,88,36,45,7,79,58,21,2,2,41,15,26
"2021","Telford and Wrekin 015D","E01014184",851,182,46,136,630,67,321,115,165,41,138,74,58,6,103,87,16,1,1,39,16,23
"2021","Telford and Wrekin 017A","E01014124",768,337,115,222,404,45,149,58,52,39,102,64,34,4,103,64,39,5,5,27,12,15
"2021","Telford and Wrekin 017B","E01014163",782,160,57,103,556,50,205,73,106,26,152,79,58,15,138,101,37,11,11,66,32,34
"2021","Telford and Wrekin 017C","E01014164",707,234,93,141,428,37,132,38,61,33,113,37,67,9,140,98,42,6,6,45,16,29
"2021","Telford and Wrekin 017D","E01014165",611,196,58,138,368,26,152,50,75,27,68,28,34,6,109,75,34,13,13,47,16,31
"2021","Telford and Wrekin 017E","E01014166",642,167,71,96,434,49,220,99,68,53,92,46,39,7,70,37,33,3,3,41,19,22
"2021","Telford and Wrekin 018A","E01014191",715,206,50,156,444,37,202,65,112,25,85,42,39,4,99,71,28,21,21,65,30,35
"2021","Telford and Wrekin 018B","E01014192",581,165,42,123,338,28,141,31,67,43,98,51,39,8,66,37,29,5,5,78,21,57
"2021","Telford and Wrekin 018C","E01014193",617,137,59,78,413,43,186,62,81,43,77,30,38,9,97,55,42,10,10,67,26,41
"2021","Telford and Wrekin 018D","E01014194",627,167,74,93,418,41,198,72,97,29,83,28,45,10,92,56,36,4,4,42,17,25
"2021","Telford and Wrekin 018E","E01014195",565,104,56,48,433,81,255,113,83,59,50,23,25,2,47,30,17,0,0,28,13,15
"2021","Telford and Wrekin 018F","E01014196",655,228,130,98,387,52,185,64,78,43,60,20,29,11,86,54,32,4,4,40,21,19
"2021","Telford and Wrekin 019A","E01014119",685,201,114,87,454,62,241,103,90,48,84,42,33,9,66,43,23,1,1,30,11,19
"2021","Telford and Wrekin 019B","E01014120",816,300,145,155,480,47,181,73,71,37,104,41,54,9,138,79,59,10,10,36,12,24
"2021","Telford and Wrekin 019C","E01014121",634,227,104,123,390,74,182,88,54,40,68,36,26,6,60,27,33,6,6,17,9,8
"2021","Telford and Wrekin 019D","E01014122",744,288,47,241,419,35,176,78,67,31,122,74,44,4,85,61,24,1,1,37,15,22
"2021","Telford and Wrekin 019E","E01014123",620,165,69,96,435,65,237,97,85,55,74,37,32,5,55,40,15,4,4,20,11,9
"2021","Telford and Wrekin 020A","E01014106",617,171,77,94,410,53,177,73,75,29,86,45,34,7,89,67,22,5,5,36,15,21
"2021","Telford and Wrekin 020B","E01014107",481,96,53,43,371,114,181,82,67,32,44,20,18,6,32,17,15,0,0,14,9,5
"2021","Telford and Wrekin 020C","E01014108",631,217,46,171,361,18,107,42,43,22,87,36,43,8,134,105,29,15,15,53,16,37
"2021","Telford and Wrekin 020D","E01014109",468,99,39,60,341,42,169,73,68,28,60,23,30,7,68,47,21,2,2,28,16,12
"2021","Telford and Wrekin 020E","E01014110",557,84,28,56,407,15,135,36,79,20,87,18,63,6,165,123,42,5,5,66,29,37
"2021","Telford and Wrekin 021A","E01014197",677,136,40,96,484,44,174,43,91,40,121,33,76,12,142,99,43,3,3,57,26,31
"2021","Telford and Wrekin 021B","E01014198",550,155,71,84,353,24,131,39,68,24,77,31,41,5,118,92,26,3,3,42,22,20
"2021","Telford and Wrekin 021C","E01014199",623,147,47,100,420,31,146,53,62,31,99,34,57,8,142,104,38,2,2,56,26,30
"2021","Telford and Wrekin 021D","E01014200",486,100,50,50,347,18,111,42,50,19,88,27,56,5,125,97,28,5,5,39,14,25
"2021","Telford and Wrekin 021E","E01014201",445,92,34,58,302,23,95,33,40,22,63,19,38,6,116,83,33,5,5,51,22,29
"2021","Telford and Wrekin 022A","E01014159",615,247,132,115,356,58,150,53,52,45,68,38,22,8,72,36,36,8,8,12,4,8
"2021","Telford and Wrekin 022B","E01014160",528,139,66,73,364,93,170,60,58,52,56,29,22,5,43,24,19,2,2,25,15,10
"2021","Telford and Wrekin 022C","E01014161",489,154,79,75,319,60,157,72,55,30,54,31,18,5,47,23,24,1,1,16,7,9
"2021","Telford and Wrekin 022D","E01014162",936,438,183,255,466,56,174,78,69,27,124,76,45,3,104,76,28,8,8,32,8,24
"2021","Telford and Wrekin 023A","E01014115",607,184,75,109,377,44,138,57,50,31,73,20,46,7,114,81,33,8,8,46,15,31
"2021","Telford and Wrekin 023B","E01014116",805,298,147,151,473,83,138,55,58,25,109,52,48,9,138,101,37,5,5,34,18,16
"2021","Telford and Wrekin 023C","E01014117",497,93,59,34,370,105,170,82,47,41,39,19,16,4,50,21,29,6,6,34,15,19
"2021","Telford and Wrekin 023D","E01014118",484,99,34,65,345,10,109,27,57,25,78,30,43,5,142,97,45,6,6,40,13,27
"2021","Telford and Wrekin 024C","E01014157",514,108,33,75,373,36,236,76,117,43,63,27,33,3,37,16,21,1,1,33,15,18
"2021","Telford and Wrekin 024E","E01014158",820,245,113,132,539,48,234,75,113,46,138,67,68,3,115,85,30,4,4,36,19,17
"2021","Telford and Wrekin 024A","E01035076",728,124,12,112,563,9,294,86,193,15,200,104,90,6,54,38,16,6,6,41,26,15
"2021","Telford and Wrekin 024B","E01035077",551,171,37,134,347,14,118,47,48,23,106,41,55,10,103,78,25,6,6,33,19,14
"2021","Telford and Wrekin 024D","E01035078",637,115,18,97,483,15,250,60,170,20,135,77,53,5,78,56,22,5,5,39,18,21
"2021","Telford and Wrekin 025A","E01035079",528,118,26,92,380,15,200,45,133,22,99,53,41,5,61,48,13,5,5,30,12,18
"2021","Telford and Wrekin 025B","E01035080",551,96,20,76,423,18,220,74,125,21,139,85,53,1,45,33,12,1,1,32,15,17
"2021","Telford and Wrekin 025C","E01035081",577,109,31,78,452,44,248,91,125,32,90,42,44,4,67,44,23,3,3,16,9,7
"2021","Telford and Wrekin 025D","E01035082",756,221,79,142,505,65,237,81,116,40,112,47,58,7,88,66,22,3,3,30,20,10
"2021","Telford and Wrekin 025E","E01035083",841,135,18,117,667,35,318,90,196,32,207,110,86,11,105,74,31,2,2,39,21,18
"2021","Stoke-on-Trent 001A","E01014257",634,190,84,106,415,71,187,87,47,53,83,26,48,9,72,55,17,2,2,29,19,10
"2021","Stoke-on-Trent 001B","E01014258",551,84,42,42,442,49,274,99,125,50,79,31,38,10,39,29,10,1,1,25,18,7
"2021","Stoke-on-Trent 001C","E01014259",758,295,169,126,443,105,171,92,39,40,95,47,37,11,66,41,25,6,6,20,8,12
"2021","Stoke-on-Trent 001D","E01014260",624,204,98,106,400,81,138,60,40,38,81,24,47,10,94,69,25,6,6,20,12,8
"2021","Stoke-on-Trent 001E","E01014264",794,209,104,105,550,75,272,106,113,53,122,57,58,7,79,48,31,2,2,35,17,18
"2021","Stoke-on-Trent 002A","E01014357",701,292,146,146,383,55,145,64,59,22,96,57,35,4,84,58,26,3,3,26,13,13
"2021","Stoke-on-Trent 002B","E01014358",540,159,85,74,362,31,136,51,58,27,85,25,51,9,107,83,24,3,3,19,9,10
"2021","Stoke-on-Trent 002C","E01014359",782,226,79,147,528,66,226,74,110,42,123,56,57,10,110,74,36,3,3,28,16,12
"2021","Stoke-on-Trent 002D","E01014360",1067,215,75,140,817,58,432,138,232,62,228,108,106,14,91,66,25,8,8,35,20,15
"2021","Stoke-on-Trent 003A","E01014261",665,206,90,116,435,36,140,48,66,26,90,29,54,7,167,126,41,2,2,24,9,15
"2021","Stoke-on-Trent 003B","E01014262",528,148,73,75,356,36,159,61,65,33,75,22,32,21,84,54,30,2,2,24,14,10
"2021","Stoke-on-Trent 003C","E01014263",610,146,46,100,416,30,180,48,81,51,97,30,58,9,104,63,41,5,5,48,33,15
"2021","Stoke-on-Trent 003D","E01014333",617,161,79,82,445,95,211,106,65,40,96,47,40,9,41,22,19,2,2,11,5,6
"2021","Stoke-on-Trent 003E","E01014334",732,336,244,92,381,142,146,73,38,35,44,29,11,4,47,24,23,2,2,15,3,12
"2021","Stoke-on-Trent 004A","E01014331",630,181,74,107,420,36,176,53,77,46,83,30,51,2,121,89,32,4,4,29,17,12
"2021","Stoke-on-Trent 004B","E01014332",782,259,166,93,510,124,219,99,73,47,80,40,34,6,86,56,30,1,1,13,4,9
"2021","Stoke-on-Trent 004C","E01014335",752,210,86,124,518,76,247,100,109,38,115,68,37,10,77,53,24,3,3,24,8,16
"2021","Stoke-on-Trent 004D","E01014336",713,265,79,186,409,24,162,52,73,37,100,33,61,6,117,83,34,6,6,39,14,25
"2021","Stoke-on-Trent 004E","E01014337",728,217,96,121,477,54,210,96,74,40,114,46,62,6,96,71,25,3,3,34,14,20
"2021","Stoke-on-Trent 005A","E01014354",822,379,124,255,402,34,143,37,91,15,90,41,46,3,120,92,28,15,15,41,20,21
"2021","Stoke-on-Trent 005B","E01014355",760,263,77,186,429,31,216,62,124,30,87,40,42,5,91,53,38,4,4,68,43,25
"2021","Stoke-on-Trent 005C","E01014356",753,230,67,163,466,36,218,77,116,25,92,44,41,7,110,77,33,10,10,57,30,27
"2021","Stoke-on-Trent 005D","E01014361",715,262,32,230,400,12,175,55,95,25,97,49,42,6,109,84,25,7,7,53,34,19
"2021","Stoke-on-Trent 006A","E01014241",650,194,72,122,424,33,181,85,57,39,95,41,51,3,106,68,38,9,9,32,18,14
"2021","Stoke-on-Trent 006B","E01014242",646,215,102,113,403,41,156,48,72,36,83,26,46,11,119,72,47,4,4,28,13,15
"2021","Stoke-on-Trent 006C","E01014243",600,163,75,88,412,91,217,88,74,55,62,25,32,5,42,21,21,0,0,25,15,10
"2021","Stoke-on-Trent 006D","E01014244",588,129,55,74,432,37,164,43,100,21,80,28,49,3,146,105,41,5,5,27,13,14
"2021","Stoke-on-Trent 006E","E01014245",695,208,69,139,454,45,201,79,89,33,110,50,53,7,91,47,44,7,7,33,15,18
"2021","Stoke-on-Trent 006F","E01014248",618,208,46,162,385,33,147,57,63,27,81,42,35,4,115,71,44,9,9,25,9,16
"2021","Stoke-on-Trent 007A","E01014214",638,139,98,41,478,113,270,117,98,55,62,32,27,3,31,17,14,2,2,21,4,17
"2021","Stoke-on-Trent 007B","E01014215",614,157,103,54,442,71,222,72,99,51,89,39,42,8,58,31,27,2,2,15,10,5
"2021","Stoke-on-Trent 007C","E01014216",624,191,114,77,417,118,174,73,61,40,76,37,32,7,49,21,28,0,0,16,4,12
"2021","Stoke-on-Trent 007D","E01014265",679,196,120,76,466,98,234,102,86,46,70,34,34,2,64,40,24,0,0,17,10,7
"2021","Stoke-on-Trent 007E","E01014267",1013,318,127,191,644,87,280,108,127,45,159,78,73,8,110,75,35,8,8,51,17,34
"2021","Stoke-on-Trent 007F","E01014272",664,217,100,117,427,75,203,85,90,28,77,46,29,2,69,46,23,3,3,20,12,8
"2021","Stoke-on-Trent 008A","E01014246",745,293,95,198,419,40,155,59,70,26,109,58,45,6,109,77,32,6,6,33,16,17
"2021","Stoke-on-Trent 008B","E01014266",594,242,86,156,331,32,106,37,49,20,85,50,33,2,106,79,27,2,2,21,8,13
"2021","Stoke-on-Trent 008C","E01014268",1168,430,183,247,705,61,305,82,179,44,187,100,79,8,145,101,44,7,7,33,15,18
"2021","Stoke-on-Trent 008D","E01014270",650,156,93,63,470,84,236,108,81,47,84,37,40,7,64,39,25,2,2,24,13,11
"2021","Stoke-on-Trent 008E","E01014271",605,148,62,86,432,61,198,75,80,43,93,45,45,3,75,39,36,5,5,25,10,15
"2021","Stoke-on-Trent 009A","E01014247",759,321,89,232,399,35,153,54,80,19,119,69,48,2,88,49,39,4,4,39,20,19
"2021","Stoke-on-Trent 009B","E01014250",584,259,93,166,292,22,113,30,64,19,72,34,34,4,81,58,23,4,4,33,10,23
"2021","Stoke-on-Trent 009D","E01014252",725,266,58,208,435,39,176,61,85,30,112,75,33,4,101,75,26,7,7,24,3,21
"2021","Stoke-on-Trent 009E","E01014255",706,260,54,206,393,28,220,60,124,36,61,30,28,3,73,49,24,11,11,53,32,21
"2021","Stoke-on-Trent 009F","E01034052",522,212,31,181,288,9,95,30,62,3,101,38,58,5,83,62,21,0,0,22,11,11
"2021","Stoke-on-Trent 009G","E01034053",698,325,124,201,337,27,107,33,62,12,88,35,52,1,103,72,31,12,12,36,16,20
"2021","Stoke-on-Trent 010A","E01014269",671,213,86,127,422,26,183,40,101,42,70,26,41,3,134,85,49,9,9,36,17,19
"2021","Stoke-on-Trent 010B","E01014324",687,229,132,97,437,114,184,80,63,41,79,45,27,7,52,23,29,8,8,21,8,13
"2021","Stoke-on-Trent 010C","E01014325",540,105,35,70,413,50,245,123,66,56,79,43,32,4,38,14,24,1,1,22,15,7
"2021","Stoke-on-Trent 010D","E01014326",578,121,72,49,441,81,245,102,73,70,85,43,34,8,30,7,23,0,0,16,9,7
"2021","Stoke-on-Trent 011A","E01014249",754,327,106,221,360,31,150,45,91,14,77,46,27,4,93,71,22,9,9,67,32,35
"2021","Stoke-on-Trent 011B","E01014253",659,184,72,112,450,57,237,80,100,57,88,46,37,5,61,38,23,7,7,25,16,9
"2021","Stoke-on-Trent 011C","E01014254",719,220,39,181,425,21,197,49,126,22,96,51,42,3,101,74,27,10,10,74,37,37
"2021","Stoke-on-Trent 011D","E01014256",874,327,105,222,504,43,251,63,155,33,110,57,46,7,95,53,42,5,5,43,21,22
"2021","Stoke-on-Trent 012A","E01014210",637,183,98,85,425,50,149,42,69,38,101,39,57,5,119,70,49,6,6,29,13,16
"2021","Stoke-on-Trent 012B","E01014211",640,176,85,91,435,38,155,58,63,34,98,20,67,11,140,91,49,4,4,29,12,17
"2021","Stoke-on-Trent 012C","E01014212",904,353,189,164,535,57,193,70,84,39,140,54,80,6,138,102,36,7,7,16,9,7
"2021","Stoke-on-Trent 012D","E01014213",552,161,49,112,368,29,154,67,59,28,84,38,40,6,97,70,27,4,4,23,14,9
"2021","Stoke-on-Trent 012E","E01014217",634,224,98,126,389,35,104,48,38,18,108,28,73,7,138,101,37,4,4,21,10,11
"2021","Stoke-on-Trent 013A","E01014323",640,245,43,202,366,30,136,60,47,29,111,70,38,3,78,45,33,11,11,29,6,23
"2021","Stoke-on-Trent 013B","E01014327",679,247,80,167,400,31,170,87,57,26,110,53,50,7,87,62,25,2,2,32,13,19
"2021","Stoke-on-Trent 013C","E01014328",676,280,65,215,347,36,128,48,53,27,71,42,28,1,103,67,36,9,9,49,19,30
"2021","Stoke-on-Trent 013D","E01014329",750,287,105,182,433,43,183,81,71,31,101,49,45,7,101,64,37,5,5,30,11,19
"2021","Stoke-on-Trent 013E","E01014330",669,340,81,259,282,11,119,41,66,12,74,41,29,4,67,44,23,11,11,47,14,33
"2021","Stoke-on-Trent 014A","E01014218",624,165,76,89,427,33,147,52,60,35,101,27,66,8,143,104,39,3,3,32,20,12
"2021","Stoke-on-Trent 014B","E01014219",598,192,93,99,388,82,168,81,46,41,77,45,29,3,57,42,15,4,4,18,7,11
"2021","Stoke-on-Trent 014C","E01014225",683,208,117,91,445,100,205,88,74,43,74,41,26,7,63,36,27,3,3,30,15,15
"2021","Stoke-on-Trent 014D","E01014226",700,298,194,104,373,62,155,67,53,35,78,29,40,9,76,51,25,2,2,29,15,14
"2021","Stoke-on-Trent 014E","E01014228",550,141,96,45,389,123,176,82,56,38,42,19,21,2,47,20,27,1,1,20,13,7
"2021","Stoke-on-Trent 014F","E01014230",720,248,98,150,450,52,165,72,61,32,114,52,49,13,107,74,33,12,12,22,13,9
"2021","Stoke-on-Trent 015A","E01014281",560,161,38,123,317,14,168,25,117,26,43,21,19,3,79,58,21,13,13,82,42,40
"2021","Stoke-on-Trent 015B","E01014285",929,316,107,209,533,24,300,68,201,31,106,74,31,1,85,56,29,18,18,80,35,45
"2021","Stoke-on-Trent 015C","E01014286",553,171,47,124,334,12,198,34,133,31,39,25,13,1,75,58,17,10,10,48,24,24
"2021","Stoke-on-Trent 015D","E01014287",887,402,64,338,418,19,169,37,107,25,73,56,15,2,137,94,43,20,20,67,27,40
"2021","Stoke-on-Trent 016D","E01014282",410,209,56,153,142,10,78,23,45,10,36,24,12,0,14,7,7,4,4,59,16,43
"2021","Stoke-on-Trent 016E","E01014283",779,288,40,248,265,2,135,33,90,12,72,58,13,1,36,24,12,20,20,226,28,198
"2021","Stoke-on-Trent 016F","E01014284",431,76,11,65,117,2,43,7,29,7,29,20,8,1,26,17,9,17,17,238,21,217
"2021","Stoke-on-Trent 016H","E01034054",506,226,11,215,250,1,111,24,83,4,93,59,33,1,41,34,7,4,4,30,12,18
"2021","Stoke-on-Trent 016I","E01034055",697,378,119,259,285,26,140,37,94,9,60,34,24,2,50,34,16,9,9,34,13,21
"2021","Stoke-on-Trent 016J","E01034056",725,254,103,151,444,58,175,75,75,25,117,67,45,5,91,67,24,3,3,27,13,14
"2021","Stoke-on-Trent 016K","E01034057",667,246,71,175,366,27,141,52,71,18,96,51,41,4,92,67,25,10,10,55,11,44
"2021","Stoke-on-Trent 017A","E01014220",705,223,73,150,451,24,163,46,82,35,102,38,56,8,150,112,38,12,12,31,13,18
"2021","Stoke-on-Trent 017B","E01014221",643,169,56,113,433,27,172,56,79,37,99,25,69,5,128,102,26,7,7,41,18,23
"2021","Stoke-on-Trent 017C","E01014222",654,215,61,154,406,16,132,47,61,24,88,32,49,7,168,128,40,2,2,33,17,16
"2021","Stoke-on-Trent 017D","E01014223",784,329,86,243,421,35,144,54,67,23,109,38,64,7,129,93,36,4,4,34,19,15
"2021","Stoke-on-Trent 017E","E01014224",665,217,96,121,405,28,156,51,81,24,92,32,51,9,124,93,31,5,5,43,26,17
"2021","Stoke-on-Trent 017F","E01014229",797,238,88,150,533,33,197,61,102,34,130,49,72,9,171,124,47,2,2,26,15,11
"2021","Stoke-on-Trent 018A","E01014288",718,236,63,173,421,31,165,64,68,33,115,77,33,5,102,62,40,8,8,61,12,49
"2021","Stoke-on-Trent 018B","E01014289",671,183,68,115,430,77,193,89,70,34,91,63,28,0,62,31,31,7,7,58,21,37
"2021","Stoke-on-Trent 018C","E01014290",662,222,78,144,394,51,170,69,77,24,99,63,33,3,67,42,25,7,7,46,21,25
"2021","Stoke-on-Trent 018D","E01014291",823,280,84,196,497,36,239,74,137,28,133,94,34,5,85,66,19,4,4,46,13,33
"2021","Stoke-on-Trent 018E","E01014292",680,219,56,163,407,56,172,65,75,32,94,54,39,1,77,42,35,8,8,54,12,42
"2021","Stoke-on-Trent 018F","E01014294",613,273,84,189,294,18,158,52,85,21,58,39,14,5,54,29,25,6,6,46,10,36
"2021","Stoke-on-Trent 019A","E01014293",744,315,48,267,363,22,131,44,71,16,117,64,44,9,78,47,31,15,15,66,13,53
"2021","Stoke-on-Trent 019B","E01014295",801,300,136,164,471,82,208,80,97,31,104,55,37,12,75,47,28,2,2,30,6,24
"2021","Stoke-on-Trent 019C","E01014339",899,342,70,272,473,21,176,75,73,28,146,93,50,3,114,80,34,16,16,84,24,60
"2021","Stoke-on-Trent 019D","E01014340",959,351,144,207,547,57,210,73,108,29,127,70,53,4,146,113,33,7,7,61,20,41
"2021","Stoke-on-Trent 019E","E01014345",924,428,79,349,418,33,150,52,78,20,129,89,31,9,94,61,33,12,12,78,20,58
"2021","Stoke-on-Trent 020A","E01014274",809,299,97,202,470,47,157,62,75,20,104,53,47,4,153,111,42,9,9,40,16,24
"2021","Stoke-on-Trent 020B","E01014275",722,351,162,189,334,27,102,34,50,18,97,53,38,6,101,61,40,7,7,37,21,16
"2021","Stoke-on-Trent 020C","E01014276",759,335,82,253,391,33,128,54,50,24,103,55,43,5,116,77,39,11,11,33,15,18
"2021","Stoke-on-Trent 020D","E01014277",705,251,100,151,422,64,168,82,60,26,92,41,45,6,89,50,39,9,9,32,17,15
"2021","Stoke-on-Trent 020E","E01014279",810,289,72,217,471,30,162,56,73,33,135,69,59,7,132,100,32,12,12,50,14,36
"2021","Stoke-on-Trent 023A","E01014338",601,167,77,90,387,52,172,63,61,48,88,40,42,6,71,36,35,4,4,47,13,34
"2021","Stoke-on-Trent 023B","E01014341",754,237,78,159,452,40,214,64,104,46,85,51,22,12,107,65,42,6,6,65,18,47
"2021","Stoke-on-Trent 023C","E01014342",587,143,73,70,414,36,170,45,83,42,74,24,45,5,127,78,49,7,7,30,14,16
"2021","Stoke-on-Trent 023D","E01014343",884,385,96,289,468,39,203,76,88,39,127,82,44,1,90,58,32,9,9,31,12,19
"2021","Stoke-on-Trent 023E","E01014344",595,150,66,84,415,34,228,58,130,40,58,25,30,3,94,58,36,1,1,30,21,9
"2021","Stoke-on-Trent 024A","E01014363",617,185,149,36,419,113,186,95,50,41,60,25,28,7,60,22,38,0,0,13,4,9
"2021","Stoke-on-Trent 024B","E01014364",622,203,67,136,393,48,177,71,74,32,95,44,44,7,70,44,26,3,3,26,13,13
"2021","Stoke-on-Trent 024C","E01014365",639,173,105,68,441,124,187,74,69,44,79,32,42,5,47,22,25,4,4,25,11,14
"2021","Stoke-on-Trent 024D","E01014369",732,169,96,73,538,76,265,89,138,38,112,41,69,2,85,55,30,0,0,25,11,14
"2021","Stoke-on-Trent 025A","E01014299",597,154,75,79,432,79,211,95,65,51,101,47,48,6,39,19,20,2,2,11,2,9
"2021","Stoke-on-Trent 025B","E01014301",655,152,49,103,480,37,293,113,122,58,90,45,42,3,59,38,21,1,1,23,14,9
"2021","Stoke-on-Trent 025C","E01014303",659,190,69,121,460,45,223,118,69,36,138,91,38,9,54,33,21,0,0,9,5,4
"2021","Stoke-on-Trent 025D","E01014304",651,191,103,88,433,83,198,96,61,41,99,46,45,8,51,30,21,2,2,27,12,15
"2021","Stoke-on-Trent 025E","E01014362",577,137,91,46,427,105,202,101,67,34,79,47,22,10,40,26,14,1,1,13,7,6
"2021","Stoke-on-Trent 026A","E01014233",622,175,111,64,421,116,183,72,70,41,74,32,34,8,48,21,27,0,0,26,10,16
"2021","Stoke-on-Trent 026B","E01014234",546,111,39,72,404,22,185,56,91,38,83,30,50,3,112,81,31,2,2,31,17,14
"2021","Stoke-on-Trent 026C","E01014239",593,135,75,60,419,70,207,67,88,52,78,37,36,5,62,36,26,2,2,39,19,20
"2021","Stoke-on-Trent 026D","E01014240",617,171,79,92,415,49,175,58,78,39,112,44,61,7,76,49,27,3,3,31,18,13
"2021","Stoke-on-Trent 027A","E01014308",751,272,165,107,461,146,206,93,56,57,75,37,28,10,34,19,15,0,0,18,5,13
"2021","Stoke-on-Trent 027B","E01014309",574,247,111,136,301,51,111,43,53,15,77,43,26,8,59,44,15,3,3,26,11,15
"2021","Stoke-on-Trent 027C","E01014311",616,230,102,128,359,69,131,59,45,27,71,46,24,1,85,56,29,3,3,27,14,13
"2021","Stoke-on-Trent 027D","E01014313",758,334,204,130,403,69,147,69,48,30,83,35,43,5,97,56,41,7,7,21,12,9
"2021","Stoke-on-Trent 028A","E01014321",644,204,73,131,421,69,175,79,65,31,97,50,43,4,76,49,27,4,4,19,8,11
"2021","Stoke-on-Trent 028B","E01014366",769,261,99,162,475,49,170,45,92,33,90,34,53,3,135,97,38,31,31,33,18,15
"2021","Stoke-on-Trent 028C","E01014367",771,263,100,163,477,25,159,54,77,28,122,41,78,3,168,131,37,3,3,31,16,15
"2021","Stoke-on-Trent 028D","E01014368",763,286,114,172,451,38,179,70,70,39,117,47,65,5,111,77,34,6,6,26,15,11
"2021","Stoke-on-Trent 029A","E01014305",501,133,50,83,306,23,189,40,123,26,40,20,17,3,53,37,16,1,1,62,40,22
"2021","Stoke-on-Trent 029B","E01014306",560,208,45,163,293,10,136,37,75,24,53,28,24,1,90,62,28,4,4,59,46,13
"2021","Stoke-on-Trent 029C","E01014307",499,122,38,84,314,20,169,39,105,25,39,16,19,4,83,70,13,3,3,63,45,18
"2021","Stoke-on-Trent 029D","E01014312",601,194,89,105,372,70,177,63,72,42,64,36,27,1,54,28,26,7,7,35,23,12
"2021","Stoke-on-Trent 030A","E01014346",727,214,139,75,498,145,239,126,81,32,67,44,16,7,45,22,23,2,2,15,4,11
"2021","Stoke-on-Trent 030B","E01014348",616,169,123,46,431,129,201,73,96,32,63,34,28,1,38,20,18,0,0,16,9,7
"2021","Stoke-on-Trent 030C","E01014349",641,196,134,62,431,108,210,99,67,44,74,41,31,2,39,14,25,0,0,14,9,5
"2021","Stoke-on-Trent 030D","E01014353",695,206,75,131,466,39,221,67,115,39,92,43,45,4,112,78,34,2,2,23,10,13
"2021","Stoke-on-Trent 031A","E01014310",793,181,85,96,565,81,340,102,175,63,79,38,34,7,62,41,21,3,3,47,24,23
"2021","Stoke-on-Trent 031B","E01014314",537,93,45,48,414,58,225,85,96,44,88,52,30,6,43,21,22,0,0,30,17,13
"2021","Stoke-on-Trent 031C","E01014316",642,165,69,96,445,25,134,32,78,24,106,26,73,7,178,146,32,2,2,32,20,12
"2021","Stoke-on-Trent 031D","E01014317",701,245,119,126,422,23,171,67,79,25,67,20,43,4,156,127,29,5,5,34,19,15
"2021","Stoke-on-Trent 031E","E01014322",652,184,72,112,420,40,197,69,96,32,87,34,48,5,92,69,23,4,4,48,33,15
"2021","Stoke-on-Trent 032A","E01014235",727,272,106,166,424,61,184,73,69,42,91,39,42,10,83,54,29,5,5,31,12,19
"2021","Stoke-on-Trent 032C","E01014237",722,255,68,187,425,21,141,44,56,41,93,42,47,4,164,120,44,6,6,42,20,22
"2021","Stoke-on-Trent 032D","E01014238",664,192,68,124,437,33,136,55,60,21,84,31,50,3,179,143,36,5,5,35,20,15
"2021","Stoke-on-Trent 032E","E01034058",767,246,111,135,489,37,147,55,68,24,104,26,69,9,170,130,40,31,31,32,15,17
"2021","Stoke-on-Trent 032F","E01034059",771,126,24,102,619,22,368,102,237,29,168,111,54,3,52,45,7,9,9,26,13,13
"2021","Stoke-on-Trent 033A","E01014315",598,163,108,55,424,142,177,71,70,36,56,33,20,3,47,23,24,2,2,11,7,4
"2021","Stoke-on-Trent 033B","E01014318",597,156,97,59,424,86,221,91,91,39,78,46,26,6,39,25,14,0,0,17,8,9
"2021","Stoke-on-Trent 033C","E01014319",571,106,48,58,431,55,224,89,88,47,77,29,37,11,74,50,24,1,1,34,18,16
"2021","Stoke-on-Trent 033D","E01014320",490,112,36,76,365,56,232,81,107,44,41,16,22,3,35,25,10,1,1,13,8,5
"2021","Stoke-on-Trent 034A","E01014347",577,127,78,49,443,86,246,99,106,41,77,36,34,7,32,16,16,2,2,7,4,3
"2021","Stoke-on-Trent 034B","E01014350",550,110,78,32,426,106,198,66,86,46,78,41,34,3,42,19,23,2,2,14,8,6
"2021","Stoke-on-Trent 034C","E01014351",557,150,53,97,394,84,195,87,75,33,78,42,33,3,36,19,17,1,1,13,4,9
"2021","Stoke-on-Trent 034D","E01014352",582,137,88,49,426,86,252,101,108,43,53,34,16,3,34,14,20,1,1,19,11,8
"2021","Stoke-on-Trent 035A","E01014273",595,237,40,197,307,16,107,41,49,17,81,38,39,4,94,71,23,9,9,51,20,31
"2021","Stoke-on-Trent 035C","E01014278",557,191,73,118,354,66,143,64,46,33,72,30,38,4,71,42,29,2,2,12,4,8
"2021","Stoke-on-Trent 035B","E01014280",588,199,98,101,385,74,175,90,48,37,82,44,31,7,54,21,33,0,0,4,1,3
"2021","Stoke-on-Trent 035H","E01014296",614,170,84,86,431,60,196,86,67,43,80,33,38,9,93,59,34,2,2,13,3,10
"2021","Stoke-on-Trent 035D","E01014297",481,99,44,55,366,63,210,98,63,49,54,20,30,4,36,21,15,3,3,16,8,8
"2021","Stoke-on-Trent 035G","E01014298",654,205,77,128,426,29,174,65,69,40,93,28,60,5,124,86,38,6,6,23,12,11
"2021","Stoke-on-Trent 035F","E01014300",619,200,88,112,389,43,131,38,60,33,99,49,46,4,108,70,38,8,8,30,15,15
"2021","Stoke-on-Trent 035E","E01014302",955,468,203,265,456,65,149,65,63,21,128,62,61,5,110,69,41,4,4,31,7,24
"2021","Shropshire 025A","E01028853",601,203,109,94,367,64,155,48,60,47,56,32,24,0,88,45,43,4,4,31,7,24
"2021","Shropshire 025B","E01028854",643,225,112,113,400,86,213,87,85,41,61,34,23,4,40,18,22,0,0,18,7,11
"2021","Shropshire 025C","E01028855",1164,249,99,150,886,129,446,170,217,59,209,125,79,5,98,68,30,4,4,29,22,7
"2021","Shropshire 025D","E01028856",785,272,120,152,487,78,219,87,99,33,109,79,29,1,78,40,38,3,3,26,6,20
"2021","Shropshire 025F","E01035069",570,96,38,58,439,58,264,86,146,32,79,45,31,3,37,25,12,1,1,35,13,22
"2021","Shropshire 025G","E01035070",752,185,73,112,542,69,245,87,127,31,159,92,60,7,68,45,23,1,1,25,11,14
"2021","Shropshire 027A","E01028826",789,244,150,94,472,121,213,101,70,42,75,44,21,10,59,38,21,4,4,73,35,38
"2021","Shropshire 027B","E01028827",603,134,84,50,426,66,204,69,87,48,77,29,41,7,74,43,31,5,5,43,13,30
"2021","Shropshire 027C","E01028844",444,99,32,67,334,41,231,57,136,38,43,29,14,0,19,13,6,0,0,11,3,8
"2021","Shropshire 027D","E01028845",899,286,191,95,578,196,266,111,96,59,67,47,17,3,45,16,29,4,4,35,13,22
"2021","Shropshire 029A","E01028838",754,266,148,118,464,88,190,81,81,28,93,35,47,11,90,64,26,3,3,24,11,13
"2021","Shropshire 029B","E01028839",600,147,94,53,429,110,230,97,90,43,57,28,26,3,30,12,18,2,2,24,9,15
"2021","Shropshire 029C","E01028840",555,121,74,47,388,69,218,105,77,36,45,14,22,9,53,35,18,3,3,46,31,15
"2021","Shropshire 029D","E01028841",687,238,110,128,416,73,198,96,57,45,81,49,26,6,63,36,27,1,1,33,22,11
"2021","Shropshire 029E","E01028850",1028,226,94,132,751,120,385,166,146,73,152,87,58,7,94,63,31,0,0,51,24,27
"2021","Shropshire 029F","E01028851",842,251,158,93,560,169,276,105,97,74,58,33,21,4,56,36,20,1,1,31,17,14
"2021","Shropshire 029G","E01028852",708,215,121,94,465,118,217,98,83,36,69,36,24,9,61,35,26,0,0,28,21,7
"2021","Shropshire 031A","E01028830",724,317,201,116,397,129,183,77,68,38,49,33,13,3,34,21,13,2,2,10,3,7
"2021","Shropshire 031B","E01028831",640,155,103,52,466,117,240,77,119,44,63,29,32,2,43,17,26,3,3,19,11,8
"2021","Shropshire 031C","E01028836",638,228,120,108,385,57,177,64,84,29,67,28,32,7,81,50,31,3,3,25,8,17
"2021","Shropshire 031D","E01028837",638,220,123,97,401,111,194,82,81,31,61,33,23,5,35,15,20,0,0,17,3,14
"2021","Shropshire 033A","E01028832",873,397,193,204,453,99,199,115,52,32,98,64,22,12,56,35,21,1,1,23,11,12
"2021","Shropshire 033B","E01028833",655,226,127,99,411,115,204,91,68,45,56,36,18,2,35,20,15,1,1,18,3,15
"2021","Shropshire 033C","E01028834",699,181,119,62,493,126,220,105,68,47,74,36,32,6,69,41,28,4,4,25,12,13
"2021","Shropshire 033D","E01028835",696,202,95,107,470,96,207,82,85,40,87,49,30,8,75,51,24,5,5,24,12,12
"2021","Shropshire 034A","E01028828",689,162,96,66,494,110,251,109,95,47,78,39,32,7,54,29,25,1,1,33,15,18
"2021","Shropshire 034B","E01028829",571,152,101,51,407,141,180,71,71,38,46,23,15,8,37,15,22,3,3,12,5,7
"2021","Shropshire 034C","E01028842",700,137,80,57,520,111,316,148,100,68,59,28,20,11,34,20,14,0,0,43,24,19
"2021","Shropshire 034D","E01028847",605,125,80,45,448,96,253,108,89,56,56,36,18,2,40,26,14,3,3,32,7,25
"2021","Shropshire 034E","E01028859",671,148,83,65,488,124,254,103,87,64,64,35,24,5,46,26,20,0,0,35,17,18
"2021","Shropshire 035A","E01028843",703,163,108,55,505,109,277,118,101,58,70,35,32,3,46,19,27,3,3,35,17,18
"2021","Shropshire 035B","E01028846",819,184,105,79,553,142,278,126,90,62,94,57,29,8,38,17,21,1,1,82,64,18
"2021","Shropshire 035C","E01028848",769,193,126,67,551,149,260,107,106,47,86,38,39,9,52,22,30,4,4,25,12,13
"2021","Shropshire 035D","E01028849",901,304,155,149,565,99,229,99,69,61,133,51,54,28,98,65,33,6,6,32,11,21
"2021","Shropshire 035E","E01028858",939,226,159,67,668,207,331,156,90,85,73,46,23,4,53,24,29,4,4,45,22,23
"2021","Shropshire 001A","E01028891",848,402,151,251,416,49,158,65,59,34,128,74,50,4,72,45,27,9,9,30,18,12
"2021","Shropshire 001B","E01028892",813,190,126,64,604,152,314,163,112,39,79,55,22,2,54,30,24,5,5,19,8,11
"2021","Shropshire 001C","E01028894",594,182,93,89,399,74,191,69,81,41,81,35,43,3,53,25,28,0,0,13,8,5
"2021","Shropshire 001D","E01028895",718,217,85,132,466,84,193,83,71,39,95,47,43,5,88,53,35,6,6,35,20,15
"2021","Shropshire 001E","E01028896",945,318,165,153,596,94,266,115,100,51,141,67,69,5,90,66,24,5,5,31,9,22
"2021","Shropshire 001F","E01028897",658,183,105,78,441,86,216,98,76,42,85,44,34,7,53,35,18,1,1,34,19,15
"2021","Shropshire 002A","E01028880",717,181,100,81,503,90,228,108,82,38,114,73,35,6,67,37,30,4,4,33,11,22
"2021","Shropshire 002B","E01028881",577,125,79,46,417,121,217,99,73,45,56,33,19,4,20,9,11,3,3,35,10,25
"2021","Shropshire 002C","E01028882",659,126,77,49,488,95,275,130,99,46,79,48,22,9,35,13,22,4,4,45,20,25
"2021","Shropshire 002D","E01028893",646,138,79,59,449,106,248,107,83,58,60,37,21,2,35,15,20,0,0,59,32,27
"2021","Shropshire 002E","E01028899",811,192,94,98,597,142,317,134,137,46,99,58,37,4,39,21,18,0,0,22,7,15
"2021","Shropshire 004A","E01028864",664,194,88,106,425,101,217,102,72,43,64,36,25,3,38,17,21,5,5,45,23,22
"2021","Shropshire 004B","E01028865",823,214,129,85,590,211,232,95,97,40,82,35,40,7,65,39,26,0,0,19,10,9
"2021","Shropshire 004C","E01028866",674,265,118,147,381,75,184,86,56,42,67,44,18,5,52,30,22,3,3,28,17,11
"2021","Shropshire 004D","E01028867",773,276,157,119,468,70,228,61,118,49,82,48,33,1,85,51,34,3,3,29,14,15
"2021","Shropshire 004E","E01028872",602,127,59,68,448,100,250,120,77,53,53,32,16,5,42,17,25,3,3,27,14,13
"2021","Shropshire 005A","E01028873",961,355,132,223,493,79,184,73,83,28,125,62,54,9,100,75,25,5,5,113,87,26
"2021","Shropshire 005B","E01028874",672,210,150,60,450,145,209,88,81,40,60,37,18,5,35,15,20,1,1,12,4,8
"2021","Shropshire 005C","E01028875",1110,274,132,142,783,129,375,138,176,61,181,91,77,13,95,66,29,3,3,53,33,20
"2021","Shropshire 005D","E01028876",831,309,156,153,480,77,176,67,75,34,124,50,66,8,98,67,31,5,5,42,21,21
"2021","Shropshire 005E","E01028877",547,131,84,47,392,106,166,72,64,30,73,32,36,5,45,22,23,2,2,24,12,12
"2021","Shropshire 005F","E01028878",678,203,103,100,442,91,211,96,70,45,77,35,34,8,60,30,30,3,3,33,13,20
"2021","Shropshire 005G","E01028879",666,203,78,125,440,63,207,84,73,50,100,45,41,14,65,43,22,5,5,23,10,13
"2021","Shropshire 008A","E01028886",799,316,123,193,464,65,195,76,77,42,102,47,52,3,98,65,33,4,4,19,4,15
"2021","Shropshire 008B","E01028887",722,220,148,72,481,123,238,82,109,47,73,28,34,11,45,20,25,2,2,21,9,12
"2021","Shropshire 008C","E01028889",658,217,151,66,416,113,220,87,91,42,45,22,21,2,38,15,23,0,0,25,9,16
"2021","Shropshire 008D","E01028890",653,264,127,137,359,77,164,67,66,31,63,33,23,7,51,29,22,4,4,30,14,16
"2021","Shropshire 009A","E01028868",596,121,70,51,438,97,233,120,81,32,70,36,29,5,37,21,16,1,1,37,11,26
"2021","Shropshire 009B","E01028869",678,120,55,65,516,81,288,135,90,63,104,56,34,14,39,22,17,4,4,42,22,20
"2021","Shropshire 009C","E01028871",519,133,64,69,339,72,178,79,72,27,51,24,23,4,38,21,17,0,0,47,33,14
"2021","Shropshire 009E","E01035057",398,80,41,39,293,52,173,77,58,38,43,22,16,5,25,11,14,0,0,25,9,16
"2021","Shropshire 009F","E01035058",403,69,31,38,319,41,178,61,93,24,51,24,26,1,47,30,17,2,2,15,7,8
"2021","Shropshire 010A","E01028860",941,227,129,98,664,108,354,128,166,60,118,61,56,1,82,62,20,2,2,50,21,29
"2021","Shropshire 010B","E01028862",729,158,87,71,537,112,321,139,122,60,60,35,21,4,41,22,19,3,3,34,13,21
"2021","Shropshire 010C","E01028863",570,122,70,52,415,82,230,112,74,44,62,33,24,5,38,19,19,3,3,33,20,13
"2021","Shropshire 010D","E01028888",679,120,66,54,516,93,291,120,109,62,85,48,33,4,47,31,16,0,0,43,17,26
"2021","Shropshire 010E","E01028898",612,108,59,49,463,104,253,94,95,64,72,49,18,5,31,10,21,3,3,41,16,25
"2021","Shropshire 013A","E01028861",611,157,85,72,435,89,245,94,113,38,68,33,28,7,31,18,13,2,2,19,7,12
"2021","Shropshire 013B","E01028870",615,119,77,42,455,101,258,119,86,53,56,35,17,4,36,16,20,4,4,41,17,24
"2021","Shropshire 013C","E01028883",585,107,52,55,453,69,271,110,136,25,66,37,28,1,46,29,17,1,1,25,12,13
"2021","Shropshire 013D","E01028884",641,166,106,60,444,81,240,104,85,51,66,34,29,3,53,34,19,4,4,31,14,17
"2021","Shropshire 003A","E01028910",534,138,93,45,367,85,192,83,78,31,63,28,32,3,27,12,15,0,0,29,9,20
"2021","Shropshire 003B","E01028911",555,143,102,41,389,83,224,102,78,44,44,24,16,4,34,18,16,4,4,23,15,8
"2021","Shropshire 003C","E01028912",628,206,82,124,392,47,146,47,72,27,100,51,45,4,96,69,27,3,3,30,17,13
"2021","Shropshire 003D","E01028920",533,147,84,63,355,77,172,71,63,38,50,24,21,5,55,31,24,1,1,31,19,12
"2021","Shropshire 003E","E01028921",789,203,111,92,555,100,261,104,111,46,110,50,54,6,79,44,35,5,5,31,13,18
"2021","Shropshire 003F","E01028925",547,122,64,58,408,99,226,112,74,40,48,26,17,5,34,15,19,1,1,17,11,6
"2021","Shropshire 003G","E01028926",611,191,102,89,400,65,175,68,67,40,87,46,37,4,70,40,30,3,3,20,8,12
"2021","Shropshire 006C","E01028902",561,178,120,58,360,90,155,70,55,30,51,21,28,2,61,40,21,3,3,23,4,19
"2021","Shropshire 006D","E01028903",619,262,165,97,331,84,128,63,31,34,58,23,29,6,60,30,30,1,1,26,8,18
"2021","Shropshire 006E","E01028904",633,163,90,73,437,57,186,61,82,43,106,36,61,9,82,48,34,6,6,33,7,26
"2021","Shropshire 006F","E01028905",778,208,87,121,511,31,214,63,106,45,114,48,57,9,149,98,51,3,3,59,45,14
"2021","Shropshire 006G","E01028909",618,197,86,111,375,42,176,78,69,29,79,33,38,8,71,35,36,7,7,46,15,31
"2021","Shropshire 006H","E01033528",1041,312,133,179,692,89,371,140,156,75,160,88,62,10,70,34,36,2,2,37,16,21
"2021","Shropshire 007A","E01028906",697,370,95,275,272,31,102,48,41,13,84,57,17,10,49,29,20,6,6,55,13,42
"2021","Shropshire 007B","E01028907",893,302,185,117,556,128,214,78,98,38,68,39,25,4,141,107,34,5,5,35,8,27
"2021","Shropshire 007C","E01028908",749,327,128,199,360,31,113,46,50,17,108,70,35,3,92,54,38,16,16,62,16,46
"2021","Shropshire 007D","E01028916",698,224,172,52,453,159,218,95,76,47,40,21,16,3,32,17,15,4,4,21,10,11
"2021","Shropshire 007E","E01028917",645,236,108,128,386,69,169,64,76,29,83,47,26,10,61,35,26,4,4,23,5,18
"2021","Shropshire 007F","E01028924",791,195,77,118,566,82,279,99,131,49,112,49,52,11,90,62,28,3,3,30,15,15
"2021","Shropshire 011A","E01028913",736,182,113,69,521,122,282,137,92,53,78,50,21,7,39,14,25,0,0,33,12,21
"2021","Shropshire 011B","E01028918",646,152,82,70,450,80,233,88,89,56,75,39,30,6,59,40,19,3,3,44,25,19
"2021","Shropshire 011C","E01028919",504,114,59,55,371,75,219,96,83,40,44,26,15,3,32,14,18,1,1,19,9,10
"2021","Shropshire 011D","E01028927",496,115,67,48,361,73,192,67,88,37,58,34,21,3,38,16,22,0,0,20,13,7
"2021","Shropshire 011E","E01028928",691,188,98,90,468,89,225,80,104,41,84,44,34,6,67,41,26,3,3,35,12,23
"2021","Shropshire 012A","E01028914",461,120,73,47,325,72,158,67,49,42,58,35,17,6,35,16,19,2,2,16,9,7
"2021","Shropshire 012B","E01028915",663,159,91,68,475,115,228,98,84,46,87,43,38,6,45,31,14,0,0,29,14,15
"2021","Shropshire 012C","E01028922",508,112,67,45,356,76,197,91,65,41,53,28,25,0,27,15,12,3,3,40,14,26
"2021","Shropshire 012D","E01028923",664,151,93,58,467,125,232,98,83,51,73,43,30,0,36,13,23,1,1,46,23,23
"2021","Shropshire 014A","E01028929",602,166,95,71,409,93,209,77,74,58,60,31,23,6,43,29,14,4,4,27,9,18
"2021","Shropshire 014B","E01028969",620,133,67,66,459,85,241,97,87,57,81,47,30,4,50,20,30,2,2,28,12,16
"2021","Shropshire 014C","E01028970",607,190,130,60,388,92,221,101,76,44,47,26,15,6,27,15,12,1,1,29,12,17
"2021","Shropshire 014D","E01028971",998,265,157,108,695,146,338,129,139,70,112,62,44,6,92,53,39,7,7,38,20,18
"2021","Shropshire 014E","E01028978",681,153,63,90,448,94,222,84,89,49,75,42,25,8,55,32,23,2,2,80,63,17
"2021","Shropshire 014F","E01028979",503,141,72,69,343,63,182,63,79,40,54,30,18,6,43,24,19,1,1,19,2,17
"2021","Shropshire 015A","E01028933",643,189,69,120,413,55,166,65,66,35,112,64,40,8,75,41,34,5,5,41,12,29
"2021","Shropshire 015B","E01028934",596,125,58,67,426,44,166,41,72,53,94,35,51,8,114,81,33,8,8,45,21,24
"2021","Shropshire 015C","E01028956",633,151,86,65,448,95,204,73,73,58,86,43,36,7,58,29,29,5,5,34,19,15
"2021","Shropshire 015D","E01028957",658,213,68,145,399,31,156,47,85,24,99,41,52,6,110,90,20,3,3,46,26,20
"2021","Shropshire 015E","E01028958",745,211,104,107,496,77,226,97,78,51,95,41,45,9,94,51,43,4,4,38,11,27
"2021","Shropshire 016B","E01028981",716,175,83,92,513,65,229,89,84,56,121,64,51,6,92,65,27,6,6,28,12,16
"2021","Shropshire 016C","E01028982",635,163,72,91,429,54,190,51,91,48,104,48,49,7,79,44,35,2,2,43,24,19
"2021","Shropshire 016D","E01028983",794,227,104,123,529,55,211,68,78,65,115,38,66,11,141,91,50,7,7,38,16,22
"2021","Shropshire 016E","E01035059",686,142,27,115,478,32,229,81,100,48,160,85,67,8,53,42,11,4,4,66,16,50
"2021","Shropshire 016F","E01035060",559,128,58,70,370,61,177,67,73,37,88,47,32,9,42,24,18,2,2,61,30,31
"2021","Shropshire 017A","E01028930",790,216,74,142,543,57,267,105,130,32,126,85,35,6,88,53,35,5,5,31,8,23
"2021","Shropshire 017B","E01028931",1060,445,142,303,544,82,214,93,87,34,134,97,31,6,106,70,36,8,8,71,11,60
"2021","Shropshire 017C","E01028944",980,409,157,252,509,79,215,93,78,44,122,76,40,6,87,55,32,6,6,62,15,47
"2021","Shropshire 017D","E01028945",1011,436,121,315,498,31,172,87,62,23,176,121,45,10,114,83,31,5,5,77,15,62
"2021","Shropshire 018A","E01028965",615,248,118,130,338,62,142,54,57,31,66,27,30,9,63,46,17,5,5,29,14,15
"2021","Shropshire 018B","E01028966",521,125,73,52,370,90,185,67,87,31,54,24,28,2,39,22,17,2,2,26,12,14
"2021","Shropshire 018C","E01028967",643,223,113,110,380,31,137,42,61,34,86,28,50,8,118,81,37,8,8,40,12,28
"2021","Shropshire 018D","E01028968",572,160,87,73,386,53,158,55,75,28,85,40,38,7,90,59,31,0,0,26,9,17
"2021","Shropshire 018E","E01028988",722,224,75,149,461,50,204,77,92,35,113,64,47,2,91,53,38,3,3,37,11,26
"2021","Shropshire 018F","E01028989",634,157,77,80,439,59,203,68,91,44,84,36,39,9,87,56,31,6,6,38,18,20
"2021","Shropshire 019B","E01028972",826,223,134,89,571,123,310,117,157,36,74,42,30,2,63,39,24,1,1,32,14,18
"2021","Shropshire 019C","E01028973",968,423,184,239,496,69,218,97,94,27,115,83,31,1,87,56,31,7,7,49,13,36
"2021","Shropshire 019E","E01035061",619,314,70,244,228,48,73,55,12,6,69,64,4,1,34,17,17,4,4,77,5,72
"2021","Shropshire 019F","E01035062",675,272,106,166,373,63,158,68,63,27,94,64,25,5,55,28,27,3,3,30,6,24
"2021","Shropshire 019G","E01035063",623,331,102,229,244,63,88,43,29,16,61,53,7,1,31,18,13,1,1,48,7,41
"2021","Shropshire 019H","E01035064",639,412,196,216,200,43,58,37,15,6,67,56,9,2,28,19,9,4,4,27,2,25
"2021","Shropshire 020B","E01028942",695,182,68,114,496,77,286,98,136,52,76,44,29,3,57,30,27,0,0,17,6,11
"2021","Shropshire 020C","E01028943",1104,482,161,321,579,88,273,129,104,40,139,92,43,4,72,38,34,7,7,43,9,34
"2021","Shropshire 020D","E01028951",859,230,102,128,597,129,316,102,165,49,85,42,38,5,64,33,31,3,3,32,12,20
"2021","Shropshire 020E","E01028953",650,154,107,47,480,115,272,89,146,37,47,28,18,1,45,27,18,1,1,16,6,10
"2021","Shropshire 020F","E01035065",643,202,83,119,391,65,182,84,80,18,85,47,33,5,56,36,20,3,3,50,15,35
"2021","Shropshire 020G","E01035066",750,213,70,143,497,47,248,53,177,18,115,65,50,0,83,65,18,4,4,40,16,24
"2021","Shropshire 021A","E01028947",777,212,154,58,540,145,223,89,96,38,124,93,27,4,46,29,17,2,2,25,12,13
"2021","Shropshire 021B","E01028948",631,204,112,92,406,117,164,53,64,47,56,29,21,6,65,30,35,4,4,21,9,12
"2021","Shropshire 021C","E01028949",694,225,130,95,444,120,224,97,97,30,58,34,21,3,39,17,22,3,3,25,10,15
"2021","Shropshire 021D","E01028985",630,239,138,101,379,105,175,76,62,37,69,36,33,0,30,15,15,0,0,12,5,7
"2021","Shropshire 022A","E01028938",823,415,192,223,375,58,160,64,68,28,75,48,19,8,78,45,33,4,4,33,10,23
"2021","Shropshire 022B","E01028939",802,343,105,238,423,49,174,74,75,25,125,91,29,5,73,50,23,2,2,36,11,25
"2021","Shropshire 022C","E01028984",665,258,115,143,376,67,126,64,35,27,80,43,25,12,101,53,48,2,2,31,9,22
"2021","Shropshire 022D","E01028986",950,239,129,110,682,134,311,118,130,63,152,95,50,7,84,50,34,1,1,29,15,14
"2021","Shropshire 023A","E01028940",681,209,119,90,452,86,228,72,119,37,68,28,29,11,69,37,32,1,1,20,6,14
"2021","Shropshire 023B","E01028952",770,300,141,159,449,92,230,89,100,41,66,43,22,1,59,38,21,2,2,21,9,12
"2021","Shropshire 023C","E01028962",650,205,91,114,409,27,166,54,66,46,82,18,31,33,129,76,53,5,5,36,11,25
"2021","Shropshire 023D","E01028963",653,147,90,57,485,119,266,77,131,58,57,25,28,4,42,25,17,1,1,21,7,14
"2021","Shropshire 023E","E01028964",834,223,125,98,591,120,309,123,139,47,86,52,30,4,76,51,25,0,0,20,5,15
"2021","Shropshire 023F","E01028974",486,127,63,64,347,59,232,69,128,35,38,22,15,1,17,11,6,1,1,12,7,5
"2021","Shropshire 024A","E01028935",665,162,110,52,477,121,234,74,105,55,66,24,40,2,55,27,28,1,1,26,11,15
"2021","Shropshire 024B","E01028936",921,219,152,67,658,170,313,111,134,68,95,55,35,5,79,49,30,1,1,44,13,31
"2021","Shropshire 024C","E01028937",623,167,110,57,432,76,218,78,96,44,71,38,28,5,65,32,33,2,2,24,10,14
"2021","Shropshire 024E","E01035067",705,195,92,103,481,108,255,114,93,48,83,44,38,1,34,15,19,1,1,29,14,15
"2021","Shropshire 024F","E01035068",686,203,72,131,453,51,194,73,96,25,134,80,52,2,71,53,18,3,3,30,14,16
"2021","Shropshire 026A","E01028954",545,110,64,46,406,97,223,105,78,40,52,36,15,1,34,15,19,0,0,29,9,20
"2021","Shropshire 026B","E01028955",555,178,105,73,361,64,181,70,79,32,59,27,28,4,57,37,20,0,0,16,7,9
"2021","Shropshire 026C","E01028975",831,244,131,113,550,98,249,88,108,53,115,56,48,11,84,54,30,4,4,37,15,22
"2021","Shropshire 026D","E01028976",743,158,109,49,550,152,278,149,87,42,80,46,29,5,36,18,18,4,4,35,14,21
"2021","Shropshire 026E","E01028977",880,254,143,111,589,173,264,104,116,44,92,53,31,8,58,36,22,2,2,37,15,22
"2021","Shropshire 028A","E01028950",1067,252,120,132,741,173,385,171,153,61,108,65,38,5,71,46,25,4,4,74,39,35
"2021","Shropshire 028B","E01028960",618,164,96,68,393,85,228,121,73,34,51,30,18,3,27,10,17,2,2,61,41,20
"2021","Shropshire 028C","E01028961",532,127,53,74,378,69,229,93,90,46,55,31,19,5,23,8,15,2,2,27,14,13
"2021","Shropshire 028D","E01028980",956,239,140,99,674,162,348,160,117,71,111,69,37,5,50,20,30,3,3,43,20,23
"2021","Shropshire 030B","E01028992",725,286,154,132,416,94,156,66,59,31,88,46,38,4,75,41,34,3,3,23,7,16
"2021","Shropshire 030E","E01033530",826,213,115,98,578,119,323,151,97,75,91,53,29,9,43,20,23,2,2,35,16,19
"2021","Shropshire 030F","E01035071",963,220,132,88,680,169,324,159,100,65,113,66,38,9,71,39,32,3,3,63,30,33
"2021","Shropshire 032A","E01028990",482,99,53,46,354,84,177,79,57,41,62,40,18,4,30,18,12,1,1,29,9,20
"2021","Shropshire 032B","E01028997",1144,395,298,97,710,270,305,170,80,55,69,38,27,4,64,33,31,2,2,39,14,25
"2021","Shropshire 032C","E01028998",1112,396,252,144,681,255,266,133,83,50,77,49,20,8,80,40,40,3,3,35,15,20
"2021","Shropshire 036A","E01028993",622,130,78,52,447,106,232,120,68,44,63,38,21,4,44,19,25,2,2,45,25,20
"2021","Shropshire 036C","E01029013",787,254,148,106,478,134,198,95,69,34,87,53,29,5,55,24,31,4,4,55,22,33
"2021","Shropshire 036D","E01029014",500,168,92,76,316,24,122,41,52,29,88,32,53,3,78,55,23,4,4,16,4,12
"2021","Shropshire 036F","E01035072",1043,235,126,109,762,197,386,203,104,79,127,74,46,7,52,22,30,0,0,46,18,28
"2021","Shropshire 037A","E01028994",553,167,108,59,373,100,170,86,40,44,68,30,29,9,32,16,16,3,3,13,7,6
"2021","Shropshire 037B","E01029003",1029,292,196,96,699,214,375,193,93,89,80,46,31,3,26,13,13,4,4,38,14,24
"2021","Shropshire 037C","E01029005",540,145,97,48,374,107,186,89,62,35,52,31,19,2,28,17,11,1,1,21,9,12
"2021","Shropshire 037D","E01029016",620,137,79,58,461,133,231,112,72,47,68,37,28,3,29,15,14,0,0,22,10,12
"2021","Shropshire 038A","E01029006",733,282,196,86,441,143,177,66,65,46,75,34,34,7,45,13,32,1,1,10,5,5
"2021","Shropshire 038B","E01029007",483,140,62,78,325,46,117,47,40,30,83,34,36,13,78,55,23,1,1,18,8,10
"2021","Shropshire 038D","E01029009",550,182,117,65,354,105,165,73,71,21,49,31,18,0,35,19,16,0,0,14,3,11
"2021","Shropshire 038E","E01029010",553,183,85,98,343,52,157,54,64,39,77,38,31,8,57,38,19,0,0,27,8,19
"2021","Shropshire 038F","E01029011",666,246,135,111,399,103,167,82,54,31,75,38,29,8,49,25,24,5,5,21,9,12
"2021","Shropshire 038G","E01029012",790,237,123,114,520,90,245,94,97,54,110,44,56,10,73,46,27,2,2,33,20,13
"2021","Shropshire 038H","E01033526",632,351,171,180,271,77,99,63,16,20,50,29,15,6,42,24,18,3,3,10,2,8
"2021","Shropshire 038I","E01033527",693,351,240,111,326,136,122,79,23,20,40,25,11,4,25,12,13,3,3,16,2,14
"2021","Shropshire 039A","E01028995",637,171,111,60,435,106,212,85,84,43,67,33,28,6,49,28,21,1,1,31,15,16
"2021","Shropshire 039B","E01028996",559,155,99,56,377,106,206,100,64,42,45,22,18,5,20,12,8,0,0,27,13,14
"2021","Shropshire 039C","E01028999",667,182,112,70,446,126,228,108,63,57,56,27,24,5,33,18,15,3,3,39,18,21
"2021","Shropshire 039D","E01029000",499,119,80,39,340,93,174,103,40,31,51,32,13,6,21,12,9,1,1,40,14,26
"2021","Shropshire 039E","E01029001",909,230,118,112,636,144,329,147,113,69,85,41,40,4,77,47,30,1,1,43,18,25
"2021","Shropshire 039F","E01029002",605,176,86,90,408,75,181,61,74,46,69,34,29,6,78,54,24,5,5,21,11,10
"2021","Cannock Chase 001A","E01029368",524,97,65,32,410,128,208,95,73,40,54,31,16,7,20,7,13,0,0,17,13,4
"2021","Cannock Chase 001B","E01029369",502,113,79,34,369,60,173,70,60,43,77,33,37,7,57,29,28,2,2,20,9,11
"2021","Cannock Chase 001C","E01029370",582,118,72,46,437,125,220,98,75,47,55,29,20,6,36,14,22,1,1,27,12,15
"2021","Cannock Chase 001D","E01029371",627,159,62,97,446,59,225,92,84,49,91,35,48,8,67,37,30,4,4,22,9,13
"2021","Cannock Chase 001E","E01029402",935,241,145,96,656,175,295,125,117,53,120,59,53,8,64,34,30,2,2,38,23,15
"2021","Cannock Chase 002A","E01029372",515,146,53,93,330,22,122,35,47,40,84,25,52,7,102,53,49,0,0,39,21,18
"2021","Cannock Chase 002B","E01029373",883,234,87,147,606,51,298,97,141,60,138,54,73,11,117,74,43,2,2,43,26,17
"2021","Cannock Chase 002C","E01029401",668,183,102,81,454,72,190,80,67,43,96,40,51,5,93,60,33,3,3,31,14,17
"2021","Cannock Chase 002D","E01029403",609,184,102,82,400,66,180,76,70,34,78,33,36,9,75,43,32,1,1,25,12,13
"2021","Cannock Chase 002E","E01029404",916,479,168,311,402,73,146,72,45,29,95,63,28,4,82,57,25,6,6,35,11,24
"2021","Cannock Chase 003A","E01029345",820,215,80,135,563,61,268,101,116,51,138,62,68,8,90,58,32,6,6,42,19,23
"2021","Cannock Chase 003B","E01029346",770,255,118,137,484,53,187,70,80,37,95,32,60,3,144,95,49,5,5,31,14,17
"2021","Cannock Chase 003C","E01029347",686,185,119,66,478,133,210,94,76,40,87,44,38,5,45,21,24,3,3,23,10,13
"2021","Cannock Chase 003D","E01029348",693,169,82,87,488,76,235,96,91,48,110,49,52,9,64,38,26,3,3,36,20,16
"2021","Cannock Chase 003E","E01029374",950,261,109,152,635,79,304,109,133,62,142,58,72,12,105,64,41,5,5,54,21,33
"2021","Cannock Chase 004A","E01029383",772,140,45,95,601,62,317,130,133,54,155,92,59,4,66,31,35,1,1,31,15,16
"2021","Cannock Chase 004B","E01029385",677,161,76,85,492,97,233,113,78,42,108,59,45,4,52,31,21,2,2,24,12,12
"2021","Cannock Chase 004C","E01029388",644,223,105,118,395,50,180,73,65,42,86,46,38,2,72,47,25,7,7,26,10,16
"2021","Cannock Chase 004D","E01029390",448,139,60,79,288,28,119,51,48,20,68,28,34,6,65,41,24,8,8,21,6,15
"2021","Cannock Chase 005B","E01029386",627,171,71,100,438,59,205,84,81,40,102,58,34,10,72,41,31,0,0,18,11,7
"2021","Cannock Chase 005C","E01029387",650,199,88,111,425,64,198,80,67,51,82,40,34,8,73,43,30,8,8,26,13,13
"2021","Cannock Chase 005D","E01029389",842,337,102,235,483,72,205,108,65,32,144,87,45,12,56,36,20,6,6,22,9,13
"2021","Cannock Chase 005E","E01034097",471,105,37,68,345,41,163,47,80,36,94,46,45,3,47,30,17,0,0,21,8,13
"2021","Cannock Chase 005F","E01034098",957,219,65,154,702,60,324,107,165,52,211,98,109,4,99,69,30,8,8,36,20,16
"2021","Cannock Chase 006A","E01029379",663,131,38,93,502,35,303,95,143,65,97,46,46,5,65,46,19,2,2,30,14,16
"2021","Cannock Chase 006B","E01029398",687,179,103,76,476,99,260,102,99,59,70,39,28,3,47,24,23,0,0,32,14,18
"2021","Cannock Chase 006C","E01029399",660,217,71,146,417,52,191,72,73,46,114,74,32,8,59,34,25,1,1,26,8,18
"2021","Cannock Chase 006D","E01029400",644,142,51,91,468,67,245,95,94,56,85,43,37,5,68,42,26,3,3,34,21,13
"2021","Cannock Chase 007A","E01029354",666,216,98,118,420,58,192,77,67,48,81,36,38,7,85,40,45,4,4,30,10,20
"2021","Cannock Chase 007B","E01029355",635,217,95,122,390,48,172,78,59,35,96,51,40,5,69,39,30,5,5,28,10,18
"2021","Cannock Chase 007C","E01029356",631,214,105,109,392,39,177,70,71,36,88,42,41,5,82,51,31,6,6,25,9,16
"2021","Cannock Chase 007D","E01029357",669,154,72,82,486,42,226,85,88,53,105,45,50,10,107,70,37,6,6,29,15,14
"2021","Cannock Chase 007E","E01029358",502,139,54,85,347,27,123,33,61,29,91,27,57,7,104,69,35,2,2,16,11,5
"2021","Cannock Chase 008A","E01029349",659,238,119,119,392,66,153,61,49,43,89,39,43,7,78,52,26,6,6,29,14,15
"2021","Cannock Chase 008B","E01029350",723,284,123,161,404,61,154,64,56,34,90,45,37,8,94,54,40,5,5,35,13,22
"2021","Cannock Chase 008C","E01029351",615,147,42,105,435,39,154,51,66,37,121,52,65,4,118,85,33,3,3,33,20,13
"2021","Cannock Chase 008D","E01029352",578,162,53,109,388,54,167,73,50,44,87,43,42,2,76,46,30,4,4,28,10,18
"2021","Cannock Chase 008E","E01029393",739,260,130,130,464,90,227,98,72,57,103,50,38,15,44,22,22,0,0,15,5,10
"2021","Cannock Chase 009A","E01029380",562,103,51,52,428,53,243,80,109,54,89,43,42,4,43,24,19,0,0,31,13,18
"2021","Cannock Chase 009B","E01029381",688,279,125,154,388,73,147,62,53,32,80,41,34,5,86,52,34,2,2,21,8,13
"2021","Cannock Chase 009C","E01029382",764,279,114,165,452,65,211,91,75,45,122,62,53,7,54,32,22,0,0,33,15,18
"2021","Cannock Chase 009D","E01029391",701,175,78,97,496,101,254,100,110,44,79,44,28,7,61,37,24,1,1,30,10,20
"2021","Cannock Chase 009E","E01029392",841,155,67,88,654,80,330,92,160,78,152,81,64,7,87,59,28,5,5,32,10,22
"2021","Cannock Chase 010A","E01029375",888,125,37,88,719,83,411,126,211,74,137,67,66,4,85,64,21,3,3,44,23,21
"2021","Cannock Chase 010B","E01029376",720,189,37,152,520,31,261,79,109,73,138,71,58,9,87,67,20,3,3,11,5,6
"2021","Cannock Chase 010C","E01029377",512,71,22,49,429,26,277,91,123,63,89,51,33,5,36,23,13,1,1,12,8,4
"2021","Cannock Chase 010D","E01029378",655,143,53,90,498,49,263,99,108,56,121,68,46,7,65,40,25,0,0,14,7,7
"2021","Cannock Chase 011A","E01029353",682,271,137,134,388,103,159,72,52,35,67,39,23,5,57,28,29,2,2,23,13,10
"2021","Cannock Chase 011B","E01029364",750,244,126,118,478,105,228,91,81,56,86,46,38,2,52,27,25,7,7,28,13,15
"2021","Cannock Chase 011C","E01029365",709,246,139,107,435,85,201,79,83,39,97,51,40,6,48,25,23,4,4,28,10,18
"2021","Cannock Chase 011D","E01029366",767,192,143,49,543,186,263,103,92,68,57,29,25,3,33,10,23,4,4,32,19,13
"2021","Cannock Chase 011E","E01029367",1004,353,144,209,609,113,281,98,118,65,112,56,50,6,98,66,32,5,5,42,18,24
"2021","Cannock Chase 012A","E01029359",1103,405,110,295,671,40,229,73,115,41,244,113,124,7,149,110,39,9,9,27,11,16
"2021","Cannock Chase 012B","E01029360",719,289,130,159,400,65,154,56,58,40,99,50,42,7,74,52,22,8,8,30,13,17
"2021","Cannock Chase 012C","E01029361",626,208,83,125,383,65,160,59,52,49,82,36,39,7,66,41,25,10,10,35,16,19
"2021","Cannock Chase 012D","E01029362",728,238,64,174,448,35,165,66,63,36,121,56,57,8,115,72,43,12,12,42,16,26
"2021","Cannock Chase 012E","E01029363",669,269,132,137,379,69,157,68,57,32,97,47,45,5,56,26,30,0,0,21,7,14
"2021","Cannock Chase 013A","E01029394",666,173,105,68,465,120,214,104,68,42,86,39,41,6,45,23,22,0,0,28,12,16
"2021","Cannock Chase 013B","E01029395",1082,262,112,150,783,108,322,118,150,54,248,136,103,9,101,71,30,4,4,37,21,16
"2021","Cannock Chase 013C","E01029396",740,211,92,119,509,89,250,114,88,48,101,60,32,9,66,37,29,3,3,20,7,13
"2021","Cannock Chase 013D","E01029397",1036,262,111,151,723,57,354,107,166,81,161,75,74,12,149,109,40,2,2,51,27,24
"2021","East Staffordshire 001A","E01029405",655,149,79,70,475,102,268,105,111,52,65,35,30,0,40,20,20,0,0,31,13,18
"2021","East Staffordshire 001B","E01029406",491,81,38,43,379,79,235,87,91,57,44,22,17,5,18,12,6,3,3,31,13,18
"2021","East Staffordshire 001C","E01029422",453,119,73,46,312,75,171,64,74,33,33,15,15,3,32,15,17,1,1,22,10,12
"2021","East Staffordshire 001D","E01029423",682,207,97,110,453,54,207,94,69,44,103,47,52,4,85,56,29,4,4,22,12,10
"2021","East Staffordshire 001E","E01029467",910,245,133,112,642,138,332,153,106,73,108,63,37,8,60,26,34,4,4,23,9,14
"2021","East Staffordshire 002A","E01029430",1017,223,99,124,767,90,385,127,201,57,192,107,78,7,98,70,28,2,2,27,12,15
"2021","East Staffordshire 002B","E01029431",681,206,84,122,447,39,198,60,89,49,106,46,55,5,101,68,33,3,3,28,11,17
"2021","East Staffordshire 002C","E01029432",621,173,109,64,438,98,215,91,83,41,69,35,28,6,55,30,25,1,1,10,1,9
"2021","East Staffordshire 002D","E01029433",606,168,79,89,404,35,187,75,72,40,90,36,45,9,86,61,25,6,6,34,14,20
"2021","East Staffordshire 003A","E01029459",648,161,63,98,473,57,261,88,128,45,102,53,43,6,51,33,18,2,2,14,7,7
"2021","East Staffordshire 003B","E01029460",831,327,168,159,477,89,240,83,112,45,92,55,30,7,53,33,20,3,3,27,7,20
"2021","East Staffordshire 003C","E01029461",872,285,116,169,539,59,265,101,114,50,132,78,48,6,80,48,32,3,3,48,14,34
"2021","East Staffordshire 003D","E01029462",727,230,115,115,470,78,216,92,86,38,99,57,37,5,73,49,24,4,4,27,12,15
"2021","East Staffordshire 004A","E01029443",730,183,113,70,529,151,276,100,130,46,50,31,17,2,52,25,27,0,0,18,6,12
"2021","East Staffordshire 004B","E01029444",719,226,151,75,476,135,226,100,82,44,57,32,21,4,55,28,27,3,3,17,10,7
"2021","East Staffordshire 004C","E01029463",501,102,64,38,376,79,212,78,92,42,55,25,26,4,28,12,16,2,2,23,10,13
"2021","East Staffordshire 004D","E01029464",708,236,129,107,444,76,184,70,73,41,98,52,38,8,80,50,30,6,6,28,11,17
"2021","East Staffordshire 004E","E01029465",967,270,127,143,679,126,360,158,144,58,116,71,42,3,71,49,22,6,6,18,7,11
"2021","East Staffordshire 004F","E01029466",880,145,70,75,698,89,395,141,197,57,144,78,58,8,69,48,21,1,1,37,21,16
"2021","East Staffordshire 005A","E01029454",637,113,78,35,508,132,301,146,104,51,40,23,17,0,34,19,15,1,1,16,7,9
"2021","East Staffordshire 005B","E01029455",744,185,119,66,535,101,289,115,115,59,84,49,28,7,59,26,33,2,2,24,16,8
"2021","East Staffordshire 005C","E01029456",739,311,163,148,413,106,161,78,50,33,85,54,26,5,61,42,19,0,0,15,6,9
"2021","East Staffordshire 005D","E01029457",537,138,50,88,381,40,236,101,88,47,70,36,29,5,35,15,20,0,0,18,12,6
"2021","East Staffordshire 005E","E01029458",759,182,100,82,551,94,300,121,125,54,93,44,45,4,63,41,22,1,1,26,9,17
"2021","East Staffordshire 006A","E01029411",570,108,70,38,435,96,253,105,106,42,49,22,15,12,34,17,17,3,3,27,15,12
"2021","East Staffordshire 006B","E01029412",610,175,104,71,421,104,225,97,93,35,44,30,11,3,47,25,22,1,1,14,7,7
"2021","East Staffordshire 006C","E01029424",434,113,73,40,298,77,168,82,56,30,37,23,12,2,16,9,7,0,0,23,10,13
"2021","East Staffordshire 006D","E01029425",624,131,73,58,458,98,257,118,90,49,68,35,26,7,34,16,18,1,1,35,16,19
"2021","East Staffordshire 006E","E01029473",622,123,81,42,468,91,291,116,119,56,48,27,18,3,34,16,18,4,4,31,11,20
"2021","East Staffordshire 006F","E01029474",520,145,104,41,369,97,198,71,90,37,39,25,11,3,32,15,17,3,3,6,4,2
"2021","East Staffordshire 007A","E01029434",641,182,77,105,396,25,196,69,95,32,77,30,41,6,93,62,31,5,5,63,24,39
"2021","East Staffordshire 007B","E01029435",635,194,115,79,406,74,203,94,69,40,65,36,26,3,60,35,25,4,4,35,11,24
"2021","East Staffordshire 007C","E01029436",821,334,112,222,427,36,181,65,87,29,75,36,36,3,125,84,41,10,10,60,32,28
"2021","East Staffordshire 007D","E01029437",1051,295,123,172,699,36,312,86,172,54,156,61,92,3,186,134,52,9,9,57,32,25
"2021","East Staffordshire 007E","E01029438",637,169,99,70,448,92,210,98,75,37,72,37,29,6,70,41,29,4,4,20,9,11
"2021","East Staffordshire 008A","E01029426",921,305,72,233,534,16,248,70,150,28,130,74,51,5,132,96,36,8,8,82,47,35
"2021","East Staffordshire 008B","E01029427",718,242,79,163,426,24,182,57,94,31,83,30,48,5,129,87,42,8,8,50,29,21
"2021","East Staffordshire 008C","E01029428",954,212,63,149,678,34,317,90,182,45,215,108,98,9,106,74,32,6,6,64,31,33
"2021","East Staffordshire 008D","E01029429",487,105,34,71,313,30,164,36,90,38,54,24,23,7,55,37,18,10,10,69,38,31
"2021","East Staffordshire 009A","E01029445",1054,348,59,289,614,18,272,65,171,36,167,108,55,4,137,98,39,20,20,92,42,50
"2021","East Staffordshire 009B","E01029446",905,286,94,192,562,75,276,87,140,49,109,64,41,4,97,64,33,5,5,57,28,29
"2021","East Staffordshire 009C","E01029447",604,167,26,141,361,11,212,45,129,38,55,33,20,2,70,43,27,13,13,76,40,36
"2021","East Staffordshire 009D","E01029448",762,298,134,164,390,39,187,55,102,30,78,41,36,1,71,44,27,15,15,74,41,33
"2021","East Staffordshire 010A","E01029468",687,255,118,137,396,35,157,48,83,26,77,30,43,4,124,101,23,3,3,36,21,15
"2021","East Staffordshire 010B","E01029469",779,200,124,76,544,121,274,121,95,58,84,44,32,8,63,35,28,2,2,35,17,18
"2021","East Staffordshire 010C","E01029470",632,138,55,83,456,56,219,71,99,49,107,50,51,6,71,43,28,3,3,38,19,19
"2021","East Staffordshire 010D","E01029471",722,224,87,137,459,73,239,89,110,40,98,53,39,6,44,25,19,5,5,39,14,25
"2021","East Staffordshire 010E","E01029472",638,160,87,73,453,82,197,75,83,39,87,38,40,9,86,52,34,1,1,25,15,10
"2021","East Staffordshire 011A","E01029407",589,163,66,97,346,24,175,37,108,30,62,31,26,5,70,46,24,15,15,80,46,34
"2021","East Staffordshire 011B","E01029408",882,227,62,165,544,22,260,70,154,36,95,60,29,6,150,113,37,17,17,111,49,62
"2021","East Staffordshire 011C","E01029409",793,271,62,209,421,17,185,50,108,27,115,55,56,4,88,62,26,16,16,101,54,47
"2021","East Staffordshire 011D","E01029410",625,170,46,124,374,29,192,52,112,28,67,39,23,5,75,54,21,11,11,81,44,37
"2021","East Staffordshire 011F","E01032896",696,283,35,248,350,10,110,48,49,13,142,89,48,5,71,46,25,17,17,63,17,46
"2021","East Staffordshire 011G","E01032897",708,230,77,153,440,37,201,71,106,24,133,70,61,2,68,46,22,1,1,38,17,21
"2021","East Staffordshire 011H","E01032898",595,277,71,206,244,13,75,25,40,10,84,49,28,7,60,43,17,12,12,74,25,49
"2021","East Staffordshire 012A","E01029418",829,171,82,89,614,118,361,156,133,72,94,49,36,9,41,19,22,0,0,44,22,22
"2021","East Staffordshire 012B","E01029419",695,199,97,102,472,95,251,98,92,61,74,38,33,3,51,34,17,1,1,24,15,9
"2021","East Staffordshire 012C","E01029420",733,221,132,89,480,93,220,93,91,36,99,51,40,8,67,43,24,1,1,32,10,22
"2021","East Staffordshire 013A","E01029413",653,220,109,111,405,80,196,68,84,44,60,35,21,4,65,36,29,4,4,28,10,18
"2021","East Staffordshire 013B","E01029414",685,192,80,112,447,53,253,100,109,44,85,49,32,4,50,29,21,6,6,46,22,24
"2021","East Staffordshire 013C","E01029415",629,127,43,84,459,20,278,97,129,52,102,54,45,3,57,38,19,2,2,43,22,21
"2021","East Staffordshire 013D","E01029416",1003,235,90,145,719,81,344,120,178,46,222,138,79,5,69,45,24,3,3,49,28,21
"2021","East Staffordshire 013E","E01029417",809,144,69,75,641,95,319,110,171,38,153,90,60,3,70,45,25,4,4,24,14,10
"2021","East Staffordshire 014A","E01029449",726,210,97,113,476,71,216,100,76,40,101,50,50,1,82,43,39,6,6,40,19,21
"2021","East Staffordshire 014B","E01029450",638,211,78,133,389,42,173,50,86,37,78,29,41,8,91,58,33,5,5,38,20,18
"2021","East Staffordshire 014C","E01029451",875,382,163,219,459,61,166,74,56,36,114,56,48,10,110,70,40,8,8,34,14,20
"2021","East Staffordshire 014D","E01029452",762,304,106,198,429,47,177,75,62,40,102,37,51,14,96,61,35,7,7,29,15,14
"2021","East Staffordshire 014E","E01029453",687,250,93,157,399,40,151,55,71,25,81,34,38,9,117,74,43,10,10,38,17,21
"2021","East Staffordshire 015A","E01029439",623,182,134,48,427,110,212,81,92,39,53,24,25,4,50,19,31,2,2,14,7,7
"2021","East Staffordshire 015B","E01029440",521,121,68,53,375,81,218,73,98,47,43,24,15,4,32,23,9,1,1,25,16,9
"2021","East Staffordshire 015C","E01029441",737,244,140,104,475,114,246,98,99,49,65,36,26,3,49,28,21,1,1,18,7,11
"2021","East Staffordshire 015D","E01029442",655,148,84,64,493,87,318,75,201,42,54,25,26,3,34,25,9,0,0,14,9,5
"2021","Lichfield 001A","E01029480",828,209,82,127,572,80,282,118,121,43,118,62,47,9,87,45,42,5,5,47,23,24
"2021","Lichfield 001C","E01029482",676,171,92,79,474,84,217,83,83,51,96,59,30,7,73,49,24,4,4,31,14,17
"2021","Lichfield 001D","E01029498",842,202,113,89,601,141,318,136,118,64,88,51,33,4,51,18,33,3,3,39,17,22
"2021","Lichfield 001E","E01034099",653,151,12,139,483,19,264,69,173,22,126,59,66,1,72,58,14,2,2,19,10,9
"2021","Lichfield 001F","E01034100",772,283,165,118,469,115,206,100,75,31,81,60,19,2,59,35,24,8,8,20,10,10
"2021","Lichfield 002A","E01029477",697,163,95,68,514,143,285,123,114,48,59,34,21,4,24,14,10,3,3,20,7,13
"2021","Lichfield 002B","E01029478",649,178,124,54,445,99,209,69,99,41,63,30,32,1,67,35,32,7,7,26,13,13
"2021","Lichfield 002D","E01029509",707,159,107,52,520,141,284,126,102,56,59,33,17,9,34,19,15,2,2,28,11,17
"2021","Lichfield 002E","E01034101",764,171,85,86,571,89,311,96,161,54,83,42,34,7,85,45,40,3,3,22,9,13
"2021","Lichfield 002F","E01034102",644,125,25,100,491,16,275,78,169,28,140,80,54,6,55,39,16,5,5,28,15,13
"2021","Lichfield 003A","E01029486",616,163,102,61,427,118,200,68,75,57,60,25,30,5,47,28,19,2,2,26,15,11
"2021","Lichfield 003B","E01029507",654,111,57,54,524,132,306,116,119,71,52,26,25,1,33,20,13,1,1,19,7,12
"2021","Lichfield 003C","E01029508",944,236,116,120,682,157,368,116,164,88,90,39,45,6,65,38,27,2,2,26,14,12
"2021","Lichfield 003D","E01029515",799,182,110,72,575,162,309,132,107,70,67,36,20,11,36,13,23,1,1,42,21,21
"2021","Lichfield 004A","E01029492",779,201,63,138,539,54,187,59,83,45,105,31,74,0,188,144,44,5,5,39,22,17
"2021","Lichfield 004B","E01029499",759,299,133,166,439,40,167,53,68,46,95,40,42,13,135,77,58,2,2,21,10,11
"2021","Lichfield 004C","E01029501",633,138,65,73,469,94,207,70,77,60,75,26,40,9,93,63,30,0,0,26,12,14
"2021","Lichfield 004E","E01029526",988,542,260,282,417,101,165,88,53,24,81,63,13,5,64,28,36,6,6,29,13,16
"2021","Lichfield 004F","E01032899",1048,563,362,201,465,136,189,96,72,21,79,62,16,1,55,31,24,6,6,20,4,16
"2021","Lichfield 004G","E01032900",850,222,51,171,597,44,281,87,163,31,152,85,59,8,118,89,29,2,2,31,12,19
"2021","Lichfield 005A","E01029483",627,130,88,42,475,152,265,92,129,44,33,17,14,2,22,13,9,3,3,22,11,11
"2021","Lichfield 005B","E01029484",841,346,156,190,472,117,210,83,93,34,92,63,25,4,51,23,28,2,2,23,5,18
"2021","Lichfield 005C","E01029485",655,195,103,92,448,111,232,96,92,44,57,39,18,0,48,25,23,0,0,12,4,8
"2021","Lichfield 005D","E01029500",736,237,117,120,474,108,240,96,95,49,72,41,28,3,51,17,34,3,3,25,9,16
"2021","Lichfield 005E","E01029520",607,97,71,26,491,141,304,103,144,57,32,17,14,1,14,6,8,0,0,19,14,5
"2021","Lichfield 005F","E01029524",780,272,99,173,466,96,210,75,96,39,97,53,40,4,58,31,27,5,5,42,14,28
"2021","Lichfield 005G","E01029525",863,255,149,106,569,143,242,116,71,55,103,62,38,3,76,29,47,5,5,39,13,26
"2021","Lichfield 006A","E01029487",744,254,119,135,470,74,181,69,67,45,97,43,42,12,115,69,46,3,3,20,8,12
"2021","Lichfield 006B","E01029493",804,206,100,106,572,108,293,116,119,58,97,53,39,5,72,41,31,2,2,26,13,13
"2021","Lichfield 006C","E01029494",685,216,107,109,446,77,203,77,79,47,96,39,48,9,65,39,26,5,5,23,7,16
"2021","Lichfield 006D","E01029495",675,159,99,60,491,108,246,89,113,44,79,32,44,3,58,19,39,0,0,25,13,12
"2021","Lichfield 006F","E01034103",586,211,64,147,359,26,149,64,63,22,111,52,54,5,72,49,23,1,1,16,6,10
"2021","Lichfield 006G","E01034104",755,185,95,90,542,94,263,71,146,46,128,70,50,8,56,35,21,1,1,28,11,17
"2021","Lichfield 007A","E01029491",782,252,123,129,498,93,213,77,97,39,106,50,52,4,80,46,34,6,6,32,13,19
"2021","Lichfield 007B","E01029511",696,199,121,78,477,119,240,73,118,49,70,38,28,4,45,25,20,3,3,20,7,13
"2021","Lichfield 007C","E01029512",910,241,111,130,634,111,333,101,180,52,111,59,44,8,78,54,24,1,1,35,16,19
"2021","Lichfield 007D","E01029518",1170,310,137,173,818,146,425,121,235,69,149,92,50,7,93,55,38,5,5,42,16,26
"2021","Lichfield 007E","E01029519",980,332,119,213,609,99,276,91,138,47,126,89,33,4,104,70,34,4,4,39,12,27
"2021","Lichfield 008A","E01029516",832,180,85,95,617,126,322,144,116,62,107,46,52,9,60,33,27,2,2,35,13,22
"2021","Lichfield 008B","E01029517",862,190,94,96,640,120,332,125,152,55,120,64,52,4,65,42,23,3,3,32,16,16
"2021","Lichfield 008D","E01029531",697,164,123,41,510,141,301,103,129,69,35,16,16,3,29,16,13,4,4,23,9,14
"2021","Lichfield 008E","E01034105",668,120,14,106,532,12,203,66,120,17,235,161,73,1,78,60,18,4,4,16,7,9
"2021","Lichfield 008F","E01034106",706,161,61,100,521,73,295,95,165,35,78,44,28,6,72,47,25,3,3,24,10,14
"2021","Lichfield 009A","E01029475",884,232,141,91,634,153,285,99,124,62,110,54,49,7,84,43,41,2,2,18,9,9
"2021","Lichfield 009B","E01029476",623,192,123,69,410,96,193,64,82,47,57,32,19,6,61,31,30,3,3,21,13,8
"2021","Lichfield 009C","E01029489",662,178,138,40,462,144,213,78,71,64,61,32,21,8,44,16,28,0,0,22,10,12
"2021","Lichfield 009D","E01029490",631,182,97,85,424,87,193,73,76,44,85,45,31,9,56,23,33,3,3,25,13,12
"2021","Lichfield 009E","E01029505",673,166,96,70,478,113,239,95,96,48,77,44,25,8,44,18,26,5,5,29,10,19
"2021","Lichfield 009F","E01029506",761,172,133,39,561,211,237,79,88,70,62,35,19,8,48,15,33,3,3,28,9,19
"2021","Lichfield 010A","E01029496",825,263,93,170,527,50,200,75,80,45,124,44,71,9,146,96,50,7,7,35,20,15
"2021","Lichfield 010B","E01029527",550,186,89,97,352,49,140,55,50,35,77,36,37,4,86,61,25,0,0,12,5,7
"2021","Lichfield 010C","E01029528",545,145,79,66,374,55,168,60,68,40,75,33,35,7,75,47,28,1,1,26,15,11
"2021","Lichfield 010D","E01029529",502,123,51,72,364,35,164,51,77,36,95,38,48,9,67,43,24,3,3,15,9,6
"2021","Lichfield 011A","E01029513",516,84,59,25,388,108,249,72,112,65,19,7,10,2,10,4,6,2,2,44,28,16
"2021","Lichfield 011B","E01029514",630,131,91,40,454,122,268,98,104,66,34,18,14,2,29,13,16,1,1,45,27,18
"2021","Lichfield 011C","E01029521",721,162,106,56,521,152,285,109,119,57,53,25,23,5,30,13,17,1,1,38,19,19
"2021","Lichfield 011D","E01029522",649,167,89,78,453,101,216,64,104,48,74,44,25,5,58,31,27,4,4,29,13,16
"2021","Lichfield 011E","E01029523",656,144,95,49,489,123,264,98,117,49,70,31,27,12,30,12,18,2,2,23,10,13
"2021","Lichfield 012A","E01029488",696,122,71,51,534,96,288,111,105,72,87,44,38,5,63,35,28,0,0,40,16,24
"2021","Lichfield 012B","E01029502",668,152,82,70,487,77,228,74,95,59,97,40,47,10,83,51,32,2,2,29,15,14
"2021","Lichfield 012C","E01029503",664,159,104,55,472,99,229,93,83,53,75,32,39,4,66,34,32,3,3,33,17,16
"2021","Lichfield 012D","E01029504",806,321,116,205,453,62,185,70,79,36,102,52,41,9,98,71,27,6,6,32,15,17
"2021","Newcastle-under-Lyme 001A","E01029562",523,129,56,73,381,74,188,67,67,54,72,43,27,2,46,28,18,1,1,13,10,3
"2021","Newcastle-under-Lyme 001B","E01029565",468,90,34,56,363,59,223,90,78,55,51,36,12,3,30,19,11,0,0,15,7,8
"2021","Newcastle-under-Lyme 001C","E01029581",686,173,96,77,481,84,240,106,89,45,108,58,44,6,49,22,27,0,0,32,13,19
"2021","Newcastle-under-Lyme 001D","E01029582",781,192,106,86,558,105,288,131,103,54,97,49,39,9,67,36,31,1,1,31,19,12
"2021","Newcastle-under-Lyme 001E","E01029586",532,115,65,50,404,125,193,97,54,42,51,23,22,6,31,13,18,4,4,13,4,9
"2021","Newcastle-under-Lyme 001F","E01029587",536,162,82,80,365,82,173,74,69,30,77,43,26,8,32,17,15,1,1,9,2,7
"2021","Newcastle-under-Lyme 002A","E01029561",596,163,94,69,416,57,160,63,58,39,105,36,57,12,93,66,27,1,1,17,6,11
"2021","Newcastle-under-Lyme 002B","E01029563",594,181,109,72,400,86,196,84,60,52,78,38,38,2,40,21,19,0,0,13,6,7
"2021","Newcastle-under-Lyme 002C","E01029564",527,141,60,81,361,37,141,32,68,41,79,31,46,2,100,67,33,4,4,25,17,8
"2021","Newcastle-under-Lyme 002D","E01029588",778,300,124,176,450,70,210,96,68,46,99,54,39,6,70,53,17,1,1,28,14,14
"2021","Newcastle-under-Lyme 003A","E01029540",612,200,136,64,394,97,180,83,53,44,63,26,30,7,52,29,23,2,2,18,8,10
"2021","Newcastle-under-Lyme 003B","E01029541",746,190,84,106,518,53,206,70,96,40,144,59,72,13,111,85,26,4,4,38,16,22
"2021","Newcastle-under-Lyme 003C","E01029542",761,256,100,156,472,68,186,84,69,33,126,71,53,2,89,61,28,3,3,33,14,19
"2021","Newcastle-under-Lyme 003D","E01029543",492,128,68,60,335,32,139,57,55,27,75,30,40,5,89,49,40,0,0,29,18,11
"2021","Newcastle-under-Lyme 003E","E01029595",590,193,89,104,374,123,167,90,48,29,59,40,18,1,24,14,10,1,1,23,6,17
"2021","Newcastle-under-Lyme 003F","E01029597",618,189,87,102,393,45,177,59,72,46,89,33,52,4,79,42,37,3,3,36,16,20
"2021","Newcastle-under-Lyme 004A","E01029536",655,187,110,77,453,121,221,92,84,45,75,41,25,9,35,17,18,1,1,15,8,7
"2021","Newcastle-under-Lyme 004B","E01029544",539,133,63,70,391,28,249,95,95,59,71,34,34,3,43,27,16,0,0,15,7,8
"2021","Newcastle-under-Lyme 004C","E01029545",610,144,71,73,436,58,226,106,84,36,85,38,40,7,65,42,23,2,2,30,13,17
"2021","Newcastle-under-Lyme 004D","E01029546",476,82,22,60,377,35,245,85,104,56,57,27,24,6,40,27,13,0,0,17,10,7
"2021","Newcastle-under-Lyme 004E","E01029596",497,161,108,53,322,101,146,72,32,42,41,25,14,2,33,7,26,1,1,14,7,7
"2021","Newcastle-under-Lyme 005A","E01029532",637,181,91,90,425,77,212,87,80,45,90,46,34,10,43,31,12,3,3,31,16,15
"2021","Newcastle-under-Lyme 005B","E01029533",639,162,92,70,450,98,209,92,74,43,73,40,30,3,68,42,26,2,2,27,12,15
"2021","Newcastle-under-Lyme 005C","E01029534",690,225,115,110,451,109,210,96,74,40,85,46,30,9,46,20,26,1,1,14,4,10
"2021","Newcastle-under-Lyme 005D","E01029535",606,209,76,133,375,34,173,64,74,35,91,35,47,9,73,48,25,4,4,22,13,9
"2021","Newcastle-under-Lyme 005E","E01029556",1120,336,181,155,739,126,361,160,128,73,153,77,60,16,98,52,46,1,1,45,18,27
"2021","Newcastle-under-Lyme 006A","E01029537",629,156,69,87,454,56,221,69,95,57,89,39,46,4,85,53,32,3,3,19,8,11
"2021","Newcastle-under-Lyme 006B","E01029538",666,201,75,126,441,53,195,68,91,36,95,41,42,12,97,70,27,1,1,24,8,16
"2021","Newcastle-under-Lyme 006C","E01029539",610,150,81,69,441,72,219,81,80,58,78,28,42,8,69,36,33,3,3,19,12,7
"2021","Newcastle-under-Lyme 006D","E01029552",618,149,74,75,437,65,187,72,72,43,98,56,31,11,80,50,30,7,7,32,11,21
"2021","Newcastle-under-Lyme 006E","E01029558",674,150,60,90,488,49,191,57,80,54,110,39,61,10,132,90,42,6,6,36,19,17
"2021","Newcastle-under-Lyme 007A","E01029547",645,235,70,165,378,20,136,47,66,23,122,47,69,6,93,64,29,7,7,32,15,17
"2021","Newcastle-under-Lyme 007B","E01029548",582,195,89,106,359,41,140,66,48,26,70,26,39,5,105,73,32,3,3,28,9,19
"2021","Newcastle-under-Lyme 007C","E01029559",601,165,63,102,405,41,185,81,60,44,114,47,56,11,62,41,21,3,3,31,14,17
"2021","Newcastle-under-Lyme 007D","E01029560",649,191,63,128,421,37,140,45,69,26,98,39,50,9,140,94,46,6,6,37,17,20
"2021","Newcastle-under-Lyme 007E","E01029568",623,228,106,122,366,61,150,64,52,34,96,34,54,8,56,33,23,3,3,29,8,21
"2021","Newcastle-under-Lyme 008A","E01029583",682,289,122,167,376,54,182,79,63,40,90,53,31,6,47,28,19,3,3,17,8,9
"2021","Newcastle-under-Lyme 008B","E01029584",531,166,81,85,339,52,162,60,71,31,80,45,30,5,40,25,15,5,5,26,12,14
"2021","Newcastle-under-Lyme 008C","E01029585",637,241,84,157,368,61,155,59,62,34,83,43,36,4,66,40,26,3,3,28,11,17
"2021","Newcastle-under-Lyme 008D","E01029609",801,323,127,196,456,73,187,75,74,38,120,77,40,3,73,43,30,3,3,22,14,8
"2021","Newcastle-under-Lyme 008E","E01029611",874,323,115,208,524,39,200,70,94,36,167,84,77,6,114,78,36,4,4,27,11,16
"2021","Newcastle-under-Lyme 009A","E01029577",692,216,105,111,452,70,209,89,83,37,105,62,28,15,62,41,21,6,6,24,9,15
"2021","Newcastle-under-Lyme 009B","E01029579",763,252,121,131,496,98,216,88,94,34,109,61,43,5,70,45,25,3,3,15,5,10
"2021","Newcastle-under-Lyme 009C","E01029580",596,160,70,90,418,71,217,77,98,42,83,47,28,8,44,23,21,3,3,18,6,12
"2021","Newcastle-under-Lyme 009D","E01029610",596,184,59,125,390,49,202,88,77,37,75,35,37,3,60,38,22,4,4,22,7,15
"2021","Newcastle-under-Lyme 009E","E01029612",504,142,82,60,347,80,177,70,70,37,51,29,19,3,37,16,21,2,2,15,6,9
"2021","Newcastle-under-Lyme 010A","E01029553",692,211,86,125,440,41,201,61,103,37,94,40,49,5,101,72,29,3,3,41,20,21
"2021","Newcastle-under-Lyme 010B","E01029554",833,326,132,194,457,46,178,56,93,29,133,72,56,5,92,60,32,8,8,50,18,32
"2021","Newcastle-under-Lyme 010C","E01029566",477,100,31,69,354,24,112,37,67,8,104,30,65,9,113,100,13,1,1,23,13,10
"2021","Newcastle-under-Lyme 010D","E01029567",765,269,91,178,447,57,179,80,63,36,121,62,49,10,86,54,32,4,4,49,14,35
"2021","Newcastle-under-Lyme 010E","E01029598",835,210,79,131,516,43,204,60,97,47,132,68,52,12,133,96,37,4,4,109,21,88
"2021","Newcastle-under-Lyme 010F","E01029599",709,314,154,160,355,56,146,54,62,30,68,27,33,8,79,52,27,6,6,40,9,31
"2021","Newcastle-under-Lyme 011A","E01029555",795,283,102,181,425,48,179,78,76,25,94,55,36,3,92,66,26,12,12,87,10,77
"2021","Newcastle-under-Lyme 011B","E01029578",823,391,150,241,406,79,200,67,87,46,72,41,26,5,53,29,24,2,2,26,7,19
"2021","Newcastle-under-Lyme 011C","E01029602",831,396,134,262,312,39,121,64,45,12,76,53,20,3,62,37,25,14,14,123,11,112
"2021","Newcastle-under-Lyme 011D","E01029603",706,308,86,222,335,52,134,56,56,22,70,48,21,1,74,36,38,5,5,63,12,51
"2021","Newcastle-under-Lyme 011E","E01029604",842,474,120,354,279,33,89,42,27,20,75,56,17,2,71,46,25,11,11,89,5,84
"2021","Newcastle-under-Lyme 012A","E01029576",501,134,70,64,340,67,180,72,79,29,63,41,19,3,28,18,10,2,2,27,14,13
"2021","Newcastle-under-Lyme 012B","E01029593",1048,306,110,196,675,61,326,112,156,58,141,50,81,10,142,97,45,5,5,67,25,42
"2021","Newcastle-under-Lyme 012C","E01029594",880,328,168,160,506,97,210,105,72,33,107,49,49,9,86,53,33,6,6,46,13,33
"2021","Newcastle-under-Lyme 013A","E01029557",560,153,84,69,388,112,185,72,68,45,52,31,17,4,39,20,19,0,0,19,9,10
"2021","Newcastle-under-Lyme 013B","E01029573",618,183,95,88,415,87,225,72,104,49,65,31,28,6,38,23,15,0,0,20,8,12
"2021","Newcastle-under-Lyme 013C","E01029574",685,247,158,89,411,98,201,82,74,45,61,36,23,2,51,25,26,0,0,27,14,13
"2021","Newcastle-under-Lyme 013D","E01029575",462,135,71,64,306,43,123,54,41,28,66,30,32,4,69,44,25,5,5,21,11,10
"2021","Newcastle-under-Lyme 014A","E01029549",769,298,160,138,443,94,180,83,71,26,88,43,39,6,75,49,26,6,6,28,14,14
"2021","Newcastle-under-Lyme 014B","E01029551",649,147,71,76,455,76,240,85,111,44,82,44,31,7,56,30,26,1,1,47,13,34
"2021","Newcastle-under-Lyme 014C","E01029591",730,318,140,178,393,53,160,50,77,33,72,28,39,5,108,79,29,0,0,19,8,11
"2021","Newcastle-under-Lyme 014D","E01029600",648,176,105,71,433,112,209,73,98,38,68,38,26,4,44,21,23,0,0,39,7,32
"2021","Newcastle-under-Lyme 014E","E01029605",556,134,73,61,377,84,197,65,91,41,64,33,26,5,30,16,14,2,2,45,11,34
"2021","Newcastle-under-Lyme 014F","E01029607",628,205,103,102,410,68,181,52,91,38,62,23,33,6,95,53,42,4,4,13,4,9
"2021","Newcastle-under-Lyme 015B","E01029589",513,116,78,38,378,104,214,99,82,33,36,19,14,3,21,10,11,3,3,19,9,10
"2021","Newcastle-under-Lyme 015C","E01029590",601,158,109,49,424,115,203,78,76,49,41,17,20,4,64,40,24,1,1,19,11,8
"2021","Newcastle-under-Lyme 015E","E01029601",669,220,145,75,422,136,189,64,90,35,57,29,27,1,40,20,20,0,0,27,9,18
"2021","Newcastle-under-Lyme 015F","E01029606",576,123,89,34,426,73,274,90,132,52,52,21,25,6,25,10,15,2,2,27,8,19
"2021","Newcastle-under-Lyme 015G","E01029608",640,184,116,68,420,140,230,78,105,47,28,12,13,3,19,6,13,3,3,36,16,20
"2021","Newcastle-under-Lyme 015H","E01033257",1109,343,161,182,735,134,403,150,171,82,118,79,31,8,75,40,35,5,5,31,14,17
"2021","Newcastle-under-Lyme 016A","E01029569",647,170,92,78,449,107,228,113,76,39,64,36,19,9,43,19,24,7,7,28,11,17
"2021","Newcastle-under-Lyme 016B","E01029570",1138,253,152,101,836,189,451,199,171,81,137,91,42,4,55,29,26,4,4,49,25,24
"2021","Newcastle-under-Lyme 016C","E01029571",552,127,74,53,396,115,203,111,53,39,41,23,13,5,36,17,19,1,1,29,10,19
"2021","Newcastle-under-Lyme 016D","E01029572",656,127,83,44,493,142,272,114,108,50,52,23,22,7,26,12,14,1,1,36,16,20
"2021","South Staffordshire 001A","E01029655",870,258,164,94,582,167,258,98,98,62,75,36,32,7,76,48,28,6,6,30,17,13
"2021","South Staffordshire 001B","E01029656",747,155,89,66,551,150,291,123,98,70,75,45,24,6,34,21,13,1,1,41,16,25
"2021","South Staffordshire 001C","E01029657",616,89,46,43,509,55,321,96,160,65,65,22,33,10,68,38,30,0,0,18,7,11
"2021","South Staffordshire 001D","E01029658",917,276,132,144,608,102,262,91,120,51,144,75,62,7,98,72,26,2,2,33,8,25
"2021","South Staffordshire 001E","E01029659",570,135,105,30,426,127,196,74,82,40,56,24,32,0,46,20,26,1,1,9,5,4
"2021","South Staffordshire 001F","E01029660",973,302,164,138,623,150,285,108,109,68,88,49,31,8,97,45,52,3,3,48,22,26
"2021","South Staffordshire 002A","E01029621",616,142,74,68,445,68,227,101,72,54,98,42,47,9,50,20,30,2,2,29,18,11
"2021","South Staffordshire 002B","E01029646",635,145,63,82,464,59,210,91,83,36,122,58,53,11,70,39,31,3,3,26,9,17
"2021","South Staffordshire 002C","E01029647",945,211,89,122,684,47,355,134,154,67,147,57,80,10,129,85,44,6,6,50,30,20
"2021","South Staffordshire 002D","E01029648",587,158,88,70,403,64,184,79,54,51,86,31,48,7,68,35,33,1,1,26,12,14
"2021","South Staffordshire 003A","E01029617",685,174,100,74,488,131,283,106,111,66,37,20,16,1,36,15,21,1,1,23,10,13
"2021","South Staffordshire 003B","E01029618",733,242,154,88,478,117,219,90,86,43,79,54,20,5,62,40,22,1,1,13,5,8
"2021","South Staffordshire 003C","E01029668",552,131,88,43,401,102,210,101,59,50,58,29,21,8,25,12,13,6,6,20,15,5
"2021","South Staffordshire 003D","E01029669",580,172,115,57,396,96,192,79,75,38,53,20,26,7,54,32,22,1,1,12,7,5
"2021","South Staffordshire 003E","E01029670",634,134,71,63,473,102,270,122,98,50,60,34,25,1,36,15,21,5,5,27,14,13
"2021","South Staffordshire 004A","E01029620",513,125,72,53,367,74,173,65,59,49,71,20,47,4,49,33,16,0,0,21,11,10
"2021","South Staffordshire 004B","E01029622",681,185,106,79,474,86,249,84,105,60,71,32,34,5,65,33,32,3,3,22,11,11
"2021","South Staffordshire 004C","E01029623",495,136,82,54,330,68,168,67,54,47,47,19,24,4,47,27,20,0,0,29,8,21
"2021","South Staffordshire 004D","E01029624",547,109,65,44,423,71,238,94,85,59,61,32,25,4,53,30,23,0,0,15,5,10
"2021","South Staffordshire 004E","E01029625",485,150,107,43,319,93,142,69,43,30,46,19,24,3,38,19,19,0,0,16,6,10
"2021","South Staffordshire 004F","E01029641",838,191,88,103,622,116,323,109,151,63,99,56,32,11,82,60,22,2,2,25,9,16
"2021","South Staffordshire 004G","E01029642",641,165,116,49,449,104,219,91,80,48,74,36,29,9,50,21,29,2,2,27,9,18
"2021","South Staffordshire 005A","E01029638",903,299,173,126,575,128,278,112,95,71,95,41,50,4,69,33,36,5,5,29,9,20
"2021","South Staffordshire 005B","E01029639",522,94,57,37,402,77,224,87,78,59,55,28,21,6,45,21,24,1,1,26,12,14
"2021","South Staffordshire 005C","E01029640",568,139,45,94,409,55,178,76,65,37,88,38,40,10,82,56,26,6,6,20,12,8
"2021","South Staffordshire 005D","E01029643",633,184,99,85,419,69,192,62,85,45,73,26,39,8,82,51,31,3,3,30,19,11
"2021","South Staffordshire 005E","E01029644",604,150,100,50,426,111,197,78,67,52,56,34,16,6,60,22,38,2,2,28,12,16
"2021","South Staffordshire 006A","E01029616",693,223,144,79,450,136,225,97,65,63,59,30,24,5,27,18,9,3,3,20,9,11
"2021","South Staffordshire 006B","E01029619",899,285,181,104,599,144,285,118,110,57,99,62,36,1,71,39,32,0,0,15,6,9
"2021","South Staffordshire 006C","E01029636",588,137,73,64,417,78,238,98,84,56,67,33,31,3,32,11,21,2,2,34,18,16
"2021","South Staffordshire 006D","E01029637",677,139,62,77,513,59,276,104,104,68,119,68,46,5,56,33,23,3,3,25,13,12
"2021","South Staffordshire 007A","E01029632",606,120,70,50,448,81,261,89,94,78,67,34,25,8,36,22,14,3,3,38,15,23
"2021","South Staffordshire 007B","E01029633",753,154,85,69,565,99,295,113,123,59,95,43,45,7,74,48,26,2,2,34,11,23
"2021","South Staffordshire 007C","E01029634",699,219,127,92,458,69,183,75,65,43,107,36,64,7,94,64,30,5,5,22,13,9
"2021","South Staffordshire 007D","E01029635",717,200,96,104,480,65,219,68,94,57,82,36,36,10,109,66,43,5,5,37,19,18
"2021","South Staffordshire 008A","E01029613",612,192,115,77,403,96,200,77,71,52,61,32,26,3,44,21,23,2,2,17,5,12
"2021","South Staffordshire 008B","E01029614",729,213,117,96,489,86,216,79,90,47,85,38,41,6,98,53,45,4,4,27,14,13
"2021","South Staffordshire 008C","E01029615",558,205,81,124,335,55,105,36,43,26,84,38,42,4,87,57,30,4,4,18,11,7
"2021","South Staffordshire 008D","E01029627",651,247,139,108,385,71,157,61,67,29,71,28,34,9,83,61,22,3,3,19,6,13
"2021","South Staffordshire 009A","E01029626",642,173,107,66,438,103,234,71,110,53,58,33,24,1,43,19,24,0,0,31,19,12
"2021","South Staffordshire 009B","E01029628",688,179,113,66,492,104,249,69,144,36,87,41,41,5,51,37,14,1,1,17,11,6
"2021","South Staffordshire 009C","E01029629",479,105,87,18,353,93,202,70,89,43,29,16,11,2,28,15,13,1,1,21,11,10
"2021","South Staffordshire 009D","E01029630",535,141,91,50,375,92,207,63,105,39,47,29,15,3,28,12,16,1,1,19,4,15
"2021","South Staffordshire 009E","E01029631",574,129,76,53,418,71,209,67,99,43,88,52,32,4,47,25,22,3,3,27,13,14
"2021","South Staffordshire 012A","E01029671",687,232,172,60,436,112,216,78,98,40,52,22,26,4,56,27,29,0,0,19,10,9
"2021","South Staffordshire 012B","E01029673",666,230,131,99,414,75,214,67,83,64,59,33,21,5,63,36,27,3,3,22,10,12
"2021","South Staffordshire 012C","E01029676",549,235,162,73,293,83,141,54,57,30,38,24,13,1,30,11,19,1,1,21,7,14
"2021","South Staffordshire 012D","E01029679",643,205,78,127,419,40,171,67,60,44,98,34,60,4,101,64,37,9,9,19,12,7
"2021","South Staffordshire 012E","E01029680",637,158,93,65,463,85,213,72,77,64,83,31,43,9,81,47,34,1,1,16,7,9
"2021","South Staffordshire 013A","E01029645",1094,333,202,131,724,181,379,139,151,89,93,60,27,6,71,45,26,0,0,37,10,27
"2021","South Staffordshire 013B","E01029667",934,231,128,103,638,140,347,146,127,74,89,47,27,15,56,31,25,6,6,65,33,32
"2021","South Staffordshire 013C","E01029672",626,130,67,63,453,101,256,95,105,56,59,36,20,3,32,14,18,5,5,43,22,21
"2021","South Staffordshire 013D","E01029674",691,153,94,59,521,91,329,102,140,87,61,27,27,7,36,15,21,4,4,17,4,13
"2021","South Staffordshire 013E","E01029675",672,220,173,47,434,136,216,70,90,56,44,20,18,6,36,18,18,2,2,18,1,17
"2021","South Staffordshire 013F","E01029677",587,168,91,77,396,69,217,70,98,49,71,36,33,2,39,22,17,0,0,23,10,13
"2021","South Staffordshire 013G","E01029678",682,158,87,71,505,89,309,131,109,69,59,37,15,7,46,25,21,2,2,19,7,12
"2021","South Staffordshire 014A","E01029649",616,255,160,95,348,113,147,75,41,31,44,25,12,7,43,16,27,1,1,13,5,8
"2021","South Staffordshire 014B","E01029650",671,193,134,59,450,132,238,109,81,48,50,31,17,2,27,17,10,3,3,28,8,20
"2021","South Staffordshire 014C","E01029651",630,145,98,47,463,143,221,93,75,53,66,38,21,7,32,16,16,1,1,22,9,13
"2021","South Staffordshire 014D","E01029652",687,132,77,55,517,141,282,97,115,70,63,37,21,5,30,15,15,1,1,38,21,17
"2021","South Staffordshire 014E","E01029653",521,130,83,47,375,76,162,61,61,40,70,32,30,8,66,39,27,1,1,16,10,6
"2021","South Staffordshire 015G","E01029654",980,266,182,84,685,155,363,136,164,63,76,36,35,5,87,49,38,4,4,29,11,18
"2021","South Staffordshire 015C","E01029661",792,188,109,79,571,116,287,114,96,77,98,57,32,9,69,42,27,1,1,33,13,20
"2021","South Staffordshire 015D","E01029662",814,173,106,67,606,111,377,142,164,71,69,30,34,5,46,24,22,3,3,35,16,19
"2021","South Staffordshire 015E","E01029663",591,146,57,89,429,72,237,94,96,47,75,32,39,4,42,22,20,3,3,16,6,10
"2021","South Staffordshire 015F","E01029664",664,201,90,111,446,74,209,84,75,50,90,44,41,5,72,41,31,1,1,17,7,10
"2021","South Staffordshire 015A","E01029665",758,227,104,123,508,97,266,109,87,70,84,48,32,4,60,35,25,1,1,23,10,13
"2021","South Staffordshire 015B","E01029666",739,341,150,191,381,40,141,53,54,34,92,38,43,11,108,73,35,0,0,17,7,10
"2021","Stafford 001A","E01029702",639,176,79,97,439,110,202,78,77,47,73,33,36,4,52,34,18,2,2,24,13,11
"2021","Stafford 001B","E01029703",665,142,63,79,499,86,270,112,105,53,98,62,30,6,44,30,14,1,1,24,8,16
"2021","Stafford 001C","E01029704",638,169,104,65,454,119,221,89,84,48,60,31,26,3,53,28,25,1,1,15,7,8
"2021","Stafford 001D","E01029705",634,157,110,47,455,150,201,83,75,43,62,32,20,10,39,16,23,3,3,22,11,11
"2021","Stafford 002A","E01029681",490,109,44,65,352,63,179,74,72,33,55,30,20,5,52,27,25,3,3,29,14,15
"2021","Stafford 002B","E01029682",700,203,138,65,479,150,209,89,81,39,76,41,32,3,41,24,17,3,3,18,8,10
"2021","Stafford 002C","E01029683",526,129,81,48,382,98,202,98,63,41,52,29,18,5,29,17,12,1,1,15,6,9
"2021","Stafford 002D","E01029748",580,153,97,56,400,84,238,110,88,40,49,30,15,4,27,12,15,2,2,27,14,13
"2021","Stafford 002E","E01029749",815,222,128,94,565,143,272,132,99,41,87,58,26,3,62,36,26,1,1,28,14,14
"2021","Stafford 003A","E01029740",668,184,105,79,466,75,220,99,77,44,84,41,35,8,84,57,27,3,3,18,7,11
"2021","Stafford 003B","E01029744",1063,332,119,213,699,94,351,127,186,38,149,90,52,7,104,70,34,1,1,32,13,19
"2021","Stafford 003C","E01029745",979,497,269,228,439,111,157,83,50,24,86,60,21,5,79,42,37,6,6,43,12,31
"2021","Stafford 003D","E01029746",675,226,107,119,427,76,204,78,90,36,81,42,34,5,63,41,22,3,3,22,7,15
"2021","Stafford 003E","E01029753",909,293,146,147,589,97,239,87,110,42,139,71,64,4,110,80,30,4,4,27,14,13
"2021","Stafford 003F","E01029756",812,271,86,185,517,38,230,65,126,39,138,74,50,14,107,65,42,4,4,24,9,15
"2021","Stafford 004A","E01029733",770,153,89,64,574,142,333,140,124,69,63,36,24,3,34,10,24,2,2,43,14,29
"2021","Stafford 004B","E01029739",598,104,60,44,480,86,297,118,133,46,70,41,23,6,27,13,14,0,0,14,7,7
"2021","Stafford 004C","E01029741",685,188,77,111,481,52,287,111,120,56,84,58,25,1,58,32,26,0,0,16,5,11
"2021","Stafford 004D","E01029754",770,171,81,90,586,130,277,106,127,44,97,50,43,4,82,61,21,0,0,13,6,7
"2021","Stafford 004E","E01029755",651,198,139,59,442,145,201,95,70,36,47,29,17,1,47,29,18,2,2,11,2,9
"2021","Stafford 005A","E01029695",1117,372,180,192,714,186,321,154,128,39,130,82,42,6,77,52,25,0,0,31,18,13
"2021","Stafford 005B","E01029696",647,176,104,72,449,91,250,140,59,51,71,41,24,6,35,10,25,2,2,22,8,14
"2021","Stafford 005C","E01029697",541,103,58,45,400,77,237,115,73,49,59,25,30,4,27,15,12,0,0,38,15,23
"2021","Stafford 005D","E01029698",798,211,122,89,567,124,271,122,106,43,113,70,40,3,57,35,22,2,2,20,7,13
"2021","Stafford 005E","E01029747",842,165,59,106,640,101,360,129,186,45,112,66,39,7,66,46,20,1,1,37,24,13
"2021","Stafford 006A","E01029690",627,175,72,103,422,49,215,75,91,49,103,53,47,3,54,28,26,1,1,30,11,19
"2021","Stafford 006B","E01029718",807,198,123,75,575,128,300,102,133,65,87,53,27,7,59,36,23,1,1,34,16,18
"2021","Stafford 006C","E01029743",1044,220,98,122,787,135,395,165,191,39,210,143,58,9,44,29,15,3,3,37,22,15
"2021","Stafford 006D","E01029751",770,248,161,87,502,137,226,97,77,52,75,39,32,4,63,39,24,1,1,20,5,15
"2021","Stafford 007A","E01029719",714,246,154,92,452,94,186,74,70,42,96,51,38,7,70,39,31,6,6,16,6,10
"2021","Stafford 007B","E01029720",662,193,53,140,438,35,149,62,64,23,113,55,50,8,136,96,40,5,5,31,16,15
"2021","Stafford 007C","E01029721",714,222,121,101,464,72,235,92,85,58,88,45,37,6,64,37,27,5,5,28,10,18
"2021","Stafford 007D","E01029750",1013,254,90,164,713,65,309,124,141,44,191,90,90,11,142,104,38,6,6,46,17,29
"2021","Stafford 007E","E01029752",523,148,63,85,365,48,125,44,55,26,81,39,33,9,110,84,26,1,1,10,6,4
"2021","Stafford 008A","E01029687",871,213,116,97,620,174,334,150,141,43,72,41,23,8,38,13,25,2,2,38,11,27
"2021","Stafford 008B","E01029710",643,172,111,61,454,163,212,94,65,53,47,29,16,2,31,14,17,1,1,17,4,13
"2021","Stafford 008C","E01029711",663,153,85,68,488,104,268,121,98,49,74,43,28,3,42,22,20,0,0,22,9,13
"2021","Stafford 008D","E01029712",864,214,116,98,628,117,340,132,145,63,106,60,41,5,64,42,22,1,1,22,8,14
"2021","Stafford 008E","E01029713",816,237,134,103,561,129,275,111,114,50,87,42,38,7,68,44,24,2,2,18,9,9
"2021","Stafford 009A","E01029692",638,234,113,121,386,38,154,42,75,37,84,46,35,3,108,74,34,2,2,18,9,9
"2021","Stafford 009B","E01029693",583,125,27,98,435,8,218,77,126,15,106,46,54,6,99,80,19,4,4,23,16,7
"2021","Stafford 009C","E01029722",700,193,73,120,445,37,204,66,100,38,90,56,29,5,110,66,44,4,4,62,27,35
"2021","Stafford 009D","E01029725",1002,434,123,311,498,43,211,78,99,34,155,105,40,10,82,43,39,7,7,70,17,53
"2021","Stafford 010A","E01029689",880,400,74,326,448,26,143,63,58,22,176,121,50,5,94,67,27,9,9,32,8,24
"2021","Stafford 010B","E01029691",789,487,178,309,273,24,100,48,43,9,89,61,25,3,50,36,14,10,10,29,5,24
"2021","Stafford 010C","E01029694",918,240,31,209,618,22,347,97,226,24,158,99,57,2,85,64,21,6,6,60,25,35
"2021","Stafford 010D","E01029699",951,410,144,266,508,45,202,62,113,27,161,99,58,4,90,53,37,10,10,33,8,25
"2021","Stafford 010F","E01034047",740,456,79,377,256,17,72,45,20,7,108,87,17,4,50,32,18,9,9,28,3,25
"2021","Stafford 010G","E01034048",606,354,120,234,223,36,74,31,41,2,64,43,21,0,43,35,8,6,6,29,4,25
"2021","Stafford 011A","E01029686",601,183,106,77,395,102,197,65,98,34,55,39,11,5,38,24,14,3,3,23,11,12
"2021","Stafford 011B","E01029700",528,149,58,91,356,53,204,88,86,30,54,40,13,1,42,27,15,3,3,23,5,18
"2021","Stafford 011C","E01029723",678,208,104,104,461,92,243,96,100,47,70,42,26,2,56,28,28,0,0,9,3,6
"2021","Stafford 011D","E01029724",685,163,69,94,493,85,283,106,117,60,77,49,24,4,48,19,29,0,0,29,16,13
"2021","Stafford 011F","E01034049",603,130,25,105,451,37,219,76,120,23,129,75,51,3,65,57,8,1,1,22,5,17
"2021","Stafford 011G","E01034050",581,113,52,61,439,69,243,89,129,25,81,42,37,2,46,33,13,0,0,29,14,15
"2021","Stafford 012A","E01029714",649,154,65,89,477,86,262,121,80,61,81,50,26,5,48,24,24,0,0,18,8,10
"2021","Stafford 012B","E01029736",674,144,54,90,498,72,303,117,126,60,75,46,25,4,45,21,24,3,3,32,9,23
"2021","Stafford 012C","E01029737",778,232,107,125,513,95,254,107,100,47,83,39,42,2,79,52,27,2,2,33,9,24
"2021","Stafford 012D","E01029738",578,151,83,68,406,73,217,86,102,29,81,54,23,4,31,17,14,4,4,21,9,12
"2021","Stafford 012E","E01029742",904,217,150,67,650,187,321,156,110,55,91,61,27,3,48,17,31,3,3,37,19,18
"2021","Stafford 013A","E01029715",755,333,114,219,412,45,168,78,67,23,104,67,32,5,90,58,32,5,5,10,6,4
"2021","Stafford 013B","E01029716",659,197,99,98,431,59,173,60,77,36,90,36,49,5,108,68,40,1,1,31,19,12
"2021","Stafford 013C","E01029717",756,231,92,139,488,48,162,67,61,34,118,35,70,13,151,111,40,9,9,37,12,25
"2021","Stafford 013D","E01029727",662,244,100,144,384,47,136,50,67,19,86,33,45,8,109,78,31,6,6,34,17,17
"2021","Stafford 013E","E01029728",627,165,89,76,439,65,199,77,79,43,83,35,40,8,90,54,36,2,2,23,5,18
"2021","Stafford 014A","E01029684",583,144,84,60,419,80,244,65,136,43,44,22,20,2,51,33,18,0,0,20,9,11
"2021","Stafford 014B","E01029685",636,146,116,30,465,134,233,76,124,33,52,27,23,2,44,22,22,2,2,25,13,12
"2021","Stafford 014E","E01029757",629,156,83,73,452,90,217,79,106,32,81,46,30,5,62,37,25,2,2,21,12,9
"2021","Stafford 014F","E01029758",673,159,103,56,495,126,253,97,120,36,64,27,35,2,51,33,18,1,1,19,7,12
"2021","Stafford 014G","E01029759",737,181,114,67,535,142,274,99,129,46,57,26,28,3,61,38,23,1,1,21,11,10
"2021","Stafford 014H","E01029760",730,163,117,46,548,161,285,73,165,47,54,24,26,4,46,30,16,2,2,19,8,11
"2021","Stafford 014I","E01034051",1104,242,167,75,832,217,461,155,206,100,82,47,30,5,72,38,34,0,0,30,9,21
"2021","Stafford 015A","E01029688",1054,282,155,127,728,180,397,182,132,83,102,58,35,9,47,27,20,2,2,44,16,28
"2021","Stafford 015B","E01029706",768,166,103,63,579,138,311,134,107,70,89,49,32,8,39,22,17,2,2,23,6,17
"2021","Stafford 015C","E01029707",687,255,142,113,405,88,182,78,74,30,72,43,21,8,60,34,26,3,3,27,14,13
"2021","Stafford 015D","E01029708",884,184,94,90,651,122,363,174,116,73,115,67,41,7,51,32,19,0,0,49,17,32
"2021","Stafford 015E","E01029709",660,171,108,63,473,120,238,108,81,49,77,43,28,6,35,17,18,3,3,16,3,13
"2021","Stafford 016A","E01029726",705,177,111,66,496,91,234,95,93,46,85,41,37,7,81,41,40,5,5,32,17,15
"2021","Stafford 016B","E01029729",843,419,149,270,403,71,157,71,49,37,100,59,39,2,74,49,25,1,1,21,10,11
"2021","Stafford 016C","E01029734",922,303,93,210,578,29,237,82,114,41,139,52,71,16,162,108,54,11,11,41,24,17
"2021","Stafford 016D","E01029735",945,262,118,144,634,101,293,121,129,43,146,72,64,10,89,59,30,5,5,49,20,29
"2021","Staffordshire Moorlands 001A","E01029797",619,122,69,53,449,96,241,101,85,55,75,44,21,10,36,17,19,1,1,48,20,28
"2021","Staffordshire Moorlands 001B","E01029806",679,217,132,85,440,99,218,105,69,44,82,46,31,5,40,22,18,1,1,22,15,7
"2021","Staffordshire Moorlands 001C","E01029808",704,282,168,114,405,67,180,69,71,40,88,39,46,3,67,47,20,3,3,17,6,11
"2021","Staffordshire Moorlands 001D","E01029809",624,186,96,90,413,43,165,66,67,32,96,42,43,11,106,64,42,3,3,25,15,10
"2021","Staffordshire Moorlands 001E","E01029810",579,171,71,100,394,40,167,68,68,31,92,34,54,4,92,51,41,3,3,14,4,10
"2021","Staffordshire Moorlands 002A","E01029767",718,190,124,66,511,139,253,119,68,66,85,54,24,7,33,12,21,1,1,17,5,12
"2021","Staffordshire Moorlands 002B","E01029769",802,221,157,64,554,159,284,129,102,53,81,45,30,6,28,9,19,2,2,27,15,12
"2021","Staffordshire Moorlands 002C","E01029770",923,260,149,111,645,175,323,123,132,68,98,49,40,9,47,30,17,2,2,18,9,9
"2021","Staffordshire Moorlands 002D","E01029802",742,159,94,65,535,135,302,131,104,67,65,37,25,3,30,11,19,3,3,48,21,27
"2021","Staffordshire Moorlands 003A","E01029763",661,230,95,135,409,30,161,65,53,43,92,44,40,8,121,89,32,5,5,22,15,7
"2021","Staffordshire Moorlands 003B","E01029764",661,121,39,82,504,25,275,84,134,57,108,50,47,11,96,65,31,0,0,36,14,22
"2021","Staffordshire Moorlands 003C","E01029765",524,148,74,74,358,32,155,52,66,37,78,29,46,3,90,65,25,3,3,18,8,10
"2021","Staffordshire Moorlands 003D","E01029766",621,210,102,108,380,38,171,52,78,41,91,32,50,9,73,38,35,7,7,31,16,15
"2021","Staffordshire Moorlands 003E","E01029774",937,363,145,218,542,80,226,103,90,33,125,61,57,7,109,78,31,2,2,32,13,19
"2021","Staffordshire Moorlands 004A","E01029768",690,192,123,69,478,127,223,86,87,50,87,43,39,5,40,28,12,1,1,20,10,10
"2021","Staffordshire Moorlands 004B","E01029771",725,206,138,68,504,148,254,111,76,67,59,31,19,9,40,15,25,3,3,15,8,7
"2021","Staffordshire Moorlands 004C","E01029772",766,254,138,116,495,124,212,89,78,45,83,39,38,6,71,43,28,5,5,17,7,10
"2021","Staffordshire Moorlands 004D","E01029773",672,168,109,59,480,159,221,102,68,51,67,31,24,12,32,11,21,1,1,24,11,13
"2021","Staffordshire Moorlands 005A","E01029804",965,484,130,354,451,48,174,76,67,31,127,83,42,2,93,66,27,9,9,30,17,13
"2021","Staffordshire Moorlands 005B","E01029807",536,224,107,117,299,67,117,47,47,23,54,27,23,4,58,25,33,3,3,13,7,6
"2021","Staffordshire Moorlands 005C","E01029811",647,204,104,100,420,60,185,66,82,37,94,35,54,5,75,52,23,6,6,23,9,14
"2021","Staffordshire Moorlands 005D","E01029812",1059,519,161,358,516,53,185,94,74,17,135,69,59,7,138,100,38,5,5,24,9,15
"2021","Staffordshire Moorlands 005E","E01029814",782,306,105,201,455,57,203,86,84,33,127,76,46,5,66,37,29,2,2,21,8,13
"2021","Staffordshire Moorlands 006A","E01029792",980,250,123,127,697,133,380,151,163,66,114,59,46,9,65,39,26,5,5,33,14,19
"2021","Staffordshire Moorlands 006B","E01029793",674,185,111,74,470,94,235,94,97,44,87,43,37,7,53,29,24,1,1,19,8,11
"2021","Staffordshire Moorlands 006C","E01029805",725,229,129,100,476,119,265,102,119,44,61,30,24,7,31,15,16,0,0,20,5,15
"2021","Staffordshire Moorlands 006D","E01029813",945,246,132,114,662,135,312,108,146,58,146,72,66,8,65,32,33,4,4,37,20,17
"2021","Staffordshire Moorlands 006E","E01029815",679,232,136,96,424,112,211,94,72,45,64,34,25,5,36,25,11,1,1,23,8,15
"2021","Staffordshire Moorlands 006F","E01029816",610,175,111,64,419,86,221,84,92,45,65,36,27,2,46,24,22,1,1,16,7,9
"2021","Staffordshire Moorlands 007A","E01029801",742,182,105,77,532,131,281,124,111,46,76,45,24,7,43,23,20,1,1,28,18,10
"2021","Staffordshire Moorlands 007B","E01029803",774,193,106,87,540,148,289,138,88,63,59,39,14,6,41,16,25,3,3,41,22,19
"2021","Staffordshire Moorlands 007C","E01029817",747,203,106,97,500,103,263,118,84,61,84,53,28,3,48,23,25,2,2,44,24,20
"2021","Staffordshire Moorlands 008A","E01029762",690,172,125,47,494,131,260,94,109,57,65,30,31,4,37,12,25,1,1,24,11,13
"2021","Staffordshire Moorlands 008B","E01029775",672,190,121,69,469,145,216,101,68,47,67,39,25,3,38,17,21,3,3,13,5,8
"2021","Staffordshire Moorlands 008C","E01029776",739,174,120,54,546,162,277,89,123,65,57,27,27,3,49,28,21,1,1,19,5,14
"2021","Staffordshire Moorlands 008D","E01029777",639,157,92,65,462,83,239,89,104,46,80,39,35,6,59,30,29,1,1,20,7,13
"2021","Staffordshire Moorlands 009A","E01029779",730,227,148,79,473,136,228,97,87,44,69,32,29,8,37,17,20,3,3,30,11,19
"2021","Staffordshire Moorlands 009B","E01029780",669,184,107,77,471,86,234,84,101,49,92,45,41,6,58,32,26,1,1,14,6,8
"2021","Staffordshire Moorlands 009C","E01029794",605,152,86,66,414,89,213,96,79,38,65,39,22,4,45,20,25,2,2,39,18,21
"2021","Staffordshire Moorlands 009D","E01029818",617,139,78,61,463,123,237,103,90,44,63,31,27,5,40,19,21,0,0,15,10,5
"2021","Staffordshire Moorlands 009E","E01029819",716,176,114,62,525,124,269,106,112,51,89,42,43,4,43,19,24,0,0,15,8,7
"2021","Staffordshire Moorlands 010A","E01029761",589,161,98,63,396,107,196,77,72,47,61,30,23,8,31,18,13,1,1,32,12,20
"2021","Staffordshire Moorlands 010B","E01029782",848,270,122,148,553,82,243,95,95,53,107,55,45,7,120,72,48,1,1,25,7,18
"2021","Staffordshire Moorlands 010C","E01029795",767,214,109,105,515,105,261,124,87,50,107,63,33,11,39,20,19,3,3,38,19,19
"2021","Staffordshire Moorlands 010D","E01029796",664,177,92,85,459,83,206,96,65,45,101,62,37,2,67,34,33,2,2,28,14,14
"2021","Staffordshire Moorlands 011A","E01029781",694,227,125,102,457,114,207,98,70,39,84,45,32,7,52,23,29,0,0,10,2,8
"2021","Staffordshire Moorlands 011B","E01029783",693,270,128,142,412,58,168,70,66,32,82,31,42,9,103,71,32,1,1,11,6,5
"2021","Staffordshire Moorlands 011C","E01029786",591,139,71,68,427,92,235,97,80,58,60,33,21,6,38,26,12,2,2,25,12,13
"2021","Staffordshire Moorlands 011D","E01029787",910,382,158,224,494,96,174,63,75,36,99,45,47,7,122,87,35,3,3,34,17,17
"2021","Staffordshire Moorlands 012A","E01029778",763,199,103,96,514,112,268,119,92,57,87,47,31,9,44,18,26,3,3,50,17,33
"2021","Staffordshire Moorlands 012B","E01029789",438,104,71,33,313,68,151,75,40,36,57,32,22,3,35,14,21,2,2,21,9,12
"2021","Staffordshire Moorlands 012C","E01029798",722,199,106,93,504,121,223,95,82,46,90,44,41,5,70,39,31,0,0,19,8,11
"2021","Staffordshire Moorlands 012D","E01029799",826,231,130,101,567,153,281,118,106,57,87,48,32,7,45,18,27,1,1,28,11,17
"2021","Staffordshire Moorlands 012E","E01029800",673,164,108,56,486,101,267,98,116,53,69,32,31,6,48,32,16,1,1,23,11,12
"2021","Staffordshire Moorlands 013A","E01029784",927,252,170,82,654,170,327,131,119,77,102,48,42,12,53,32,21,2,2,21,10,11
"2021","Staffordshire Moorlands 013B","E01029785",713,143,86,57,544,106,335,139,128,68,65,24,38,3,37,18,19,1,1,26,11,15
"2021","Staffordshire Moorlands 013C","E01029788",535,107,65,42,401,106,216,91,82,43,50,27,22,1,27,11,16,2,2,27,14,13
"2021","Staffordshire Moorlands 013D","E01029790",750,191,100,91,534,87,292,110,131,51,83,39,39,5,72,47,25,0,0,25,13,12
"2021","Staffordshire Moorlands 013E","E01029791",664,206,78,128,436,97,218,88,87,43,58,38,15,5,60,38,22,3,3,22,11,11
"2021","Tamworth 001A","E01029846",666,141,80,61,488,75,223,87,96,40,112,52,56,4,74,48,26,4,4,37,18,19
"2021","Tamworth 001B","E01029847",572,137,78,59,413,100,226,99,74,53,60,31,25,4,27,10,17,0,0,22,14,8
"2021","Tamworth 001C","E01029848",504,121,88,33,355,93,188,68,77,43,35,22,9,4,38,22,16,1,1,28,9,19
"2021","Tamworth 001D","E01029852",748,212,135,77,510,85,224,79,88,57,94,39,45,10,103,58,45,4,4,26,12,14
"2021","Tamworth 001E","E01029853",687,204,118,86,447,59,216,67,107,42,83,37,39,7,83,50,33,6,6,36,17,19
"2021","Tamworth 001F","E01029854",1009,205,110,95,771,143,357,128,160,69,184,95,83,6,86,63,23,1,1,33,19,14
"2021","Tamworth 002A","E01029835",1080,669,345,324,376,79,125,75,33,17,93,66,22,5,66,33,33,13,13,35,9,26
"2021","Tamworth 002B","E01029836",766,238,86,152,497,42,211,64,100,47,150,87,57,6,90,63,27,4,4,31,12,19
"2021","Tamworth 002C","E01029849",692,225,115,110,430,45,160,58,70,32,74,21,47,6,142,109,33,9,9,37,17,20
"2021","Tamworth 002D","E01029850",589,210,91,119,345,32,134,47,50,37,77,39,36,2,97,59,38,5,5,34,11,23
"2021","Tamworth 002E","E01029851",982,328,167,161,579,73,251,109,98,44,135,83,43,9,117,74,43,3,3,75,24,51
"2021","Tamworth 003A","E01029820",922,179,68,111,692,86,312,109,142,61,170,96,66,8,122,92,30,2,2,51,30,21
"2021","Tamworth 003B","E01029821",627,191,92,99,406,104,196,95,59,42,60,33,23,4,44,22,22,2,2,30,8,22
"2021","Tamworth 003C","E01029822",531,70,15,55,437,36,299,81,153,65,67,32,27,8,34,23,11,1,1,24,14,10
"2021","Tamworth 003D","E01029824",699,200,63,137,453,41,190,66,77,47,88,36,48,4,125,85,40,9,9,46,25,21
"2021","Tamworth 003E","E01029841",612,169,94,75,404,93,179,75,59,45,75,34,35,6,53,26,27,4,4,39,16,23
"2021","Tamworth 004A","E01029823",649,188,122,66,440,121,210,82,80,48,64,34,27,3,44,21,23,1,1,21,7,14
"2021","Tamworth 004B","E01029831",642,184,64,120,423,60,194,75,74,45,86,36,43,7,79,51,28,4,4,35,19,16
"2021","Tamworth 004C","E01029832",698,192,137,55,472,99,214,75,85,54,82,41,41,0,76,47,29,1,1,34,11,23
"2021","Tamworth 004D","E01029834",704,213,107,106,459,67,198,69,79,50,95,37,55,3,98,60,38,1,1,32,15,17
"2021","Tamworth 004E","E01029844",492,99,49,50,373,62,205,84,76,45,61,33,20,8,44,25,19,1,1,20,6,14
"2021","Tamworth 005A","E01029833",697,192,67,125,481,50,254,99,105,50,105,51,49,5,66,43,23,6,6,24,12,12
"2021","Tamworth 005B","E01029837",661,205,74,131,428,57,207,78,89,40,87,49,27,11,75,47,28,2,2,28,15,13
"2021","Tamworth 005C","E01029838",706,233,84,149,434,36,210,90,74,46,106,62,41,3,73,50,23,9,9,39,14,25
"2021","Tamworth 005D","E01029839",449,58,24,34,379,61,245,92,104,49,39,20,17,2,33,19,14,1,1,12,4,8
"2021","Tamworth 006A","E01029825",514,110,68,42,380,66,192,76,76,40,67,27,37,3,51,25,26,4,4,24,8,16
"2021","Tamworth 006B","E01029826",738,166,94,72,545,103,266,95,104,67,108,56,43,9,67,31,36,1,1,27,10,17
"2021","Tamworth 006C","E01029827",548,150,91,59,354,29,147,44,63,40,72,25,36,11,99,57,42,7,7,44,26,18
"2021","Tamworth 006D","E01029828",463,128,46,82,299,21,125,34,56,35,63,19,39,5,84,58,26,6,6,36,14,22
"2021","Tamworth 006E","E01029830",529,174,64,110,320,39,114,50,49,15,82,47,30,5,76,56,20,9,9,35,12,23
"2021","Tamworth 007A","E01029840",456,90,39,51,327,25,132,37,70,25,53,11,36,6,112,76,36,5,5,39,20,19
"2021","Tamworth 007B","E01029842",493,122,38,84,352,32,131,34,66,31,66,26,35,5,121,88,33,2,2,19,10,9
"2021","Tamworth 007C","E01029843",546,121,58,63,380,52,139,34,70,35,79,32,45,2,106,53,53,4,4,45,26,19
"2021","Tamworth 007D","E01029845",442,174,73,101,260,16,86,30,34,22,61,13,43,5,97,80,17,0,0,8,4,4
"2021","Tamworth 007E","E01029859",715,198,76,122,475,27,175,58,78,39,113,38,68,7,152,113,39,8,8,42,19,23
"2021","Tamworth 008A","E01029855",581,115,45,70,433,50,238,83,100,55,79,30,42,7,65,38,27,1,1,33,17,16
"2021","Tamworth 008B","E01029856",587,123,41,82,443,57,215,93,84,38,112,53,48,11,58,36,22,1,1,21,9,12
"2021","Tamworth 008C","E01029857",612,160,54,106,423,39,186,69,77,40,109,50,52,7,85,57,28,4,4,29,17,12
"2021","Tamworth 008D","E01029858",624,153,57,96,446,69,251,121,89,41,84,39,42,3,37,22,15,5,5,25,12,13
"2021","Tamworth 008E","E01029865",606,103,37,66,459,60,268,96,109,63,94,51,39,4,34,14,20,3,3,44,22,22
"2021","Tamworth 009A","E01029860",534,106,57,49,416,65,234,84,100,50,75,37,36,2,40,26,14,2,2,12,6,6
"2021","Tamworth 009B","E01029861",592,169,114,55,393,101,174,66,72,36,60,28,29,3,51,32,19,7,7,30,14,16
"2021","Tamworth 009C","E01029862",488,80,36,44,391,46,251,86,110,55,55,27,24,4,39,23,16,0,0,17,9,8
"2021","Tamworth 009D","E01029863",771,187,99,88,555,92,247,103,97,47,136,82,51,3,76,40,36,4,4,29,13,16
"2021","Tamworth 009E","E01029864",656,135,63,72,500,131,258,95,110,53,71,33,34,4,37,21,16,3,3,21,12,9
"2021","Tamworth 010A","E01029829",847,182,66,116,625,72,278,84,140,54,146,58,74,14,128,86,42,1,1,40,17,23
"2021","Tamworth 010C","E01029867",696,215,88,127,448,52,183,59,88,36,90,38,48,4,120,84,36,3,3,33,12,21
"2021","Tamworth 010D","E01029868",524,66,35,31,433,53,266,110,91,65,70,30,34,6,41,27,14,3,3,25,7,18
"2021","Tamworth 010E","E01029869",650,167,88,79,465,56,223,86,86,51,92,38,50,4,93,49,44,1,1,18,11,7
"2021","Tamworth 010F","E01032901",706,139,23,116,536,33,224,56,129,39,158,72,76,10,115,90,25,6,6,31,14,17
"2021","Tamworth 010G","E01032902",596,188,74,114,376,46,170,74,64,32,96,55,37,4,58,29,29,6,6,32,14,18
"2021","North Warwickshire 001A","E01031035",800,192,103,89,564,96,307,126,113,68,85,37,37,11,75,43,32,1,1,44,18,26
"2021","North Warwickshire 001B","E01031036",723,154,100,54,528,108,292,124,105,63,80,37,39,4,46,24,22,2,2,41,16,25
"2021","North Warwickshire 001C","E01031037",837,249,106,143,546,78,259,85,119,55,128,54,64,10,76,53,23,5,5,42,20,22
"2021","North Warwickshire 001D","E01031038",752,154,89,65,559,120,257,71,124,62,92,37,45,10,90,43,47,0,0,39,22,17
"2021","North Warwickshire 001E","E01031039",651,147,76,71,479,102,251,87,98,66,81,36,40,5,45,24,21,0,0,25,12,13
"2021","North Warwickshire 001F","E01031040",756,209,102,107,510,69,243,98,87,58,110,58,39,13,86,47,39,2,2,37,16,21
"2021","North Warwickshire 002A","E01031016",688,196,121,75,467,85,200,86,72,42,98,42,46,10,81,48,33,3,3,25,13,12
"2021","North Warwickshire 002B","E01031025",724,209,108,101,465,72,188,80,67,41,109,48,50,11,88,58,30,8,8,50,15,35
"2021","North Warwickshire 002C","E01031026",605,135,64,71,434,50,183,63,83,37,92,29,51,12,103,65,38,6,6,36,13,23
"2021","North Warwickshire 002D","E01031031",1033,239,110,129,731,90,365,139,153,73,144,60,74,10,131,83,48,1,1,63,22,41
"2021","North Warwickshire 002E","E01031032",560,124,67,57,404,55,185,69,72,44,90,33,49,8,74,48,26,0,0,32,14,18
"2021","North Warwickshire 003A","E01031009",998,330,122,208,616,80,224,88,93,43,181,94,75,12,128,90,38,3,3,52,22,30
"2021","North Warwickshire 003B","E01031010",945,419,101,318,487,40,164,61,79,24,159,88,60,11,117,94,23,7,7,39,15,24
"2021","North Warwickshire 003C","E01031011",968,263,106,157,663,124,347,135,130,82,102,58,40,4,87,47,40,3,3,42,21,21
"2021","North Warwickshire 003D","E01031012",632,216,121,95,386,55,153,46,71,36,91,34,49,8,85,44,41,2,2,30,13,17
"2021","North Warwickshire 003E","E01031013",497,184,105,79,299,81,138,63,52,23,43,23,15,5,37,17,20,0,0,14,10,4
"2021","North Warwickshire 003F","E01031014",500,125,86,39,348,78,196,71,79,46,41,20,19,2,31,17,14,2,2,27,10,17
"2021","North Warwickshire 003G","E01031015",700,247,120,127,427,59,162,69,57,36,88,41,38,9,111,72,39,7,7,26,11,15
"2021","North Warwickshire 004A","E01031023",656,154,100,54,464,118,234,71,100,63,60,29,25,6,50,24,26,2,2,38,19,19
"2021","North Warwickshire 004B","E01031024",723,139,68,71,524,91,317,137,104,76,79,45,26,8,35,19,16,2,2,60,31,29
"2021","North Warwickshire 004C","E01031033",788,218,126,92,533,115,218,82,74,62,102,55,40,7,93,61,32,5,5,37,18,19
"2021","North Warwickshire 004D","E01031034",763,184,96,88,545,107,276,114,94,68,94,55,33,6,66,34,32,2,2,34,16,18
"2021","North Warwickshire 005A","E01031005",681,177,79,98,471,55,193,84,65,44,134,64,57,13,86,60,26,3,3,33,18,15
"2021","North Warwickshire 005B","E01031008",651,174,68,106,438,37,170,64,73,33,96,44,47,5,130,91,39,5,5,39,13,26
"2021","North Warwickshire 005C","E01031017",670,131,63,68,507,75,266,88,117,61,106,49,51,6,60,30,30,0,0,32,18,14
"2021","North Warwickshire 005D","E01031018",463,105,52,53,339,63,173,76,55,42,57,30,23,4,45,23,22,1,1,19,15,4
"2021","North Warwickshire 005E","E01031029",619,151,68,83,439,62,226,95,93,38,96,46,42,8,52,30,22,3,3,29,10,19
"2021","North Warwickshire 005F","E01031030",1031,334,148,186,648,113,265,123,87,55,141,70,64,7,125,72,53,4,4,49,18,31
"2021","North Warwickshire 006A","E01031019",679,153,68,85,496,63,243,77,104,62,112,52,56,4,75,43,32,3,3,30,23,7
"2021","North Warwickshire 006B","E01031020",705,237,91,146,452,76,201,73,83,45,100,59,36,5,74,44,30,1,1,16,10,6
"2021","North Warwickshire 006C","E01031021",854,375,183,192,449,85,200,84,79,37,79,48,27,4,85,56,29,0,0,30,13,17
"2021","North Warwickshire 006D","E01031022",812,248,130,118,536,113,261,79,112,70,87,47,31,9,73,41,32,2,2,28,13,15
"2021","North Warwickshire 006E","E01031041",711,207,94,113,477,72,240,87,85,68,87,44,38,5,78,48,30,0,0,27,13,14
"2021","North Warwickshire 006F","E01031042",766,184,100,84,551,105,279,100,114,65,99,40,42,17,68,40,28,0,0,31,18,13
"2021","North Warwickshire 007A","E01031006",693,247,94,153,417,51,180,82,69,29,99,51,45,3,84,54,30,3,3,29,13,16
"2021","North Warwickshire 007B","E01031007",540,111,58,53,399,88,208,90,75,43,71,39,25,7,30,13,17,2,2,30,12,18
"2021","North Warwickshire 007C","E01031027",643,146,71,75,450,84,242,98,88,56,91,46,38,7,31,15,16,2,2,47,22,25
"2021","North Warwickshire 007D","E01031028",778,179,90,89,555,106,287,119,113,55,97,58,32,7,63,34,29,2,2,44,17,27
"2021","Nuneaton and Bedworth 001A","E01031110",707,202,139,63,480,126,238,81,116,41,70,50,19,1,44,26,18,2,2,25,9,16
"2021","Nuneaton and Bedworth 001B","E01031111",405,70,45,25,318,74,187,78,69,40,25,12,12,1,32,17,15,0,0,17,8,9
"2021","Nuneaton and Bedworth 001C","E01031112",658,158,81,77,479,90,224,73,104,47,86,37,38,11,76,41,35,3,3,21,13,8
"2021","Nuneaton and Bedworth 001E","E01031114",763,314,162,152,430,75,205,89,74,42,73,35,28,10,73,50,23,4,4,19,7,12
"2021","Nuneaton and Bedworth 001F","E01035014",784,115,10,105,637,14,326,90,216,20,186,101,79,6,105,88,17,6,6,32,23,9
"2021","Nuneaton and Bedworth 001G","E01035015",707,163,91,72,521,107,257,91,129,37,85,47,31,7,72,45,27,0,0,23,12,11
"2021","Nuneaton and Bedworth 002C","E01031073",883,229,121,108,613,87,284,115,114,55,139,71,60,8,97,56,41,6,6,41,20,21
"2021","Nuneaton and Bedworth 002D","E01031074",726,249,80,169,441,51,168,68,68,32,97,52,36,9,116,73,43,9,9,36,15,21
"2021","Nuneaton and Bedworth 002E","E01031075",921,251,97,154,627,37,271,102,117,52,145,63,72,10,165,125,40,9,9,43,22,21
"2021","Nuneaton and Bedworth 002G","E01035016",667,173,42,131,448,19,127,33,75,19,116,29,72,15,179,134,45,7,7,46,19,27
"2021","Nuneaton and Bedworth 002H","E01035017",782,218,32,186,512,18,210,73,112,25,141,75,62,4,137,107,30,6,6,52,29,23
"2021","Nuneaton and Bedworth 003A","E01031100",510,92,51,41,392,64,241,85,100,56,49,26,17,6,37,17,20,1,1,26,12,14
"2021","Nuneaton and Bedworth 003B","E01031101",520,102,54,48,380,68,243,90,102,51,42,14,25,3,24,14,10,3,3,38,19,19
"2021","Nuneaton and Bedworth 003C","E01031102",579,202,67,135,354,54,178,65,73,40,67,34,29,4,49,29,20,6,6,23,8,15
"2021","Nuneaton and Bedworth 003E","E01031104",639,176,133,43,435,152,210,85,79,46,34,15,15,4,35,19,16,4,4,28,14,14
"2021","Nuneaton and Bedworth 003F","E01035018",616,83,35,48,497,71,277,72,159,46,90,37,53,0,59,43,16,0,0,36,24,12
"2021","Nuneaton and Bedworth 003G","E01035019",613,108,31,77,479,29,228,76,114,38,129,77,50,2,90,77,13,3,3,26,16,10
"2021","Nuneaton and Bedworth 004A","E01031081",667,176,54,122,453,33,219,79,93,47,98,41,52,5,98,68,30,5,5,38,19,19
"2021","Nuneaton and Bedworth 004B","E01031082",554,107,37,70,421,32,267,109,92,66,94,50,42,2,28,18,10,0,0,26,11,15
"2021","Nuneaton and Bedworth 004C","E01031083",754,195,87,108,531,63,263,93,110,60,120,65,48,7,84,55,29,1,1,28,16,12
"2021","Nuneaton and Bedworth 004D","E01031084",888,224,77,147,616,58,317,107,157,53,142,67,64,11,96,68,28,3,3,48,26,22
"2021","Nuneaton and Bedworth 004E","E01031085",542,103,50,53,407,75,197,85,66,46,77,32,40,5,57,29,28,1,1,32,16,16
"2021","Nuneaton and Bedworth 005A","E01031043",986,554,139,415,389,43,145,60,60,25,91,59,28,4,99,66,33,11,11,43,14,29
"2021","Nuneaton and Bedworth 005B","E01031044",777,264,73,191,453,40,158,51,73,34,101,47,52,2,143,107,36,11,11,60,24,36
"2021","Nuneaton and Bedworth 005C","E01031045",788,249,110,139,480,69,234,74,106,54,98,52,42,4,73,48,25,6,6,59,26,33
"2021","Nuneaton and Bedworth 005D","E01031046",715,218,61,157,423,35,217,72,87,58,67,34,31,2,99,64,35,5,5,74,34,40
"2021","Nuneaton and Bedworth 005E","E01031047",842,328,73,255,441,22,245,65,127,53,90,50,34,6,77,54,23,7,7,73,37,36
"2021","Nuneaton and Bedworth 006A","E01031057",653,222,77,145,391,21,137,46,60,31,98,35,56,7,127,100,27,8,8,40,21,19
"2021","Nuneaton and Bedworth 006B","E01031058",648,188,88,100,415,71,173,75,61,37,81,40,34,7,88,57,31,2,2,45,23,22
"2021","Nuneaton and Bedworth 006C","E01031059",689,192,57,135,453,38,199,73,94,32,137,61,71,5,77,53,24,2,2,44,21,23
"2021","Nuneaton and Bedworth 006D","E01031060",620,195,109,86,393,79,187,83,63,41,61,25,29,7,62,34,28,4,4,32,13,19
"2021","Nuneaton and Bedworth 006E","E01031061",607,159,71,88,417,44,224,81,80,63,86,50,30,6,61,42,19,2,2,31,15,16
"2021","Nuneaton and Bedworth 007A","E01031090",671,220,70,150,415,43,147,46,76,25,99,42,55,2,123,93,30,3,3,36,16,20
"2021","Nuneaton and Bedworth 007B","E01031091",696,203,96,107,469,96,224,71,106,47,84,34,44,6,63,31,32,2,2,24,19,5
"2021","Nuneaton and Bedworth 007C","E01031092",615,186,77,109,397,45,139,43,72,24,104,54,43,7,106,69,37,3,3,32,13,19
"2021","Nuneaton and Bedworth 007D","E01031093",555,140,79,61,387,87,178,67,63,48,64,28,32,4,54,32,22,4,4,28,17,11
"2021","Nuneaton and Bedworth 007E","E01031094",504,146,47,99,332,30,129,50,54,25,88,33,46,9,80,59,21,5,5,26,10,16
"2021","Nuneaton and Bedworth 008A","E01031048",533,141,53,88,373,64,182,60,74,48,61,34,23,4,65,46,19,1,1,19,8,11
"2021","Nuneaton and Bedworth 008B","E01031049",1120,285,110,175,774,72,402,119,215,68,171,82,82,7,123,70,53,6,6,61,30,31
"2021","Nuneaton and Bedworth 008C","E01031050",794,232,53,179,510,59,212,82,85,45,125,67,54,4,108,73,35,6,6,52,29,23
"2021","Nuneaton and Bedworth 008D","E01031051",582,169,116,53,391,87,189,74,64,51,68,31,27,10,45,28,17,2,2,22,13,9
"2021","Nuneaton and Bedworth 009A","E01031115",725,229,103,126,430,51,220,67,107,46,74,37,29,8,75,47,28,10,10,66,28,38
"2021","Nuneaton and Bedworth 009B","E01031116",683,215,116,99,437,42,151,37,77,37,93,28,56,9,143,98,45,8,8,31,19,12
"2021","Nuneaton and Bedworth 009C","E01031117",588,154,80,74,391,41,173,47,88,38,68,28,36,4,106,68,38,3,3,43,23,20
"2021","Nuneaton and Bedworth 009D","E01031118",474,121,51,70,326,49,150,61,48,41,58,23,24,11,66,36,30,3,3,27,19,8
"2021","Nuneaton and Bedworth 009E","E01031119",728,297,106,191,377,36,206,51,109,46,55,25,28,2,67,33,34,13,13,54,23,31
"2021","Nuneaton and Bedworth 010A","E01031052",648,214,65,149,386,31,156,47,67,42,95,56,35,4,98,61,37,6,6,48,19,29
"2021","Nuneaton and Bedworth 010B","E01031053",745,382,164,218,335,58,148,59,53,36,60,34,24,2,66,37,29,3,3,28,12,16
"2021","Nuneaton and Bedworth 010C","E01031054",701,201,82,119,468,72,191,71,78,42,94,49,38,7,102,66,36,9,9,32,13,19
"2021","Nuneaton and Bedworth 010D","E01031055",685,166,43,123,488,35,249,84,124,41,101,58,37,6,100,69,31,3,3,31,14,17
"2021","Nuneaton and Bedworth 010E","E01031056",617,164,73,91,429,60,202,63,94,45,77,33,36,8,86,54,32,4,4,24,9,15
"2021","Nuneaton and Bedworth 011A","E01031120",582,153,78,75,403,93,205,81,67,57,70,37,26,7,31,17,14,4,4,26,7,19
"2021","Nuneaton and Bedworth 011B","E01031121",450,77,57,20,350,80,227,85,86,56,27,14,11,2,13,6,7,3,3,23,10,13
"2021","Nuneaton and Bedworth 011C","E01031122",626,161,104,57,444,112,219,87,71,61,69,42,25,2,40,14,26,4,4,21,9,12
"2021","Nuneaton and Bedworth 011D","E01031123",513,106,78,28,387,105,220,104,77,39,33,13,15,5,28,12,16,1,1,20,10,10
"2021","Nuneaton and Bedworth 011E","E01031124",636,147,103,44,460,122,258,98,98,62,50,33,17,0,28,12,16,2,2,29,13,16
"2021","Nuneaton and Bedworth 012A","E01031105",696,255,136,119,415,78,204,64,85,55,76,29,39,8,55,21,34,2,2,26,12,14
"2021","Nuneaton and Bedworth 012B","E01031106",642,179,91,88,432,109,186,79,60,47,68,26,37,5,65,39,26,4,4,31,17,14
"2021","Nuneaton and Bedworth 012C","E01031107",465,111,54,57,329,53,162,56,65,41,65,33,28,4,47,29,18,2,2,25,17,8
"2021","Nuneaton and Bedworth 012D","E01031108",554,117,60,57,408,54,237,88,87,62,57,28,25,4,60,39,21,0,0,29,13,16
"2021","Nuneaton and Bedworth 012E","E01031109",712,239,102,137,440,56,182,76,58,48,89,42,46,1,110,79,31,3,3,33,16,17
"2021","Nuneaton and Bedworth 013A","E01031062",500,126,88,38,354,88,179,67,63,49,39,14,21,4,41,23,18,7,7,20,13,7
"2021","Nuneaton and Bedworth 013B","E01031063",623,243,113,130,370,68,117,52,43,22,68,31,34,3,113,86,27,4,4,10,5,5
"2021","Nuneaton and Bedworth 013C","E01031064",621,243,119,124,356,60,139,52,49,38,67,34,27,6,81,54,27,9,9,22,8,14
"2021","Nuneaton and Bedworth 013D","E01031065",646,160,61,99,448,65,176,60,69,47,110,50,51,9,91,54,37,6,6,38,25,13
"2021","Nuneaton and Bedworth 013E","E01031066",661,224,106,118,395,52,145,41,74,30,94,32,51,11,103,74,29,1,1,42,19,23
"2021","Nuneaton and Bedworth 014A","E01031067",712,288,171,117,401,99,165,71,53,41,66,33,28,5,67,39,28,4,4,23,8,15
"2021","Nuneaton and Bedworth 014B","E01031068",762,220,142,78,503,125,247,104,81,62,66,32,31,3,62,35,27,3,3,39,14,25
"2021","Nuneaton and Bedworth 014C","E01031069",678,202,163,39,442,151,200,79,90,31,58,33,20,5,32,13,19,1,1,34,11,23
"2021","Nuneaton and Bedworth 014D","E01031070",650,180,130,50,449,148,206,88,57,61,57,25,28,4,36,12,24,2,2,21,9,12
"2021","Nuneaton and Bedworth 015A","E01031095",509,128,59,69,359,35,124,32,57,35,77,29,44,4,118,90,28,5,5,22,12,10
"2021","Nuneaton and Bedworth 015B","E01031096",597,199,63,136,372,40,172,60,73,39,75,36,35,4,80,63,17,5,5,26,19,7
"2021","Nuneaton and Bedworth 015C","E01031097",765,270,133,137,457,45,203,73,88,42,95,43,44,8,110,71,39,4,4,38,16,22
"2021","Nuneaton and Bedworth 015D","E01031098",555,139,63,76,369,47,186,51,88,47,51,21,26,4,80,50,30,5,5,47,23,24
"2021","Nuneaton and Bedworth 015E","E01031099",949,254,61,193,632,60,311,109,148,54,157,91,57,9,99,60,39,5,5,63,31,32
"2021","Nuneaton and Bedworth 016A","E01031086",811,217,129,88,554,75,261,74,132,55,107,36,63,8,106,71,35,5,5,40,22,18
"2021","Nuneaton and Bedworth 016B","E01031087",886,239,100,139,588,53,261,83,121,57,135,58,66,11,132,91,41,7,7,59,36,23
"2021","Nuneaton and Bedworth 016C","E01031088",787,155,66,89,585,68,299,113,116,70,93,46,39,8,118,68,50,7,7,47,25,22
"2021","Nuneaton and Bedworth 016D","E01031089",637,177,113,64,432,113,197,88,73,36,68,34,29,5,51,20,31,3,3,28,13,15
"2021","Nuneaton and Bedworth 018A","E01031077",707,173,60,113,491,27,216,72,113,31,83,33,43,7,161,127,34,4,4,43,18,25
"2021","Nuneaton and Bedworth 018B","E01031078",847,220,89,131,569,64,296,98,127,71,111,47,57,7,93,56,37,5,5,58,31,27
"2021","Nuneaton and Bedworth 018C","E01031079",681,215,92,123,427,81,176,65,66,45,94,38,44,12,74,47,27,2,2,39,22,17
"2021","Nuneaton and Bedworth 018D","E01031080",675,222,104,118,411,58,181,59,75,47,75,36,35,4,92,53,39,5,5,42,25,17
"2021","Nuneaton and Bedworth 018E","E01032588",581,154,87,67,384,78,195,70,75,50,59,29,26,4,49,26,23,3,3,43,28,15
"2021","Rugby 002A","E01031137",560,209,73,136,323,43,156,67,68,21,81,53,27,1,40,23,17,3,3,28,10,18
"2021","Rugby 002B","E01031138",467,81,25,56,358,46,221,93,88,40,42,22,19,1,48,26,22,1,1,28,11,17
"2021","Rugby 002C","E01031139",685,142,50,92,509,70,329,138,131,60,73,40,28,5,37,20,17,0,0,34,16,18
"2021","Rugby 002D","E01031140",533,110,62,48,377,75,185,62,73,50,56,16,32,8,57,31,26,4,4,46,24,22
"2021","Rugby 002F","E01031142",695,201,38,163,441,16,180,52,90,38,104,44,55,5,127,93,34,14,14,53,22,31
"2021","Rugby 002G","E01035020",687,182,11,171,466,7,238,67,157,14,155,111,44,0,58,46,12,8,8,39,14,25
"2021","Rugby 002H","E01035021",748,171,57,114,498,32,252,70,146,36,108,66,38,4,97,59,38,9,9,79,25,54
"2021","Rugby 003A","E01031171",600,151,72,79,406,42,194,67,88,39,81,42,35,4,86,44,42,3,3,43,15,28
"2021","Rugby 003B","E01031172",717,229,109,120,450,53,173,58,90,25,100,44,51,5,113,76,37,11,11,38,16,22
"2021","Rugby 003C","E01031173",997,500,186,314,435,33,150,57,69,24,136,90,43,3,99,64,35,17,17,62,19,43
"2021","Rugby 003D","E01031174",968,377,94,283,475,28,187,68,86,33,120,76,39,5,122,74,48,18,18,116,32,84
"2021","Rugby 004A","E01031151",619,144,89,55,438,133,228,71,104,53,51,20,25,6,25,10,15,1,1,37,22,15
"2021","Rugby 004B","E01031152",478,147,80,67,316,89,144,59,58,27,40,18,18,4,41,19,22,2,2,15,7,8
"2021","Rugby 004C","E01031153",672,173,76,97,470,70,235,83,118,34,84,39,37,8,76,47,29,5,5,29,10,19
"2021","Rugby 004D","E01031154",772,215,100,115,523,138,254,101,105,48,81,49,28,4,49,29,20,1,1,34,13,21
"2021","Rugby 004E","E01031181",780,211,112,99,530,93,261,96,120,45,101,54,39,8,72,37,35,3,3,39,20,19
"2021","Rugby 005A","E01031130",797,215,45,170,491,19,225,67,118,40,133,85,43,5,103,74,29,11,11,91,27,64
"2021","Rugby 005B","E01031131",724,213,51,162,375,21,134,41,73,20,119,83,34,2,80,41,39,21,21,136,46,90
"2021","Rugby 005C","E01031132",870,330,72,258,458,30,228,74,119,35,104,66,31,7,84,50,34,12,12,82,25,57
"2021","Rugby 005D","E01031133",578,166,67,99,353,35,150,43,76,31,83,39,38,6,82,55,27,3,3,59,22,37
"2021","Rugby 006A","E01031167",585,161,65,96,380,58,196,82,73,41,65,38,21,6,56,30,26,5,5,44,11,33
"2021","Rugby 006B","E01031168",1169,323,109,214,735,53,307,100,167,40,188,113,70,5,171,128,43,16,16,111,48,63
"2021","Rugby 006C","E01031169",932,310,68,242,523,26,204,62,100,42,169,106,55,8,111,69,42,13,13,99,23,76
"2021","Rugby 006D","E01031170",769,293,115,178,401,17,179,69,81,29,115,65,47,3,85,51,34,5,5,75,21,54
"2021","Rugby 007A","E01031125",657,180,100,80,451,102,217,85,94,38,75,42,30,3,53,29,24,4,4,26,12,14
"2021","Rugby 007C","E01031127",670,181,72,109,457,75,173,57,86,30,80,36,40,4,125,96,29,4,4,32,12,20
"2021","Rugby 007E","E01031165",689,195,100,95,469,75,213,76,108,29,84,42,40,2,97,66,31,0,0,25,9,16
"2021","Rugby 007F","E01032893",688,72,26,46,577,35,412,98,246,68,63,36,23,4,65,43,22,2,2,39,21,18
"2021","Rugby 007G","E01032894",774,124,32,92,611,38,394,82,262,50,92,39,44,9,84,65,19,3,3,39,21,18
"2021","Rugby 007H","E01032895",569,119,67,52,422,74,243,69,135,39,56,24,29,3,48,32,16,1,1,28,11,17
"2021","Rugby 007I","E01035022",613,112,28,84,477,21,228,61,148,19,115,56,56,3,112,92,20,1,1,24,13,11
"2021","Rugby 007J","E01035023",682,154,60,94,498,73,269,82,148,39,99,54,43,2,52,26,26,5,5,30,15,15
"2021","Rugby 008A","E01031155",552,120,74,46,408,78,251,76,126,49,40,18,21,1,37,20,17,2,2,24,11,13
"2021","Rugby 008B","E01031156",642,165,73,92,450,68,243,80,115,48,90,48,40,2,46,27,19,3,3,27,11,16
"2021","Rugby 008C","E01031157",932,239,97,142,640,64,375,86,230,59,99,60,35,4,96,63,33,6,6,53,30,23
"2021","Rugby 008D","E01031158",473,132,96,36,324,88,167,49,85,33,47,20,24,3,19,7,12,3,3,17,9,8
"2021","Rugby 009A","E01031143",655,177,121,56,460,121,238,90,99,49,55,29,15,11,43,19,24,3,3,18,5,13
"2021","Rugby 009B","E01031144",664,259,97,162,372,36,189,62,99,28,83,54,27,2,56,38,18,8,8,33,13,20
"2021","Rugby 009C","E01031145",501,274,124,150,205,28,92,33,39,20,57,47,9,1,24,12,12,4,4,22,4,18
"2021","Rugby 009D","E01031146",625,155,102,53,435,86,177,51,87,39,66,22,29,15,102,67,35,4,4,35,17,18
"2021","Rugby 010A","E01031161",887,248,139,109,602,144,284,89,147,48,97,52,41,4,73,34,39,4,4,37,19,18
"2021","Rugby 010B","E01031162",880,215,121,94,625,84,348,106,170,72,109,58,47,4,84,57,27,0,0,40,25,15
"2021","Rugby 010C","E01031163",786,298,174,124,457,96,190,72,84,34,61,27,28,6,105,79,26,5,5,31,15,16
"2021","Rugby 010D","E01031179",794,135,63,72,628,76,358,95,208,55,110,53,50,7,81,49,32,3,3,31,17,14
"2021","Rugby 010E","E01031180",859,214,103,111,610,105,328,102,160,66,89,34,49,6,83,52,31,5,5,35,11,24
"2021","Rugby 011A","E01031134",736,212,139,73,502,153,264,111,98,55,56,33,20,3,28,11,17,1,1,22,11,11
"2021","Rugby 011B","E01031135",760,279,210,69,464,154,213,86,93,34,53,30,21,2,41,16,25,3,3,17,7,10
"2021","Rugby 011C","E01031136",801,242,127,115,527,100,268,108,101,59,83,53,25,5,71,46,25,5,5,32,14,18
"2021","Rugby 011D","E01031175",583,143,113,30,416,128,222,76,97,49,39,23,13,3,24,13,11,3,3,24,13,11
"2021","Rugby 011E","E01031176",595,142,76,66,418,41,215,63,112,40,71,29,36,6,87,47,40,4,4,35,22,13
"2021","Rugby 011F","E01031177",607,160,59,101,400,44,185,49,102,34,69,27,36,6,98,66,32,4,4,47,24,23
"2021","Rugby 011G","E01031178",630,189,122,67,408,101,197,68,92,37,49,19,24,6,56,32,24,5,5,33,15,18
"2021","Rugby 012B","E01031148",819,267,146,121,525,129,264,77,140,47,60,29,25,6,70,55,15,2,2,27,15,12
"2021","Rugby 012C","E01031149",662,161,88,73,473,88,269,128,98,43,69,44,24,1,47,21,26,0,0,28,16,12
"2021","Rugby 012D","E01031150",503,132,85,47,353,82,191,68,87,36,44,30,11,3,36,19,17,0,0,18,11,7
"2021","Rugby 012E","E01031166",841,171,94,77,635,155,348,158,139,51,77,56,19,2,52,21,31,3,3,35,17,18
"2021","Rugby 012F","E01035024",741,121,14,107,579,14,273,61,188,24,143,64,78,1,146,135,11,3,3,41,24,17
"2021","Rugby 012G","E01035025",659,209,168,41,431,160,203,62,106,35,38,23,13,2,29,15,14,1,1,19,7,12
"2021","Rugby 013C","E01031159",678,162,106,56,479,95,252,119,81,52,76,52,20,4,53,29,24,3,3,37,12,25
"2021","Rugby 013B","E01031160",917,263,136,127,610,131,322,135,130,57,93,57,31,5,61,29,32,3,3,44,21,23
"2021","Rugby 013A","E01031182",855,159,90,69,637,133,377,146,168,63,85,46,33,6,38,19,19,4,4,59,31,28
"2021","Rugby 013D","E01035026",572,120,54,66,428,56,246,93,116,37,95,60,32,3,27,13,14,4,4,24,13,11
"2021","Rugby 014D","E01031129",531,159,97,62,342,71,192,84,72,36,47,26,18,3,31,17,14,1,1,30,12,18
"2021","Rugby 014C","E01032891",731,167,21,146,507,10,299,85,182,32,121,79,35,7,68,48,20,9,9,57,27,30
"2021","Rugby 014A","E01035027",551,89,10,79,419,13,266,86,161,19,90,57,29,4,44,34,10,6,6,43,18,25
"2021","Rugby 014B","E01035028",595,105,23,82,468,36,226,58,133,35,122,73,45,4,81,70,11,3,3,22,15,7
"2021","Rugby 014E","E01035029",638,94,8,86,513,13,276,65,195,16,171,116,53,2,52,47,5,1,1,31,18,13
"2021","Stratford-on-Avon 001A","E01031213",795,171,87,84,579,122,310,125,117,68,80,52,23,5,65,39,26,2,2,45,20,25
"2021","Stratford-on-Avon 001B","E01031243",809,144,104,40,617,175,347,130,134,83,64,31,26,7,29,10,19,2,2,48,24,24
"2021","Stratford-on-Avon 001C","E01031244",773,179,96,83,546,143,294,118,115,61,67,41,23,3,40,21,19,2,2,48,15,33
"2021","Stratford-on-Avon 002A","E01031195",939,203,154,49,700,161,397,143,175,79,80,35,40,5,57,35,22,5,5,36,21,15
"2021","Stratford-on-Avon 002B","E01031202",821,329,206,123,467,135,214,85,91,38,63,46,16,1,54,29,25,1,1,25,7,18
"2021","Stratford-on-Avon 002C","E01031203",767,273,155,118,466,75,219,87,82,50,65,34,27,4,104,59,45,3,3,28,12,16
"2021","Stratford-on-Avon 002D","E01031204",708,253,179,74,430,151,205,103,71,31,51,36,14,1,22,11,11,1,1,25,8,17
"2021","Stratford-on-Avon 003A","E01031239",770,261,129,132,480,92,208,75,101,32,104,66,35,3,73,43,30,3,3,29,11,18
"2021","Stratford-on-Avon 003B","E01031240",595,205,109,96,365,78,167,62,67,38,56,25,26,5,64,43,21,0,0,25,13,12
"2021","Stratford-on-Avon 003C","E01031241",616,144,84,60,451,94,235,77,101,57,54,26,24,4,65,35,30,3,3,21,8,13
"2021","Stratford-on-Avon 003D","E01031242",660,204,119,85,429,78,196,67,91,38,67,37,24,6,84,60,24,4,4,27,13,14
"2021","Stratford-on-Avon 004A","E01031219",992,265,110,155,700,80,337,121,167,49,166,109,50,7,114,85,29,3,3,27,10,17
"2021","Stratford-on-Avon 004B","E01031220",612,142,83,59,454,89,226,80,87,59,64,37,22,5,74,39,35,1,1,16,9,7
"2021","Stratford-on-Avon 004C","E01031221",885,319,174,145,532,88,227,68,121,38,102,55,42,5,111,66,45,4,4,34,8,26
"2021","Stratford-on-Avon 004D","E01031222",1099,355,112,243,710,106,360,132,164,64,160,117,40,3,79,55,24,5,5,34,12,22
"2021","Stratford-on-Avon 004E","E01031223",635,139,51,88,474,72,253,94,113,46,93,57,31,5,55,30,25,1,1,22,8,14
"2021","Stratford-on-Avon 004F","E01031224",583,135,59,76,420,84,225,92,102,31,68,41,19,8,42,25,17,1,1,28,9,19
"2021","Stratford-on-Avon 005A","E01031197",540,140,73,67,372,74,212,91,86,35,52,36,14,2,32,18,14,2,2,28,13,15
"2021","Stratford-on-Avon 005B","E01031198",563,129,61,68,409,71,233,100,95,38,64,44,16,4,39,25,14,2,2,25,11,14
"2021","Stratford-on-Avon 005C","E01031199",870,192,96,96,627,103,316,106,146,64,125,69,50,6,78,54,24,5,5,51,26,25
"2021","Stratford-on-Avon 005D","E01031200",726,159,64,95,533,72,299,123,123,53,99,57,38,4,62,30,32,1,1,34,15,19
"2021","Stratford-on-Avon 005E","E01031201",712,184,123,61,514,163,268,90,135,43,48,29,15,4,33,16,17,2,2,14,4,10
"2021","Stratford-on-Avon 005F","E01031210",526,126,71,55,382,84,200,80,88,32,55,38,13,4,41,23,18,2,2,18,8,10
"2021","Stratford-on-Avon 005G","E01031211",737,177,83,94,537,53,263,88,143,32,135,77,55,3,80,53,27,6,6,23,9,14
"2021","Stratford-on-Avon 006A","E01031183",822,324,140,184,473,105,202,94,66,42,91,61,24,6,70,37,33,5,5,25,3,22
"2021","Stratford-on-Avon 006B","E01031184",658,209,134,75,426,103,223,88,97,38,57,26,28,3,40,19,21,3,3,23,8,15
"2021","Stratford-on-Avon 006C","E01031185",620,215,113,102,381,68,148,54,65,29,74,34,29,11,89,56,33,2,2,24,9,15
"2021","Stratford-on-Avon 006D","E01031186",708,273,169,104,414,110,186,62,87,37,47,23,22,2,68,41,27,3,3,21,8,13
"2021","Stratford-on-Avon 007A","E01031187",832,236,144,92,551,140,306,130,121,55,62,41,13,8,40,18,22,3,3,45,18,27
"2021","Stratford-on-Avon 007B","E01031188",1070,251,137,114,752,198,378,165,155,58,108,57,44,7,66,40,26,2,2,67,28,39
"2021","Stratford-on-Avon 007C","E01031208",1063,300,175,125,731,226,349,160,149,40,86,50,31,5,70,48,22,0,0,32,7,25
"2021","Stratford-on-Avon 008A","E01031217",537,119,72,47,400,112,203,80,96,27,48,25,23,0,37,23,14,0,0,18,10,8
"2021","Stratford-on-Avon 008B","E01031218",486,93,46,47,371,67,219,79,96,44,45,32,11,2,39,21,18,1,1,22,9,13
"2021","Stratford-on-Avon 008C","E01031249",525,173,99,74,332,58,166,70,67,29,47,27,16,4,58,32,26,3,3,20,7,13
"2021","Stratford-on-Avon 008E","E01031251",499,134,103,31,352,99,200,84,81,35,34,24,9,1,19,9,10,0,0,13,3,10
"2021","Stratford-on-Avon 008F","E01031252",532,165,80,85,351,55,202,76,90,36,56,37,16,3,35,19,16,3,3,16,6,10
"2021","Stratford-on-Avon 008G","E01031253",640,195,107,88,422,79,214,64,113,37,53,32,16,5,71,38,33,5,5,23,10,13
"2021","Stratford-on-Avon 008H","E01035030",680,203,123,80,459,125,221,91,101,29,72,39,32,1,41,28,13,0,0,18,5,13
"2021","Stratford-on-Avon 008I","E01035031",644,109,38,71,496,40,252,76,157,19,126,61,62,3,72,55,17,6,6,39,16,23
"2021","Stratford-on-Avon 009A","E01031228",726,212,139,73,485,159,234,103,89,42,53,29,20,4,36,19,17,3,3,29,11,18
"2021","Stratford-on-Avon 009B","E01031229",1196,593,209,384,539,119,202,112,66,24,145,122,21,2,62,41,21,11,11,64,10,54
"2021","Stratford-on-Avon 009D","E01031231",1144,441,128,313,619,41,254,102,109,43,169,119,44,6,139,93,46,16,16,84,17,67
"2021","Stratford-on-Avon 009E","E01031236",647,171,84,87,430,71,211,79,83,49,72,46,21,5,71,40,31,5,5,46,14,32
"2021","Stratford-on-Avon 009F","E01031238",604,233,100,133,327,49,117,40,55,22,72,44,26,2,85,45,40,4,4,44,11,33
"2021","Stratford-on-Avon 009G","E01035032",658,129,64,65,475,66,232,80,111,41,98,51,43,4,73,43,30,6,6,54,16,38
"2021","Stratford-on-Avon 009H","E01035033",740,191,45,146,499,33,258,98,135,25,116,78,32,6,84,65,19,8,8,50,13,37
"2021","Stratford-on-Avon 010A","E01031225",775,226,151,75,512,134,284,91,141,52,46,26,20,0,46,28,18,2,2,37,9,28
"2021","Stratford-on-Avon 010C","E01031227",1004,369,226,143,597,139,289,112,127,50,89,51,33,5,77,49,28,3,3,38,14,24
"2021","Stratford-on-Avon 010D","E01033250",554,139,47,92,377,39,213,68,123,22,59,40,18,1,59,36,23,7,7,38,10,28
"2021","Stratford-on-Avon 010E","E01033251",716,187,81,106,497,69,247,79,141,27,89,51,35,3,87,56,31,5,5,32,11,21
"2021","Stratford-on-Avon 010F","E01033252",599,125,87,38,451,133,245,101,99,45,35,23,10,2,38,22,16,0,0,23,10,13
"2021","Stratford-on-Avon 011A","E01031232",956,296,128,168,631,150,322,125,146,51,86,57,25,4,71,32,39,2,2,29,14,15
"2021","Stratford-on-Avon 011B","E01031233",747,246,99,147,458,80,260,95,118,47,71,39,30,2,43,22,21,4,4,43,14,29
"2021","Stratford-on-Avon 011C","E01031234",955,507,306,201,411,95,170,81,60,29,79,62,13,4,59,30,29,8,8,37,10,27
"2021","Stratford-on-Avon 011D","E01031235",938,392,243,149,508,135,221,85,108,28,87,57,23,7,61,25,36,4,4,38,10,28
"2021","Stratford-on-Avon 011E","E01031237",635,157,89,68,449,97,251,83,119,49,41,20,19,2,57,29,28,3,3,29,7,22
"2021","Stratford-on-Avon 012A","E01031189",740,183,102,81,529,97,285,124,114,47,76,46,24,6,69,38,31,2,2,28,11,17
"2021","Stratford-on-Avon 012B","E01031190",1008,231,86,145,737,88,365,142,176,47,153,67,77,9,124,81,43,7,7,40,17,23
"2021","Stratford-on-Avon 012C","E01031191",880,216,123,93,624,145,332,137,144,51,89,44,43,2,56,32,24,2,2,40,15,25
"2021","Stratford-on-Avon 012D","E01031192",1097,344,147,197,719,119,361,145,163,53,145,89,51,5,91,60,31,3,3,34,19,15
"2021","Stratford-on-Avon 012E","E01031248",1052,256,159,97,748,197,417,177,177,63,91,61,21,9,40,18,22,3,3,48,19,29
"2021","Stratford-on-Avon 013A","E01031194",1022,262,109,153,721,133,407,171,180,56,124,76,42,6,51,29,22,6,6,39,12,27
"2021","Stratford-on-Avon 013B","E01031205",781,211,96,115,539,102,304,123,129,52,74,49,20,5,57,36,21,2,2,31,11,20
"2021","Stratford-on-Avon 013C","E01031206",697,195,93,102,480,80,238,90,106,42,92,51,32,9,69,42,27,1,1,22,3,19
"2021","Stratford-on-Avon 013D","E01031207",638,186,78,108,428,68,213,85,79,49,89,59,24,6,54,28,26,4,4,24,6,18
"2021","Stratford-on-Avon 013E","E01031247",1049,245,142,103,757,194,405,175,162,68,97,62,31,4,58,26,32,3,3,47,17,30
"2021","Stratford-on-Avon 014A","E01031196",1059,274,152,122,747,154,434,166,194,74,93,55,33,5,65,38,27,1,1,38,17,21
"2021","Stratford-on-Avon 014C","E01031245",580,171,106,65,390,114,205,87,70,48,41,30,11,0,29,25,4,1,1,19,9,10
"2021","Stratford-on-Avon 014D","E01031246",570,133,75,58,406,86,218,81,99,38,60,34,24,2,40,25,15,2,2,31,9,22
"2021","Stratford-on-Avon 014E","E01035034",611,138,75,63,450,98,240,100,98,42,71,42,28,1,39,20,19,2,2,23,5,18
"2021","Stratford-on-Avon 014F","E01035035",669,113,13,100,535,23,238,65,155,18,164,74,88,2,110,86,24,0,0,21,8,13
"2021","Stratford-on-Avon 014G","E01035036",643,195,69,126,424,55,222,83,109,30,85,60,23,2,60,43,17,2,2,24,10,14
"2021","Stratford-on-Avon 015A","E01031193",985,309,177,132,631,160,347,176,114,57,71,41,21,9,50,26,24,3,3,45,15,30
"2021","Stratford-on-Avon 015B","E01031209",1006,276,150,126,692,187,350,151,141,58,79,52,21,6,74,37,37,2,2,38,5,33
"2021","Stratford-on-Avon 015C","E01031214",1044,263,145,118,749,167,360,132,165,63,144,85,54,5,74,54,20,4,4,32,18,14
"2021","Stratford-on-Avon 015D","E01031215",910,378,187,191,496,110,192,81,77,34,115,65,44,6,75,45,30,4,4,36,7,29
"2021","Stratford-on-Avon 015E","E01031216",747,272,153,119,454,81,213,96,79,38,79,51,24,4,78,44,34,3,3,21,7,14
"2021","Warwick 001A","E01031254",723,173,105,68,517,108,286,115,126,45,82,46,34,2,39,23,16,2,2,33,12,21
"2021","Warwick 001B","E01031255",624,154,95,59,457,111,238,83,120,35,56,28,24,4,51,25,26,1,1,13,2,11
"2021","Warwick 001C","E01031256",784,256,145,111,507,145,260,100,125,35,61,43,18,0,37,17,20,4,4,21,6,15
"2021","Warwick 001D","E01031257",669,241,91,150,393,41,161,51,84,26,109,74,29,6,75,50,25,7,7,35,11,24
"2021","Warwick 001E","E01031258",870,380,219,161,454,97,207,90,91,26,87,58,27,2,58,32,26,5,5,36,5,31
"2021","Warwick 002A","E01031296",709,240,98,142,451,82,238,83,106,49,73,53,18,2,58,38,20,0,0,18,8,10
"2021","Warwick 002B","E01031297",862,282,103,179,525,77,273,92,142,39,108,60,41,7,62,37,25,5,5,55,15,40
"2021","Warwick 002C","E01031298",759,264,180,84,473,112,240,78,118,44,56,33,19,4,63,30,33,2,2,22,7,15
"2021","Warwick 002D","E01031299",559,102,71,31,439,129,260,84,123,53,27,11,14,2,23,12,11,0,0,18,3,15
"2021","Warwick 002E","E01031300",748,156,81,75,563,112,330,103,180,47,71,36,30,5,50,31,19,0,0,29,6,23
"2021","Warwick 003A","E01031303",698,283,156,127,386,65,193,60,103,30,59,36,20,3,64,32,32,5,5,29,6,23
"2021","Warwick 003B","E01031304",598,145,100,45,436,77,262,68,145,49,47,17,24,6,50,24,26,0,0,17,2,15
"2021","Warwick 003C","E01031305",646,170,134,36,464,175,240,82,115,43,28,15,11,2,21,12,9,0,0,12,5,7
"2021","Warwick 003D","E01031306",605,157,95,62,423,87,229,85,105,39,48,24,17,7,58,37,21,1,1,25,11,14
"2021","Warwick 003E","E01031307",661,219,129,90,433,130,235,84,108,43,44,26,15,3,24,10,14,0,0,9,1,8
"2021","Warwick 004A","E01031281",658,142,81,61,490,100,283,99,130,54,66,36,23,7,38,16,22,3,3,26,8,18
"2021","Warwick 004B","E01031282",741,224,116,108,485,94,262,109,107,46,76,46,25,5,51,27,24,2,2,32,14,18
"2021","Warwick 004C","E01031283",538,130,66,64,374,90,213,83,92,38,44,26,16,2,26,8,18,1,1,34,18,16
"2021","Warwick 004D","E01031284",519,115,67,48,385,88,234,78,108,48,36,18,13,5,26,13,13,1,1,19,7,12
"2021","Warwick 005A","E01031277",637,159,97,62,455,88,238,73,128,37,76,40,32,4,53,31,22,0,0,23,6,17
"2021","Warwick 005B","E01031278",656,143,76,67,474,98,278,78,148,52,50,28,18,4,47,30,17,1,1,39,16,23
"2021","Warwick 005C","E01031279",610,187,130,57,402,90,188,64,84,40,57,40,17,0,65,34,31,2,2,21,6,15
"2021","Warwick 005D","E01031280",522,103,59,44,396,67,254,107,95,52,39,21,13,5,34,17,17,2,2,23,8,15
"2021","Warwick 005E","E01031301",765,155,72,83,579,124,304,102,153,49,95,62,30,3,52,38,14,4,4,31,7,24
"2021","Warwick 005F","E01031302",437,123,58,65,293,44,152,48,77,27,58,38,17,3,38,22,16,1,1,21,6,15
"2021","Warwick 005G","E01031308",695,172,95,77,485,107,257,99,109,49,75,45,27,3,45,27,18,1,1,38,11,27
"2021","Warwick 006A","E01031273",607,245,54,191,329,23,116,35,59,22,75,31,36,8,109,65,44,6,6,33,16,17
"2021","Warwick 006B","E01031274",612,158,72,86,413,39,196,58,101,37,70,44,22,4,98,70,28,10,10,41,12,29
"2021","Warwick 006C","E01031275",520,130,87,43,356,95,168,52,80,36,35,16,18,1,56,24,32,2,2,34,14,20
"2021","Warwick 006D","E01031276",623,183,87,96,403,45,182,59,86,37,97,53,34,10,72,40,32,7,7,37,11,26
"2021","Warwick 007B","E01031272",762,241,69,172,435,46,203,67,101,35,120,97,20,3,57,30,27,9,9,86,6,80
"2021","Warwick 007C","E01031285",1157,469,266,203,617,164,292,117,147,28,113,94,17,2,45,19,26,3,3,71,9,62
"2021","Warwick 007D","E01031286",699,277,164,113,393,51,202,83,104,15,82,57,22,3,52,27,25,6,6,29,6,23
"2021","Warwick 007E","E01031287",579,114,75,39,445,59,285,81,167,37,52,27,19,6,48,26,22,1,1,20,9,11
"2021","Warwick 007F","E01031288",678,188,95,93,455,109,262,65,157,40,52,38,11,3,30,17,13,2,2,35,12,23
"2021","Warwick 007G","E01031289",604,119,63,56,464,60,285,64,172,49,69,41,23,5,50,29,21,0,0,21,9,12
"2021","Warwick 007H","E01033253",741,349,65,284,255,21,103,48,45,10,87,78,8,1,27,15,12,17,17,137,5,132
"2021","Warwick 007I","E01033256",676,355,84,271,233,30,90,52,30,8,84,74,9,1,19,11,8,10,10,88,4,84
"2021","Warwick 008A","E01031309",944,347,95,252,538,55,231,66,121,44,159,111,45,3,89,48,41,4,4,59,12,47
"2021","Warwick 008B","E01031310",555,143,81,62,386,73,220,75,105,40,42,27,13,2,49,23,26,2,2,26,13,13
"2021","Warwick 008C","E01031311",591,205,106,99,353,49,167,52,79,36,71,37,31,3,62,41,21,4,4,33,12,21
"2021","Warwick 008D","E01031312",606,198,70,128,380,40,159,53,74,32,81,41,36,4,93,60,33,7,7,28,6,22
"2021","Warwick 008E","E01031313",590,142,90,52,426,118,220,103,76,41,52,24,24,4,32,18,14,4,4,22,5,17
"2021","Warwick 008F","E01031314",610,212,92,120,370,72,187,75,72,40,63,34,23,6,40,17,23,8,8,28,11,17
"2021","Warwick 009A","E01031290",804,299,79,220,437,56,210,84,101,25,127,105,19,3,39,22,17,5,5,68,10,58
"2021","Warwick 009B","E01031291",925,424,85,339,382,37,165,63,84,18,120,86,32,2,54,32,22,6,6,119,10,109
"2021","Warwick 009C","E01031292",668,176,78,98,461,55,219,70,116,33,124,87,34,3,60,37,23,3,3,31,13,18
"2021","Warwick 009D","E01031293",673,231,101,130,383,40,204,75,103,26,90,64,22,4,48,28,20,1,1,59,14,45
"2021","Warwick 009E","E01031294",639,230,70,160,361,48,211,63,119,29,64,50,10,4,34,19,15,4,4,48,6,42
"2021","Warwick 009F","E01031295",490,113,87,26,352,116,186,59,99,28,24,11,11,2,26,12,14,0,0,25,12,13
"2021","Warwick 010A","E01031271",906,397,160,237,428,70,195,75,97,23,86,58,27,1,66,35,31,11,11,81,7,74
"2021","Warwick 010B","E01031332",496,137,51,86,293,36,129,24,69,36,45,18,24,3,76,51,25,7,7,66,27,39
"2021","Warwick 010C","E01031333",477,102,44,58,290,51,159,34,83,42,31,16,12,3,40,21,19,9,9,85,35,50
"2021","Warwick 010D","E01031334",657,218,92,126,396,42,204,68,92,44,89,65,24,0,55,33,22,6,6,43,15,28
"2021","Warwick 010E","E01031335",611,239,29,210,283,32,142,42,85,15,82,69,11,2,19,10,9,8,8,89,14,75
"2021","Warwick 010F","E01031336",809,288,37,251,300,9,148,59,73,16,96,75,18,3,34,18,16,13,13,221,10,211
"2021","Warwick 010G","E01031337",853,294,65,229,498,21,217,87,114,16,166,124,40,2,88,61,27,6,6,61,11,50
"2021","Warwick 011A","E01031321",499,92,31,61,373,22,150,51,68,31,82,35,40,7,114,78,36,5,5,34,21,13
"2021","Warwick 011B","E01031322",877,287,96,191,536,77,262,87,127,48,114,72,39,3,79,44,35,4,4,54,14,40
"2021","Warwick 011C","E01031323",828,363,183,180,443,67,234,90,102,42,88,58,24,6,46,29,17,8,8,22,6,16
"2021","Warwick 011D","E01031324",1239,642,189,453,540,64,210,107,79,24,181,151,26,4,80,48,32,5,5,57,10,47
"2021","Warwick 011E","E01031325",614,193,99,94,392,37,172,54,82,36,95,62,29,4,85,50,35,3,3,29,9,20
"2021","Warwick 011G","E01033254",562,138,20,118,400,20,238,61,161,16,94,52,36,6,47,36,11,1,1,24,10,14
"2021","Warwick 011H","E01033255",984,173,69,104,766,48,435,100,290,45,137,64,66,7,140,110,30,6,6,45,21,24
"2021","Warwick 012A","E01031315",923,181,55,126,685,63,399,98,230,71,114,77,34,3,102,69,33,7,7,57,28,29
"2021","Warwick 012B","E01031316",765,359,205,154,364,74,165,68,71,26,87,61,26,0,37,22,15,1,1,42,14,28
"2021","Warwick 012C","E01031317",722,267,160,107,433,125,225,92,99,34,52,35,14,3,31,15,16,0,0,22,3,19
"2021","Warwick 012E","E01031319",891,302,115,187,551,79,296,94,158,44,103,66,32,5,64,29,35,9,9,38,12,26
"2021","Warwick 012F","E01031320",602,177,57,120,384,70,193,77,87,29,72,48,16,8,45,30,15,4,4,41,10,31
"2021","Warwick 012G","E01035037",576,151,42,109,401,21,207,54,136,17,96,54,40,2,73,65,8,4,4,24,12,12
"2021","Warwick 012H","E01035038",583,66,17,49,455,18,325,85,182,58,63,45,16,2,46,28,18,3,3,62,28,34
"2021","Warwick 012I","E01035039",521,107,26,81,393,44,191,45,140,6,76,43,33,0,82,71,11,0,0,21,11,10
"2021","Warwick 013A","E01031261",733,223,79,144,373,16,172,55,73,44,79,40,36,3,102,73,29,4,4,137,28,109
"2021","Warwick 013B","E01031262",606,237,58,179,305,10,162,59,73,30,77,48,24,5,53,35,18,3,3,64,10,54
"2021","Warwick 013C","E01031263",646,166,45,121,291,13,153,40,76,37,62,37,20,5,51,29,22,12,12,189,21,168
"2021","Warwick 013D","E01031264",632,141,64,77,417,31,181,49,101,31,84,32,41,11,112,63,49,9,9,74,25,49
"2021","Warwick 013E","E01031265",691,217,128,89,380,54,188,51,93,44,47,21,22,4,79,38,41,12,12,94,24,70
"2021","Warwick 013F","E01031266",768,314,49,265,291,6,170,77,81,12,65,48,15,2,39,19,20,11,11,163,10,153
"2021","Warwick 014A","E01031259",1096,179,40,139,861,59,448,122,277,49,208,129,74,5,141,111,30,5,5,56,26,30
"2021","Warwick 014B","E01031260",920,197,80,117,684,65,346,117,184,45,154,76,70,8,114,88,26,5,5,39,16,23
"2021","Warwick 014C","E01031267",743,172,116,56,551,144,313,115,136,62,54,33,16,5,40,23,17,0,0,20,6,14
"2021","Warwick 014D","E01031268",1086,270,100,170,787,96,463,137,263,63,130,100,29,1,94,63,31,4,4,29,7,22
"2021","Warwick 014E","E01031269",883,238,105,133,603,113,310,106,164,40,100,63,34,3,77,59,18,3,3,42,18,24
"2021","Warwick 015A","E01031327",624,175,82,93,394,45,194,70,80,44,66,43,21,2,86,42,44,3,3,55,17,38
"2021","Warwick 015B","E01031328",1177,271,109,162,839,94,474,143,250,81,153,91,56,6,114,81,33,4,4,67,24,43
"2021","Warwick 015C","E01031329",985,219,89,130,695,64,427,111,242,74,118,76,40,2,80,44,36,6,6,71,27,44
"2021","Warwick 015D","E01031330",602,155,63,92,412,51,222,59,112,51,75,44,27,4,59,23,36,5,5,35,16,19
"2021","Warwick 015E","E01031331",776,218,110,108,511,67,308,118,129,61,77,45,27,5,52,29,23,7,7,47,18,29
"2021","Bromsgrove 001A","E01032138",627,137,84,53,468,124,267,75,145,47,37,20,14,3,40,27,13,0,0,22,12,10
"2021","Bromsgrove 001B","E01032139",919,234,135,99,654,110,359,67,250,42,85,41,42,2,99,63,36,1,1,31,14,17
"2021","Bromsgrove 001C","E01032140",731,195,134,61,516,97,287,63,174,50,63,37,25,1,69,48,21,0,0,20,13,7
"2021","Bromsgrove 001D","E01032141",599,141,72,69,423,110,230,61,135,34,38,19,19,0,43,19,24,2,2,35,21,14
"2021","Bromsgrove 002A","E01032136",525,132,63,69,372,59,251,96,100,55,35,21,10,4,27,17,10,0,0,21,8,13
"2021","Bromsgrove 002B","E01032137",660,198,113,85,442,81,240,78,124,38,73,38,31,4,46,31,15,2,2,20,12,8
"2021","Bromsgrove 002C","E01032168",477,133,79,54,325,65,166,57,69,40,52,23,24,5,41,25,16,1,1,19,8,11
"2021","Bromsgrove 002D","E01032169",495,148,97,51,325,75,192,77,68,47,38,18,19,1,20,10,10,0,0,22,10,12
"2021","Bromsgrove 002E","E01032176",923,216,123,93,637,145,364,165,124,75,78,41,32,5,48,19,29,2,2,70,33,37
"2021","Bromsgrove 003A","E01032126",850,203,138,65,605,149,294,108,120,66,84,45,28,11,74,38,36,4,4,42,19,23
"2021","Bromsgrove 003B","E01032170",556,123,48,75,403,57,174,61,66,47,84,31,40,13,84,51,33,4,4,30,11,19
"2021","Bromsgrove 003C","E01032171",609,158,116,42,433,87,244,77,101,66,56,28,26,2,45,21,24,1,1,18,8,10
"2021","Bromsgrove 003D","E01032172",670,194,98,96,459,69,195,78,74,43,103,46,46,11,85,60,25,7,7,17,11,6
"2021","Bromsgrove 004A","E01032133",737,260,167,93,452,84,159,47,74,38,73,37,31,5,131,99,32,5,5,25,10,15
"2021","Bromsgrove 004B","E01032135",635,128,70,58,485,101,284,99,111,74,64,36,26,2,36,20,16,0,0,22,12,10
"2021","Bromsgrove 004C","E01032145",623,142,95,47,467,118,251,77,125,49,57,28,26,3,40,20,20,1,1,14,9,5
"2021","Bromsgrove 004D","E01032147",562,178,128,50,365,100,166,59,70,37,45,22,19,4,52,30,22,2,2,19,10,9
"2021","Bromsgrove 005A","E01032134",630,180,100,80,416,98,239,98,88,53,43,23,16,4,34,13,21,2,2,34,18,16
"2021","Bromsgrove 005B","E01032146",669,150,108,42,488,116,265,92,109,64,55,18,34,3,49,19,30,3,3,31,15,16
"2021","Bromsgrove 005C","E01032177",728,161,71,90,535,91,300,92,162,46,72,44,23,5,71,51,20,1,1,32,18,14
"2021","Bromsgrove 005D","E01032178",550,155,115,40,373,126,190,75,77,38,30,18,12,0,27,12,15,0,0,22,7,15
"2021","Bromsgrove 006A","E01032142",935,156,75,81,760,97,435,128,243,64,138,85,41,12,87,56,31,3,3,19,9,10
"2021","Bromsgrove 006B","E01032143",624,107,68,39,489,89,291,106,125,60,72,39,31,2,36,26,10,1,1,28,13,15
"2021","Bromsgrove 006C","E01032144",860,239,141,98,598,149,324,98,168,58,77,44,28,5,48,14,34,0,0,23,12,11
"2021","Bromsgrove 006D","E01032149",497,94,58,36,389,77,263,88,129,46,20,10,8,2,28,15,13,1,1,14,9,5
"2021","Bromsgrove 007A","E01032127",769,236,107,129,519,94,232,100,92,40,109,56,43,10,81,44,37,3,3,14,6,8
"2021","Bromsgrove 007B","E01032128",653,201,86,115,430,86,192,70,77,45,69,37,24,8,79,54,25,4,4,22,8,14
"2021","Bromsgrove 007C","E01032129",542,120,52,68,389,40,206,68,94,44,65,34,21,10,78,43,35,0,0,33,20,13
"2021","Bromsgrove 007D","E01032152",628,221,127,94,376,50,151,53,64,34,71,34,32,5,101,75,26,3,3,31,12,19
"2021","Bromsgrove 008A","E01032148",458,117,76,41,320,64,187,69,83,35,47,28,16,3,22,9,13,0,0,21,13,8
"2021","Bromsgrove 008B","E01032150",619,134,87,47,463,115,257,102,105,50,59,40,15,4,32,10,22,0,0,22,10,12
"2021","Bromsgrove 008C","E01032151",573,108,62,46,436,105,218,74,99,45,69,37,29,3,43,21,22,1,1,29,13,16
"2021","Bromsgrove 008D","E01032153",922,242,105,137,656,78,326,103,180,43,145,79,59,7,105,72,33,2,2,24,13,11
"2021","Bromsgrove 008E","E01032155",658,125,76,49,503,83,314,100,152,62,53,25,25,3,51,23,28,2,2,30,10,20
"2021","Bromsgrove 009A","E01032122",887,213,113,100,633,117,366,126,179,61,88,42,39,7,60,34,26,2,2,41,21,20
"2021","Bromsgrove 009B","E01032123",664,168,102,66,454,130,248,105,92,51,47,26,15,6,25,12,13,4,4,42,21,21
"2021","Bromsgrove 009C","E01032124",725,250,130,120,450,95,193,70,85,38,76,54,16,6,81,54,27,5,5,25,11,14
"2021","Bromsgrove 009D","E01032125",607,158,101,57,429,86,226,72,127,27,61,24,29,8,56,33,23,0,0,20,13,7
"2021","Bromsgrove 010A","E01032154",676,146,47,99,508,58,315,103,158,54,89,43,39,7,46,27,19,0,0,22,10,12
"2021","Bromsgrove 010B","E01032159",864,301,158,143,531,90,228,76,107,45,105,50,49,6,103,71,32,5,5,32,17,15
"2021","Bromsgrove 010C","E01032160",800,283,135,148,478,90,222,86,99,37,84,51,27,6,77,42,35,5,5,39,18,21
"2021","Bromsgrove 010D","E01032161",821,242,91,151,542,43,203,63,88,52,115,41,63,11,172,128,44,9,9,37,19,18
"2021","Bromsgrove 011A","E01032156",882,442,169,273,412,58,146,61,57,28,110,70,36,4,95,62,33,3,3,28,9,19
"2021","Bromsgrove 011B","E01032157",1043,661,361,300,371,97,133,69,49,15,73,47,21,5,67,47,20,1,1,11,6,5
"2021","Bromsgrove 011C","E01032173",669,135,66,69,502,82,257,88,107,62,81,34,44,3,79,48,31,3,3,32,12,20
"2021","Bromsgrove 011D","E01032175",686,173,98,75,485,116,246,88,88,70,70,37,23,10,52,21,31,1,1,28,7,21
"2021","Bromsgrove 012A","E01032158",653,154,106,48,488,141,244,79,115,50,55,33,18,4,47,27,20,1,1,11,7,4
"2021","Bromsgrove 012B","E01032162",758,164,107,57,567,119,316,82,183,51,68,37,27,4,64,41,23,0,0,27,10,17
"2021","Bromsgrove 012D","E01033059",590,117,37,80,456,37,279,71,164,44,80,43,35,2,58,47,11,2,2,17,7,10
"2021","Bromsgrove 012E","E01033061",670,114,69,45,530,73,338,89,198,51,66,19,41,6,52,41,11,1,1,26,11,15
"2021","Bromsgrove 013B","E01032131",642,168,58,110,440,52,171,41,86,44,84,31,47,6,132,95,37,1,1,34,20,14
"2021","Bromsgrove 013C","E01032132",928,350,190,160,541,59,222,77,99,46,116,58,51,7,141,88,53,3,3,37,17,20
"2021","Bromsgrove 013D","E01032174",675,188,76,112,453,54,216,65,113,38,86,42,41,3,92,65,27,5,5,34,13,21
"2021","Bromsgrove 013E","E01034316",627,236,48,188,376,22,148,40,91,17,121,77,40,4,84,60,24,1,1,15,5,10
"2021","Bromsgrove 013F","E01034317",577,138,47,91,412,38,190,63,94,33,97,41,50,6,83,59,24,4,4,27,8,19
"2021","Bromsgrove 014E","E01033060",466,112,58,54,332,76,193,77,70,46,37,28,6,3,25,12,13,1,1,22,12,10
"2021","Bromsgrove 014F","E01033062",914,175,86,89,715,134,407,156,175,76,96,52,40,4,70,39,31,8,8,24,12,12
"2021","Bromsgrove 014G","E01033243",726,195,57,138,507,79,258,85,122,51,111,71,34,6,57,37,20,2,2,24,6,18
"2021","Bromsgrove 014H","E01034318",647,188,75,113,439,81,207,87,76,44,95,65,24,6,56,31,25,0,0,20,10,10
"2021","Bromsgrove 014I","E01034319",558,153,86,67,386,50,175,63,86,26,87,47,38,2,74,48,26,0,0,19,8,11
"2021","Malvern Hills 001A","E01032193",959,204,119,85,705,181,352,165,117,70,107,53,49,5,63,29,34,2,2,50,18,32
"2021","Malvern Hills 001B","E01032212",892,187,101,86,653,149,355,133,147,75,85,47,34,4,62,33,29,2,2,52,17,35
"2021","Malvern Hills 001C","E01032213",748,172,116,56,533,135,284,136,93,55,68,37,26,5,43,23,20,3,3,43,11,32
"2021","Malvern Hills 001D","E01032214",1056,422,237,185,612,134,270,111,107,52,106,46,53,7,94,56,38,8,8,22,10,12
"2021","Malvern Hills 002A","E01032181",913,228,130,98,634,154,328,136,138,54,94,48,37,9,53,26,27,5,5,51,22,29
"2021","Malvern Hills 002B","E01032190",890,221,147,74,637,124,347,135,153,59,84,54,24,6,79,43,36,3,3,32,12,20
"2021","Malvern Hills 002C","E01032199",837,207,111,96,600,129,338,131,143,64,59,35,24,0,74,39,35,0,0,30,10,20
"2021","Malvern Hills 002D","E01032223",888,185,112,73,655,143,382,141,153,88,83,42,32,9,45,28,17,2,2,48,21,27
"2021","Malvern Hills 003A","E01032179",714,165,94,71,520,139,255,128,77,50,75,38,34,3,48,21,27,3,3,29,15,14
"2021","Malvern Hills 003B","E01032180",879,189,100,89,640,148,333,152,119,62,101,59,38,4,56,34,22,2,2,50,16,34
"2021","Malvern Hills 003C","E01032182",965,218,123,95,696,170,365,134,171,60,98,52,37,9,58,36,22,5,5,51,20,31
"2021","Malvern Hills 003D","E01032183",636,136,83,53,471,110,236,75,111,50,71,27,35,9,51,26,25,3,3,29,10,19
"2021","Malvern Hills 004A","E01032194",733,244,157,87,449,92,159,74,59,26,89,37,45,7,108,68,40,1,1,40,18,22
"2021","Malvern Hills 004B","E01032195",744,262,162,100,468,87,219,97,82,40,97,62,30,5,63,34,29,2,2,14,2,12
"2021","Malvern Hills 004C","E01032196",797,303,174,129,465,93,204,102,66,36,91,58,25,8,74,37,37,3,3,29,13,16
"2021","Malvern Hills 004D","E01032197",764,343,177,166,396,88,203,96,77,30,57,40,15,2,45,19,26,3,3,25,9,16
"2021","Malvern Hills 005A","E01032205",466,140,96,44,300,84,152,75,40,37,43,22,15,6,21,6,15,0,0,26,13,13
"2021","Malvern Hills 005B","E01032206",572,152,105,47,398,112,199,92,66,41,47,30,15,2,38,20,18,2,2,22,9,13
"2021","Malvern Hills 005C","E01032207",766,152,86,66,589,123,309,124,139,46,92,58,32,2,59,38,21,6,6,25,8,17
"2021","Malvern Hills 005D","E01032217",700,181,103,78,487,138,254,95,107,52,43,24,15,4,49,25,24,3,3,32,16,16
"2021","Malvern Hills 006A","E01032188",798,227,112,115,525,69,253,84,119,50,103,48,42,13,94,49,45,6,6,46,20,26
"2021","Malvern Hills 006B","E01032189",1174,301,141,160,831,138,392,143,192,57,172,75,88,9,125,83,42,4,4,42,14,28
"2021","Malvern Hills 006C","E01032220",662,231,69,162,399,86,225,104,85,36,62,40,18,4,22,7,15,4,4,32,12,20
"2021","Malvern Hills 006D","E01032221",559,150,57,93,388,91,204,104,67,33,53,32,19,2,36,18,18,4,4,21,6,15
"2021","Malvern Hills 006E","E01032222",605,186,75,111,398,54,192,70,83,39,89,44,36,9,63,47,16,0,0,21,4,17
"2021","Malvern Hills 007A","E01032201",691,185,90,95,486,93,210,80,86,44,93,44,44,5,86,54,32,4,4,20,10,10
"2021","Malvern Hills 007B","E01032202",739,252,122,130,455,55,168,61,71,36,105,39,59,7,125,83,42,2,2,32,17,15
"2021","Malvern Hills 007C","E01032203",695,265,129,136,408,67,194,73,78,43,83,46,34,3,62,36,26,2,2,22,8,14
"2021","Malvern Hills 007D","E01032204",672,214,81,133,429,19,143,49,59,35,94,21,65,8,169,126,43,4,4,29,15,14
"2021","Malvern Hills 008A","E01032191",1190,243,133,110,891,176,479,193,211,75,134,71,58,5,99,64,35,3,3,56,24,32
"2021","Malvern Hills 008B","E01032192",910,239,148,91,646,129,311,117,147,47,128,75,48,5,75,50,25,3,3,25,14,11
"2021","Malvern Hills 008C","E01032211",846,207,153,54,601,166,296,160,95,41,89,53,31,5,47,33,14,3,3,38,18,20
"2021","Malvern Hills 009A","E01032184",772,312,198,114,441,161,178,76,66,36,62,40,18,4,40,13,27,0,0,19,4,15
"2021","Malvern Hills 009B","E01032185",693,192,137,55,470,148,207,93,75,39,60,36,20,4,53,33,20,2,2,31,8,23
"2021","Malvern Hills 009C","E01032186",555,223,111,112,309,62,143,64,62,17,61,33,22,6,41,23,18,2,2,23,3,20
"2021","Malvern Hills 009D","E01032187",786,302,140,162,452,62,195,87,72,36,90,33,47,10,101,61,40,4,4,32,15,17
"2021","Malvern Hills 010A","E01032208",809,379,178,201,390,131,149,77,49,23,72,56,13,3,37,17,20,1,1,40,10,30
"2021","Malvern Hills 010B","E01032209",646,277,153,124,343,108,149,86,43,20,54,43,8,3,29,16,13,3,3,26,2,24
"2021","Malvern Hills 010C","E01032210",526,190,106,84,320,94,124,61,39,24,51,21,20,10,50,29,21,1,1,16,8,8
"2021","Malvern Hills 010D","E01032218",661,191,103,88,440,107,213,92,84,37,64,41,21,2,56,26,30,0,0,30,7,23
"2021","Malvern Hills 010E","E01032219",776,242,119,123,506,143,260,115,102,43,62,34,25,3,39,18,21,2,2,28,11,17
"2021","Malvern Hills 011A","E01032198",871,207,123,84,607,148,348,152,120,76,63,33,20,10,39,19,20,9,9,57,20,37
"2021","Malvern Hills 011B","E01032200",1013,241,147,94,725,189,372,139,169,64,91,56,32,3,67,51,16,6,6,47,20,27
"2021","Malvern Hills 011C","E01032215",534,210,122,88,299,73,119,59,33,27,55,35,18,2,48,23,25,4,4,25,8,17
"2021","Malvern Hills 011D","E01032216",814,327,157,170,457,98,211,109,71,31,88,53,29,6,59,36,23,1,1,30,6,24
"2021","Redditch 001A","E01032226",1128,259,100,159,804,114,373,131,179,63,186,99,72,15,128,99,29,3,3,65,34,31
"2021","Redditch 001B","E01032227",467,106,77,29,346,127,173,71,62,40,34,17,15,2,12,6,6,0,0,15,7,8
"2021","Redditch 001C","E01032243",572,128,80,48,432,103,256,110,78,68,50,29,18,3,22,8,14,1,1,12,4,8
"2021","Redditch 001D","E01032244",632,176,76,100,429,72,194,83,85,26,77,42,30,5,82,55,27,4,4,27,10,17
"2021","Redditch 002A","E01032240",548,181,62,119,325,39,129,59,46,24,75,24,48,3,74,51,23,8,8,42,11,31
"2021","Redditch 002B","E01032241",499,106,40,66,359,27,129,31,69,29,77,36,38,3,125,81,44,1,1,34,16,18
"2021","Redditch 002C","E01032242",589,180,56,124,378,36,175,60,95,20,86,50,31,5,78,54,24,3,3,31,18,13
"2021","Redditch 002D","E01032245",685,269,82,187,389,30,140,39,84,17,106,56,44,6,110,86,24,3,3,27,5,22
"2021","Redditch 003A","E01032232",750,345,120,225,381,23,167,59,68,40,88,47,32,9,102,63,39,1,1,24,9,15
"2021","Redditch 003C","E01032234",774,277,91,186,447,39,181,61,91,29,85,40,40,5,133,93,40,9,9,50,26,24
"2021","Redditch 003D","E01032235",721,210,118,92,466,35,158,38,82,38,107,40,61,6,161,120,41,5,5,45,21,24
"2021","Redditch 003E","E01034320",561,80,9,71,462,12,207,62,135,10,165,94,68,3,77,66,11,1,1,19,13,6
"2021","Redditch 003F","E01034321",487,112,36,76,359,34,197,79,89,29,84,47,32,5,44,27,17,0,0,16,6,10
"2021","Redditch 003G","E01034322",573,110,30,80,437,43,248,84,130,34,90,54,31,5,53,38,15,3,3,26,12,14
"2021","Redditch 004A","E01032224",774,251,65,186,427,31,185,53,95,37,107,72,28,7,87,50,37,17,17,96,43,53
"2021","Redditch 004B","E01032225",494,155,74,81,306,26,111,28,57,26,66,30,30,6,100,70,30,3,3,33,12,21
"2021","Redditch 004C","E01032239",678,197,82,115,363,8,173,43,98,32,83,41,42,0,84,64,20,15,15,118,58,60
"2021","Redditch 004D","E01032262",842,253,106,147,520,45,235,80,113,42,101,44,48,9,130,84,46,9,9,69,32,37
"2021","Redditch 005A","E01032273",569,133,79,54,416,103,222,104,82,36,55,32,19,4,35,11,24,1,1,20,11,9
"2021","Redditch 005B","E01032275",608,169,93,76,418,57,198,73,95,30,88,47,34,7,74,41,33,1,1,21,12,9
"2021","Redditch 005C","E01032277",499,132,48,84,327,30,147,47,63,37,71,33,35,3,77,42,35,2,2,40,19,21
"2021","Redditch 005D","E01032278",725,276,69,207,406,30,135,48,62,25,91,44,42,5,142,94,48,8,8,43,17,26
"2021","Redditch 006A","E01032236",824,325,90,235,441,30,187,60,88,39,130,81,45,4,82,54,28,12,12,58,26,32
"2021","Redditch 006B","E01032237",608,190,80,110,384,73,209,81,83,45,55,34,16,5,45,23,22,2,2,34,13,21
"2021","Redditch 006C","E01032238",563,163,53,110,347,47,185,66,81,38,66,40,23,3,45,23,22,4,4,53,17,36
"2021","Redditch 006D","E01032264",649,134,83,51,453,51,223,59,108,56,72,23,44,5,104,75,29,3,3,62,23,39
"2021","Redditch 007A","E01032255",545,120,74,46,385,55,210,63,104,43,73,37,33,3,46,24,22,1,1,40,21,19
"2021","Redditch 007B","E01032263",716,200,124,76,465,86,213,72,95,46,75,40,32,3,85,40,45,6,6,51,23,28
"2021","Redditch 007C","E01032266",716,213,85,128,469,113,220,97,85,38,71,43,25,3,61,34,27,4,4,34,11,23
"2021","Redditch 007D","E01032274",516,100,61,39,395,84,208,79,84,45,60,28,29,3,40,21,19,3,3,21,12,9
"2021","Redditch 008A","E01032259",620,201,132,69,396,80,205,72,81,52,63,36,22,5,46,21,25,2,2,23,11,12
"2021","Redditch 008B","E01032269",754,269,121,148,453,80,221,101,82,38,87,48,33,6,62,35,27,3,3,32,12,20
"2021","Redditch 008C","E01032270",570,112,70,42,434,70,258,80,129,49,67,38,25,4,38,23,15,1,1,24,11,13
"2021","Redditch 008D","E01032271",795,120,37,83,642,68,365,124,176,65,136,60,68,8,72,53,19,1,1,33,15,18
"2021","Redditch 008E","E01032272",530,166,103,63,349,85,169,75,60,34,52,27,22,3,41,17,24,2,2,15,8,7
"2021","Redditch 009A","E01032253",643,108,49,59,506,79,245,85,101,59,122,72,47,3,58,39,19,2,2,29,9,20
"2021","Redditch 009B","E01032265",639,174,94,80,413,50,163,55,79,29,92,35,52,5,103,68,35,5,5,52,27,25
"2021","Redditch 009C","E01032267",668,139,66,73,459,46,217,61,102,54,91,32,48,11,102,64,38,3,3,70,32,38
"2021","Redditch 009D","E01032268",483,94,57,37,368,80,197,82,75,40,59,29,19,11,29,12,17,3,3,21,10,11
"2021","Redditch 009E","E01032276",601,117,56,61,461,93,221,73,111,37,93,43,42,8,52,26,26,2,2,23,12,11
"2021","Redditch 010A","E01032250",507,117,35,82,346,31,134,40,71,23,84,35,45,4,93,66,27,4,4,44,23,21
"2021","Redditch 010B","E01032251",702,173,48,125,467,43,176,51,92,33,126,65,58,3,117,80,37,5,5,62,26,36
"2021","Redditch 010C","E01032252",551,184,56,128,325,20,123,28,67,28,68,24,37,7,109,84,25,5,5,42,18,24
"2021","Redditch 010D","E01032254",844,158,83,75,628,77,263,73,135,55,159,70,73,16,125,85,40,4,4,58,27,31
"2021","Redditch 011A","E01032256",629,213,99,114,394,67,198,90,70,38,66,36,23,7,63,33,30,0,0,22,5,17
"2021","Redditch 011B","E01032257",572,118,62,56,438,75,251,93,99,59,71,34,33,4,39,21,18,2,2,16,8,8
"2021","Redditch 011C","E01032258",702,251,108,143,430,79,195,90,70,35,94,49,37,8,61,36,25,1,1,21,5,16
"2021","Redditch 011D","E01032260",701,319,135,184,358,39,112,48,40,24,91,48,39,4,109,72,37,7,7,24,9,15
"2021","Redditch 012A","E01032246",559,124,69,55,416,95,216,72,99,45,64,30,32,2,40,23,17,1,1,19,10,9
"2021","Redditch 012B","E01032247",635,228,112,116,377,52,169,63,69,37,80,45,28,7,75,38,37,1,1,30,17,13
"2021","Redditch 012C","E01032248",534,89,43,46,431,78,286,96,132,58,49,33,15,1,18,10,8,0,0,14,8,6
"2021","Redditch 012D","E01032249",689,232,81,151,445,54,203,77,78,48,108,62,41,5,79,45,34,1,1,12,4,8
"2021","Redditch 012E","E01032261",578,144,100,44,408,89,222,68,103,51,54,26,24,4,40,18,22,3,3,26,11,15
"2021","Redditch 013A","E01032228",548,126,64,62,395,89,224,92,86,46,48,37,8,3,31,13,18,3,3,27,8,19
"2021","Redditch 013B","E01032229",623,199,69,130,387,49,171,73,66,32,82,43,33,6,80,56,24,5,5,37,15,22
"2021","Redditch 013C","E01032230",596,130,85,45,448,88,263,84,126,53,55,27,23,5,42,25,17,0,0,18,11,7
"2021","Redditch 013D","E01032231",818,251,128,123,529,102,256,90,115,51,99,52,43,4,66,38,28,6,6,38,18,20
"2021","Worcester 001A","E01032296",718,268,100,168,418,54,187,56,94,37,107,77,27,3,64,44,20,6,6,32,3,29
"2021","Worcester 001B","E01032297",670,150,89,61,508,96,278,99,143,36,80,49,26,5,49,21,28,5,5,12,5,7
"2021","Worcester 001C","E01032298",769,186,128,58,555,138,312,119,152,41,70,29,33,8,34,14,20,1,1,28,7,21
"2021","Worcester 001D","E01032299",677,195,81,114,448,57,237,90,115,32,93,57,30,6,57,34,23,4,4,34,13,21
"2021","Worcester 001E","E01032300",712,189,140,49,501,146,266,91,132,43,53,27,23,3,35,18,17,1,1,22,9,13
"2021","Worcester 002A","E01032303",512,112,53,59,369,28,121,41,50,30,93,23,62,8,123,87,36,4,4,31,13,18
"2021","Worcester 002B","E01032304",621,182,66,116,403,30,155,50,65,40,88,33,49,6,121,81,40,9,9,36,19,17
"2021","Worcester 002C","E01032331",653,273,100,173,353,36,138,49,60,29,76,29,37,10,100,74,26,3,3,27,12,15
"2021","Worcester 002D","E01032332",644,275,77,198,355,22,112,42,44,26,75,31,33,11,141,120,21,5,5,14,7,7
"2021","Worcester 003A","E01032330",593,248,82,166,322,31,132,54,54,24,94,63,29,2,58,30,28,7,7,23,10,13
"2021","Worcester 003B","E01032334",1004,273,78,195,693,38,380,148,178,54,183,120,52,11,90,52,38,2,2,38,12,26
"2021","Worcester 003C","E01032335",578,99,31,68,453,56,295,88,160,47,61,34,26,1,40,23,17,1,1,26,11,15
"2021","Worcester 003D","E01032336",635,149,53,96,461,47,247,94,107,46,112,74,34,4,55,33,22,0,0,25,8,17
"2021","Worcester 004A","E01032279",528,143,59,84,355,35,173,68,78,27,70,36,30,4,75,50,25,2,2,30,7,23
"2021","Worcester 004B","E01032312",659,217,49,168,386,33,163,58,81,24,113,80,24,9,69,44,25,8,8,56,15,41
"2021","Worcester 004C","E01032327",1024,407,173,234,579,59,267,106,130,31,161,106,49,6,88,59,29,4,4,38,18,20
"2021","Worcester 004D","E01032328",649,178,104,74,436,66,207,89,71,47,69,31,33,5,90,44,46,4,4,35,11,24
"2021","Worcester 004E","E01032329",864,251,136,115,577,96,327,117,153,57,90,48,36,6,59,24,35,5,5,36,18,18
"2021","Worcester 005A","E01032301",611,174,97,77,398,67,183,69,88,26,91,53,31,7,55,31,24,2,2,39,11,28
"2021","Worcester 005B","E01032302",565,197,59,138,309,26,147,43,82,22,63,30,29,4,60,32,28,13,13,59,30,29
"2021","Worcester 005C","E01032310",656,196,55,141,417,24,185,68,79,38,120,75,39,6,80,46,34,8,8,43,15,28
"2021","Worcester 005D","E01032311",626,170,63,107,416,26,153,51,65,37,114,57,46,11,117,73,44,6,6,40,20,20
"2021","Worcester 005E","E01032313",492,125,54,71,326,21,127,44,63,20,76,31,35,10,97,66,31,5,5,41,20,21
"2021","Worcester 005F","E01032333",768,204,53,151,525,27,202,61,108,33,134,41,82,11,159,126,33,3,3,39,21,18
"2021","Worcester 006A","E01032314",433,117,57,60,257,54,118,46,46,26,55,29,23,3,26,17,9,4,4,59,8,51
"2021","Worcester 006B","E01032315",503,114,54,60,283,58,124,46,52,26,63,44,19,0,31,20,11,7,7,106,11,95
"2021","Worcester 006C","E01032316",499,132,101,31,351,104,163,63,60,40,55,29,18,8,26,13,13,3,3,16,4,12
"2021","Worcester 006D","E01032317",675,227,127,100,399,99,184,57,73,54,67,35,26,6,45,25,20,4,4,49,3,46
"2021","Worcester 007A","E01032280",904,429,204,225,441,67,202,97,75,30,110,86,23,1,56,33,23,6,6,34,8,26
"2021","Worcester 007B","E01032281",663,237,64,173,372,24,143,64,60,19,135,104,28,3,62,31,31,8,8,54,9,45
"2021","Worcester 007C","E01032282",931,458,81,377,372,24,126,59,55,12,153,127,24,2,59,38,21,10,10,101,19,82
"2021","Worcester 007E","E01033246",731,386,148,238,308,53,117,54,45,18,88,68,19,1,46,21,25,4,4,37,2,35
"2021","Worcester 007F","E01033247",613,353,32,321,194,5,51,31,18,2,103,86,15,2,21,17,4,14,14,66,5,61
"2021","Worcester 008A","E01032337",1002,215,85,130,716,89,385,134,193,58,134,66,59,9,106,73,33,2,2,71,33,38
"2021","Worcester 008B","E01032338",811,215,44,171,569,33,311,106,163,42,128,85,37,6,94,70,24,3,3,27,10,17
"2021","Worcester 008C","E01032339",653,124,53,71,502,60,328,113,151,64,63,25,35,3,50,24,26,1,1,27,13,14
"2021","Worcester 009A","E01032318",667,173,64,109,438,30,170,51,92,27,94,33,51,10,140,96,44,4,4,56,28,28
"2021","Worcester 009B","E01032319",751,169,95,74,491,107,220,75,96,49,85,40,40,5,77,49,28,2,2,91,12,79
"2021","Worcester 009C","E01032320",638,148,67,81,373,37,168,51,87,30,104,57,39,8,61,36,25,3,3,117,16,101
"2021","Worcester 009D","E01032321",762,195,73,122,504,62,208,74,95,39,113,42,63,8,112,75,37,9,9,63,25,38
"2021","Worcester 009E","E01032322",956,500,240,260,354,61,117,43,50,24,108,78,20,10,59,32,27,9,9,102,13,89
"2021","Worcester 010A","E01032305",702,175,74,101,460,55,211,80,84,47,101,53,40,8,83,52,31,10,10,67,33,34
"2021","Worcester 010B","E01032306",607,167,62,105,383,36,199,60,100,39,72,40,24,8,72,44,28,4,4,57,28,29
"2021","Worcester 010C","E01032307",667,139,67,72,454,46,223,50,130,43,64,26,35,3,109,75,34,12,12,74,35,39
"2021","Worcester 010D","E01032309",714,215,101,114,458,54,234,63,123,48,88,49,34,5,78,49,29,4,4,41,24,17
"2021","Worcester 011A","E01032285",729,231,87,144,457,66,241,74,129,38,83,46,34,3,60,41,19,7,7,41,12,29
"2021","Worcester 011B","E01032292",635,219,47,172,344,18,177,50,102,25,88,63,22,3,55,33,22,6,6,72,32,40
"2021","Worcester 011D","E01032294",634,231,93,138,353,62,174,52,89,33,66,35,25,6,46,34,12,5,5,50,33,17
"2021","Worcester 011E","E01033248",710,401,94,307,271,19,64,37,22,5,106,84,19,3,68,53,15,14,14,38,2,36
"2021","Worcester 011F","E01033249",752,398,85,313,299,24,100,45,42,13,99,81,17,1,67,51,16,9,9,55,14,41
"2021","Worcester 012A","E01032286",1103,304,126,178,735,88,347,116,174,57,180,101,72,7,117,85,32,3,3,64,25,39
"2021","Worcester 012B","E01032287",678,194,76,118,428,60,206,69,104,33,89,46,31,12,69,44,25,4,4,56,15,41
"2021","Worcester 012C","E01032288",666,180,82,98,448,83,228,87,96,45,78,50,23,5,55,31,24,4,4,38,13,25
"2021","Worcester 012D","E01032289",627,142,109,33,452,138,222,81,90,51,57,32,18,7,34,15,19,1,1,33,12,21
"2021","Worcester 012E","E01032290",658,207,130,77,429,119,178,68,70,40,70,45,21,4,59,31,28,3,3,22,9,13
"2021","Worcester 013A","E01032283",697,172,92,80,484,82,228,62,121,45,87,43,40,4,86,44,42,1,1,41,12,29
"2021","Worcester 013B","E01032284",835,221,120,101,571,149,299,107,137,55,75,44,27,4,45,17,28,3,3,43,17,26
"2021","Worcester 013D","E01032308",783,168,89,79,581,89,300,97,159,44,123,76,39,8,64,42,22,5,5,34,16,18
"2021","Worcester 013E","E01034323",871,364,72,292,458,43,178,83,80,15,144,106,36,2,90,60,30,3,3,49,9,40
"2021","Worcester 013F","E01034324",769,289,76,213,420,62,171,88,68,15,124,88,32,4,59,38,21,4,4,60,11,49
"2021","Worcester 014A","E01032323",616,122,72,50,468,94,245,88,108,49,63,29,28,6,64,38,26,2,2,26,11,15
"2021","Worcester 014B","E01032324",610,213,83,130,378,40,198,72,78,48,89,58,29,2,50,31,19,1,1,19,6,13
"2021","Worcester 014C","E01032325",642,189,51,138,428,26,229,79,105,45,117,68,42,7,55,35,20,1,1,25,11,14
"2021","Worcester 014D","E01032326",609,161,97,64,432,85,229,104,77,48,79,45,28,6,37,19,18,2,2,16,6,10
"2021","Wychavon 001B","E01032386",603,144,72,72,426,94,236,92,95,49,52,33,17,2,43,25,18,1,1,33,16,17
"2021","Wychavon 001C","E01032387",704,191,98,93,481,96,245,92,100,53,71,38,29,4,67,52,15,2,2,32,16,16
"2021","Wychavon 001D","E01032401",1141,262,118,144,829,174,357,138,172,47,190,116,69,5,108,77,31,0,0,50,27,23
"2021","Wychavon 001E","E01034325",609,139,60,79,426,62,237,75,116,46,79,46,28,5,47,28,19,1,1,44,17,27
"2021","Wychavon 001F","E01034326",592,167,71,96,404,54,219,80,101,38,81,43,32,6,48,33,15,2,2,21,5,16
"2021","Wychavon 002A","E01032368",532,183,83,100,316,36,137,39,67,31,65,26,32,7,76,40,36,2,2,33,16,17
"2021","Wychavon 002B","E01032369",620,180,75,105,411,31,151,51,80,20,103,37,58,8,122,86,36,4,4,29,10,19
"2021","Wychavon 002C","E01032370",506,116,51,65,365,71,168,70,76,22,64,34,27,3,60,38,22,2,2,25,11,14
"2021","Wychavon 002D","E01032371",594,192,100,92,378,44,183,77,71,35,72,38,28,6,76,46,30,3,3,24,8,16
"2021","Wychavon 003A","E01032359",1085,639,377,262,415,111,133,65,49,19,82,51,28,3,84,51,33,5,5,31,8,23
"2021","Wychavon 003B","E01032360",827,233,142,91,566,92,262,103,104,55,102,51,41,10,106,71,35,4,4,28,14,14
"2021","Wychavon 003C","E01032361",764,219,113,106,518,148,268,106,116,46,61,36,23,2,39,20,19,2,2,27,14,13
"2021","Wychavon 004A","E01032357",507,172,95,77,323,67,152,58,60,34,62,38,20,4,40,24,16,2,2,12,7,5
"2021","Wychavon 004B","E01032358",654,263,88,175,368,56,167,62,62,43,70,23,38,9,71,32,39,4,4,23,7,16
"2021","Wychavon 004C","E01032365",786,237,142,95,515,74,215,75,87,53,111,36,65,10,114,67,47,1,1,34,19,15
"2021","Wychavon 004D","E01032367",658,190,132,58,448,138,213,66,104,43,46,24,21,1,51,34,17,0,0,20,9,11
"2021","Wychavon 005B","E01032363",647,126,74,52,502,112,282,118,105,59,73,36,29,8,33,20,13,2,2,19,8,11
"2021","Wychavon 005C","E01032364",703,126,79,47,549,137,298,115,125,58,58,38,18,2,52,31,21,4,4,28,10,18
"2021","Wychavon 005D","E01032366",751,273,157,116,457,111,212,74,90,48,77,46,26,5,55,33,22,2,2,21,3,18
"2021","Wychavon 005E","E01034327",681,130,72,58,524,98,255,83,130,42,95,50,39,6,76,53,23,0,0,27,12,15
"2021","Wychavon 005F","E01034328",674,96,24,72,553,31,286,95,158,33,140,68,68,4,95,79,16,1,1,25,10,15
"2021","Wychavon 006A","E01032399",946,214,111,103,684,105,337,102,181,54,125,61,57,7,117,76,41,0,0,48,25,23
"2021","Wychavon 006B","E01032400",1030,222,123,99,760,157,423,147,208,68,106,53,40,13,74,43,31,0,0,48,19,29
"2021","Wychavon 006C","E01032404",1100,284,170,114,759,167,435,225,144,66,96,60,31,5,60,34,26,1,1,57,23,34
"2021","Wychavon 007A","E01032345",634,130,65,65,473,114,265,109,99,57,49,30,17,2,45,28,17,0,0,31,12,19
"2021","Wychavon 007B","E01032346",608,119,73,46,469,118,266,105,129,32,45,34,11,0,37,22,15,3,3,20,8,12
"2021","Wychavon 007C","E01032395",539,104,48,56,403,103,214,94,83,37,65,33,23,9,19,14,5,2,2,32,15,17
"2021","Wychavon 007D","E01032417",641,158,94,64,451,114,242,92,97,53,61,33,26,2,34,15,19,0,0,32,14,18
"2021","Wychavon 008A","E01032392",707,162,94,68,493,137,261,120,90,51,61,43,15,3,33,15,18,1,1,52,23,29
"2021","Wychavon 008B","E01032393",773,171,101,70,579,143,314,109,148,57,66,37,26,3,56,28,28,0,0,23,5,18
"2021","Wychavon 008C","E01032394",531,124,65,59,382,94,217,104,72,41,44,31,10,3,27,14,13,0,0,25,14,11
"2021","Wychavon 008D","E01032416",468,81,52,29,356,98,212,102,70,40,36,18,12,6,10,5,5,0,0,31,12,19
"2021","Wychavon 009A","E01032355",643,133,62,71,480,113,227,95,90,42,76,37,27,12,62,37,25,2,2,30,13,17
"2021","Wychavon 009B","E01032356",477,99,64,35,362,73,215,79,94,42,41,24,16,1,33,16,17,0,0,16,9,7
"2021","Wychavon 009C","E01032402",620,117,42,75,480,40,289,93,151,45,86,48,34,4,64,46,18,1,1,23,9,14
"2021","Wychavon 009D","E01032403",978,233,82,151,701,86,354,127,186,41,139,85,47,7,118,87,31,4,4,44,21,23
"2021","Wychavon 010A","E01032375",521,123,82,41,378,108,206,104,65,37,40,24,13,3,23,12,11,1,1,20,8,12
"2021","Wychavon 010B","E01032382",608,190,103,87,405,89,207,87,75,45,57,33,19,5,50,18,32,2,2,13,3,10
"2021","Wychavon 010C","E01032383",643,145,78,67,464,139,246,123,78,45,49,38,9,2,29,13,16,1,1,34,15,19
"2021","Wychavon 010D","E01032410",613,139,75,64,448,128,219,104,76,39,59,33,22,4,39,16,23,3,3,26,7,19
"2021","Wychavon 010E","E01032411",766,210,117,93,523,91,268,101,113,54,96,50,34,12,67,40,27,1,1,33,8,25
"2021","Wychavon 011A","E01032390",689,123,65,58,537,109,282,116,122,44,93,57,32,4,52,31,21,1,1,29,10,19
"2021","Wychavon 011B","E01032391",567,139,59,80,408,61,184,73,70,41,85,46,33,6,78,49,29,0,0,20,8,12
"2021","Wychavon 011C","E01032414",672,167,107,60,482,122,247,116,76,55,70,37,30,3,41,25,16,2,2,23,9,14
"2021","Wychavon 011D","E01032415",572,127,63,64,417,69,216,94,86,36,85,46,31,8,45,25,20,2,2,28,10,18
"2021","Wychavon 012A","E01032405",819,240,134,106,554,141,232,102,96,34,83,44,33,6,94,61,33,4,4,25,7,18
"2021","Wychavon 012B","E01032406",756,399,223,176,334,84,100,45,37,18,72,40,26,6,74,60,14,4,4,23,9,14
"2021","Wychavon 012C","E01032407",657,217,143,74,411,98,197,87,65,45,57,27,26,4,59,31,28,0,0,29,12,17
"2021","Wychavon 012D","E01032408",665,197,147,50,455,171,180,86,55,39,64,33,27,4,37,23,14,3,3,13,4,9
"2021","Wychavon 012E","E01032409",1071,344,157,187,690,78,308,125,144,39,162,84,67,11,134,92,42,8,8,37,16,21
"2021","Wychavon 013A","E01032340",796,203,101,102,557,90,262,98,115,49,114,51,54,9,89,49,40,2,2,36,11,25
"2021","Wychavon 013B","E01032341",616,144,82,62,441,110,236,122,69,45,47,32,12,3,47,24,23,1,1,31,11,20
"2021","Wychavon 013C","E01032349",745,202,111,91,511,108,262,118,93,51,96,53,38,5,42,23,19,3,3,32,9,23
"2021","Wychavon 013D","E01032350",524,146,78,68,359,80,182,80,75,27,57,28,23,6,38,25,13,2,2,19,4,15
"2021","Wychavon 013E","E01032388",587,137,85,52,421,118,211,88,94,29,54,27,21,6,38,20,18,0,0,29,10,19
"2021","Wychavon 013F","E01032389",616,185,112,73,403,93,182,89,64,29,64,37,22,5,62,37,25,2,2,28,10,18
"2021","Wychavon 014B","E01032377",954,435,155,280,460,45,178,73,85,20,124,75,45,4,100,64,36,13,13,59,24,35
"2021","Wychavon 014C","E01032378",840,342,186,156,439,55,193,72,82,39,87,47,32,8,98,61,37,6,6,59,28,31
"2021","Wychavon 014D","E01034329",664,311,87,224,285,30,94,41,46,7,89,59,26,4,58,37,21,14,14,68,21,47
"2021","Wychavon 014E","E01034330",596,191,78,113,349,41,140,46,65,29,108,64,42,2,50,34,16,10,10,56,14,42
"2021","Wychavon 015A","E01032376",669,194,84,110,436,107,222,86,93,43,64,44,19,1,41,24,17,2,2,39,10,29
"2021","Wychavon 015B","E01032384",668,176,73,103,458,49,214,88,85,41,97,41,47,9,89,55,34,9,9,34,11,23
"2021","Wychavon 015C","E01032385",1038,326,183,143,683,173,271,111,131,29,142,82,58,2,91,62,29,6,6,29,14,15
"2021","Wychavon 015D","E01032396",732,158,59,99,535,62,290,92,141,57,127,80,42,5,53,37,16,3,3,39,16,23
"2021","Wychavon 016A","E01032342",1116,228,77,151,802,74,362,98,207,57,210,92,110,8,145,100,45,11,11,86,46,40
"2021","Wychavon 016B","E01032344",950,217,102,115,693,152,332,119,162,51,123,70,49,4,84,56,28,2,2,40,14,26
"2021","Wychavon 016C","E01032379",727,173,85,88,507,81,288,100,116,72,84,44,34,6,53,32,21,1,1,47,19,28
"2021","Wychavon 016D","E01032380",675,218,145,73,432,112,214,79,87,48,65,40,21,4,39,20,19,2,2,25,8,17
"2021","Wychavon 017A","E01032381",831,266,120,146,514,60,231,89,101,41,122,64,51,7,97,53,44,4,4,51,19,32
"2021","Wychavon 017B","E01032397",963,270,135,135,648,113,297,110,139,48,124,52,68,4,107,67,40,7,7,45,19,26
"2021","Wychavon 017C","E01032398",677,171,52,119,457,45,254,88,122,44,94,60,28,6,61,34,27,3,3,49,22,27
"2021","Wychavon 018A","E01032351",967,332,218,114,610,269,252,154,68,30,59,44,13,2,26,9,17,4,4,25,10,15
"2021","Wychavon 018B","E01032352",667,169,104,65,481,133,246,114,82,50,77,44,28,5,24,10,14,1,1,17,6,11
"2021","Wychavon 018C","E01032353",789,302,181,121,474,108,187,74,73,40,88,53,32,3,88,52,36,3,3,13,6,7
"2021","Wychavon 018D","E01032374",576,127,71,56,428,98,226,86,91,49,61,37,18,6,40,26,14,3,3,21,7,14
"2021","Wychavon 019A","E01032347",565,149,87,62,397,91,212,80,95,37,54,30,21,3,40,23,17,0,0,19,5,14
"2021","Wychavon 019B","E01032348",572,123,84,39,434,117,240,95,109,36,54,33,15,6,21,9,12,2,2,15,6,9
"2021","Wychavon 019C","E01032372",638,146,86,60,466,116,261,119,101,41,50,30,19,1,38,19,19,1,1,26,11,15
"2021","Wychavon 019D","E01032373",590,150,89,61,423,136,225,117,70,38,46,27,15,4,16,8,8,0,0,17,6,11
"2021","Wychavon 019E","E01032412",573,153,88,65,402,115,204,93,80,31,46,32,13,1,37,24,13,0,0,18,6,12
"2021","Wychavon 019F","E01032413",505,116,74,42,367,114,178,78,64,36,37,23,10,4,35,17,18,3,3,22,11,11
"2021","Wyre Forest 001A","E01032431",679,187,101,86,458,128,239,96,93,50,55,29,22,4,34,16,18,2,2,34,10,24
"2021","Wyre Forest 001B","E01032432",569,143,74,69,391,79,202,79,82,41,61,28,25,8,42,24,18,7,7,35,19,16
"2021","Wyre Forest 001C","E01032433",583,125,76,49,431,82,240,74,127,39,60,28,27,5,49,34,15,0,0,27,11,16
"2021","Wyre Forest 001D","E01032439",608,171,115,56,413,110,207,82,75,50,64,38,20,6,32,18,14,0,0,24,14,10
"2021","Wyre Forest 001E","E01032440",543,206,133,73,310,51,136,64,45,27,65,36,20,9,57,39,18,1,1,27,16,11
"2021","Wyre Forest 001F","E01032479",1101,329,194,135,728,196,318,137,113,68,120,76,39,5,92,53,39,2,2,44,21,23
"2021","Wyre Forest 002A","E01032441",534,121,82,39,393,100,175,68,64,43,67,34,26,7,50,25,25,1,1,20,11,9
"2021","Wyre Forest 002B","E01032442",672,139,63,76,519,77,252,88,103,61,126,68,54,4,64,40,24,0,0,14,4,10
"2021","Wyre Forest 002C","E01032443",603,169,128,41,413,142,167,64,51,52,68,32,30,6,34,21,13,2,2,21,7,14
"2021","Wyre Forest 002D","E01032444",538,153,58,95,365,62,166,60,75,31,69,39,23,7,68,39,29,0,0,20,8,12
"2021","Wyre Forest 002E","E01032445",648,199,111,88,414,72,188,57,87,44,80,31,39,10,73,40,33,1,1,35,18,17
"2021","Wyre Forest 003A","E01032436",675,202,107,95,437,80,190,79,71,40,99,54,42,3,65,36,29,3,3,36,18,18
"2021","Wyre Forest 003B","E01032438",668,181,102,79,463,90,231,90,96,45,89,51,33,5,50,25,25,3,3,24,9,15
"2021","Wyre Forest 003C","E01032446",602,175,101,74,403,95,180,63,77,40,81,41,36,4,43,21,22,4,4,24,7,17
"2021","Wyre Forest 003D","E01032447",639,210,70,140,396,35,195,74,95,26,98,58,35,5,67,39,28,1,1,33,9,24
"2021","Wyre Forest 003E","E01032448",476,110,59,51,343,75,173,56,84,33,58,31,23,4,35,19,16,2,2,23,9,14
"2021","Wyre Forest 004A","E01032434",941,289,73,216,604,30,246,84,135,27,146,55,85,6,178,130,48,4,4,48,19,29
"2021","Wyre Forest 004B","E01032435",671,250,83,167,375,41,156,59,58,39,79,38,40,1,93,64,29,6,6,46,22,24
"2021","Wyre Forest 004C","E01032437",769,219,85,134,516,48,197,74,81,42,133,72,50,11,135,83,52,3,3,34,17,17
"2021","Wyre Forest 004E","E01034331",680,424,141,283,231,19,75,39,27,9,75,55,19,1,57,42,15,5,5,25,8,17
"2021","Wyre Forest 004F","E01034332",746,286,58,228,429,25,154,48,71,35,133,77,51,5,113,91,22,4,4,31,14,17
"2021","Wyre Forest 005A","E01032430",806,223,137,86,547,147,238,103,91,44,90,47,31,12,67,35,32,5,5,36,16,20
"2021","Wyre Forest 005B","E01032480",789,220,142,78,539,142,239,98,91,50,88,51,33,4,68,38,30,2,2,30,12,18
"2021","Wyre Forest 005C","E01032481",850,286,158,128,544,119,228,95,89,44,84,45,29,10,112,69,43,1,1,20,11,9
"2021","Wyre Forest 005D","E01032482",662,213,113,100,433,130,194,87,75,32,53,33,17,3,54,29,25,2,2,16,5,11
"2021","Wyre Forest 006A","E01032451",660,170,107,63,461,128,229,86,90,53,69,40,27,2,34,15,19,1,1,29,12,17
"2021","Wyre Forest 006B","E01032452",647,149,104,45,473,121,249,87,118,44,67,31,32,4,34,14,20,2,2,25,4,21
"2021","Wyre Forest 006C","E01032453",774,271,147,124,477,59,175,55,89,31,126,41,74,11,115,59,56,2,2,26,10,16
"2021","Wyre Forest 006D","E01032454",836,308,127,181,504,77,226,92,87,47,113,59,47,7,84,53,31,4,4,24,9,15
"2021","Wyre Forest 007A","E01032449",744,272,82,190,429,25,152,60,65,27,137,80,53,4,106,71,35,9,9,43,13,30
"2021","Wyre Forest 007B","E01032464",750,334,177,157,385,69,144,53,64,27,72,36,31,5,99,69,30,1,1,31,14,17
"2021","Wyre Forest 007C","E01032465",617,197,94,103,386,40,158,44,81,33,85,17,56,12,101,69,32,2,2,34,13,21
"2021","Wyre Forest 007D","E01032466",662,278,157,121,351,101,148,60,59,29,59,39,17,3,39,22,17,4,4,33,14,19
"2021","Wyre Forest 007E","E01032467",525,160,99,61,351,105,166,69,63,34,47,26,18,3,26,13,13,7,7,14,7,7
"2021","Wyre Forest 007F","E01032468",501,135,99,36,346,130,150,71,49,30,37,18,17,2,27,17,10,2,2,20,8,12
"2021","Wyre Forest 008A","E01032474",900,397,97,300,449,29,147,64,64,19,131,75,49,7,128,87,41,14,14,54,21,33
"2021","Wyre Forest 008B","E01032475",754,231,69,162,492,52,204,83,92,29,130,78,47,5,101,59,42,5,5,31,15,16
"2021","Wyre Forest 008C","E01032476",626,209,96,113,385,53,184,67,82,35,89,47,34,8,56,35,21,3,3,32,14,18
"2021","Wyre Forest 008D","E01032477",523,139,101,38,368,96,190,77,70,43,47,24,16,7,34,16,18,1,1,16,4,12
"2021","Wyre Forest 008E","E01032478",652,200,108,92,427,47,173,58,74,41,107,46,49,12,99,50,49,1,1,25,9,16
"2021","Wyre Forest 009A","E01032469",657,195,92,103,404,41,171,62,69,40,93,33,54,6,95,55,40,4,4,58,25,33
"2021","Wyre Forest 009C","E01032471",633,216,57,159,388,25,121,33,47,41,98,22,63,13,142,104,38,2,2,29,16,13
"2021","Wyre Forest 009D","E01034333",618,217,113,104,375,45,164,71,71,22,120,61,53,6,45,26,19,1,1,26,10,16
"2021","Wyre Forest 009E","E01034334",620,210,95,115,382,56,161,68,62,31,95,44,45,6,69,45,24,1,1,28,10,18
"2021","Wyre Forest 010A","E01032418",613,195,76,119,398,79,159,65,60,34,87,54,29,4,62,28,34,11,11,20,5,15
"2021","Wyre Forest 010B","E01032419",571,164,129,35,387,151,190,81,73,36,22,14,7,1,23,12,11,1,1,20,9,11
"2021","Wyre Forest 010C","E01032420",514,120,56,64,378,67,213,82,76,55,62,30,28,4,35,18,17,1,1,16,7,9
"2021","Wyre Forest 010D","E01032421",479,96,63,33,368,87,203,69,77,57,42,27,12,3,33,13,20,3,3,15,7,8
"2021","Wyre Forest 010E","E01032422",661,224,57,167,411,12,148,74,53,21,122,61,53,8,127,99,28,2,2,26,14,12
"2021","Wyre Forest 011A","E01032427",707,225,148,77,470,130,221,90,80,51,60,33,18,9,55,25,30,4,4,12,5,7
"2021","Wyre Forest 011B","E01032428",865,397,176,221,448,116,191,111,48,32,83,62,18,3,57,36,21,1,1,20,6,14
"2021","Wyre Forest 011C","E01032429",666,176,125,51,475,155,211,101,65,45,52,31,20,1,55,32,23,2,2,15,10,5
"2021","Wyre Forest 011D","E01032472",530,128,78,50,352,100,185,95,54,36,36,22,12,2,30,13,17,1,1,50,25,25
"2021","Wyre Forest 011E","E01032473",592,142,87,55,419,104,199,95,64,40,64,31,27,6,49,28,21,3,3,31,15,16
"2021","Wyre Forest 012A","E01032455",621,157,102,55,450,126,213,79,88,46,65,28,33,4,46,19,27,0,0,14,7,7
"2021","Wyre Forest 012B","E01032456",519,157,70,87,343,49,125,41,59,25,83,38,34,11,80,48,32,6,6,19,6,13
"2021","Wyre Forest 012C","E01032457",593,139,92,47,429,80,197,63,94,40,72,31,39,2,80,59,21,0,0,25,11,14
"2021","Wyre Forest 012D","E01032458",653,166,111,55,456,134,211,76,90,45,66,28,31,7,43,18,25,2,2,31,12,19
"2021","Wyre Forest 012E","E01032459",621,159,96,63,429,85,213,75,91,47,68,35,30,3,62,27,35,1,1,33,18,15
"2021","Wyre Forest 013A","E01032460",950,420,221,199,501,96,199,82,71,46,111,57,42,12,90,58,32,5,5,29,11,18
"2021","Wyre Forest 013B","E01032461",1018,452,156,296,535,103,239,107,81,51,102,70,22,10,85,56,29,6,6,31,12,19
"2021","Wyre Forest 013C","E01032462",933,261,129,132,632,108,295,106,125,64,122,61,57,4,101,58,43,6,6,40,18,22
"2021","Wyre Forest 013D","E01032463",745,231,164,67,483,157,226,88,101,37,55,29,21,5,44,17,27,1,1,31,8,23
"2021","Wyre Forest 014A","E01032423",787,245,162,83,512,148,216,118,56,42,78,47,29,2,65,42,23,5,5,30,8,22
"2021","Wyre Forest 014B","E01032424",620,193,82,111,398,52,127,44,49,34,93,35,51,7,122,77,45,4,4,29,15,14
"2021","Wyre Forest 014C","E01032425",655,199,140,59,442,129,182,72,66,44,63,33,22,8,67,30,37,1,1,14,4,10
"2021","Wyre Forest 014D","E01032426",658,215,148,67,427,110,187,72,71,44,66,26,34,6,63,26,37,1,1,16,7,9
"2021","Birmingham 001A","E01009417",639,180,130,50,432,62,264,67,151,46,45,22,17,6,58,33,25,3,3,27,18,9
"2021","Birmingham 001B","E01009418",641,167,94,73,447,72,199,50,120,29,67,27,33,7,107,76,31,2,2,27,15,12
"2021","Birmingham 001C","E01009419",603,176,89,87,394,83,213,53,116,44,39,21,13,5,55,34,21,4,4,33,18,15
"2021","Birmingham 001D","E01009433",753,213,142,71,514,131,302,77,152,73,40,26,11,3,37,15,22,4,4,26,15,11
"2021","Birmingham 002A","E01009415",684,155,99,56,506,110,319,88,183,48,37,15,21,1,39,27,12,1,1,23,8,15
"2021","Birmingham 002B","E01009422",854,270,160,110,547,125,275,70,158,47,83,46,34,3,60,37,23,4,4,37,19,18
"2021","Birmingham 002C","E01009423",758,286,166,120,447,68,205,56,100,49,77,37,31,9,94,58,36,3,3,25,12,13
"2021","Birmingham 002D","E01009425",837,336,196,140,476,143,227,69,111,47,41,24,12,5,61,41,20,4,4,25,10,15
"2021","Birmingham 003A","E01009416",1067,243,117,126,774,84,474,111,293,70,89,49,38,2,126,89,37,1,1,50,30,20
"2021","Birmingham 003B","E01009420",647,146,95,51,476,59,275,63,176,36,74,35,29,10,67,40,27,1,1,25,15,10
"2021","Birmingham 003C","E01009426",612,150,102,48,441,116,247,71,127,49,38,19,13,6,40,15,25,0,0,21,9,12
"2021","Birmingham 003D","E01009429",580,127,84,43,436,122,250,57,149,44,40,23,15,2,24,13,11,0,0,17,9,8
"2021","Birmingham 003E","E01009431",663,159,80,79,482,86,287,74,163,50,55,23,30,2,50,26,24,4,4,22,14,8
"2021","Birmingham 004A","E01009421",651,118,90,28,493,150,296,83,140,73,25,11,10,4,20,4,16,2,2,40,21,19
"2021","Birmingham 004B","E01009424",721,275,106,169,419,50,220,84,105,31,85,64,19,2,62,34,28,2,2,27,7,20
"2021","Birmingham 004C","E01009427",680,256,117,139,393,74,209,67,97,45,60,40,20,0,41,27,14,9,9,31,17,14
"2021","Birmingham 004D","E01009428",640,94,73,21,519,154,303,88,150,65,45,22,22,1,17,10,7,0,0,27,18,9
"2021","Birmingham 004E","E01009430",683,133,85,48,510,142,274,87,127,60,49,29,16,4,45,22,23,0,0,40,23,17
"2021","Birmingham 004F","E01009468",605,156,92,64,424,98,241,70,114,57,47,29,11,7,36,23,13,2,2,25,10,15
"2021","Birmingham 005A","E01009445",791,253,95,158,507,19,173,52,85,36,79,40,34,5,234,165,69,2,2,31,16,15
"2021","Birmingham 005B","E01009446",1008,293,112,181,667,76,372,101,210,61,98,51,36,11,115,62,53,6,6,48,24,24
"2021","Birmingham 005C","E01009447",632,148,77,71,448,52,220,48,125,47,79,33,40,6,91,55,36,6,6,36,14,22
"2021","Birmingham 005D","E01009448",672,183,92,91,455,46,200,60,88,52,83,28,46,9,122,59,63,4,4,34,18,16
"2021","Birmingham 005E","E01009452",693,199,117,82,448,74,198,44,115,39,70,29,36,5,99,55,44,7,7,46,21,25
"2021","Birmingham 005F","E01009455",694,342,147,195,341,56,126,39,57,30,48,28,16,4,104,73,31,7,7,11,5,6
"2021","Birmingham 006A","E01009432",648,199,90,109,415,74,200,66,97,37,56,31,20,5,82,56,26,3,3,34,16,18
"2021","Birmingham 006B","E01009435",708,169,71,98,511,75,277,76,128,73,94,56,31,7,63,40,23,2,2,28,14,14
"2021","Birmingham 006C","E01009437",820,302,184,118,484,116,257,77,126,54,60,37,20,3,49,27,22,2,2,34,16,18
"2021","Birmingham 006D","E01009444",605,142,106,36,440,111,251,67,129,55,51,27,21,3,27,18,9,0,0,23,11,12
"2021","Birmingham 006E","E01009454",648,222,78,144,408,83,216,61,99,56,57,32,21,4,51,26,25,1,1,18,8,10
"2021","Birmingham 007A","E01009221",594,145,79,66,410,54,182,59,74,49,57,16,33,8,112,69,43,5,5,39,23,16
"2021","Birmingham 007B","E01009464",542,123,77,46,383,64,233,66,111,56,45,19,15,11,39,17,22,2,2,36,17,19
"2021","Birmingham 007C","E01009465",502,64,38,26,401,59,242,62,119,61,54,19,29,6,43,23,20,3,3,37,22,15
"2021","Birmingham 007D","E01009467",657,170,96,74,458,104,228,79,95,54,49,18,30,1,72,42,30,5,5,29,16,13
"2021","Birmingham 008A","E01009220",618,172,63,109,415,36,186,55,95,36,84,31,42,11,106,67,39,3,3,31,16,15
"2021","Birmingham 008B","E01009222",578,148,53,95,392,24,139,35,63,41,65,21,35,9,154,98,56,10,10,38,25,13
"2021","Birmingham 008C","E01009224",591,180,101,79,369,40,181,59,80,42,63,24,33,6,83,34,49,2,2,42,20,22
"2021","Birmingham 008D","E01009233",626,162,61,101,429,39,137,36,73,28,81,28,42,11,162,119,43,10,10,35,17,18
"2021","Birmingham 009A","E01009449",1109,503,164,339,553,69,231,86,115,30,155,124,27,4,90,54,36,8,8,53,11,42
"2021","Birmingham 009B","E01009451",640,246,99,147,368,30,171,40,104,27,91,55,28,8,73,55,18,3,3,26,13,13
"2021","Birmingham 009C","E01009453",517,99,57,42,392,51,230,58,115,57,61,24,27,10,46,29,17,4,4,26,10,16
"2021","Birmingham 009D","E01009466",655,167,92,75,469,83,281,75,150,56,63,31,24,8,42,22,20,0,0,19,6,13
"2021","Birmingham 009E","E01009471",722,243,102,141,452,83,272,80,142,50,59,32,22,5,38,18,20,0,0,27,14,13
"2021","Birmingham 010A","E01009135",595,189,112,77,356,73,185,70,75,40,51,24,22,5,43,15,28,4,4,50,21,29
"2021","Birmingham 010B","E01009469",583,121,76,45,435,116,214,67,107,40,49,25,22,2,50,26,24,6,6,27,16,11
"2021","Birmingham 010C","E01009470",533,71,51,20,433,108,264,83,123,58,40,17,19,4,18,11,7,3,3,29,11,18
"2021","Birmingham 010D","E01009472",664,165,96,69,468,85,252,56,134,62,80,43,29,8,49,29,20,2,2,31,17,14
"2021","Birmingham 010E","E01009473",689,240,111,129,405,65,204,65,102,37,61,38,18,5,72,45,27,3,3,44,20,24
"2021","Birmingham 010F","E01009474",639,174,85,89,441,61,266,79,128,59,60,34,21,5,48,32,16,6,6,24,15,9
"2021","Birmingham 011A","E01009127",569,155,51,104,344,19,124,30,58,36,55,21,30,4,137,96,41,9,9,70,31,39
"2021","Birmingham 011B","E01009128",521,158,49,109,321,16,117,31,58,28,62,14,38,10,117,71,46,9,9,42,24,18
"2021","Birmingham 011C","E01009130",598,201,78,123,357,26,132,42,57,33,66,25,32,9,128,88,40,5,5,40,21,19
"2021","Birmingham 011D","E01009131",508,108,40,68,347,21,140,34,72,34,49,11,29,9,127,73,54,10,10,53,34,19
"2021","Birmingham 011E","E01009133",600,210,74,136,346,14,124,24,70,30,58,18,31,9,144,91,53,6,6,44,30,14
"2021","Birmingham 011F","E01009134",655,214,89,125,394,20,159,48,81,30,80,31,38,11,119,83,36,16,16,47,23,24
"2021","Birmingham 011G","E01009137",586,150,64,86,383,26,162,35,84,43,64,21,34,9,125,83,42,6,6,53,26,27
"2021","Birmingham 012A","E01009434",709,200,83,117,485,51,301,94,150,57,71,49,22,0,59,30,29,3,3,24,13,11
"2021","Birmingham 012B","E01009436",556,114,90,24,416,116,227,73,102,52,47,26,18,3,25,14,11,1,1,26,9,17
"2021","Birmingham 012C","E01009438",596,168,81,87,411,91,217,80,90,47,66,35,29,2,36,23,13,1,1,17,7,10
"2021","Birmingham 012D","E01009440",645,175,112,63,443,107,236,81,106,49,53,28,20,5,45,20,25,2,2,27,11,16
"2021","Birmingham 012E","E01009450",669,182,100,82,452,67,235,76,103,56,81,46,32,3,65,33,32,4,4,35,15,20
"2021","Birmingham 013A","E01009223",687,231,106,125,418,49,198,53,94,51,81,40,37,4,81,46,35,9,9,38,20,18
"2021","Birmingham 013B","E01009225",749,311,167,144,395,49,144,37,74,33,71,32,37,2,124,88,36,7,7,43,18,25
"2021","Birmingham 013C","E01009227",711,209,83,126,464,54,224,77,88,59,74,35,36,3,107,62,45,5,5,38,21,17
"2021","Birmingham 013D","E01009228",680,224,93,131,416,46,169,52,81,36,88,42,40,6,110,72,38,3,3,40,23,17
"2021","Birmingham 014B","E01009122",665,242,88,154,377,20,149,44,74,31,68,30,34,4,135,85,50,5,5,46,24,22
"2021","Birmingham 014C","E01009129",567,152,45,107,359,11,146,29,83,34,63,22,38,3,131,74,57,8,8,56,35,21
"2021","Birmingham 014D","E01009132",593,178,69,109,372,24,139,38,64,37,65,23,34,8,135,92,43,9,9,43,27,16
"2021","Birmingham 014E","E01009136",845,392,171,221,405,50,139,49,66,24,60,33,23,4,146,98,48,10,10,48,22,26
"2021","Birmingham 014F","E01034913",430,125,44,81,270,15,105,22,56,27,40,13,22,5,107,66,41,3,3,35,23,12
"2021","Birmingham 014G","E01034914",700,202,77,125,448,38,172,34,102,36,62,19,38,5,174,135,39,2,2,50,32,18
"2021","Birmingham 015A","E01009457",603,125,90,35,446,140,243,70,108,65,24,11,11,2,38,14,24,1,1,32,19,13
"2021","Birmingham 015B","E01009459",638,163,89,74,439,102,248,67,128,53,51,29,17,5,36,18,18,2,2,36,16,20
"2021","Birmingham 015C","E01009461",521,108,76,32,386,94,230,75,101,54,33,15,16,2,27,14,13,2,2,27,15,12
"2021","Birmingham 015D","E01009463",617,174,107,67,405,102,213,70,92,51,42,24,16,2,41,22,19,7,7,38,21,17
"2021","Birmingham 016A","E01009235",629,148,64,84,444,58,214,67,96,51,61,27,27,7,104,54,50,7,7,37,21,16
"2021","Birmingham 016B","E01009243",730,215,99,116,465,41,217,59,119,39,92,56,32,4,111,74,37,4,4,50,32,18
"2021","Birmingham 016C","E01009245",568,148,66,82,357,41,182,44,86,52,41,21,16,4,84,51,33,9,9,63,24,39
"2021","Birmingham 016D","E01009246",666,211,84,127,417,62,203,67,103,33,54,23,27,4,93,50,43,5,5,38,18,20
"2021","Birmingham 016E","E01009247",586,128,59,69,401,41,212,59,99,54,41,12,24,5,101,49,52,6,6,57,31,26
"2021","Birmingham 017A","E01009226",670,234,95,139,405,42,143,46,66,31,86,40,43,3,124,82,42,10,10,31,12,19
"2021","Birmingham 017B","E01009229",656,193,106,87,416,47,172,53,77,42,80,29,49,2,113,70,43,4,4,47,20,27
"2021","Birmingham 017C","E01009230",741,242,98,144,457,55,193,72,82,39,84,42,31,11,118,85,33,7,7,42,18,24
"2021","Birmingham 017D","E01009231",781,236,129,107,489,77,243,76,108,59,84,30,49,5,82,46,36,3,3,56,22,34
"2021","Birmingham 018A","E01009001",716,237,86,151,433,49,187,70,85,32,81,42,29,10,110,70,40,6,6,46,20,26
"2021","Birmingham 018B","E01009003",687,262,90,172,369,62,185,64,75,46,66,49,13,4,51,33,18,5,5,56,21,35
"2021","Birmingham 018C","E01009456",708,200,107,93,481,73,298,87,150,61,58,29,23,6,51,23,28,1,1,27,7,20
"2021","Birmingham 018D","E01009458",737,380,253,127,332,73,165,58,71,36,53,31,18,4,40,19,21,1,1,25,13,12
"2021","Birmingham 018E","E01009460",810,399,126,273,370,46,161,66,65,30,86,54,26,6,73,49,24,4,4,41,16,25
"2021","Birmingham 018F","E01009462",768,306,125,181,433,60,211,79,94,38,82,54,26,2,73,39,34,7,7,29,10,19
"2021","Birmingham 019A","E01009234",611,184,66,118,395,36,160,39,77,44,93,38,49,6,105,72,33,1,1,32,13,19
"2021","Birmingham 019B","E01009236",600,146,59,87,419,48,211,51,113,47,56,23,30,3,100,53,47,4,4,35,22,13
"2021","Birmingham 019C","E01009244",807,276,107,169,486,40,221,38,137,46,83,36,44,3,128,91,37,14,14,45,27,18
"2021","Birmingham 019D","E01009248",705,183,80,103,486,52,215,68,94,53,104,39,55,10,113,70,43,2,2,36,20,16
"2021","Birmingham 020A","E01009403",607,181,60,121,382,26,159,39,88,32,77,36,33,8,117,87,30,3,3,44,23,21
"2021","Birmingham 020B","E01009404",627,182,64,118,387,21,147,35,76,36,62,24,30,8,153,91,62,4,4,58,36,22
"2021","Birmingham 020C","E01009405",606,211,78,133,340,41,133,41,64,28,62,18,36,8,96,61,35,8,8,55,28,27
"2021","Birmingham 020D","E01009406",759,300,118,182,407,27,170,50,82,38,77,41,31,5,128,93,35,5,5,52,32,20
"2021","Birmingham 020E","E01009407",696,230,75,155,400,36,188,52,104,32,70,37,27,6,100,59,41,6,6,66,29,37
"2021","Birmingham 021A","E01009439",603,173,94,79,396,100,192,54,94,44,51,20,24,7,52,34,18,1,1,34,20,14
"2021","Birmingham 021B","E01009441",640,201,88,113,406,61,176,56,83,37,87,51,29,7,77,42,35,5,5,33,15,18
"2021","Birmingham 021C","E01009442",593,131,90,41,440,86,244,79,105,60,56,26,24,6,50,23,27,4,4,22,12,10
"2021","Birmingham 021D","E01009443",522,152,81,71,352,63,182,62,87,33,48,26,16,6,58,38,20,1,1,18,9,9
"2021","Birmingham 022A","E01009123",611,191,61,130,359,23,152,30,92,30,63,29,27,7,113,76,37,8,8,61,30,31
"2021","Birmingham 022B","E01009124",713,138,23,115,522,6,148,38,89,21,56,10,42,4,300,257,43,12,12,53,37,16
"2021","Birmingham 022C","E01009125",681,161,54,107,467,38,223,46,130,47,51,13,32,6,134,73,61,21,21,53,38,15
"2021","Birmingham 022D","E01009232",588,171,78,93,377,57,173,45,85,43,63,23,32,8,76,43,33,8,8,40,21,19
"2021","Birmingham 023A","E01009002",786,219,74,145,524,17,149,33,96,20,89,29,55,5,259,214,45,10,10,43,19,24
"2021","Birmingham 023C","E01009006",748,292,61,231,398,31,148,61,70,17,103,61,35,7,102,60,42,14,14,58,16,42
"2021","Birmingham 023D","E01009007",902,423,77,346,418,13,141,53,71,17,119,70,41,8,124,78,46,21,21,61,15,46
"2021","Birmingham 023G","E01034915",632,122,27,95,475,3,136,15,112,9,84,23,58,3,250,225,25,2,2,35,19,16
"2021","Birmingham 023H","E01034916",654,251,102,149,342,46,168,60,73,35,65,36,27,2,59,31,28,4,4,61,20,41
"2021","Birmingham 024A","E01009237",579,182,78,104,351,25,166,42,88,36,39,11,22,6,103,59,44,18,18,46,29,17
"2021","Birmingham 024B","E01009238",631,174,102,72,379,63,196,41,110,45,38,16,18,4,76,35,41,6,6,78,54,24
"2021","Birmingham 024C","E01009240",597,167,68,99,387,52,193,43,110,40,41,18,21,2,93,51,42,8,8,43,26,17
"2021","Birmingham 024D","E01009241",591,129,48,81,384,31,217,50,130,37,44,13,24,7,86,55,31,6,6,78,49,29
"2021","Birmingham 024E","E01009242",637,138,65,73,382,28,223,34,137,52,41,17,21,3,79,45,34,11,11,117,64,53
"2021","Birmingham 025A","E01009005",727,257,93,164,431,31,188,54,99,35,94,57,33,4,104,73,31,14,14,39,25,14
"2021","Birmingham 025B","E01009009",628,206,86,120,379,56,187,71,77,39,50,22,22,6,84,47,37,2,2,43,29,14
"2021","Birmingham 025C","E01009098",935,364,145,219,521,36,219,76,103,40,106,38,59,9,155,91,64,5,5,50,24,26
"2021","Birmingham 025D","E01009100",817,277,114,163,479,41,200,73,84,43,89,43,36,10,140,88,52,9,9,61,33,28
"2021","Birmingham 025E","E01009105",741,194,90,104,505,56,220,73,98,49,106,48,49,9,118,87,31,5,5,42,20,22
"2021","Birmingham 026A","E01009126",542,124,59,65,366,50,189,49,100,40,65,25,31,9,58,37,21,4,4,52,32,20
"2021","Birmingham 026B","E01009408",659,209,65,144,371,21,186,37,114,35,46,17,22,7,112,63,49,6,6,79,42,37
"2021","Birmingham 026C","E01009409",841,359,95,264,379,23,126,42,64,20,80,47,23,10,130,90,40,20,20,103,41,62
"2021","Birmingham 026D","E01009410",814,334,158,176,400,48,175,49,85,41,57,31,23,3,108,73,35,12,12,80,34,46
"2021","Birmingham 029A","E01009096",774,313,116,197,423,34,122,37,49,36,89,35,38,16,152,97,55,26,26,38,20,18
"2021","Birmingham 029B","E01009097",772,208,80,128,502,34,149,37,70,42,72,16,45,11,237,161,76,10,10,62,37,25
"2021","Birmingham 029C","E01009099",800,347,89,258,412,20,100,37,40,23,84,26,50,8,207,151,56,1,1,41,23,18
"2021","Birmingham 029D","E01009101",609,198,100,98,375,42,126,40,51,35,63,23,35,5,144,82,62,0,0,36,25,11
"2021","Birmingham 029E","E01009103",682,250,130,120,391,33,108,26,48,34,62,20,29,13,183,120,63,5,5,41,25,16
"2021","Birmingham 029F","E01009106",571,168,76,92,365,51,147,46,48,53,60,27,25,8,107,67,40,0,0,38,22,16
"2021","Birmingham 030A","E01008915",559,125,42,83,356,14,198,31,146,21,29,11,17,1,106,83,23,9,9,78,39,39
"2021","Birmingham 030B","E01009411",873,354,96,258,465,30,200,66,93,41,92,42,47,3,132,82,50,11,11,54,32,22
"2021","Birmingham 030C","E01009412",645,196,53,143,311,18,147,42,79,26,44,25,17,2,89,47,42,13,13,138,43,95
"2021","Birmingham 030D","E01009413",669,201,43,158,383,21,182,38,99,45,47,23,21,3,121,63,58,12,12,85,29,56
"2021","Birmingham 030E","E01009414",863,240,38,202,513,23,236,64,135,37,89,35,50,4,147,95,52,18,18,110,53,57
"2021","Birmingham 031A","E01008998",648,181,51,130,383,21,171,24,117,30,48,16,29,3,133,74,59,10,10,84,40,44
"2021","Birmingham 031B","E01008999",519,127,46,81,316,21,156,33,81,42,33,13,15,5,96,46,50,10,10,76,45,31
"2021","Birmingham 031C","E01009000",847,444,98,346,347,31,136,58,57,21,67,41,20,6,105,68,37,8,8,56,20,36
"2021","Birmingham 031D","E01009013",898,382,100,282,437,27,156,47,74,35,105,65,35,5,133,81,52,16,16,79,22,57
"2021","Birmingham 031E","E01009400",576,160,58,102,326,19,140,34,81,25,60,27,26,7,98,58,40,9,9,90,36,54
"2021","Birmingham 031F","E01009401",637,200,37,163,333,25,125,29,70,26,66,24,34,8,101,65,36,16,16,104,49,55
"2021","Birmingham 031H","E01033630",598,269,30,239,287,2,105,41,52,12,58,45,11,2,110,84,26,12,12,42,12,30
"2021","Birmingham 031I","E01033646",851,446,65,381,324,10,102,36,50,16,73,51,18,4,126,88,38,13,13,81,32,49
"2021","Birmingham 032A","E01009049",576,222,86,136,274,19,159,20,95,44,22,8,10,4,65,32,33,9,9,80,45,35
"2021","Birmingham 032B","E01009056",751,269,52,217,374,14,168,34,96,38,44,21,23,0,142,108,34,6,6,108,69,39
"2021","Birmingham 032C","E01009263",628,245,57,188,321,24,156,49,74,33,27,14,12,1,107,75,32,7,7,62,35,27
"2021","Birmingham 032D","E01009264",683,405,63,342,257,6,116,56,52,8,46,34,11,1,77,58,19,12,12,21,10,11
"2021","Birmingham 032E","E01009265",593,195,55,140,285,25,171,31,96,44,17,7,8,2,65,39,26,7,7,113,60,53
"2021","Birmingham 033A","E01009051",542,126,46,80,323,15,187,24,123,40,19,6,11,2,82,37,45,20,20,93,61,32
"2021","Birmingham 033B","E01009053",441,76,32,44,302,13,168,17,129,22,11,3,7,1,105,67,38,5,5,63,48,15
"2021","Birmingham 033C","E01009054",433,70,31,39,262,25,167,19,94,54,12,3,9,0,52,20,32,6,6,101,67,34
"2021","Birmingham 033D","E01009058",500,88,30,58,302,6,230,24,169,37,15,3,12,0,42,25,17,9,9,110,78,32
"2021","Birmingham 033E","E01009061",458,73,31,42,270,9,172,14,122,36,5,0,5,0,75,35,40,9,9,115,90,25
"2021","Birmingham 033F","E01009239",557,198,66,132,288,13,135,34,77,24,50,38,10,2,71,48,23,19,19,71,30,41
"2021","Birmingham 034A","E01009266",591,157,47,110,348,21,182,27,110,45,29,4,22,3,111,68,43,5,5,86,50,36
"2021","Birmingham 034B","E01009269",501,121,36,85,297,19,145,26,101,18,22,4,16,2,104,69,35,7,7,83,44,39
"2021","Birmingham 034C","E01009270",632,197,46,151,328,13,166,12,119,35,22,8,12,2,120,73,47,7,7,107,70,37
"2021","Birmingham 034D","E01009271",513,119,43,76,314,14,171,8,125,38,29,11,15,3,90,48,42,10,10,80,57,23
"2021","Birmingham 034E","E01009273",494,104,42,62,289,26,144,18,83,43,26,10,14,2,70,29,41,23,23,101,66,35
"2021","Birmingham 035A","E01009050",748,194,51,143,461,18,228,37,146,45,44,32,9,3,160,118,42,11,11,93,55,38
"2021","Birmingham 035D","E01009057",625,206,49,157,341,13,166,16,124,26,31,8,20,3,124,88,36,7,7,78,53,25
"2021","Birmingham 035E","E01009059",570,200,39,161,275,7,131,13,89,29,18,4,10,4,106,62,44,13,13,95,69,26
"2021","Birmingham 035F","E01009060",478,105,24,81,271,4,148,27,98,23,10,3,7,0,99,65,34,10,10,102,70,32
"2021","Birmingham 035H","E01034917",507,135,28,107,296,12,149,21,94,34,18,5,13,0,102,69,33,15,15,76,47,29
"2021","Birmingham 035I","E01034918",549,206,36,170,248,21,143,18,90,35,18,5,12,1,63,44,19,3,3,95,64,31
"2021","Birmingham 036A","E01009268",432,64,35,29,292,24,195,26,93,76,20,3,11,6,50,21,29,3,3,76,51,25
"2021","Birmingham 036B","E01009272",470,118,35,83,293,13,138,12,88,38,32,14,16,2,103,61,42,7,7,59,30,29
"2021","Birmingham 036C","E01009274",706,206,72,134,388,19,185,21,110,54,35,27,8,0,134,71,63,15,15,112,69,43
"2021","Birmingham 036D","E01009349",562,137,32,105,353,12,157,18,119,20,31,8,16,7,140,92,48,13,13,72,39,33
"2021","Birmingham 036E","E01009351",550,112,30,82,378,13,197,21,144,32,22,8,13,1,137,98,39,9,9,60,33,27
"2021","Birmingham 036F","E01009354",508,172,80,92,248,9,126,27,81,18,23,8,14,1,77,45,32,13,13,88,52,36
"2021","Birmingham 037A","E01008899",457,185,59,126,235,10,119,14,95,10,24,13,6,5,71,44,27,11,11,37,26,11
"2021","Birmingham 037C","E01008901",606,217,53,164,313,19,162,24,106,32,9,2,5,2,110,46,64,13,13,76,56,20
"2021","Birmingham 037E","E01008916",484,108,22,86,295,7,159,12,125,22,16,3,12,1,102,81,21,11,11,81,58,23
"2021","Birmingham 037G","E01034919",480,124,60,64,263,7,176,17,117,42,16,5,8,3,59,26,33,5,5,93,65,28
"2021","Birmingham 037H","E01034920",412,47,16,31,233,6,149,8,116,25,9,4,4,1,61,21,40,8,8,132,98,34
"2021","Birmingham 039A","E01009275",501,105,34,71,288,15,161,19,114,28,26,11,12,3,72,47,25,14,14,108,68,40
"2021","Birmingham 039B","E01009350",474,108,40,68,286,6,155,18,106,31,16,5,8,3,96,58,38,13,13,80,55,25
"2021","Birmingham 039C","E01009352",485,124,33,91,221,11,116,11,71,34,6,1,5,0,73,42,31,15,15,140,83,57
"2021","Birmingham 039D","E01009353",473,94,30,64,278,10,160,19,108,33,12,5,7,0,90,57,33,6,6,101,62,39
"2021","Birmingham 039E","E01009355",474,152,23,129,228,9,92,21,44,27,20,12,5,3,86,59,27,21,21,94,65,29
"2021","Birmingham 039I","E01034921",435,76,23,53,285,14,166,20,116,30,17,0,15,2,74,49,25,14,14,74,45,29
"2021","Birmingham 039J","E01034922",524,116,31,85,332,18,150,21,99,30,24,1,19,4,128,69,59,12,12,76,51,25
"2021","Birmingham 040A","E01008905",485,65,21,44,321,7,206,20,156,30,14,3,10,1,87,46,41,7,7,99,72,27
"2021","Birmingham 040B","E01008907",620,207,62,145,318,5,144,22,94,28,27,18,8,1,132,97,35,10,10,95,47,48
"2021","Birmingham 040C","E01009047",552,192,40,152,248,10,153,20,107,26,15,6,8,1,56,31,25,14,14,112,71,41
"2021","Birmingham 040D","E01009048",641,243,37,206,281,10,138,15,92,31,17,6,10,1,101,59,42,15,15,117,57,60
"2021","Birmingham 040E","E01009062",511,112,27,85,308,7,182,28,126,28,19,7,11,1,90,45,45,10,10,91,63,28
"2021","Birmingham 041D","E01008909",550,97,23,74,365,4,195,16,155,24,21,6,15,0,131,86,45,14,14,88,63,25
"2021","Birmingham 041H","E01034923",526,178,56,122,268,4,150,16,106,28,8,2,6,0,92,48,44,14,14,80,55,25
"2021","Birmingham 041I","E01034924",438,145,25,120,200,7,113,9,77,27,5,1,4,0,70,26,44,5,5,93,68,25
"2021","Birmingham 041J","E01034925",535,156,54,102,317,8,183,27,146,10,29,4,25,0,88,55,33,9,9,62,47,15
"2021","Birmingham 041K","E01034926",533,210,82,128,264,11,130,7,103,20,12,1,9,2,101,45,56,10,10,59,39,20
"2021","Birmingham 042A","E01009084",528,87,43,44,355,27,226,22,151,53,33,9,22,2,62,46,16,7,7,86,61,25
"2021","Birmingham 042B","E01009085",494,68,39,29,295,35,191,17,128,46,16,4,4,8,47,27,20,6,6,131,96,35
"2021","Birmingham 042C","E01009087",579,135,70,65,392,45,221,39,151,31,38,14,15,9,82,47,35,6,6,52,36,16
"2021","Birmingham 042D","E01009089",489,68,38,30,358,40,227,29,159,39,20,9,8,3,68,47,21,3,3,63,46,17
"2021","Birmingham 042E","E01009090",541,106,59,47,300,19,217,34,148,35,11,3,7,1,42,28,14,11,11,135,97,38
"2021","Birmingham 043A","E01009201",714,259,98,161,389,17,144,18,107,19,38,11,19,8,163,97,66,27,27,66,36,30
"2021","Birmingham 043B","E01009202",635,214,60,154,363,16,141,22,105,14,40,11,22,7,157,115,42,9,9,58,39,19
"2021","Birmingham 043D","E01034927",642,233,66,167,356,9,123,22,88,13,21,6,15,0,195,159,36,8,8,53,32,21
"2021","Birmingham 043E","E01034928",498,150,22,128,307,5,119,6,104,9,18,4,13,1,157,128,29,8,8,41,20,21
"2021","Birmingham 044A","E01009082",497,109,58,51,348,22,158,25,97,36,31,8,18,5,134,78,56,3,3,40,30,10
"2021","Birmingham 044B","E01009086",628,132,42,90,417,25,286,51,183,52,15,5,7,3,87,53,34,4,4,79,57,22
"2021","Birmingham 044C","E01009480",582,94,43,51,417,16,251,46,174,31,42,13,26,3,96,64,32,12,12,71,48,23
"2021","Birmingham 044D","E01009481",716,115,51,64,482,19,317,40,235,42,22,7,9,6,114,65,49,10,10,119,90,29
"2021","Birmingham 044E","E01009486",609,112,43,69,396,15,219,28,161,30,21,9,11,1,128,96,32,13,13,101,63,38
"2021","Birmingham 044F","E01009487",571,87,33,54,383,12,254,27,174,53,16,2,9,5,90,59,31,11,11,101,71,30
"2021","Birmingham 045A","E01009088",684,262,153,109,378,70,165,46,80,39,51,21,26,4,88,51,37,4,4,44,24,20
"2021","Birmingham 045B","E01009091",657,214,83,131,396,43,160,36,87,37,69,24,34,11,115,74,41,9,9,47,29,18
"2021","Birmingham 045C","E01009305",702,237,81,156,424,19,129,37,65,27,80,34,40,6,178,138,40,18,18,41,26,15
"2021","Birmingham 045D","E01009307",727,292,113,179,403,34,134,48,58,28,89,31,47,11,143,94,49,3,3,32,11,21
"2021","Birmingham 045E","E01009309",782,294,110,184,451,23,166,49,91,26,86,38,43,5,173,129,44,3,3,37,19,18
"2021","Birmingham 046A","E01009304",810,277,114,163,479,32,151,51,71,29,120,49,57,14,174,108,66,2,2,54,25,29
"2021","Birmingham 046B","E01009306",711,252,106,146,413,52,161,46,70,45,78,35,37,6,119,80,39,3,3,46,23,23
"2021","Birmingham 046C","E01009308",765,230,95,135,494,31,166,49,93,24,106,36,59,11,187,135,52,4,4,41,24,17
"2021","Birmingham 046D","E01009310",806,256,107,149,494,37,166,49,84,33,91,35,48,8,194,138,56,6,6,56,32,24
"2021","Birmingham 047A","E01009348",818,317,75,242,416,22,142,31,85,26,55,31,17,7,177,105,72,20,20,85,46,39
"2021","Birmingham 047B","E01009358",742,251,49,202,385,13,174,21,107,46,30,12,14,4,125,84,41,43,43,106,56,50
"2021","Birmingham 047C","E01009359",691,171,36,135,427,26,200,26,140,34,28,7,18,3,162,117,45,11,11,93,49,44
"2021","Birmingham 047D","E01009360",954,251,68,183,583,13,232,42,158,32,56,26,26,4,260,184,76,22,22,120,62,58
"2021","Birmingham 047E","E01009361",775,222,86,136,447,13,181,30,124,27,43,14,23,6,195,156,39,15,15,106,45,61
"2021","Birmingham 048A","E01009478",623,150,51,99,407,13,218,33,161,24,29,6,20,3,140,103,37,7,7,66,43,23
"2021","Birmingham 048B","E01009479",597,140,60,80,350,12,217,20,162,35,21,7,10,4,93,53,40,7,7,107,69,38
"2021","Birmingham 048C","E01009482",473,91,21,70,305,5,164,22,119,23,24,8,13,3,95,62,33,17,17,77,54,23
"2021","Birmingham 048D","E01009484",488,113,22,91,286,4,153,22,108,23,21,10,11,0,90,56,34,18,18,89,73,16
"2021","Birmingham 048E","E01009485",500,64,27,37,337,10,234,20,178,36,13,1,11,1,75,42,33,5,5,99,70,29
"2021","Birmingham 049A","E01008906",511,89,24,65,330,4,214,14,175,25,13,0,10,3,91,51,40,8,8,92,76,16
"2021","Birmingham 049B","E01008911",639,214,72,142,386,4,154,6,131,17,39,9,27,3,179,142,37,10,10,39,29,10
"2021","Birmingham 049D","E01009347",569,178,58,120,323,13,132,20,82,30,33,17,10,6,137,89,48,8,8,68,44,24
"2021","Birmingham 049E","E01033559",911,454,7,447,339,1,87,63,21,3,193,186,7,0,28,21,7,30,30,118,5,113
"2021","Birmingham 049F","E01033638",666,238,77,161,365,6,160,16,128,16,36,12,23,1,152,113,39,11,11,63,31,32
"2021","Birmingham 050A","E01008910",441,124,27,97,259,8,138,17,102,19,20,7,11,2,83,42,41,10,10,58,41,17
"2021","Birmingham 050B","E01008913",934,396,154,242,467,11,192,36,144,12,32,18,11,3,218,151,67,14,14,71,38,33
"2021","Birmingham 050E","E01033561",413,175,48,127,175,4,65,19,41,5,16,13,3,0,82,53,29,8,8,63,22,41
"2021","Birmingham 050F","E01033617",853,497,5,492,251,0,86,49,36,1,114,105,8,1,23,18,5,28,28,105,5,100
"2021","Birmingham 050G","E01034929",521,140,17,123,347,2,118,18,93,7,43,7,36,0,168,141,27,16,16,34,22,12
"2021","Birmingham 050H","E01034930",507,235,10,225,211,2,70,13,50,7,63,52,10,1,49,40,9,27,27,61,12,49
"2021","Birmingham 051B","E01009483",525,99,28,71,326,6,211,20,158,33,14,1,12,1,91,50,41,4,4,100,63,37
"2021","Birmingham 051C","E01009488",719,158,55,103,467,16,256,31,179,46,23,5,14,4,159,105,54,13,13,94,70,24
"2021","Birmingham 051D","E01009489",519,71,21,50,353,11,214,29,152,33,18,4,12,2,98,68,30,12,12,95,71,24
"2021","Birmingham 051E","E01009491",524,84,34,50,321,15,213,23,156,34,12,1,11,0,78,50,28,3,3,119,84,35
"2021","Birmingham 051F","E01034931",429,42,16,26,292,5,205,15,134,56,7,2,5,0,71,32,39,4,4,95,81,14
"2021","Birmingham 051G","E01034932",436,137,33,104,221,4,113,11,88,14,6,4,1,1,90,71,19,8,8,78,55,23
"2021","Birmingham 052B","E01009192",612,70,32,38,341,9,228,21,160,47,9,2,7,0,88,51,37,7,7,201,144,57
"2021","Birmingham 052D","E01009199",541,169,13,156,322,4,167,34,115,18,34,15,16,3,101,70,31,16,16,50,16,34
"2021","Birmingham 052E","E01009204",712,254,65,189,382,9,174,21,132,21,28,6,15,7,166,111,55,5,5,76,35,41
"2021","Birmingham 052G","E01034933",409,83,14,69,240,5,137,14,91,32,7,4,3,0,82,44,38,9,9,86,57,29
"2021","Birmingham 052H","E01034934",432,77,14,63,261,3,138,14,106,18,21,1,20,0,96,50,46,3,3,94,70,24
"2021","Birmingham 053A","E01009151",627,139,43,96,388,13,201,28,138,35,38,14,22,2,127,75,52,9,9,100,61,39
"2021","Birmingham 053B","E01009152",575,207,39,168,209,7,122,19,69,34,17,6,10,1,50,22,28,13,13,159,82,77
"2021","Birmingham 053C","E01009153",819,341,66,275,339,12,137,19,91,27,78,45,30,3,99,62,37,13,13,139,40,99
"2021","Birmingham 053D","E01009345",503,131,22,109,329,11,139,13,100,26,20,9,10,1,143,103,40,16,16,43,27,16
"2021","Birmingham 053E","E01009346",530,106,32,74,354,14,192,30,134,28,18,7,8,3,123,78,45,7,7,70,50,20
"2021","Birmingham 054A","E01009092",614,152,44,108,411,19,153,32,95,26,51,10,31,10,182,125,57,6,6,51,32,19
"2021","Birmingham 054B","E01009093",644,189,62,127,419,19,170,44,107,19,62,18,37,7,157,106,51,11,11,36,23,13
"2021","Birmingham 054C","E01009094",548,128,40,88,373,25,182,41,117,24,50,24,25,1,115,68,47,1,1,47,28,19
"2021","Birmingham 054D","E01009298",585,149,50,99,384,8,145,33,89,23,62,14,39,9,161,106,55,8,8,52,26,26
"2021","Birmingham 054E","E01009311",558,123,44,79,403,24,160,30,87,43,63,28,31,4,146,102,44,10,10,32,20,12
"2021","Birmingham 054F","E01009511",483,116,54,62,288,14,116,22,75,19,52,13,36,3,101,60,41,5,5,79,53,26
"2021","Birmingham 055A","E01009475",612,114,43,71,390,6,241,21,184,36,26,9,13,4,108,59,49,9,9,108,73,35
"2021","Birmingham 055B","E01009476",578,165,52,113,329,13,215,25,163,27,10,5,5,0,83,58,25,8,8,84,64,20
"2021","Birmingham 055C","E01009477",529,101,40,61,356,20,200,28,150,22,34,14,13,7,98,61,37,4,4,72,56,16
"2021","Birmingham 055D","E01009490",633,146,39,107,408,18,249,40,165,44,31,8,16,7,97,63,34,13,13,79,49,30
"2021","Birmingham 055E","E01009492",538,93,23,70,368,18,219,26,170,23,26,10,14,2,99,62,37,6,6,77,59,18
"2021","Birmingham 056A","E01009095",666,200,77,123,399,29,216,41,131,44,47,21,23,3,101,70,31,6,6,67,40,27
"2021","Birmingham 056B","E01009507",573,226,94,132,271,16,131,26,82,23,24,9,9,6,91,73,18,9,9,76,47,29
"2021","Birmingham 056C","E01009508",606,181,64,117,370,43,188,45,100,43,41,19,18,4,90,55,35,8,8,55,36,19
"2021","Birmingham 056D","E01009509",631,201,37,164,323,24,174,40,94,40,39,18,17,4,72,49,23,14,14,107,76,31
"2021","Birmingham 056E","E01009510",685,263,139,124,368,35,145,39,82,24,38,12,21,5,144,113,31,6,6,54,41,13
"2021","Birmingham 057A","E01009297",800,299,124,175,455,55,169,58,72,39,85,30,44,11,142,92,50,4,4,46,22,24
"2021","Birmingham 057B","E01009299",623,190,74,116,398,33,158,44,76,38,50,18,21,11,148,94,54,9,9,35,18,17
"2021","Birmingham 057C","E01009300",716,173,55,118,491,25,157,44,78,35,68,29,31,8,232,160,72,9,9,52,36,16
"2021","Birmingham 057D","E01009301",769,321,85,236,400,12,126,38,63,25,90,33,48,9,170,121,49,2,2,48,21,27
"2021","Birmingham 057E","E01009303",711,330,125,205,360,19,145,35,74,36,80,36,35,9,113,68,45,3,3,21,12,9
"2021","Birmingham 058A","E01009195",672,105,57,48,428,13,276,29,207,40,16,6,9,1,118,80,38,5,5,139,109,30
"2021","Birmingham 058C","E01009197",485,76,27,49,328,8,198,12,153,33,19,7,10,2,98,63,35,5,5,81,59,22
"2021","Birmingham 058F","E01033649",499,79,23,56,350,6,253,20,207,26,13,1,10,2,69,47,22,9,9,70,52,18
"2021","Birmingham 058G","E01034935",830,134,42,92,559,9,376,37,305,34,29,11,14,4,137,90,47,8,8,137,92,45
"2021","Birmingham 060A","E01009138",677,128,43,85,425,27,258,41,166,51,47,29,15,3,82,45,37,11,11,124,83,41
"2021","Birmingham 060B","E01009139",559,167,46,121,297,30,157,31,87,39,39,20,16,3,63,37,26,8,8,95,42,53
"2021","Birmingham 060C","E01009140",842,273,54,219,444,49,230,66,138,26,65,44,20,1,81,53,28,19,19,125,44,81
"2021","Birmingham 060D","E01009145",729,232,66,166,409,29,216,52,120,44,59,44,14,1,98,57,41,7,7,88,38,50
"2021","Birmingham 060E","E01009147",670,304,33,271,250,16,134,43,63,28,42,27,11,4,48,31,17,10,10,116,37,79
"2021","Birmingham 062A","E01009512",706,165,65,100,479,26,196,48,107,41,67,24,31,12,181,122,59,9,9,62,40,22
"2021","Birmingham 062B","E01009514",623,204,115,89,375,23,145,27,88,30,52,23,18,11,147,90,57,8,8,44,31,13
"2021","Birmingham 062C","E01009516",519,134,67,67,341,35,164,42,86,36,41,15,20,6,97,57,40,4,4,44,25,19
"2021","Birmingham 062D","E01009517",700,172,69,103,462,32,216,56,122,38,73,21,42,10,130,77,53,11,11,66,40,26
"2021","Birmingham 063A","E01009325",510,67,26,41,365,21,208,25,153,30,17,1,12,4,112,65,47,7,7,78,56,22
"2021","Birmingham 063D","E01009342",406,73,19,54,247,17,175,17,121,37,5,0,3,2,47,22,25,3,3,86,67,19
"2021","Birmingham 063E","E01009343",494,96,23,73,301,9,175,26,126,23,9,3,4,2,98,64,34,10,10,97,61,36
"2021","Birmingham 063F","E01033642",834,117,55,62,586,22,408,38,291,79,20,7,10,3,123,74,49,13,13,131,99,32
"2021","Birmingham 064A","E01008986",785,412,59,353,313,11,174,71,82,21,68,58,9,1,51,43,8,9,9,60,16,44
"2021","Birmingham 064B","E01008987",625,245,92,153,204,14,81,25,45,11,31,16,11,4,62,30,32,16,16,176,14,162
"2021","Birmingham 064C","E01008988",986,488,58,430,380,15,178,76,83,19,102,90,10,2,47,23,24,38,38,118,27,91
"2021","Birmingham 064D","E01008989",925,502,152,350,366,26,152,73,66,13,104,97,7,0,71,48,23,13,13,57,16,41
"2021","Birmingham 064E","E01008990",510,182,60,122,288,42,167,49,92,26,48,39,8,1,24,12,12,7,7,40,9,31
"2021","Birmingham 064F","E01008991",577,140,89,51,384,74,242,44,146,52,27,16,11,0,32,18,14,9,9,53,33,20
"2021","Birmingham 066A","E01008882",670,165,49,116,428,10,227,40,159,28,38,17,14,7,143,93,50,10,10,77,52,25
"2021","Birmingham 066B","E01008896",568,115,43,72,378,17,194,31,136,27,36,14,16,6,126,84,42,5,5,75,67,8
"2021","Birmingham 066C","E01008898",557,118,44,74,373,18,204,42,130,32,31,13,9,9,111,72,39,9,9,66,45,21
"2021","Birmingham 066D","E01009326",558,109,55,54,372,19,223,18,172,33,14,2,11,1,108,60,48,8,8,77,57,20
"2021","Birmingham 066E","E01009341",524,147,38,109,318,10,161,21,113,27,26,9,14,3,115,93,22,6,6,59,41,18
"2021","Birmingham 066F","E01009513",595,133,38,95,394,13,246,38,181,27,27,11,14,2,101,65,36,7,7,68,54,14
"2021","Birmingham 067A","E01008881",584,148,88,60,375,27,203,37,122,44,37,14,16,7,92,51,41,16,16,61,43,18
"2021","Birmingham 067B","E01008897",617,132,56,76,418,39,243,51,153,39,22,8,10,4,105,53,52,9,9,67,46,21
"2021","Birmingham 067C","E01009515",633,215,105,110,358,49,191,49,106,36,54,28,18,8,56,21,35,8,8,60,34,26
"2021","Birmingham 067D","E01009518",705,254,115,139,387,53,199,59,83,57,61,30,25,6,69,39,30,5,5,64,47,17
"2021","Birmingham 067E","E01009521",617,147,68,79,413,47,230,64,109,57,58,26,26,6,75,34,41,3,3,57,31,26
"2021","Birmingham 069A","E01009302",612,204,109,95,381,79,156,52,59,45,68,35,27,6,75,40,35,3,3,27,10,17
"2021","Birmingham 069B","E01009314",749,215,107,108,480,45,207,70,106,31,84,27,45,12,134,87,47,10,10,54,32,22
"2021","Birmingham 069C","E01009321",817,268,96,172,493,25,147,38,74,35,74,31,37,6,235,165,70,12,12,56,27,29
"2021","Birmingham 069D","E01009322",723,262,82,180,410,17,153,42,74,37,83,32,42,9,151,101,50,6,6,51,28,23
"2021","Birmingham 069E","E01009323",640,152,71,81,425,29,183,44,108,31,61,23,32,6,144,99,45,8,8,63,36,27
"2021","Birmingham 070A","E01009329",708,161,39,122,393,9,239,30,165,44,20,7,10,3,104,58,46,21,21,154,110,44
"2021","Birmingham 070B","E01009334",437,77,35,42,225,13,149,12,87,50,10,3,5,2,47,17,30,6,6,135,92,43
"2021","Birmingham 070C","E01009337",493,84,25,59,328,9,223,14,174,35,10,3,6,1,76,47,29,10,10,81,59,22
"2021","Birmingham 070D","E01009338",431,58,28,30,271,7,165,13,123,29,13,3,8,2,83,45,38,3,3,102,71,31
"2021","Birmingham 070E","E01009380",505,106,28,78,308,6,193,18,154,21,12,2,7,3,90,63,27,7,7,91,70,21
"2021","Birmingham 071A","E01009362",490,207,35,172,243,3,130,12,107,11,14,7,6,1,91,66,25,5,5,40,25,15
"2021","Birmingham 071B","E01009363",576,196,51,145,313,16,169,33,113,23,28,12,14,2,88,48,40,12,12,67,54,13
"2021","Birmingham 071C","E01009364",556,165,25,140,342,6,143,11,110,22,27,17,10,0,158,104,54,8,8,49,36,13
"2021","Birmingham 071D","E01009365",589,204,42,162,304,6,160,21,113,26,24,18,5,1,99,44,55,15,15,81,63,18
"2021","Birmingham 071E","E01009379",680,292,118,174,312,11,165,26,109,30,21,4,17,0,103,66,37,12,12,76,42,34
"2021","Birmingham 072A","E01009312",613,159,78,81,414,54,226,64,105,57,63,27,31,5,70,38,32,1,1,40,21,19
"2021","Birmingham 072B","E01009324",716,201,121,80,480,84,229,76,94,59,84,39,38,7,78,42,36,5,5,35,19,16
"2021","Birmingham 072C","E01009519",597,150,71,79,414,59,193,55,87,51,78,37,32,9,79,44,35,5,5,33,21,12
"2021","Birmingham 072D","E01009520",709,239,116,123,424,65,226,63,108,55,65,24,34,7,63,31,32,5,5,46,31,15
"2021","Birmingham 073A","E01009066",878,358,239,119,470,121,282,78,160,44,30,22,7,1,35,19,16,2,2,50,31,19
"2021","Birmingham 073B","E01009070",678,223,108,115,415,53,246,65,152,29,65,51,11,3,46,32,14,5,5,40,19,21
"2021","Birmingham 073C","E01009252",644,142,56,86,438,65,223,65,125,33,92,63,26,3,54,39,15,4,4,64,23,41
"2021","Birmingham 073D","E01009260",627,204,122,82,339,79,186,46,101,39,29,23,6,0,44,24,20,1,1,84,49,35
"2021","Birmingham 073E","E01009261",726,229,123,106,428,70,241,70,128,43,48,27,20,1,67,39,28,2,2,69,28,41
"2021","Birmingham 074A","E01008984",783,410,108,302,293,19,122,39,68,15,46,27,17,2,94,51,43,12,12,80,31,49
"2021","Birmingham 074B","E01008994",648,240,81,159,340,38,163,57,92,14,60,44,14,2,60,35,25,19,19,68,12,56
"2021","Birmingham 074C","E01008996",681,245,81,164,363,13,189,40,129,20,28,15,12,1,126,76,50,7,7,73,39,34
"2021","Birmingham 074D","E01008997",627,213,87,126,358,46,173,59,78,36,30,22,8,0,106,61,45,3,3,56,17,39
"2021","Birmingham 075A","E01009065",635,171,73,98,421,50,271,73,153,45,59,41,16,2,35,15,20,6,6,43,13,30
"2021","Birmingham 075B","E01009067",685,243,100,143,414,47,254,81,141,32,70,53,17,0,40,28,12,3,3,28,4,24
"2021","Birmingham 075C","E01009068",728,274,95,179,369,29,190,50,124,16,102,82,16,4,44,27,17,4,4,85,9,76
"2021","Birmingham 075D","E01009069",854,362,100,262,421,45,166,62,85,19,137,109,25,3,62,48,14,11,11,71,4,67
"2021","Birmingham 075E","E01009072",849,314,90,224,456,34,215,75,121,19,135,119,13,3,63,35,28,9,9,79,11,68
"2021","Birmingham 076A","E01008885",502,123,55,68,336,38,180,48,82,50,41,15,22,4,68,37,31,9,9,43,30,13
"2021","Birmingham 076B","E01008886",693,261,113,148,392,21,176,52,92,32,65,34,26,5,125,85,40,5,5,40,14,26
"2021","Birmingham 076C","E01008888",632,129,58,71,462,44,236,75,111,50,107,46,56,5,67,48,19,8,8,41,19,22
"2021","Birmingham 076D","E01009313",631,173,86,87,421,45,217,42,116,59,76,38,36,2,78,39,39,5,5,37,24,13
"2021","Birmingham 077A","E01009368",417,123,30,93,205,8,106,15,70,21,6,2,4,0,80,44,36,5,5,89,65,24
"2021","Birmingham 077D","E01009371",522,101,25,76,320,5,201,26,148,27,7,3,3,1,98,61,37,9,9,101,74,27
"2021","Birmingham 077E","E01009397",464,73,21,52,299,4,170,20,116,34,10,4,4,2,109,55,54,6,6,92,63,29
"2021","Birmingham 077F","E01033650",726,149,70,79,427,22,273,18,217,38,14,3,6,5,103,47,56,15,15,150,116,34
"2021","Birmingham 078A","E01008883",635,162,58,104,392,23,221,42,146,33,31,10,18,3,102,58,44,15,15,81,52,29
"2021","Birmingham 078B","E01008884",715,179,78,101,453,9,238,41,177,20,48,21,19,8,148,107,41,10,10,83,57,26
"2021","Birmingham 078C","E01008887",616,171,64,107,392,16,186,35,117,34,57,24,28,5,125,86,39,8,8,53,32,21
"2021","Birmingham 078D","E01008889",665,240,98,142,347,41,177,37,120,20,49,27,13,9,71,45,26,9,9,78,40,38
"2021","Birmingham 079A","E01008982",702,263,60,203,363,21,197,76,93,28,75,65,8,2,55,35,20,15,15,76,14,62
"2021","Birmingham 079C","E01008992",478,142,59,83,298,54,168,49,96,23,35,29,6,0,24,15,9,17,17,38,13,25
"2021","Birmingham 079E","E01009283",612,180,60,120,326,33,166,53,92,21,73,46,25,2,46,22,24,8,8,106,33,73
"2021","Birmingham 079G","E01034936",405,146,91,55,220,56,109,26,67,16,22,16,5,1,28,17,11,5,5,39,12,27
"2021","Birmingham 079H","E01034937",443,172,21,151,213,25,138,54,61,23,35,30,3,2,13,9,4,2,2,58,21,37
"2021","Birmingham 080A","E01009249",645,189,86,103,417,40,203,63,104,36,72,47,22,3,95,51,44,7,7,39,17,22
"2021","Birmingham 080B","E01009250",732,218,87,131,480,83,211,74,93,44,74,34,37,3,106,64,42,6,6,34,16,18
"2021","Birmingham 080C","E01009251",630,180,78,102,421,58,241,78,109,54,64,44,20,0,52,31,21,6,6,29,25,4
"2021","Birmingham 080D","E01009253",629,140,58,82,456,67,255,73,118,64,62,31,27,4,68,37,31,4,4,33,15,18
"2021","Birmingham 080E","E01009255",623,197,81,116,359,30,148,44,73,31,55,22,29,4,121,77,44,5,5,67,39,28
"2021","Birmingham 080F","E01009257",619,177,63,114,391,32,160,33,91,36,71,28,35,8,121,78,43,7,7,51,26,25
"2021","Birmingham 081A","E01009315",840,380,148,232,410,64,159,49,77,33,72,48,20,4,110,67,43,5,5,50,23,27
"2021","Birmingham 081B","E01009316",794,266,93,173,474,52,230,80,106,44,83,48,30,5,89,52,37,20,20,54,29,25
"2021","Birmingham 081C","E01009317",845,237,92,145,556,55,216,66,95,55,115,50,56,9,167,114,53,3,3,52,30,22
"2021","Birmingham 081D","E01009318",638,175,81,94,428,57,204,72,84,48,89,47,36,6,73,35,38,5,5,35,18,17
"2021","Birmingham 081E","E01009319",625,165,79,86,424,64,221,63,85,73,74,34,30,10,62,33,29,3,3,36,19,17
"2021","Birmingham 081F","E01009320",653,188,79,109,412,63,193,53,97,43,84,45,35,4,63,27,36,9,9,53,29,24
"2021","Birmingham 082A","E01009372",417,53,21,32,271,5,174,16,133,25,19,3,15,1,63,28,35,10,10,93,68,25
"2021","Birmingham 082B","E01009373",461,78,33,45,296,7,206,18,144,44,6,1,3,2,70,38,32,7,7,87,58,29
"2021","Birmingham 082D","E01009396",508,94,31,63,268,7,160,21,100,39,10,5,5,0,83,33,50,8,8,146,109,37
"2021","Birmingham 082F","E01033643",823,147,49,98,515,13,350,36,256,58,14,6,6,2,129,89,40,9,9,161,114,47
"2021","Birmingham 083A","E01009367",553,178,24,154,280,11,162,21,102,39,18,5,12,1,82,45,37,7,7,95,70,25
"2021","Birmingham 083B","E01009375",552,131,25,106,330,11,202,21,144,37,8,3,4,1,98,53,45,11,11,91,74,17
"2021","Birmingham 083C","E01009377",432,106,36,70,279,11,130,16,96,18,20,8,10,2,111,68,43,7,7,47,37,10
"2021","Birmingham 083D","E01009383",413,128,33,95,212,5,122,14,72,36,26,11,10,5,44,15,29,15,15,73,51,22
"2021","Birmingham 083E","E01009399",421,72,17,55,279,8,162,14,115,33,18,5,12,1,85,64,21,6,6,70,51,19
"2021","Birmingham 084A","E01009366",537,134,47,87,337,8,161,24,110,27,47,11,34,2,115,57,58,6,6,66,38,28
"2021","Birmingham 084B","E01009374",437,175,49,126,217,14,118,10,90,18,8,5,3,0,69,31,38,8,8,45,35,10
"2021","Birmingham 084C","E01009376",541,224,56,168,238,8,119,19,75,25,27,18,8,1,76,45,31,8,8,79,45,34
"2021","Birmingham 084F","E01033648",826,286,45,241,374,15,192,25,127,40,31,20,8,3,126,77,49,10,10,166,127,39
"2021","Birmingham 085A","E01009073",644,150,47,103,451,21,139,28,85,26,49,14,32,3,233,195,38,9,9,43,28,15
"2021","Birmingham 085B","E01009074",711,275,74,201,391,11,153,34,92,27,62,28,29,5,154,107,47,11,11,45,22,23
"2021","Birmingham 085C","E01009254",846,327,160,167,470,49,236,69,130,37,51,26,24,1,124,86,38,10,10,49,15,34
"2021","Birmingham 085D","E01009256",679,227,92,135,421,45,188,41,106,41,73,38,29,6,110,75,35,5,5,31,19,12
"2021","Birmingham 085E","E01009258",651,238,78,160,387,33,151,31,89,31,52,22,26,4,143,99,44,8,8,26,13,13
"2021","Birmingham 087B","E01009071",737,291,130,161,402,53,208,67,111,30,73,53,16,4,58,35,23,10,10,44,12,32
"2021","Birmingham 087C","E01009075",816,414,150,264,304,24,107,34,61,12,73,50,21,2,89,60,29,11,11,98,20,78
"2021","Birmingham 087E","E01009078",609,205,71,134,265,22,119,31,71,17,60,43,12,5,57,29,28,7,7,139,9,130
"2021","Birmingham 087F","E01033562",1012,332,124,208,484,50,218,64,126,28,87,66,18,3,109,58,51,20,20,196,26,170
"2021","Birmingham 088C","E01009183",581,128,48,80,380,56,222,65,122,35,50,33,16,1,48,24,24,4,4,73,40,33
"2021","Birmingham 088D","E01009186",779,293,81,212,442,52,218,68,112,38,113,70,42,1,53,33,20,6,6,44,18,26
"2021","Birmingham 088F","E01034938",516,122,33,89,257,11,151,11,110,30,22,4,16,2,70,39,31,3,3,137,72,65
"2021","Birmingham 088G","E01034939",440,115,23,92,200,7,109,13,66,30,23,14,7,2,57,32,25,4,4,125,70,55
"2021","Birmingham 089A","E01008890",708,260,70,190,379,19,181,38,105,38,65,34,26,5,106,67,39,8,8,69,40,29
"2021","Birmingham 089B","E01008891",714,265,94,171,430,49,221,74,100,47,79,44,32,3,81,45,36,0,0,19,12,7
"2021","Birmingham 089C","E01008892",498,139,48,91,289,20,126,20,80,26,21,4,13,4,113,64,49,9,9,70,36,34
"2021","Birmingham 089D","E01008893",729,257,75,182,412,35,209,73,94,42,89,53,33,3,73,50,23,6,6,60,26,34
"2021","Birmingham 089E","E01008894",714,364,130,234,288,29,140,39,71,30,44,31,11,2,63,32,31,12,12,62,26,36
"2021","Birmingham 089F","E01008895",765,232,52,180,460,38,210,59,112,39,85,46,36,3,119,74,45,8,8,73,31,42
"2021","Birmingham 089G","E01009015",787,328,123,205,389,24,199,52,115,32,78,39,34,5,80,55,25,8,8,70,31,39
"2021","Birmingham 090A","E01009014",814,152,40,112,579,23,313,47,218,48,52,25,23,4,166,101,65,25,25,83,56,27
"2021","Birmingham 090B","E01009018",719,284,95,189,367,48,201,51,102,48,48,26,18,4,64,34,30,6,6,68,29,39
"2021","Birmingham 090C","E01009026",708,199,60,139,449,25,244,48,168,28,56,25,23,8,116,85,31,8,8,60,36,24
"2021","Birmingham 090D","E01009028",618,164,59,105,396,18,199,32,139,28,52,23,24,5,121,84,37,6,6,58,36,22
"2021","Birmingham 090E","E01009029",518,120,51,69,341,11,192,39,128,25,29,12,12,5,103,69,34,6,6,57,33,24
"2021","Birmingham 092A","E01009182",640,332,61,271,245,4,126,50,57,19,46,31,13,2,61,41,20,8,8,63,38,25
"2021","Birmingham 092B","E01009184",721,330,89,241,305,25,146,50,73,23,78,61,16,1,47,34,13,9,9,86,16,70
"2021","Birmingham 092C","E01009187",651,262,125,137,345,65,181,61,99,21,61,40,19,2,36,23,13,2,2,44,10,34
"2021","Birmingham 092D","E01009188",660,272,69,203,345,40,187,61,103,23,68,42,23,3,49,32,17,1,1,43,16,27
"2021","Birmingham 092E","E01009384",700,397,96,301,247,11,97,37,46,14,72,56,10,6,58,34,24,9,9,56,18,38
"2021","Birmingham 092F","E01009385",601,325,64,261,222,19,81,38,36,7,72,59,12,1,44,30,14,6,6,54,19,35
"2021","Birmingham 093A","E01009185",761,339,123,216,354,71,161,52,81,28,66,57,8,1,49,29,20,7,7,68,39,29
"2021","Birmingham 093B","E01009389",479,100,42,58,248,16,166,21,97,48,12,7,3,2,47,15,32,7,7,131,74,57
"2021","Birmingham 093C","E01009390",648,335,33,302,229,15,112,25,66,21,44,37,6,1,56,36,20,2,2,84,43,41
"2021","Birmingham 093D","E01009394",729,364,73,291,274,22,145,34,84,27,60,48,12,0,44,27,17,3,3,91,54,37
"2021","Birmingham 094A","E01008918",723,248,90,158,440,41,148,30,87,31,60,27,30,3,186,139,47,5,5,35,20,15
"2021","Birmingham 094B","E01008920",548,143,81,62,375,54,174,61,63,50,67,21,39,7,78,46,32,2,2,30,12,18
"2021","Birmingham 094C","E01008921",621,209,79,130,371,60,159,61,63,35,51,23,28,0,96,63,33,5,5,41,15,26
"2021","Birmingham 094D","E01008931",624,244,87,157,338,31,127,36,70,21,47,14,25,8,123,79,44,10,10,42,29,13
"2021","Birmingham 094E","E01009259",718,255,68,187,413,31,136,37,68,31,55,25,25,5,186,121,65,5,5,50,25,25
"2021","Birmingham 095A","E01008919",696,241,71,170,422,54,185,52,104,29,72,36,27,9,105,64,41,6,6,33,11,22
"2021","Birmingham 095B","E01009064",592,163,66,97,376,37,183,45,102,36,59,32,24,3,90,58,32,7,7,53,17,36
"2021","Birmingham 095C","E01009077",690,214,100,114,427,61,202,55,124,23,74,36,34,4,86,56,30,4,4,49,11,38
"2021","Birmingham 095D","E01009291",586,153,50,103,377,23,161,39,83,39,84,49,30,5,100,66,34,9,9,56,23,33
"2021","Birmingham 095E","E01009500",610,200,70,130,364,29,144,31,81,32,64,28,26,10,115,75,40,12,12,46,25,21
"2021","Birmingham 096A","E01009284",995,286,54,232,402,21,159,47,101,11,101,79,19,3,99,69,30,22,22,307,33,274
"2021","Birmingham 096C","E01009286",516,46,21,25,58,4,24,5,14,5,7,2,5,0,16,14,2,7,7,412,18,394
"2021","Birmingham 096E","E01009289",606,92,22,70,80,1,27,3,22,2,12,8,4,0,31,19,12,9,9,434,14,420
"2021","Birmingham 096F","E01009290",526,44,7,37,53,5,12,0,9,3,15,10,4,1,18,10,8,3,3,429,5,424
"2021","Birmingham 096H","E01034940",437,108,15,93,100,2,31,4,22,5,16,11,4,1,45,37,8,6,6,229,9,220
"2021","Birmingham 096I","E01034941",427,44,7,37,42,1,13,3,7,3,8,3,4,1,14,11,3,6,6,341,5,336
"2021","Birmingham 097A","E01009017",484,74,37,37,334,30,206,26,131,49,19,6,10,3,73,38,35,6,6,76,56,20
"2021","Birmingham 097B","E01009043",600,140,74,66,385,28,231,37,139,55,25,14,10,1,93,40,53,8,8,75,56,19
"2021","Birmingham 097C","E01009044",456,77,30,47,281,18,173,19,129,25,15,10,4,1,70,48,22,5,5,98,71,27
"2021","Birmingham 097D","E01009045",699,216,134,82,385,48,203,31,129,43,40,13,24,3,86,49,37,8,8,98,66,32
"2021","Birmingham 097E","E01009046",605,153,95,58,372,54,226,48,119,59,30,13,4,13,61,27,34,1,1,80,60,20
"2021","Birmingham 097F","E01009395",524,175,42,133,253,19,147,26,92,29,17,12,5,0,66,27,39,4,4,96,61,35
"2021","Birmingham 098A","E01009016",726,340,144,196,334,25,174,40,95,39,50,24,20,6,82,43,39,3,3,52,31,21
"2021","Birmingham 098B","E01009022",588,117,39,78,414,22,239,42,135,62,46,20,18,8,98,52,46,9,9,57,43,14
"2021","Birmingham 098C","E01009023",559,105,52,53,400,43,250,60,141,49,38,16,17,5,62,35,27,7,7,54,35,19
"2021","Birmingham 098D","E01009030",625,138,50,88,408,31,239,53,132,54,35,21,11,3,96,70,26,7,7,79,56,23
"2021","Birmingham 099A","E01009281",697,296,183,113,376,69,202,62,116,24,55,28,22,5,47,23,24,3,3,25,14,11
"2021","Birmingham 099B","E01009292",665,194,58,136,398,42,225,60,119,46,67,39,25,3,57,29,28,7,7,73,16,57
"2021","Birmingham 099C","E01009294",805,240,95,145,512,52,226,75,118,33,103,57,46,0,127,80,47,4,4,53,10,43
"2021","Birmingham 099D","E01009295",670,262,135,127,283,54,139,44,79,16,44,25,19,0,41,23,18,5,5,125,24,101
"2021","Birmingham 100A","E01009280",746,237,96,141,455,32,226,83,125,18,103,67,34,2,90,49,41,4,4,54,16,38
"2021","Birmingham 100B","E01009282",696,241,66,175,357,23,159,57,77,25,69,49,17,3,94,52,42,12,12,98,30,68
"2021","Birmingham 100C","E01009288",448,135,55,80,255,58,130,36,66,28,40,31,8,1,24,14,10,3,3,58,14,44
"2021","Birmingham 100D","E01009293",619,195,76,119,301,35,156,48,86,22,55,40,15,0,48,28,20,7,7,123,22,101
"2021","Birmingham 100E","E01009296",591,175,41,134,319,21,146,50,79,17,83,55,27,1,64,46,18,5,5,97,20,77
"2021","Birmingham 101A","E01008924",634,231,95,136,363,49,174,57,79,38,77,37,33,7,59,42,17,4,4,40,19,21
"2021","Birmingham 101B","E01009501",568,152,47,105,371,19,137,30,75,32,63,23,35,5,143,93,50,9,9,45,30,15
"2021","Birmingham 101C","E01009502",581,207,110,97,332,18,154,60,74,20,47,14,26,7,110,76,34,3,3,42,20,22
"2021","Birmingham 101D","E01009503",581,170,64,106,360,22,143,37,72,34,62,23,35,4,125,79,46,8,8,51,27,24
"2021","Birmingham 101E","E01009505",644,182,85,97,424,28,180,58,85,37,49,15,32,2,162,104,58,5,5,38,22,16
"2021","Birmingham 102A","E01008917",509,126,53,73,354,58,177,62,68,47,48,18,27,3,68,33,35,3,3,29,17,12
"2021","Birmingham 102B","E01008923",640,246,103,143,360,36,123,36,63,24,62,18,42,2,133,93,40,6,6,34,22,12
"2021","Birmingham 102C","E01008925",509,140,73,67,347,76,160,57,48,55,54,21,28,5,53,27,26,4,4,22,10,12
"2021","Birmingham 102D","E01008927",598,221,72,149,351,29,103,39,41,23,56,26,22,8,159,111,48,4,4,26,13,13
"2021","Birmingham 102E","E01008928",738,340,119,221,374,33,139,42,66,31,48,19,23,6,151,97,54,3,3,24,17,7
"2021","Birmingham 103A","E01009019",606,159,59,100,392,23,173,29,110,34,54,20,24,10,134,89,45,8,8,55,37,18
"2021","Birmingham 103B","E01009020",557,140,53,87,359,24,179,38,100,41,43,16,20,7,105,71,34,8,8,58,44,14
"2021","Birmingham 103C","E01009021",680,179,54,125,460,19,162,32,99,31,72,31,32,9,199,150,49,8,8,41,19,22
"2021","Birmingham 103D","E01009024",615,162,56,106,397,13,187,41,114,32,35,7,23,5,156,95,61,6,6,56,34,22
"2021","Birmingham 103E","E01009025",573,133,48,85,394,19,164,33,90,41,57,17,32,8,149,102,47,5,5,46,26,20
"2021","Birmingham 103F","E01009033",701,200,59,141,449,19,217,43,151,23,69,23,37,9,140,91,49,4,4,52,35,17
"2021","Birmingham 104A","E01009175",593,170,55,115,368,19,173,47,98,28,102,63,37,2,66,39,27,8,8,55,18,37
"2021","Birmingham 104B","E01009177",633,203,87,116,369,21,185,56,114,15,87,63,22,2,71,42,29,5,5,61,21,40
"2021","Birmingham 104C","E01009178",761,273,81,192,409,12,174,67,94,13,140,104,31,5,77,49,28,6,6,79,14,65
"2021","Birmingham 104D","E01009179",638,183,94,89,406,59,232,59,115,58,59,38,17,4,47,20,27,9,9,49,26,23
"2021","Birmingham 104E","E01009189",589,185,75,110,366,57,196,57,103,36,64,46,16,2,47,31,16,2,2,38,14,24
"2021","Birmingham 105A","E01008933",543,125,44,81,372,37,221,48,118,55,43,20,17,6,68,38,30,3,3,46,29,17
"2021","Birmingham 105B","E01008934",547,135,74,61,370,58,216,50,115,51,37,17,17,3,54,20,34,5,5,42,27,15
"2021","Birmingham 105C","E01009031",645,188,87,101,388,49,226,53,119,54,36,26,10,0,73,40,33,4,4,69,41,28
"2021","Birmingham 105D","E01009037",755,254,129,125,434,87,239,73,126,40,43,24,15,4,59,24,35,6,6,67,37,30
"2021","Birmingham 105E","E01009176",678,240,96,144,368,51,180,49,88,43,47,32,14,1,87,56,31,3,3,70,43,27
"2021","Birmingham 106C","E01008929",698,298,123,175,368,26,125,42,61,22,75,34,31,10,136,96,40,6,6,32,17,15
"2021","Birmingham 106D","E01008930",790,227,72,155,521,34,240,71,139,30,113,63,43,7,129,88,41,5,5,42,24,18
"2021","Birmingham 106E","E01009495",537,154,77,77,358,27,126,43,56,27,62,20,34,8,136,93,43,7,7,25,11,14
"2021","Birmingham 106F","E01033629",1052,385,137,248,605,51,224,55,122,47,87,40,41,6,237,174,63,6,6,62,29,33
"2021","Birmingham 107A","E01008953",660,222,70,152,384,30,168,47,89,32,78,46,25,7,97,68,29,11,11,54,27,27
"2021","Birmingham 107B","E01008963",619,210,58,152,368,22,159,48,84,27,79,41,30,8,101,63,38,7,7,41,20,21
"2021","Birmingham 107C","E01008964",621,227,107,120,360,31,148,45,81,22,78,45,27,6,93,53,40,10,10,34,23,11
"2021","Birmingham 107D","E01008965",574,146,57,89,383,45,196,63,95,38,80,49,28,3,58,39,19,4,4,45,22,23
"2021","Birmingham 107E","E01008966",681,231,87,144,399,29,163,27,112,24,67,38,26,3,130,70,60,10,10,51,22,29
"2021","Birmingham 108A","E01009032",589,127,75,52,379,41,239,40,132,67,25,12,11,2,70,33,37,4,4,83,57,26
"2021","Birmingham 108B","E01009034",553,112,55,57,368,48,235,37,137,61,37,19,13,5,46,20,26,2,2,73,49,24
"2021","Birmingham 108C","E01009035",612,103,46,57,434,41,225,53,126,46,42,12,25,5,116,72,44,10,10,75,47,28
"2021","Birmingham 108D","E01009036",537,150,69,81,324,44,191,28,101,62,41,15,20,6,44,25,19,4,4,63,38,25
"2021","Birmingham 109A","E01009494",622,175,83,92,426,23,124,29,61,34,44,12,27,5,231,171,60,4,4,21,12,9
"2021","Birmingham 109B","E01009496",637,194,125,69,411,89,190,62,81,47,63,28,25,10,66,37,29,3,3,32,21,11
"2021","Birmingham 109C","E01009497",755,247,98,149,472,45,231,52,108,71,86,36,41,9,106,63,43,4,4,36,17,19
"2021","Birmingham 109D","E01009504",641,185,106,79,412,76,221,69,122,30,48,20,24,4,63,38,25,4,4,44,21,23
"2021","Birmingham 109E","E01009506",623,178,111,67,422,93,228,57,122,49,48,21,23,4,51,24,27,2,2,23,14,9
"2021","Birmingham 110A","E01008967",648,181,100,81,435,79,257,63,136,58,42,24,14,4,54,26,28,3,3,32,12,20
"2021","Birmingham 110B","E01008968",712,198,122,76,460,75,276,79,154,43,48,23,19,6,61,40,21,0,0,54,30,24
"2021","Birmingham 110C","E01008970",603,186,82,104,378,48,162,32,101,29,49,23,23,3,114,64,50,5,5,39,19,20
"2021","Birmingham 110D","E01008981",589,144,81,63,402,79,237,73,119,45,50,24,24,2,32,12,20,4,4,43,23,20
"2021","Birmingham 111A","E01008932",656,222,85,137,393,27,187,54,107,26,55,33,19,3,118,67,51,6,6,41,22,19
"2021","Birmingham 111B","E01008935",675,240,81,159,372,19,164,40,101,23,53,20,25,8,133,88,45,3,3,63,33,30
"2021","Birmingham 111C","E01008936",656,217,77,140,386,59,187,40,106,41,42,22,17,3,92,53,39,6,6,53,27,26
"2021","Birmingham 111D","E01008938",571,146,55,91,386,24,195,24,137,34,49,12,25,12,108,75,33,10,10,39,21,18
"2021","Birmingham 111E","E01008939",703,261,99,162,386,28,174,45,89,40,60,27,26,7,118,78,40,6,6,56,30,26
"2021","Birmingham 112A","E01008951",613,199,102,97,379,53,195,49,118,28,72,42,25,5,57,32,25,2,2,35,12,23
"2021","Birmingham 112B","E01008952",875,326,54,272,460,17,150,73,61,16,181,136,40,5,100,59,41,12,12,89,13,76
"2021","Birmingham 112C","E01008955",743,237,64,173,447,43,180,75,76,29,149,102,41,6,69,46,23,6,6,59,17,42
"2021","Birmingham 112D","E01008956",556,157,83,74,375,40,226,65,125,36,59,28,25,6,46,23,23,4,4,24,10,14
"2021","Birmingham 112E","E01008957",727,264,51,213,412,23,154,62,68,24,109,80,28,1,114,75,39,12,12,51,13,38
"2021","Birmingham 113A","E01008950",719,304,122,182,397,103,185,58,92,35,45,25,16,4,61,32,29,3,3,18,5,13
"2021","Birmingham 113B","E01008954",597,161,87,74,417,98,219,71,93,55,39,18,21,0,58,33,25,3,3,19,11,8
"2021","Birmingham 113C","E01008958",768,324,169,155,420,68,137,53,48,36,69,31,32,6,144,87,57,2,2,24,11,13
"2021","Birmingham 113D","E01009493",1021,587,210,377,391,43,152,43,91,18,60,33,24,3,132,104,28,4,4,43,14,29
"2021","Birmingham 115A","E01008937",631,200,92,108,374,43,143,43,75,25,45,18,24,3,135,90,45,8,8,57,34,23
"2021","Birmingham 115B","E01008940",579,177,63,114,359,19,134,32,82,20,60,18,35,7,135,91,44,11,11,43,20,23
"2021","Birmingham 115C","E01008941",576,149,58,91,373,23,164,31,86,47,53,25,21,7,125,81,44,8,8,54,36,18
"2021","Birmingham 115D","E01008944",734,247,88,159,449,39,176,52,97,27,93,48,41,4,137,85,52,4,4,38,18,20
"2021","Birmingham 116A","E01008959",801,319,191,128,453,73,195,51,99,45,77,50,23,4,103,65,38,5,5,29,13,16
"2021","Birmingham 116B","E01008960",624,165,62,103,430,31,260,77,130,53,86,44,33,9,51,27,24,2,2,29,8,21
"2021","Birmingham 116C","E01008961",726,350,111,239,339,43,149,59,59,31,72,46,23,3,68,39,29,7,7,37,13,24
"2021","Birmingham 116D","E01008962",859,276,83,193,533,46,161,52,76,33,81,30,49,2,240,193,47,5,5,50,28,22
"2021","Birmingham 117A","E01008942",628,180,65,115,398,30,157,43,76,38,88,30,47,11,116,71,45,7,7,50,28,22
"2021","Birmingham 117B","E01008943",573,176,59,117,351,26,138,35,66,37,68,26,32,10,118,75,43,1,1,46,21,25
"2021","Birmingham 117C","E01008969",690,217,95,122,438,55,220,52,126,42,80,39,30,11,75,46,29,8,8,35,16,19
"2021","Birmingham 117D","E01008971",749,258,109,149,448,59,209,63,101,45,70,38,26,6,103,65,38,7,7,43,16,27
"2021","Birmingham 118A","E01008972",758,250,75,175,443,41,166,37,93,36,83,40,38,5,146,95,51,7,7,65,26,39
"2021","Birmingham 118B","E01008973",877,324,101,223,508,51,219,67,108,44,101,56,40,5,135,79,56,2,2,45,20,25
"2021","Birmingham 118C","E01008974",1104,303,100,203,749,69,351,72,217,62,159,99,44,16,166,98,68,4,4,52,33,19
"2021","Birmingham 118D","E01008975",660,237,121,116,396,49,192,68,85,39,88,43,39,6,65,36,29,2,2,27,14,13
"2021","Birmingham 119A","E01009172",557,170,63,107,344,26,133,24,78,31,60,26,26,8,119,75,44,6,6,43,24,19
"2021","Birmingham 119B","E01009173",637,141,45,96,430,12,156,40,85,31,74,28,35,11,183,128,55,5,5,66,33,33
"2021","Birmingham 119C","E01009174",521,178,74,104,315,30,109,39,47,23,62,25,33,4,112,80,32,2,2,28,14,14
"2021","Birmingham 119D","E01009498",679,190,46,144,443,25,143,55,58,30,85,30,43,12,180,127,53,10,10,46,23,23
"2021","Birmingham 119E","E01009499",662,174,63,111,427,34,175,53,82,40,79,26,43,10,128,74,54,11,11,61,34,27
"2021","Birmingham 120A","E01009205",614,177,83,94,405,63,212,59,94,59,64,27,30,7,65,36,29,1,1,32,13,19
"2021","Birmingham 120B","E01009206",648,181,103,78,433,84,212,77,81,54,68,30,29,9,68,33,35,1,1,34,15,19
"2021","Birmingham 120C","E01009211",687,246,87,159,413,57,206,93,69,44,74,50,21,3,73,43,30,3,3,28,14,14
"2021","Birmingham 120D","E01009218",643,204,129,75,407,79,251,66,141,44,44,18,24,2,32,17,15,1,1,32,18,14
"2021","Birmingham 120E","E01009219",607,156,66,90,422,55,157,50,75,32,90,46,41,3,110,68,42,10,10,29,16,13
"2021","Birmingham 121A","E01008976",647,212,92,120,386,32,145,38,78,29,51,27,19,5,149,82,67,9,9,49,17,32
"2021","Birmingham 121B","E01008978",629,315,100,215,286,14,88,17,56,15,40,16,22,2,136,105,31,8,8,28,19,9
"2021","Birmingham 121C","E01008979",705,276,99,177,389,43,120,48,48,24,74,27,38,9,147,99,48,5,5,40,24,16
"2021","Birmingham 121D","E01008980",680,215,80,135,431,29,128,39,66,23,63,26,23,14,203,128,75,8,8,34,17,17
"2021","Birmingham 122A","E01008945",741,236,68,168,461,40,196,57,96,43,94,46,39,9,127,84,43,4,4,44,22,22
"2021","Birmingham 122B","E01008946",646,234,97,137,370,39,163,51,81,31,76,33,32,11,90,52,38,2,2,42,23,19
"2021","Birmingham 122C","E01008947",539,158,63,95,360,29,153,44,67,42,86,33,46,7,89,56,33,3,3,21,15,6
"2021","Birmingham 122D","E01008948",618,173,87,86,428,64,182,72,72,38,96,44,42,10,81,43,38,5,5,17,10,7
"2021","Birmingham 122E","E01008949",507,131,81,50,353,50,175,67,59,49,77,35,36,6,48,23,25,3,3,23,9,14
"2021","Birmingham 123A","E01008977",704,242,64,178,431,30,144,56,60,28,90,50,35,5,163,118,45,4,4,31,16,15
"2021","Birmingham 123B","E01009109",514,123,22,101,351,10,98,27,60,11,68,22,40,6,171,135,36,4,4,40,27,13
"2021","Birmingham 123C","E01009119",661,238,115,123,401,66,182,58,85,39,73,42,28,3,74,43,31,6,6,22,8,14
"2021","Birmingham 123D","E01009120",778,271,96,175,474,55,180,68,83,29,138,68,65,5,96,67,29,5,5,33,13,20
"2021","Birmingham 124A","E01009162",635,163,79,84,438,54,204,65,89,50,89,36,44,9,86,62,24,5,5,34,18,16
"2021","Birmingham 124B","E01009207",666,178,96,82,460,69,232,71,112,49,82,38,33,11,73,29,44,4,4,28,20,8
"2021","Birmingham 124C","E01009208",703,171,78,93,508,57,247,91,106,50,105,51,47,7,94,55,39,5,5,24,7,17
"2021","Birmingham 124D","E01009209",946,358,117,241,532,61,217,84,86,47,102,60,33,9,141,102,39,11,11,56,19,37
"2021","Birmingham 124E","E01009213",752,271,122,149,447,87,166,69,66,31,79,45,27,7,110,73,37,5,5,34,14,20
"2021","Birmingham 125B","E01009155",581,208,94,114,340,34,122,46,38,38,59,26,26,7,119,60,59,6,6,33,13,20
"2021","Birmingham 125D","E01009157",617,216,106,110,355,36,102,39,38,25,64,23,31,10,150,103,47,3,3,46,25,21
"2021","Birmingham 125E","E01009160",711,265,63,202,411,23,102,31,45,26,63,16,40,7,219,165,54,4,4,35,20,15
"2021","Birmingham 125F","E01009161",610,200,100,100,367,57,118,44,44,30,78,33,39,6,109,76,33,5,5,43,20,23
"2021","Birmingham 125H","E01034942",669,138,16,122,485,10,218,58,145,15,116,56,54,6,136,108,28,5,5,46,29,17
"2021","Birmingham 125I","E01034943",730,261,111,150,423,46,128,41,52,35,91,31,50,10,150,95,55,8,8,46,24,22
"2021","Birmingham 126A","E01009117",802,285,90,195,462,21,130,34,79,17,68,18,45,5,238,174,64,5,5,55,38,17
"2021","Birmingham 126B","E01009210",834,306,109,197,493,57,169,63,72,34,106,57,39,10,155,96,59,6,6,35,19,16
"2021","Birmingham 126C","E01009212",774,282,72,210,457,43,157,47,78,32,84,38,39,7,158,115,43,15,15,35,19,16
"2021","Birmingham 126D","E01009214",767,317,113,204,408,21,134,48,57,29,85,35,37,13,161,97,64,7,7,42,24,18
"2021","Birmingham 126E","E01009215",933,447,196,251,447,38,128,48,60,20,80,35,41,4,188,130,58,13,13,39,12,27
"2021","Birmingham 127A","E01009108",435,114,73,41,303,72,149,56,56,37,40,22,16,2,37,15,22,5,5,18,9,9
"2021","Birmingham 127B","E01009111",598,139,49,90,422,50,196,59,99,38,84,40,37,7,90,54,36,2,2,37,14,23
"2021","Birmingham 127C","E01009112",642,196,100,96,419,50,173,51,84,38,77,36,37,4,112,67,45,7,7,27,16,11
"2021","Birmingham 127D","E01009116",569,159,109,50,379,114,196,62,103,31,38,25,12,1,27,10,17,4,4,31,14,17
"2021","Birmingham 127E","E01009118",680,234,111,123,403,60,165,53,66,46,77,31,42,4,93,55,38,8,8,43,18,25
"2021","Birmingham 128A","E01009107",697,243,79,164,416,27,128,28,75,25,70,26,35,9,185,154,31,6,6,38,26,12
"2021","Birmingham 128B","E01009110",606,238,70,168,322,43,103,35,47,21,73,34,32,7,99,65,34,4,4,46,27,19
"2021","Birmingham 128C","E01009113",704,274,115,159,380,14,123,41,60,22,63,25,34,4,174,132,42,6,6,50,27,23
"2021","Birmingham 128D","E01009114",650,256,115,141,355,44,115,37,48,30,80,45,30,5,110,74,36,6,6,39,22,17
"2021","Birmingham 128E","E01009115",613,203,94,109,371,41,129,55,43,31,73,25,39,9,125,90,35,3,3,39,25,14
"2021","Birmingham 129A","E01009158",895,261,80,181,563,25,199,65,97,37,145,64,68,13,189,132,57,5,5,71,42,29
"2021","Birmingham 129C","E01009165",643,295,94,201,324,15,121,45,54,22,79,40,37,2,106,80,26,3,3,24,12,12
"2021","Birmingham 129D","E01009169",701,184,80,104,484,48,194,60,85,49,123,52,60,11,112,70,42,7,7,33,12,21
"2021","Birmingham 129E","E01034944",662,302,183,119,327,73,91,34,44,13,60,34,25,1,102,87,15,1,1,33,18,15
"2021","Birmingham 129F","E01034945",637,195,73,122,407,51,155,49,71,35,94,54,33,7,105,62,43,2,2,35,20,15
"2021","Birmingham 130A","E01009159",912,264,93,171,596,56,297,100,155,42,118,56,50,12,123,80,43,2,2,52,30,22
"2021","Birmingham 130B","E01009164",627,225,98,127,368,47,161,56,64,41,79,39,35,5,75,51,24,6,6,34,20,14
"2021","Birmingham 130C","E01009167",588,146,63,83,405,36,166,51,73,42,89,36,45,8,111,71,40,3,3,37,16,21
"2021","Birmingham 130D","E01009171",723,244,83,161,449,57,166,50,78,38,105,55,45,5,118,83,35,3,3,30,16,14
"2021","Birmingham 131A","E01009166",566,169,66,103,362,24,137,42,62,33,90,52,36,2,107,79,28,4,4,35,13,22
"2021","Birmingham 131B","E01009168",653,202,87,115,425,67,183,72,57,54,100,49,42,9,72,41,31,3,3,26,7,19
"2021","Birmingham 131C","E01009170",634,167,81,86,440,55,195,74,80,41,97,45,45,7,88,57,31,5,5,27,14,13
"2021","Birmingham 131D","E01009216",836,259,120,139,543,74,231,82,103,46,97,46,45,6,134,100,34,7,7,34,15,19
"2021","Birmingham 131E","E01009217",656,168,81,87,458,69,217,81,78,58,98,45,50,3,67,40,27,7,7,30,8,22
"2021","Birmingham 132A","E01009039",651,144,79,65,466,77,265,71,153,41,61,29,23,9,61,35,26,2,2,41,21,20
"2021","Birmingham 132B","E01009040",614,129,64,65,430,58,271,66,149,56,57,30,21,6,40,16,24,4,4,55,36,19
"2021","Birmingham 132C","E01009041",636,142,62,80,458,52,274,81,144,49,49,28,19,2,82,41,41,1,1,36,19,17
"2021","Birmingham 132D","E01009042",525,118,51,67,382,35,194,59,97,38,59,28,27,4,91,68,23,3,3,25,15,10
"2021","Birmingham 132E","E01032589",604,209,115,94,350,48,204,53,107,44,29,20,7,2,67,38,29,2,2,45,23,22
"2021","Birmingham 133A","E01009262",535,105,28,77,309,26,200,39,106,55,23,7,11,5,55,23,32,5,5,121,77,44
"2021","Birmingham 133B","E01009267",600,175,77,98,320,48,187,31,101,55,24,13,10,1,56,18,38,5,5,105,68,37
"2021","Birmingham 133C","E01009276",542,106,58,48,360,42,225,32,114,79,16,6,7,3,74,32,42,3,3,76,46,30
"2021","Birmingham 133D","E01009278",546,112,44,68,348,30,215,40,105,70,22,10,10,2,74,23,51,7,7,86,58,28
"2021","Birmingham 133E","E01009279",451,55,26,29,325,27,210,39,104,67,23,6,13,4,58,29,29,7,7,71,51,20
"2021","Birmingham 133F","E01032591",472,76,54,22,307,46,195,29,91,75,10,1,6,3,49,20,29,7,7,89,63,26
"2021","Birmingham 134A","E01008995",912,361,116,245,488,13,163,42,105,16,64,30,31,3,239,164,75,9,9,63,26,37
"2021","Birmingham 134B","E01033557",988,555,13,542,342,7,114,72,39,3,152,145,7,0,30,18,12,39,39,91,7,84
"2021","Birmingham 134C","E01033624",770,316,27,289,364,4,149,66,81,2,112,100,10,2,77,58,19,22,22,90,7,83
"2021","Birmingham 134D","E01033626",595,264,51,213,252,3,88,34,49,5,64,56,8,0,86,71,15,11,11,79,6,73
"2021","Birmingham 134E","E01033640",901,360,37,323,424,4,179,52,114,13,86,70,14,2,127,88,39,28,28,117,29,88
"2021","Birmingham 135B","E01033567",640,360,7,353,214,0,62,37,21,4,104,98,6,0,23,18,5,25,25,66,4,62
"2021","Birmingham 135C","E01033615",485,227,4,223,201,2,79,45,30,4,93,87,6,0,15,8,7,12,12,57,0,57
"2021","Birmingham 135D","E01033616",757,424,47,377,256,4,75,42,26,7,78,61,17,0,73,56,17,26,26,77,7,70
"2021","Birmingham 135E","E01034946",585,302,58,244,223,6,70,35,34,1,91,80,11,0,40,32,8,16,16,60,6,54
"2021","Birmingham 135F","E01034947",698,280,26,254,340,11,136,31,85,20,78,68,10,0,93,64,29,22,22,78,17,61
"2021","Birmingham 136A","E01009143",750,288,50,238,406,7,165,40,110,15,41,18,22,1,173,131,42,20,20,56,20,36
"2021","Birmingham 136B","E01009146",1044,717,88,629,259,7,81,44,37,0,83,70,12,1,70,44,26,18,18,68,9,59
"2021","Birmingham 136C","E01033564",725,412,8,404,257,5,94,51,36,7,123,118,5,0,21,10,11,14,14,56,5,51
"2021","Birmingham 136E","E01034948",906,436,26,410,387,5,123,43,75,5,127,107,17,3,100,70,30,32,32,83,14,69
"2021","Birmingham 136F","E01034949",740,405,33,372,268,2,106,52,48,6,79,69,9,1,54,40,14,27,27,67,11,56
"2021","Birmingham 137A","E01009141",813,342,80,262,400,9,143,27,95,21,41,18,18,5,181,124,57,26,26,71,33,38
"2021","Birmingham 137B","E01033565",875,416,12,404,357,3,96,71,23,2,224,216,7,1,14,6,8,20,20,102,0,102
"2021","Birmingham 137C","E01033618",758,372,13,359,299,9,95,62,31,2,155,149,6,0,18,8,10,22,22,87,4,83
"2021","Birmingham 137E","E01033627",505,203,56,147,233,5,94,32,50,12,56,42,13,1,68,39,29,10,10,69,17,52
"2021","Birmingham 137F","E01034950",703,342,4,338,263,1,64,42,22,0,182,176,6,0,6,4,2,10,10,98,0,98
"2021","Birmingham 137G","E01034951",601,243,20,223,284,5,80,47,30,3,136,125,11,0,44,20,24,19,19,74,6,68
"2021","Birmingham 138A","E01033620",739,467,29,438,215,2,61,39,16,6,110,108,1,1,17,9,8,25,25,57,3,54
"2021","Birmingham 138B","E01033622",1163,589,28,561,419,3,123,84,37,2,211,201,9,1,37,29,8,45,45,155,1,154
"2021","Birmingham 138C","E01033623",1067,716,13,703,288,1,71,56,12,3,193,188,4,1,14,10,4,9,9,63,1,62
"2021","Birmingham 138D","E01033625",1100,615,21,594,410,6,157,104,49,4,185,173,12,0,29,20,9,33,33,75,7,68
"2021","Birmingham 139A","E01009200",607,161,28,133,378,8,173,29,122,22,31,11,17,3,157,112,45,9,9,68,36,32
"2021","Birmingham 139B","E01009327",409,62,21,41,278,8,190,20,135,35,12,3,8,1,61,36,25,7,7,69,50,19
"2021","Birmingham 139C","E01009328",511,60,24,36,298,17,196,7,133,56,4,2,0,2,73,32,41,8,8,153,117,36
"2021","Birmingham 139D","E01009331",580,72,32,40,406,11,287,45,201,41,9,3,6,0,88,44,44,11,11,102,71,31
"2021","Birmingham 139E","E01009332",596,188,53,135,339,9,181,23,135,23,21,9,7,5,115,68,47,13,13,69,45,24
"2021","Birmingham 139F","E01009333",401,56,23,33,281,4,195,19,159,17,14,3,9,2,61,43,18,7,7,64,47,17
"2021","Birmingham 139G","E01009335",484,64,26,38,327,13,228,27,151,50,8,1,7,0,73,37,36,5,5,93,75,18
"2021","Birmingham 139H","E01009344",469,86,30,56,311,3,169,20,125,24,16,4,10,2,112,74,38,11,11,72,55,17
"2021","Birmingham 141A","E01009008",601,193,94,99,362,58,178,60,68,50,63,27,30,6,57,29,28,6,6,46,23,23
"2021","Birmingham 141B","E01009011",791,300,127,173,443,59,202,67,83,52,72,35,30,7,100,55,45,10,10,48,24,24
"2021","Birmingham 141C","E01009012",605,178,78,100,372,38,186,62,86,38,63,33,24,6,80,37,43,5,5,55,29,26
"2021","Birmingham 141G","E01009079",486,110,36,74,330,28,134,33,77,24,43,19,23,1,117,81,36,8,8,46,20,26
"2021","Birmingham 141F","E01009080",404,65,17,48,292,14,105,17,74,14,37,7,24,6,132,92,40,4,4,47,33,14
"2021","Birmingham 141H","E01009081",559,225,66,159,307,12,131,27,84,20,27,12,15,0,129,88,41,8,8,27,14,13
"2021","Birmingham 141I","E01009083",548,175,71,104,329,14,156,23,107,26,36,9,22,5,117,73,44,6,6,44,30,14
"2021","Birmingham 141E","E01009102",646,207,68,139,393,22,166,46,92,28,57,21,31,5,135,89,46,13,13,46,26,20
"2021","Birmingham 141D","E01009104",623,179,50,129,396,11,168,39,103,26,61,23,30,8,148,102,46,8,8,48,26,22
"2021","Birmingham 142A","E01009339",467,105,53,52,292,16,179,19,130,30,12,2,10,0,79,50,29,6,6,70,42,28
"2021","Birmingham 142D","E01009382",469,71,29,42,267,13,185,15,135,35,13,3,7,3,45,23,22,11,11,131,86,45
"2021","Birmingham 142E","E01009392",420,66,26,40,244,27,149,14,98,37,10,3,6,1,54,32,22,4,4,110,77,33
"2021","Birmingham 142B","E01034952",407,82,17,65,282,7,153,25,110,18,30,9,20,1,82,53,29,10,10,43,23,20
"2021","Birmingham 142C","E01034953",411,54,22,32,277,15,173,18,130,25,8,2,6,0,75,42,33,6,6,80,51,29
"2021","Birmingham 143C","E01009391",514,89,18,71,347,13,220,25,176,19,19,9,9,1,91,66,25,4,4,78,54,24
"2021","Birmingham 143D","E01009393",480,86,20,66,316,11,206,25,163,18,15,3,10,2,79,46,33,5,5,78,47,31
"2021","Birmingham 143A","E01034954",515,115,29,86,335,11,196,27,149,20,41,14,22,5,77,52,25,10,10,65,35,30
"2021","Birmingham 143B","E01034955",571,92,21,71,390,11,240,26,176,38,18,7,7,4,113,75,38,8,8,89,62,27
"2021","Coventry 001A","E01009589",647,171,69,102,425,35,202,59,106,37,98,41,51,6,83,52,31,7,7,51,29,22
"2021","Coventry 001F","E01032536",952,374,95,279,516,38,252,77,122,53,119,53,57,9,99,67,32,8,8,62,35,27
"2021","Coventry 001G","E01032537",821,282,139,143,485,71,207,67,93,47,89,25,61,3,105,61,44,13,13,54,25,29
"2021","Coventry 001H","E01032538",974,348,98,250,534,46,192,70,84,38,132,81,47,4,151,103,48,13,13,92,38,54
"2021","Coventry 002A","E01009590",593,135,66,69,417,57,204,58,93,53,68,34,26,8,79,44,35,9,9,41,16,25
"2021","Coventry 002B","E01009591",595,136,54,82,406,26,175,45,95,35,76,41,31,4,126,67,59,3,3,53,31,22
"2021","Coventry 002C","E01009593",622,151,88,63,427,56,216,52,113,51,69,19,40,10,78,42,36,8,8,44,31,13
"2021","Coventry 002D","E01009598",769,169,96,73,527,68,295,65,152,78,76,25,48,3,86,48,38,2,2,73,41,32
"2021","Coventry 004A","E01009604",559,156,69,87,358,40,179,40,97,42,52,26,24,2,81,47,34,6,6,45,20,25
"2021","Coventry 004B","E01009605",707,198,83,115,456,30,160,42,83,35,83,39,41,3,175,125,50,8,8,53,22,31
"2021","Coventry 004C","E01009607",769,337,73,264,389,16,118,46,45,27,65,29,33,3,183,131,52,7,7,43,18,25
"2021","Coventry 004D","E01009608",623,178,88,90,392,34,169,46,87,36,70,26,34,10,111,73,38,8,8,53,28,25
"2021","Coventry 004E","E01009610",607,187,60,127,367,32,166,44,84,38,53,17,28,8,116,68,48,0,0,53,34,19
"2021","Coventry 005A","E01009564",687,174,49,125,413,12,214,31,144,39,66,29,33,4,109,64,45,12,12,100,59,41
"2021","Coventry 005B","E01009575",452,108,28,80,273,9,141,24,84,33,39,20,15,4,81,49,32,3,3,71,36,35
"2021","Coventry 005C","E01009606",772,164,64,100,531,37,277,67,157,53,115,50,56,9,91,52,39,11,11,77,49,28
"2021","Coventry 005D","E01009609",584,148,61,87,372,28,173,46,92,35,51,17,29,5,115,71,44,5,5,64,32,32
"2021","Coventry 006A","E01009524",748,349,207,142,376,56,185,70,68,47,66,36,28,2,66,34,32,3,3,23,14,9
"2021","Coventry 006B","E01009525",576,133,76,57,400,53,199,54,72,73,69,31,32,6,78,38,40,1,1,43,24,19
"2021","Coventry 006C","E01009527",656,167,53,114,457,49,196,58,105,33,113,63,44,6,95,60,35,4,4,32,15,17
"2021","Coventry 006D","E01009594",554,107,63,44,406,67,211,63,94,54,64,29,29,6,62,35,27,2,2,41,17,24
"2021","Coventry 007A","E01009577",678,208,66,142,421,9,158,38,100,20,110,33,72,5,138,105,33,6,6,49,26,23
"2021","Coventry 007B","E01009579",870,257,89,168,552,19,220,62,125,33,86,39,41,6,214,168,46,13,13,61,45,16
"2021","Coventry 007C","E01009581",695,230,109,121,417,24,181,44,100,37,73,21,41,11,127,76,51,12,12,48,25,23
"2021","Coventry 007D","E01009584",865,205,79,126,587,58,216,85,92,39,159,65,78,16,148,116,32,6,6,73,36,37
"2021","Coventry 007E","E01009585",605,105,14,91,427,3,203,32,154,17,78,32,44,2,136,105,31,7,7,73,48,25
"2021","Coventry 007F","E01009709",420,94,41,53,289,15,94,15,67,12,29,8,19,2,150,120,30,1,1,37,26,11
"2021","Coventry 008A","E01009576",717,255,110,145,423,41,205,74,87,44,68,36,28,4,102,65,37,7,7,39,13,26
"2021","Coventry 008B","E01009578",572,147,73,74,391,80,215,85,82,48,51,28,20,3,45,25,20,0,0,34,19,15
"2021","Coventry 008C","E01009582",721,234,90,144,437,52,223,80,98,45,79,43,29,7,80,54,26,3,3,50,24,26
"2021","Coventry 008D","E01009583",654,205,88,117,405,59,212,55,112,45,40,16,19,5,87,53,34,7,7,44,16,28
"2021","Coventry 008E","E01009586",723,186,99,87,490,64,227,73,89,65,86,27,52,7,107,72,35,6,6,47,24,23
"2021","Coventry 009A","E01009565",458,72,33,39,281,15,183,24,122,37,14,4,10,0,61,39,22,8,8,105,76,29
"2021","Coventry 009B","E01009566",657,169,23,146,398,6,189,31,139,19,62,34,26,2,126,93,33,15,15,90,42,48
"2021","Coventry 009C","E01009567",588,185,51,134,325,12,184,24,125,35,24,8,15,1,97,71,26,8,8,78,42,36
"2021","Coventry 009D","E01009568",540,101,34,67,334,18,203,28,131,44,38,11,25,2,70,41,29,5,5,105,52,53
"2021","Coventry 010A","E01009523",628,136,96,40,446,120,249,83,109,57,49,22,22,5,27,5,22,1,1,46,24,22
"2021","Coventry 010B","E01009526",602,143,86,57,422,74,219,71,102,46,76,33,38,5,53,28,25,0,0,37,20,17
"2021","Coventry 010C","E01009528",860,193,121,72,635,125,329,83,181,65,92,47,39,6,84,43,41,5,5,32,16,16
"2021","Coventry 010D","E01009531",775,319,160,159,430,102,175,53,87,35,77,39,34,4,75,47,28,1,1,26,11,15
"2021","Coventry 011A","E01009587",782,168,48,120,538,32,270,57,171,42,76,32,39,5,150,102,48,10,10,76,38,38
"2021","Coventry 011B","E01009624",600,181,58,123,370,27,180,43,99,38,59,22,35,2,93,51,42,11,11,49,20,29
"2021","Coventry 011C","E01009625",874,223,81,142,570,50,294,61,159,74,84,38,38,8,133,84,49,9,9,81,50,31
"2021","Coventry 011D","E01009626",633,162,52,110,428,40,203,46,105,52,77,32,41,4,101,63,38,7,7,43,23,20
"2021","Coventry 012A","E01009622",662,173,68,105,427,26,166,38,89,39,76,31,31,14,156,90,66,3,3,62,32,30
"2021","Coventry 012B","E01009623",668,249,67,182,374,36,168,48,83,37,81,35,39,7,83,46,37,6,6,45,32,13
"2021","Coventry 012C","E01009627",727,246,107,139,391,33,183,46,102,35,62,29,28,5,104,62,42,9,9,90,56,34
"2021","Coventry 012D","E01009628",635,191,94,97,393,44,184,54,94,36,68,36,27,5,90,48,42,7,7,51,26,25
"2021","Coventry 013A","E01009599",561,259,119,140,271,83,86,39,36,11,43,23,16,4,53,33,20,6,6,31,15,16
"2021","Coventry 013B","E01009663",622,200,136,64,386,78,181,48,82,51,47,28,16,3,76,30,46,4,4,36,15,21
"2021","Coventry 013C","E01009710",601,221,84,137,350,44,161,55,76,30,69,35,31,3,74,36,38,2,2,30,10,20
"2021","Coventry 013D","E01009711",752,197,96,101,505,56,234,64,129,41,116,58,50,8,94,55,39,5,5,50,26,24
"2021","Coventry 014A","E01009522",740,213,111,102,481,61,237,79,119,39,91,45,40,6,87,47,40,5,5,46,28,18
"2021","Coventry 014B","E01009529",627,173,80,93,426,63,204,64,101,39,76,32,30,14,75,40,35,8,8,28,14,14
"2021","Coventry 014C","E01009530",554,136,71,65,390,49,212,67,102,43,58,19,33,6,70,44,26,1,1,28,9,19
"2021","Coventry 014D","E01009645",563,125,53,72,401,44,199,56,85,58,80,31,45,4,77,45,32,1,1,37,20,17
"2021","Coventry 015A","E01009569",495,124,32,92,296,14,126,21,79,26,40,14,23,3,105,79,26,11,11,75,29,46
"2021","Coventry 015B","E01009570",683,156,43,113,426,18,236,26,168,42,68,17,48,3,95,62,33,9,9,101,60,41
"2021","Coventry 015C","E01009571",643,291,68,223,305,12,156,40,102,14,40,13,26,1,88,54,34,9,9,47,23,24
"2021","Coventry 015E","E01009573",497,141,39,102,272,9,160,21,113,26,27,9,17,1,70,45,25,6,6,84,54,30
"2021","Coventry 015F","E01009574",563,162,54,108,346,18,175,34,111,30,39,17,21,1,98,75,23,16,16,55,32,23
"2021","Coventry 015G","E01034735",612,175,15,160,382,1,231,45,171,15,79,55,22,2,60,41,19,11,11,55,23,32
"2021","Coventry 015H","E01034736",567,145,30,115,357,5,162,21,124,17,62,28,30,4,119,83,36,9,9,65,40,25
"2021","Coventry 016A","E01009655",847,262,70,192,534,28,234,52,145,37,84,40,39,5,169,117,52,19,19,51,19,32
"2021","Coventry 016B","E01009656",699,228,97,131,413,37,160,44,82,34,101,71,25,5,108,65,43,7,7,58,23,35
"2021","Coventry 016C","E01009659",784,278,61,217,398,16,142,40,81,21,81,48,31,2,136,91,45,23,23,108,66,42
"2021","Coventry 016D","E01009662",567,195,52,143,313,32,173,49,73,51,32,16,14,2,72,40,32,4,4,59,34,25
"2021","Coventry 016E","E01009664",591,145,47,98,390,40,195,57,95,43,63,18,36,9,88,56,32,4,4,56,32,24
"2021","Coventry 017A","E01009643",592,158,65,93,412,63,202,60,98,44,69,32,33,4,72,43,29,6,6,22,7,15
"2021","Coventry 017B","E01009644",678,188,92,96,472,56,244,81,114,49,92,53,33,6,76,49,27,4,4,18,6,12
"2021","Coventry 017C","E01009647",826,296,126,170,435,56,217,74,105,38,76,49,23,4,79,47,32,7,7,95,24,71
"2021","Coventry 017D","E01009648",593,127,60,67,436,50,227,71,109,47,80,38,33,9,72,39,33,7,7,30,12,18
"2021","Coventry 017E","E01009652",620,189,108,81,400,67,202,62,93,47,59,27,28,4,71,33,38,1,1,31,11,20
"2021","Coventry 017F","E01009653",634,173,99,74,430,53,234,62,122,50,78,36,33,9,62,44,18,3,3,31,17,14
"2021","Coventry 018A","E01009613",493,116,58,58,343,35,198,52,96,50,47,17,28,2,60,34,26,3,3,34,22,12
"2021","Coventry 018B","E01009657",610,145,66,79,402,38,209,59,95,55,87,44,36,7,67,37,30,1,1,63,33,30
"2021","Coventry 018C","E01009712",595,161,75,86,383,35,196,54,112,30,73,32,36,5,79,45,34,0,0,51,24,27
"2021","Coventry 018D","E01009714",563,126,59,67,409,43,202,48,105,49,68,29,36,3,91,53,38,5,5,28,19,9
"2021","Coventry 018E","E01009716",643,161,81,80,430,37,207,55,111,41,76,33,35,8,104,64,40,6,6,52,26,26
"2021","Coventry 019A","E01009580",608,227,123,104,334,66,174,59,94,21,38,30,8,0,48,27,21,8,8,47,23,24
"2021","Coventry 019B","E01009713",522,108,46,62,372,49,188,46,99,43,61,22,37,2,69,39,30,5,5,42,27,15
"2021","Coventry 019C","E01009715",583,185,68,117,365,52,196,56,99,41,49,21,26,2,66,45,21,2,2,33,18,15
"2021","Coventry 019D","E01009717",574,131,74,57,408,72,219,66,107,46,44,18,22,4,70,41,29,3,3,35,21,14
"2021","Coventry 019E","E01009718",846,389,154,235,410,36,159,45,82,32,69,31,30,8,142,102,40,4,4,47,26,21
"2021","Coventry 020B","E01009630",710,177,55,122,454,19,186,55,100,31,86,45,38,3,153,105,48,10,10,79,35,44
"2021","Coventry 020C","E01009631",599,203,74,129,334,16,112,26,61,25,50,18,27,5,148,80,68,8,8,62,38,24
"2021","Coventry 020D","E01009632",983,535,128,407,341,12,121,56,53,12,82,69,12,1,101,68,33,25,25,107,14,93
"2021","Coventry 020E","E01009650",755,384,51,333,266,14,71,33,27,11,95,83,8,4,73,33,40,13,13,105,13,92
"2021","Coventry 020F","E01034737",598,149,31,118,350,12,185,40,109,36,43,19,21,3,98,55,43,12,12,99,62,37
"2021","Coventry 020G","E01034738",545,162,34,128,256,7,108,21,56,31,52,36,15,1,65,27,38,24,24,127,46,81
"2021","Coventry 021A","E01009614",585,156,76,80,387,52,184,51,93,40,65,25,36,4,79,50,29,7,7,42,16,26
"2021","Coventry 021B","E01009654",710,178,64,114,494,49,264,65,148,51,85,35,38,12,92,56,36,4,4,38,17,21
"2021","Coventry 021C","E01009658",636,158,57,101,427,47,238,58,140,40,67,36,28,3,68,38,30,7,7,51,25,26
"2021","Coventry 021D","E01009660",649,181,59,122,372,37,184,36,101,47,59,40,13,6,80,44,36,12,12,96,44,52
"2021","Coventry 022A","E01009646",604,145,57,88,430,44,235,70,120,45,81,42,37,2,64,39,25,6,6,29,9,20
"2021","Coventry 022B","E01009692",523,171,122,49,332,91,163,51,74,38,46,21,23,2,31,17,14,1,1,20,7,13
"2021","Coventry 022C","E01009693",675,223,117,106,421,69,164,64,68,32,106,54,46,6,78,48,30,4,4,31,11,20
"2021","Coventry 022D","E01009694",615,182,96,86,407,82,211,64,104,43,68,39,27,2,45,23,22,1,1,26,6,20
"2021","Coventry 023A","E01009695",745,262,171,91,458,144,208,73,85,50,60,32,22,6,46,22,24,0,0,25,15,10
"2021","Coventry 023B","E01009696",650,198,107,91,427,109,181,68,79,34,81,45,28,8,56,33,23,0,0,25,9,16
"2021","Coventry 023C","E01009704",599,147,76,71,425,99,216,80,87,49,63,28,27,8,46,18,28,1,1,27,13,14
"2021","Coventry 023D","E01009705",570,143,92,51,411,103,232,82,105,45,50,25,23,2,24,15,9,2,2,16,8,8
"2021","Coventry 024A","E01009636",962,287,37,250,490,10,210,45,142,23,107,74,31,2,133,105,28,30,30,185,37,148
"2021","Coventry 024B","E01009637",521,122,49,73,320,5,188,27,127,34,29,5,23,1,88,55,33,10,10,79,59,20
"2021","Coventry 024C","E01009638",756,370,49,321,326,8,112,27,71,14,55,13,42,0,133,104,29,18,18,60,27,33
"2021","Coventry 024D","E01009639",554,121,41,80,327,23,185,26,121,38,41,6,31,4,63,39,24,15,15,106,56,50
"2021","Coventry 024E","E01009640",736,179,42,137,464,6,203,38,145,20,82,29,45,8,162,128,34,11,11,93,35,58
"2021","Coventry 024F","E01009641",823,334,68,266,294,6,110,31,66,13,63,43,19,1,91,67,24,24,24,195,29,166
"2021","Coventry 025A","E01009697",864,224,108,116,603,99,298,94,160,44,106,63,37,6,92,64,28,8,8,37,10,27
"2021","Coventry 025B","E01009698",633,169,97,72,441,101,215,74,95,46,68,35,28,5,56,25,31,1,1,23,8,15
"2021","Coventry 025D","E01009706",645,193,100,93,424,94,196,63,93,40,74,37,33,4,60,41,19,0,0,28,13,15
"2021","Coventry 025E","E01034739",710,234,15,219,446,11,195,57,125,13,134,88,41,5,100,81,19,6,6,30,8,22
"2021","Coventry 025F","E01034740",736,253,91,162,443,44,221,70,105,46,73,34,32,7,105,63,42,0,0,40,17,23
"2021","Coventry 026A","E01009649",574,149,68,81,387,50,189,49,111,29,67,33,34,0,75,34,41,6,6,38,15,23
"2021","Coventry 026B","E01009684",680,282,77,205,356,35,144,50,62,32,72,38,28,6,101,59,42,4,4,42,20,22
"2021","Coventry 026C","E01009685",715,216,93,123,466,55,224,78,96,50,96,59,30,7,82,47,35,9,9,33,15,18
"2021","Coventry 026D","E01009686",676,180,82,98,439,51,225,75,96,54,95,47,41,7,60,32,28,8,8,57,22,35
"2021","Coventry 026E","E01009687",603,182,74,108,379,54,177,66,84,27,79,33,39,7,64,41,23,5,5,42,11,31
"2021","Coventry 027A","E01009615",656,206,43,163,320,33,168,50,86,32,50,29,19,2,56,35,21,13,13,130,34,96
"2021","Coventry 027B","E01009616",604,153,47,106,388,38,210,71,93,46,58,32,19,7,72,37,35,10,10,63,21,42
"2021","Coventry 027C","E01009617",466,117,45,72,290,48,140,39,67,34,45,22,20,3,53,28,25,4,4,59,37,22
"2021","Coventry 027D","E01009618",656,141,55,86,468,46,224,66,105,53,102,41,44,17,91,56,35,5,5,47,19,28
"2021","Coventry 027E","E01009620",1019,225,82,143,706,46,392,119,217,56,139,63,70,6,118,80,38,11,11,88,43,45
"2021","Coventry 027F","E01009621",548,154,62,92,304,27,130,35,66,29,57,26,28,3,82,54,28,8,8,90,57,33
"2021","Coventry 028A","E01009633",736,204,49,155,272,5,87,32,45,10,59,35,20,4,106,62,44,15,15,260,32,228
"2021","Coventry 028B","E01009634",689,162,40,122,295,22,112,24,67,21,38,19,14,5,51,37,14,72,72,232,19,213
"2021","Coventry 028D","E01009661",797,230,44,186,364,11,107,27,59,21,77,34,40,3,117,84,33,52,52,203,27,176
"2021","Coventry 028E","E01034741",424,165,10,155,122,2,39,16,17,6,32,23,8,1,30,20,10,19,19,137,6,131
"2021","Coventry 028F","E01034742",445,122,25,97,129,7,35,9,14,12,20,12,8,0,43,25,18,24,24,194,12,182
"2021","Coventry 029A","E01009674",747,273,69,204,407,25,157,47,83,27,99,55,39,5,116,75,41,10,10,67,31,36
"2021","Coventry 029B","E01009699",625,196,93,103,399,86,172,57,81,34,71,28,38,5,65,33,32,5,5,30,11,19
"2021","Coventry 029C","E01009700",833,432,92,340,351,21,147,51,72,24,71,39,22,10,106,75,31,6,6,50,28,22
"2021","Coventry 029D","E01009701",717,279,95,184,404,47,173,74,56,43,82,39,36,7,97,70,27,5,5,34,16,18
"2021","Coventry 029E","E01009702",736,301,90,211,398,30,138,42,73,23,74,31,42,1,149,108,41,7,7,37,18,19
"2021","Coventry 030A","E01009688",630,221,48,173,303,23,111,34,61,16,96,64,29,3,62,37,25,11,11,106,24,82
"2021","Coventry 030B","E01009689",912,465,218,247,342,71,94,40,44,10,101,80,19,2,71,39,32,5,5,105,7,98
"2021","Coventry 030C","E01009690",635,213,56,157,271,21,95,42,40,13,88,57,29,2,57,38,19,10,10,151,5,146
"2021","Coventry 030D","E01009691",599,214,44,170,276,16,74,40,29,5,91,70,20,1,79,57,22,16,16,109,6,103
"2021","Coventry 031A","E01009548",928,355,97,258,450,39,210,71,103,36,109,86,23,0,75,42,33,17,17,123,19,104
"2021","Coventry 031B","E01009553",870,483,48,435,268,14,87,38,42,7,84,70,13,1,58,46,12,25,25,119,12,107
"2021","Coventry 031D","E01009651",729,398,79,319,274,7,76,22,42,12,62,36,19,7,121,77,44,8,8,57,15,42
"2021","Coventry 031E","E01034743",423,333,96,237,65,10,18,11,7,0,15,14,1,0,9,7,2,13,13,25,1,24
"2021","Coventry 031F","E01034744",479,261,34,227,146,7,42,28,11,3,35,31,4,0,29,21,8,33,33,72,10,62
"2021","Coventry 032A","E01009676",676,190,54,136,438,44,201,60,100,41,89,47,38,4,98,65,33,6,6,48,12,36
"2021","Coventry 032B","E01009681",549,160,74,86,351,48,184,60,85,39,70,35,31,4,45,24,21,4,4,38,13,25
"2021","Coventry 032C","E01009682",600,165,92,73,397,57,198,73,79,46,75,32,35,8,64,33,31,3,3,38,15,23
"2021","Coventry 032D","E01009683",709,168,53,115,435,28,175,44,107,24,100,56,42,2,124,88,36,8,8,106,18,88
"2021","Coventry 033A","E01009532",574,175,95,80,373,57,173,62,77,34,82,36,40,6,60,36,24,1,1,26,12,14
"2021","Coventry 033B","E01009535",569,137,98,39,406,117,191,60,90,41,40,11,24,5,53,25,28,5,5,26,11,15
"2021","Coventry 033C","E01009536",605,160,94,66,407,94,202,63,96,43,54,22,25,7,55,22,33,2,2,38,19,19
"2021","Coventry 033D","E01009543",617,92,25,67,487,47,352,109,162,81,46,21,21,4,38,18,20,4,4,38,21,17
"2021","Coventry 033E","E01009707",730,182,77,105,505,73,243,73,125,45,93,47,40,6,92,54,38,4,4,43,25,18
"2021","Coventry 033F","E01009708",606,183,96,87,388,76,177,62,69,46,65,37,21,7,64,32,32,6,6,35,15,20
"2021","Coventry 034A","E01009554",580,190,85,105,324,35,147,47,73,27,78,40,33,5,57,33,24,7,7,66,7,59
"2021","Coventry 034B","E01009555",588,137,82,55,389,86,212,74,98,40,48,26,18,4,42,26,16,1,1,62,17,45
"2021","Coventry 034C","E01009556",706,290,123,167,352,43,186,60,95,31,71,46,23,2,48,28,20,4,4,64,8,56
"2021","Coventry 034D","E01009557",538,106,76,30,395,106,242,88,106,48,25,9,11,5,21,10,11,1,1,37,13,24
"2021","Coventry 034E","E01009558",631,199,64,135,365,47,198,74,91,33,68,49,15,4,45,23,22,7,7,67,7,60
"2021","Coventry 034F","E01009559",579,203,143,60,339,92,191,61,84,46,35,30,5,0,20,10,10,1,1,37,13,24
"2021","Coventry 035C","E01009537",626,222,110,112,357,46,138,40,63,35,72,28,29,15,98,57,41,3,3,47,23,24
"2021","Coventry 035D","E01009538",625,190,78,112,382,37,177,70,78,29,70,29,29,12,94,56,38,4,4,53,27,26
"2021","Coventry 035F","E01009612",550,147,54,93,362,14,149,39,87,23,58,20,28,10,134,97,37,7,7,41,24,17
"2021","Coventry 035G","E01032527",667,195,79,116,429,49,194,73,74,47,73,28,36,9,110,68,42,3,3,43,26,17
"2021","Coventry 035H","E01032528",694,232,107,125,433,65,187,70,92,25,54,22,29,3,119,81,38,8,8,29,16,13
"2021","Coventry 035I","E01034745",461,71,11,60,339,2,170,36,111,23,70,39,28,3,94,67,27,3,3,51,23,28
"2021","Coventry 035J","E01034746",555,113,39,74,386,8,151,23,115,13,44,8,29,7,173,134,39,10,10,56,37,19
"2021","Coventry 036C","E01009679",802,258,105,153,310,18,148,46,79,23,45,25,14,6,89,58,31,10,10,234,26,208
"2021","Coventry 036F","E01032532",663,214,82,132,405,70,194,85,67,42,81,52,21,8,56,24,32,4,4,44,20,24
"2021","Coventry 036G","E01032533",617,92,37,55,433,78,292,90,118,84,25,10,12,3,36,18,18,2,2,92,39,53
"2021","Coventry 036H","E01034747",695,199,56,143,415,27,133,38,70,25,75,23,45,7,174,137,37,6,6,81,25,56
"2021","Coventry 036I","E01034748",537,192,87,105,272,11,82,18,47,17,50,17,28,5,123,103,20,6,6,73,20,53
"2021","Coventry 037B","E01009549",654,175,91,84,435,88,267,79,136,52,40,24,12,4,37,15,22,3,3,44,19,25
"2021","Coventry 037C","E01009550",725,197,81,116,459,54,229,80,110,39,88,54,31,3,77,45,32,11,11,69,25,44
"2021","Coventry 037E","E01009552",683,257,138,119,388,56,212,39,128,45,30,20,10,0,88,49,39,2,2,38,16,22
"2021","Coventry 037F","E01032534",719,238,102,136,415,44,216,43,118,55,48,21,25,2,100,49,51,7,7,66,27,39
"2021","Coventry 037G","E01032535",471,92,47,45,332,44,184,68,84,32,50,26,22,2,52,24,28,2,2,47,21,26
"2021","Coventry 038A","E01009544",739,310,127,183,374,52,196,70,93,33,61,35,23,3,58,28,30,7,7,55,14,41
"2021","Coventry 038E","E01032529",655,285,111,174,331,41,138,56,69,13,73,41,23,9,72,49,23,7,7,39,12,27
"2021","Coventry 038F","E01032530",789,239,111,128,495,57,251,94,118,39,107,56,44,7,73,37,36,7,7,55,21,34
"2021","Coventry 038G","E01034749",764,250,56,194,386,16,160,35,109,16,84,54,28,2,89,59,30,37,37,128,18,110
"2021","Coventry 038H","E01034750",1059,245,10,235,649,4,391,90,280,21,132,101,28,3,87,60,27,35,35,165,50,115
"2021","Coventry 039A","E01009539",939,392,64,328,482,18,174,44,96,34,104,51,46,7,176,136,40,10,10,65,34,31
"2021","Coventry 039B","E01009540",759,232,74,158,484,22,177,30,118,29,92,28,56,8,187,148,39,6,6,43,24,19
"2021","Coventry 039C","E01009541",817,351,96,255,428,55,154,56,61,37,77,37,30,10,132,91,41,10,10,38,15,23
"2021","Coventry 039D","E01009542",814,313,125,188,454,27,187,48,110,29,69,28,35,6,163,111,52,8,8,47,20,27
"2021","Coventry 040A","E01009560",535,92,59,33,397,91,247,63,123,61,28,14,10,4,30,7,23,1,1,46,24,22
"2021","Coventry 040B","E01009561",755,289,124,165,431,73,198,60,101,37,60,41,17,2,96,61,35,4,4,35,10,25
"2021","Coventry 040C","E01009562",675,192,116,76,448,95,249,86,107,56,46,24,15,7,52,25,27,6,6,35,12,23
"2021","Coventry 040D","E01009563",619,109,81,28,474,72,327,86,180,61,35,15,18,2,38,14,24,2,2,36,16,20
"2021","Coventry 040E","E01009672",832,193,141,52,588,146,357,91,191,75,34,16,14,4,48,22,26,3,3,51,29,22
"2021","Coventry 041A","E01009666",515,108,73,35,389,65,220,56,115,49,57,15,37,5,45,19,26,2,2,18,10,8
"2021","Coventry 041B","E01009667",569,185,145,40,348,124,179,40,89,50,16,10,6,0,25,7,18,4,4,36,20,16
"2021","Coventry 041C","E01009668",627,134,80,54,452,46,267,74,145,48,59,20,35,4,75,40,35,5,5,41,17,24
"2021","Coventry 041D","E01009670",663,172,86,86,452,68,277,65,157,55,57,32,21,4,48,22,26,2,2,39,19,20
"2021","Coventry 042A","E01009665",474,105,78,27,297,88,165,56,75,34,20,6,10,4,20,10,10,4,4,72,19,53
"2021","Coventry 042B","E01009669",468,93,55,38,344,45,216,52,114,50,29,13,14,2,52,34,18,2,2,31,13,18
"2021","Coventry 042C","E01009671",408,54,29,25,281,57,195,61,80,54,8,3,1,4,18,6,12,3,3,73,39,34
"2021","Coventry 042F","E01033058",840,281,133,148,357,66,168,69,67,32,47,22,18,7,67,32,35,9,9,202,18,184
"2021","Coventry 043A","E01009588",648,237,112,125,365,25,163,42,65,56,76,24,45,7,96,60,36,5,5,46,23,23
"2021","Coventry 043B","E01009592",619,157,60,97,409,17,204,43,131,30,68,28,37,3,116,79,37,4,4,53,26,27
"2021","Coventry 043C","E01009596",752,178,49,129,488,34,231,48,141,42,89,34,48,7,126,91,35,8,8,86,44,42
"2021","Coventry 043D","E01009597",668,168,68,100,418,44,211,46,112,53,63,23,32,8,92,57,35,8,8,82,44,38
"2021","Coventry 043E","E01032587",641,125,51,74,465,29,211,46,120,45,74,24,34,16,145,95,50,6,6,51,28,23
"2021","Dudley 001A","E01009763",878,222,52,170,621,46,213,65,103,45,150,50,89,11,211,162,49,1,1,35,23,12
"2021","Dudley 001B","E01009764",632,143,70,73,464,92,194,69,76,49,75,28,38,9,102,24,78,1,1,25,8,17
"2021","Dudley 001C","E01009767",659,200,87,113,434,53,203,62,90,51,82,36,41,5,93,55,38,3,3,25,17,8
"2021","Dudley 001D","E01009769",823,330,132,198,462,43,150,49,70,31,120,47,65,8,144,110,34,5,5,31,22,9
"2021","Dudley 001E","E01009770",641,208,96,112,416,68,187,59,66,62,76,27,43,6,85,44,41,0,0,17,10,7
"2021","Dudley 002A","E01009773",676,244,139,105,399,57,180,62,72,46,68,26,38,4,91,53,38,3,3,33,16,17
"2021","Dudley 002B","E01009777",658,196,77,119,427,48,180,46,73,61,79,31,42,6,112,63,49,8,8,35,15,20
"2021","Dudley 002C","E01009778",630,152,70,82,448,57,231,79,92,60,90,35,45,10,70,44,26,0,0,30,17,13
"2021","Dudley 002D","E01009895",622,213,118,95,385,74,183,65,74,44,66,26,28,12,61,31,30,1,1,24,14,10
"2021","Dudley 003A","E01009896",595,147,92,55,437,101,224,66,104,54,58,29,23,6,53,30,23,1,1,11,5,6
"2021","Dudley 003B","E01009897",606,158,111,47,428,125,229,67,104,58,47,27,18,2,27,12,15,0,0,20,9,11
"2021","Dudley 003C","E01009898",675,239,132,107,415,128,212,73,81,58,42,19,19,4,31,17,14,2,2,21,8,13
"2021","Dudley 003D","E01009901",633,191,132,59,414,136,199,70,76,53,44,32,10,2,33,9,24,2,2,28,14,14
"2021","Dudley 003E","E01009902",521,115,84,31,386,135,174,56,69,49,38,15,20,3,39,20,19,0,0,20,11,9
"2021","Dudley 004A","E01009765",666,176,89,87,458,90,203,76,78,49,89,41,44,4,70,44,26,6,6,32,18,14
"2021","Dudley 004B","E01009766",687,231,90,141,429,74,188,60,74,54,73,27,37,9,90,53,37,4,4,27,12,15
"2021","Dudley 004C","E01009768",606,219,96,123,357,56,176,54,71,51,67,32,28,7,57,40,17,1,1,30,16,14
"2021","Dudley 004D","E01009771",651,212,137,75,422,93,192,65,78,49,82,54,21,7,52,19,33,3,3,17,7,10
"2021","Dudley 004E","E01009775",620,189,79,110,392,50,194,63,77,54,57,14,37,6,88,51,37,3,3,39,19,20
"2021","Dudley 004F","E01009776",593,114,72,42,455,79,240,76,101,63,81,31,43,7,49,19,30,6,6,24,10,14
"2021","Dudley 005A","E01009758",685,187,96,91,463,49,192,54,88,50,97,21,62,14,120,80,40,5,5,35,24,11
"2021","Dudley 005B","E01009760",523,120,59,61,380,37,176,51,81,44,78,39,36,3,83,46,37,6,6,23,14,9
"2021","Dudley 005C","E01009772",511,115,44,71,377,35,171,68,66,37,72,28,36,8,94,63,31,5,5,19,11,8
"2021","Dudley 005D","E01009774",691,226,93,133,437,86,212,75,82,55,80,43,31,6,59,29,30,0,0,28,17,11
"2021","Dudley 005E","E01009788",713,250,109,141,432,54,172,68,56,48,87,27,47,13,115,72,43,4,4,31,17,14
"2021","Dudley 006B","E01009756",539,122,54,68,372,26,162,41,88,33,75,13,45,17,103,57,46,6,6,45,32,13
"2021","Dudley 006C","E01009757",865,232,79,153,578,47,269,103,112,54,132,68,54,10,127,88,39,3,3,55,33,22
"2021","Dudley 006D","E01009759",518,130,87,43,357,95,189,65,69,55,41,19,16,6,29,13,16,3,3,31,20,11
"2021","Dudley 006F","E01009762",504,106,49,57,361,19,143,25,94,24,66,9,48,9,126,92,34,7,7,37,23,14
"2021","Dudley 006H","E01034306",563,94,45,49,434,14,131,33,78,20,77,17,52,8,205,159,46,7,7,35,24,11
"2021","Dudley 006I","E01034307",640,137,42,95,473,17,183,48,102,33,98,34,60,4,171,129,42,4,4,30,16,14
"2021","Dudley 007A","E01009781",890,295,125,170,561,67,236,75,106,55,100,48,41,11,154,126,28,4,4,34,19,15
"2021","Dudley 007B","E01009786",618,205,67,138,387,28,135,52,54,29,95,31,60,4,125,90,35,4,4,26,11,15
"2021","Dudley 007C","E01009789",684,240,93,147,420,71,234,95,81,58,77,46,27,4,37,14,23,1,1,24,9,15
"2021","Dudley 007D","E01009790",704,218,86,132,457,40,185,58,75,52,86,32,50,4,142,89,53,4,4,29,17,12
"2021","Dudley 008A","E01009779",699,287,155,132,394,76,180,71,65,44,74,40,30,4,64,38,26,0,0,18,7,11
"2021","Dudley 008B","E01009782",751,217,81,136,505,49,223,57,116,50,118,42,66,10,108,60,48,7,7,29,12,17
"2021","Dudley 008C","E01009783",594,171,80,91,400,51,148,52,56,40,107,29,74,4,92,61,31,2,2,23,12,11
"2021","Dudley 008D","E01009785",662,180,129,51,464,102,248,101,87,60,75,37,33,5,38,19,19,1,1,18,8,10
"2021","Dudley 008E","E01009899",620,167,131,36,434,129,203,65,75,63,64,27,34,3,38,16,22,0,0,19,8,11
"2021","Dudley 008F","E01009900",637,198,146,52,425,142,205,58,87,60,53,25,23,5,25,9,16,0,0,14,6,8
"2021","Dudley 009A","E01009780",848,194,33,161,609,40,360,113,156,91,113,49,56,8,90,54,36,6,6,45,20,25
"2021","Dudley 009B","E01009784",629,120,34,86,484,53,272,98,107,67,97,54,34,9,61,33,28,1,1,25,14,11
"2021","Dudley 009C","E01009787",592,114,54,60,460,87,273,91,116,66,54,25,20,9,41,16,25,5,5,18,11,7
"2021","Dudley 009D","E01009880",567,107,45,62,430,40,259,72,114,73,67,40,22,5,63,33,30,1,1,30,20,10
"2021","Dudley 009E","E01009882",564,134,69,65,401,50,207,79,87,41,51,24,22,5,89,62,27,4,4,29,16,13
"2021","Dudley 010A","E01009891",646,142,56,86,449,25,234,59,131,44,63,25,35,3,119,72,47,8,8,55,34,21
"2021","Dudley 010B","E01009892",642,239,61,178,342,19,137,49,56,32,84,34,45,5,92,63,29,10,10,61,34,27
"2021","Dudley 010C","E01009893",655,150,49,101,455,22,209,31,129,49,65,17,44,4,153,110,43,6,6,50,41,9
"2021","Dudley 010D","E01009894",692,211,75,136,448,69,194,64,91,39,78,30,39,9,100,67,33,7,7,33,23,10
"2021","Dudley 011A","E01009844",616,241,40,201,326,22,153,34,88,31,54,19,30,5,88,55,33,9,9,49,31,18
"2021","Dudley 011B","E01009879",952,302,83,219,593,44,280,88,139,53,84,44,37,3,173,91,82,12,12,57,37,20
"2021","Dudley 011D","E01009885",671,233,92,141,387,53,157,49,64,44,79,40,34,5,95,62,33,3,3,51,31,20
"2021","Dudley 011E","E01034308",667,301,100,201,316,10,94,38,44,12,64,38,25,1,142,115,27,6,6,50,27,23
"2021","Dudley 011F","E01034309",709,415,93,322,245,7,67,22,38,7,60,37,21,2,92,63,29,19,19,49,22,27
"2021","Dudley 012A","E01009816",712,175,120,55,520,108,255,89,111,55,99,57,39,3,58,33,25,0,0,17,10,7
"2021","Dudley 012B","E01009817",536,132,96,36,386,108,205,79,83,43,43,18,17,8,27,16,11,3,3,18,7,11
"2021","Dudley 012C","E01009819",687,230,105,125,434,81,221,87,97,37,72,42,26,4,57,39,18,3,3,23,11,12
"2021","Dudley 012D","E01009820",667,224,114,110,418,81,186,58,87,41,81,49,29,3,68,37,31,2,2,25,11,14
"2021","Dudley 013A","E01009748",670,183,82,101,457,40,177,58,79,40,88,32,47,9,145,86,59,7,7,30,18,12
"2021","Dudley 013B","E01009839",627,148,50,98,433,50,211,60,101,50,66,23,37,6,101,56,45,5,5,46,33,13
"2021","Dudley 013C","E01009883",662,216,115,101,418,33,176,54,80,42,103,48,49,6,102,66,36,4,4,28,18,10
"2021","Dudley 013D","E01009884",622,232,82,150,356,39,160,51,73,36,69,35,29,5,84,57,27,4,4,34,18,16
"2021","Dudley 013E","E01009886",1035,520,255,265,487,80,183,73,80,30,90,49,35,6,126,85,41,8,8,28,16,12
"2021","Dudley 014A","E01009814",516,121,85,36,383,97,201,66,91,44,50,21,26,3,34,10,24,1,1,12,3,9
"2021","Dudley 014B","E01009815",494,89,64,25,393,88,238,69,104,65,39,11,23,5,28,17,11,0,0,12,4,8
"2021","Dudley 014C","E01009818",549,182,92,90,344,43,164,56,58,50,63,32,28,3,73,56,17,1,1,23,10,13
"2021","Dudley 014D","E01009821",606,171,120,51,426,134,209,78,89,42,44,23,18,3,39,21,18,0,0,9,4,5
"2021","Dudley 014E","E01009822",652,212,137,75,415,114,207,71,91,45,53,29,21,3,41,24,17,0,0,25,9,16
"2021","Dudley 015A","E01009887",639,170,67,103,399,51,191,52,94,45,63,23,38,2,86,54,32,8,8,70,51,19
"2021","Dudley 015B","E01009888",669,172,66,106,449,63,220,63,112,45,80,31,42,7,86,55,31,0,0,48,29,19
"2021","Dudley 015C","E01009889",1183,456,54,402,600,24,243,71,138,34,138,77,55,6,180,132,48,15,15,127,62,65
"2021","Dudley 015D","E01009890",669,170,66,104,452,25,211,63,104,44,89,33,51,5,119,89,30,8,8,47,31,16
"2021","Dudley 016A","E01009749",961,221,92,129,704,77,359,119,162,78,176,98,72,6,89,61,28,3,3,36,24,12
"2021","Dudley 016B","E01009750",595,150,77,73,415,69,182,68,68,46,78,28,40,10,83,50,33,3,3,30,16,14
"2021","Dudley 016C","E01009823",532,109,71,38,397,87,235,90,83,62,47,23,20,4,27,9,18,1,1,26,13,13
"2021","Dudley 016D","E01009824",856,314,137,177,516,55,209,64,97,48,131,58,64,9,118,87,31,3,3,26,8,18
"2021","Dudley 017A","E01009751",687,253,94,159,413,54,158,57,61,40,100,44,51,5,94,48,46,7,7,21,13,8
"2021","Dudley 017B","E01009752",646,167,78,89,453,41,164,58,73,33,91,26,55,10,154,116,38,3,3,26,12,14
"2021","Dudley 017C","E01009753",619,157,62,95,434,35,147,41,63,43,107,34,62,11,142,92,50,3,3,28,15,13
"2021","Dudley 017D","E01009754",693,168,77,91,489,47,188,70,61,57,91,34,48,9,146,104,42,17,17,36,25,11
"2021","Dudley 017E","E01009841",679,269,80,189,373,39,166,54,79,33,52,22,26,4,102,67,35,14,14,37,21,16
"2021","Dudley 018A","E01009840",542,171,61,110,316,19,161,35,94,32,58,31,24,3,75,48,27,3,3,55,37,18
"2021","Dudley 018B","E01009842",678,268,109,159,373,41,148,45,71,32,73,29,39,5,105,72,33,6,6,37,26,11
"2021","Dudley 018C","E01009843",652,194,91,103,433,83,187,73,69,45,83,43,31,9,75,42,33,5,5,25,16,9
"2021","Dudley 018D","E01009871",914,328,115,213,553,66,228,87,86,55,134,71,53,10,121,71,50,4,4,33,17,16
"2021","Dudley 018E","E01009875",633,201,81,120,411,57,178,56,67,55,96,40,53,3,78,50,28,2,2,21,13,8
"2021","Dudley 019A","E01009825",615,176,86,90,420,70,197,60,80,57,78,39,34,5,73,43,30,2,2,19,7,12
"2021","Dudley 019B","E01009826",633,171,128,43,445,146,226,72,101,53,47,25,18,4,24,13,11,2,2,17,8,9
"2021","Dudley 019C","E01009827",628,115,75,40,499,114,282,63,143,76,59,25,26,8,43,23,20,1,1,14,7,7
"2021","Dudley 019D","E01009828",571,158,117,41,396,95,181,73,63,45,61,22,29,10,56,29,27,3,3,17,5,12
"2021","Dudley 019E","E01009829",626,168,129,39,434,82,232,80,96,56,63,19,37,7,56,34,22,1,1,24,17,7
"2021","Dudley 019F","E01009830",630,123,84,39,493,115,274,83,118,73,57,24,32,1,46,15,31,1,1,14,11,3
"2021","Dudley 020A","E01009872",508,128,40,88,357,22,149,42,72,35,72,31,35,6,111,85,26,3,3,23,12,11
"2021","Dudley 020B","E01009873",653,173,76,97,447,89,210,78,82,50,73,38,25,10,69,34,35,6,6,33,19,14
"2021","Dudley 020C","E01009874",578,124,62,62,420,39,203,65,84,54,90,33,50,7,87,57,30,1,1,34,21,13
"2021","Dudley 020D","E01009876",682,186,117,69,465,77,196,61,80,55,84,38,42,4,105,68,37,3,3,31,18,13
"2021","Dudley 020E","E01009877",672,187,70,117,448,27,157,46,70,41,90,37,46,7,169,118,51,5,5,37,19,18
"2021","Dudley 021A","E01009911",602,215,122,93,364,111,162,67,54,41,56,33,19,4,31,17,14,4,4,23,11,12
"2021","Dudley 021B","E01009912",889,273,109,164,583,99,292,95,153,44,115,66,44,5,76,48,28,1,1,33,12,21
"2021","Dudley 021C","E01009913",652,177,117,60,453,85,198,82,68,48,90,38,44,8,75,55,20,5,5,22,13,9
"2021","Dudley 021D","E01009914",590,148,117,31,425,139,195,70,86,39,61,31,27,3,30,14,16,0,0,17,5,12
"2021","Dudley 021E","E01009915",734,238,92,146,471,79,230,85,101,44,111,65,40,6,51,28,23,0,0,25,7,18
"2021","Dudley 021F","E01009916",755,253,96,157,478,63,221,89,86,46,98,53,41,4,93,59,34,3,3,24,14,10
"2021","Dudley 022A","E01009741",1085,557,105,452,494,33,166,68,70,28,133,76,52,5,148,108,40,14,14,34,11,23
"2021","Dudley 022B","E01009744",1076,497,111,386,533,49,193,72,88,33,154,103,45,6,129,93,36,8,8,46,22,24
"2021","Dudley 022C","E01009746",884,406,140,266,431,39,159,58,75,26,90,47,41,2,133,94,39,10,10,47,29,18
"2021","Dudley 022D","E01009747",687,243,67,176,420,36,157,67,62,28,115,62,47,6,109,77,32,3,3,24,14,10
"2021","Dudley 023A","E01009731",735,248,60,188,467,42,221,97,88,36,111,69,35,7,88,57,31,5,5,20,9,11
"2021","Dudley 023B","E01009740",864,223,57,166,611,33,229,66,122,41,181,71,96,14,165,120,45,3,3,30,19,11
"2021","Dudley 023C","E01009742",669,198,93,105,453,42,168,54,80,34,91,37,44,10,150,99,51,2,2,18,10,8
"2021","Dudley 023D","E01009743",709,181,90,91,494,43,195,61,96,38,123,40,74,9,129,86,43,4,4,34,16,18
"2021","Dudley 023E","E01009745",745,220,99,121,504,84,239,95,91,53,115,61,48,6,65,36,29,1,1,21,11,10
"2021","Dudley 024A","E01009917",497,96,57,39,388,97,184,61,78,45,63,32,27,4,44,20,24,0,0,13,2,11
"2021","Dudley 024B","E01009918",604,170,105,65,413,55,143,45,59,39,97,41,49,7,118,58,60,0,0,21,13,8
"2021","Dudley 024C","E01009919",501,130,86,44,357,104,161,58,61,42,51,19,26,6,39,10,29,2,2,14,7,7
"2021","Dudley 024D","E01009920",730,208,72,136,507,75,227,89,95,43,126,78,42,6,74,38,36,5,5,15,10,5
"2021","Dudley 025A","E01009864",600,133,55,78,430,69,192,64,91,37,84,39,42,3,80,48,32,5,5,37,24,13
"2021","Dudley 025B","E01009865",673,196,100,96,450,53,175,60,87,28,105,40,55,10,113,82,31,4,4,27,9,18
"2021","Dudley 025C","E01009866",773,285,102,183,455,62,205,84,87,34,112,60,43,9,72,42,30,4,4,33,11,22
"2021","Dudley 025D","E01009867",710,192,84,108,479,84,246,103,95,48,80,28,47,5,68,33,35,1,1,39,20,19
"2021","Dudley 025E","E01009878",898,219,80,139,639,83,325,118,134,73,140,55,76,9,86,46,40,5,5,40,21,19
"2021","Dudley 026A","E01009791",662,219,98,121,412,59,196,59,86,51,80,35,39,6,72,47,25,5,5,31,18,13
"2021","Dudley 026B","E01009792",626,206,87,119,365,42,169,46,92,31,70,33,31,6,80,45,35,4,4,55,35,20
"2021","Dudley 026C","E01009795",744,274,88,186,435,39,197,66,102,29,82,44,34,4,110,77,33,7,7,35,17,18
"2021","Dudley 026D","E01009796",634,159,81,78,432,54,220,64,96,60,71,29,30,12,84,57,27,3,3,43,27,16
"2021","Dudley 026E","E01009798",1003,267,97,170,681,64,312,131,131,50,157,87,63,7,140,100,40,8,8,55,28,27
"2021","Dudley 027A","E01009719",566,136,62,74,400,72,196,67,88,41,73,34,33,6,55,31,24,4,4,30,23,7
"2021","Dudley 027B","E01009722",611,194,100,94,403,99,183,90,59,34,62,25,28,9,58,28,30,1,1,14,6,8
"2021","Dudley 027C","E01009727",555,149,114,35,388,60,234,97,87,50,56,24,26,6,38,18,20,0,0,18,12,6
"2021","Dudley 027D","E01009728",492,107,69,38,364,76,191,66,75,50,54,21,30,3,42,17,25,1,1,21,13,8
"2021","Dudley 027E","E01009729",638,159,81,78,452,82,193,73,62,58,77,26,41,10,97,70,27,3,3,27,17,10
"2021","Dudley 028A","E01009720",532,96,52,44,420,88,252,93,100,59,54,32,20,2,24,15,9,2,2,16,6,10
"2021","Dudley 028B","E01009723",461,83,40,43,353,69,212,86,79,47,46,15,29,2,26,13,13,0,0,25,14,11
"2021","Dudley 028C","E01009724",619,161,74,87,450,87,259,94,105,60,74,40,26,8,29,8,21,1,1,8,2,6
"2021","Dudley 028D","E01009730",635,186,37,149,430,46,255,102,83,70,79,49,29,1,50,28,22,0,0,19,11,8
"2021","Dudley 029A","E01009903",623,163,102,61,436,129,223,76,96,51,57,35,21,1,27,13,14,0,0,24,11,13
"2021","Dudley 029B","E01009904",615,188,116,72,405,92,201,85,77,39,64,38,20,6,44,22,22,4,4,22,7,15
"2021","Dudley 029C","E01009909",673,234,115,119,418,76,203,92,76,35,79,46,26,7,59,28,31,1,1,21,11,10
"2021","Dudley 029D","E01009910",717,257,112,145,437,65,152,59,55,38,106,47,51,8,108,75,33,6,6,23,17,6
"2021","Dudley 030A","E01009793",612,122,62,60,463,52,243,75,108,60,87,38,41,8,80,50,30,1,1,27,12,15
"2021","Dudley 030B","E01009794",626,159,109,50,441,99,213,67,104,42,62,34,26,2,64,31,33,3,3,26,15,11
"2021","Dudley 030C","E01009797",650,258,132,126,373,76,155,47,73,35,65,31,29,5,76,44,32,1,1,19,8,11
"2021","Dudley 030D","E01009801",700,152,96,56,523,123,244,84,98,62,46,16,26,4,107,68,39,3,3,25,13,12
"2021","Dudley 031A","E01009721",1109,414,170,244,633,82,296,118,137,41,155,100,52,3,93,49,44,7,7,62,18,44
"2021","Dudley 031B","E01009725",633,202,64,138,405,34,120,36,65,19,84,30,46,8,167,121,46,0,0,26,11,15
"2021","Dudley 031C","E01009726",547,160,75,85,365,76,179,63,61,55,65,31,33,1,43,28,15,2,2,22,12,10
"2021","Dudley 031D","E01009834",736,269,101,168,433,60,187,61,77,49,87,44,35,8,92,53,39,7,7,34,17,17
"2021","Dudley 032A","E01009833",529,159,51,108,296,21,150,32,91,27,49,26,18,5,67,47,20,9,9,74,36,38
"2021","Dudley 032B","E01009835",603,149,52,97,391,39,240,57,135,48,61,36,20,5,48,30,18,3,3,63,30,33
"2021","Dudley 032C","E01009869",672,209,96,113,445,66,199,74,72,53,121,59,52,10,56,31,25,3,3,18,9,9
"2021","Dudley 032D","E01009870",754,323,134,189,416,96,193,88,52,53,82,55,25,2,41,19,22,4,4,15,6,9
"2021","Dudley 033A","E01009809",687,210,109,101,439,30,166,51,81,34,122,64,54,4,119,78,41,2,2,38,21,17
"2021","Dudley 033B","E01009813",656,184,105,79,438,64,179,72,69,38,93,46,36,11,99,63,36,3,3,34,16,18
"2021","Dudley 033C","E01009861",725,227,76,151,448,59,212,75,93,44,77,33,38,6,92,51,41,8,8,50,12,38
"2021","Dudley 033D","E01009862",755,208,89,119,509,65,204,69,86,49,111,49,58,4,125,95,30,4,4,38,22,16
"2021","Dudley 033E","E01009863",793,218,65,153,539,53,241,80,112,49,122,64,55,3,120,81,39,3,3,36,16,20
"2021","Dudley 033F","E01009868",664,214,98,116,423,52,160,65,68,27,106,57,42,7,100,53,47,5,5,27,15,12
"2021","Dudley 034A","E01009734",679,237,121,116,413,63,181,54,81,46,69,31,35,3,96,68,28,4,4,29,11,18
"2021","Dudley 034B","E01009735",701,196,94,102,480,70,264,83,109,72,86,45,35,6,55,35,20,5,5,25,9,16
"2021","Dudley 034C","E01009736",617,176,96,80,423,101,192,61,84,47,77,42,34,1,53,25,28,0,0,18,8,10
"2021","Dudley 034D","E01009737",699,239,138,101,436,98,189,65,75,49,77,44,27,6,69,42,27,3,3,24,9,15
"2021","Dudley 034E","E01009738",603,138,80,58,433,49,227,49,125,53,72,30,38,4,81,41,40,4,4,32,19,13
"2021","Dudley 035A","E01009856",973,423,135,288,512,56,229,75,115,39,144,93,47,4,80,47,33,3,3,38,18,20
"2021","Dudley 035B","E01009905",664,218,93,125,432,71,196,79,77,40,110,65,41,4,54,31,23,1,1,14,6,8
"2021","Dudley 035C","E01009906",904,464,162,302,423,41,147,60,67,20,126,77,38,11,103,63,40,6,6,17,8,9
"2021","Dudley 035D","E01009907",668,241,126,115,393,51,179,66,77,36,88,61,27,0,72,49,23,3,3,34,11,23
"2021","Dudley 035E","E01009908",685,199,84,115,475,73,225,62,113,50,105,67,33,5,69,41,28,3,3,11,7,4
"2021","Dudley 036A","E01009800",649,207,130,77,416,106,216,57,102,57,51,21,27,3,43,23,20,0,0,26,17,9
"2021","Dudley 036B","E01009802",680,151,76,75,495,70,257,71,117,69,87,37,42,8,80,55,25,1,1,34,18,16
"2021","Dudley 036C","E01009803",648,159,117,42,455,125,268,85,121,62,36,13,20,3,26,7,19,0,0,34,20,14
"2021","Dudley 036D","E01009804",536,146,82,64,368,104,200,84,64,52,29,13,13,3,32,13,19,3,3,22,13,9
"2021","Dudley 037A","E01009831",637,228,117,111,375,49,172,53,66,53,65,28,31,6,84,50,34,5,5,34,21,13
"2021","Dudley 037B","E01009836",881,438,118,320,387,21,134,52,66,16,99,29,58,12,133,105,28,0,0,56,39,17
"2021","Dudley 037C","E01009837",669,232,79,153,374,46,169,47,82,40,76,51,22,3,81,54,27,2,2,63,35,28
"2021","Dudley 037D","E01009838",698,202,98,104,447,63,188,50,91,47,97,34,51,12,93,39,54,6,6,49,15,34
"2021","Dudley 038A","E01009847",621,141,93,48,462,104,203,59,84,60,77,35,35,7,75,47,28,3,3,18,7,11
"2021","Dudley 038B","E01009848",623,214,118,96,390,64,171,54,76,41,91,43,38,10,62,41,21,2,2,19,12,7
"2021","Dudley 038C","E01009849",657,181,79,102,446,73,192,59,92,41,99,42,45,12,76,33,43,6,6,30,18,12
"2021","Dudley 038D","E01009851",647,171,108,63,458,96,273,87,127,59,46,19,26,1,43,18,25,0,0,18,4,14
"2021","Dudley 039A","E01009732",745,228,114,114,480,79,218,62,108,48,73,40,27,6,104,61,43,6,6,37,16,21
"2021","Dudley 039B","E01009733",948,468,152,316,443,25,116,47,55,14,123,64,55,4,168,117,51,11,11,37,16,21
"2021","Dudley 039C","E01009739",666,184,89,95,453,49,190,68,92,30,92,44,42,6,115,79,36,7,7,29,10,19
"2021","Dudley 039D","E01009799",702,267,152,115,420,106,202,62,90,50,58,32,25,1,52,25,27,2,2,15,6,9
"2021","Dudley 039E","E01009805",650,204,97,107,409,81,193,73,74,46,66,38,23,5,66,29,37,3,3,37,12,25
"2021","Dudley 039F","E01009806",698,267,122,145,407,82,198,77,83,38,73,49,23,1,52,20,32,2,2,24,13,11
"2021","Dudley 040A","E01009854",643,173,118,55,451,118,251,76,115,60,57,33,22,2,24,11,13,1,1,19,6,13
"2021","Dudley 040B","E01009857",700,225,106,119,439,45,181,60,85,36,96,47,43,6,106,66,40,11,11,36,24,12
"2021","Dudley 040C","E01009858",670,317,119,198,346,70,134,52,62,20,90,67,20,3,51,30,21,1,1,7,4,3
"2021","Dudley 040D","E01009859",641,166,90,76,453,98,255,84,113,58,58,40,15,3,39,18,21,3,3,22,13,9
"2021","Dudley 041A","E01009845",650,170,109,61,450,156,244,81,126,37,37,17,17,3,12,5,7,1,1,30,18,12
"2021","Dudley 041B","E01009846",639,178,119,59,424,100,230,71,93,66,54,31,16,7,37,21,16,3,3,37,13,24
"2021","Dudley 041C","E01009850",662,215,117,98,426,109,214,61,115,38,50,31,16,3,51,34,17,2,2,21,9,12
"2021","Dudley 041D","E01009852",607,137,112,25,449,142,235,93,96,46,39,22,12,5,33,14,19,0,0,21,8,13
"2021","Dudley 042A","E01009832",733,228,138,90,477,40,178,54,83,41,86,37,38,11,167,118,49,6,6,28,18,10
"2021","Dudley 042B","E01009853",621,169,138,31,431,135,218,85,96,37,43,29,11,3,34,14,20,1,1,21,12,9
"2021","Dudley 042C","E01009855",642,133,96,37,477,153,261,90,99,72,39,18,19,2,24,15,9,0,0,32,23,9
"2021","Dudley 042D","E01009860",634,153,116,37,446,131,233,85,95,53,36,21,11,4,43,21,22,3,3,35,18,17
"2021","Dudley 043A","E01009807",749,173,118,55,547,126,306,90,156,60,67,23,42,2,48,16,32,0,0,29,16,13
"2021","Dudley 043B","E01009808",591,144,88,56,430,112,232,85,98,49,51,29,17,5,33,14,19,2,2,17,7,10
"2021","Dudley 043C","E01009810",770,232,128,104,505,91,259,74,126,59,70,33,32,5,83,43,40,2,2,33,19,14
"2021","Dudley 043D","E01009811",653,204,118,86,428,91,196,58,95,43,64,32,25,7,75,43,32,2,2,21,14,7
"2021","Dudley 043E","E01009812",577,103,77,26,454,92,253,79,113,61,63,33,23,7,41,21,20,5,5,20,12,8
"2021","Sandwell 001A","E01010085",665,194,71,123,437,48,225,77,104,44,97,34,58,5,66,39,27,1,1,34,14,20
"2021","Sandwell 001B","E01010086",674,201,78,123,428,46,194,53,86,55,80,27,49,4,102,74,28,6,6,45,28,17
"2021","Sandwell 001C","E01010087",621,124,63,61,459,57,221,73,101,47,87,27,51,9,89,53,36,5,5,38,20,18
"2021","Sandwell 001D","E01010088",566,117,50,67,395,33,198,67,83,48,90,27,52,11,66,35,31,8,8,54,31,23
"2021","Sandwell 001E","E01010089",694,167,84,83,485,47,214,58,106,50,105,41,52,12,110,63,47,9,9,42,30,12
"2021","Sandwell 002A","E01009969",802,192,60,132,531,34,223,57,114,52,102,42,54,6,165,120,45,7,7,79,52,27
"2021","Sandwell 002B","E01009970",687,177,80,97,475,46,248,66,128,54,70,27,37,6,107,76,31,4,4,35,24,11
"2021","Sandwell 002C","E01009971",687,193,83,110,455,40,181,52,92,37,99,36,48,15,128,83,45,7,7,39,25,14
"2021","Sandwell 002D","E01009973",770,140,55,85,517,31,323,64,175,84,62,22,33,7,96,52,44,5,5,113,86,27
"2021","Sandwell 003A","E01009960",628,196,88,108,390,33,162,41,74,47,97,30,55,12,93,57,36,5,5,42,26,16
"2021","Sandwell 003B","E01009961",530,140,77,63,366,60,188,72,75,41,66,24,36,6,49,23,26,3,3,24,14,10
"2021","Sandwell 003C","E01009966",465,120,48,72,320,38,139,45,64,30,76,15,47,14,64,48,16,3,3,25,20,5
"2021","Sandwell 003D","E01009967",771,218,81,137,518,49,250,82,121,47,109,45,53,11,105,68,37,5,5,35,21,14
"2021","Sandwell 003E","E01010092",798,280,115,165,473,56,215,63,98,54,78,38,32,8,119,85,34,5,5,45,36,9
"2021","Sandwell 004A","E01009962",516,137,66,71,346,34,152,43,67,42,49,15,29,5,107,63,44,4,4,33,21,12
"2021","Sandwell 004B","E01009963",502,123,59,64,350,21,157,49,64,44,71,19,45,7,98,66,32,3,3,29,17,12
"2021","Sandwell 004C","E01009964",584,132,56,76,418,36,152,41,73,38,91,11,67,13,131,97,34,8,8,34,18,16
"2021","Sandwell 004D","E01009965",452,72,41,31,348,22,165,43,79,43,59,8,43,8,97,71,26,5,5,32,17,15
"2021","Sandwell 005A","E01010090",816,250,73,177,522,47,193,62,97,34,131,51,72,8,145,112,33,6,6,44,24,20
"2021","Sandwell 005B","E01010091",691,265,96,169,359,51,178,62,76,40,65,36,25,4,62,28,34,3,3,67,49,18
"2021","Sandwell 005C","E01010096",797,299,147,152,458,82,204,90,67,47,73,27,38,8,98,71,27,1,1,40,32,8
"2021","Sandwell 005D","E01010097",783,222,132,90,516,104,246,103,85,58,83,38,37,8,79,43,36,4,4,45,25,20
"2021","Sandwell 006A","E01009968",636,214,102,112,375,68,194,35,96,63,45,26,16,3,65,33,32,3,3,47,30,17
"2021","Sandwell 006B","E01009972",742,173,113,60,503,91,256,75,121,60,78,34,40,4,72,36,36,6,6,66,33,33
"2021","Sandwell 006C","E01009974",667,177,92,85,435,88,225,62,92,71,60,25,28,7,59,29,30,3,3,55,24,31
"2021","Sandwell 006D","E01009975",672,172,100,72,443,92,237,78,92,67,47,23,19,5,64,23,41,3,3,57,37,20
"2021","Sandwell 007A","E01010030",714,246,66,180,426,39,137,44,61,32,90,24,56,10,154,124,30,6,6,42,30,12
"2021","Sandwell 007B","E01010034",500,96,32,64,386,35,244,102,69,73,66,34,25,7,41,20,21,0,0,18,8,10
"2021","Sandwell 007C","E01010035",599,171,105,66,409,110,196,77,61,58,51,22,26,3,50,27,23,2,2,19,11,8
"2021","Sandwell 007D","E01010036",690,142,56,86,487,22,207,59,92,56,123,38,74,11,130,92,38,5,5,61,40,21
"2021","Sandwell 009A","E01009982",557,112,45,67,398,23,196,53,93,50,82,26,48,8,91,62,29,6,6,47,29,18
"2021","Sandwell 009B","E01009983",601,132,72,60,441,56,181,72,67,42,78,26,48,4,125,79,46,1,1,28,18,10
"2021","Sandwell 009C","E01010029",596,165,75,90,386,31,122,36,53,33,97,14,79,4,132,107,25,4,4,45,29,16
"2021","Sandwell 009D","E01010037",490,111,55,56,353,29,128,35,62,31,76,23,48,5,115,82,33,5,5,26,16,10
"2021","Sandwell 010A","E01009991",844,226,67,159,535,38,271,62,125,84,90,26,55,9,133,78,55,3,3,83,54,29
"2021","Sandwell 010B","E01009994",641,173,67,106,407,44,192,51,96,45,64,18,41,5,101,59,42,6,6,61,39,22
"2021","Sandwell 010C","E01009995",627,162,74,88,423,51,191,58,85,48,69,18,46,5,109,84,25,3,3,42,25,17
"2021","Sandwell 010D","E01009996",648,181,82,99,428,52,176,47,80,49,72,24,44,4,125,80,45,3,3,39,22,17
"2021","Sandwell 010E","E01009997",660,155,54,101,444,42,187,54,96,37,68,20,38,10,142,98,44,5,5,61,37,24
"2021","Sandwell 010F","E01009998",808,224,87,137,519,38,240,65,120,55,88,28,54,6,143,109,34,10,10,65,46,19
"2021","Sandwell 011A","E01010008",627,163,81,82,412,49,210,51,99,60,49,13,30,6,101,49,52,3,3,52,36,16
"2021","Sandwell 011B","E01010010",628,219,70,149,374,50,158,45,79,34,44,23,17,4,121,85,36,1,1,35,27,8
"2021","Sandwell 011C","E01010011",719,222,111,111,442,56,212,49,106,57,66,25,31,10,103,50,53,5,5,55,34,21
"2021","Sandwell 011D","E01010012",569,142,72,70,398,65,217,68,100,49,44,14,29,1,68,35,33,4,4,29,20,9
"2021","Sandwell 012A","E01010007",545,159,68,91,347,47,155,36,76,43,42,18,16,8,97,60,37,6,6,39,20,19
"2021","Sandwell 012B","E01010009",553,131,64,67,388,45,180,35,87,58,47,18,23,6,113,66,47,3,3,34,19,15
"2021","Sandwell 012C","E01010013",522,150,87,63,329,71,147,35,57,55,50,24,25,1,54,20,34,7,7,43,29,14
"2021","Sandwell 012D","E01010014",697,227,114,113,427,73,197,57,96,44,58,27,25,6,91,43,48,8,8,43,26,17
"2021","Sandwell 013A","E01010093",713,293,108,185,375,19,204,57,123,24,66,33,29,4,74,41,33,12,12,45,26,19
"2021","Sandwell 013B","E01010094",574,105,42,63,384,37,203,42,100,61,37,9,24,4,104,72,32,3,3,85,52,33
"2021","Sandwell 013C","E01010095",687,125,37,88,478,36,219,42,130,47,91,29,55,7,129,84,45,3,3,84,65,19
"2021","Sandwell 013D","E01010098",815,295,106,189,469,49,208,61,97,50,89,34,46,9,122,63,59,1,1,51,33,18
"2021","Sandwell 013E","E01010099",668,186,80,106,436,51,241,65,125,51,61,21,34,6,83,51,32,0,0,46,28,18
"2021","Sandwell 013F","E01010100",724,187,81,106,435,60,221,41,121,59,58,27,29,2,90,47,43,6,6,102,66,36
"2021","Sandwell 014A","E01009978",652,127,78,49,479,59,232,53,100,79,79,18,52,9,101,48,53,8,8,46,28,18
"2021","Sandwell 014B","E01010031",721,277,89,188,414,38,129,48,50,31,128,59,62,7,112,73,39,7,7,30,20,10
"2021","Sandwell 014C","E01010032",521,102,43,59,381,16,141,29,86,26,71,12,50,9,146,105,41,7,7,38,27,11
"2021","Sandwell 014D","E01010033",780,330,91,239,421,46,170,56,70,44,83,39,34,10,116,92,24,6,6,29,19,10
"2021","Sandwell 014F","E01033886",573,123,37,86,415,17,196,53,125,18,93,33,50,10,108,69,39,1,1,35,25,10
"2021","Sandwell 014G","E01033887",616,204,59,145,369,25,165,43,80,42,73,27,42,4,97,57,40,9,9,43,28,15
"2021","Sandwell 015A","E01010066",696,282,144,138,357,49,183,51,99,33,49,23,22,4,69,43,26,7,7,57,46,11
"2021","Sandwell 015B","E01010067",705,276,57,219,356,22,160,45,92,23,61,33,24,4,104,65,39,9,9,73,53,20
"2021","Sandwell 015C","E01010068",697,198,91,107,456,40,207,68,100,39,89,27,53,9,117,81,36,3,3,43,29,14
"2021","Sandwell 015D","E01010070",828,352,111,241,439,44,221,81,87,53,80,33,42,5,88,58,30,6,6,37,20,17
"2021","Sandwell 015E","E01010075",489,68,22,46,357,15,218,59,101,58,53,25,25,3,67,42,25,4,4,64,44,20
"2021","Sandwell 015F","E01010076",862,312,151,161,491,47,214,58,113,43,119,55,58,6,103,71,32,8,8,59,41,18
"2021","Sandwell 016A","E01009976",1054,251,62,189,722,53,376,108,191,77,151,74,73,4,137,85,52,5,5,81,50,31
"2021","Sandwell 016B","E01009977",799,214,68,146,521,27,282,68,158,56,84,36,45,3,124,80,44,4,4,64,32,32
"2021","Sandwell 016C","E01009979",848,382,162,220,388,35,136,51,60,25,82,35,41,6,125,82,43,10,10,78,62,16
"2021","Sandwell 016D","E01009980",859,271,63,208,504,33,253,59,135,59,69,35,29,5,139,86,53,10,10,84,54,30
"2021","Sandwell 016E","E01010069",731,100,38,62,505,37,289,49,164,76,51,18,27,6,98,55,43,30,30,126,100,26
"2021","Sandwell 016F","E01010071",681,216,51,165,396,28,191,52,93,46,66,33,30,3,104,61,43,7,7,69,47,22
"2021","Sandwell 017A","E01009947",912,272,110,162,574,50,298,81,153,64,81,42,30,9,141,92,49,4,4,66,44,22
"2021","Sandwell 017B","E01009992",615,163,84,79,357,29,206,41,106,59,45,18,23,4,77,45,32,0,0,95,59,36
"2021","Sandwell 017C","E01009993",725,251,83,168,410,31,202,50,110,42,53,14,33,6,114,65,49,10,10,64,43,21
"2021","Sandwell 017D","E01010103",960,415,94,321,484,33,222,44,143,35,76,37,33,6,144,85,59,9,9,61,40,21
"2021","Sandwell 017E","E01010104",820,347,146,201,420,57,206,70,79,57,63,42,18,3,90,34,56,4,4,53,30,23
"2021","Sandwell 017F","E01010105",543,136,36,100,312,38,169,32,83,54,41,25,15,1,56,28,28,8,8,95,65,30
"2021","Sandwell 018A","E01009981",766,207,82,125,491,44,227,61,113,53,86,32,39,15,127,75,52,7,7,68,36,32
"2021","Sandwell 018C","E01009985",667,209,94,115,405,41,200,37,112,51,46,18,21,7,110,70,40,8,8,53,41,12
"2021","Sandwell 018F","E01033888",543,167,66,101,321,35,161,30,94,37,34,8,20,6,76,50,26,15,15,55,36,19
"2021","Sandwell 018G","E01033889",660,156,40,116,447,19,238,57,140,41,66,19,41,6,114,75,39,10,10,57,43,14
"2021","Sandwell 019A","E01009986",540,141,56,85,307,31,186,47,105,34,27,9,17,1,58,43,15,5,5,92,57,35
"2021","Sandwell 019B","E01009987",593,238,108,130,310,31,181,33,89,59,31,14,17,0,63,42,21,4,4,45,35,10
"2021","Sandwell 019C","E01009989",653,185,105,80,370,36,197,53,102,42,59,18,37,4,69,39,30,9,9,98,69,29
"2021","Sandwell 019D","E01010106",636,198,46,152,312,25,165,44,91,30,34,22,12,0,82,50,32,6,6,126,78,48
"2021","Sandwell 020A","E01009988",1060,311,124,187,651,37,342,88,199,55,92,29,49,14,171,101,70,9,9,98,55,43
"2021","Sandwell 020B","E01010101",920,397,128,269,459,35,187,54,87,46,101,75,22,4,130,83,47,6,6,64,43,21
"2021","Sandwell 020C","E01010102",707,222,76,146,404,44,192,41,97,54,63,19,40,4,96,55,41,9,9,81,54,27
"2021","Sandwell 020D","E01010107",802,294,76,218,367,7,172,34,103,35,34,11,20,3,146,90,56,8,8,141,83,58
"2021","Sandwell 021A","E01010015",718,170,77,93,472,52,277,74,146,57,56,14,38,4,83,42,41,4,4,76,43,33
"2021","Sandwell 021B","E01010016",612,178,51,127,359,24,176,42,101,33,62,29,27,6,89,49,40,8,8,75,53,22
"2021","Sandwell 021C","E01010018",1002,350,69,281,585,32,260,71,152,37,134,66,63,5,145,87,58,14,14,67,38,29
"2021","Sandwell 021D","E01010072",972,347,59,288,554,24,264,84,151,29,110,53,50,7,151,103,48,5,5,71,41,30
"2021","Sandwell 021E","E01010073",631,152,53,99,439,43,222,51,130,41,58,16,34,8,110,68,42,6,6,40,15,25
"2021","Sandwell 022A","E01010077",672,215,76,139,418,45,162,46,72,44,79,29,42,8,128,95,33,4,4,39,24,15
"2021","Sandwell 022B","E01010079",613,162,64,98,425,65,236,76,94,66,77,33,39,5,45,23,22,2,2,26,16,10
"2021","Sandwell 022C","E01010080",768,224,48,176,503,27,198,33,126,39,102,36,52,14,169,131,38,7,7,41,28,13
"2021","Sandwell 022D","E01010081",665,192,90,102,446,71,231,73,94,64,78,41,36,1,59,37,22,7,7,27,16,11
"2021","Sandwell 022E","E01010082",852,178,59,119,614,47,368,112,173,83,88,47,36,5,106,66,40,5,5,60,49,11
"2021","Sandwell 022F","E01010083",689,152,73,79,488,45,222,65,108,49,103,26,71,6,110,77,33,8,8,49,26,23
"2021","Sandwell 022G","E01010084",555,99,44,55,411,23,174,54,84,36,79,20,49,10,131,100,31,4,4,45,20,25
"2021","Sandwell 023A","E01010046",810,130,25,105,523,9,326,38,246,42,60,21,34,5,121,83,38,7,7,157,123,34
"2021","Sandwell 023B","E01010047",589,114,34,80,334,27,208,32,132,44,25,5,16,4,65,34,31,9,9,141,93,48
"2021","Sandwell 023C","E01010048",526,71,38,33,333,19,205,29,130,46,35,6,25,4,57,27,30,17,17,122,85,37
"2021","Sandwell 023D","E01010049",561,125,57,68,316,22,186,27,114,45,21,10,9,2,74,41,33,13,13,120,60,60
"2021","Sandwell 023E","E01010050",513,87,46,41,333,32,218,29,126,63,18,3,13,2,56,24,32,9,9,93,66,27
"2021","Sandwell 023F","E01010052",477,129,55,74,282,16,161,26,108,27,29,13,15,1,68,34,34,8,8,66,46,20
"2021","Sandwell 023G","E01010053",668,154,37,117,419,14,232,22,156,54,38,13,24,1,120,77,43,15,15,95,61,34
"2021","Sandwell 024A","E01010017",882,385,141,244,426,32,177,49,95,33,63,37,23,3,121,84,37,33,33,71,36,35
"2021","Sandwell 024B","E01010019",668,191,45,146,402,19,239,47,156,36,37,7,27,3,101,68,33,6,6,75,47,28
"2021","Sandwell 024C","E01010020",702,129,68,61,474,44,253,38,153,62,45,18,20,7,122,66,56,10,10,99,52,47
"2021","Sandwell 024D","E01010021",675,174,53,121,429,31,215,37,135,43,57,24,30,3,116,59,57,10,10,72,51,21
"2021","Sandwell 025A","E01010039",773,160,69,91,570,31,242,51,144,47,158,70,82,6,132,100,32,7,7,43,25,18
"2021","Sandwell 025B","E01010043",592,153,92,61,403,77,214,85,83,46,64,25,30,9,47,13,34,1,1,36,20,16
"2021","Sandwell 025C","E01010044",621,166,80,86,432,44,185,52,93,40,98,48,44,6,104,68,36,1,1,23,14,9
"2021","Sandwell 025D","E01010078",525,145,93,52,360,97,193,73,72,48,38,15,17,6,31,12,19,1,1,20,13,7
"2021","Sandwell 027A","E01009934",595,177,78,99,391,40,142,39,76,27,58,20,31,7,141,100,41,10,10,27,17,10
"2021","Sandwell 027B","E01009935",1041,397,109,288,608,34,233,67,116,50,122,41,67,14,209,167,42,10,10,36,24,12
"2021","Sandwell 027C","E01009936",661,183,111,72,430,96,195,65,77,53,82,40,34,8,54,24,30,3,3,48,27,21
"2021","Sandwell 027D","E01010004",878,387,122,265,439,45,186,65,79,42,94,48,42,4,112,76,36,2,2,52,31,21
"2021","Sandwell 028A","E01010054",908,432,148,284,419,29,173,42,107,24,47,29,14,4,157,83,74,13,13,57,40,17
"2021","Sandwell 028B","E01010055",631,128,37,91,416,20,227,36,152,39,56,21,31,4,103,81,22,10,10,87,62,25
"2021","Sandwell 028C","E01010056",656,187,86,101,389,33,181,34,99,48,51,23,22,6,113,72,41,11,11,80,55,25
"2021","Sandwell 028D","E01010057",698,200,96,104,386,31,212,29,145,38,41,17,24,0,91,59,32,11,11,112,78,34
"2021","Sandwell 028E","E01010060",701,205,43,162,364,15,167,32,111,24,42,18,22,2,128,82,46,12,12,132,80,52
"2021","Sandwell 029A","E01010038",705,165,72,93,509,45,210,59,96,55,118,43,64,11,133,100,33,3,3,31,17,14
"2021","Sandwell 029B","E01010040",589,163,81,82,395,76,174,58,71,45,56,23,27,6,84,49,35,5,5,31,16,15
"2021","Sandwell 029C","E01010041",792,280,163,117,484,68,154,49,74,31,106,39,59,8,151,106,45,5,5,28,13,15
"2021","Sandwell 029D","E01010045",638,158,72,86,423,45,195,65,75,55,86,31,45,10,91,66,25,6,6,57,36,21
"2021","Sandwell 030A","E01010000",752,264,125,139,439,51,220,60,111,49,74,39,27,8,88,50,38,6,6,49,27,22
"2021","Sandwell 030B","E01010002",870,238,79,159,569,56,256,71,136,49,114,58,49,7,134,86,48,9,9,63,35,28
"2021","Sandwell 030C","E01010003",706,313,99,214,340,22,150,50,62,38,72,33,36,3,93,60,33,3,3,53,27,26
"2021","Sandwell 030D","E01010005",608,176,56,120,371,43,179,47,86,46,50,22,23,5,87,58,29,12,12,61,31,30
"2021","Sandwell 030E","E01010006",679,185,74,111,431,61,227,60,106,61,62,30,26,6,75,41,34,6,6,63,35,28
"2021","Sandwell 031A","E01009938",682,159,87,72,472,57,216,46,109,61,72,25,32,15,120,68,52,7,7,51,35,16
"2021","Sandwell 031B","E01009943",489,93,61,32,330,22,173,33,96,44,39,15,19,5,89,53,36,7,7,66,49,17
"2021","Sandwell 031C","E01009944",621,145,73,72,408,27,210,45,115,50,61,26,28,7,105,63,42,5,5,68,32,36
"2021","Sandwell 031D","E01010051",493,123,53,70,313,30,158,33,89,36,43,10,26,7,82,48,34,0,0,57,36,21
"2021","Sandwell 031E","E01010058",649,206,84,122,407,30,206,55,104,47,48,17,24,7,114,68,46,9,9,36,24,12
"2021","Sandwell 032A","E01009937",613,151,64,87,426,33,185,62,84,39,80,27,41,12,121,66,55,7,7,36,24,12
"2021","Sandwell 032B","E01009939",679,195,89,106,448,59,233,51,121,61,69,32,28,9,84,47,37,3,3,36,20,16
"2021","Sandwell 032C","E01009940",607,186,99,87,374,36,176,46,92,38,59,19,34,6,95,57,38,8,8,47,31,16
"2021","Sandwell 032D","E01009941",620,187,90,97,386,51,207,57,93,57,47,18,20,9,77,35,42,4,4,47,26,21
"2021","Sandwell 032E","E01009942",652,157,78,79,455,64,214,47,105,62,62,18,33,11,111,60,51,4,4,40,25,15
"2021","Sandwell 033A","E01009929",724,223,114,109,454,44,193,60,88,45,84,36,43,5,126,75,51,7,7,47,29,18
"2021","Sandwell 033B","E01009930",644,196,83,113,416,34,157,58,73,26,83,25,51,7,134,86,48,8,8,32,21,11
"2021","Sandwell 033C","E01009931",963,207,80,127,699,105,358,132,145,81,126,75,44,7,108,55,53,2,2,57,29,28
"2021","Sandwell 033D","E01009932",792,400,197,203,345,40,133,52,54,27,81,48,27,6,88,45,43,3,3,47,21,26
"2021","Sandwell 033E","E01009999",561,144,52,92,365,52,161,39,75,47,61,25,30,6,85,53,32,6,6,52,34,18
"2021","Sandwell 034A","E01009921",757,227,61,166,466,23,185,57,99,29,131,92,36,3,106,79,27,21,21,64,29,35
"2021","Sandwell 034B","E01009922",506,104,51,53,358,39,152,38,77,37,63,23,32,8,99,48,51,5,5,44,29,15
"2021","Sandwell 034C","E01009924",630,199,69,130,378,32,158,46,85,27,107,71,30,6,74,43,31,7,7,53,12,41
"2021","Sandwell 034D","E01009925",588,159,62,97,375,53,204,51,117,36,72,40,27,5,44,20,24,2,2,54,14,40
"2021","Sandwell 034E","E01009926",621,202,50,152,370,25,179,54,95,30,90,50,38,2,72,43,29,4,4,49,16,33
"2021","Sandwell 034F","E01009927",689,273,80,193,346,20,151,64,68,19,94,59,33,2,71,43,28,10,10,70,22,48
"2021","Sandwell 034G","E01009928",751,256,86,170,443,17,184,70,95,19,82,51,31,0,144,100,44,16,16,52,24,28
"2021","Sandwell 035A","E01009933",553,151,76,75,360,35,170,51,68,51,71,24,40,7,82,50,32,2,2,42,26,16
"2021","Sandwell 035B","E01009952",942,360,111,249,527,22,166,55,81,30,115,58,51,6,217,150,67,7,7,55,29,26
"2021","Sandwell 035C","E01009955",883,356,99,257,443,48,178,49,96,33,102,44,52,6,108,72,36,7,7,84,60,24
"2021","Sandwell 035D","E01009956",720,260,106,154,419,43,179,59,74,46,91,43,42,6,104,66,38,2,2,41,21,20
"2021","Sandwell 035E","E01009959",607,134,81,53,462,86,266,107,99,60,62,31,26,5,48,23,25,0,0,11,4,7
"2021","Sandwell 035F","E01010042",809,286,139,147,480,55,217,71,104,42,94,55,32,7,107,55,52,7,7,43,24,19
"2021","Sandwell 036A","E01009923",597,162,102,60,389,60,203,63,102,38,57,25,26,6,68,34,34,1,1,46,26,20
"2021","Sandwell 036B","E01010024",655,210,108,102,417,74,216,49,109,58,61,25,31,5,61,38,23,5,5,28,20,8
"2021","Sandwell 036C","E01010026",713,184,99,85,485,70,243,62,119,62,57,25,28,4,109,46,63,6,6,44,27,17
"2021","Sandwell 036D","E01010027",616,149,70,79,418,63,241,69,120,52,52,25,25,2,61,28,33,1,1,49,35,14
"2021","Sandwell 037A","E01010001",766,216,113,103,498,53,220,70,94,56,88,32,47,9,127,81,46,10,10,52,35,17
"2021","Sandwell 037B","E01010022",624,150,63,87,437,59,235,71,107,57,61,28,28,5,80,34,46,2,2,37,20,17
"2021","Sandwell 037C","E01010023",790,250,121,129,497,81,237,72,100,65,77,33,39,5,97,63,34,5,5,43,24,19
"2021","Sandwell 037D","E01010025",706,251,152,99,407,38,184,59,94,31,78,27,44,7,104,67,37,3,3,48,31,17
"2021","Sandwell 037E","E01010028",651,223,105,118,401,29,168,47,88,33,81,30,42,9,113,74,39,10,10,27,13,14
"2021","Sandwell 038A","E01009953",974,364,128,236,579,50,212,91,86,35,150,78,62,10,163,128,35,4,4,31,14,17
"2021","Sandwell 038B","E01009954",755,229,117,112,491,63,227,73,107,47,84,34,41,9,111,70,41,6,6,35,18,17
"2021","Sandwell 038C","E01009957",696,220,69,151,430,32,177,58,95,24,82,24,52,6,135,100,35,4,4,46,28,18
"2021","Sandwell 038D","E01009958",665,169,90,79,481,85,253,81,108,64,87,42,37,8,55,21,34,1,1,15,10,5
"2021","Sandwell 039A","E01009946",691,183,87,96,445,75,221,60,101,60,69,26,36,7,74,37,37,6,6,63,34,29
"2021","Sandwell 039B","E01009948",609,139,87,52,443,96,214,52,85,77,54,27,22,5,73,26,47,6,6,27,14,13
"2021","Sandwell 039C","E01009949",573,118,77,41,389,90,222,58,108,56,31,17,13,1,41,20,21,5,5,66,51,15
"2021","Sandwell 039D","E01009950",660,164,92,72,448,76,249,67,106,76,54,22,25,7,63,23,40,6,6,48,24,24
"2021","Sandwell 039E","E01009951",1061,412,79,333,572,33,174,56,70,48,139,78,56,5,205,167,38,21,21,77,29,48
"2021","Sandwell 039F","E01032592",726,188,93,95,502,93,223,88,91,44,72,29,33,10,111,64,47,3,3,36,23,13
"2021","Sandwell 040A","E01010062",852,311,108,203,460,21,229,30,152,47,42,19,16,7,157,95,62,11,11,81,60,21
"2021","Sandwell 040D","E01010064",800,285,84,201,425,20,240,50,157,33,48,31,16,1,102,64,38,15,15,90,53,37
"2021","Sandwell 040B","E01033890",435,94,12,82,274,5,136,14,108,14,44,17,24,3,84,65,19,5,5,67,37,30
"2021","Sandwell 040C","E01033891",561,211,36,175,285,1,123,18,91,14,52,22,29,1,99,65,34,10,10,65,47,18
"2021","Sandwell 041D","E01010059",705,152,27,125,414,11,237,34,168,35,29,15,14,0,127,88,39,10,10,139,61,78
"2021","Sandwell 041B","E01010061",541,83,29,54,364,14,214,22,156,36,28,7,20,1,99,67,32,9,9,94,63,31
"2021","Sandwell 041A","E01033892",612,135,13,122,395,4,186,24,134,28,53,25,26,2,140,104,36,12,12,82,58,24
"2021","Sandwell 041C","E01033893",497,95,9,86,330,3,186,21,141,24,53,18,31,4,82,63,19,6,6,72,54,18
"2021","Solihull 001A","E01010118",504,135,78,57,343,70,177,63,67,47,50,17,19,14,44,23,21,2,2,26,13,13
"2021","Solihull 001B","E01010120",648,280,128,152,352,59,132,56,41,35,60,32,23,5,100,70,30,1,1,16,8,8
"2021","Solihull 001C","E01010121",609,152,91,61,410,99,208,71,88,49,60,22,31,7,39,14,25,4,4,47,23,24
"2021","Solihull 001D","E01010122",600,180,111,69,392,102,190,66,79,45,64,35,26,3,34,10,24,2,2,28,16,12
"2021","Solihull 002A","E01010235",562,146,62,84,368,42,103,35,45,23,71,20,43,8,145,96,49,7,7,48,31,17
"2021","Solihull 002B","E01010236",574,175,66,109,366,27,108,34,48,26,56,18,32,6,172,117,55,3,3,33,22,11
"2021","Solihull 002C","E01010239",622,164,74,90,411,51,152,50,66,36,59,21,28,10,146,96,50,3,3,47,23,24
"2021","Solihull 002D","E01010240",561,186,67,119,341,22,129,37,59,33,70,26,36,8,117,84,33,3,3,34,16,18
"2021","Solihull 003A","E01010117",566,116,82,34,423,74,249,81,89,79,49,17,29,3,51,24,27,0,0,27,12,15
"2021","Solihull 003B","E01010119",599,136,96,40,434,78,236,69,99,68,84,25,48,11,33,21,12,3,3,29,17,12
"2021","Solihull 003C","E01010123",628,185,135,50,407,70,228,74,90,64,57,22,28,7,50,29,21,2,2,36,16,20
"2021","Solihull 003D","E01010124",619,137,76,61,456,96,232,80,91,61,74,32,34,8,52,24,28,2,2,26,13,13
"2021","Solihull 004A","E01010146",622,134,65,69,454,41,158,50,70,38,93,26,50,17,158,90,68,4,4,34,17,17
"2021","Solihull 004B","E01010234",743,247,64,183,457,41,156,39,91,26,79,27,45,7,176,140,36,5,5,39,20,19
"2021","Solihull 004C","E01010237",756,208,115,93,507,69,198,63,71,64,96,30,52,14,136,81,55,8,8,41,14,27
"2021","Solihull 004D","E01010238",630,241,61,180,357,48,106,26,54,26,72,26,40,6,128,89,39,3,3,32,19,13
"2021","Solihull 005A","E01010145",679,192,103,89,442,54,206,63,101,42,87,36,35,16,91,58,33,4,4,45,18,27
"2021","Solihull 005B","E01010147",650,169,50,119,445,22,122,34,63,25,93,25,55,13,207,168,39,1,1,36,16,20
"2021","Solihull 005C","E01010148",700,218,107,111,435,24,159,33,86,40,78,18,49,11,168,114,54,6,6,47,31,16
"2021","Solihull 005D","E01010149",632,156,93,63,444,79,191,63,75,53,97,40,48,9,75,24,51,2,2,32,18,14
"2021","Solihull 006A","E01010125",840,318,119,199,488,34,168,55,60,53,100,28,68,4,183,132,51,3,3,34,15,19
"2021","Solihull 006B","E01010129",746,304,114,190,400,41,121,35,54,32,83,31,40,12,151,116,35,4,4,42,20,22
"2021","Solihull 006C","E01010139",431,129,69,60,279,52,104,31,38,35,51,22,24,5,71,52,19,1,1,23,11,12
"2021","Solihull 006D","E01010141",636,279,74,205,338,23,95,33,39,23,60,21,33,6,159,118,41,1,1,19,9,10
"2021","Solihull 007A","E01010140",607,207,78,129,370,30,129,37,44,48,60,14,33,13,148,101,47,3,3,30,20,10
"2021","Solihull 007B","E01010142",636,231,70,161,371,18,100,27,41,32,71,18,47,6,177,135,42,5,5,34,15,19
"2021","Solihull 007C","E01010143",701,237,98,139,445,39,129,34,70,25,77,20,48,9,195,145,50,5,5,19,10,9
"2021","Solihull 007D","E01010144",739,224,100,124,481,52,187,64,74,49,98,35,47,16,141,94,47,3,3,34,16,18
"2021","Solihull 008A","E01010111",638,221,57,164,377,27,110,33,50,27,66,22,38,6,165,115,50,9,9,40,23,17
"2021","Solihull 008B","E01010126",633,224,81,143,387,38,102,39,39,24,77,21,48,8,167,119,48,3,3,22,10,12
"2021","Solihull 008C","E01010127",748,209,84,125,494,54,193,52,105,36,104,42,58,4,140,102,38,3,3,45,19,26
"2021","Solihull 008D","E01010128",656,204,89,115,415,49,144,46,57,41,54,23,25,6,162,105,57,6,6,37,18,19
"2021","Solihull 008E","E01010130",776,262,96,166,481,36,129,34,55,40,105,37,55,13,202,137,65,9,9,33,17,16
"2021","Solihull 008F","E01010131",689,273,94,179,371,34,116,45,48,23,68,28,32,8,142,99,43,11,11,45,26,19
"2021","Solihull 009A","E01010109",654,155,85,70,462,84,215,70,88,57,90,40,42,8,72,49,23,1,1,37,18,19
"2021","Solihull 009B","E01010110",576,125,69,56,413,81,226,66,92,68,62,27,27,8,41,27,14,3,3,38,15,23
"2021","Solihull 009C","E01010112",684,215,73,142,439,40,172,61,64,47,122,61,44,17,103,66,37,2,2,30,19,11
"2021","Solihull 009D","E01010113",552,172,91,81,349,47,136,44,55,37,80,36,34,10,85,57,28,1,1,31,15,16
"2021","Solihull 009E","E01010114",778,228,121,107,498,97,252,73,120,59,83,45,29,9,66,33,33,0,0,52,26,26
"2021","Solihull 010A","E01010157",592,140,47,93,440,42,209,65,99,45,99,53,41,5,86,48,38,4,4,12,7,5
"2021","Solihull 010B","E01010159",540,131,65,66,367,31,207,46,103,58,63,32,28,3,61,29,32,5,5,42,23,19
"2021","Solihull 010C","E01010162",619,159,96,63,429,71,251,86,113,52,47,21,23,3,55,24,31,5,5,31,17,14
"2021","Solihull 010D","E01010163",563,117,54,63,411,50,236,60,119,57,64,26,32,6,58,25,33,3,3,35,20,15
"2021","Solihull 011A","E01010132",627,172,99,73,416,57,211,70,100,41,72,36,25,11,72,37,35,4,4,39,20,19
"2021","Solihull 011B","E01010133",687,209,128,81,431,90,217,52,103,62,57,29,27,1,63,31,32,4,4,47,23,24
"2021","Solihull 011C","E01010134",578,135,83,52,415,52,222,63,117,42,81,42,30,9,57,30,27,3,3,28,14,14
"2021","Solihull 011D","E01010135",650,196,99,97,418,64,204,74,75,55,78,31,42,5,72,39,33,0,0,36,13,23
"2021","Solihull 011E","E01010138",588,166,90,76,393,53,209,62,99,48,77,42,30,5,52,31,21,2,2,29,17,12
"2021","Solihull 012A","E01010136",509,125,58,67,369,46,205,61,106,38,67,36,28,3,48,29,19,3,3,15,9,6
"2021","Solihull 012B","E01010137",645,276,136,140,328,67,140,37,66,37,53,26,24,3,66,39,27,2,2,41,20,21
"2021","Solihull 012C","E01010158",635,227,101,126,365,29,151,48,71,32,67,23,39,5,113,69,44,5,5,43,26,17
"2021","Solihull 012D","E01010160",627,175,90,85,428,76,214,63,95,56,58,31,22,5,77,38,39,3,3,24,15,9
"2021","Solihull 012E","E01010161",614,161,97,64,417,65,225,53,118,54,67,32,27,8,56,24,32,4,4,36,22,14
"2021","Solihull 013A","E01010174",689,172,80,92,488,66,254,74,122,58,79,47,29,3,84,47,37,5,5,29,17,12
"2021","Solihull 013B","E01010175",709,201,104,97,457,115,235,69,110,56,58,39,14,5,48,33,15,1,1,51,20,31
"2021","Solihull 013C","E01010177",572,188,82,106,361,53,178,52,82,44,57,29,25,3,67,42,25,6,6,23,7,16
"2021","Solihull 013D","E01010178",973,493,170,323,433,47,209,77,101,31,81,56,23,2,90,54,36,6,6,47,16,31
"2021","Solihull 014A","E01010172",578,119,89,30,428,78,281,72,145,64,37,16,17,4,29,19,10,3,3,31,17,14
"2021","Solihull 014B","E01010173",539,113,72,41,402,93,257,68,136,53,25,15,9,1,24,13,11,3,3,24,16,8
"2021","Solihull 014C","E01010176",485,77,50,27,371,82,221,64,101,56,35,11,23,1,31,13,18,2,2,37,22,15
"2021","Solihull 014D","E01010179",786,354,235,119,398,101,189,72,82,35,54,35,13,6,52,26,26,2,2,34,12,22
"2021","Solihull 015A","E01010115",669,224,106,118,414,70,236,73,109,54,52,25,24,3,53,24,29,3,3,31,17,14
"2021","Solihull 015B","E01010116",519,85,62,23,405,105,238,74,109,55,23,12,9,2,36,13,23,3,3,29,22,7
"2021","Solihull 015C","E01010227",775,209,130,79,532,126,300,100,145,55,58,35,17,6,45,22,23,3,3,34,17,17
"2021","Solihull 015D","E01010228",661,174,98,76,457,78,235,67,118,50,74,37,29,8,66,43,23,4,4,30,9,21
"2021","Solihull 015E","E01010232",1007,393,125,268,559,44,207,61,118,28,123,59,58,6,179,122,57,6,6,55,19,36
"2021","Solihull 016A","E01010195",578,107,81,26,437,111,274,59,161,54,23,9,8,6,28,13,15,1,1,34,21,13
"2021","Solihull 016B","E01010226",921,452,276,176,443,134,183,63,92,28,63,51,12,0,57,28,29,6,6,26,14,12
"2021","Solihull 016C","E01010229",565,100,74,26,432,98,265,59,142,64,34,11,18,5,32,13,19,3,3,33,19,14
"2021","Solihull 016D","E01010230",756,240,117,123,478,64,259,67,143,49,75,46,27,2,78,54,24,2,2,38,18,20
"2021","Solihull 016E","E01010231",640,137,87,50,456,127,264,64,140,60,33,15,16,2,30,11,19,2,2,47,25,22
"2021","Solihull 016F","E01010233",810,222,103,119,535,62,254,86,128,40,94,65,25,4,123,69,54,2,2,53,31,22
"2021","Solihull 017A","E01010108",913,250,120,130,624,111,362,115,181,66,85,64,19,2,64,40,24,2,2,39,17,22
"2021","Solihull 017B","E01010164",723,184,107,77,518,108,295,119,116,60,63,38,21,4,49,22,27,3,3,21,15,6
"2021","Solihull 017C","E01010165",831,307,166,141,485,101,233,76,119,38,74,46,19,9,74,48,26,3,3,39,16,23
"2021","Solihull 017D","E01010167",649,146,64,82,464,85,277,111,100,66,54,32,20,2,42,21,21,6,6,39,20,19
"2021","Solihull 018A","E01010199",685,132,83,49,513,83,334,58,209,67,31,7,19,5,63,28,35,2,2,40,27,13
"2021","Solihull 018B","E01010200",653,256,165,91,368,62,171,46,92,33,48,21,23,4,81,49,32,6,6,29,12,17
"2021","Solihull 018C","E01010201",723,207,145,62,478,116,254,64,134,56,40,20,18,2,66,33,33,2,2,38,22,16
"2021","Solihull 018D","E01010204",660,284,90,194,344,34,144,50,73,21,60,29,28,3,102,67,35,4,4,32,16,16
"2021","Solihull 018E","E01010205",545,116,64,52,393,72,250,71,128,51,33,15,17,1,37,19,18,1,1,36,19,17
"2021","Solihull 018F","E01010206",638,110,63,47,497,66,308,71,169,68,64,27,31,6,59,31,28,0,0,31,18,13
"2021","Solihull 019A","E01010192",813,291,115,176,498,104,293,102,145,46,57,44,8,5,42,21,21,2,2,24,13,11
"2021","Solihull 019B","E01010196",621,93,67,26,484,106,320,85,155,80,33,12,13,8,21,8,13,4,4,44,25,19
"2021","Solihull 019C","E01010197",638,114,86,28,493,132,312,90,155,67,18,9,7,2,29,16,13,2,2,31,14,17
"2021","Solihull 019D","E01010198",736,256,178,78,455,111,272,75,153,44,33,20,11,2,39,23,16,0,0,25,7,18
"2021","Solihull 021A","E01010218",649,286,128,158,346,58,136,44,58,34,58,27,26,5,91,54,37,3,3,17,9,8
"2021","Solihull 021B","E01010219",677,211,116,95,433,76,222,63,103,56,66,40,22,4,69,41,28,0,0,33,12,21
"2021","Solihull 021C","E01010221",905,320,174,146,557,77,280,90,134,56,95,51,41,3,102,70,32,3,3,28,11,17
"2021","Solihull 021D","E01010222",629,210,90,120,396,85,186,67,72,47,58,26,26,6,65,36,29,2,2,23,11,12
"2021","Solihull 022A","E01010191",802,225,129,96,545,133,305,77,163,65,49,29,16,4,53,32,21,5,5,32,18,14
"2021","Solihull 022B","E01010202",602,138,82,56,429,78,263,47,149,67,35,19,12,4,50,27,23,3,3,35,22,13
"2021","Solihull 022C","E01010203",732,250,112,138,445,53,225,45,138,42,76,38,35,3,87,53,34,4,4,37,18,19
"2021","Solihull 022D","E01010209",679,173,86,87,469,64,233,58,133,42,77,40,35,2,90,59,31,5,5,37,24,13
"2021","Solihull 022E","E01010213",718,225,127,98,450,39,240,69,118,53,65,32,32,1,102,54,48,4,4,43,19,24
"2021","Solihull 023A","E01010208",623,147,105,42,444,95,252,65,132,55,47,20,23,4,46,20,26,4,4,32,16,16
"2021","Solihull 023B","E01010210",633,136,94,42,469,128,266,86,112,68,41,23,12,6,32,11,21,2,2,28,14,14
"2021","Solihull 023C","E01010211",661,259,157,102,377,85,179,54,81,44,52,34,15,3,61,21,40,0,0,25,13,12
"2021","Solihull 023D","E01010217",630,149,93,56,454,75,260,79,127,54,68,39,26,3,48,26,22,3,3,27,11,16
"2021","Solihull 024A","E01010190",668,181,92,89,463,85,284,96,134,54,50,31,16,3,43,23,20,1,1,24,11,13
"2021","Solihull 024B","E01010193",475,71,44,27,393,92,250,79,114,57,22,10,11,1,29,14,15,0,0,11,5,6
"2021","Solihull 024C","E01010194",649,150,73,77,478,86,283,92,132,59,38,22,12,4,67,37,30,4,4,21,11,10
"2021","Solihull 024D","E01010207",585,168,106,62,396,82,235,69,107,59,34,16,15,3,44,18,26,1,1,21,10,11
"2021","Solihull 025A","E01010166",726,152,78,74,539,126,279,61,162,56,66,37,26,3,67,36,31,1,1,35,13,22
"2021","Solihull 025B","E01010168",788,249,151,98,512,88,298,109,133,56,67,38,25,4,58,33,25,1,1,27,9,18
"2021","Solihull 025C","E01010169",715,191,116,75,495,120,266,89,127,50,59,27,25,7,48,25,23,2,2,29,16,13
"2021","Solihull 025D","E01010170",559,88,60,28,443,111,269,78,138,53,39,20,14,5,24,12,12,0,0,28,16,12
"2021","Solihull 025E","E01010171",550,124,77,47,403,95,228,69,106,53,43,21,18,4,37,25,12,0,0,23,15,8
"2021","Solihull 026A","E01010151",787,324,177,147,443,87,231,72,114,45,52,34,16,2,71,51,20,2,2,20,4,16
"2021","Solihull 026B","E01010152",499,88,64,24,398,93,249,82,130,37,29,13,15,1,26,11,15,1,1,13,6,7
"2021","Solihull 026C","E01010153",727,175,111,64,537,146,272,80,149,43,49,26,19,4,68,48,20,2,2,15,5,10
"2021","Solihull 026D","E01010154",671,169,124,45,481,170,249,77,127,45,29,15,13,1,31,17,14,2,2,21,12,9
"2021","Solihull 026E","E01010155",771,237,152,85,512,120,279,71,154,54,49,16,30,3,63,31,32,1,1,22,10,12
"2021","Solihull 026F","E01010156",620,146,110,36,453,122,273,75,137,61,22,13,8,1,34,14,20,2,2,21,14,7
"2021","Solihull 027A","E01010212",483,81,51,30,379,84,240,71,103,66,29,14,14,1,26,10,16,0,0,23,8,15
"2021","Solihull 027B","E01010214",503,135,75,60,356,77,201,76,96,29,37,28,7,2,40,17,23,1,1,12,1,11
"2021","Solihull 027C","E01010215",654,168,76,92,462,105,244,82,103,59,46,29,14,3,63,40,23,4,4,24,12,12
"2021","Solihull 027D","E01010216",612,165,59,106,424,68,248,71,133,44,49,33,15,1,59,36,23,0,0,23,14,9
"2021","Solihull 028A","E01010150",656,164,131,33,478,130,288,75,163,50,28,16,10,2,32,16,16,0,0,14,8,6
"2021","Solihull 028B","E01010184",696,245,130,115,430,72,206,53,126,27,57,21,31,5,92,69,23,3,3,21,13,8
"2021","Solihull 028C","E01010185",620,138,114,24,470,127,294,91,157,46,23,13,10,0,26,14,12,0,0,12,6,6
"2021","Solihull 028D","E01010186",784,226,140,86,543,96,300,74,179,47,62,43,15,4,81,48,33,4,4,15,6,9
"2021","Solihull 028E","E01010187",517,71,40,31,420,60,303,79,168,56,27,15,9,3,30,17,13,0,0,26,10,16
"2021","Solihull 028F","E01010188",709,165,129,36,525,138,313,101,153,59,43,19,23,1,29,19,10,2,2,19,7,12
"2021","Solihull 029A","E01010180",636,176,107,69,448,74,229,64,114,51,76,38,35,3,66,50,16,3,3,12,5,7
"2021","Solihull 029B","E01010181",1052,208,76,132,794,97,446,113,258,75,135,81,50,4,114,92,22,2,2,50,22,28
"2021","Solihull 029D","E01010183",742,133,58,75,579,112,298,81,150,67,99,71,27,1,70,54,16,0,0,30,14,16
"2021","Solihull 029E","E01010189",664,154,98,56,491,100,281,88,142,51,56,30,23,3,50,26,24,4,4,19,9,10
"2021","Solihull 029F","E01032885",862,412,31,381,416,14,158,57,87,14,160,141,19,0,77,57,20,7,7,34,7,27
"2021","Solihull 029G","E01032886",1095,261,47,214,788,61,451,125,261,65,144,82,58,4,128,87,41,4,4,46,23,23
"2021","Solihull 030A","E01010220",665,178,94,84,465,66,268,63,148,57,67,26,37,4,60,33,27,4,4,22,10,12
"2021","Solihull 030B","E01010223",476,119,74,45,329,33,181,50,96,35,49,18,30,1,63,38,25,3,3,28,16,12
"2021","Solihull 030C","E01010225",578,124,50,74,430,51,247,53,146,48,77,43,30,4,55,27,28,0,0,24,11,13
"2021","Solihull 030D","E01032590",963,314,137,177,582,90,326,94,163,69,96,61,32,3,64,38,26,6,6,67,35,32
"2021","Walsall 001A","E01010301",615,191,82,109,404,70,144,60,45,39,87,37,43,7,102,67,35,1,1,20,13,7
"2021","Walsall 001B","E01010303",633,153,75,78,451,76,209,86,76,47,86,39,38,9,79,44,35,1,1,29,18,11
"2021","Walsall 001C","E01010306",904,235,81,154,614,51,303,104,141,58,150,80,62,8,105,63,42,5,5,55,35,20
"2021","Walsall 001D","E01010307",680,156,68,88,491,53,289,80,138,71,98,47,45,6,48,32,16,3,3,33,14,19
"2021","Walsall 002A","E01010302",634,189,100,89,412,53,164,61,57,46,96,38,46,12,90,68,22,9,9,33,20,13
"2021","Walsall 002B","E01010304",733,212,119,93,495,118,210,75,81,54,98,40,47,11,68,46,22,1,1,26,16,10
"2021","Walsall 002C","E01010305",518,120,64,56,376,47,152,53,56,43,81,30,44,7,94,58,36,2,2,22,13,9
"2021","Walsall 002D","E01010308",880,402,163,239,446,48,161,60,64,37,102,43,48,11,131,96,35,4,4,32,17,15
"2021","Walsall 003A","E01010345",474,115,86,29,339,87,176,69,70,37,42,23,19,0,31,14,17,3,3,20,13,7
"2021","Walsall 003B","E01010346",517,111,55,56,380,88,191,70,72,49,59,17,35,7,38,12,26,4,4,26,11,15
"2021","Walsall 003C","E01010347",639,215,122,93,404,49,178,62,73,43,82,30,36,16,90,65,25,5,5,20,7,13
"2021","Walsall 003D","E01010350",579,129,70,59,438,55,231,78,97,56,86,50,31,5,64,37,27,2,2,12,7,5
"2021","Walsall 004A","E01010249",763,216,67,149,503,61,189,79,70,40,114,54,54,6,129,89,40,10,10,44,25,19
"2021","Walsall 004B","E01010250",577,149,77,72,402,81,173,60,72,41,78,35,38,5,69,45,24,1,1,26,12,14
"2021","Walsall 004C","E01010252",736,212,96,116,494,75,208,73,85,50,99,37,59,3,105,80,25,7,7,30,12,18
"2021","Walsall 004D","E01010254",614,193,97,96,388,48,202,67,91,44,61,27,28,6,75,41,34,2,2,33,13,20
"2021","Walsall 005A","E01010348",637,172,100,72,446,72,175,54,73,48,105,52,42,11,91,54,37,3,3,19,9,10
"2021","Walsall 005B","E01010349",614,256,150,106,335,65,137,47,53,37,65,27,33,5,66,34,32,2,2,23,10,13
"2021","Walsall 005C","E01010351",743,219,119,100,492,102,242,89,99,54,82,41,34,7,65,33,32,1,1,32,18,14
"2021","Walsall 005D","E01010352",684,186,134,52,460,121,229,92,88,49,49,21,21,7,57,27,30,4,4,38,17,21
"2021","Walsall 006A","E01010284",684,215,123,92,437,48,192,59,81,52,88,22,54,12,107,75,32,2,2,32,17,15
"2021","Walsall 006B","E01010285",746,181,106,75,521,101,246,76,100,70,103,50,43,10,70,33,37,1,1,44,22,22
"2021","Walsall 006C","E01010286",641,180,106,74,432,37,179,57,73,49,90,21,53,16,123,83,40,3,3,29,15,14
"2021","Walsall 006D","E01010290",774,279,148,131,476,85,183,64,73,46,84,35,40,9,119,72,47,5,5,19,5,14
"2021","Walsall 007A","E01010251",568,91,45,46,459,69,283,91,127,65,75,36,31,8,32,13,19,0,0,18,10,8
"2021","Walsall 007B","E01010253",524,157,80,77,344,62,148,56,61,31,63,26,27,10,65,40,25,6,6,23,10,13
"2021","Walsall 007C","E01010255",618,173,131,42,434,141,185,69,72,44,59,32,23,4,48,17,31,1,1,11,6,5
"2021","Walsall 007D","E01010256",707,247,107,140,437,73,192,71,80,41,90,48,35,7,76,34,42,6,6,23,6,17
"2021","Walsall 007E","E01010257",497,125,90,35,357,87,178,67,71,40,53,21,30,2,39,17,22,0,0,15,6,9
"2021","Walsall 008A","E01010292",931,405,144,261,483,53,178,65,75,38,144,85,47,12,102,65,37,6,6,43,15,28
"2021","Walsall 008B","E01010294",653,259,95,164,365,25,160,59,63,38,83,30,45,8,90,55,35,7,7,29,14,15
"2021","Walsall 008C","E01010296",621,151,71,80,454,74,244,95,95,54,89,42,38,9,39,21,18,8,8,16,7,9
"2021","Walsall 008D","E01010297",576,133,98,35,428,114,248,96,82,70,43,25,14,4,23,6,17,0,0,15,6,9
"2021","Walsall 009A","E01010291",546,132,68,64,379,35,133,34,61,38,89,20,61,8,117,79,38,5,5,35,23,12
"2021","Walsall 009B","E01010293",783,299,176,123,459,80,179,64,66,49,90,44,39,7,99,65,34,11,11,25,12,13
"2021","Walsall 009C","E01010298",486,120,54,66,336,45,143,47,56,40,77,27,35,15,69,39,30,2,2,30,14,16
"2021","Walsall 009D","E01010299",591,146,62,84,410,23,154,46,74,34,106,33,63,10,124,81,43,3,3,35,22,13
"2021","Walsall 009E","E01010300",622,186,97,89,406,40,143,54,51,38,97,34,54,9,118,71,47,8,8,30,18,12
"2021","Walsall 010A","E01010319",479,81,34,47,351,53,223,68,94,61,39,16,17,6,32,13,19,4,4,47,27,20
"2021","Walsall 010B","E01010321",636,179,96,83,416,42,186,58,81,47,92,37,49,6,94,50,44,2,2,41,24,17
"2021","Walsall 010C","E01010353",677,201,106,95,446,73,203,71,80,52,78,34,35,9,86,47,39,6,6,30,14,16
"2021","Walsall 010D","E01010354",651,160,97,63,463,87,198,64,73,61,76,28,41,7,99,58,41,3,3,28,15,13
"2021","Walsall 011A","E01010395",492,76,42,34,389,74,238,73,99,66,48,18,26,4,28,14,14,1,1,27,11,16
"2021","Walsall 011B","E01010397",615,126,59,67,458,47,192,56,82,54,97,18,67,12,120,85,35,2,2,31,21,10
"2021","Walsall 011C","E01010398",620,136,86,50,453,87,271,98,97,76,56,24,28,4,39,17,22,0,0,31,19,12
"2021","Walsall 011D","E01010399",630,153,64,89,455,77,211,81,80,50,92,36,47,9,74,51,23,1,1,22,16,6
"2021","Walsall 012A","E01010282",508,124,45,79,351,19,158,49,71,38,77,34,34,9,94,57,37,3,3,33,24,9
"2021","Walsall 012B","E01010287",724,270,119,151,419,46,188,62,84,42,96,37,45,14,78,42,36,11,11,35,17,18
"2021","Walsall 012C","E01010288",621,167,79,88,421,37,168,54,77,37,101,40,52,9,108,77,31,7,7,33,22,11
"2021","Walsall 012D","E01010289",715,174,84,90,499,47,175,46,93,36,99,30,61,8,172,131,41,6,6,42,25,17
"2021","Walsall 013B","E01010277",653,172,93,79,436,35,198,61,87,50,90,35,45,10,109,70,39,4,4,45,30,15
"2021","Walsall 013D","E01010283",673,179,51,128,448,22,167,39,98,30,117,31,80,6,138,103,35,4,4,46,25,21
"2021","Walsall 013F","E01033894",603,104,35,69,471,25,192,44,128,20,104,28,68,8,146,127,19,4,4,28,22,6
"2021","Walsall 013G","E01033895",557,91,32,59,424,14,176,49,104,23,105,39,58,8,125,95,30,4,4,42,26,16
"2021","Walsall 014A","E01010393",582,138,84,54,407,78,199,56,87,56,61,28,22,11,65,34,31,4,4,37,17,20
"2021","Walsall 014B","E01010394",514,112,62,50,367,72,179,57,83,39,59,17,36,6,56,31,25,1,1,35,21,14
"2021","Walsall 014C","E01010396",641,152,72,80,457,45,204,56,91,57,115,44,61,10,90,55,35,3,3,32,16,16
"2021","Walsall 014D","E01010400",959,337,118,219,589,63,160,59,66,35,160,53,98,9,196,146,50,10,10,33,16,17
"2021","Walsall 015A","E01010241",1113,456,262,194,621,154,284,116,116,52,93,56,33,4,88,38,50,2,2,36,10,26
"2021","Walsall 015B","E01010242",783,319,165,154,433,50,150,44,64,42,109,46,51,12,116,85,31,8,8,31,13,18
"2021","Walsall 015C","E01010243",691,233,169,64,443,106,211,66,91,54,59,28,27,4,65,36,29,2,2,15,4,11
"2021","Walsall 015D","E01010244",608,159,77,82,419,34,158,61,58,39,100,44,50,6,118,89,29,9,9,30,21,9
"2021","Walsall 016A","E01010320",584,181,78,103,376,52,143,56,47,40,76,37,33,6,104,64,40,1,1,27,13,14
"2021","Walsall 016B","E01010322",709,208,81,127,464,51,197,67,99,31,104,49,50,5,107,73,34,5,5,37,22,15
"2021","Walsall 016C","E01010323",620,182,100,82,399,76,185,57,76,52,68,28,32,8,68,35,33,2,2,39,27,12
"2021","Walsall 016D","E01010324",832,268,91,177,541,40,218,77,92,49,111,49,56,6,120,80,40,52,52,23,12,11
"2021","Walsall 017A","E01010271",793,202,68,134,551,38,230,72,108,50,115,37,67,11,165,126,39,3,3,40,26,14
"2021","Walsall 017B","E01010272",693,270,81,189,386,21,113,50,39,24,95,34,59,2,153,106,47,4,4,37,17,20
"2021","Walsall 017C","E01010273",604,179,86,93,384,35,115,36,41,38,103,31,58,14,131,90,41,0,0,41,31,10
"2021","Walsall 017D","E01010295",635,203,104,99,401,36,154,53,62,39,90,25,50,15,116,77,39,5,5,31,15,16
"2021","Walsall 018B","E01010279",789,229,89,140,514,40,235,85,127,23,93,34,50,9,143,103,40,3,3,46,35,11
"2021","Walsall 018D","E01010374",905,193,45,148,616,32,288,70,178,40,125,50,61,14,159,121,38,12,12,96,61,35
"2021","Walsall 018E","E01010375",731,175,39,136,453,13,246,44,165,37,58,21,34,3,121,83,38,15,15,103,81,22
"2021","Walsall 018F","E01032888",1017,275,127,148,671,51,290,82,134,74,125,46,62,17,198,143,55,7,7,71,45,26
"2021","Walsall 019A","E01010378",471,120,57,63,321,72,164,50,74,40,43,20,21,2,40,23,17,2,2,30,16,14
"2021","Walsall 019B","E01010379",565,156,99,57,394,104,185,69,61,55,62,26,30,6,42,16,26,1,1,15,8,7
"2021","Walsall 019C","E01010382",640,179,99,80,420,99,163,55,56,52,77,26,43,8,81,45,36,0,0,41,20,21
"2021","Walsall 019D","E01010383",747,300,121,179,412,34,146,46,72,28,105,36,63,6,125,81,44,2,2,35,19,16
"2021","Walsall 020A","E01010376",494,111,51,60,353,81,190,67,54,69,43,18,17,8,37,15,22,2,2,30,24,6
"2021","Walsall 020B","E01010377",727,185,80,105,516,49,226,71,109,46,136,64,68,4,99,59,40,6,6,26,13,13
"2021","Walsall 020C","E01010380",672,228,163,65,422,120,202,78,69,55,58,26,26,6,39,17,22,3,3,22,9,13
"2021","Walsall 020D","E01010381",675,214,79,135,444,62,170,67,63,40,86,30,49,7,123,61,62,3,3,17,13,4
"2021","Walsall 021A","E01010267",687,202,97,105,447,67,224,82,100,42,85,42,39,4,66,24,42,5,5,38,21,17
"2021","Walsall 021B","E01010268",563,135,38,97,365,21,190,19,136,35,49,19,27,3,97,67,30,8,8,63,45,18
"2021","Walsall 021C","E01010274",593,142,68,74,409,26,148,48,66,34,93,23,57,13,139,99,40,3,3,42,25,17
"2021","Walsall 021D","E01010275",740,205,107,98,500,42,197,64,86,47,93,29,60,4,159,110,49,9,9,35,18,17
"2021","Walsall 022A","E01010245",677,191,140,51,467,123,224,65,103,56,62,31,26,5,55,25,30,3,3,19,13,6
"2021","Walsall 022B","E01010246",633,152,93,59,455,68,254,76,109,69,72,30,32,10,59,22,37,2,2,26,14,12
"2021","Walsall 022C","E01010247",679,206,124,82,457,98,234,74,107,53,55,28,24,3,68,31,37,2,2,16,5,11
"2021","Walsall 022D","E01010248",633,138,101,37,465,98,284,86,132,66,45,20,19,6,34,14,20,4,4,30,21,9
"2021","Walsall 022E","E01010388",566,124,87,37,406,106,233,67,97,69,39,15,18,6,25,9,16,3,3,36,19,17
"2021","Walsall 023A","E01010258",730,244,113,131,465,46,169,52,75,42,75,23,48,4,167,113,54,8,8,21,13,8
"2021","Walsall 023B","E01010259",626,156,92,64,426,68,195,73,78,44,80,27,46,7,78,46,32,5,5,44,27,17
"2021","Walsall 023C","E01010260",714,191,81,110,490,53,232,61,129,42,86,34,48,4,115,79,36,4,4,33,19,14
"2021","Walsall 023D","E01010266",509,124,61,63,345,38,120,41,55,24,68,19,41,8,118,73,45,1,1,40,26,14
"2021","Walsall 024A","E01010317",685,205,118,87,433,123,240,88,93,59,37,20,12,5,31,14,17,2,2,47,25,22
"2021","Walsall 024B","E01010318",782,369,118,251,365,45,122,42,56,24,66,26,36,4,125,75,50,7,7,48,22,26
"2021","Walsall 024C","E01010325",774,253,71,182,458,63,238,66,119,53,75,44,28,3,76,40,36,6,6,63,40,23
"2021","Walsall 024D","E01010369",817,393,93,300,368,21,164,70,73,21,88,48,28,12,85,52,33,10,10,56,26,30
"2021","Walsall 025A","E01010401",662,171,71,100,455,54,164,49,78,37,102,38,60,4,131,66,65,4,4,36,21,15
"2021","Walsall 025B","E01010403",728,205,50,155,456,20,209,59,103,47,98,27,66,5,121,84,37,8,8,67,49,18
"2021","Walsall 025C","E01010404",803,230,68,162,521,36,184,46,96,42,120,54,57,9,174,97,77,7,7,52,29,23
"2021","Walsall 025D","E01010407",698,158,77,81,489,62,231,75,97,59,78,25,45,8,113,76,37,5,5,51,34,17
"2021","Walsall 025E","E01010408",736,235,62,173,454,22,182,66,78,38,110,52,54,4,132,87,45,8,8,47,28,19
"2021","Walsall 026A","E01010269",544,154,32,122,319,9,155,43,96,16,60,23,34,3,77,53,24,18,18,71,49,22
"2021","Walsall 026B","E01010270",649,194,68,126,392,46,194,48,97,49,54,24,24,6,92,58,34,6,6,63,41,22
"2021","Walsall 026C","E01010362",610,117,64,53,434,39,208,36,136,36,51,14,29,8,128,68,60,8,8,59,38,21
"2021","Walsall 026D","E01010363",1125,440,80,360,590,19,249,77,142,30,129,75,47,7,159,110,49,34,34,95,49,46
"2021","Walsall 027A","E01010402",665,161,69,92,443,49,243,76,113,54,83,30,49,4,64,43,21,4,4,61,38,23
"2021","Walsall 027B","E01010405",777,278,71,207,446,40,194,54,92,48,99,48,48,3,100,56,44,13,13,53,30,23
"2021","Walsall 027C","E01010406",1192,409,110,299,699,44,293,80,166,47,143,59,80,4,182,121,61,37,37,84,44,40
"2021","Walsall 027D","E01010409",629,169,69,100,415,55,151,47,57,47,92,35,47,10,114,73,41,3,3,45,26,19
"2021","Walsall 028A","E01010385",615,156,99,57,423,99,259,74,121,64,28,22,3,3,35,16,19,2,2,36,18,18
"2021","Walsall 028B","E01010386",715,244,198,46,446,134,229,63,124,42,40,22,12,6,40,21,19,3,3,25,14,11
"2021","Walsall 028C","E01010387",605,155,103,52,425,90,237,70,113,54,48,21,24,3,48,23,25,2,2,25,15,10
"2021","Walsall 028D","E01010392",629,169,90,79,436,90,240,81,113,46,60,27,28,5,43,16,27,3,3,24,13,11
"2021","Walsall 029A","E01010326",555,130,68,62,364,59,226,40,118,68,28,13,13,2,50,25,25,1,1,61,46,15
"2021","Walsall 029B","E01010327",581,161,55,106,356,14,188,33,115,40,53,25,25,3,96,64,32,5,5,64,45,19
"2021","Walsall 029C","E01010328",509,92,71,21,347,77,228,62,111,55,15,5,5,5,26,11,15,1,1,70,43,27
"2021","Walsall 029D","E01010330",617,258,92,166,303,32,152,48,78,26,51,32,15,4,62,40,22,6,6,56,41,15
"2021","Walsall 030A","E01010368",1177,661,131,530,451,22,157,47,88,22,133,96,34,3,121,74,47,18,18,65,39,26
"2021","Walsall 030B","E01010370",871,355,85,270,459,32,170,40,101,29,95,49,40,6,152,115,37,10,10,57,37,20
"2021","Walsall 030D","E01010372",602,191,66,125,344,30,172,48,91,33,53,29,20,4,83,53,30,6,6,67,35,32
"2021","Walsall 030E","E01010373",522,111,47,64,344,37,200,50,96,54,23,10,10,3,80,54,26,4,4,67,47,20
"2021","Walsall 030F","E01033896",658,288,51,237,306,4,135,36,87,12,45,25,19,1,113,91,22,9,9,64,45,19
"2021","Walsall 030G","E01033897",486,139,25,114,297,3,139,26,92,21,45,26,17,2,102,78,24,8,8,50,31,19
"2021","Walsall 031A","E01010361",572,143,56,87,388,36,207,68,90,49,43,32,10,1,93,49,44,9,9,41,20,21
"2021","Walsall 031B","E01010364",473,82,41,41,331,24,177,27,117,33,41,6,28,7,80,49,31,9,9,60,42,18
"2021","Walsall 031C","E01010365",672,250,75,175,370,17,193,44,121,28,39,24,15,0,115,96,19,6,6,52,31,21
"2021","Walsall 031D","E01010366",624,167,82,85,399,23,229,33,163,33,38,14,21,3,103,66,37,6,6,58,43,15
"2021","Walsall 031E","E01010367",621,144,76,68,398,33,238,48,152,38,46,15,25,6,75,52,23,6,6,79,45,34
"2021","Walsall 032A","E01010384",562,129,79,50,415,76,220,53,113,54,64,30,27,7,54,23,31,1,1,18,10,8
"2021","Walsall 032B","E01010389",577,130,78,52,401,105,228,70,100,58,36,16,17,3,31,12,19,1,1,46,26,20
"2021","Walsall 032C","E01010390",704,193,103,90,483,95,263,74,127,62,68,25,38,5,52,30,22,5,5,28,15,13
"2021","Walsall 032D","E01010391",754,175,101,74,540,96,280,85,134,61,87,40,41,6,74,36,38,3,3,39,19,20
"2021","Walsall 033A","E01010261",728,180,76,104,522,30,168,49,86,33,107,43,59,5,211,159,52,6,6,26,18,8
"2021","Walsall 033B","E01010263",533,137,31,106,338,27,202,42,109,51,36,11,23,2,69,44,25,4,4,58,43,15
"2021","Walsall 033C","E01010264",764,214,84,130,494,36,219,62,105,52,103,50,47,6,132,92,40,4,4,56,38,18
"2021","Walsall 033D","E01010265",700,178,42,136,448,21,214,33,136,45,71,27,42,2,135,96,39,7,7,74,51,23
"2021","Walsall 034A","E01010336",503,112,42,70,334,28,213,40,123,50,30,14,14,2,55,35,20,8,8,57,41,16
"2021","Walsall 034B","E01010340",581,176,50,126,340,17,173,25,119,29,28,12,16,0,119,87,32,3,3,65,44,21
"2021","Walsall 034C","E01010341",473,92,35,57,318,28,212,25,148,39,13,4,6,3,61,29,32,4,4,63,44,19
"2021","Walsall 034D","E01010342",517,87,29,58,350,6,214,27,162,25,30,10,20,0,95,65,30,5,5,80,56,24
"2021","Walsall 034E","E01010343",463,91,41,50,315,14,201,30,141,30,22,7,14,1,72,44,28,6,6,57,33,24
"2021","Walsall 034F","E01010344",583,139,71,68,387,26,223,35,155,33,37,19,16,2,93,58,35,8,8,57,41,16
"2021","Walsall 035A","E01010331",623,147,111,36,424,111,249,57,123,69,19,10,6,3,44,23,21,1,1,52,32,20
"2021","Walsall 035B","E01010332",649,127,76,51,399,97,243,55,124,64,15,10,2,3,40,19,21,4,4,123,82,41
"2021","Walsall 035C","E01010333",626,186,124,62,382,76,219,55,101,63,32,18,10,4,47,27,20,8,8,58,35,23
"2021","Walsall 035D","E01010334",573,125,100,25,385,89,242,65,113,64,19,8,11,0,32,13,19,3,3,63,39,24
"2021","Walsall 036A","E01010262",689,180,59,121,457,36,212,62,85,65,90,37,50,3,112,71,41,7,7,52,34,18
"2021","Walsall 036B","E01010309",884,315,67,248,521,40,247,56,150,41,81,24,52,5,146,102,44,7,7,48,23,25
"2021","Walsall 036C","E01010311",1071,290,109,181,722,42,311,82,180,49,121,48,67,6,240,181,59,8,8,59,41,18
"2021","Walsall 036D","E01010316",622,166,73,93,415,26,150,37,80,33,84,22,52,10,144,100,44,11,11,41,21,20
"2021","Walsall 037A","E01010335",598,157,81,76,397,27,182,39,108,35,60,18,35,7,118,79,39,10,10,44,33,11
"2021","Walsall 037B","E01010337",536,165,87,78,322,53,165,41,73,51,46,17,24,5,55,43,12,3,3,49,27,22
"2021","Walsall 037C","E01010338",535,96,49,47,353,29,212,37,135,40,34,18,11,5,73,40,33,5,5,86,69,17
"2021","Walsall 037D","E01010339",512,101,51,50,354,47,200,40,108,52,39,19,14,6,65,37,28,3,3,57,38,19
"2021","Walsall 038A","E01010310",764,148,54,94,556,38,252,77,119,56,127,49,70,8,130,82,48,9,9,60,37,23
"2021","Walsall 038B","E01010312",699,189,73,116,473,39,191,51,93,47,99,28,60,11,137,94,43,7,7,37,20,17
"2021","Walsall 038C","E01010313",544,111,54,57,387,39,171,48,82,41,61,13,39,9,111,82,29,5,5,46,29,17
"2021","Walsall 038D","E01010314",696,258,97,161,399,43,161,43,72,46,81,29,45,7,109,72,37,5,5,39,19,20
"2021","Walsall 038E","E01010315",782,178,80,98,567,42,212,58,125,29,144,56,77,11,164,126,38,5,5,37,21,16
"2021","Walsall 039A","E01010329",652,166,122,44,435,104,247,64,121,62,37,24,13,0,44,23,21,3,3,51,30,21
"2021","Walsall 039B","E01010355",598,169,110,59,409,69,217,55,103,59,66,27,29,10,55,26,29,2,2,20,12,8
"2021","Walsall 039C","E01010356",609,160,104,56,420,76,208,72,83,53,79,30,43,6,53,27,26,4,4,29,23,6
"2021","Walsall 039D","E01010357",965,250,96,154,679,89,332,102,170,60,124,65,48,11,133,90,43,1,1,36,23,13
"2021","Walsall 039E","E01010358",625,176,87,89,419,54,192,60,90,42,85,29,49,7,87,45,42,1,1,30,22,8
"2021","Walsall 039F","E01010359",636,178,94,84,429,61,198,54,95,49,91,42,45,4,76,48,28,3,3,29,18,11
"2021","Walsall 039G","E01010360",614,162,106,56,426,63,199,59,83,57,82,40,37,5,78,42,36,4,4,26,11,15
"2021","Wolverhampton 001A","E01010434",743,215,95,120,481,55,194,66,88,40,98,34,54,10,129,76,53,5,5,47,24,23
"2021","Wolverhampton 001B","E01010436",636,185,115,70,429,58,254,117,86,51,65,30,28,7,50,15,35,2,2,22,11,11
"2021","Wolverhampton 001C","E01010437",502,116,44,72,360,63,183,79,54,50,75,38,29,8,37,16,21,2,2,26,17,9
"2021","Wolverhampton 001D","E01010438",632,197,103,94,405,81,182,76,71,35,55,21,26,8,85,44,41,2,2,30,15,15
"2021","Wolverhampton 001E","E01010439",523,149,82,67,356,41,148,52,70,26,72,18,44,10,93,49,44,2,2,18,10,8
"2021","Wolverhampton 001F","E01010440",697,278,148,130,374,42,154,40,73,41,79,32,37,10,96,57,39,3,3,45,17,28
"2021","Wolverhampton 001G","E01010441",542,124,75,49,390,46,140,54,51,35,70,20,45,5,128,87,41,6,6,28,14,14
"2021","Wolverhampton 002A","E01010495",765,254,128,126,475,41,212,77,98,37,98,45,43,10,121,72,49,3,3,36,20,16
"2021","Wolverhampton 002B","E01010497",457,107,54,53,321,56,186,65,68,53,46,22,19,5,32,17,15,1,1,29,9,20
"2021","Wolverhampton 002C","E01010499",528,116,62,54,371,36,190,53,86,51,61,27,27,7,79,42,37,5,5,41,32,9
"2021","Wolverhampton 002D","E01010500",508,113,39,74,342,25,142,38,74,30,46,10,28,8,124,91,33,5,5,53,34,19
"2021","Wolverhampton 003A","E01010496",628,233,100,133,365,22,152,49,60,43,71,33,32,6,117,76,41,3,3,30,15,15
"2021","Wolverhampton 003B","E01010498",653,243,83,160,389,44,204,108,54,42,85,47,33,5,51,21,30,5,5,21,12,9
"2021","Wolverhampton 003C","E01010541",623,257,92,165,336,33,125,30,62,33,59,29,26,4,117,71,46,2,2,30,19,11
"2021","Wolverhampton 003D","E01010543",555,161,47,114,363,25,136,48,66,22,81,23,55,3,115,81,34,6,6,31,20,11
"2021","Wolverhampton 004A","E01010456",495,71,30,41,392,13,98,26,50,22,68,8,48,12,208,152,56,5,5,32,17,15
"2021","Wolverhampton 004B","E01010457",649,169,82,87,436,65,224,75,100,49,60,25,30,5,80,45,35,7,7,44,21,23
"2021","Wolverhampton 004C","E01010462",636,217,91,126,369,15,159,46,75,38,60,23,33,4,129,81,48,6,6,50,34,16
"2021","Wolverhampton 004D","E01010481",526,119,58,61,366,31,143,30,69,44,65,17,39,9,119,83,36,8,8,41,26,15
"2021","Wolverhampton 005A","E01010555",692,262,111,151,404,37,147,56,59,32,81,29,42,10,135,91,44,4,4,26,14,12
"2021","Wolverhampton 005B","E01010556",594,166,69,97,413,52,193,66,66,61,93,41,46,6,74,52,22,1,1,15,11,4
"2021","Wolverhampton 005C","E01010557",622,157,107,50,441,110,199,75,74,50,74,34,35,5,55,27,28,3,3,24,11,13
"2021","Wolverhampton 005D","E01010559",648,232,91,141,391,45,145,53,54,38,99,44,47,8,96,54,42,6,6,25,10,15
"2021","Wolverhampton 005E","E01010560",788,304,144,160,456,58,172,62,69,41,103,47,50,6,118,76,42,5,5,28,12,16
"2021","Wolverhampton 006B","E01010501",584,167,67,100,389,49,172,66,71,35,75,28,37,10,90,52,38,3,3,28,17,11
"2021","Wolverhampton 006C","E01010502",521,143,70,73,337,28,194,48,87,59,55,28,24,3,56,28,28,4,4,41,25,16
"2021","Wolverhampton 006D","E01010503",571,238,84,154,299,22,125,47,49,29,68,36,29,3,82,51,31,2,2,34,18,16
"2021","Wolverhampton 006E","E01034310",410,108,47,61,281,7,99,22,58,19,64,27,34,3,108,80,28,3,3,21,13,8
"2021","Wolverhampton 006F","E01034311",848,185,27,158,602,19,314,86,193,35,168,93,74,1,93,61,32,8,8,61,37,24
"2021","Wolverhampton 007A","E01010482",487,98,57,41,341,35,105,27,44,34,59,11,41,7,138,98,40,4,4,48,35,13
"2021","Wolverhampton 007B","E01010483",548,142,78,64,373,15,108,24,57,27,78,17,53,8,171,116,55,1,1,33,19,14
"2021","Wolverhampton 007C","E01010484",497,110,57,53,356,28,117,34,53,30,63,15,40,8,143,106,37,5,5,31,15,16
"2021","Wolverhampton 007D","E01010485",815,210,78,132,558,22,197,41,131,25,90,21,66,3,240,190,50,9,9,47,33,14
"2021","Wolverhampton 008A","E01010458",752,264,107,157,449,35,175,56,72,47,102,46,46,10,134,92,42,3,3,39,20,19
"2021","Wolverhampton 008B","E01010459",604,157,69,88,401,48,209,54,94,61,70,26,37,7,74,42,32,0,0,46,23,23
"2021","Wolverhampton 008C","E01010460",631,172,88,84,410,59,221,62,91,68,64,24,28,12,66,35,31,0,0,49,23,26
"2021","Wolverhampton 008D","E01010461",606,150,97,53,417,62,259,81,109,69,49,21,25,3,47,19,28,0,0,39,21,18
"2021","Wolverhampton 008E","E01010566",734,235,133,102,459,49,220,59,103,58,85,24,44,17,100,62,38,5,5,40,26,14
"2021","Wolverhampton 009A","E01010539",647,181,59,122,438,29,202,57,100,45,90,43,39,8,110,64,46,7,7,28,16,12
"2021","Wolverhampton 009B","E01010540",640,225,119,106,383,106,196,66,94,36,55,33,21,1,26,13,13,0,0,32,15,17
"2021","Wolverhampton 009C","E01010542",643,171,67,104,434,41,214,66,110,38,80,34,40,6,96,51,45,3,3,38,18,20
"2021","Wolverhampton 009D","E01010544",600,150,92,58,402,81,207,66,89,52,57,34,18,5,56,25,31,1,1,48,33,15
"2021","Wolverhampton 009E","E01010545",655,146,60,86,471,70,238,70,113,55,79,36,39,4,80,36,44,4,4,38,23,15
"2021","Wolverhampton 010A","E01010554",613,185,107,78,399,82,180,56,69,55,63,32,29,2,73,35,38,1,1,29,15,14
"2021","Wolverhampton 010B","E01010558",663,172,116,56,448,104,214,76,80,58,57,28,25,4,72,34,38,1,1,43,27,16
"2021","Wolverhampton 010C","E01010562",705,269,121,148,394,71,143,49,59,35,78,29,41,8,96,70,26,6,6,42,27,15
"2021","Wolverhampton 010D","E01010563",655,266,126,140,359,43,140,44,55,41,67,23,42,2,107,75,32,2,2,30,15,15
"2021","Wolverhampton 010E","E01010567",642,203,78,125,403,40,156,54,56,46,94,25,59,10,110,64,46,3,3,36,22,14
"2021","Wolverhampton 011A","E01010478",514,135,33,102,317,10,149,30,97,22,40,15,23,2,104,71,33,14,14,62,33,29
"2021","Wolverhampton 011B","E01010479",577,123,54,69,398,46,168,35,83,50,64,21,36,7,115,77,38,5,5,56,38,18
"2021","Wolverhampton 011C","E01010480",512,123,47,76,346,18,154,43,78,33,96,21,72,3,76,49,27,2,2,43,27,16
"2021","Wolverhampton 011D","E01010486",626,169,64,105,418,17,149,27,90,32,77,28,40,9,167,121,46,8,8,39,28,11
"2021","Wolverhampton 012A","E01010474",613,158,100,58,398,45,176,50,74,52,79,22,45,12,94,65,29,4,4,57,28,29
"2021","Wolverhampton 012B","E01010561",618,149,108,41,435,86,233,65,117,51,62,28,28,6,54,23,31,0,0,34,21,13
"2021","Wolverhampton 012C","E01010564",971,279,53,226,606,32,303,73,174,56,116,51,57,8,144,98,46,11,11,86,48,38
"2021","Wolverhampton 012D","E01010565",727,186,102,84,504,103,291,100,116,75,55,28,24,3,53,26,27,2,2,37,20,17
"2021","Wolverhampton 013A","E01010522",625,180,38,142,388,13,186,35,130,21,67,33,31,3,116,69,47,6,6,57,34,23
"2021","Wolverhampton 013B","E01010523",616,158,55,103,376,23,209,44,98,67,59,23,33,3,74,43,31,11,11,82,41,41
"2021","Wolverhampton 013C","E01010524",668,234,58,176,374,16,191,31,118,42,72,13,53,6,91,49,42,4,4,60,34,26
"2021","Wolverhampton 013D","E01010525",651,127,35,92,452,13,195,35,135,25,73,28,41,4,128,84,44,43,43,72,33,39
"2021","Wolverhampton 014A","E01010546",599,124,66,58,422,101,263,74,119,70,30,14,13,3,26,10,16,2,2,53,33,20
"2021","Wolverhampton 014B","E01010547",767,336,225,111,411,128,160,68,63,29,54,31,21,2,64,38,26,5,5,20,11,9
"2021","Wolverhampton 014C","E01010548",724,314,212,102,386,91,143,52,64,27,59,24,30,5,90,53,37,3,3,24,12,12
"2021","Wolverhampton 014D","E01010549",635,178,95,83,424,73,188,57,81,50,71,28,38,5,89,49,40,3,3,33,21,12
"2021","Wolverhampton 014E","E01010553",644,169,100,69,433,88,228,66,105,57,67,38,24,5,48,27,21,2,2,42,23,19
"2021","Wolverhampton 015A","E01010471",833,393,94,299,382,20,171,40,104,27,57,26,26,5,122,82,40,12,12,58,38,20
"2021","Wolverhampton 015B","E01010472",1012,295,62,233,628,10,241,46,154,41,88,47,36,5,258,197,61,31,31,89,53,36
"2021","Wolverhampton 015C","E01010473",965,462,81,381,449,15,176,34,126,16,83,28,51,4,163,115,48,12,12,54,33,21
"2021","Wolverhampton 015D","E01010475",645,183,66,117,399,59,186,64,82,40,75,34,34,7,70,35,35,9,9,63,29,34
"2021","Wolverhampton 015E","E01010476",874,331,118,213,480,32,178,49,107,22,81,33,38,10,174,124,50,15,15,63,33,30
"2021","Wolverhampton 015F","E01010477",690,236,83,153,399,18,167,45,91,31,62,22,39,1,143,91,52,9,9,55,31,24
"2021","Wolverhampton 016A","E01010526",496,124,20,104,302,14,138,20,91,27,46,17,24,5,96,64,32,8,8,70,32,38
"2021","Wolverhampton 016B","E01010527",705,246,82,164,360,16,183,44,114,25,47,18,21,8,103,66,37,11,11,99,45,54
"2021","Wolverhampton 016C","E01010528",491,268,45,223,171,2,64,11,45,8,40,29,11,0,54,34,20,11,11,52,18,34
"2021","Wolverhampton 016D","E01010529",670,259,32,227,288,11,122,17,80,25,29,12,15,2,89,59,30,37,37,123,44,79
"2021","Wolverhampton 017A","E01010506",829,455,65,390,322,19,131,48,57,26,74,55,16,3,91,67,24,7,7,52,23,29
"2021","Wolverhampton 017B","E01010508",818,472,71,401,303,11,115,27,44,44,110,54,56,0,64,40,24,3,3,43,19,24
"2021","Wolverhampton 017C","E01010510",725,318,75,243,353,33,155,53,71,31,65,50,14,1,95,48,47,5,5,54,29,25
"2021","Wolverhampton 017D","E01010511",670,217,47,170,359,16,179,33,114,32,47,26,20,1,104,66,38,13,13,94,47,47
"2021","Wolverhampton 017E","E01010512",617,244,68,176,316,22,144,56,62,26,62,31,29,2,83,63,20,5,5,57,21,36
"2021","Wolverhampton 018A","E01010442",534,164,57,107,332,39,121,33,54,34,52,19,30,3,108,62,46,12,12,38,30,8
"2021","Wolverhampton 018B","E01010443",627,188,62,126,416,25,140,30,77,33,91,23,53,15,159,120,39,1,1,23,14,9
"2021","Wolverhampton 018C","E01010444",554,177,85,92,331,63,146,58,48,40,52,27,19,6,65,38,27,5,5,46,26,20
"2021","Wolverhampton 018D","E01010445",489,102,34,68,339,18,119,17,77,25,50,12,31,7,147,96,51,5,5,48,29,19
"2021","Wolverhampton 018E","E01010447",850,359,111,248,452,42,214,54,109,51,94,35,52,7,97,63,34,5,5,39,21,18
"2021","Wolverhampton 018F","E01010448",757,279,139,140,446,45,169,58,73,38,78,28,42,8,149,95,54,5,5,32,19,13
"2021","Wolverhampton 019A","E01010509",729,287,113,174,407,49,152,50,76,26,78,43,32,3,123,83,40,5,5,35,16,19
"2021","Wolverhampton 019B","E01010550",655,144,95,49,465,121,268,89,105,74,47,32,11,4,29,13,16,0,0,46,25,21
"2021","Wolverhampton 019C","E01010551",774,311,153,158,426,103,201,77,84,40,65,43,20,2,54,25,29,3,3,37,23,14
"2021","Wolverhampton 019D","E01010552",801,231,116,115,531,74,229,80,102,47,114,47,58,9,111,63,48,3,3,39,15,24
"2021","Wolverhampton 020A","E01010463",742,278,59,219,388,16,172,40,108,24,65,33,28,4,119,80,39,16,16,76,35,41
"2021","Wolverhampton 020B","E01010464",887,525,146,379,319,22,113,43,54,16,67,39,25,3,112,62,50,5,5,43,24,19
"2021","Wolverhampton 020C","E01010465",591,153,47,106,354,24,158,28,93,37,55,16,37,2,110,71,39,7,7,84,34,50
"2021","Wolverhampton 020D","E01010466",537,141,33,108,316,5,155,16,112,27,47,20,25,2,96,70,26,13,13,80,48,32
"2021","Wolverhampton 020E","E01010470",703,310,88,222,344,27,159,31,87,41,51,27,20,4,99,65,34,8,8,49,28,21
"2021","Wolverhampton 020G","E01034312",580,242,36,206,293,12,75,18,47,10,98,78,18,2,95,59,36,13,13,45,19,26
"2021","Wolverhampton 020H","E01034313",593,296,11,285,223,0,99,49,45,5,79,66,12,1,35,27,8,10,10,74,5,69
"2021","Wolverhampton 021A","E01010487",607,151,88,63,416,65,242,69,109,64,52,20,26,6,56,32,24,1,1,40,28,12
"2021","Wolverhampton 021B","E01010488",631,202,129,73,390,84,196,67,80,49,49,15,31,3,60,33,27,1,1,39,21,18
"2021","Wolverhampton 021C","E01010493",622,170,65,105,423,64,244,75,113,56,56,15,37,4,56,32,24,3,3,29,20,9
"2021","Wolverhampton 021D","E01010504",585,153,85,68,374,89,217,64,111,42,36,19,16,1,29,13,16,3,3,58,29,29
"2021","Wolverhampton 021E","E01010505",503,141,77,64,327,81,155,40,78,37,43,22,15,6,46,17,29,2,2,35,21,14
"2021","Wolverhampton 021F","E01010507",618,192,127,65,390,96,204,81,79,44,39,17,17,5,47,26,21,4,4,36,21,15
"2021","Wolverhampton 022A","E01010418",576,126,67,59,407,62,238,85,85,68,60,24,30,6,45,26,19,2,2,43,23,20
"2021","Wolverhampton 022B","E01010421",589,130,62,68,418,38,180,39,99,42,64,15,43,6,134,88,46,2,2,41,31,10
"2021","Wolverhampton 022C","E01010423",654,227,104,123,374,39,150,32,77,41,67,18,41,8,113,65,48,5,5,53,29,24
"2021","Wolverhampton 022D","E01010424",592,156,79,77,374,54,193,54,85,54,72,14,47,11,54,34,20,1,1,62,39,23
"2021","Wolverhampton 023A","E01010417",695,229,98,131,417,48,139,33,67,39,80,36,38,6,142,77,65,8,8,49,25,24
"2021","Wolverhampton 023B","E01010419",672,184,73,111,437,48,174,53,90,31,102,39,52,11,106,67,39,7,7,51,29,22
"2021","Wolverhampton 023C","E01010420",526,145,76,69,334,39,147,37,76,34,55,10,41,4,87,53,34,6,6,47,23,24
"2021","Wolverhampton 023D","E01010425",514,124,73,51,354,50,169,61,59,49,47,16,28,3,83,39,44,5,5,36,22,14
"2021","Wolverhampton 023E","E01010446",696,251,89,162,392,53,170,51,76,43,70,27,38,5,95,56,39,4,4,53,30,23
"2021","Wolverhampton 026A","E01010467",630,236,75,161,311,37,155,44,75,36,55,27,23,5,60,35,25,4,4,83,47,36
"2021","Wolverhampton 026B","E01010468",603,166,89,77,387,37,200,66,79,55,59,25,32,2,88,46,42,3,3,50,32,18
"2021","Wolverhampton 026C","E01010469",626,197,73,124,395,44,196,65,83,48,73,35,28,10,76,41,35,6,6,34,10,24
"2021","Wolverhampton 026D","E01010516",516,91,54,37,382,63,218,48,97,73,45,13,30,2,53,15,38,3,3,43,24,19
"2021","Wolverhampton 026E","E01010518",630,186,113,73,383,58,236,66,101,69,42,22,13,7,44,16,28,3,3,61,36,25
"2021","Wolverhampton 027A","E01010414",997,393,141,252,550,38,238,97,91,50,115,55,52,8,149,108,41,10,10,54,38,16
"2021","Wolverhampton 027B","E01010415",600,101,39,62,442,38,183,44,92,47,74,18,46,10,144,92,52,3,3,57,37,20
"2021","Wolverhampton 027C","E01010416",743,247,89,158,420,50,174,40,93,41,73,27,38,8,116,73,43,7,7,76,53,23
"2021","Wolverhampton 027D","E01010422",726,237,106,131,430,64,228,59,103,66,63,31,28,4,72,37,35,3,3,59,32,27
"2021","Wolverhampton 028A","E01010489",657,221,105,116,397,77,184,71,73,40,55,25,27,3,80,43,37,1,1,39,22,17
"2021","Wolverhampton 028B","E01010490",938,418,131,287,495,37,128,46,60,22,112,46,55,11,208,160,48,10,10,25,8,17
"2021","Wolverhampton 028C","E01010491",610,174,73,101,403,55,170,38,92,40,76,28,40,8,97,53,44,5,5,33,14,19
"2021","Wolverhampton 028D","E01010492",509,104,60,44,383,66,219,75,86,58,46,24,17,5,50,24,26,2,2,22,10,12
"2021","Wolverhampton 028E","E01010494",602,139,88,51,433,63,239,73,109,57,74,27,43,4,56,34,22,1,1,30,19,11
"2021","Wolverhampton 029A","E01010449",936,268,78,190,567,33,261,57,160,44,83,41,37,5,174,105,69,16,16,101,59,42
"2021","Wolverhampton 029B","E01010450",1067,335,99,236,645,38,284,84,158,42,136,70,56,10,176,126,50,11,11,87,56,31
"2021","Wolverhampton 029C","E01010451",789,189,46,143,542,37,239,70,106,63,131,74,50,7,125,79,46,10,10,58,37,21
"2021","Wolverhampton 029D","E01010452",680,228,94,134,405,27,144,33,77,34,78,33,38,7,154,100,54,2,2,47,32,15
"2021","Wolverhampton 029E","E01010455",1062,338,88,250,639,34,284,73,163,48,120,47,68,5,161,115,46,40,40,85,52,33
"2021","Wolverhampton 030A","E01010427",545,102,44,58,359,53,219,39,111,69,22,8,12,2,58,22,36,7,7,84,59,25
"2021","Wolverhampton 030B","E01010431",468,73,41,32,303,38,204,32,90,82,9,1,6,2,44,11,33,8,8,92,62,30
"2021","Wolverhampton 030C","E01010432",504,120,56,64,312,40,209,38,91,80,17,5,11,1,44,11,33,2,2,72,48,24
"2021","Wolverhampton 030D","E01010519",561,150,66,84,344,59,176,43,74,59,51,26,20,5,55,32,23,3,3,67,39,28
"2021","Wolverhampton 030E","E01010520",662,156,96,60,457,92,252,82,110,60,45,25,20,0,62,26,36,6,6,49,30,19
"2021","Wolverhampton 031A","E01010513",631,205,140,65,395,98,222,62,107,53,41,25,15,1,34,12,22,0,0,31,19,12
"2021","Wolverhampton 031B","E01010514",646,153,72,81,460,70,261,72,132,57,73,38,30,5,50,29,21,6,6,33,22,11
"2021","Wolverhampton 031C","E01010515",674,160,88,72,482,83,253,90,111,52,77,30,42,5,68,41,27,1,1,32,20,12
"2021","Wolverhampton 031D","E01010517",655,185,80,105,418,47,243,71,117,55,42,16,20,6,79,45,34,7,7,52,31,21
"2021","Wolverhampton 032A","E01010533",692,213,78,135,433,25,192,43,105,44,75,22,48,5,135,91,44,6,6,46,31,15
"2021","Wolverhampton 032B","E01010535",620,175,76,99,402,36,165,43,81,41,63,20,34,9,132,85,47,6,6,43,25,18
"2021","Wolverhampton 032C","E01010536",625,136,104,32,440,86,247,71,107,69,47,12,27,8,58,21,37,2,2,49,34,15
"2021","Wolverhampton 032D","E01010537",660,214,133,81,427,112,210,77,79,54,59,29,23,7,46,16,30,0,0,19,14,5
"2021","Wolverhampton 033A","E01010410",1049,342,114,228,658,52,257,73,138,46,156,65,80,11,184,128,56,9,9,49,20,29
"2021","Wolverhampton 033B","E01010411",796,174,71,103,568,39,304,78,163,63,110,45,54,11,114,76,38,1,1,54,31,23
"2021","Wolverhampton 033C","E01010412",836,242,85,157,529,62,221,74,107,40,112,39,67,6,127,84,43,7,7,65,38,27
"2021","Wolverhampton 033D","E01010413",691,209,110,99,438,51,167,54,74,39,92,33,49,10,122,67,55,6,6,44,28,16
"2021","Wolverhampton 034A","E01010531",712,222,93,129,444,66,162,43,76,43,91,36,48,7,122,75,47,3,3,46,24,22
"2021","Wolverhampton 034B","E01010532",667,201,83,118,426,38,170,50,76,44,93,29,55,9,121,81,40,4,4,40,20,20
"2021","Wolverhampton 034C","E01010534",477,70,25,45,322,39,213,44,84,85,24,12,12,0,44,20,24,2,2,85,54,31
"2021","Wolverhampton 034D","E01010538",622,155,77,78,435,55,216,75,78,63,61,15,38,8,101,57,44,2,2,32,20,12
"2021","Wolverhampton 035A","E01010426",541,170,54,116,311,40,152,44,56,52,46,25,20,1,62,31,31,11,11,60,32,28
"2021","Wolverhampton 035B","E01010428",547,128,51,77,336,13,171,17,108,46,33,13,18,2,90,59,31,29,29,83,54,29
"2021","Wolverhampton 035C","E01010429",476,134,46,88,291,26,159,24,90,45,25,7,16,2,78,47,31,3,3,51,36,15
"2021","Wolverhampton 035D","E01010430",688,213,68,145,394,32,186,34,108,44,45,15,21,9,120,66,54,11,11,81,50,31
"2021","Wolverhampton 035E","E01010433",498,145,81,64,286,23,154,25,102,27,23,13,7,3,75,45,30,11,11,67,48,19
"2021","Wolverhampton 035G","E01010454",623,167,65,102,388,26,184,31,104,49,51,19,26,6,114,55,59,13,13,68,39,29
"2021","Wolverhampton 035H","E01010530",660,145,33,112,430,9,210,44,131,35,63,21,34,8,135,98,37,13,13,85,44,41
"2021","Wolverhampton 035I","E01034314",643,128,46,82,468,16,188,43,120,25,99,53,41,5,164,130,34,1,1,47,24,23
"2021","Wolverhampton 035J","E01034315",431,98,44,54,286,15,152,29,94,29,37,14,20,3,73,47,26,9,9,47,30,17
"2021","Peterborough 001A","E01015629",699,143,87,56,529,125,273,94,117,62,77,29,43,5,53,30,23,1,1,27,15,12
"2021","Peterborough 001B","E01015635",650,135,98,37,485,132,254,102,102,50,62,29,30,3,37,25,12,0,0,30,13,17
"2021","Peterborough 001C","E01015636",483,100,64,36,363,93,192,90,69,33,41,26,13,2,36,20,16,1,1,20,9,11
"2021","Peterborough 001D","E01015679",840,314,129,185,493,72,259,125,80,54,90,58,29,3,69,43,26,3,3,33,13,20
"2021","Peterborough 002A","E01015678",567,159,56,103,378,39,208,82,91,35,68,36,26,6,62,38,24,1,1,30,16,14
"2021","Peterborough 002B","E01015680",626,184,52,132,405,20,146,43,70,33,91,39,43,9,144,89,55,4,4,37,18,19
"2021","Peterborough 002C","E01015681",598,113,49,64,459,65,269,101,103,65,76,42,25,9,46,25,21,3,3,26,14,12
"2021","Peterborough 002D","E01015682",682,245,93,152,411,41,217,89,88,40,87,57,26,4,60,38,22,6,6,26,11,15
"2021","Peterborough 003A","E01015630",783,174,65,109,571,77,264,85,134,45,125,59,56,10,104,81,23,1,1,38,20,18
"2021","Peterborough 003B","E01015631",594,123,66,57,435,80,240,83,112,45,71,39,27,5,44,32,12,0,0,36,14,22
"2021","Peterborough 003C","E01015659",840,236,76,160,573,51,273,110,105,58,144,83,56,5,102,61,41,3,3,31,14,17
"2021","Peterborough 003D","E01015684",618,162,121,41,432,148,209,96,64,49,47,24,22,1,24,7,17,4,4,24,11,13
"2021","Peterborough 003E","E01015685",706,195,120,75,487,136,231,111,70,50,76,38,28,10,43,16,27,1,1,24,11,13
"2021","Peterborough 004A","E01015589",777,157,98,59,582,117,342,114,175,53,73,35,30,8,50,37,13,0,0,38,15,23
"2021","Peterborough 004B","E01015590",643,171,91,80,447,94,262,95,130,37,47,34,13,0,43,29,14,1,1,25,10,15
"2021","Peterborough 004C","E01015626",524,117,16,101,382,11,229,71,142,16,74,45,27,2,68,56,12,0,0,25,12,13
"2021","Peterborough 004D","E01015628",763,204,76,128,524,75,262,118,119,25,114,60,49,5,70,50,20,3,3,35,11,24
"2021","Peterborough 005A","E01015617",627,169,61,108,429,68,222,92,97,33,78,52,21,5,59,41,18,2,2,29,13,16
"2021","Peterborough 005B","E01015618",535,117,59,58,385,50,201,86,78,37,65,33,26,6,64,43,21,5,5,33,14,19
"2021","Peterborough 005C","E01015619",973,306,146,160,596,92,245,98,111,36,123,62,50,11,128,76,52,8,8,71,36,35
"2021","Peterborough 005D","E01015620",916,222,98,124,656,124,350,136,159,55,100,52,46,2,82,54,28,0,0,38,13,25
"2021","Peterborough 006A","E01015674",667,209,100,109,414,34,171,58,84,29,89,35,46,8,118,71,47,2,2,44,22,22
"2021","Peterborough 006B","E01015675",689,200,96,104,440,67,218,81,87,50,76,39,35,2,74,49,25,5,5,49,21,28
"2021","Peterborough 006C","E01015676",825,244,74,170,530,63,233,81,119,33,121,62,52,7,108,74,34,5,5,51,28,23
"2021","Peterborough 006D","E01015683",864,303,211,92,529,154,243,108,83,52,68,32,28,8,61,27,34,3,3,32,14,18
"2021","Peterborough 006E","E01015686",714,228,139,89,461,158,195,91,71,33,66,34,22,10,41,23,18,1,1,25,12,13
"2021","Peterborough 007A","E01015607",761,247,87,160,449,29,162,54,88,20,94,47,43,4,150,115,35,14,14,65,36,29
"2021","Peterborough 007B","E01015609",669,153,32,121,443,20,153,36,102,15,100,32,58,10,162,136,26,8,8,73,43,30
"2021","Peterborough 007C","E01015656",675,222,88,134,400,37,177,69,73,35,77,27,45,5,104,60,44,5,5,53,24,29
"2021","Peterborough 007E","E01015658",666,222,95,127,370,28,141,50,74,17,63,18,41,4,130,88,42,8,8,74,34,40
"2021","Peterborough 007F","E01015660",756,290,90,200,422,47,174,68,78,28,113,57,47,9,85,52,33,3,3,44,18,26
"2021","Peterborough 007G","E01035538",646,130,7,123,470,11,187,48,126,13,165,85,77,3,105,86,19,2,2,46,27,19
"2021","Peterborough 007H","E01035539",645,174,43,131,396,14,151,36,100,15,90,27,58,5,132,97,35,9,9,75,43,32
"2021","Peterborough 008A","E01015605",639,176,98,78,387,39,183,41,102,40,66,22,38,6,95,65,30,4,4,76,45,31
"2021","Peterborough 008B","E01015608",647,175,72,103,392,32,190,56,108,26,69,21,43,5,95,66,29,6,6,80,52,28
"2021","Peterborough 008C","E01015610",745,206,60,146,477,32,205,51,126,28,94,33,54,7,136,97,39,10,10,62,43,19
"2021","Peterborough 008D","E01015633",1003,311,158,153,617,69,266,86,131,49,102,36,53,13,167,113,54,13,13,75,44,31
"2021","Peterborough 008E","E01015634",759,243,117,126,424,32,209,49,136,24,72,26,38,8,100,69,31,11,11,92,56,36
"2021","Peterborough 009A","E01015593",623,169,74,95,382,31,139,39,69,31,83,38,39,6,120,84,36,9,9,72,34,38
"2021","Peterborough 009B","E01015596",610,134,60,74,398,31,156,44,79,33,83,24,56,3,117,88,29,11,11,78,32,46
"2021","Peterborough 009C","E01015662",480,80,29,51,313,15,143,30,87,26,50,13,29,8,97,57,40,8,8,87,47,40
"2021","Peterborough 009D","E01015663",687,242,88,154,386,24,149,36,88,25,56,21,29,6,147,100,47,10,10,59,34,25
"2021","Peterborough 009E","E01015664",659,194,54,140,393,23,163,41,94,28,79,22,52,5,123,83,40,5,5,72,37,35
"2021","Peterborough 010A","E01015603",821,195,66,129,460,21,222,42,140,40,84,34,43,7,109,82,27,24,24,166,100,66
"2021","Peterborough 010B","E01015604",534,68,17,51,323,6,175,24,123,28,33,17,14,2,91,62,29,18,18,143,93,50
"2021","Peterborough 010C","E01015632",716,192,53,139,412,17,201,54,122,25,63,24,33,6,116,80,36,15,15,112,64,48
"2021","Peterborough 010D","E01015661",620,166,60,106,371,52,160,34,90,36,70,31,33,6,82,52,30,7,7,83,50,33
"2021","Peterborough 010E","E01015677",518,171,45,126,307,18,126,46,60,20,73,34,33,6,80,53,27,10,10,40,19,21
"2021","Peterborough 011A","E01015591",596,148,85,63,383,79,204,81,80,43,57,22,25,10,39,20,19,4,4,65,27,38
"2021","Peterborough 011B","E01015592",634,188,91,97,384,56,164,63,76,25,72,31,38,3,87,56,31,5,5,62,39,23
"2021","Peterborough 011C","E01015594",921,267,92,175,567,53,240,70,141,29,115,67,44,4,142,96,46,17,17,87,36,51
"2021","Peterborough 011D","E01015595",713,278,103,175,375,44,161,44,86,31,71,27,41,3,93,70,23,6,6,60,31,29
"2021","Peterborough 011E","E01015597",649,153,49,104,417,26,147,45,81,21,79,25,44,10,157,115,42,8,8,79,48,31
"2021","Peterborough 012A","E01015601",588,107,36,71,303,13,168,27,112,29,43,21,22,0,66,44,22,13,13,178,125,53
"2021","Peterborough 012B","E01015651",659,113,49,64,419,44,253,62,148,43,60,27,31,2,59,34,25,3,3,127,91,36
"2021","Peterborough 012C","E01015652",640,120,39,81,386,18,240,44,164,32,42,15,24,3,80,46,34,6,6,134,84,50
"2021","Peterborough 012D","E01015653",656,156,78,78,406,57,213,77,109,27,54,27,21,6,72,46,26,10,10,94,59,35
"2021","Peterborough 012E","E01015654",914,257,95,162,474,20,224,47,141,36,80,34,41,5,124,96,28,26,26,183,104,79
"2021","Peterborough 013A","E01015606",737,200,85,115,453,64,220,71,103,46,79,39,33,7,86,61,25,4,4,84,55,29
"2021","Peterborough 013C","E01015613",654,205,84,121,398,56,154,60,79,15,72,29,40,3,108,90,18,8,8,51,31,20
"2021","Peterborough 013D","E01015614",865,225,53,172,572,27,236,73,128,35,149,74,70,5,150,118,32,10,10,68,36,32
"2021","Peterborough 013E","E01015615",739,219,104,115,435,51,197,52,115,30,58,25,30,3,119,80,39,10,10,85,49,36
"2021","Peterborough 013F","E01015616",788,233,81,152,456,19,188,43,123,22,82,46,32,4,145,103,42,22,22,99,60,39
"2021","Peterborough 013G","E01035540",610,211,77,134,322,27,139,47,71,21,54,34,18,2,93,68,25,9,9,77,40,37
"2021","Peterborough 013H","E01035541",629,219,63,156,341,7,157,47,97,13,80,51,27,2,88,63,25,9,9,69,31,38
"2021","Peterborough 014A","E01015599",1116,433,85,348,549,12,262,80,155,27,116,87,28,1,133,99,34,26,26,134,62,72
"2021","Peterborough 014B","E01015600",576,163,78,85,287,13,165,33,104,28,30,12,16,2,63,41,22,16,16,126,82,44
"2021","Peterborough 014D","E01015612",932,304,107,197,468,28,206,59,124,23,107,51,49,7,109,66,43,18,18,160,87,73
"2021","Peterborough 014E","E01015655",852,242,54,188,471,30,227,77,119,31,106,61,40,5,86,57,29,22,22,139,60,79
"2021","Peterborough 014F","E01035542",647,240,35,205,318,13,137,45,79,13,79,61,13,5,70,48,22,19,19,89,40,49
"2021","Peterborough 014G","E01035543",571,238,49,189,272,7,100,43,46,11,85,67,18,0,57,39,18,23,23,61,26,35
"2021","Peterborough 015A","E01015598",642,176,100,76,427,95,241,100,87,54,47,21,20,6,40,24,16,4,4,39,17,22
"2021","Peterborough 015B","E01015687",643,181,125,56,410,101,229,79,113,37,32,14,15,3,45,22,23,3,3,52,38,14
"2021","Peterborough 015C","E01015689",624,167,108,59,430,136,222,89,87,46,35,18,14,3,35,18,17,2,2,27,9,18
"2021","Peterborough 015D","E01015690",509,128,64,64,335,88,178,63,71,44,36,23,8,5,31,17,14,2,2,46,30,16
"2021","Peterborough 015E","E01015691",640,134,74,60,435,65,257,51,161,45,48,26,20,2,62,33,29,3,3,71,45,26
"2021","Peterborough 016A","E01015622",1140,370,93,277,662,22,304,102,164,38,179,105,68,6,141,107,34,16,16,108,38,70
"2021","Peterborough 016C","E01015665",585,157,60,97,328,23,189,41,120,28,43,22,18,3,63,41,22,10,10,100,68,32
"2021","Peterborough 016D","E01015688",1021,316,94,222,619,73,319,108,182,29,103,68,30,5,107,72,35,17,17,86,41,45
"2021","Peterborough 016E","E01015692",528,113,33,80,318,23,174,40,110,24,39,21,17,1,72,51,21,10,10,97,63,34
"2021","Peterborough 016F","E01033173",819,172,30,142,585,19,342,78,227,37,124,58,66,0,92,68,24,8,8,62,30,32
"2021","Peterborough 016G","E01033182",675,212,55,157,391,14,133,43,72,18,108,53,43,12,128,95,33,8,8,72,26,46
"2021","Peterborough 017B","E01015623",774,225,82,143,491,55,212,71,100,41,114,65,45,4,101,68,33,9,9,58,29,29
"2021","Peterborough 017C","E01015624",729,220,50,170,448,38,185,67,94,24,108,60,42,6,110,70,40,7,7,61,25,36
"2021","Peterborough 017D","E01015666",677,265,108,157,367,47,136,62,47,27,96,52,38,6,78,56,22,10,10,45,14,31
"2021","Peterborough 017E","E01015668",922,308,83,225,535,38,189,68,92,29,154,98,52,4,142,104,38,12,12,79,28,51
"2021","Peterborough 017F","E01035544",730,261,32,229,420,6,188,68,106,14,132,92,38,2,84,69,15,10,10,49,13,36
"2021","Peterborough 017G","E01035545",708,228,57,171,418,21,190,58,103,29,109,69,34,6,90,61,29,8,8,62,25,37
"2021","Peterborough 018A","E01015627",778,187,104,83,564,121,312,128,123,61,62,30,25,7,66,39,27,3,3,27,10,17
"2021","Peterborough 018B","E01015644",1019,233,56,177,713,60,383,139,199,45,155,82,67,6,109,80,29,6,6,73,42,31
"2021","Peterborough 018C","E01015645",775,264,139,125,475,73,228,91,102,35,100,55,37,8,70,52,18,4,4,36,9,27
"2021","Peterborough 018D","E01015646",891,279,175,104,585,180,298,135,108,55,64,46,16,2,40,17,23,3,3,27,6,21
"2021","Peterborough 018E","E01015648",601,148,103,45,433,127,250,110,92,48,38,29,9,0,17,6,11,1,1,20,6,14
"2021","Peterborough 019A","E01015667",642,222,111,111,390,47,166,62,79,25,98,54,39,5,75,50,25,4,4,30,15,15
"2021","Peterborough 019B","E01015669",630,167,92,75,427,82,195,73,85,37,69,25,39,5,77,47,30,4,4,36,12,24
"2021","Peterborough 019C","E01015670",603,164,107,57,400,86,183,58,76,49,60,19,36,5,66,37,29,5,5,39,15,24
"2021","Peterborough 019E","E01015672",643,175,92,83,426,86,218,67,104,47,58,33,21,4,61,35,26,3,3,42,18,24
"2021","Peterborough 019F","E01015673",652,196,92,104,415,49,170,71,73,26,78,30,41,7,114,74,40,4,4,41,21,20
"2021","Peterborough 019G","E01035546",599,151,81,70,409,67,215,93,78,44,76,40,30,6,50,22,28,1,1,39,15,24
"2021","Peterborough 019H","E01035547",605,106,15,91,451,19,221,53,153,15,153,92,59,2,49,38,11,9,9,48,29,19
"2021","Peterborough 019I","E01035548",587,146,7,139,402,1,181,43,127,11,133,66,65,2,84,74,10,3,3,39,22,17
"2021","Peterborough 019J","E01035549",629,112,6,106,478,3,245,63,167,15,123,56,63,4,104,91,13,3,3,39,24,15
"2021","Peterborough 021A","E01015637",589,153,37,116,367,20,153,40,92,21,80,32,39,9,108,81,27,6,6,69,37,32
"2021","Peterborough 021B","E01015639",715,287,88,199,364,30,142,39,77,26,81,37,39,5,101,70,31,10,10,64,32,32
"2021","Peterborough 021C","E01015640",608,163,60,103,387,32,190,67,84,39,76,35,36,5,78,54,24,11,11,58,29,29
"2021","Peterborough 021D","E01015641",580,187,109,78,343,37,148,49,70,29,60,32,23,5,88,65,23,10,10,50,21,29
"2021","Peterborough 021E","E01015642",588,140,46,94,387,15,153,36,95,22,71,22,43,6,137,98,39,11,11,61,33,28
"2021","Peterborough 021F","E01015647",695,291,126,165,347,24,133,39,73,21,66,27,34,5,120,96,24,4,4,57,34,23
"2021","Peterborough 022A","E01015638",621,151,108,43,420,106,217,84,94,39,50,22,26,2,40,16,24,7,7,50,27,23
"2021","Peterborough 022B","E01015650",870,265,84,181,544,77,276,103,132,41,120,69,45,6,65,35,30,6,6,61,25,36
"2021","Peterborough 022C","E01033174",1131,379,98,281,675,38,265,68,176,21,220,135,82,3,142,110,32,10,10,77,33,44
"2021","Peterborough 022D","E01033179",1166,259,65,194,835,63,391,112,242,37,221,107,110,4,151,107,44,9,9,72,39,33
"2021","Peterborough 022E","E01033181",595,99,21,78,435,15,268,80,157,31,73,31,33,9,76,54,22,3,3,61,28,33
"2021","Peterborough 023A","E01015643",599,183,59,124,369,45,170,73,73,24,67,34,29,4,85,61,24,2,2,47,28,19
"2021","Peterborough 023B","E01033175",548,111,27,84,395,16,241,48,155,38,75,30,40,5,63,40,23,0,0,42,21,21
"2021","Peterborough 023D","E01033177",633,131,20,111,438,14,244,49,173,22,90,41,45,4,85,67,18,5,5,64,33,31
"2021","Peterborough 023F","E01033180",609,119,3,116,433,7,212,27,166,19,94,37,56,1,113,89,24,7,7,57,34,23
"2021","Peterborough 023G","E01035551",591,133,14,119,392,9,225,70,131,24,93,46,44,3,59,45,14,6,6,66,33,33
"2021","Peterborough 023H","E01035552",626,93,5,88,498,7,273,67,196,10,179,112,62,5,35,29,6,4,4,35,23,12
"2021","Peterborough 023I","E01035553",496,109,4,105,331,6,151,22,111,18,55,23,28,4,113,95,18,6,6,56,26,30
"2021","Peterborough 023J","E01035554",514,64,3,61,404,3,249,38,201,10,83,44,37,2,65,53,12,4,4,46,30,16
"2021","Luton 001A","E01015706",608,205,119,86,360,73,205,68,86,51,40,22,14,4,40,27,13,2,2,43,26,17
"2021","Luton 001B","E01015707",600,146,68,78,416,78,215,67,107,41,76,41,29,6,46,28,18,1,1,38,22,16
"2021","Luton 001C","E01015708",517,115,65,50,360,62,240,63,108,69,37,21,13,3,15,7,8,6,6,42,21,21
"2021","Luton 001D","E01015709",624,205,80,125,379,60,195,62,90,43,67,41,22,4,51,32,19,6,6,40,18,22
"2021","Luton 001E","E01015710",652,222,86,136,387,51,205,55,107,43,75,40,29,6,52,32,20,4,4,43,26,17
"2021","Luton 001F","E01015770",501,97,53,44,359,95,169,49,81,39,37,9,24,4,53,15,38,5,5,45,30,15
"2021","Luton 002A","E01015801",797,204,72,132,545,32,190,49,102,39,77,29,41,7,235,177,58,11,11,48,19,29
"2021","Luton 002B","E01015803",609,117,62,55,446,77,237,70,114,53,66,28,33,5,58,30,28,8,8,46,22,24
"2021","Luton 002C","E01015804",714,157,51,106,514,42,255,63,138,54,67,28,35,4,144,99,45,6,6,43,25,18
"2021","Luton 002D","E01015805",491,112,71,41,345,61,192,48,91,53,32,9,19,4,53,17,36,7,7,34,23,11
"2021","Luton 003A","E01015769",503,153,75,78,313,28,160,41,93,26,45,20,18,7,74,51,23,6,6,37,20,17
"2021","Luton 003B","E01015771",586,172,58,114,369,15,147,26,101,20,45,7,33,5,156,115,41,6,6,45,25,20
"2021","Luton 003C","E01015772",595,177,60,117,354,21,137,24,82,31,42,20,17,5,147,110,37,7,7,64,40,24
"2021","Luton 003D","E01015773",456,113,30,83,298,14,129,17,72,40,40,11,25,4,107,67,40,8,8,45,30,15
"2021","Luton 003E","E01015774",514,116,37,79,353,13,154,29,99,26,51,22,25,4,130,91,39,5,5,45,25,20
"2021","Luton 003F","E01015802",608,167,63,104,389,36,160,31,97,32,49,12,30,7,139,94,45,5,5,52,27,25
"2021","Luton 004A","E01015744",644,226,56,170,375,15,197,49,112,36,58,24,23,11,98,57,41,7,7,43,19,24
"2021","Luton 004B","E01015746",622,168,88,80,407,73,195,54,96,45,54,26,23,5,76,44,32,9,9,47,26,21
"2021","Luton 004C","E01015747",475,71,53,18,346,84,203,58,77,68,22,12,7,3,31,5,26,6,6,58,42,16
"2021","Luton 004D","E01015748",741,245,155,90,439,88,193,56,91,46,73,24,38,11,79,37,42,6,6,57,33,24
"2021","Luton 005A","E01015749",714,163,35,128,468,17,219,34,115,70,59,19,36,4,168,117,51,5,5,83,65,18
"2021","Luton 005B","E01015751",730,193,59,134,457,44,247,48,150,49,45,16,22,7,116,62,54,5,5,80,50,30
"2021","Luton 005C","E01015752",485,101,54,47,324,30,172,37,100,35,36,13,20,3,82,42,40,4,4,60,39,21
"2021","Luton 005D","E01015753",657,211,60,151,392,42,207,61,109,37,56,33,20,3,80,48,32,7,7,54,36,18
"2021","Luton 005E","E01015754",799,319,172,147,429,31,190,39,115,36,59,26,27,6,143,89,54,6,6,51,30,21
"2021","Luton 005F","E01015755",680,212,129,83,398,69,216,48,124,44,46,19,22,5,61,29,32,6,6,70,40,30
"2021","Luton 006A","E01015764",595,136,91,45,406,83,220,60,106,54,36,16,18,2,62,23,39,5,5,53,39,14
"2021","Luton 006B","E01015765",710,219,61,158,423,32,233,65,117,51,52,20,23,9,96,61,35,10,10,68,40,28
"2021","Luton 006C","E01015766",550,102,44,58,397,35,248,48,145,55,28,11,14,3,80,32,48,6,6,51,35,16
"2021","Luton 006D","E01015767",603,135,63,72,415,59,247,68,127,52,27,14,8,5,76,35,41,6,6,53,32,21
"2021","Luton 006E","E01015768",577,133,80,53,393,68,216,51,111,54,34,14,17,3,70,34,36,5,5,51,30,21
"2021","Luton 006F","E01015783",539,94,30,64,363,21,225,29,156,40,29,7,14,8,82,42,40,6,6,82,47,35
"2021","Luton 006G","E01015785",916,242,79,163,592,22,303,56,201,46,82,45,32,5,164,126,38,21,21,82,48,34
"2021","Luton 007A","E01015693",529,70,40,30,404,50,284,62,173,49,32,9,19,4,37,14,23,1,1,55,30,25
"2021","Luton 007B","E01015694",493,107,71,36,305,43,205,39,126,40,15,10,4,1,42,17,25,0,0,81,52,29
"2021","Luton 007C","E01015695",496,60,30,30,367,34,258,51,158,49,18,7,9,2,52,25,27,5,5,69,52,17
"2021","Luton 007D","E01015696",503,90,23,67,381,26,203,55,116,32,71,46,22,3,78,54,24,3,3,32,23,9
"2021","Luton 007E","E01015697",639,141,74,67,447,52,257,57,129,71,64,41,20,3,69,42,27,5,5,51,29,22
"2021","Luton 007F","E01015745",545,119,79,40,358,66,227,50,116,61,25,11,10,4,35,16,19,5,5,68,46,22
"2021","Luton 008A","E01015797",525,115,86,29,387,99,212,64,76,72,42,13,24,5,33,18,15,1,1,23,10,13
"2021","Luton 008B","E01015798",540,151,78,73,334,37,159,40,76,43,49,20,24,5,85,32,53,4,4,55,30,25
"2021","Luton 008C","E01015799",576,131,72,59,419,72,223,88,93,42,74,30,36,8,47,20,27,3,3,26,12,14
"2021","Luton 008D","E01015800",618,174,69,105,402,49,205,56,103,46,76,33,32,11,66,37,29,6,6,42,24,18
"2021","Luton 008E","E01015812",520,109,55,54,379,53,213,66,95,52,66,33,27,6,44,25,19,3,3,32,16,16
"2021","Luton 008F","E01015813",722,382,184,198,303,39,143,58,62,23,64,40,17,7,52,31,21,5,5,37,18,19
"2021","Luton 009A","E01015756",691,182,62,120,465,19,243,66,139,38,79,34,39,6,113,67,46,11,11,44,27,17
"2021","Luton 009B","E01015757",617,174,97,77,375,33,191,45,103,43,39,13,22,4,105,50,55,7,7,68,42,26
"2021","Luton 009C","E01015758",528,94,27,67,380,11,182,40,110,32,61,19,37,5,119,64,55,7,7,54,34,20
"2021","Luton 009D","E01015759",611,210,110,100,355,20,198,33,130,35,34,11,19,4,93,45,48,10,10,46,31,15
"2021","Luton 009E","E01015760",590,242,63,179,301,20,147,22,92,33,47,19,18,10,84,46,38,3,3,47,34,13
"2021","Luton 009F","E01015761",610,119,64,55,418,30,221,45,142,34,53,16,31,6,108,57,51,6,6,73,47,26
"2021","Luton 010A","E01015700",796,156,59,97,492,37,302,40,224,38,42,17,22,3,98,81,17,13,13,148,109,39
"2021","Luton 010B","E01015701",525,68,20,48,320,12,223,24,163,36,8,2,4,2,68,43,25,9,9,137,104,33
"2021","Luton 010C","E01015704",580,74,25,49,425,5,306,56,201,49,34,14,15,5,77,43,34,3,3,81,60,21
"2021","Luton 010D","E01015782",655,107,51,56,419,41,288,37,205,46,24,7,16,1,58,33,25,8,8,129,102,27
"2021","Luton 010E","E01015784",540,43,19,24,340,14,252,26,185,41,20,8,9,3,50,29,21,4,4,157,121,36
"2021","Luton 010F","E01015786",595,72,29,43,399,19,308,78,186,44,23,12,9,2,47,22,25,2,2,124,97,27
"2021","Luton 011A","E01015711",541,114,56,58,324,20,223,22,158,43,22,9,11,2,51,24,27,8,8,103,70,33
"2021","Luton 011B","E01015712",632,150,82,68,393,36,251,42,163,46,35,20,13,2,59,30,29,12,12,89,61,28
"2021","Luton 011C","E01015715",626,107,28,79,403,16,220,23,165,32,22,8,11,3,134,61,73,11,11,116,80,36
"2021","Luton 011D","E01015716",674,161,41,120,391,10,206,39,136,31,46,14,25,7,128,92,36,1,1,122,98,24
"2021","Luton 011E","E01015717",506,93,39,54,338,23,209,36,153,20,26,8,16,2,66,33,33,14,14,75,43,32
"2021","Luton 011F","E01015750",762,135,41,94,484,17,297,49,212,36,55,15,36,4,99,58,41,16,16,143,104,39
"2021","Luton 012A","E01015740",606,180,50,130,348,29,191,44,108,39,66,38,25,3,53,38,15,9,9,78,36,42
"2021","Luton 012B","E01015775",813,253,96,157,507,54,250,72,132,46,93,44,41,8,102,71,31,8,8,53,29,24
"2021","Luton 012C","E01015776",728,175,93,82,465,69,225,58,124,43,77,25,44,8,88,51,37,6,6,88,43,45
"2021","Luton 012D","E01015777",728,184,55,129,472,49,201,53,109,39,76,43,27,6,137,91,46,9,9,72,37,35
"2021","Luton 012E","E01015778",673,157,49,108,428,36,227,56,132,39,75,38,36,1,83,44,39,7,7,88,48,40
"2021","Luton 012F","E01015796",650,237,132,105,361,61,189,72,70,47,59,36,17,6,51,26,25,1,1,52,25,27
"2021","Luton 013A","E01015713",521,126,70,56,316,45,189,34,116,39,18,8,10,0,58,22,36,6,6,79,47,32
"2021","Luton 013B","E01015714",682,155,86,69,444,52,245,53,141,51,31,15,14,2,100,65,35,16,16,83,53,30
"2021","Luton 013C","E01015718",582,165,94,71,367,51,211,51,119,41,37,18,12,7,60,27,33,8,8,50,24,26
"2021","Luton 013D","E01015762",679,134,59,75,451,57,272,67,141,64,50,27,18,5,60,27,33,12,12,94,49,45
"2021","Luton 013E","E01015763",627,194,108,86,374,60,197,44,112,41,48,22,20,6,68,27,41,1,1,59,36,23
"2021","Luton 014A","E01015721",662,163,65,98,436,43,220,66,125,29,96,61,31,4,67,31,36,10,10,63,28,35
"2021","Luton 014B","E01015722",560,150,53,97,347,28,179,43,99,37,54,21,25,8,82,53,29,4,4,63,29,34
"2021","Luton 014C","E01015806",583,134,36,98,416,33,237,105,87,45,87,50,35,2,51,26,25,8,8,33,13,20
"2021","Luton 014D","E01015808",622,191,59,132,396,24,213,71,100,42,97,59,34,4,57,38,19,5,5,35,13,22
"2021","Luton 014E","E01015809",512,84,45,39,377,73,214,63,87,64,49,22,22,5,40,23,17,1,1,51,32,19
"2021","Luton 014F","E01015810",512,93,19,74,391,28,189,55,83,51,65,29,31,5,104,63,41,5,5,28,17,11
"2021","Luton 014G","E01015811",581,139,43,96,405,58,204,66,94,44,88,50,38,0,49,29,20,6,6,37,23,14
"2021","Luton 015A","E01015703",467,60,20,40,252,10,174,13,119,42,7,2,5,0,47,24,23,14,14,155,120,35
"2021","Luton 015B","E01015726",589,77,18,59,373,10,230,21,170,39,32,10,17,5,91,57,34,10,10,139,98,41
"2021","Luton 015C","E01015731",552,82,30,52,348,7,231,29,174,28,31,11,20,0,73,51,22,6,6,122,93,29
"2021","Luton 015D","E01015787",752,185,25,160,449,15,282,56,192,34,35,17,16,2,103,69,34,14,14,118,75,43
"2021","Luton 015E","E01015788",473,56,22,34,250,21,173,24,108,41,3,1,1,1,43,19,24,10,10,167,133,34
"2021","Luton 016A","E01015719",895,281,61,220,523,53,264,91,129,44,128,93,31,4,62,37,25,16,16,91,40,51
"2021","Luton 016B","E01015720",622,193,40,153,354,12,174,40,102,32,51,15,28,8,111,67,44,6,6,75,40,35
"2021","Luton 016C","E01015723",503,109,38,71,315,33,175,44,94,37,46,22,20,4,59,35,24,2,2,79,37,42
"2021","Luton 016D","E01015779",505,91,40,51,354,39,143,31,77,35,46,13,24,9,119,61,58,7,7,60,38,22
"2021","Luton 016E","E01015780",630,143,68,75,410,47,223,53,135,35,70,25,37,8,66,42,24,4,4,77,41,36
"2021","Luton 016F","E01015781",540,113,42,71,344,18,188,28,112,48,45,16,22,7,88,50,38,5,5,83,39,44
"2021","Luton 016G","E01015807",613,129,46,83,438,36,212,50,132,30,63,28,29,6,120,68,52,7,7,46,22,24
"2021","Luton 017A","E01015698",556,185,26,159,313,7,215,31,154,30,34,15,19,0,48,29,19,9,9,58,31,27
"2021","Luton 017B","E01015699",786,326,38,288,378,19,192,42,135,15,58,43,12,3,102,61,41,7,7,82,45,37
"2021","Luton 017C","E01015702",469,84,28,56,291,9,215,19,165,31,17,6,9,2,40,23,17,10,10,94,73,21
"2021","Luton 017D","E01015705",486,94,14,80,323,6,190,39,131,20,32,17,12,3,88,70,18,7,7,69,51,18
"2021","Luton 017E","E01015725",493,79,35,44,337,7,242,18,196,28,19,3,14,2,67,46,21,2,2,77,57,20
"2021","Luton 017F","E01015727",570,103,15,88,328,7,241,25,196,20,23,10,13,0,43,20,23,14,14,139,90,49
"2021","Luton 019A","E01015724",742,153,28,125,459,12,310,46,220,44,52,28,20,4,72,45,27,13,13,130,75,55
"2021","Luton 019B","E01015728",515,89,35,54,341,22,202,30,140,32,30,13,11,6,80,57,23,7,7,85,65,20
"2021","Luton 019C","E01015729",704,208,24,184,331,12,180,52,107,21,42,30,11,1,64,44,20,33,33,165,81,84
"2021","Luton 019D","E01015730",767,176,40,136,460,10,262,32,210,20,52,31,18,3,121,90,31,15,15,131,68,63
"2021","Luton 020A","E01015732",596,110,35,75,405,21,177,28,114,35,49,8,36,5,142,96,46,16,16,81,53,28
"2021","Luton 020B","E01015733",628,125,71,54,417,30,206,22,143,41,37,9,19,9,132,71,61,12,12,86,62,24
"2021","Luton 020C","E01015734",722,169,87,82,456,42,226,62,131,33,93,35,52,6,78,42,36,17,17,97,35,62
"2021","Luton 020D","E01015735",775,263,32,231,420,6,204,41,144,19,74,44,25,5,116,78,38,20,20,92,33,59
"2021","Luton 020E","E01015736",758,276,113,163,407,14,208,38,137,33,66,25,37,4,111,78,33,8,8,75,48,27
"2021","Luton 020F","E01015737",488,86,34,52,322,24,185,27,121,37,31,11,14,6,78,42,36,4,4,80,51,29
"2021","Luton 021A","E01015738",871,335,45,290,444,29,186,47,105,34,79,51,23,5,101,71,30,49,49,92,29,63
"2021","Luton 021B","E01015790",595,147,58,89,365,24,199,56,107,36,64,25,32,7,65,36,29,13,13,83,37,46
"2021","Luton 021D","E01015792",730,208,40,168,387,8,167,48,95,24,78,45,31,2,119,90,29,15,15,135,39,96
"2021","Luton 021E","E01015793",662,194,58,136,369,34,216,65,106,45,57,33,23,1,52,30,22,10,10,99,41,58
"2021","Luton 021F","E01015795",1052,420,36,384,534,2,245,92,134,19,148,90,52,6,121,96,25,18,18,98,35,63
"2021","Luton 021G","E01033806",638,256,47,209,351,5,138,30,100,8,65,39,26,0,128,108,20,15,15,31,9,22
"2021","Luton 021H","E01033807",710,259,44,215,366,4,165,40,113,12,65,36,25,4,115,84,31,17,17,85,29,56
"2021","Luton 022A","E01015739",966,385,85,300,486,18,236,65,155,16,115,76,38,1,86,62,24,31,31,95,35,60
"2021","Luton 022B","E01015742",811,263,45,218,409,14,167,54,95,18,98,65,30,3,97,66,31,33,33,139,44,95
"2021","Luton 022E","E01015743",758,297,60,237,385,11,157,44,95,18,92,53,35,4,100,77,23,25,25,76,27,49
"2021","Luton 022C","E01033801",775,260,54,206,379,6,148,46,88,14,81,53,27,1,115,78,37,29,29,136,38,98
"2021","Luton 022D","E01033802",719,242,17,225,355,3,124,44,71,9,97,67,28,2,102,86,16,29,29,122,63,59
"2021","Luton 023D","E01015789",983,533,220,313,381,16,133,41,79,13,61,29,28,4,161,131,30,10,10,69,25,44
"2021","Luton 023A","E01033803",744,344,38,306,306,10,112,42,63,7,65,41,21,3,84,61,23,35,35,94,22,72
"2021","Luton 023B","E01033804",595,269,3,266,289,1,107,40,60,7,79,62,16,1,69,56,13,33,33,37,8,29
"2021","Luton 023C","E01033805",643,290,3,287,314,0,149,58,85,6,81,69,12,0,64,51,13,20,20,39,8,31
"2021","Southend-on-Sea 001A","E01015833",633,143,104,39,458,110,231,87,91,53,63,25,33,5,53,21,32,1,1,32,16,16
"2021","Southend-on-Sea 001B","E01015834",629,175,116,59,436,87,220,81,83,56,77,35,28,14,52,27,25,0,0,18,7,11
"2021","Southend-on-Sea 001C","E01015835",759,252,129,123,467,73,188,65,78,45,92,40,45,7,108,64,44,6,6,40,18,22
"2021","Southend-on-Sea 001D","E01015836",654,173,122,51,445,109,209,77,78,54,86,43,39,4,39,25,14,2,2,36,12,24
"2021","Southend-on-Sea 001E","E01015837",742,220,124,96,488,78,225,69,101,55,99,45,44,10,81,46,35,5,5,34,16,18
"2021","Southend-on-Sea 001F","E01015838",634,155,110,45,460,139,229,82,93,54,50,26,22,2,41,13,28,1,1,19,5,14
"2021","Southend-on-Sea 002A","E01015863",999,319,178,141,637,102,314,89,170,55,120,54,59,7,101,57,44,0,0,43,17,26
"2021","Southend-on-Sea 002B","E01015864",599,153,102,51,410,88,220,69,97,54,50,28,20,2,50,22,28,2,2,36,14,22
"2021","Southend-on-Sea 002C","E01015865",648,203,128,75,403,75,185,77,75,33,83,42,33,8,57,23,34,3,3,42,16,26
"2021","Southend-on-Sea 002D","E01015866",905,226,129,97,631,93,308,117,144,47,144,74,61,9,83,45,38,3,3,48,24,24
"2021","Southend-on-Sea 002E","E01015867",654,216,110,106,394,56,138,55,56,27,77,25,40,12,111,65,46,12,12,44,23,21
"2021","Southend-on-Sea 002F","E01015868",678,182,82,100,462,55,208,76,99,33,96,40,41,15,98,66,32,5,5,34,24,10
"2021","Southend-on-Sea 003A","E01015814",606,196,125,71,391,76,196,60,88,48,60,27,27,6,57,29,28,2,2,19,11,8
"2021","Southend-on-Sea 003B","E01015815",641,153,81,72,457,80,243,67,130,46,68,34,27,7,63,37,26,3,3,31,9,22
"2021","Southend-on-Sea 003C","E01015816",786,312,206,106,450,131,183,79,70,34,69,36,29,4,62,29,33,5,5,24,7,17
"2021","Southend-on-Sea 003D","E01015817",743,203,155,48,516,164,235,90,98,47,63,35,22,6,53,22,31,1,1,24,10,14
"2021","Southend-on-Sea 003E","E01015818",793,280,176,104,482,115,208,66,98,44,87,44,32,11,72,41,31,0,0,31,9,22
"2021","Southend-on-Sea 003F","E01015819",635,197,99,98,416,52,192,57,103,32,73,34,32,7,92,43,49,7,7,22,12,10
"2021","Southend-on-Sea 004A","E01015857",667,167,116,51,465,115,245,64,109,72,62,29,25,8,43,19,24,0,0,35,18,17
"2021","Southend-on-Sea 004B","E01015858",725,158,87,71,539,113,292,86,147,59,64,30,31,3,68,39,29,2,2,28,15,13
"2021","Southend-on-Sea 004C","E01015859",801,256,138,118,492,80,268,75,144,49,66,38,25,3,76,47,29,2,2,53,27,26
"2021","Southend-on-Sea 004D","E01015860",634,154,85,69,445,77,248,75,119,54,62,32,26,4,55,30,25,3,3,35,20,15
"2021","Southend-on-Sea 004E","E01015861",879,351,115,236,490,56,208,56,116,36,111,61,41,9,108,70,38,7,7,38,20,18
"2021","Southend-on-Sea 004F","E01015862",741,249,78,171,439,42,188,58,98,32,96,46,44,6,106,69,37,7,7,53,29,24
"2021","Southend-on-Sea 005A","E01015820",672,222,93,129,404,34,185,50,89,46,74,33,40,1,108,65,43,3,3,46,23,23
"2021","Southend-on-Sea 005B","E01015821",755,256,147,109,460,69,210,76,87,47,106,56,44,6,72,47,25,3,3,39,10,29
"2021","Southend-on-Sea 005C","E01015822",499,111,58,53,357,63,190,49,113,28,49,20,28,1,54,30,24,1,1,31,11,20
"2021","Southend-on-Sea 005D","E01015823",738,210,88,122,492,61,234,62,133,39,116,70,39,7,79,37,42,2,2,36,6,30
"2021","Southend-on-Sea 005E","E01015824",625,176,83,93,409,32,178,49,100,29,71,27,36,8,122,70,52,6,6,40,27,13
"2021","Southend-on-Sea 005F","E01015825",584,139,79,60,399,68,202,46,119,37,77,33,40,4,52,25,27,0,0,46,34,12
"2021","Southend-on-Sea 005G","E01015826",572,137,90,47,414,68,204,53,99,52,74,28,41,5,64,34,30,4,4,21,10,11
"2021","Southend-on-Sea 006A","E01015869",638,155,64,91,444,36,206,75,93,38,90,35,47,8,103,61,42,9,9,39,19,20
"2021","Southend-on-Sea 006B","E01015870",651,181,65,116,434,36,195,51,109,35,101,47,45,9,100,67,33,2,2,36,15,21
"2021","Southend-on-Sea 006C","E01015871",649,151,83,68,462,70,225,71,98,56,88,37,41,10,75,41,34,4,4,36,16,20
"2021","Southend-on-Sea 006D","E01015872",684,201,89,112,439,39,213,61,105,47,100,46,45,9,84,54,30,3,3,44,23,21
"2021","Southend-on-Sea 006E","E01015873",542,167,61,106,345,17,147,49,73,25,88,48,34,6,93,66,27,0,0,30,5,25
"2021","Southend-on-Sea 006F","E01015874",739,223,85,138,474,46,224,65,102,57,108,50,49,9,92,47,45,4,4,42,18,24
"2021","Southend-on-Sea 006G","E01015875",731,268,92,176,430,36,170,53,76,41,75,37,32,6,146,90,56,3,3,33,15,18
"2021","Southend-on-Sea 007A","E01015901",651,207,61,146,390,16,178,49,100,29,84,38,40,6,108,78,30,4,4,54,25,29
"2021","Southend-on-Sea 007B","E01015902",699,230,48,182,399,11,160,57,74,29,105,66,36,3,116,77,39,7,7,70,25,45
"2021","Southend-on-Sea 007C","E01015903",673,197,61,136,426,27,179,46,103,30,88,36,45,7,127,75,52,5,5,50,22,28
"2021","Southend-on-Sea 007D","E01015904",740,246,63,183,454,30,222,68,119,35,97,46,46,5,100,64,36,5,5,40,16,24
"2021","Southend-on-Sea 007E","E01015905",621,182,53,129,401,24,182,59,92,31,116,58,51,7,75,42,33,4,4,38,11,27
"2021","Southend-on-Sea 007F","E01015906",612,183,48,135,387,17,176,48,97,31,103,50,46,7,86,54,32,5,5,42,14,28
"2021","Southend-on-Sea 007G","E01015907",635,191,54,137,390,16,187,62,88,37,88,47,37,4,93,64,29,6,6,54,20,34
"2021","Southend-on-Sea 008A","E01015908",634,121,79,42,489,103,295,81,169,45,55,26,25,4,34,22,12,2,2,24,9,15
"2021","Southend-on-Sea 008B","E01015909",632,193,80,113,422,54,241,65,147,29,81,39,38,4,45,30,15,1,1,17,8,9
"2021","Southend-on-Sea 008C","E01015910",631,143,80,63,471,90,285,84,136,65,61,30,28,3,32,19,13,3,3,17,6,11
"2021","Southend-on-Sea 008D","E01015911",503,100,63,37,391,90,226,56,128,42,45,18,24,3,30,11,19,0,0,12,5,7
"2021","Southend-on-Sea 008E","E01015912",648,153,105,48,478,107,261,78,129,54,66,30,29,7,43,27,16,1,1,17,4,13
"2021","Southend-on-Sea 008F","E01015913",804,283,120,163,491,76,232,73,123,36,112,67,39,6,65,35,30,6,6,30,11,19
"2021","Southend-on-Sea 009A","E01015883",558,99,68,31,434,127,244,65,124,55,25,13,11,1,37,19,18,1,1,25,15,10
"2021","Southend-on-Sea 009B","E01015884",1053,354,160,194,644,68,256,88,130,38,144,76,62,6,170,117,53,6,6,55,25,30
"2021","Southend-on-Sea 009C","E01015885",714,174,130,44,514,167,266,82,129,55,43,25,15,3,36,19,17,2,2,26,13,13
"2021","Southend-on-Sea 009D","E01015886",622,219,91,128,366,26,133,41,63,29,55,13,33,9,147,108,39,5,5,37,17,20
"2021","Southend-on-Sea 009E","E01015887",606,165,76,89,398,43,151,43,74,34,73,19,46,8,127,78,49,4,4,43,22,21
"2021","Southend-on-Sea 009F","E01015888",646,177,122,55,440,132,193,77,62,54,52,16,28,8,60,26,34,3,3,29,17,12
"2021","Southend-on-Sea 010B","E01015896",884,384,100,284,442,24,170,53,91,26,100,49,47,4,139,99,40,9,9,58,24,34
"2021","Southend-on-Sea 010C","E01015897",910,343,143,200,519,22,209,78,103,28,108,55,46,7,169,106,63,11,11,48,23,25
"2021","Southend-on-Sea 010D","E01015898",918,407,145,262,460,32,167,51,76,40,128,69,49,10,128,82,46,5,5,51,23,28
"2021","Southend-on-Sea 010E","E01015899",872,291,80,211,516,39,222,57,121,44,113,56,49,8,139,95,44,3,3,65,27,38
"2021","Southend-on-Sea 010F","E01015900",696,233,53,180,406,21,172,42,105,25,84,40,41,3,122,84,38,7,7,57,24,33
"2021","Southend-on-Sea 010G","E01034095",906,468,88,380,392,8,128,57,68,3,152,117,32,3,91,73,18,13,13,46,11,35
"2021","Southend-on-Sea 010H","E01034096",781,292,56,236,449,8,117,40,61,16,107,48,52,7,209,167,42,8,8,40,13,27
"2021","Southend-on-Sea 011A","E01015845",694,203,71,132,468,32,235,72,130,33,130,80,43,7,69,53,16,2,2,23,8,15
"2021","Southend-on-Sea 011B","E01015846",842,357,129,228,455,50,221,68,125,28,119,82,33,4,61,39,22,4,4,30,7,23
"2021","Southend-on-Sea 011C","E01015847",775,312,77,235,426,36,195,64,101,30,121,79,37,5,71,47,24,3,3,37,6,31
"2021","Southend-on-Sea 011D","E01015848",934,455,193,262,446,89,164,79,55,30,113,91,20,2,71,39,32,9,9,33,10,23
"2021","Southend-on-Sea 011E","E01015849",788,288,104,184,460,41,183,49,106,28,136,80,44,12,95,61,34,5,5,40,12,28
"2021","Southend-on-Sea 011F","E01015850",675,203,77,126,447,54,242,82,129,31,89,46,38,5,57,33,24,5,5,25,9,16
"2021","Southend-on-Sea 012A","E01015827",699,233,89,144,438,109,203,65,97,41,85,51,28,6,39,15,24,2,2,28,10,18
"2021","Southend-on-Sea 012B","E01015828",936,533,84,449,366,27,118,47,53,18,131,87,39,5,79,58,21,11,11,37,10,27
"2021","Southend-on-Sea 012C","E01015829",656,220,71,149,403,39,209,60,123,26,94,64,24,6,59,34,25,2,2,33,12,21
"2021","Southend-on-Sea 012D","E01015830",625,151,83,68,451,81,278,71,148,59,57,33,22,2,34,15,19,1,1,23,5,18
"2021","Southend-on-Sea 012E","E01015831",792,325,56,269,415,21,189,54,104,31,110,75,30,5,90,59,31,5,5,52,21,31
"2021","Southend-on-Sea 012F","E01015832",763,353,194,159,377,81,172,48,98,26,67,47,20,0,50,31,19,7,7,33,11,22
"2021","Southend-on-Sea 013A","E01015876",1039,261,121,140,742,126,380,148,162,70,114,54,50,10,119,67,52,3,3,36,16,20
"2021","Southend-on-Sea 013B","E01015877",906,373,130,243,486,52,190,74,81,35,118,65,43,10,122,88,34,4,4,47,22,25
"2021","Southend-on-Sea 013C","E01015878",583,190,66,124,370,48,177,71,63,43,83,48,28,7,61,39,22,1,1,23,10,13
"2021","Southend-on-Sea 013D","E01015879",594,187,89,98,386,30,145,55,65,25,79,30,38,11,130,79,51,2,2,21,12,9
"2021","Southend-on-Sea 013E","E01015880",665,251,121,130,380,33,123,34,56,33,94,44,39,11,126,72,54,4,4,34,18,16
"2021","Southend-on-Sea 013F","E01015881",584,175,117,58,383,78,175,48,76,51,71,27,36,8,58,30,28,1,1,26,10,16
"2021","Southend-on-Sea 013G","E01015882",777,258,91,167,478,38,173,52,71,50,108,54,46,8,152,89,63,7,7,41,18,23
"2021","Southend-on-Sea 014A","E01015839",817,299,82,217,458,28,180,61,85,34,100,47,46,7,146,94,52,4,4,60,24,36
"2021","Southend-on-Sea 014B","E01015840",781,283,54,229,444,23,171,68,82,21,105,50,51,4,141,108,33,4,4,54,22,32
"2021","Southend-on-Sea 014C","E01015841",1188,501,81,420,599,19,205,72,112,21,179,98,73,8,177,131,46,19,19,88,41,47
"2021","Southend-on-Sea 014D","E01015842",964,425,149,276,502,17,126,43,54,29,116,50,57,9,240,183,57,3,3,37,9,28
"2021","Southend-on-Sea 014E","E01015843",742,265,86,179,429,24,180,46,98,36,122,70,44,8,102,64,38,1,1,48,22,26
"2021","Southend-on-Sea 014F","E01015844",1060,505,160,345,491,22,173,67,81,25,154,97,54,3,136,97,39,6,6,64,24,40
"2021","Southend-on-Sea 015A","E01015851",1009,618,277,341,353,80,105,62,34,9,95,66,24,5,68,39,29,5,5,38,8,30
"2021","Southend-on-Sea 015B","E01015852",1114,567,121,446,454,17,144,69,57,18,138,95,41,2,131,87,44,24,24,93,24,69
"2021","Southend-on-Sea 015C","E01015853",931,454,152,302,421,53,151,70,62,19,120,78,40,2,88,59,29,9,9,56,9,47
"2021","Southend-on-Sea 015D","E01015854",824,284,55,229,441,13,152,45,85,22,137,70,61,6,127,95,32,12,12,99,22,77
"2021","Southend-on-Sea 015E","E01015855",953,387,97,290,479,33,167,54,85,28,124,68,50,6,143,102,41,12,12,87,34,53
"2021","Southend-on-Sea 015F","E01015856",835,337,79,258,435,17,205,76,104,25,113,68,42,3,94,61,33,6,6,63,15,48
"2021","Southend-on-Sea 016A","E01015889",619,205,156,49,380,116,189,54,81,54,36,16,18,2,37,12,25,2,2,34,19,15
"2021","Southend-on-Sea 016B","E01015890",642,166,111,55,445,110,249,80,108,61,41,20,16,5,43,20,23,2,2,31,10,21
"2021","Southend-on-Sea 016C","E01015891",693,271,116,155,383,50,151,55,67,29,96,47,44,5,82,51,31,4,4,39,12,27
"2021","Southend-on-Sea 016D","E01015892",633,122,57,65,475,59,252,67,139,46,92,44,35,13,69,47,22,3,3,36,16,20
"2021","Southend-on-Sea 016E","E01015893",767,276,248,28,464,205,193,96,52,45,39,22,12,5,25,9,16,2,2,27,8,19
"2021","Southend-on-Sea 016F","E01015894",604,125,83,42,444,98,236,74,110,52,61,30,26,5,46,21,25,3,3,35,16,19
"2021","Southend-on-Sea 017A","E01015914",496,79,57,22,392,101,230,66,109,55,25,10,12,3,33,13,20,3,3,25,9,16
"2021","Southend-on-Sea 017B","E01015915",608,177,107,70,406,96,200,62,89,49,59,29,28,2,50,26,24,1,1,25,12,13
"2021","Southend-on-Sea 017C","E01015916",507,128,46,82,350,23,125,35,61,29,77,23,39,15,124,91,33,1,1,29,20,9
"2021","Southend-on-Sea 017D","E01015917",623,171,52,119,405,23,162,36,85,41,74,29,32,13,140,94,46,6,6,47,29,18
"2021","Southend-on-Sea 017E","E01015918",550,146,62,84,371,36,171,51,82,38,83,35,39,9,74,45,29,7,7,33,13,20
"2021","Southend-on-Sea 017F","E01015919",500,101,65,36,364,53,194,53,96,45,69,23,37,9,44,26,18,4,4,35,19,16
"2021","Southend-on-Sea 017G","E01015920",639,151,103,48,458,118,217,86,77,54,69,30,29,10,51,25,26,3,3,30,12,18
"2021","Thurrock 001A","E01015943",609,135,74,61,433,105,225,75,88,62,62,26,28,8,37,22,15,4,4,41,15,26
"2021","Thurrock 001B","E01015944",518,116,88,28,381,95,202,65,89,48,49,14,27,8,33,10,23,2,2,21,12,9
"2021","Thurrock 001C","E01015946",631,151,82,69,437,94,208,64,98,46,77,32,34,11,54,24,30,4,4,43,16,27
"2021","Thurrock 001D","E01015997",514,77,49,28,412,84,224,65,98,61,63,28,27,8,39,14,25,2,2,25,7,18
"2021","Thurrock 001E","E01015999",493,74,42,32,379,75,188,55,78,55,72,27,42,3,39,20,19,5,5,40,22,18
"2021","Thurrock 002A","E01015945",516,118,75,43,367,79,194,61,78,55,43,16,21,6,47,20,27,4,4,31,17,14
"2021","Thurrock 002B","E01015983",630,184,106,78,422,91,189,60,80,49,71,21,43,7,66,39,27,5,5,24,11,13
"2021","Thurrock 002C","E01015987",590,135,80,55,413,62,165,44,75,46,73,11,54,8,108,69,39,5,5,42,18,24
"2021","Thurrock 002D","E01015988",590,196,127,69,348,39,127,30,64,33,71,18,42,11,109,65,44,2,2,46,20,26
"2021","Thurrock 002E","E01015998",583,126,83,43,420,83,217,56,98,63,66,24,38,4,53,23,30,1,1,37,18,19
"2021","Thurrock 003A","E01015984",488,102,62,40,360,76,190,54,78,58,53,18,28,7,38,19,19,3,3,26,14,12
"2021","Thurrock 003B","E01015985",626,209,163,46,394,117,164,53,64,47,61,26,20,15,52,22,30,0,0,23,13,10
"2021","Thurrock 003C","E01015986",609,163,80,83,404,33,164,48,77,39,83,32,45,6,115,71,44,9,9,42,24,18
"2021","Thurrock 003D","E01015990",593,152,91,61,399,47,206,65,83,58,77,33,28,16,68,35,33,1,1,42,23,19
"2021","Thurrock 003E","E01016001",518,96,55,41,388,79,200,53,94,53,57,18,29,10,52,28,24,0,0,34,16,18
"2021","Thurrock 004A","E01015977",735,169,97,72,500,104,234,77,103,54,97,33,51,13,63,32,31,2,2,66,33,33
"2021","Thurrock 004B","E01015978",559,99,55,44,404,81,226,76,85,65,70,34,29,7,24,13,11,3,3,56,21,35
"2021","Thurrock 004C","E01015979",553,106,37,69,411,35,228,74,97,57,97,45,43,9,45,24,21,6,6,36,22,14
"2021","Thurrock 004D","E01015980",613,136,85,51,441,109,222,73,91,58,51,24,22,5,55,29,26,4,4,36,16,20
"2021","Thurrock 005A","E01015989",701,270,100,170,384,24,168,59,74,35,108,56,48,4,78,53,25,6,6,47,17,30
"2021","Thurrock 005B","E01015991",683,143,78,65,500,75,236,74,103,59,114,44,59,11,73,53,20,2,2,40,17,23
"2021","Thurrock 005C","E01015992",1087,252,86,166,757,48,370,93,213,64,185,88,87,10,149,103,46,5,5,78,34,44
"2021","Thurrock 005D","E01016000",590,133,66,67,418,73,178,44,79,55,86,31,50,5,79,52,27,2,2,39,12,27
"2021","Thurrock 005E","E01016002",526,107,74,33,394,87,209,56,96,57,53,23,29,1,42,20,22,3,3,25,13,12
"2021","Thurrock 006A","E01015932",621,125,54,71,411,40,217,46,113,58,74,30,36,8,73,43,30,7,7,85,49,36
"2021","Thurrock 006B","E01015971",682,220,92,128,421,38,175,56,86,33,102,53,39,10,94,67,27,12,12,41,24,17
"2021","Thurrock 006C","E01015972",716,185,103,82,464,36,242,66,127,49,81,31,43,7,98,58,40,7,7,67,45,22
"2021","Thurrock 006E","E01015974",550,114,56,58,406,62,240,67,128,45,49,20,24,5,53,29,24,2,2,30,17,13
"2021","Thurrock 006F","E01015975",624,155,58,97,402,58,174,58,90,26,71,28,37,6,96,56,40,3,3,67,34,33
"2021","Thurrock 006G","E01034368",698,173,24,149,478,11,242,58,174,10,129,80,46,3,88,71,17,8,8,47,28,19
"2021","Thurrock 006H","E01034369",620,127,52,75,424,17,204,36,132,36,75,27,39,9,120,88,32,8,8,69,47,22
"2021","Thurrock 007A","E01015927",659,132,62,70,457,26,225,52,127,46,57,19,27,11,142,97,45,7,7,70,42,28
"2021","Thurrock 007B","E01015928",640,152,79,73,433,33,229,59,110,60,82,23,47,12,86,38,48,3,3,55,35,20
"2021","Thurrock 007C","E01015929",654,255,101,154,358,18,147,38,84,25,65,27,31,7,120,70,50,8,8,41,21,20
"2021","Thurrock 007D","E01015930",664,142,55,87,467,33,234,47,143,44,95,42,44,9,102,60,42,3,3,55,29,26
"2021","Thurrock 007E","E01015931",661,254,51,203,357,7,131,34,76,21,106,34,69,3,107,88,19,6,6,50,27,23
"2021","Thurrock 007F","E01015976",754,253,75,178,438,22,180,56,95,29,90,35,43,12,141,90,51,5,5,63,32,31
"2021","Thurrock 008A","E01015922",574,123,78,45,395,37,180,53,85,42,75,24,41,10,96,55,41,7,7,56,32,24
"2021","Thurrock 008B","E01015923",883,227,66,161,588,26,273,60,164,49,138,37,95,6,141,92,49,10,10,68,45,23
"2021","Thurrock 008C","E01015924",583,137,66,71,391,26,182,48,94,40,90,29,50,11,87,44,43,6,6,55,36,19
"2021","Thurrock 008D","E01015925",674,143,78,65,478,65,252,68,124,60,94,39,40,15,63,38,25,4,4,53,32,21
"2021","Thurrock 008E","E01015926",819,232,110,122,521,59,276,66,161,49,95,49,43,3,86,60,26,5,5,66,36,30
"2021","Thurrock 009A","E01015957",608,205,131,74,358,41,188,44,94,50,59,18,34,7,69,35,34,1,1,45,28,17
"2021","Thurrock 009B","E01015958",467,95,53,42,318,34,165,43,80,42,42,8,22,12,72,36,36,5,5,54,29,25
"2021","Thurrock 009C","E01015993",642,183,133,50,424,54,226,62,120,44,74,25,39,10,69,37,32,1,1,35,18,17
"2021","Thurrock 009D","E01015994",691,231,175,56,411,68,209,52,114,43,65,23,32,10,67,34,33,2,2,49,33,16
"2021","Thurrock 009E","E01015995",605,107,70,37,457,95,283,80,131,72,37,12,20,5,40,16,24,2,2,41,21,20
"2021","Thurrock 009F","E01015996",622,145,83,62,426,42,237,47,119,71,56,16,27,13,88,58,30,3,3,51,32,19
"2021","Thurrock 010A","E01015963",483,138,64,74,319,32,123,27,65,31,49,11,36,2,113,89,24,2,2,26,14,12
"2021","Thurrock 010B","E01015964",597,120,85,35,439,77,239,63,106,70,67,21,33,13,51,29,22,5,5,38,19,19
"2021","Thurrock 010C","E01015965",948,174,105,69,691,97,403,106,225,72,121,40,65,16,68,40,28,2,2,83,57,26
"2021","Thurrock 010D","E01015966",631,135,97,38,454,112,246,68,111,67,51,23,19,9,45,22,23,0,0,42,21,21
"2021","Thurrock 012A","E01015933",637,163,82,81,414,48,222,64,111,47,82,32,44,6,61,35,26,1,1,60,38,22
"2021","Thurrock 012B","E01015934",510,86,35,51,368,28,143,32,80,31,82,22,48,12,112,70,42,3,3,56,37,19
"2021","Thurrock 012C","E01015935",625,123,60,63,442,46,205,56,105,44,77,22,48,7,114,77,37,0,0,60,29,31
"2021","Thurrock 012D","E01015936",741,204,124,80,488,58,249,76,117,56,72,23,40,9,105,65,40,4,4,49,28,21
"2021","Thurrock 012E","E01015937",668,207,147,60,410,85,213,69,85,59,45,19,18,8,66,30,36,1,1,51,32,19
"2021","Thurrock 012F","E01015938",779,218,112,106,511,52,158,38,79,41,85,16,59,10,214,168,46,2,2,50,29,21
"2021","Thurrock 013A","E01015947",550,104,38,66,403,24,170,47,77,46,94,35,53,6,113,87,26,2,2,43,21,22
"2021","Thurrock 013B","E01015948",915,164,56,108,678,38,337,78,188,71,147,54,85,8,151,123,28,5,5,73,45,28
"2021","Thurrock 013C","E01015949",651,108,51,57,493,50,264,92,109,63,100,37,47,16,73,48,25,6,6,50,27,23
"2021","Thurrock 013D","E01015950",689,152,76,76,483,89,238,71,111,56,72,35,33,4,81,51,30,3,3,54,31,23
"2021","Thurrock 014A","E01015960",539,126,102,24,353,68,212,58,94,60,41,16,22,3,30,13,17,2,2,60,38,22
"2021","Thurrock 014B","E01015967",589,119,48,71,422,59,214,63,83,68,81,33,39,9,61,30,31,7,7,48,24,24
"2021","Thurrock 014C","E01015968",596,201,109,92,350,43,197,58,91,48,48,25,22,1,56,36,20,6,6,45,24,21
"2021","Thurrock 014D","E01015969",774,235,121,114,469,67,228,73,114,41,92,48,40,4,77,37,40,5,5,70,36,34
"2021","Thurrock 014E","E01015970",498,89,38,51,371,52,206,47,107,52,69,16,45,8,42,21,21,2,2,38,17,21
"2021","Thurrock 016A","E01015955",687,176,54,122,453,32,262,87,137,38,101,71,26,4,53,32,21,5,5,58,31,27
"2021","Thurrock 016B","E01015956",817,230,50,180,486,21,233,62,117,54,111,61,43,7,97,59,38,24,24,101,48,53
"2021","Thurrock 016C","E01015959",705,172,56,116,445,40,208,50,110,48,77,42,31,4,105,67,38,15,15,88,37,51
"2021","Thurrock 016D","E01015961",614,151,60,91,400,36,230,54,132,44,64,32,27,5,59,37,22,11,11,63,33,30
"2021","Thurrock 016E","E01015962",617,122,50,72,399,20,198,49,118,31,64,30,31,3,105,72,33,12,12,96,52,44
"2021","Thurrock 017A","E01015951",668,152,34,118,445,17,193,46,115,32,104,36,62,6,119,84,35,12,12,71,43,28
"2021","Thurrock 017B","E01015952",929,249,49,200,601,12,265,68,160,37,140,63,70,7,175,131,44,9,9,79,45,34
"2021","Thurrock 017C","E01015953",1128,352,47,305,670,18,336,100,214,22,169,92,74,3,119,87,32,28,28,106,45,61
"2021","Thurrock 017D","E01015954",1046,308,70,238,659,13,236,63,148,25,160,71,82,7,238,185,53,12,12,79,36,43
"2021","Thurrock 018A","E01016003",941,257,60,197,585,34,250,69,138,43,131,62,62,7,156,105,51,14,14,99,50,49
"2021","Thurrock 018B","E01016004",711,197,104,93,444,21,188,49,96,43,61,18,36,7,167,130,37,7,7,70,41,29
"2021","Thurrock 018C","E01016005",556,93,35,58,398,28,171,42,91,38,85,22,51,12,108,75,33,6,6,65,41,24
"2021","Thurrock 018D","E01016006",643,150,60,90,436,23,122,20,84,18,91,11,73,7,195,167,28,5,5,57,33,24
"2021","Thurrock 018E","E01016007",646,134,61,73,424,15,193,38,110,45,72,11,51,10,135,100,35,9,9,88,51,37
"2021","Thurrock 018F","E01016008",591,145,49,96,394,32,198,68,91,39,78,24,46,8,80,61,19,6,6,52,25,27
"2021","Thurrock 018G","E01016009",637,142,58,84,424,17,186,58,87,41,77,37,33,7,137,83,54,7,7,71,41,30
"2021","Thurrock 018H","E01016010",496,97,39,58,355,23,160,37,91,32,62,15,36,11,103,69,34,7,7,44,29,15
"2021","Thurrock 019A","E01015982",888,138,22,116,672,22,423,76,267,80,125,63,53,9,93,67,26,9,9,78,52,26
"2021","Thurrock 019B","E01033610",553,85,7,78,402,10,241,42,175,24,59,30,27,2,90,61,29,2,2,66,39,27
"2021","Thurrock 019C","E01033611",631,126,15,111,449,9,247,43,181,23,96,53,41,2,89,71,18,8,8,56,35,21
"2021","Thurrock 019D","E01033613",577,112,18,94,412,15,251,65,152,34,85,42,40,3,52,42,10,9,9,53,29,24
"2021","Thurrock 020A","E01015939",556,126,35,91,390,15,237,55,132,50,69,26,37,6,64,35,29,5,5,40,22,18
"2021","Thurrock 020B","E01015941",523,97,23,74,379,24,222,48,135,39,74,33,36,5,55,38,17,4,4,47,21,26
"2021","Thurrock 020C","E01015942",559,111,27,84,398,39,233,58,125,50,81,44,30,7,40,21,19,5,5,50,29,21
"2021","Thurrock 020D","E01033612",595,137,23,114,418,21,251,56,159,36,85,41,37,7,56,40,16,5,5,40,26,14
"2021","Thurrock 020E","E01033614",612,100,35,65,456,19,293,59,186,48,68,14,51,3,73,53,20,3,3,56,34,22
"2021","Thurrock 021A","E01015921",545,195,33,162,314,8,151,48,84,19,80,38,38,4,69,48,21,6,6,36,25,11
"2021","Thurrock 021C","E01016013",1080,384,45,339,605,16,289,90,162,37,139,68,65,6,149,119,30,12,12,91,50,41
"2021","Thurrock 021B","E01016014",1021,261,51,210,656,17,291,73,188,30,119,45,67,7,215,160,55,14,14,104,50,54
"2021","Thurrock 022A","E01016011",739,243,40,203,428,10,210,56,131,23,102,56,42,4,91,70,21,15,15,68,34,34
"2021","Thurrock 022B","E01016015",930,167,42,125,654,35,327,71,191,65,144,66,67,11,137,89,48,11,11,109,67,42
"2021","Thurrock 022C","E01034370",722,192,16,176,464,3,223,64,145,14,145,83,57,5,84,62,22,9,9,66,34,32
"2021","Thurrock 022D","E01034371",724,153,50,103,476,20,216,47,137,32,97,26,65,6,136,96,40,7,7,95,59,36
"2021","Bedford 001A","E01017540",618,119,73,46,478,115,278,122,97,59,51,32,19,0,33,22,11,1,1,21,4,17
"2021","Bedford 001B","E01017541",530,122,72,50,387,76,203,79,88,36,57,35,16,6,49,29,20,2,2,21,8,13
"2021","Bedford 001C","E01017544",606,166,89,77,421,112,214,71,111,32,44,23,16,5,49,30,19,2,2,19,6,13
"2021","Bedford 001D","E01017545",590,126,61,65,439,79,258,106,109,43,49,31,14,4,51,35,16,2,2,25,11,14
"2021","Bedford 002A","E01017464",634,162,98,64,452,128,250,118,91,41,41,25,13,3,31,16,15,2,2,20,9,11
"2021","Bedford 002B","E01017465",641,177,112,65,446,108,230,95,96,39,59,35,21,3,49,26,23,0,0,18,9,9
"2021","Bedford 002C","E01017503",546,140,68,72,377,55,187,63,86,38,66,24,37,5,67,47,20,2,2,29,13,16
"2021","Bedford 002D","E01017504",854,254,121,133,562,106,292,105,143,44,90,57,28,5,72,45,27,2,2,38,15,23
"2021","Bedford 002E","E01017546",504,141,92,49,340,68,186,67,79,40,50,32,16,2,35,18,17,1,1,23,11,12
"2021","Bedford 002F","E01017547",644,158,87,71,437,89,258,88,114,56,58,37,16,5,29,12,17,3,3,49,31,18
"2021","Bedford 003A","E01017478",726,194,97,97,500,92,257,110,98,49,73,40,29,4,74,51,23,4,4,32,21,11
"2021","Bedford 003B","E01017479",647,263,166,97,357,89,163,67,68,28,60,36,19,5,40,24,16,5,5,27,11,16
"2021","Bedford 003C","E01017480",782,197,85,112,552,52,290,70,172,48,101,49,44,8,106,77,29,3,3,33,17,16
"2021","Bedford 003D","E01017481",491,136,74,62,332,41,182,63,88,31,51,20,30,1,56,37,19,2,2,23,14,9
"2021","Bedford 003E","E01017528",978,205,141,64,730,150,399,109,217,73,79,37,37,5,100,67,33,2,2,43,18,25
"2021","Bedford 004B","E01017495",940,218,100,118,686,120,351,122,177,52,115,58,55,2,95,62,33,5,5,36,16,20
"2021","Bedford 004C","E01017496",684,169,99,70,486,112,260,115,94,51,68,39,24,5,43,24,19,3,3,29,10,19
"2021","Bedford 004D","E01017542",618,149,69,80,435,99,223,103,67,53,77,56,17,4,34,21,13,2,2,34,17,17
"2021","Bedford 004E","E01017543",628,129,75,54,453,82,258,131,76,51,71,42,24,5,42,23,19,0,0,46,12,34
"2021","Bedford 004F","E01033431",588,97,31,66,447,31,266,61,160,45,68,31,32,5,81,63,18,1,1,44,30,14
"2021","Bedford 004H","E01034412",830,184,91,93,602,123,309,105,150,54,87,39,43,5,81,50,31,2,2,44,25,19
"2021","Bedford 004I","E01034413",431,86,23,63,322,24,164,51,94,19,88,38,44,6,41,33,8,5,5,23,12,11
"2021","Bedford 005A","E01017453",624,246,112,134,350,63,137,52,62,23,60,26,25,9,89,54,35,1,1,28,15,13
"2021","Bedford 005B","E01017454",583,148,95,53,405,93,216,66,98,52,53,20,29,4,43,16,27,0,0,30,17,13
"2021","Bedford 005C","E01017455",645,207,111,96,420,95,200,75,83,42,48,21,26,1,71,40,31,6,6,18,10,8
"2021","Bedford 005D","E01017456",645,184,130,54,427,124,226,65,113,48,37,24,13,0,37,18,19,3,3,34,14,20
"2021","Bedford 005E","E01017457",495,138,58,80,328,52,173,53,89,31,45,22,17,6,58,33,25,0,0,29,14,15
"2021","Bedford 005F","E01017458",515,134,70,64,360,69,180,57,84,39,58,25,30,3,48,29,19,5,5,21,12,9
"2021","Bedford 006A","E01017529",510,126,81,45,355,70,190,47,82,61,41,22,15,4,51,21,30,3,3,29,14,15
"2021","Bedford 006B","E01017530",583,131,100,31,434,115,242,66,122,54,45,17,22,6,30,11,19,2,2,18,9,9
"2021","Bedford 006C","E01017531",579,205,102,103,347,59,139,47,66,26,49,24,21,4,97,45,52,3,3,27,13,14
"2021","Bedford 006D","E01017532",513,106,80,26,370,95,209,66,96,47,35,18,15,2,31,11,20,0,0,37,16,21
"2021","Bedford 006E","E01017533",479,112,85,27,345,125,158,48,76,34,33,18,13,2,26,9,17,3,3,22,9,13
"2021","Bedford 006F","E01017534",643,165,113,52,454,89,262,81,121,60,59,32,24,3,40,11,29,4,4,24,6,18
"2021","Bedford 007A","E01017488",703,248,180,68,430,114,205,61,93,51,53,24,25,4,57,29,28,1,1,25,15,10
"2021","Bedford 007B","E01017489",614,149,64,85,423,31,157,30,84,43,65,17,40,8,163,106,57,7,7,42,24,18
"2021","Bedford 007C","E01017490",595,218,91,127,346,19,116,33,60,23,71,22,36,13,135,76,59,5,5,31,8,23
"2021","Bedford 007D","E01017491",635,184,91,93,410,56,213,53,121,39,59,27,28,4,76,37,39,6,6,41,18,23
"2021","Bedford 007E","E01017492",612,198,64,134,367,35,141,41,66,34,66,24,37,5,117,73,44,8,8,47,23,24
"2021","Bedford 007F","E01017493",649,161,42,119,450,37,197,61,94,42,86,34,43,9,124,87,37,6,6,38,20,18
"2021","Bedford 008A","E01017459",693,172,99,73,498,113,267,101,129,37,62,34,25,3,55,21,34,1,1,23,7,16
"2021","Bedford 008B","E01017460",925,178,83,95,694,120,380,133,183,64,112,67,42,3,76,49,27,6,6,53,27,26
"2021","Bedford 008D","E01017462",622,138,90,48,466,89,282,91,136,55,52,18,26,8,42,21,21,1,1,18,7,11
"2021","Bedford 008E","E01017463",593,192,138,54,380,105,195,60,96,39,37,17,18,2,42,24,18,1,1,21,12,9
"2021","Bedford 008F","E01034414",593,108,49,59,452,88,274,90,132,52,52,24,27,1,37,20,17,1,1,33,17,16
"2021","Bedford 008G","E01034415",538,112,15,97,391,9,184,35,133,16,87,50,37,0,105,85,20,6,6,35,19,16
"2021","Bedford 008H","E01034416",609,148,11,137,427,17,239,57,167,15,110,70,39,1,57,39,18,4,4,34,14,20
"2021","Bedford 008I","E01034417",509,99,7,92,383,5,214,66,140,8,101,52,46,3,62,49,13,1,1,27,13,14
"2021","Bedford 009A","E01017482",626,268,74,194,332,54,161,54,86,21,58,48,10,0,50,33,17,9,9,26,12,14
"2021","Bedford 009B","E01017483",593,191,118,73,360,85,169,52,81,36,56,19,27,10,44,25,19,6,6,42,10,32
"2021","Bedford 009C","E01017484",620,352,102,250,241,23,95,37,49,9,71,56,15,0,36,25,11,16,16,27,3,24
"2021","Bedford 009D","E01017485",628,235,41,194,363,35,182,55,100,27,81,55,24,2,60,43,17,5,5,30,13,17
"2021","Bedford 010A","E01017497",604,215,44,171,328,12,146,50,69,27,86,56,27,3,74,49,25,10,10,61,22,39
"2021","Bedford 010B","E01017498",489,133,72,61,327,54,175,51,78,46,53,33,19,1,41,23,18,4,4,29,12,17
"2021","Bedford 010C","E01017499",623,267,45,222,326,30,152,56,78,18,77,61,15,1,58,41,17,9,9,30,7,23
"2021","Bedford 010D","E01017500",620,323,83,240,259,21,98,35,55,8,80,61,18,1,56,43,13,4,4,38,8,30
"2021","Bedford 010E","E01017501",938,512,139,373,384,28,142,54,74,14,116,95,18,3,78,59,19,20,20,42,10,32
"2021","Bedford 010F","E01017502",926,540,183,357,336,13,120,45,60,15,79,58,21,0,110,65,45,14,14,50,10,40
"2021","Bedford 011A","E01017524",696,193,69,124,451,59,254,89,118,47,67,35,30,2,67,43,24,4,4,52,20,32
"2021","Bedford 011B","E01017525",510,159,70,89,318,34,151,51,73,27,59,22,32,5,64,39,25,10,10,33,12,21
"2021","Bedford 011C","E01017526",606,145,50,95,428,42,235,91,106,38,90,46,40,4,55,35,20,6,6,33,16,17
"2021","Bedford 011D","E01017527",542,168,57,111,341,46,165,70,68,27,78,48,26,4,45,22,23,7,7,33,10,23
"2021","Bedford 012A","E01017466",995,394,42,352,463,13,197,65,108,24,125,94,27,4,104,72,32,24,24,138,46,92
"2021","Bedford 012B","E01017467",655,249,106,143,380,41,186,60,102,24,92,61,28,3,58,33,25,3,3,26,7,19
"2021","Bedford 012C","E01017468",595,186,71,115,374,27,191,56,110,25,96,64,26,6,54,25,29,6,6,35,11,24
"2021","Bedford 012E","E01017470",509,105,55,50,374,44,204,60,117,27,81,41,34,6,43,22,21,2,2,30,13,17
"2021","Bedford 012F","E01017471",978,523,138,385,393,19,147,58,79,10,108,69,38,1,105,85,20,14,14,62,22,40
"2021","Bedford 012G","E01034418",653,352,80,272,266,22,107,58,40,9,89,76,10,3,43,29,14,5,5,35,7,28
"2021","Bedford 012H","E01034419",661,326,62,264,291,15,121,46,63,12,96,84,10,2,44,29,15,15,15,44,9,35
"2021","Bedford 013A","E01017535",674,120,50,70,465,30,299,62,185,52,63,29,33,1,64,36,28,9,9,89,62,27
"2021","Bedford 013B","E01017536",836,183,29,154,502,16,266,61,168,37,80,44,33,3,122,88,34,18,18,151,70,81
"2021","Bedford 013C","E01017537",490,123,52,71,314,23,148,19,101,28,40,9,29,2,102,61,41,1,1,53,41,12
"2021","Bedford 013D","E01017538",525,102,36,66,321,13,190,27,125,38,33,13,15,5,74,37,37,11,11,102,74,28
"2021","Bedford 013E","E01017539",526,139,35,104,305,10,170,22,115,33,45,22,20,3,73,42,31,7,7,82,48,34
"2021","Bedford 014A","E01017518",655,190,55,135,408,17,197,45,122,30,73,43,27,3,116,71,45,5,5,57,23,34
"2021","Bedford 014B","E01017519",642,175,75,100,414,23,152,44,78,30,74,30,34,10,158,93,65,7,7,53,28,25
"2021","Bedford 014C","E01017520",785,262,88,174,475,50,255,84,133,38,87,47,37,3,77,40,37,6,6,48,23,25
"2021","Bedford 014D","E01017521",643,177,58,119,405,31,207,47,118,42,84,48,30,6,70,34,36,13,13,61,32,29
"2021","Bedford 014E","E01017522",947,384,144,240,478,43,192,50,114,28,112,70,39,3,123,73,50,8,8,85,31,54
"2021","Bedford 014F","E01017523",631,132,46,86,450,14,172,40,102,30,64,23,31,10,195,143,52,5,5,49,27,22
"2021","Bedford 015A","E01017472",538,156,45,111,318,6,147,25,84,38,42,14,27,1,112,73,39,11,11,64,36,28
"2021","Bedford 015C","E01017474",694,202,30,172,388,9,177,33,116,28,70,45,21,4,120,76,44,12,12,104,48,56
"2021","Bedford 015D","E01017475",577,141,63,78,363,26,202,46,104,52,59,28,24,7,66,41,25,10,10,73,31,42
"2021","Bedford 015E","E01017476",547,120,52,68,339,37,173,45,91,37,52,19,25,8,69,20,49,8,8,88,37,51
"2021","Bedford 015F","E01017477",521,160,79,81,316,16,138,23,88,27,42,16,22,4,115,73,42,5,5,45,20,25
"2021","Bedford 015G","E01034420",756,229,19,210,404,8,200,61,100,39,96,63,25,8,92,69,23,8,8,123,44,79
"2021","Bedford 015H","E01034421",660,218,16,202,363,6,184,53,123,8,86,56,28,2,69,43,26,18,18,79,40,39
"2021","Bedford 016A","E01017509",519,214,97,117,280,30,120,29,57,34,45,18,24,3,83,43,40,2,2,25,18,7
"2021","Bedford 016B","E01017510",723,227,95,132,454,76,188,72,77,39,89,53,24,12,97,51,46,4,4,42,21,21
"2021","Bedford 016C","E01017511",484,119,47,72,318,55,164,62,54,48,36,26,8,2,60,29,31,3,3,47,25,22
"2021","Bedford 016D","E01017512",542,120,36,84,360,36,178,46,91,41,56,31,18,7,85,47,38,5,5,62,28,34
"2021","Bedford 017A","E01017505",647,199,81,118,400,66,183,47,86,50,59,30,27,2,86,41,45,6,6,48,29,19
"2021","Bedford 017B","E01017506",670,217,87,130,409,30,182,58,90,34,82,39,36,7,108,72,36,7,7,44,25,19
"2021","Bedford 017C","E01017507",528,137,64,73,347,42,179,43,90,46,53,27,20,6,65,28,37,8,8,44,27,17
"2021","Bedford 017D","E01017508",688,174,64,110,456,49,210,79,92,39,98,53,41,4,94,57,37,5,5,58,34,24
"2021","Bedford 018A","E01017513",549,105,45,60,403,59,199,52,101,46,54,19,30,5,88,49,39,3,3,41,22,19
"2021","Bedford 018B","E01017514",664,187,68,119,426,41,190,58,94,38,68,34,29,5,123,78,45,4,4,51,36,15
"2021","Bedford 018C","E01017515",622,156,51,105,419,47,204,43,101,60,65,27,30,8,97,54,43,6,6,47,23,24
"2021","Bedford 018E","E01017517",601,129,66,63,430,65,246,73,113,60,68,39,24,5,47,22,25,4,4,42,23,19
"2021","Bedford 018F","E01034422",582,134,33,101,390,35,193,56,110,27,88,33,49,6,72,52,20,2,2,58,28,30
"2021","Bedford 018G","E01034423",408,95,59,36,275,45,149,50,57,42,37,17,16,4,39,22,17,5,5,38,13,25
"2021","Bedford 018H","E01034424",606,156,9,147,419,0,219,61,145,13,135,85,49,1,65,56,9,0,0,31,15,16
"2021","Bedford 020B","E01017552",1039,216,84,132,772,35,359,87,227,45,251,123,119,9,124,101,23,3,3,51,22,29
"2021","Bedford 020C","E01017553",551,106,74,32,419,97,211,66,98,47,66,33,25,8,44,24,20,1,1,26,15,11
"2021","Bedford 020D","E01017554",807,239,134,105,534,86,262,61,144,57,102,52,47,3,81,53,28,3,3,34,14,20
"2021","Bedford 020E","E01034425",729,150,55,95,546,69,319,99,163,57,78,48,25,5,78,59,19,2,2,33,21,12
"2021","Bedford 020F","E01034426",820,129,43,86,661,20,353,93,235,25,184,83,99,2,100,85,15,4,4,30,20,10
"2021","Bedford 021B","E01017487",743,181,51,130,514,43,243,60,142,41,117,62,45,10,109,71,38,2,2,48,27,21
"2021","Bedford 021F","E01017549",715,219,143,76,474,143,220,101,82,37,63,37,21,5,48,25,23,0,0,22,12,10
"2021","Bedford 021A","E01034427",571,129,11,118,399,6,181,45,121,15,135,83,50,2,74,63,11,3,3,43,19,24
"2021","Bedford 021C","E01034428",516,87,19,68,394,12,213,65,130,18,117,63,48,6,50,32,18,2,2,35,18,17
"2021","Bedford 021D","E01034429",486,118,60,58,346,51,169,71,61,37,70,31,32,7,53,28,25,3,3,22,12,10
"2021","Bedford 021E","E01034430",436,116,61,55,299,72,150,58,58,34,42,21,20,1,35,17,18,0,0,21,14,7
"2021","Bedford 022A","E01034431",675,136,47,89,459,30,262,64,138,60,83,44,34,5,78,48,30,6,6,80,40,40
"2021","Bedford 022B","E01034432",579,196,146,50,354,105,163,63,70,30,51,31,18,2,33,14,19,2,2,29,12,17
"2021","Bedford 022C","E01034433",814,124,17,107,644,30,349,66,268,15,152,73,76,3,109,90,19,4,4,46,28,18
"2021","Bedford 022D","E01034434",701,102,13,89,559,15,283,70,198,15,164,81,80,3,90,77,13,7,7,40,26,14
"2021","Central Bedfordshire 001A","E01017433",645,216,113,103,388,30,178,56,92,30,86,32,46,8,89,58,31,5,5,41,20,21
"2021","Central Bedfordshire 001B","E01017434",688,178,88,90,483,60,246,90,113,43,94,44,47,3,79,44,35,4,4,27,16,11
"2021","Central Bedfordshire 001C","E01017436",979,191,68,123,765,112,434,143,217,74,140,77,58,5,77,43,34,2,2,23,10,13
"2021","Central Bedfordshire 002A","E01017430",642,188,84,104,427,70,183,75,75,33,98,49,43,6,72,50,22,4,4,27,11,16
"2021","Central Bedfordshire 002B","E01017431",750,253,91,162,467,64,214,77,94,43,118,78,35,5,70,47,23,1,1,30,5,25
"2021","Central Bedfordshire 002C","E01017432",580,117,62,55,434,104,232,92,89,51,64,33,26,5,31,12,19,3,3,29,14,15
"2021","Central Bedfordshire 002D","E01017435",728,188,92,96,502,59,238,83,104,51,122,62,51,9,83,58,25,0,0,38,17,21
"2021","Central Bedfordshire 003A","E01017425",479,89,48,41,370,69,219,98,72,49,46,26,17,3,34,17,17,2,2,20,13,7
"2021","Central Bedfordshire 003B","E01017426",596,137,76,61,431,102,223,103,89,31,58,32,22,4,43,21,22,5,5,28,15,13
"2021","Central Bedfordshire 003C","E01017427",842,214,91,123,596,94,291,100,146,45,120,69,47,4,90,61,29,1,1,32,9,23
"2021","Central Bedfordshire 003D","E01017428",707,209,101,108,476,89,242,82,112,48,99,50,41,8,45,30,15,1,1,22,6,16
"2021","Central Bedfordshire 003E","E01017429",865,262,96,166,574,70,279,107,132,40,154,96,53,5,69,49,20,2,2,29,13,16
"2021","Central Bedfordshire 004A","E01017412",609,151,86,65,423,74,239,106,84,49,70,37,28,5,39,17,22,1,1,35,12,23
"2021","Central Bedfordshire 004B","E01017422",695,157,90,67,499,114,252,102,103,47,75,41,27,7,56,33,23,2,2,39,13,26
"2021","Central Bedfordshire 004C","E01017423",794,174,116,58,580,101,303,117,127,59,100,51,44,5,74,46,28,2,2,40,14,26
"2021","Central Bedfordshire 004D","E01017424",612,144,78,66,438,103,226,103,78,45,60,39,16,5,47,22,25,2,2,30,17,13
"2021","Central Bedfordshire 005A","E01017383",898,320,95,225,539,73,258,101,108,49,133,81,45,7,72,52,20,3,3,39,13,26
"2021","Central Bedfordshire 005B","E01017384",688,204,88,116,457,41,189,63,83,43,116,60,43,13,106,70,36,5,5,27,14,13
"2021","Central Bedfordshire 005C","E01017385",1012,486,195,291,480,84,176,75,80,21,127,80,40,7,84,54,30,9,9,46,9,37
"2021","Central Bedfordshire 005D","E01017386",770,216,85,131,528,58,257,93,130,34,134,92,39,3,76,48,28,3,3,26,10,16
"2021","Central Bedfordshire 005E","E01017387",490,95,55,40,376,68,214,78,89,47,58,21,29,8,35,15,20,1,1,19,7,12
"2021","Central Bedfordshire 005F","E01017388",1114,239,80,159,827,74,405,119,232,54,223,120,96,7,123,81,42,2,2,48,22,26
"2021","Central Bedfordshire 006A","E01017381",624,160,89,71,437,120,213,83,76,54,49,23,21,5,50,24,26,5,5,27,12,15
"2021","Central Bedfordshire 006B","E01017382",603,140,92,48,434,71,209,71,92,46,81,42,34,5,63,31,32,10,10,29,9,20
"2021","Central Bedfordshire 006E","E01033808",524,110,21,89,397,19,237,77,142,18,112,61,49,2,28,22,6,1,1,17,10,7
"2021","Central Bedfordshire 006F","E01033809",554,110,16,94,416,20,218,70,131,17,116,63,53,0,57,42,15,5,5,28,13,15
"2021","Central Bedfordshire 006G","E01033810",591,154,73,81,421,56,253,93,104,56,58,31,23,4,52,30,22,2,2,16,5,11
"2021","Central Bedfordshire 006H","E01033811",574,102,35,67,431,40,208,64,111,33,120,60,53,7,58,35,23,5,5,41,19,22
"2021","Central Bedfordshire 006I","E01033812",506,74,10,64,406,9,212,61,130,21,141,80,58,3,43,28,15,1,1,26,14,12
"2021","Central Bedfordshire 006J","E01033813",490,140,66,74,331,38,162,71,54,37,65,31,23,11,63,33,30,3,3,19,8,11
"2021","Central Bedfordshire 007A","E01017379",517,168,103,65,324,56,177,77,73,27,52,26,22,4,36,23,13,3,3,25,14,11
"2021","Central Bedfordshire 007B","E01017380",544,126,59,67,398,89,218,79,107,32,60,43,12,5,31,24,7,0,0,20,10,10
"2021","Central Bedfordshire 007C","E01017394",584,122,58,64,409,67,195,69,83,43,77,37,35,5,65,41,24,5,5,53,15,38
"2021","Central Bedfordshire 007F","E01017397",720,172,104,68,486,87,241,65,126,50,94,54,33,7,61,40,21,3,3,62,13,49
"2021","Central Bedfordshire 007H","E01033814",446,103,52,51,310,48,185,55,96,34,46,24,21,1,30,16,14,1,1,33,10,23
"2021","Central Bedfordshire 007I","E01033815",508,84,24,60,390,24,208,67,117,24,93,52,39,2,62,55,7,3,3,34,8,26
"2021","Central Bedfordshire 007J","E01033816",504,85,26,59,395,29,197,67,103,27,124,66,57,1,42,32,10,3,3,24,9,15
"2021","Central Bedfordshire 008A","E01017410",494,115,68,47,357,105,183,75,66,42,38,17,18,3,30,15,15,1,1,22,7,15
"2021","Central Bedfordshire 008C","E01017419",671,149,91,58,487,114,283,98,124,61,58,27,24,7,29,17,12,3,3,35,8,27
"2021","Central Bedfordshire 008D","E01017420",696,186,87,99,482,75,249,83,118,48,89,45,35,9,66,53,13,3,3,28,11,17
"2021","Central Bedfordshire 008E","E01017421",746,168,95,73,553,107,304,110,137,57,89,47,37,5,51,32,19,2,2,25,12,13
"2021","Central Bedfordshire 008F","E01033817",619,150,83,67,444,64,237,82,100,55,76,47,27,2,65,46,19,2,2,25,9,16
"2021","Central Bedfordshire 008G","E01033818",601,94,28,66,473,36,210,88,97,25,162,111,48,3,58,44,14,7,7,34,16,18
"2021","Central Bedfordshire 009C","E01017418",640,187,103,84,422,72,196,74,80,42,76,40,30,6,75,42,33,3,3,31,12,19
"2021","Central Bedfordshire 009D","E01017451",601,158,74,84,410,78,231,87,102,42,69,45,19,5,31,17,14,1,1,33,15,18
"2021","Central Bedfordshire 009E","E01017452",599,230,139,91,353,79,176,70,73,33,51,27,17,7,45,30,15,2,2,16,4,12
"2021","Central Bedfordshire 009F","E01033819",611,92,33,59,490,29,300,71,202,27,102,54,44,4,58,38,20,1,1,29,17,12
"2021","Central Bedfordshire 009G","E01033820",660,153,63,90,478,59,284,92,137,55,72,37,34,1,59,32,27,4,4,29,19,10
"2021","Central Bedfordshire 009H","E01033821",503,89,33,56,377,36,194,62,99,33,83,47,31,5,63,51,12,1,1,37,17,20
"2021","Central Bedfordshire 009I","E01033822",484,63,12,51,395,20,222,63,132,27,95,37,52,6,55,43,12,3,3,26,12,14
"2021","Central Bedfordshire 009J","E01033823",422,99,28,71,308,16,178,63,98,17,65,39,24,2,47,29,18,2,2,15,7,8
"2021","Central Bedfordshire 010A","E01017376",920,294,64,230,587,47,280,97,142,41,172,104,62,6,86,58,28,2,2,39,14,25
"2021","Central Bedfordshire 010B","E01017377",763,190,70,120,544,71,303,110,136,57,94,48,41,5,71,41,30,5,5,29,15,14
"2021","Central Bedfordshire 010C","E01017378",891,267,101,166,588,55,266,97,125,44,148,92,47,9,114,65,49,5,5,36,14,22
"2021","Central Bedfordshire 010D","E01017413",909,194,106,88,669,121,343,131,149,63,123,59,58,6,82,46,36,0,0,46,22,24
"2021","Central Bedfordshire 010E","E01017414",805,210,107,103,564,107,290,121,102,67,87,54,29,4,77,48,29,3,3,31,14,17
"2021","Central Bedfordshire 010F","E01017415",850,235,122,113,580,103,292,92,153,47,93,47,34,12,85,56,29,7,7,35,17,18
"2021","Central Bedfordshire 011A","E01017437",807,237,83,154,527,64,238,86,115,37,125,60,61,4,93,55,38,7,7,43,17,26
"2021","Central Bedfordshire 011B","E01017438",726,221,96,125,480,90,252,81,127,44,88,42,40,6,50,34,16,0,0,25,9,16
"2021","Central Bedfordshire 011C","E01017439",792,149,71,78,602,52,354,96,207,51,121,62,51,8,74,49,25,1,1,41,14,27
"2021","Central Bedfordshire 011D","E01017440",823,266,84,182,527,59,248,74,138,36,124,70,51,3,93,74,19,3,3,30,12,18
"2021","Central Bedfordshire 011E","E01017441",643,104,54,50,513,45,355,116,196,43,72,30,37,5,40,23,17,1,1,26,19,7
"2021","Central Bedfordshire 011F","E01017444",877,230,110,120,616,108,314,114,140,60,116,64,39,13,75,46,29,3,3,31,8,23
"2021","Central Bedfordshire 012A","E01017371",738,181,115,66,538,94,267,81,138,48,108,52,51,5,69,50,19,0,0,19,8,11
"2021","Central Bedfordshire 012B","E01017372",789,211,109,102,555,69,281,102,146,33,105,53,45,7,94,60,34,6,6,23,14,9
"2021","Central Bedfordshire 012C","E01017373",864,179,77,102,653,63,398,91,251,56,94,45,43,6,95,65,30,3,3,32,17,15
"2021","Central Bedfordshire 012D","E01017374",664,174,66,108,459,104,239,78,117,44,59,39,15,5,53,39,14,4,4,31,12,19
"2021","Central Bedfordshire 012E","E01017375",689,260,120,140,410,71,227,74,102,51,64,44,17,3,44,27,17,4,4,19,4,15
"2021","Central Bedfordshire 013A","E01017391",632,171,69,102,438,64,195,60,90,45,89,39,41,9,87,54,33,3,3,23,12,11
"2021","Central Bedfordshire 013B","E01017392",778,182,110,72,568,145,306,112,140,54,74,48,26,0,42,25,17,1,1,28,16,12
"2021","Central Bedfordshire 013C","E01017393",804,170,87,83,603,99,339,131,150,58,98,55,36,7,66,39,27,1,1,31,15,16
"2021","Central Bedfordshire 013D","E01017442",1075,203,80,123,828,108,464,160,244,60,164,83,73,8,90,55,35,2,2,44,24,20
"2021","Central Bedfordshire 013E","E01017443",716,229,86,143,467,58,247,89,142,16,110,64,43,3,50,35,15,2,2,20,4,16
"2021","Central Bedfordshire 014A","E01017446",741,213,97,116,502,77,263,85,120,58,99,41,55,3,62,34,28,1,1,26,11,15
"2021","Central Bedfordshire 014B","E01017447",1046,246,122,124,764,133,390,122,192,76,150,72,67,11,88,59,29,3,3,36,13,23
"2021","Central Bedfordshire 014D","E01017449",862,195,101,94,631,85,345,107,183,55,108,50,51,7,89,60,29,4,4,36,18,18
"2021","Central Bedfordshire 014E","E01033188",602,130,74,56,450,89,236,76,115,45,65,21,38,6,58,33,25,2,2,22,9,13
"2021","Central Bedfordshire 014F","E01033189",1053,204,59,145,813,52,503,122,333,48,159,76,79,4,98,68,30,1,1,36,18,18
"2021","Central Bedfordshire 014G","E01033190",631,184,57,127,423,41,244,70,156,18,74,44,29,1,63,45,18,1,1,24,11,13
"2021","Central Bedfordshire 015A","E01017399",590,134,38,96,430,50,225,86,106,33,96,64,26,6,57,36,21,2,2,26,11,15
"2021","Central Bedfordshire 015B","E01017400",657,223,104,119,405,35,157,56,63,38,86,32,39,15,123,70,53,4,4,29,12,17
"2021","Central Bedfordshire 015C","E01017401",533,174,70,104,346,46,196,69,94,33,62,37,20,5,38,21,17,4,4,13,9,4
"2021","Central Bedfordshire 015D","E01017402",654,174,109,65,458,110,246,89,91,66,54,30,22,2,46,19,27,2,2,22,7,15
"2021","Central Bedfordshire 016A","E01017403",626,187,78,109,410,64,224,83,102,39,69,36,27,6,50,27,23,3,3,29,8,21
"2021","Central Bedfordshire 016B","E01017404",493,83,52,31,396,80,258,89,109,60,36,17,16,3,21,8,13,1,1,14,6,8
"2021","Central Bedfordshire 016C","E01017405",606,171,64,107,408,41,214,84,88,42,89,56,29,4,64,29,35,0,0,27,13,14
"2021","Central Bedfordshire 016D","E01017406",1041,217,58,159,795,63,423,133,230,60,205,126,73,6,98,69,29,6,6,29,13,16
"2021","Central Bedfordshire 016E","E01017407",677,214,69,145,440,57,221,79,101,41,101,57,42,2,59,37,22,2,2,23,6,17
"2021","Central Bedfordshire 017A","E01017398",990,169,95,74,766,146,448,164,207,77,97,38,47,12,71,45,26,4,4,55,20,35
"2021","Central Bedfordshire 017B","E01017408",429,96,48,48,316,65,177,60,86,31,55,32,17,6,15,10,5,4,4,17,5,12
"2021","Central Bedfordshire 017C","E01017409",519,136,85,51,370,75,208,80,86,42,44,24,16,4,41,20,21,2,2,13,6,7
"2021","Central Bedfordshire 017E","E01017450",889,185,86,99,665,126,363,131,156,76,99,44,46,9,71,40,31,6,6,39,20,19
"2021","Central Bedfordshire 017F","E01033824",637,117,28,89,493,31,272,64,175,33,91,47,40,4,96,76,20,3,3,27,13,14
"2021","Central Bedfordshire 017G","E01033825",695,174,93,81,487,105,274,99,127,48,56,23,29,4,51,31,20,1,1,34,12,22
"2021","Central Bedfordshire 018A","E01017558",752,204,88,116,517,71,271,90,115,66,93,46,38,9,80,49,31,2,2,31,15,16
"2021","Central Bedfordshire 018B","E01017559",679,165,103,62,485,83,276,78,125,73,64,36,26,2,61,37,24,1,1,29,14,15
"2021","Central Bedfordshire 018C","E01017560",626,157,110,47,444,116,225,69,106,50,64,27,30,7,39,10,29,0,0,25,10,15
"2021","Central Bedfordshire 018D","E01017616",953,247,82,165,654,71,318,99,153,66,138,78,52,8,120,76,44,7,7,52,25,27
"2021","Central Bedfordshire 019A","E01017577",1064,250,111,139,779,131,426,167,179,80,124,69,47,8,97,61,36,1,1,35,13,22
"2021","Central Bedfordshire 019C","E01017620",761,187,94,93,534,89,306,105,143,58,79,47,26,6,59,32,27,1,1,40,18,22
"2021","Central Bedfordshire 019D","E01017621",640,161,106,55,462,110,242,80,107,55,66,30,30,6,43,21,22,1,1,17,6,11
"2021","Central Bedfordshire 019E","E01017622",706,192,101,91,467,55,235,69,117,49,86,45,35,6,90,54,36,1,1,47,15,32
"2021","Central Bedfordshire 019F","E01033826",440,55,17,38,363,19,184,68,96,20,137,88,48,1,21,15,6,2,2,22,10,12
"2021","Central Bedfordshire 019G","E01033827",806,173,101,72,579,138,323,144,109,70,77,42,31,4,41,20,21,0,0,54,29,25
"2021","Central Bedfordshire 020A","E01017603",642,166,80,86,454,80,244,91,105,48,71,36,29,6,52,29,23,7,7,22,5,17
"2021","Central Bedfordshire 020B","E01017604",635,125,65,60,484,82,268,100,115,53,81,37,37,7,52,23,29,1,1,26,11,15
"2021","Central Bedfordshire 020C","E01017605",509,104,43,61,361,27,165,49,80,36,59,17,32,10,107,74,33,3,3,44,24,20
"2021","Central Bedfordshire 020D","E01017606",737,155,99,56,563,152,285,85,146,54,79,48,27,4,43,19,24,4,4,19,10,9
"2021","Central Bedfordshire 020E","E01017607",532,93,60,33,416,111,227,76,103,48,51,24,21,6,25,17,8,2,2,23,11,12
"2021","Central Bedfordshire 021A","E01017555",1060,488,193,295,531,53,208,76,97,35,156,108,45,3,106,69,37,8,8,41,15,26
"2021","Central Bedfordshire 021B","E01017556",724,218,67,151,476,44,243,75,126,42,112,65,39,8,74,38,36,3,3,30,10,20
"2021","Central Bedfordshire 021C","E01017557",1002,456,216,240,511,67,213,92,99,22,129,83,37,9,93,59,34,9,9,35,11,24
"2021","Central Bedfordshire 021D","E01017608",752,238,102,136,479,63,245,87,117,41,93,50,39,4,76,43,33,2,2,35,12,23
"2021","Central Bedfordshire 021E","E01017609",818,184,68,116,583,34,247,60,136,51,116,44,63,9,182,119,63,4,4,51,22,29
"2021","Central Bedfordshire 022A","E01017589",808,301,80,221,467,50,199,74,96,29,140,103,31,6,72,42,30,6,6,40,7,33
"2021","Central Bedfordshire 022B","E01017590",662,192,107,85,450,114,222,89,99,34,63,31,28,4,48,21,27,3,3,20,7,13
"2021","Central Bedfordshire 022C","E01017591",776,231,100,131,518,83,246,86,124,36,104,65,36,3,77,43,34,8,8,27,8,19
"2021","Central Bedfordshire 022D","E01017610",446,68,47,21,366,104,182,53,86,43,39,19,19,1,40,22,18,1,1,12,6,6
"2021","Central Bedfordshire 023A","E01017611",510,119,46,73,379,82,214,71,103,40,52,24,28,0,29,16,13,2,2,12,3,9
"2021","Central Bedfordshire 023B","E01017612",531,137,64,73,375,58,207,67,108,32,73,36,33,4,36,21,15,1,1,19,4,15
"2021","Central Bedfordshire 023C","E01017613",594,161,78,83,404,86,226,69,123,34,54,31,21,2,37,17,20,1,1,29,13,16
"2021","Central Bedfordshire 023D","E01017614",585,134,71,63,433,65,245,79,125,41,76,45,23,8,44,24,20,3,3,18,6,12
"2021","Central Bedfordshire 025A","E01017600",837,231,58,173,548,35,298,105,149,44,130,61,58,11,79,53,26,6,6,58,30,28
"2021","Central Bedfordshire 025B","E01017601",506,104,37,67,340,33,138,31,65,42,60,19,33,8,103,67,36,6,6,62,42,20
"2021","Central Bedfordshire 025C","E01017602",628,219,82,137,347,34,164,44,76,44,60,23,29,8,84,53,31,5,5,62,39,23
"2021","Central Bedfordshire 025D","E01017618",795,154,59,95,570,27,280,69,173,38,112,40,61,11,145,99,46,6,6,71,40,31
"2021","Central Bedfordshire 025E","E01017619",777,159,66,93,543,36,268,56,160,52,86,28,50,8,146,91,55,7,7,75,38,37
"2021","Central Bedfordshire 024A","E01017573",596,144,100,44,429,101,213,71,93,49,63,28,25,10,50,21,29,2,2,23,6,17
"2021","Central Bedfordshire 024D","E01017576",556,122,68,54,413,76,217,76,95,46,75,40,26,9,43,25,18,2,2,21,8,13
"2021","Central Bedfordshire 024E","E01033191",715,161,31,130,528,22,249,60,168,21,152,81,67,4,100,77,23,5,5,26,13,13
"2021","Central Bedfordshire 024F","E01033192",617,122,15,107,462,11,219,51,160,8,134,65,66,3,96,82,14,2,2,33,18,15
"2021","Central Bedfordshire 024H","E01033828",544,124,33,91,398,13,219,66,140,13,135,71,64,0,27,17,10,4,4,22,10,12
"2021","Central Bedfordshire 024I","E01033829",507,133,35,98,349,18,149,44,87,18,110,59,49,2,66,49,17,6,6,25,12,13
"2021","Central Bedfordshire 024J","E01033830",494,170,62,108,315,24,138,50,65,23,90,47,39,4,62,38,24,1,1,9,1,8
"2021","Central Bedfordshire 024K","E01033831",420,104,41,63,302,39,183,60,89,34,52,29,20,3,24,16,8,4,4,14,7,7
"2021","Central Bedfordshire 024L","E01033832",499,129,59,70,357,14,182,42,127,13,104,53,49,2,55,45,10,2,2,13,10,3
"2021","Central Bedfordshire 024M","E01033833",537,84,15,69,430,12,233,52,158,23,106,57,49,0,76,63,13,3,3,23,11,12
"2021","Central Bedfordshire 026A","E01017578",912,175,74,101,666,60,366,123,182,61,135,75,55,5,92,53,39,13,13,71,27,44
"2021","Central Bedfordshire 026B","E01017579",787,181,72,109,550,49,274,86,140,48,108,42,56,10,117,73,44,2,2,56,27,29
"2021","Central Bedfordshire 026C","E01017580",1022,277,58,219,690,30,288,98,150,40,175,84,81,10,188,130,58,9,9,55,26,29
"2021","Central Bedfordshire 026D","E01017581",758,240,89,151,462,53,218,69,108,41,98,46,44,8,84,47,37,9,9,56,29,27
"2021","Central Bedfordshire 026E","E01017617",529,133,84,49,356,56,189,62,75,52,44,16,23,5,58,25,33,9,9,40,23,17
"2021","Central Bedfordshire 027A","E01017582",600,148,78,70,406,65,224,55,103,66,68,29,34,5,46,18,28,3,3,46,20,26
"2021","Central Bedfordshire 027B","E01017583",746,163,84,79,524,61,292,77,150,65,89,44,33,12,75,37,38,7,7,59,28,31
"2021","Central Bedfordshire 027C","E01017584",806,203,100,103,526,83,264,77,127,60,84,37,38,9,83,41,42,12,12,77,30,47
"2021","Central Bedfordshire 027D","E01017585",535,109,73,36,393,86,219,72,89,58,44,16,21,7,42,12,30,2,2,33,18,15
"2021","Central Bedfordshire 028A","E01017566",596,138,99,39,419,112,228,87,94,47,49,32,15,2,29,13,16,1,1,39,17,22
"2021","Central Bedfordshire 028B","E01017595",464,119,59,60,319,51,144,39,71,34,49,17,22,10,72,31,41,3,3,26,16,10
"2021","Central Bedfordshire 028C","E01017596",620,157,62,95,421,27,191,44,114,33,84,31,42,11,108,63,45,11,11,42,23,19
"2021","Central Bedfordshire 028D","E01017597",616,159,81,78,413,43,210,55,105,50,73,33,32,8,81,52,29,6,6,44,19,25
"2021","Central Bedfordshire 028E","E01017598",641,136,55,81,465,48,272,79,152,41,95,43,49,3,48,29,19,2,2,40,22,18
"2021","Central Bedfordshire 028G","E01033834",643,190,64,126,405,26,197,42,126,29,103,52,46,5,71,46,25,8,8,48,22,26
"2021","Central Bedfordshire 028H","E01033835",573,134,26,108,397,21,185,54,107,24,94,48,39,7,91,67,24,6,6,42,18,24
"2021","Central Bedfordshire 029A","E01017565",636,155,114,41,454,115,251,91,96,64,47,20,24,3,40,13,27,1,1,27,15,12
"2021","Central Bedfordshire 029B","E01017567",708,224,83,141,436,58,205,66,94,45,84,33,45,6,81,44,37,8,8,48,16,32
"2021","Central Bedfordshire 029C","E01017568",1040,398,135,263,563,33,224,76,113,35,156,94,60,2,134,93,41,16,16,79,24,55
"2021","Central Bedfordshire 029D","E01017569",813,295,114,181,473,28,211,74,106,31,122,69,45,8,102,67,35,10,10,45,19,26
"2021","Central Bedfordshire 029F","E01033836",727,242,85,157,436,27,203,58,124,21,144,83,58,3,49,35,14,13,13,49,29,20
"2021","Central Bedfordshire 029G","E01033837",705,260,76,184,400,38,193,60,108,25,96,61,32,3,63,39,24,10,10,45,22,23
"2021","Central Bedfordshire 030A","E01017592",753,275,132,143,423,45,199,72,88,39,83,42,31,10,89,46,43,7,7,55,28,27
"2021","Central Bedfordshire 030B","E01017593",636,181,102,79,417,81,212,55,99,58,66,23,34,9,57,33,24,1,1,38,16,22
"2021","Central Bedfordshire 030C","E01017594",894,218,65,153,609,21,228,63,131,34,114,42,66,6,237,170,67,9,9,67,38,29
"2021","Central Bedfordshire 031A","E01017623",787,291,97,194,461,47,226,95,92,39,89,48,38,3,90,48,42,9,9,35,13,22
"2021","Central Bedfordshire 031B","E01017624",725,155,68,87,522,85,261,97,110,54,99,53,40,6,75,34,41,2,2,48,24,24
"2021","Central Bedfordshire 031C","E01017625",647,140,103,37,482,128,246,88,100,58,58,24,30,4,47,19,28,3,3,25,15,10
"2021","Central Bedfordshire 031D","E01017626",664,156,86,70,479,117,273,97,111,65,44,21,22,1,45,16,29,0,0,29,10,19
"2021","Central Bedfordshire 032A","E01017571",544,151,83,68,363,96,173,68,67,38,50,33,14,3,43,22,21,1,1,30,14,16
"2021","Central Bedfordshire 032B","E01017572",587,145,74,71,412,91,207,74,86,47,66,38,22,6,45,25,20,3,3,30,14,16
"2021","Central Bedfordshire 032C","E01017586",628,160,91,69,440,74,227,84,101,42,72,34,30,8,65,37,28,2,2,28,12,16
"2021","Central Bedfordshire 032D","E01017587",714,167,100,67,515,153,269,135,86,48,51,24,26,1,40,16,24,2,2,32,17,15
"2021","Central Bedfordshire 032E","E01017588",557,174,109,65,354,85,170,71,62,37,54,33,15,6,42,22,20,3,3,29,10,19
"2021","Central Bedfordshire 033A","E01017561",622,134,72,62,461,107,245,98,92,55,65,29,30,6,43,20,23,1,1,27,9,18
"2021","Central Bedfordshire 033B","E01017562",1058,300,169,131,707,100,320,118,155,47,141,77,51,13,136,84,52,10,10,51,26,25
"2021","Central Bedfordshire 033C","E01017563",685,173,118,55,484,131,235,84,109,42,63,32,30,1,53,23,30,2,2,28,10,18
"2021","Central Bedfordshire 033D","E01017564",623,188,100,88,406,85,183,54,98,31,75,40,28,7,59,26,33,4,4,29,11,18
"2021","Cambridge 001A","E01017975",708,187,60,127,373,26,178,56,86,36,54,24,24,6,103,69,34,12,12,148,77,71
"2021","Cambridge 001B","E01017976",688,175,56,119,402,43,207,75,97,35,93,66,26,1,55,21,34,4,4,111,21,90
"2021","Cambridge 001C","E01017977",774,279,53,226,411,23,187,65,93,29,108,72,33,3,88,66,22,5,5,84,22,62
"2021","Cambridge 001D","E01017978",625,213,92,121,331,32,142,42,84,16,67,33,29,5,83,51,32,7,7,81,21,60
"2021","Cambridge 001E","E01017979",662,257,52,205,326,11,144,55,66,23,74,45,21,8,88,57,31,9,9,79,28,51
"2021","Cambridge 001F","E01017980",556,174,57,117,268,30,118,42,52,24,65,44,19,2,47,24,23,8,8,114,8,106
"2021","Cambridge 002A","E01017949",732,275,85,190,342,36,152,56,79,17,106,88,18,0,41,19,22,7,7,115,17,98
"2021","Cambridge 002B","E01017950",532,169,62,107,287,38,144,58,77,9,76,60,13,3,24,13,11,5,5,76,7,69
"2021","Cambridge 002C","E01017951",639,193,62,131,376,49,199,64,102,33,68,43,22,3,48,24,24,12,12,70,18,52
"2021","Cambridge 002D","E01017952",682,237,84,153,384,24,183,46,115,22,73,38,32,3,96,64,32,8,8,61,16,45
"2021","Cambridge 002E","E01017953",724,236,79,157,405,44,221,51,134,36,67,30,31,6,61,34,27,12,12,83,36,47
"2021","Cambridge 002F","E01017954",587,147,65,82,370,39,179,46,100,33,71,30,39,2,76,51,25,5,5,70,23,47
"2021","Cambridge 003B","E01017971",685,239,65,174,358,35,157,48,72,37,74,43,25,6,81,42,39,11,11,88,19,69
"2021","Cambridge 003C","E01017972",685,198,81,117,400,53,189,65,91,33,69,42,25,2,82,45,37,7,7,87,18,69
"2021","Cambridge 003D","E01017973",742,202,89,113,470,56,187,65,83,39,118,55,54,9,103,74,29,6,6,70,12,58
"2021","Cambridge 003E","E01017974",711,208,84,124,411,31,179,57,92,30,117,65,43,9,77,44,33,7,7,92,19,73
"2021","Cambridge 003F","E01032792",594,208,49,159,320,34,144,62,66,16,98,78,18,2,40,22,18,4,4,66,10,56
"2021","Cambridge 003G","E01032802",663,285,116,169,289,28,130,59,63,8,93,77,14,2,30,20,10,8,8,89,13,76
"2021","Cambridge 004A","E01018006",736,283,119,164,386,44,205,74,105,26,96,76,16,4,34,22,12,7,7,67,9,58
"2021","Cambridge 004B","E01018007",616,124,67,57,443,95,265,84,137,44,45,28,14,3,33,12,21,5,5,49,10,39
"2021","Cambridge 004C","E01018008",667,216,88,128,367,50,205,66,113,26,69,48,19,2,36,22,14,7,7,84,18,66
"2021","Cambridge 004D","E01018009",913,363,89,274,443,29,237,102,109,26,123,107,16,0,42,34,8,12,12,107,16,91
"2021","Cambridge 004E","E01018010",843,387,88,299,384,76,191,72,93,26,82,73,7,2,29,13,16,6,6,72,7,65
"2021","Cambridge 005A","E01017955",636,185,107,78,363,59,199,70,108,21,62,53,8,1,39,17,22,4,4,88,16,72
"2021","Cambridge 005E","E01035511",506,132,31,101,345,23,211,52,132,27,66,48,17,1,41,31,10,4,4,29,5,24
"2021","Cambridge 005F","E01035512",409,174,2,172,208,5,125,47,75,3,68,59,8,1,5,3,2,5,5,27,2,25
"2021","Cambridge 005G","E01035513",491,195,23,172,264,32,158,77,65,16,60,50,8,2,10,6,4,4,4,32,3,29
"2021","Cambridge 005H","E01035514",888,363,138,225,398,53,202,87,93,22,92,76,16,0,42,23,19,9,9,127,5,122
"2021","Cambridge 006A","E01017943",898,315,55,260,462,33,218,78,120,20,133,97,34,2,66,41,25,12,12,121,10,111
"2021","Cambridge 006B","E01017944",585,151,44,107,381,30,181,62,99,20,72,40,30,2,90,53,37,8,8,53,9,44
"2021","Cambridge 006C","E01017945",780,256,56,200,408,25,187,88,84,15,127,99,26,2,58,35,23,11,11,116,16,100
"2021","Cambridge 006D","E01017946",607,162,58,104,356,36,150,43,77,30,72,35,34,3,90,58,32,8,8,89,23,66
"2021","Cambridge 006E","E01017947",690,179,65,114,401,51,181,63,88,30,91,48,36,7,67,31,36,11,11,110,26,84
"2021","Cambridge 006F","E01017948",673,230,78,152,382,14,173,62,81,30,81,36,41,4,106,84,22,8,8,61,12,49
"2021","Cambridge 007C","E01017983",1141,454,153,301,549,64,277,120,141,16,159,132,27,0,35,14,21,14,14,138,8,130
"2021","Cambridge 007E","E01017985",652,209,98,111,386,70,215,58,128,29,55,43,10,2,44,23,21,2,2,57,10,47
"2021","Cambridge 007H","E01035515",401,179,68,111,125,13,44,22,17,5,53,41,12,0,10,5,5,5,5,97,5,92
"2021","Cambridge 007I","E01035516",940,284,124,160,563,131,308,116,160,32,81,66,12,3,38,26,12,5,5,93,17,76
"2021","Cambridge 007J","E01035517",426,180,37,143,174,11,77,39,34,4,53,49,4,0,30,20,10,3,3,72,3,69
"2021","Cambridge 008A","E01017987",805,282,57,225,410,40,211,76,109,26,106,95,9,2,46,36,10,7,7,113,8,105
"2021","Cambridge 008B","E01017988",530,144,45,99,278,47,137,49,70,18,67,48,16,3,24,14,10,3,3,108,4,104
"2021","Cambridge 008C","E01017989",899,315,86,229,458,18,203,86,106,11,157,127,26,4,73,44,29,7,7,126,6,120
"2021","Cambridge 008D","E01017990",590,219,52,167,306,24,140,56,73,11,114,97,16,1,23,13,10,5,5,65,2,63
"2021","Cambridge 008E","E01017991",566,249,98,151,252,23,107,39,54,14,59,42,16,1,59,36,23,4,4,65,7,58
"2021","Cambridge 009A","E01017997",1072,305,71,234,575,48,266,82,163,21,155,114,37,4,92,54,38,14,14,192,25,167
"2021","Cambridge 009B","E01017998",723,206,52,154,352,20,151,63,72,16,125,107,18,0,40,23,17,16,16,165,38,127
"2021","Cambridge 009C","E01017999",745,218,70,148,387,26,175,60,83,32,101,72,28,1,71,44,27,14,14,140,22,118
"2021","Cambridge 009D","E01018000",751,265,38,227,319,21,164,57,91,16,100,83,16,1,23,14,9,11,11,167,29,138
"2021","Cambridge 009E","E01018001",749,247,80,167,358,32,146,68,65,13,151,129,22,0,20,11,9,9,9,144,7,137
"2021","Cambridge 010A","E01017965",720,278,118,160,367,41,176,64,84,28,75,42,32,1,74,44,30,1,1,75,15,60
"2021","Cambridge 010C","E01017967",583,138,56,82,332,35,174,44,106,24,60,27,30,3,55,33,22,8,8,113,25,88
"2021","Cambridge 010D","E01017968",695,221,102,119,376,41,226,76,89,61,77,59,14,4,27,17,10,5,5,98,16,82
"2021","Cambridge 010E","E01017969",684,189,70,119,412,28,273,46,191,36,51,32,16,3,54,29,25,6,6,83,17,66
"2021","Cambridge 010F","E01035518",811,306,24,282,418,15,187,94,83,10,159,137,18,4,41,32,9,16,16,87,4,83
"2021","Cambridge 010G","E01035519",584,155,53,102,244,20,145,48,74,23,53,43,10,0,23,13,10,3,3,185,16,169
"2021","Cambridge 011A","E01017959",685,164,79,85,440,54,277,69,176,32,61,46,11,4,41,24,17,7,7,81,24,57
"2021","Cambridge 011B","E01017960",558,137,54,83,361,26,195,49,111,35,55,30,24,1,74,48,26,11,11,60,15,45
"2021","Cambridge 011C","E01017961",572,224,95,129,305,26,160,52,84,24,60,43,14,3,56,32,24,3,3,43,15,28
"2021","Cambridge 011D","E01017962",761,196,74,122,494,61,278,80,150,48,79,52,26,1,71,42,29,5,5,71,17,54
"2021","Cambridge 011E","E01017963",667,184,79,105,410,54,215,65,112,38,67,53,14,0,71,40,31,3,3,73,31,42
"2021","Cambridge 011F","E01017964",507,80,52,28,372,75,227,58,133,36,31,26,4,1,37,15,22,2,2,55,13,42
"2021","Cambridge 013A","E01017992",789,201,115,86,474,47,270,108,115,47,64,35,24,5,83,36,47,10,10,114,38,76
"2021","Cambridge 013C","E01017994",741,127,56,71,537,46,224,59,117,48,173,139,28,6,88,55,33,6,6,77,22,55
"2021","Cambridge 013D","E01017995",821,181,94,87,565,125,339,106,190,43,55,37,16,2,42,26,16,4,4,75,18,57
"2021","Cambridge 013E","E01017996",622,173,71,102,390,56,222,77,122,23,74,52,19,3,31,20,11,7,7,59,7,52
"2021","Cambridge 013F","E01035520",484,88,44,44,290,52,170,56,87,27,31,19,11,1,35,22,13,2,2,106,21,85
"2021","Cambridge 013G","E01035521",561,247,23,224,135,25,74,34,29,11,24,17,6,1,8,5,3,4,4,179,8,171
"2021","Cambridge 015A","E01035524",588,133,5,128,421,8,223,49,161,13,85,57,28,0,102,87,15,3,3,34,12,22
"2021","Cambridge 015B","E01035525",687,216,73,143,417,38,205,61,128,16,110,74,33,3,63,46,17,1,1,54,14,40
"2021","Cambridge 015C","E01035526",794,208,50,158,525,23,262,67,174,21,120,70,50,0,114,85,29,6,6,61,21,40
"2021","Cambridge 015D","E01035527",530,112,14,98,338,9,196,46,140,10,71,42,29,0,59,48,11,3,3,80,34,46
"2021","Cambridge 015E","E01035528",559,113,31,82,368,26,188,54,114,20,76,47,25,4,75,59,16,3,3,78,28,50
"2021","Cambridge 015F","E01035529",553,94,6,88,372,14,197,64,119,14,76,43,29,4,83,69,14,2,2,87,44,43
"2021","Cambridge 015G","E01035530",562,133,52,81,390,30,243,77,145,21,62,49,13,0,52,32,20,3,3,39,12,27
"2021","Cambridge 014A","E01018005",690,307,76,231,295,26,143,59,73,11,72,59,9,4,49,26,23,5,5,88,6,82
"2021","Cambridge 014D","E01032794",593,227,109,118,311,71,170,70,83,17,44,37,7,0,21,10,11,5,5,55,8,47
"2021","Cambridge 014B","E01035522",659,325,34,291,276,35,86,49,34,3,110,98,11,1,34,20,14,11,11,58,1,57
"2021","Cambridge 014C","E01035523",491,153,24,129,305,18,158,49,90,19,72,52,18,2,54,40,14,3,3,33,12,21
"2021","East Cambridgeshire 001A","E01018042",650,217,119,98,392,76,174,78,67,29,82,55,22,5,58,37,21,2,2,41,15,26
"2021","East Cambridgeshire 001B","E01018043",909,226,122,104,633,114,323,116,142,65,126,68,48,10,69,43,26,1,1,50,28,22
"2021","East Cambridgeshire 001C","E01018044",819,272,76,196,509,77,242,108,93,41,112,72,38,2,71,49,22,7,7,38,8,30
"2021","East Cambridgeshire 001D","E01018045",558,124,44,80,400,42,226,101,87,38,82,45,30,7,49,28,21,1,1,34,11,23
"2021","East Cambridgeshire 001F","E01035531",517,170,76,94,325,26,136,38,76,22,94,42,48,4,66,36,30,3,3,22,11,11
"2021","East Cambridgeshire 001G","E01035532",641,103,32,71,501,32,274,64,184,26,134,76,54,4,61,44,17,0,0,37,16,21
"2021","East Cambridgeshire 002A","E01018020",605,110,55,55,461,77,279,87,133,59,59,35,22,2,40,21,19,6,6,34,9,25
"2021","East Cambridgeshire 002B","E01018021",625,161,86,75,443,92,234,83,112,39,65,40,20,5,49,27,22,3,3,21,9,12
"2021","East Cambridgeshire 002C","E01018022",604,140,72,68,436,86,229,99,91,39,67,33,29,5,53,29,24,1,1,28,8,20
"2021","East Cambridgeshire 002D","E01018055",855,195,95,100,633,136,338,136,149,53,109,59,42,8,48,27,21,2,2,27,9,18
"2021","East Cambridgeshire 002E","E01018056",820,220,85,135,559,76,286,93,156,37,111,62,44,5,85,52,33,1,1,41,15,26
"2021","East Cambridgeshire 003A","E01018027",785,240,120,120,523,120,264,87,140,37,87,58,24,5,47,34,13,5,5,22,7,15
"2021","East Cambridgeshire 003D","E01018032",1088,326,150,176,715,152,391,145,197,49,99,63,30,6,72,39,33,1,1,47,14,33
"2021","East Cambridgeshire 003E","E01018033",912,344,185,159,538,107,227,79,112,36,102,59,39,4,96,58,38,6,6,30,9,21
"2021","East Cambridgeshire 003F","E01033426",566,99,37,62,442,30,276,64,191,21,71,33,31,7,63,47,16,2,2,25,15,10
"2021","East Cambridgeshire 003G","E01033430",587,174,71,103,383,42,166,58,79,29,64,30,31,3,109,72,37,2,2,30,8,22
"2021","East Cambridgeshire 003H","E01035533",638,148,22,126,461,28,252,85,145,22,123,89,33,1,52,36,16,6,6,29,9,20
"2021","East Cambridgeshire 003I","E01035534",636,260,86,174,352,60,157,63,70,24,71,56,13,2,59,42,17,5,5,24,10,14
"2021","East Cambridgeshire 004A","E01018024",584,209,154,55,351,95,173,67,75,31,56,42,11,3,26,15,11,1,1,24,8,16
"2021","East Cambridgeshire 004B","E01018025",745,361,158,203,351,38,174,82,76,16,96,81,13,2,37,24,13,6,6,33,8,25
"2021","East Cambridgeshire 004C","E01018026",702,239,127,112,443,92,204,105,77,22,80,60,18,2,62,36,26,5,5,20,1,19
"2021","East Cambridgeshire 004F","E01033425",706,111,25,86,559,46,373,74,264,35,101,57,37,7,36,28,8,3,3,36,16,20
"2021","East Cambridgeshire 004H","E01035535",1025,294,116,178,693,121,368,116,192,60,124,81,38,5,80,51,29,0,0,38,13,25
"2021","East Cambridgeshire 005A","E01018036",719,220,120,100,472,77,250,86,121,43,82,48,28,6,60,41,19,3,3,27,12,15
"2021","East Cambridgeshire 005B","E01018037",597,118,59,59,455,99,260,104,107,49,61,32,24,5,35,20,15,0,0,24,14,10
"2021","East Cambridgeshire 005C","E01018038",665,159,79,80,479,102,268,102,125,41,77,45,23,9,30,21,9,2,2,27,8,19
"2021","East Cambridgeshire 005D","E01018039",553,155,89,66,374,77,201,70,87,44,49,23,21,5,46,28,18,1,1,24,5,19
"2021","East Cambridgeshire 005E","E01018053",738,194,92,102,510,106,274,100,124,50,68,38,23,7,62,37,25,0,0,34,18,16
"2021","East Cambridgeshire 005F","E01018054",1042,255,109,146,738,141,399,159,174,66,112,71,36,5,83,49,34,3,3,49,23,26
"2021","East Cambridgeshire 006A","E01018047",825,205,82,123,573,76,296,126,121,49,115,50,57,8,83,48,35,3,3,47,23,24
"2021","East Cambridgeshire 006C","E01018049",895,294,168,126,566,87,303,113,134,56,106,62,40,4,68,49,19,2,2,35,11,24
"2021","East Cambridgeshire 006D","E01018050",599,143,57,86,425,57,217,72,107,38,71,38,29,4,76,50,26,4,4,31,10,21
"2021","East Cambridgeshire 006E","E01018051",997,226,98,128,724,86,347,119,180,48,158,74,74,10,127,92,35,6,6,47,17,30
"2021","East Cambridgeshire 006F","E01018052",895,366,148,218,478,71,214,65,112,37,110,57,47,6,76,53,23,7,7,51,17,34
"2021","East Cambridgeshire 006G","E01033427",504,121,25,96,359,16,181,45,107,29,87,45,39,3,71,55,16,4,4,24,14,10
"2021","East Cambridgeshire 006H","E01033429",892,263,101,162,590,99,279,95,136,48,136,82,48,6,69,40,29,7,7,39,19,20
"2021","East Cambridgeshire 007A","E01018034",697,158,75,83,510,92,278,90,143,45,90,51,35,4,45,26,19,5,5,29,15,14
"2021","East Cambridgeshire 007B","E01018035",957,283,120,163,637,92,347,141,141,65,115,64,42,9,79,53,26,4,4,37,12,25
"2021","East Cambridgeshire 007C","E01018040",554,123,67,56,402,100,226,91,105,30,46,23,22,1,29,12,17,1,1,29,10,19
"2021","East Cambridgeshire 007D","E01018041",495,134,67,67,337,42,181,75,81,25,62,26,25,11,50,28,22,2,2,24,12,12
"2021","East Cambridgeshire 008A","E01018013",828,249,148,101,545,126,274,100,129,45,96,51,36,9,48,27,21,1,1,34,12,22
"2021","East Cambridgeshire 008B","E01018014",767,219,93,126,528,86,279,91,142,46,97,60,29,8,64,39,25,2,2,20,5,15
"2021","East Cambridgeshire 008C","E01018015",577,135,69,66,420,92,233,88,110,35,60,34,21,5,34,15,19,1,1,22,7,15
"2021","East Cambridgeshire 008D","E01018016",589,171,96,75,400,54,208,67,99,42,62,29,31,2,74,50,24,2,2,18,2,16
"2021","East Cambridgeshire 009A","E01018011",1027,245,130,115,736,166,393,127,199,67,106,59,41,6,68,42,26,3,3,46,21,25
"2021","East Cambridgeshire 009B","E01018012",634,155,79,76,446,85,231,60,134,37,60,24,29,7,70,50,20,0,0,33,8,25
"2021","East Cambridgeshire 009C","E01018057",857,219,117,102,595,109,330,117,150,63,83,48,29,6,73,44,29,0,0,43,17,26
"2021","East Cambridgeshire 011A","E01018017",592,176,109,67,398,66,230,90,113,27,49,32,15,2,50,35,15,3,3,18,4,14
"2021","East Cambridgeshire 011B","E01018019",478,129,68,61,333,85,163,62,75,26,41,21,20,0,42,33,9,2,2,16,7,9
"2021","East Cambridgeshire 011C","E01018023",920,228,108,120,641,123,352,144,155,53,96,66,22,8,67,43,24,3,3,51,11,40
"2021","East Cambridgeshire 011D","E01032611",740,207,79,128,498,108,278,114,121,43,73,52,18,3,34,14,20,5,5,35,7,28
"2021","Fenland 001A","E01018094",814,233,133,100,546,124,222,101,77,44,104,46,49,9,96,67,29,0,0,35,14,21
"2021","Fenland 001B","E01018095",718,158,108,50,511,132,236,109,79,48,70,37,25,8,68,30,38,5,5,49,19,30
"2021","Fenland 001C","E01018096",791,270,149,121,477,120,230,103,72,55,77,46,26,5,47,24,23,3,3,44,23,21
"2021","Fenland 001D","E01018097",682,159,95,64,482,102,236,132,69,35,78,45,28,5,62,31,31,4,4,41,13,28
"2021","Fenland 002A","E01018063",1138,329,105,224,673,68,237,94,111,32,188,104,66,18,166,121,45,14,14,136,50,86
"2021","Fenland 002B","E01018073",1049,262,132,130,694,111,291,120,99,72,160,77,71,12,124,76,48,8,8,93,53,40
"2021","Fenland 002C","E01018107",661,160,83,77,425,45,180,72,87,21,90,30,51,9,99,74,25,11,11,76,47,29
"2021","Fenland 002D","E01018108",829,223,96,127,525,73,171,60,81,30,140,56,70,14,134,98,36,7,7,81,48,33
"2021","Fenland 002E","E01018109",808,237,115,122,503,84,190,70,89,31,113,56,52,5,107,69,38,9,9,68,33,35
"2021","Fenland 003A","E01018069",749,189,103,86,509,96,260,112,91,57,88,47,35,6,60,42,18,5,5,51,24,27
"2021","Fenland 003B","E01018070",877,284,93,191,500,45,163,68,73,22,146,70,68,8,132,89,43,14,14,93,38,55
"2021","Fenland 003C","E01018071",822,282,140,142,457,80,156,62,59,35,97,47,41,9,106,69,37,18,18,83,40,43
"2021","Fenland 003E","E01018093",1077,350,175,175,653,108,309,134,110,65,133,67,61,5,96,62,34,7,7,74,40,34
"2021","Fenland 003F","E01018103",490,149,58,91,284,26,108,28,53,27,71,21,43,7,77,51,26,2,2,57,28,29
"2021","Fenland 003G","E01018104",523,155,81,74,344,63,170,74,49,47,65,25,33,7,41,16,25,5,5,24,10,14
"2021","Fenland 003H","E01033111",761,254,134,120,448,95,166,74,58,34,101,46,49,6,76,43,33,10,10,59,28,31
"2021","Fenland 003I","E01033112",692,332,111,221,288,21,101,47,39,15,92,57,32,3,58,39,19,16,16,72,26,46
"2021","Fenland 004A","E01018066",683,215,119,96,433,96,193,82,68,43,77,38,33,6,62,37,25,5,5,35,12,23
"2021","Fenland 004B","E01018067",791,207,109,98,543,123,234,98,88,48,120,59,53,8,65,39,26,1,1,41,20,21
"2021","Fenland 004C","E01018068",647,134,70,64,468,96,214,112,60,42,100,43,45,12,55,33,22,3,3,45,19,26
"2021","Fenland 004D","E01018090",871,220,130,90,601,124,279,137,88,54,112,54,50,8,83,49,34,3,3,50,26,24
"2021","Fenland 004E","E01018091",648,170,67,103,425,65,211,99,74,38,80,48,25,7,66,38,28,3,3,53,26,27
"2021","Fenland 004F","E01018092",813,236,113,123,521,95,239,107,84,48,108,52,51,5,76,48,28,3,3,56,25,31
"2021","Fenland 005A","E01018081",603,131,71,60,428,62,223,91,90,42,73,29,40,4,69,36,33,1,1,44,17,27
"2021","Fenland 005B","E01018082",815,226,122,104,549,92,273,107,112,54,122,58,55,9,60,34,26,2,2,40,20,20
"2021","Fenland 005C","E01018083",760,212,99,113,501,55,209,65,100,44,126,56,58,12,106,68,38,5,5,47,20,27
"2021","Fenland 005D","E01018084",926,292,157,135,590,137,253,112,84,57,110,66,40,4,87,59,28,3,3,44,15,29
"2021","Fenland 006A","E01018064",1034,231,115,116,767,127,385,162,171,52,158,75,72,11,93,64,29,4,4,36,17,19
"2021","Fenland 006B","E01018072",951,222,100,122,659,65,260,89,117,54,199,85,104,10,134,93,41,1,1,70,35,35
"2021","Fenland 006C","E01018074",534,145,90,55,366,94,177,78,63,36,61,24,27,10,32,20,12,2,2,23,11,12
"2021","Fenland 006D","E01018075",517,169,104,65,318,60,132,50,54,28,52,27,20,5,72,46,26,2,2,30,15,15
"2021","Fenland 006E","E01018098",594,214,137,77,356,65,184,81,78,25,62,36,22,4,42,26,16,3,3,24,7,17
"2021","Fenland 006F","E01018099",534,134,80,54,377,89,183,81,56,46,61,26,28,7,43,20,23,1,1,23,10,13
"2021","Fenland 006G","E01018100",706,303,108,195,383,61,145,80,49,16,107,59,40,8,69,45,24,1,1,20,7,13
"2021","Fenland 006H","E01018101",660,220,89,131,407,74,195,89,58,48,73,49,20,4,63,43,20,2,2,33,16,17
"2021","Fenland 007A","E01018077",940,370,137,233,520,93,167,74,55,38,144,78,60,6,108,77,31,8,8,50,15,35
"2021","Fenland 007B","E01018078",831,309,190,119,479,85,177,71,77,29,91,41,44,6,124,88,36,2,2,43,16,27
"2021","Fenland 007C","E01018079",801,252,166,86,515,154,195,103,58,34,81,47,29,5,83,50,33,2,2,34,13,21
"2021","Fenland 007D","E01018080",984,240,129,111,680,135,303,137,115,51,149,66,73,10,89,69,20,4,4,64,27,37
"2021","Fenland 008A","E01018058",696,206,123,83,471,113,223,131,68,24,72,42,26,4,62,39,23,1,1,19,7,12
"2021","Fenland 008B","E01018059",597,114,61,53,458,93,237,106,86,45,79,43,31,5,46,26,20,3,3,25,13,12
"2021","Fenland 008C","E01018060",785,189,68,121,549,73,270,116,110,44,137,81,49,7,64,39,25,5,5,47,24,23
"2021","Fenland 008D","E01018061",533,130,47,83,371,61,186,73,84,29,76,42,26,8,47,24,23,1,1,32,13,19
"2021","Fenland 009A","E01018085",709,215,124,91,467,131,233,110,71,52,61,32,27,2,40,19,21,2,2,27,11,16
"2021","Fenland 009B","E01018086",856,230,127,103,565,101,221,91,83,47,120,45,70,5,120,87,33,3,3,61,30,31
"2021","Fenland 009C","E01018087",1056,377,181,196,624,128,276,117,106,53,122,77,38,7,94,64,30,4,4,55,18,37
"2021","Fenland 009D","E01018088",707,237,141,96,442,116,202,94,66,42,73,34,34,5,51,26,25,0,0,28,20,8
"2021","Fenland 010A","E01018065",1044,248,142,106,745,162,380,169,154,57,142,79,57,6,58,30,28,3,3,51,21,30
"2021","Fenland 010B","E01018076",1079,255,123,132,769,133,392,151,173,68,154,72,75,7,84,54,30,6,6,55,26,29
"2021","Fenland 010C","E01018111",1022,235,148,87,734,169,346,167,126,53,125,70,46,9,88,61,27,6,6,53,28,25
"2021","Fenland 011A","E01018062",1127,305,160,145,764,126,339,146,130,63,180,94,73,13,117,75,42,2,2,58,16,42
"2021","Fenland 011C","E01018105",556,199,93,106,326,60,138,50,55,33,77,34,34,9,50,30,20,1,1,31,13,18
"2021","Fenland 011D","E01018106",701,205,99,106,459,82,210,93,72,45,112,58,49,5,52,35,17,3,3,37,21,16
"2021","Fenland 011E","E01018110",1140,316,160,156,769,143,396,149,176,71,138,73,53,12,84,51,33,8,8,55,18,37
"2021","Fenland 011F","E01035536",791,255,68,187,498,36,229,121,84,24,137,67,63,7,94,62,32,2,2,38,18,20
"2021","Fenland 011G","E01035537",562,192,84,108,341,44,157,56,76,25,74,35,35,4,61,44,17,5,5,29,18,11
"2021","Huntingdonshire 001A","E01018212",682,181,88,93,454,77,210,86,85,39,87,47,33,7,77,44,33,3,3,47,22,25
"2021","Huntingdonshire 001B","E01018213",799,193,71,122,558,65,276,104,125,47,121,61,52,8,93,68,25,3,3,48,24,24
"2021","Huntingdonshire 001C","E01018214",830,235,90,145,547,60,267,86,145,36,93,45,40,8,121,85,36,6,6,48,26,22
"2021","Huntingdonshire 001D","E01018215",606,140,67,73,433,64,226,82,103,41,83,41,38,4,55,39,16,5,5,33,23,10
"2021","Huntingdonshire 001E","E01018216",990,199,82,117,747,110,428,138,222,68,130,60,62,8,77,40,37,2,2,44,20,24
"2021","Huntingdonshire 001F","E01018217",732,221,128,93,482,121,233,92,103,38,73,40,28,5,55,30,25,0,0,29,11,18
"2021","Huntingdonshire 002A","E01018127",640,157,79,78,463,104,258,110,105,43,56,35,14,7,43,20,23,2,2,20,8,12
"2021","Huntingdonshire 002B","E01018128",534,153,74,79,358,81,195,88,71,36,42,24,11,7,38,21,17,2,2,23,7,16
"2021","Huntingdonshire 002C","E01018200",657,120,68,52,503,105,308,125,126,57,59,27,27,5,30,15,15,1,1,34,11,23
"2021","Huntingdonshire 002D","E01018201",617,193,83,110,404,54,198,78,82,38,80,40,37,3,70,45,25,2,2,20,4,16
"2021","Huntingdonshire 003A","E01018156",719,210,129,81,491,115,247,113,89,45,87,38,45,4,40,18,22,2,2,18,9,9
"2021","Huntingdonshire 003B","E01018157",847,178,82,96,627,76,356,140,154,62,124,80,40,4,67,42,25,4,4,42,16,26
"2021","Huntingdonshire 003C","E01018158",906,439,157,282,434,71,169,77,55,37,102,74,23,5,90,62,28,2,2,33,9,24
"2021","Huntingdonshire 003D","E01018159",670,154,59,95,493,95,260,100,116,44,87,48,36,3,50,30,20,1,1,23,8,15
"2021","Huntingdonshire 003E","E01018160",683,219,108,111,428,49,177,63,81,33,106,43,57,6,95,62,33,1,1,36,14,22
"2021","Huntingdonshire 004A","E01018191",567,141,86,55,409,58,218,89,93,36,89,45,40,4,41,26,15,3,3,17,9,8
"2021","Huntingdonshire 004B","E01018192",787,185,94,91,570,111,295,134,116,45,104,61,37,6,58,39,19,2,2,32,11,21
"2021","Huntingdonshire 004C","E01018193",546,141,53,88,388,84,197,70,89,38,65,40,22,3,42,24,18,0,0,17,8,9
"2021","Huntingdonshire 004D","E01018194",587,160,85,75,401,70,227,96,84,47,67,36,25,6,32,17,15,5,5,26,7,19
"2021","Huntingdonshire 004E","E01018195",553,161,69,92,370,47,176,68,67,41,65,35,28,2,79,53,26,3,3,22,11,11
"2021","Huntingdonshire 005A","E01018208",900,227,102,125,638,97,314,134,142,38,128,69,48,11,97,72,25,2,2,35,21,14
"2021","Huntingdonshire 005B","E01018209",669,164,95,69,478,89,271,117,105,49,80,52,22,6,37,20,17,1,1,27,10,17
"2021","Huntingdonshire 005C","E01018210",618,227,117,110,372,42,205,97,76,32,69,34,33,2,55,25,30,1,1,19,6,13
"2021","Huntingdonshire 005D","E01018211",764,149,87,62,580,114,317,126,133,58,88,42,42,4,57,28,29,4,4,35,16,19
"2021","Huntingdonshire 006A","E01018196",553,146,76,70,386,92,203,92,76,35,51,24,25,2,38,15,23,2,2,21,10,11
"2021","Huntingdonshire 006B","E01018197",649,244,126,118,384,49,201,77,88,36,73,43,28,2,57,31,26,4,4,21,7,14
"2021","Huntingdonshire 006C","E01018198",707,180,87,93,496,115,265,116,107,42,72,40,24,8,43,26,17,1,1,31,14,17
"2021","Huntingdonshire 006D","E01018199",661,163,80,83,467,101,248,106,96,46,71,43,26,2,47,26,21,0,0,31,15,16
"2021","Huntingdonshire 006E","E01018206",762,127,39,88,611,29,387,141,217,29,118,75,42,1,73,53,20,4,4,24,11,13
"2021","Huntingdonshire 006F","E01018207",648,145,62,83,482,92,259,119,104,36,73,36,31,6,57,30,27,1,1,21,5,16
"2021","Huntingdonshire 007A","E01018121",530,98,57,41,411,95,245,99,104,42,45,24,16,5,26,9,17,0,0,21,5,16
"2021","Huntingdonshire 007B","E01018122",494,139,90,49,342,81,176,70,71,35,41,29,9,3,41,17,24,3,3,13,6,7
"2021","Huntingdonshire 007C","E01018123",686,166,81,85,491,79,284,124,117,43,88,52,32,4,38,23,15,2,2,29,15,14
"2021","Huntingdonshire 007D","E01018124",779,156,92,64,594,124,328,123,141,64,77,36,36,5,63,32,31,2,2,29,8,21
"2021","Huntingdonshire 008A","E01018143",884,275,103,172,539,41,253,72,144,37,104,42,53,9,133,82,51,8,8,70,25,45
"2021","Huntingdonshire 008B","E01018144",624,141,56,85,397,21,162,36,98,28,97,31,60,6,104,77,27,13,13,86,37,49
"2021","Huntingdonshire 008C","E01018145",485,114,48,66,299,14,143,39,73,31,53,14,34,5,80,49,31,9,9,72,32,40
"2021","Huntingdonshire 008D","E01018146",793,222,55,167,478,20,229,70,115,44,107,42,56,9,115,72,43,7,7,93,38,55
"2021","Huntingdonshire 008E","E01018147",618,145,67,78,400,29,178,55,93,30,77,34,42,1,107,65,42,9,9,73,32,41
"2021","Huntingdonshire 009A","E01018139",618,130,57,73,431,49,234,100,98,36,73,39,27,7,72,47,25,3,3,57,23,34
"2021","Huntingdonshire 009B","E01018140",508,116,67,49,340,82,161,61,65,35,55,29,22,4,39,16,23,3,3,52,15,37
"2021","Huntingdonshire 009C","E01018141",708,179,92,87,504,126,292,132,118,42,55,36,15,4,28,16,12,3,3,25,8,17
"2021","Huntingdonshire 009D","E01018142",631,180,118,62,424,109,182,76,71,35,61,30,27,4,70,40,30,2,2,27,13,14
"2021","Huntingdonshire 010B","E01018113",609,139,88,51,438,85,238,92,88,58,67,41,25,1,43,21,22,5,5,32,18,14
"2021","Huntingdonshire 010D","E01018116",1060,236,93,143,765,70,397,109,242,46,168,91,73,4,124,104,20,6,6,59,37,22
"2021","Huntingdonshire 010E","E01018117",839,285,173,112,522,145,216,84,92,40,83,53,27,3,75,51,24,3,3,32,12,20
"2021","Huntingdonshire 010F","E01018118",866,227,93,134,608,78,309,108,155,46,115,59,48,8,101,56,45,5,5,31,12,19
"2021","Huntingdonshire 010H","E01034435",680,150,60,90,496,42,280,99,145,36,121,78,41,2,52,37,15,1,1,34,11,23
"2021","Huntingdonshire 010I","E01034436",735,191,74,117,527,99,302,108,163,31,73,42,26,5,50,35,15,3,3,17,7,10
"2021","Huntingdonshire 011A","E01018161",583,142,58,84,414,60,191,81,85,25,97,54,39,4,61,30,31,5,5,27,11,16
"2021","Huntingdonshire 011B","E01018162",624,142,41,101,457,95,248,93,102,53,63,43,18,2,49,34,15,2,2,25,4,21
"2021","Huntingdonshire 011C","E01018163",606,202,39,163,374,20,158,57,75,26,113,70,39,4,79,58,21,4,4,30,10,20
"2021","Huntingdonshire 011D","E01018164",527,137,54,83,355,59,169,58,82,29,72,42,27,3,52,31,21,3,3,35,13,22
"2021","Huntingdonshire 011E","E01018165",556,190,57,133,344,42,162,58,83,21,73,56,15,2,64,37,27,3,3,22,9,13
"2021","Huntingdonshire 011F","E01018170",596,175,98,77,393,83,175,64,79,32,77,38,31,8,51,24,27,7,7,28,7,21
"2021","Huntingdonshire 011G","E01018171",688,180,84,96,487,104,260,96,127,37,68,37,29,2,53,27,26,2,2,21,6,15
"2021","Huntingdonshire 012A","E01018138",1063,438,135,303,576,64,287,117,130,40,138,98,36,4,80,44,36,7,7,49,17,32
"2021","Huntingdonshire 012B","E01018148",1045,207,45,162,763,44,431,113,250,68,147,77,62,8,132,96,36,9,9,75,35,40
"2021","Huntingdonshire 012C","E01018149",549,93,33,60,428,36,275,85,135,55,82,53,28,1,35,21,14,0,0,28,16,12
"2021","Huntingdonshire 012D","E01018150",673,193,39,154,442,32,236,72,126,38,89,46,39,4,79,47,32,6,6,38,22,16
"2021","Huntingdonshire 012F","E01034437",583,280,78,202,257,26,95,53,40,2,91,71,18,2,39,28,11,6,6,46,7,39
"2021","Huntingdonshire 012G","E01034438",729,393,107,286,291,33,130,61,60,9,67,53,12,2,51,41,10,10,10,45,8,37
"2021","Huntingdonshire 013A","E01018166",653,194,112,82,432,115,206,65,101,40,62,35,24,3,46,20,26,3,3,27,13,14
"2021","Huntingdonshire 013B","E01018167",596,145,85,60,426,98,238,82,104,52,53,30,20,3,34,15,19,3,3,25,10,15
"2021","Huntingdonshire 013C","E01018168",1180,659,272,387,471,80,165,84,62,19,141,120,19,2,70,42,28,15,15,50,14,36
"2021","Huntingdonshire 013D","E01018169",917,231,92,139,637,94,288,85,154,49,120,65,52,3,133,86,47,2,2,49,19,30
"2021","Huntingdonshire 014A","E01018131",657,221,109,112,394,48,207,66,96,45,75,40,33,2,62,33,29,2,2,42,14,28
"2021","Huntingdonshire 014C","E01018133",674,170,83,87,474,58,279,108,123,48,91,45,42,4,42,26,16,4,4,30,15,15
"2021","Huntingdonshire 014D","E01018134",784,227,65,162,530,62,298,97,168,33,107,66,39,2,59,38,21,4,4,27,11,16
"2021","Huntingdonshire 014E","E01034439",701,331,139,192,350,91,123,57,49,17,76,58,18,0,54,24,30,6,6,20,11,9
"2021","Huntingdonshire 014F","E01034440",643,169,43,126,451,19,205,66,125,14,136,70,61,5,90,77,13,1,1,23,11,12
"2021","Huntingdonshire 015A","E01018125",623,129,68,61,468,92,286,123,108,55,52,32,15,5,35,20,15,3,3,26,12,14
"2021","Huntingdonshire 015B","E01018126",683,110,54,56,545,96,335,144,139,52,72,42,23,7,42,23,19,0,0,28,12,16
"2021","Huntingdonshire 015C","E01018152",599,137,64,73,449,83,268,108,107,53,71,40,27,4,26,15,11,1,1,13,7,6
"2021","Huntingdonshire 015D","E01018153",763,222,121,101,507,116,276,121,107,48,57,32,19,6,57,45,12,1,1,34,8,26
"2021","Huntingdonshire 016A","E01018129",720,191,87,104,490,96,242,93,107,42,87,46,34,7,62,40,22,3,3,39,7,32
"2021","Huntingdonshire 016B","E01018130",809,186,92,94,603,111,299,116,136,47,125,63,58,4,67,45,22,1,1,20,7,13
"2021","Huntingdonshire 016C","E01018202",641,151,111,40,472,145,247,103,108,36,43,28,14,1,37,18,19,0,0,18,8,10
"2021","Huntingdonshire 016D","E01018203",795,220,93,127,538,106,259,88,135,36,99,67,29,3,72,45,27,2,2,37,7,30
"2021","Huntingdonshire 016E","E01018204",555,100,64,36,431,108,249,91,117,41,33,12,17,4,38,24,14,3,3,24,6,18
"2021","Huntingdonshire 016F","E01018205",831,276,150,126,527,159,250,103,114,33,74,45,27,2,41,20,21,3,3,28,6,22
"2021","Huntingdonshire 017A","E01018115",570,153,75,78,405,110,216,112,76,28,51,34,12,5,26,13,13,2,2,12,5,7
"2021","Huntingdonshire 017B","E01018119",690,182,95,87,477,115,255,95,114,46,63,44,16,3,43,25,18,1,1,31,8,23
"2021","Huntingdonshire 017C","E01018120",830,274,158,116,536,132,241,84,107,50,77,36,36,5,83,43,40,3,3,20,3,17
"2021","Huntingdonshire 017D","E01018137",728,161,88,73,543,88,297,131,118,48,104,61,36,7,51,32,19,3,3,24,9,15
"2021","Huntingdonshire 018B","E01018136",687,141,94,47,525,111,319,123,149,47,57,30,21,6,36,20,16,2,2,21,8,13
"2021","Huntingdonshire 018C","E01018154",1085,346,147,199,696,114,338,110,186,42,147,85,56,6,89,61,28,8,8,43,15,28
"2021","Huntingdonshire 018D","E01018155",690,209,102,107,458,123,240,92,109,39,55,30,24,1,40,19,21,0,0,23,9,14
"2021","Huntingdonshire 018E","E01034441",663,121,57,64,519,76,312,92,190,30,85,50,32,3,44,29,15,2,2,23,8,15
"2021","Huntingdonshire 018F","E01034442",642,127,10,117,490,8,241,63,168,10,128,57,69,2,112,94,18,1,1,25,12,13
"2021","Huntingdonshire 018G","E01034443",632,130,20,110,478,15,256,71,164,21,128,75,50,3,77,59,18,2,2,24,9,15
"2021","Huntingdonshire 019A","E01018187",1155,624,237,387,483,60,186,93,68,25,126,87,32,7,99,72,27,12,12,48,13,35
"2021","Huntingdonshire 019B","E01018188",636,207,105,102,410,57,192,60,99,33,87,50,32,5,71,37,34,3,3,19,7,12
"2021","Huntingdonshire 019C","E01018189",499,79,58,21,410,99,243,94,101,48,45,22,15,8,22,13,9,1,1,10,6,4
"2021","Huntingdonshire 019D","E01018190",664,179,86,93,443,57,205,81,81,43,81,35,39,7,97,59,38,3,3,42,17,25
"2021","Huntingdonshire 020A","E01018172",657,226,137,89,408,123,174,63,84,27,68,39,25,4,41,18,23,2,2,23,9,14
"2021","Huntingdonshire 020B","E01018173",516,153,46,107,339,45,161,55,72,34,84,53,28,3,46,31,15,3,3,24,7,17
"2021","Huntingdonshire 020C","E01018174",690,214,86,128,448,93,209,71,88,50,102,57,39,6,42,22,20,2,2,28,6,22
"2021","Huntingdonshire 020D","E01018175",561,116,41,75,428,101,249,88,118,43,46,22,21,3,28,16,12,4,4,17,8,9
"2021","Huntingdonshire 020E","E01018176",522,82,56,26,420,134,233,86,103,44,29,14,13,2,23,13,10,1,1,20,7,13
"2021","Huntingdonshire 021B","E01018182",585,138,50,88,416,49,185,71,79,35,110,58,45,7,68,35,33,4,4,31,14,17
"2021","Huntingdonshire 021C","E01018183",630,192,72,120,398,55,163,81,53,29,86,47,35,4,91,58,33,3,3,40,9,31
"2021","Huntingdonshire 021D","E01018184",494,153,60,93,317,33,134,32,72,30,69,25,32,12,78,49,29,3,3,24,11,13
"2021","Huntingdonshire 021E","E01018185",728,256,125,131,442,95,215,82,79,54,78,47,24,7,52,28,24,2,2,30,9,21
"2021","Huntingdonshire 021F","E01018186",734,221,92,129,472,67,226,88,91,47,88,42,40,6,86,50,36,5,5,41,14,27
"2021","Huntingdonshire 021G","E01034444",721,199,76,123,489,45,270,96,116,58,124,79,41,4,47,25,22,3,3,33,4,29
"2021","Huntingdonshire 021H","E01034445",715,218,63,155,464,25,219,65,129,25,144,86,52,6,73,51,22,3,3,33,13,20
"2021","Huntingdonshire 022A","E01018177",645,200,116,84,412,112,193,79,75,39,71,43,26,2,34,13,21,2,2,33,8,25
"2021","Huntingdonshire 022B","E01018178",676,182,101,81,480,102,236,78,118,40,87,42,40,5,53,28,25,2,2,14,4,10
"2021","Huntingdonshire 022C","E01018179",605,204,91,113,352,41,149,46,76,27,87,45,37,5,72,40,32,3,3,49,15,34
"2021","Huntingdonshire 022D","E01018180",576,205,59,146,343,26,131,50,55,26,96,52,39,5,87,44,43,3,3,28,13,15
"2021","South Cambridgeshire 001A","E01018304",915,267,112,155,610,70,307,120,152,35,134,76,52,6,93,58,35,6,6,38,11,27
"2021","South Cambridgeshire 001B","E01018305",540,125,85,40,391,90,204,70,89,45,55,31,20,4,40,23,17,2,2,24,8,16
"2021","South Cambridgeshire 001C","E01018306",621,111,64,47,488,92,288,92,155,41,60,29,26,5,44,28,16,4,4,22,9,13
"2021","South Cambridgeshire 001D","E01018307",921,214,101,113,676,124,359,130,178,51,105,56,44,5,83,51,32,5,5,31,16,15
"2021","South Cambridgeshire 002A","E01018233",664,203,114,89,428,83,249,95,106,48,64,43,17,4,32,15,17,0,0,33,13,20
"2021","South Cambridgeshire 002B","E01018234",699,231,82,149,442,100,244,75,116,53,66,46,18,2,31,21,10,1,1,26,6,20
"2021","South Cambridgeshire 002C","E01018235",695,199,123,76,476,93,247,68,146,33,66,30,31,5,68,39,29,2,2,20,7,13
"2021","South Cambridgeshire 002D","E01018236",855,261,106,155,557,69,274,74,158,42,120,56,56,8,90,56,34,4,4,37,15,22
"2021","South Cambridgeshire 003A","E01018237",613,153,72,81,437,99,212,71,105,36,68,37,30,1,57,36,21,1,1,23,5,18
"2021","South Cambridgeshire 003C","E01018284",584,180,74,106,383,69,221,76,116,29,55,33,22,0,37,24,13,1,1,21,5,16
"2021","South Cambridgeshire 003D","E01018285",594,177,68,109,403,43,219,80,120,19,82,43,37,2,57,46,11,2,2,14,9,5
"2021","South Cambridgeshire 003E","E01035555",622,107,6,101,476,6,259,71,170,18,150,98,49,3,54,50,4,7,7,39,16,23
"2021","South Cambridgeshire 003F","E01035556",525,110,14,96,382,22,267,55,184,28,56,36,19,1,35,20,15,2,2,33,15,18
"2021","South Cambridgeshire 003G","E01035557",550,136,49,87,399,45,201,74,110,17,80,42,36,2,69,43,26,4,4,15,6,9
"2021","South Cambridgeshire 003H","E01035558",539,143,49,94,366,59,192,53,113,26,74,52,22,0,38,25,13,3,3,30,8,22
"2021","South Cambridgeshire 004A","E01018298",695,190,35,155,463,28,241,79,150,12,125,87,33,5,63,52,11,6,6,42,8,34
"2021","South Cambridgeshire 004B","E01018299",985,276,111,165,675,82,369,123,194,52,137,82,51,4,84,60,24,3,3,34,11,23
"2021","South Cambridgeshire 004C","E01018300",526,155,81,74,351,71,175,67,68,40,66,43,19,4,39,18,21,0,0,20,9,11
"2021","South Cambridgeshire 004D","E01018301",579,171,85,86,383,66,209,74,97,38,59,40,17,2,47,25,22,2,2,25,9,16
"2021","South Cambridgeshire 006A","E01018257",625,192,105,87,408,74,201,52,109,40,66,32,29,5,65,36,29,2,2,25,7,18
"2021","South Cambridgeshire 006B","E01018258",682,180,116,64,474,107,271,81,148,42,60,33,24,3,32,18,14,4,4,28,8,20
"2021","South Cambridgeshire 006C","E01018259",586,150,72,78,404,78,222,72,124,26,63,35,24,4,41,24,17,0,0,32,8,24
"2021","South Cambridgeshire 006D","E01018260",882,340,156,184,512,108,282,95,156,31,84,53,29,2,35,21,14,3,3,30,6,24
"2021","South Cambridgeshire 006F","E01018262",541,132,78,54,395,78,241,79,130,32,38,22,14,2,35,21,14,3,3,14,6,8
"2021","South Cambridgeshire 006G","E01033120",550,123,36,87,328,27,134,49,67,18,61,31,27,3,97,62,35,9,9,99,16,83
"2021","South Cambridgeshire 006H","E01033121",817,215,16,199,463,6,240,59,162,19,128,75,47,6,82,63,19,7,7,139,21,118
"2021","South Cambridgeshire 007A","E01018272",581,108,48,60,434,75,257,79,135,43,63,36,23,4,34,21,13,5,5,39,10,29
"2021","South Cambridgeshire 007B","E01018273",654,264,117,147,345,62,176,64,81,31,64,48,15,1,38,21,17,5,5,45,9,36
"2021","South Cambridgeshire 007C","E01018274",681,189,26,163,450,42,252,100,115,37,108,93,14,1,43,29,14,5,5,42,8,34
"2021","South Cambridgeshire 007D","E01018297",782,268,105,163,471,79,242,100,99,43,94,57,27,10,50,27,23,6,6,43,14,29
"2021","South Cambridgeshire 010A","E01018231",1072,219,110,109,799,133,492,128,287,77,100,59,32,9,73,52,21,1,1,54,24,30
"2021","South Cambridgeshire 010B","E01018232",970,283,169,114,645,138,341,91,185,65,72,35,35,2,91,49,42,3,3,42,13,29
"2021","South Cambridgeshire 010C","E01018251",483,122,48,74,340,45,217,88,91,38,40,28,12,0,38,19,19,0,0,21,10,11
"2021","South Cambridgeshire 010D","E01018252",604,125,49,76,451,58,264,94,116,54,69,43,20,6,58,38,20,2,2,28,11,17
"2021","South Cambridgeshire 010E","E01018255",467,107,59,48,337,76,182,65,87,30,48,34,11,3,31,18,13,0,0,23,8,15
"2021","South Cambridgeshire 011A","E01018242",716,209,112,97,464,76,240,58,140,42,71,42,29,0,71,37,34,6,6,43,16,27
"2021","South Cambridgeshire 011B","E01018243",659,171,57,114,454,47,275,97,133,45,80,51,25,4,43,30,13,9,9,34,8,26
"2021","South Cambridgeshire 011C","E01018244",781,280,116,164,466,122,255,91,128,36,58,35,16,7,30,16,14,1,1,35,9,26
"2021","South Cambridgeshire 011D","E01018286",660,182,59,123,440,41,244,80,121,43,89,51,33,5,62,40,22,4,4,38,9,29
"2021","South Cambridgeshire 011E","E01018287",571,189,39,150,343,30,210,65,127,18,72,53,18,1,26,19,7,5,5,39,11,28
"2021","South Cambridgeshire 011F","E01018296",454,124,60,64,309,72,162,58,81,23,46,31,12,3,28,20,8,1,1,21,9,12
"2021","South Cambridgeshire 012A","E01018292",575,114,70,44,429,82,261,83,140,38,53,38,12,3,32,20,12,1,1,32,11,21
"2021","South Cambridgeshire 012B","E01018293",679,188,133,55,470,112,276,78,161,37,47,36,11,0,35,24,11,0,0,21,12,9
"2021","South Cambridgeshire 012C","E01018294",895,385,138,247,490,81,232,84,108,40,102,80,19,3,73,47,26,2,2,20,4,16
"2021","South Cambridgeshire 012D","E01018295",696,182,121,61,494,114,286,85,157,44,56,30,26,0,33,19,14,5,5,20,5,15
"2021","South Cambridgeshire 013A","E01018245",719,185,123,62,508,122,267,100,121,46,85,39,40,6,33,12,21,1,1,26,10,16
"2021","South Cambridgeshire 013B","E01018246",702,206,117,89,463,121,205,78,91,36,68,43,20,5,65,38,27,4,4,33,18,15
"2021","South Cambridgeshire 013C","E01018247",739,160,71,89,549,102,304,126,132,46,85,46,30,9,56,34,22,2,2,30,10,20
"2021","South Cambridgeshire 013D","E01018275",1154,327,134,193,789,185,398,138,196,64,113,64,40,9,90,49,41,3,3,38,14,24
"2021","South Cambridgeshire 014A","E01018240",536,116,70,46,397,71,218,87,96,35,53,33,18,2,50,30,20,5,5,23,11,12
"2021","South Cambridgeshire 014B","E01018253",445,84,43,41,335,73,202,56,108,38,28,15,11,2,32,20,12,0,0,26,10,16
"2021","South Cambridgeshire 014C","E01018254",878,277,119,158,570,101,319,97,188,34,83,48,27,8,63,39,24,4,4,31,9,22
"2021","South Cambridgeshire 014D","E01018256",1021,231,108,123,752,93,442,133,251,58,109,62,45,2,106,81,25,2,2,38,10,28
"2021","South Cambridgeshire 014E","E01018291",486,122,63,59,348,76,192,69,93,30,39,23,13,3,38,25,13,3,3,16,2,14
"2021","South Cambridgeshire 015A","E01018279",702,206,118,88,463,78,228,78,114,36,76,43,27,6,80,42,38,1,1,33,7,26
"2021","South Cambridgeshire 015B","E01018280",617,159,84,75,426,92,224,70,127,27,49,28,18,3,58,31,27,3,3,32,11,21
"2021","South Cambridgeshire 015C","E01018281",689,222,124,98,434,72,199,64,104,31,62,25,33,4,95,56,39,6,6,33,10,23
"2021","South Cambridgeshire 015D","E01018282",557,142,83,59,392,78,219,73,113,33,45,28,12,5,50,27,23,0,0,23,6,17
"2021","South Cambridgeshire 015E","E01018283",489,96,64,32,365,58,213,54,114,45,55,30,21,4,37,21,16,2,2,28,9,19
"2021","South Cambridgeshire 016A","E01018218",709,154,102,52,532,126,294,109,131,54,60,31,24,5,51,25,26,1,1,23,9,14
"2021","South Cambridgeshire 016B","E01018219",597,124,78,46,453,93,240,91,100,49,69,40,24,5,48,30,18,3,3,20,8,12
"2021","South Cambridgeshire 016C","E01018220",592,144,81,63,414,78,236,97,106,33,58,37,16,5,40,18,22,2,2,34,11,23
"2021","South Cambridgeshire 016D","E01018263",606,144,84,60,435,77,248,89,120,39,67,35,27,5,40,27,13,3,3,27,6,21
"2021","South Cambridgeshire 016E","E01018264",694,234,153,81,435,78,203,67,89,47,65,36,22,7,85,49,36,4,4,25,9,16
"2021","South Cambridgeshire 016F","E01018265",715,189,112,77,489,128,263,87,139,37,46,20,21,5,51,30,21,1,1,37,11,26
"2021","South Cambridgeshire 017A","E01018238",591,148,85,63,413,65,233,76,120,37,66,42,20,4,48,29,19,1,1,30,9,21
"2021","South Cambridgeshire 017B","E01018239",615,132,71,61,458,88,265,92,140,33,59,40,17,2,44,31,13,2,2,25,6,19
"2021","South Cambridgeshire 017C","E01018288",567,167,89,78,387,78,201,75,99,27,62,37,21,4,43,28,15,3,3,13,5,8
"2021","South Cambridgeshire 017D","E01018289",504,111,55,56,352,57,222,78,112,32,40,23,15,2,31,14,17,2,2,41,11,30
"2021","South Cambridgeshire 017E","E01018302",613,138,49,89,437,50,261,88,135,38,78,51,26,1,42,20,22,6,6,38,12,26
"2021","South Cambridgeshire 017F","E01018303",526,151,95,56,364,74,223,69,110,44,40,20,17,3,27,13,14,0,0,11,4,7
"2021","South Cambridgeshire 018A","E01018241",527,114,64,50,394,89,235,84,123,28,40,20,20,0,30,17,13,0,0,19,6,13
"2021","South Cambridgeshire 018B","E01018267",1014,293,202,91,686,181,367,140,175,52,77,51,25,1,57,22,35,4,4,35,11,24
"2021","South Cambridgeshire 018C","E01018268",810,192,76,116,594,106,336,105,166,65,94,48,41,5,56,29,27,2,2,24,8,16
"2021","South Cambridgeshire 018D","E01018269",671,220,107,113,420,63,192,64,101,27,75,45,29,1,85,49,36,5,5,31,12,19
"2021","South Cambridgeshire 018E","E01018270",462,111,58,53,323,68,185,78,76,31,44,22,16,6,24,14,10,2,2,28,12,16
"2021","South Cambridgeshire 018F","E01018271",636,156,76,80,441,67,237,71,127,39,72,29,39,4,63,45,18,2,2,39,19,20
"2021","South Cambridgeshire 019A","E01018226",419,80,27,53,318,27,197,67,103,27,60,37,17,6,33,23,10,1,1,21,8,13
"2021","South Cambridgeshire 019B","E01018227",781,199,109,90,557,95,269,83,130,56,97,36,51,10,93,51,42,3,3,25,9,16
"2021","South Cambridgeshire 019C","E01018228",660,146,80,66,483,82,284,96,135,53,76,38,29,9,40,21,19,1,1,31,13,18
"2021","South Cambridgeshire 019D","E01018290",1012,210,123,87,763,158,426,175,185,66,102,53,42,7,75,45,30,2,2,39,13,26
"2021","South Cambridgeshire 020A","E01033113",495,153,65,88,315,15,174,41,117,16,56,28,26,2,66,53,13,4,4,27,12,15
"2021","South Cambridgeshire 020B","E01033114",550,139,31,108,381,20,237,66,150,21,65,36,23,6,57,41,16,2,2,30,15,15
"2021","South Cambridgeshire 020C","E01033115",477,75,16,59,377,14,238,37,179,22,50,21,25,4,74,61,13,1,1,25,10,15
"2021","South Cambridgeshire 020D","E01033117",478,107,21,86,353,9,230,57,155,18,58,27,31,0,55,44,11,1,1,18,7,11
"2021","South Cambridgeshire 020F","E01035559",696,123,20,103,536,16,352,62,263,27,95,49,44,2,65,55,10,8,8,37,17,20
"2021","South Cambridgeshire 020G","E01035560",811,112,5,107,659,11,406,71,321,14,123,63,58,2,117,101,16,2,2,40,15,25
"2021","South Cambridgeshire 021A","E01018276",620,151,58,93,449,52,232,74,116,42,84,51,31,2,76,47,29,5,5,20,8,12
"2021","South Cambridgeshire 021B","E01018277",769,191,89,102,553,108,309,118,138,53,76,49,16,11,58,30,28,2,2,25,9,16
"2021","South Cambridgeshire 021C","E01018278",1027,249,54,195,732,60,480,161,273,46,121,71,46,4,69,41,28,2,2,46,26,20
"2021","South Cambridgeshire 021D","E01033116",1019,173,74,99,788,95,487,117,320,50,100,47,46,7,105,77,28,1,1,58,21,37
"2021","South Cambridgeshire 021E","E01033118",595,136,46,90,430,50,252,72,143,37,70,46,18,6,53,31,22,5,5,29,16,13
"2021","South Cambridgeshire 022A","E01018221",755,259,83,176,468,51,241,93,108,40,106,68,36,2,68,45,23,2,2,28,8,20
"2021","South Cambridgeshire 022B","E01018222",589,113,68,45,452,116,245,97,95,53,54,28,23,3,36,17,19,1,1,24,10,14
"2021","South Cambridgeshire 022C","E01018223",830,224,119,105,555,95,284,110,126,48,100,59,33,8,75,46,29,1,1,51,21,30
"2021","South Cambridgeshire 022F","E01018224",587,138,82,56,416,61,242,73,133,36,63,34,26,3,47,25,22,3,3,33,7,26
"2021","South Cambridgeshire 022G","E01018225",481,165,114,51,283,67,151,59,63,29,26,19,7,0,37,17,20,2,2,33,4,29
"2021","South Cambridgeshire 022E","E01018248",787,206,131,75,543,99,322,88,194,40,74,37,32,5,43,23,20,5,5,38,6,32
"2021","South Cambridgeshire 022D","E01035561",965,306,197,109,608,155,317,110,158,49,75,40,31,4,59,28,31,2,2,51,13,38
"2021","Basildon 001A","E01021237",514,91,70,21,408,97,247,66,130,51,37,14,20,3,26,18,8,1,1,15,9,6
"2021","Basildon 001B","E01021238",509,85,57,28,417,71,249,58,131,60,49,20,28,1,48,23,25,0,0,7,5,2
"2021","Basildon 001C","E01021242",480,86,49,37,376,75,205,50,105,50,61,26,27,8,34,23,11,1,1,18,11,7
"2021","Basildon 001D","E01021250",627,150,83,67,455,95,254,57,144,53,63,37,21,5,41,25,16,2,2,22,10,12
"2021","Basildon 001E","E01021251",608,117,63,54,470,90,288,77,147,64,52,26,25,1,38,22,16,2,2,21,11,10
"2021","Basildon 002A","E01021245",639,226,93,133,377,40,171,53,89,29,73,40,29,4,92,58,34,1,1,36,19,17
"2021","Basildon 002B","E01021246",653,213,124,89,427,68,222,73,115,34,88,48,38,2,47,27,20,2,2,13,4,9
"2021","Basildon 002C","E01021248",619,173,69,104,422,47,236,59,121,56,73,44,26,3,64,34,30,2,2,24,10,14
"2021","Basildon 002D","E01021249",625,127,61,66,480,108,260,67,148,45,61,38,19,4,49,25,24,2,2,18,8,10
"2021","Basildon 002E","E01021252",625,208,116,92,406,56,223,87,106,30,86,50,31,5,41,22,19,0,0,11,4,7
"2021","Basildon 003A","E01021239",540,88,65,23,428,88,267,82,127,58,47,20,26,1,26,11,15,0,0,24,12,12
"2021","Basildon 003B","E01021240",833,312,137,175,484,72,215,72,107,36,118,82,34,2,73,48,25,6,6,37,17,20
"2021","Basildon 003C","E01021241",654,160,88,72,456,41,209,52,115,42,106,51,48,7,98,62,36,2,2,38,15,23
"2021","Basildon 003D","E01021243",667,145,80,65,495,73,303,91,153,59,75,44,26,5,44,20,24,0,0,27,13,14
"2021","Basildon 003E","E01021247",658,205,132,73,436,100,244,62,135,47,54,32,20,2,38,21,17,0,0,17,2,15
"2021","Basildon 004A","E01021244",679,205,111,94,448,116,232,56,134,42,60,37,23,0,39,19,20,1,1,26,8,18
"2021","Basildon 004B","E01021253",684,125,83,42,542,138,311,90,162,59,58,25,27,6,35,16,19,0,0,17,6,11
"2021","Basildon 004C","E01021255",670,212,163,49,436,114,210,52,115,43,53,28,24,1,58,30,28,1,1,22,12,10
"2021","Basildon 004D","E01021256",607,130,100,30,460,91,289,95,125,69,60,28,26,6,20,7,13,0,0,17,9,8
"2021","Basildon 004E","E01021258",795,327,181,146,437,51,210,57,111,42,77,36,38,3,93,53,40,6,6,31,15,16
"2021","Basildon 005A","E01021334",722,215,99,116,483,101,228,72,94,62,85,47,36,2,66,23,43,3,3,24,13,11
"2021","Basildon 005B","E01021336",759,248,162,86,473,90,223,72,100,51,83,43,29,11,73,33,40,4,4,38,13,25
"2021","Basildon 005C","E01021338",822,168,78,90,608,78,312,98,162,52,123,50,65,8,92,56,36,3,3,46,21,25
"2021","Basildon 005D","E01021339",657,263,96,167,366,49,172,66,75,31,79,41,34,4,60,32,28,6,6,28,16,12
"2021","Basildon 006A","E01021264",537,98,62,36,385,86,229,73,99,57,41,23,16,2,28,10,18,1,1,54,22,32
"2021","Basildon 006B","E01021329",671,221,160,61,420,80,181,54,72,55,64,25,35,4,94,56,38,1,1,30,13,17
"2021","Basildon 006C","E01021330",657,169,104,65,448,97,235,79,96,60,69,29,37,3,44,18,26,3,3,40,22,18
"2021","Basildon 006D","E01021332",610,159,112,47,425,102,210,69,90,51,66,32,28,6,46,20,26,1,1,26,10,16
"2021","Basildon 006E","E01021333",653,147,104,43,477,128,235,85,85,65,65,28,28,9,48,21,27,1,1,29,16,13
"2021","Basildon 007A","E01021335",520,89,35,54,396,54,231,75,97,59,61,29,30,2,49,30,19,1,1,35,19,16
"2021","Basildon 007B","E01021337",630,180,129,51,421,110,207,57,97,53,61,34,25,2,42,20,22,1,1,29,15,14
"2021","Basildon 007C","E01021340",724,163,76,87,527,78,260,70,124,66,112,58,49,5,76,45,31,1,1,34,14,20
"2021","Basildon 007D","E01021341",660,158,92,66,460,85,240,65,106,69,66,27,35,4,68,35,33,1,1,42,23,19
"2021","Basildon 007E","E01021345",761,153,46,107,586,31,363,87,226,50,128,53,67,8,64,46,18,0,0,22,12,10
"2021","Basildon 008A","E01021331",816,275,87,188,496,68,243,64,121,58,115,63,46,6,69,47,22,1,1,45,21,24
"2021","Basildon 008B","E01021342",697,238,136,102,422,50,201,52,105,44,97,37,58,2,74,47,27,0,0,37,21,16
"2021","Basildon 008C","E01021343",750,225,58,167,504,16,236,59,125,52,141,74,60,7,108,69,39,3,3,21,10,11
"2021","Basildon 008D","E01021344",851,174,56,118,618,59,333,91,182,60,115,62,43,10,107,72,35,4,4,59,29,30
"2021","Basildon 008E","E01021346",917,255,98,157,642,65,344,113,170,61,155,93,60,2,77,45,32,1,1,20,12,8
"2021","Basildon 009A","E01021254",573,112,66,46,423,103,248,68,115,65,37,20,13,4,33,12,21,2,2,38,18,20
"2021","Basildon 009B","E01021257",628,152,98,54,446,105,233,71,117,45,73,26,39,8,33,14,19,2,2,30,18,12
"2021","Basildon 009C","E01021259",640,177,81,96,442,68,236,74,122,40,71,31,36,4,62,41,21,5,5,21,9,12
"2021","Basildon 009D","E01021260",726,166,81,85,510,101,269,90,105,74,85,39,39,7,52,32,20,3,3,50,18,32
"2021","Basildon 010A","E01021261",693,191,74,117,464,69,230,77,97,56,87,46,33,8,72,45,27,6,6,38,17,21
"2021","Basildon 010B","E01021262",732,267,120,147,431,61,190,79,82,29,87,55,27,5,88,52,36,5,5,34,15,19
"2021","Basildon 010C","E01021263",804,226,62,164,543,54,249,78,116,55,125,74,43,8,108,71,37,7,7,35,19,16
"2021","Basildon 010D","E01021274",766,265,115,150,456,63,208,52,120,36,102,49,44,9,79,46,33,4,4,45,19,26
"2021","Basildon 010E","E01021279",666,173,60,113,452,30,216,80,95,41,80,26,43,11,120,76,44,6,6,41,18,23
"2021","Basildon 011A","E01021301",593,168,81,87,381,29,161,43,80,38,62,19,37,6,124,88,36,5,5,44,19,25
"2021","Basildon 011B","E01021303",641,258,146,112,348,44,155,50,72,33,72,39,26,7,75,52,23,2,2,35,17,18
"2021","Basildon 011C","E01021307",586,173,48,125,363,36,158,55,71,32,83,43,33,7,82,50,32,4,4,50,28,22
"2021","Basildon 011D","E01021308",484,96,28,68,360,24,185,73,77,35,95,41,43,11,56,38,18,0,0,28,17,11
"2021","Basildon 011E","E01021309",607,201,51,150,377,28,162,65,66,31,89,52,36,1,96,51,45,2,2,29,16,13
"2021","Basildon 011F","E01021312",600,142,50,92,396,81,191,64,67,60,75,31,27,17,49,20,29,0,0,62,33,29
"2021","Basildon 012A","E01021265",678,159,78,81,459,43,219,61,110,48,90,33,51,6,100,59,41,7,7,60,29,31
"2021","Basildon 012B","E01021267",811,242,126,116,508,48,228,73,112,43,124,57,61,6,104,71,33,4,4,61,30,31
"2021","Basildon 012C","E01021269",795,181,77,104,563,35,280,89,145,46,124,49,59,16,120,83,37,4,4,51,34,17
"2021","Basildon 012D","E01021270",881,256,69,187,572,29,221,58,116,47,138,49,80,9,182,129,53,2,2,53,30,23
"2021","Basildon 012E","E01021272",645,154,61,93,445,37,216,67,110,39,78,32,38,8,107,66,41,7,7,46,27,19
"2021","Basildon 013A","E01021271",678,157,51,106,475,28,148,42,82,24,91,23,60,8,202,170,32,6,6,46,19,27
"2021","Basildon 013B","E01021302",673,247,94,153,396,27,124,31,71,22,88,26,52,10,152,115,37,5,5,30,18,12
"2021","Basildon 013C","E01021304",615,212,79,133,367,37,146,47,62,37,68,25,34,9,110,67,43,6,6,36,11,25
"2021","Basildon 013D","E01021305",597,189,90,99,372,53,161,48,77,36,63,20,30,13,92,53,39,3,3,36,20,16
"2021","Basildon 013E","E01021306",584,162,77,85,365,52,138,53,51,34,61,17,40,4,110,71,39,4,4,57,21,36
"2021","Basildon 014A","E01021273",795,250,123,127,500,56,201,63,95,43,124,61,58,5,116,84,32,3,3,45,21,24
"2021","Basildon 014B","E01021275",697,192,117,75,463,93,239,85,90,64,78,40,28,10,52,23,29,1,1,42,18,24
"2021","Basildon 014C","E01021276",678,253,96,157,384,59,172,53,83,36,65,35,24,6,81,46,35,7,7,41,25,16
"2021","Basildon 014D","E01021277",644,216,101,115,391,49,160,71,62,27,78,34,39,5,100,48,52,4,4,37,17,20
"2021","Basildon 014F","E01034354",711,135,21,114,538,21,271,73,175,23,182,103,75,4,64,46,18,0,0,38,17,21
"2021","Basildon 014G","E01034355",748,295,101,194,413,31,172,55,88,29,91,42,44,5,114,87,27,5,5,40,25,15
"2021","Basildon 015A","E01021266",713,207,98,109,459,39,212,62,103,47,98,35,58,5,107,69,38,3,3,47,23,24
"2021","Basildon 015B","E01021268",682,263,136,127,379,32,158,55,72,31,89,31,52,6,97,73,24,3,3,40,23,17
"2021","Basildon 015C","E01021318",1163,354,89,265,720,46,245,71,141,33,132,68,58,6,277,221,56,20,20,89,43,46
"2021","Basildon 015D","E01021320",643,175,76,99,385,39,178,44,84,50,67,19,41,7,94,57,37,7,7,83,36,47
"2021","Basildon 015E","E01021321",682,205,81,124,418,37,180,57,88,35,88,32,50,6,101,62,39,12,12,59,30,29
"2021","Basildon 016A","E01021286",869,304,70,234,498,28,201,56,109,36,93,38,50,5,170,125,45,6,6,67,38,29
"2021","Basildon 016B","E01021288",585,107,40,67,431,15,129,20,86,23,83,15,53,15,201,148,53,3,3,47,26,21
"2021","Basildon 016C","E01021289",746,181,59,122,517,38,235,63,126,46,91,25,57,9,141,92,49,12,12,48,23,25
"2021","Basildon 016D","E01021290",695,158,54,104,486,22,172,36,84,52,107,33,60,14,175,125,50,10,10,51,28,23
"2021","Basildon 016E","E01021291",902,293,103,190,558,34,254,63,151,40,121,53,62,6,141,79,62,8,8,51,36,15
"2021","Basildon 017A","E01021287",608,137,58,79,427,43,216,49,109,58,81,31,39,11,79,45,34,8,8,44,17,27
"2021","Basildon 017B","E01021292",659,157,77,80,453,54,195,49,105,41,87,33,48,6,110,70,40,7,7,49,26,23
"2021","Basildon 017C","E01021293",748,219,93,126,477,42,206,46,119,41,87,37,44,6,131,91,40,11,11,52,28,24
"2021","Basildon 017D","E01021298",640,186,92,94,407,38,216,58,114,44,67,28,36,3,78,42,36,8,8,47,22,25
"2021","Basildon 017E","E01021319",994,315,78,237,596,38,265,71,160,34,151,79,64,8,133,92,41,9,9,83,41,42
"2021","Basildon 018A","E01021313",609,154,81,73,420,107,217,87,72,58,52,21,25,6,44,17,27,0,0,35,17,18
"2021","Basildon 018B","E01021314",567,166,68,98,357,34,163,52,78,33,58,23,34,1,99,60,39,3,3,44,20,24
"2021","Basildon 018C","E01021315",634,210,82,128,380,38,168,55,80,33,76,25,39,12,94,61,33,4,4,44,19,25
"2021","Basildon 018D","E01021316",816,336,160,176,441,61,160,59,75,26,102,46,43,13,109,61,48,9,9,39,22,17
"2021","Basildon 018E","E01021317",655,202,104,98,403,39,175,46,92,37,68,28,33,7,116,74,42,5,5,50,26,24
"2021","Basildon 019A","E01021322",613,157,53,104,407,38,163,45,85,33,81,31,44,6,117,71,46,8,8,49,24,25
"2021","Basildon 019B","E01021323",663,173,56,117,442,21,160,45,83,32,103,38,59,6,148,110,38,10,10,48,23,25
"2021","Basildon 019C","E01021324",659,165,53,112,439,29,182,52,87,43,87,22,48,17,139,84,55,2,2,55,31,24
"2021","Basildon 019D","E01021325",638,204,59,145,389,24,132,32,79,21,85,29,51,5,141,109,32,7,7,45,19,26
"2021","Basildon 019E","E01021327",728,240,124,116,439,45,184,62,80,42,93,33,50,10,113,73,40,4,4,49,28,21
"2021","Basildon 020A","E01021294",683,141,84,57,500,75,268,79,130,59,88,42,43,3,67,34,33,2,2,42,21,21
"2021","Basildon 020B","E01021295",682,201,100,101,423,49,195,53,92,50,87,36,46,5,83,52,31,9,9,58,28,30
"2021","Basildon 020D","E01021297",884,237,65,172,587,47,297,94,156,47,137,75,54,8,101,68,33,5,5,60,23,37
"2021","Basildon 020E","E01021299",605,135,84,51,428,97,240,69,96,75,51,25,13,13,37,16,21,3,3,42,21,21
"2021","Basildon 020F","E01034356",783,314,18,296,404,4,201,88,109,4,121,100,21,0,64,53,11,14,14,65,11,54
"2021","Basildon 020G","E01034357",702,212,89,123,445,43,212,64,103,45,80,34,39,7,105,69,36,5,5,45,22,23
"2021","Basildon 021A","E01021280",606,150,36,114,433,39,226,65,126,35,114,65,43,6,53,33,20,1,1,23,8,15
"2021","Basildon 021B","E01021281",592,161,62,99,401,77,215,56,103,56,69,43,23,3,38,20,18,2,2,30,15,15
"2021","Basildon 021C","E01021282",625,119,71,48,464,124,225,89,94,42,69,33,32,4,44,17,27,2,2,42,17,25
"2021","Basildon 021D","E01021283",640,191,66,125,405,43,185,57,81,47,78,34,39,5,95,62,33,4,4,44,12,32
"2021","Basildon 021E","E01021284",576,111,31,80,443,45,293,81,146,66,77,46,28,3,28,12,16,0,0,22,16,6
"2021","Basildon 021F","E01021285",537,105,48,57,407,40,261,72,136,53,66,32,26,8,37,20,17,3,3,25,12,13
"2021","Basildon 022A","E01021300",846,244,88,156,540,42,247,79,120,48,117,46,59,12,126,84,42,8,8,62,34,28
"2021","Basildon 022B","E01021310",693,295,86,209,377,59,159,67,53,39,84,54,28,2,73,58,15,2,2,21,8,13
"2021","Basildon 022C","E01021311",592,209,68,141,341,62,156,48,69,39,63,28,29,6,59,34,25,1,1,42,26,16
"2021","Basildon 022D","E01021326",716,184,88,96,474,41,205,60,109,36,113,48,58,7,113,71,42,2,2,58,33,25
"2021","Basildon 022E","E01021328",603,143,74,69,409,41,174,55,82,37,78,32,37,9,109,58,51,7,7,51,30,21
"2021","Braintree 001A","E01021375",467,121,58,63,333,74,170,65,71,34,57,35,18,4,31,21,10,1,1,13,4,9
"2021","Braintree 001B","E01021376",572,122,70,52,430,89,249,93,95,61,66,28,29,9,26,12,14,0,0,20,7,13
"2021","Braintree 001C","E01021414",922,192,104,88,684,140,384,183,128,73,99,65,33,1,56,37,19,5,5,46,21,25
"2021","Braintree 001D","E01021430",917,187,108,79,680,114,364,140,149,75,116,55,51,10,82,49,33,4,4,50,26,24
"2021","Braintree 002A","E01021398",638,161,91,70,447,111,240,108,79,53,66,37,26,3,28,13,15,2,2,30,10,20
"2021","Braintree 002B","E01021406",1006,227,125,102,734,175,378,191,114,73,128,86,36,6,50,26,24,3,3,45,15,30
"2021","Braintree 002C","E01021407",940,229,135,94,670,163,349,154,135,60,95,53,34,8,61,38,23,2,2,41,12,29
"2021","Braintree 003A","E01021382",811,196,99,97,585,95,310,133,131,46,122,63,51,8,54,35,19,4,4,30,11,19
"2021","Braintree 003B","E01021397",1012,261,100,161,703,110,338,127,158,53,156,71,74,11,95,62,33,4,4,48,20,28
"2021","Braintree 003C","E01021399",697,187,120,67,481,82,245,88,107,50,74,29,39,6,79,50,29,1,1,29,8,21
"2021","Braintree 003D","E01021400",760,224,125,99,504,108,250,103,103,44,93,50,37,6,50,24,26,3,3,32,11,21
"2021","Braintree 004A","E01021387",1068,473,175,298,560,82,223,96,97,30,154,78,66,10,96,54,42,5,5,35,12,23
"2021","Braintree 004B","E01021388",724,213,95,118,474,64,223,71,115,37,96,42,44,10,89,58,31,2,2,37,13,24
"2021","Braintree 004C","E01021391",658,169,82,87,460,49,188,52,94,42,99,34,57,8,120,77,43,4,4,29,10,19
"2021","Braintree 004D","E01021392",778,270,119,151,486,65,223,90,95,38,113,66,41,6,82,48,34,3,3,22,5,17
"2021","Braintree 004E","E01021393",665,215,99,116,424,69,212,59,112,41,81,38,38,5,58,34,24,4,4,26,12,14
"2021","Braintree 005A","E01021404",935,238,137,101,642,156,348,155,109,84,74,43,27,4,63,31,32,1,1,55,14,41
"2021","Braintree 005B","E01021411",595,155,80,75,411,77,220,98,84,38,66,35,28,3,48,26,22,0,0,29,8,21
"2021","Braintree 005C","E01021412",594,142,83,59,419,80,261,87,112,62,54,35,16,3,23,11,12,1,1,33,11,22
"2021","Braintree 005D","E01021413",544,119,70,49,400,97,211,85,81,45,54,30,19,5,38,18,20,0,0,25,12,13
"2021","Braintree 006A","E01021389",928,256,170,86,636,134,306,101,140,65,122,61,52,9,71,44,27,3,3,36,13,23
"2021","Braintree 006B","E01021390",768,174,102,72,573,120,286,106,131,49,103,59,38,6,61,42,19,3,3,21,10,11
"2021","Braintree 006C","E01021408",759,190,120,70,531,110,310,121,123,66,63,38,21,4,46,24,22,2,2,38,16,22
"2021","Braintree 006D","E01021409",742,165,91,74,552,103,304,105,130,69,95,47,43,5,50,29,21,0,0,25,9,16
"2021","Braintree 006E","E01021410",798,258,137,121,510,80,229,90,98,41,101,34,62,5,100,75,25,0,0,30,13,17
"2021","Braintree 007A","E01021349",500,80,31,49,388,40,232,69,117,46,69,26,35,8,46,22,24,1,1,32,18,14
"2021","Braintree 007B","E01021351",570,79,32,47,463,40,298,83,161,54,78,33,41,4,43,27,16,4,4,28,16,12
"2021","Braintree 007C","E01021352",599,135,83,52,436,67,246,88,111,47,55,21,31,3,63,36,27,5,5,28,17,11
"2021","Braintree 007D","E01021355",871,264,118,146,565,115,264,111,109,44,101,58,37,6,81,46,35,4,4,42,17,25
"2021","Braintree 007E","E01021356",592,154,88,66,411,114,191,63,83,45,63,26,35,2,41,21,20,2,2,27,12,15
"2021","Braintree 007F","E01021381",545,145,94,51,383,111,193,90,72,31,45,18,20,7,32,10,22,2,2,17,7,10
"2021","Braintree 008A","E01021354",509,135,61,74,353,47,141,44,66,31,86,33,48,5,77,55,22,2,2,21,12,9
"2021","Braintree 008B","E01021357",681,219,108,111,429,90,191,74,74,43,87,42,33,12,60,29,31,1,1,33,14,19
"2021","Braintree 008C","E01021358",1026,295,141,154,659,57,283,96,139,48,156,58,86,12,158,116,42,5,5,72,37,35
"2021","Braintree 008D","E01021359",873,244,101,143,586,60,227,66,109,52,135,56,70,9,160,91,69,4,4,43,15,28
"2021","Braintree 009A","E01021350",787,235,113,122,516,115,257,93,118,46,91,48,35,8,52,22,30,1,1,36,6,30
"2021","Braintree 009B","E01021353",763,236,116,120,490,71,226,65,117,44,105,60,39,6,86,60,26,2,2,37,17,20
"2021","Braintree 009D","E01021365",1176,481,157,324,620,71,261,92,121,48,161,106,48,7,122,86,36,5,5,75,21,54
"2021","Braintree 009E","E01033458",823,362,94,268,416,25,157,50,89,18,139,91,44,4,85,65,20,10,10,45,18,27
"2021","Braintree 009F","E01033459",825,296,123,173,474,53,173,57,86,30,139,85,47,7,99,62,37,10,10,55,13,42
"2021","Braintree 010A","E01021364",701,179,84,95,483,71,245,67,135,43,102,63,32,7,63,38,25,2,2,39,17,22
"2021","Braintree 010B","E01021366",642,113,75,38,506,139,266,81,120,65,57,18,31,8,43,26,17,1,1,23,13,10
"2021","Braintree 010C","E01021383",801,111,60,51,654,91,368,82,201,85,113,52,53,8,80,52,28,2,2,36,20,16
"2021","Braintree 010D","E01021405",936,192,113,79,706,124,415,152,177,86,97,47,43,7,67,33,34,3,3,38,12,26
"2021","Braintree 011A","E01021368",711,238,104,134,437,62,189,63,90,36,91,46,35,10,92,63,29,3,3,36,18,18
"2021","Braintree 011B","E01021370",723,237,94,143,450,32,199,63,101,35,115,51,50,14,97,58,39,7,7,36,12,24
"2021","Braintree 011C","E01021372",880,232,81,151,609,73,286,82,149,55,151,83,61,7,95,53,42,4,4,39,14,25
"2021","Braintree 011E","E01021374",617,163,80,83,413,46,185,58,76,51,75,29,36,10,104,54,50,3,3,41,18,23
"2021","Braintree 011F","E01035155",601,211,58,153,363,37,144,58,72,14,80,24,49,7,98,58,40,4,4,27,15,12
"2021","Braintree 011G","E01035156",632,157,55,102,442,50,215,94,90,31,112,72,38,2,60,41,19,5,5,33,10,23
"2021","Braintree 012A","E01021360",738,175,107,68,543,56,263,91,120,52,120,43,68,9,102,57,45,2,2,20,10,10
"2021","Braintree 012B","E01021361",731,175,73,102,527,80,256,79,128,49,118,71,43,4,69,38,31,4,4,29,12,17
"2021","Braintree 012C","E01021367",568,144,69,75,388,45,190,65,77,48,67,22,32,13,85,50,35,1,1,36,9,27
"2021","Braintree 012D","E01021369",1013,209,80,129,735,50,383,89,233,61,168,75,82,11,130,82,48,4,4,69,35,34
"2021","Braintree 012E","E01021380",1115,272,141,131,782,145,372,151,136,85,160,79,69,12,98,57,41,7,7,61,17,44
"2021","Braintree 013A","E01021347",1039,241,128,113,743,104,399,124,210,65,129,61,57,11,111,73,38,0,0,55,32,23
"2021","Braintree 013B","E01021371",772,266,176,90,490,109,229,67,118,44,98,46,43,9,52,32,20,2,2,16,8,8
"2021","Braintree 013C","E01021384",867,176,100,76,652,82,393,100,222,71,104,52,49,3,72,43,29,1,1,39,22,17
"2021","Braintree 013D","E01021385",512,117,40,77,374,37,187,53,95,39,77,40,34,3,71,46,25,2,2,21,10,11
"2021","Braintree 013E","E01021386",576,85,45,40,470,81,296,87,145,64,57,19,31,7,36,24,12,0,0,21,10,11
"2021","Braintree 014A","E01021377",746,206,138,68,516,113,265,75,127,63,85,47,32,6,49,29,20,4,4,24,9,15
"2021","Braintree 014B","E01021378",768,299,184,115,449,94,201,81,81,39,74,38,32,4,78,49,29,2,2,20,7,13
"2021","Braintree 014C","E01021379",730,153,84,69,552,114,301,86,151,64,80,46,31,3,50,22,28,7,7,25,9,16
"2021","Braintree 014D","E01021401",699,220,134,86,453,75,207,65,105,37,68,42,21,5,101,63,38,2,2,26,10,16
"2021","Braintree 014E","E01021402",850,213,112,101,607,99,344,117,164,63,88,54,31,3,74,40,34,2,2,30,10,20
"2021","Braintree 014F","E01021403",633,127,70,57,481,101,274,85,141,48,67,35,25,7,38,16,22,1,1,25,9,16
"2021","Braintree 015A","E01021362",911,197,90,107,668,77,318,101,160,57,190,120,67,3,81,52,29,2,2,46,20,26
"2021","Braintree 015B","E01021417",663,206,102,104,433,79,207,70,91,46,80,35,36,9,67,34,33,0,0,24,12,12
"2021","Braintree 015C","E01021418",559,130,54,76,388,19,175,41,95,39,86,22,53,11,105,66,39,3,3,41,20,21
"2021","Braintree 015D","E01021419",713,207,122,85,461,78,222,71,95,56,88,43,37,8,69,36,33,4,4,45,19,26
"2021","Braintree 015E","E01021426",562,177,49,128,363,59,147,47,66,34,89,49,35,5,65,44,21,3,3,22,11,11
"2021","Braintree 015F","E01021428",620,154,112,42,446,134,213,86,72,55,57,34,20,3,42,17,25,0,0,20,5,15
"2021","Braintree 016A","E01021423",616,148,49,99,431,25,179,44,100,35,103,43,54,6,116,69,47,8,8,37,10,27
"2021","Braintree 016B","E01021425",589,138,63,75,409,38,175,53,93,29,88,38,42,8,104,61,43,4,4,42,16,26
"2021","Braintree 016C","E01021427",519,135,58,77,349,37,164,53,77,34,79,36,34,9,69,40,29,0,0,35,14,21
"2021","Braintree 016D","E01021429",514,133,63,70,350,48,167,53,80,34,69,27,38,4,66,46,20,0,0,31,15,16
"2021","Braintree 017A","E01021415",836,431,269,162,383,79,157,66,61,30,93,63,27,3,50,30,20,4,4,22,9,13
"2021","Braintree 017B","E01021416",988,430,139,291,521,78,203,82,93,28,167,123,41,3,67,34,33,6,6,37,7,30
"2021","Braintree 017C","E01021420",746,227,77,150,488,54,225,89,94,42,116,57,53,6,87,41,46,6,6,31,13,18
"2021","Braintree 017E","E01021422",793,262,140,122,499,85,224,86,98,40,98,47,47,4,86,44,42,6,6,32,10,22
"2021","Braintree 017F","E01033460",868,219,62,157,631,49,290,89,163,38,168,92,71,5,119,89,30,5,5,18,8,10
"2021","Braintree 017G","E01033461",560,98,22,76,436,12,244,74,145,25,97,53,42,2,78,59,19,5,5,26,15,11
"2021","Braintree 017H","E01033462",496,184,38,146,289,20,116,52,56,8,84,59,23,2,65,50,15,4,4,23,5,18
"2021","Braintree 018A","E01021348",655,145,80,65,479,110,258,102,106,50,65,28,29,8,41,24,17,5,5,31,13,18
"2021","Braintree 018B","E01021394",676,234,112,122,424,56,213,93,81,39,79,46,28,5,74,39,35,2,2,18,2,16
"2021","Braintree 018C","E01021395",623,161,99,62,437,92,235,90,102,43,55,31,21,3,53,24,29,2,2,25,13,12
"2021","Braintree 018D","E01021396",539,129,67,62,378,93,204,90,69,45,47,25,22,0,34,14,20,0,0,32,18,14
"2021","Braintree 018E","E01021424",906,213,98,115,637,65,335,117,162,56,125,65,52,8,107,72,35,5,5,56,24,32
"2021","Brentwood 001A","E01021441",583,120,73,47,441,92,227,70,103,54,53,17,32,4,68,32,36,1,1,22,8,14
"2021","Brentwood 001B","E01021442",510,109,81,28,387,98,221,62,105,54,41,17,18,6,27,12,15,0,0,14,5,9
"2021","Brentwood 001C","E01021443",570,118,70,48,410,79,217,77,91,49,57,23,31,3,54,31,23,3,3,42,19,23
"2021","Brentwood 001D","E01021444",650,137,73,64,474,105,255,72,120,63,59,24,29,6,52,25,27,3,3,39,26,13
"2021","Brentwood 001E","E01021469",470,107,66,41,333,81,194,63,74,57,34,20,12,2,22,15,7,2,2,30,14,16
"2021","Brentwood 001F","E01021470",433,103,63,40,300,58,180,71,65,44,23,9,11,3,39,19,20,0,0,30,10,20
"2021","Brentwood 001G","E01021471",620,108,84,24,485,129,268,74,116,78,54,20,23,11,32,10,22,2,2,27,12,15
"2021","Brentwood 002A","E01021457",657,189,120,69,440,85,205,66,92,47,57,33,24,0,92,54,38,1,1,28,11,17
"2021","Brentwood 002B","E01021458",839,362,194,168,453,85,222,71,112,39,82,54,26,2,63,32,31,1,1,24,8,16
"2021","Brentwood 002C","E01021459",523,109,82,27,405,112,219,60,106,53,36,10,16,10,38,13,25,0,0,9,6,3
"2021","Brentwood 002D","E01021460",762,201,111,90,527,67,257,81,131,45,111,59,43,9,90,52,38,2,2,34,9,25
"2021","Brentwood 003A","E01021448",680,236,109,127,421,52,204,59,105,40,78,34,41,3,84,62,22,3,3,23,11,12
"2021","Brentwood 003B","E01021449",656,174,85,89,449,52,229,66,112,51,79,43,27,9,86,45,41,3,3,33,14,19
"2021","Brentwood 003C","E01021450",795,180,101,79,587,99,350,90,178,82,66,30,27,9,70,41,29,2,2,28,10,18
"2021","Brentwood 003D","E01021451",619,181,71,110,408,19,168,44,90,34,88,41,40,7,131,81,50,2,2,30,14,16
"2021","Brentwood 003E","E01021452",622,164,99,65,440,95,222,64,118,40,78,36,36,6,42,23,19,3,3,18,6,12
"2021","Brentwood 004A","E01021431",640,158,76,82,452,52,242,45,149,48,82,43,32,7,70,43,27,6,6,30,10,20
"2021","Brentwood 004B","E01021432",755,217,85,132,501,64,197,31,129,37,102,44,49,9,129,87,42,9,9,37,20,17
"2021","Brentwood 004C","E01021434",666,188,79,109,447,50,211,48,120,43,107,55,42,10,76,44,32,3,3,31,19,12
"2021","Brentwood 004D","E01021461",638,194,96,98,415,53,158,47,81,30,72,31,34,7,130,78,52,2,2,29,17,12
"2021","Brentwood 004E","E01021464",617,160,82,78,427,71,213,58,113,42,64,26,33,5,71,33,38,8,8,30,17,13
"2021","Brentwood 005A","E01021447",970,225,150,75,689,145,423,104,231,88,72,38,27,7,48,15,33,1,1,56,29,27
"2021","Brentwood 005B","E01021453",528,167,82,85,343,62,185,55,100,30,59,35,21,3,36,19,17,1,1,18,6,12
"2021","Brentwood 005C","E01021455",532,88,60,28,424,106,251,73,123,55,34,14,18,2,32,21,11,1,1,20,13,7
"2021","Brentwood 005D","E01021465",848,285,143,142,537,85,284,79,168,37,87,57,28,2,75,46,29,6,6,26,12,14
"2021","Brentwood 005E","E01021466",640,100,72,28,516,122,339,78,183,78,22,10,10,2,32,17,15,1,1,24,11,13
"2021","Brentwood 005F","E01021467",677,132,88,44,509,98,336,82,184,70,40,25,13,2,33,12,21,2,2,36,14,22
"2021","Brentwood 006A","E01021438",888,227,74,153,625,87,369,92,207,70,100,59,35,6,65,36,29,4,4,36,14,22
"2021","Brentwood 006B","E01021462",576,133,84,49,405,86,185,55,93,37,63,35,25,3,67,34,33,4,4,38,13,25
"2021","Brentwood 006C","E01021463",635,174,103,71,423,76,221,56,106,59,67,21,38,8,56,24,32,3,3,38,19,19
"2021","Brentwood 006D","E01021468",792,195,99,96,534,86,295,90,153,52,88,42,42,4,60,28,32,5,5,63,32,31
"2021","Brentwood 007A","E01021433",1089,432,181,251,627,87,224,74,113,37,165,117,42,6,142,106,36,9,9,30,10,20
"2021","Brentwood 007E","E01021475",685,219,53,166,430,36,225,55,135,35,100,75,22,3,64,46,18,5,5,36,12,24
"2021","Brentwood 007F","E01033063",637,190,46,144,419,18,210,67,114,29,108,78,28,2,77,50,27,6,6,28,8,20
"2021","Brentwood 007G","E01033064",685,295,122,173,362,32,151,50,75,26,102,69,27,6,73,50,23,4,4,28,4,24
"2021","Brentwood 007H","E01034358",663,337,99,238,291,16,90,37,42,11,104,91,12,1,69,49,20,12,12,35,8,27
"2021","Brentwood 007I","E01034359",648,252,78,174,367,29,166,52,90,24,101,70,26,5,64,36,28,7,7,29,8,21
"2021","Brentwood 007J","E01034360",718,318,131,187,373,44,182,57,101,24,95,80,12,3,44,35,9,8,8,27,12,15
"2021","Brentwood 007K","E01034361",591,243,25,218,324,9,108,41,63,4,111,83,27,1,87,67,20,9,9,24,4,20
"2021","Brentwood 008A","E01021435",764,205,101,104,526,79,273,84,129,60,81,42,33,6,90,59,31,3,3,33,16,17
"2021","Brentwood 008B","E01021437",736,204,85,119,499,35,204,56,113,35,115,56,48,11,135,84,51,10,10,33,18,15
"2021","Brentwood 008C","E01021472",927,444,110,334,441,26,161,58,79,24,136,99,34,3,109,80,29,9,9,42,15,27
"2021","Brentwood 008D","E01021473",610,161,73,88,409,71,207,71,101,35,69,31,29,9,59,28,31,3,3,40,21,19
"2021","Brentwood 008E","E01021474",609,145,96,49,452,80,293,77,154,62,48,26,19,3,31,16,15,0,0,12,8,4
"2021","Brentwood 009A","E01021445",842,199,115,84,598,91,371,110,162,99,75,40,31,4,59,29,30,2,2,45,23,22
"2021","Brentwood 009B","E01021446",703,198,102,96,471,70,249,79,106,64,97,53,42,2,49,26,23,6,6,34,16,18
"2021","Brentwood 009C","E01021454",529,170,83,87,350,53,177,61,77,39,59,32,27,0,61,35,26,0,0,9,6,3
"2021","Brentwood 009D","E01021456",504,149,61,88,334,55,189,47,99,43,52,30,21,1,38,26,12,0,0,21,10,11
"2021","Castle Point 001A","E01021513",642,131,100,31,477,105,247,90,103,54,65,34,27,4,58,27,31,2,2,34,15,19
"2021","Castle Point 001B","E01021514",613,157,106,51,435,83,225,64,110,51,71,26,40,5,54,31,23,2,2,21,8,13
"2021","Castle Point 001C","E01021515",494,90,58,32,382,73,186,47,90,49,77,25,41,11,45,21,24,1,1,22,11,11
"2021","Castle Point 001D","E01021525",704,192,85,107,471,62,184,61,76,47,104,48,50,6,115,79,36,6,6,41,19,22
"2021","Castle Point 001E","E01021527",674,165,118,47,474,113,238,70,111,57,71,25,37,9,51,25,26,1,1,35,20,15
"2021","Castle Point 002A","E01021509",641,204,118,86,407,95,188,71,69,48,69,47,18,4,55,27,28,0,0,30,14,16
"2021","Castle Point 002B","E01021510",668,216,156,60,424,103,182,68,80,34,82,39,35,8,56,29,27,1,1,28,14,14
"2021","Castle Point 002C","E01021511",773,184,96,88,552,86,311,89,164,58,78,35,40,3,73,45,28,4,4,37,17,20
"2021","Castle Point 002D","E01021528",615,125,81,44,458,106,234,83,92,59,58,26,24,8,57,27,30,3,3,32,21,11
"2021","Castle Point 002E","E01021531",608,128,64,64,446,85,218,76,89,53,75,37,29,9,67,33,34,1,1,34,13,21
"2021","Castle Point 003A","E01021476",791,199,127,72,551,105,291,76,136,79,79,36,38,5,72,47,25,4,4,41,28,13
"2021","Castle Point 003B","E01021477",630,142,103,39,461,123,222,66,91,65,59,33,21,5,56,24,32,1,1,27,10,17
"2021","Castle Point 003C","E01021478",679,140,91,49,492,97,274,71,131,72,65,26,32,7,55,36,19,1,1,47,29,18
"2021","Castle Point 003D","E01021516",544,125,80,45,395,91,190,60,79,51,68,33,26,9,46,13,33,0,0,24,14,10
"2021","Castle Point 004A","E01021479",591,116,80,36,442,87,231,56,111,64,81,34,40,7,43,20,23,0,0,33,14,19
"2021","Castle Point 004B","E01021481",620,126,62,64,466,93,249,65,122,62,76,35,33,8,44,32,12,4,4,28,13,15
"2021","Castle Point 004C","E01021483",725,172,111,61,522,120,287,93,141,53,82,37,40,5,30,16,14,3,3,31,11,20
"2021","Castle Point 004D","E01021512",645,173,115,58,440,112,224,71,89,64,54,23,27,4,48,22,26,2,2,32,16,16
"2021","Castle Point 004E","E01021526",639,134,89,45,475,104,262,101,104,57,65,29,29,7,43,21,22,1,1,30,14,16
"2021","Castle Point 005A","E01021517",729,189,129,60,512,110,263,99,107,57,78,41,33,4,57,28,29,4,4,28,6,22
"2021","Castle Point 005B","E01021519",651,162,115,47,461,120,225,79,90,56,58,27,25,6,55,27,28,3,3,28,12,16
"2021","Castle Point 005C","E01021530",623,169,105,64,422,107,209,55,102,52,52,26,25,1,52,18,34,2,2,32,12,20
"2021","Castle Point 005D","E01021532",630,162,113,49,447,155,201,90,62,49,53,34,15,4,38,10,28,0,0,21,12,9
"2021","Castle Point 006A","E01021482",595,157,108,49,411,78,207,72,84,51,74,31,36,7,49,25,24,3,3,27,14,13
"2021","Castle Point 006B","E01021518",1062,434,193,241,577,94,202,75,95,32,121,73,41,7,158,117,41,2,2,51,19,32
"2021","Castle Point 006C","E01021520",670,206,122,84,435,100,195,63,80,52,74,27,39,8,64,36,28,2,2,29,13,16
"2021","Castle Point 006D","E01021529",639,199,122,77,414,54,193,61,94,38,72,30,37,5,93,62,31,2,2,26,12,14
"2021","Castle Point 007A","E01021480",702,156,67,89,509,85,278,88,126,64,91,56,29,6,48,29,19,7,7,37,19,18
"2021","Castle Point 007B","E01021521",607,175,118,57,408,79,195,71,74,50,83,43,33,7,49,24,25,2,2,24,7,17
"2021","Castle Point 007C","E01021522",771,222,94,128,511,85,231,70,107,54,87,41,39,7,107,61,46,1,1,38,21,17
"2021","Castle Point 007D","E01021523",591,160,115,45,402,104,222,63,85,74,53,24,26,3,20,9,11,3,3,29,17,12
"2021","Castle Point 007E","E01021524",641,159,97,62,449,88,223,62,102,59,81,35,37,9,52,30,22,5,5,33,13,20
"2021","Castle Point 008A","E01021487",599,186,108,78,382,96,160,57,59,44,69,42,19,8,55,34,21,2,2,31,8,23
"2021","Castle Point 008B","E01021494",583,153,77,76,396,76,184,58,81,45,74,31,37,6,59,35,24,3,3,34,18,16
"2021","Castle Point 008C","E01021504",494,88,33,55,374,33,228,57,119,52,55,32,18,5,57,36,21,1,1,32,17,15
"2021","Castle Point 008D","E01021505",495,79,52,27,378,58,209,51,105,53,64,26,29,9,45,19,26,2,2,38,19,19
"2021","Castle Point 008E","E01021506",519,138,59,79,358,33,171,59,75,37,72,31,36,5,80,55,25,2,2,23,13,10
"2021","Castle Point 009A","E01021492",713,204,119,85,474,94,212,64,90,58,97,51,39,7,67,42,25,4,4,35,16,19
"2021","Castle Point 009B","E01021493",705,235,152,83,435,105,180,73,58,49,77,47,26,4,71,30,41,2,2,35,14,21
"2021","Castle Point 009C","E01021495",1179,553,436,117,598,305,164,88,46,30,71,49,20,2,57,12,45,1,1,28,7,21
"2021","Castle Point 009D","E01021496",596,167,97,70,394,76,174,49,71,54,68,29,34,5,72,36,36,4,4,35,17,18
"2021","Castle Point 010A","E01021485",484,134,82,52,307,44,136,32,58,46,55,22,28,5,68,30,38,4,4,43,22,21
"2021","Castle Point 010B","E01021486",457,102,58,44,324,27,138,36,67,35,57,9,40,8,94,60,34,8,8,31,22,9
"2021","Castle Point 010C","E01021488",637,192,115,77,410,73,159,58,56,45,76,37,28,11,98,54,44,4,4,35,18,17
"2021","Castle Point 010D","E01021503",549,107,56,51,400,66,181,59,72,50,68,21,44,3,81,42,39,4,4,42,25,17
"2021","Castle Point 010E","E01021507",595,170,85,85,378,27,144,52,62,30,59,25,28,6,142,93,49,6,6,47,26,21
"2021","Castle Point 010F","E01021508",445,55,23,32,357,33,157,26,77,54,75,15,48,12,89,50,39,3,3,33,19,14
"2021","Castle Point 011A","E01021484",602,208,146,62,358,89,158,47,56,55,65,24,33,8,46,25,21,0,0,36,22,14
"2021","Castle Point 011B","E01021498",667,174,95,79,449,110,208,70,71,67,63,23,34,6,67,48,19,1,1,44,19,25
"2021","Castle Point 011C","E01021499",660,176,123,53,441,114,203,85,57,61,67,21,38,8,54,27,27,3,3,43,16,27
"2021","Castle Point 011D","E01021501",624,197,120,77,394,97,182,78,61,43,57,31,20,6,55,28,27,3,3,33,10,23
"2021","Castle Point 011E","E01021502",840,229,112,117,577,114,299,108,121,70,86,35,40,11,76,43,33,2,2,34,18,16
"2021","Castle Point 012A","E01021489",624,194,108,86,405,91,173,72,65,36,90,43,41,6,48,27,21,3,3,25,10,15
"2021","Castle Point 012B","E01021490",621,199,104,95,384,79,164,52,67,45,66,33,26,7,73,47,26,2,2,38,21,17
"2021","Castle Point 012C","E01021491",685,177,101,76,472,97,215,71,86,58,85,34,35,16,74,31,43,1,1,36,20,16
"2021","Castle Point 012D","E01021497",659,206,138,68,414,76,190,69,60,61,73,39,28,6,70,39,31,5,5,39,17,22
"2021","Castle Point 012E","E01021500",1148,427,203,224,686,175,260,106,93,61,111,60,41,10,136,92,44,4,4,35,18,17
"2021","Chelmsford 001A","E01021538",1119,199,90,109,865,101,463,132,252,79,160,80,72,8,136,101,35,5,5,55,23,32
"2021","Chelmsford 001B","E01021539",573,138,88,50,415,87,209,75,94,40,55,29,20,6,59,32,27,5,5,20,9,11
"2021","Chelmsford 001C","E01021540",882,199,90,109,642,103,298,90,169,39,132,79,48,5,108,82,26,1,1,41,16,25
"2021","Chelmsford 001E","E01034081",700,205,112,93,462,73,227,78,116,33,71,49,21,1,87,57,30,4,4,33,15,18
"2021","Chelmsford 001F","E01034082",603,99,32,67,482,18,266,58,198,10,97,49,42,6,100,86,14,1,1,22,9,13
"2021","Chelmsford 002A","E01021542",1004,321,115,206,620,83,341,106,191,44,89,47,39,3,102,62,40,5,5,63,24,39
"2021","Chelmsford 002B","E01021543",669,153,83,70,491,107,269,70,157,42,68,44,21,3,46,21,25,1,1,25,10,15
"2021","Chelmsford 002C","E01021587",621,145,108,37,447,114,240,86,112,42,56,31,21,4,36,16,20,1,1,29,9,20
"2021","Chelmsford 002D","E01021590",582,140,78,62,422,98,234,76,121,37,45,29,15,1,45,24,21,0,0,20,9,11
"2021","Chelmsford 002E","E01021591",655,161,64,97,462,81,268,71,152,45,63,40,20,3,46,21,25,4,4,32,13,19
"2021","Chelmsford 003A","E01021550",689,128,62,66,524,103,292,96,148,48,88,51,30,7,40,24,16,1,1,37,16,21
"2021","Chelmsford 003B","E01021597",601,148,71,77,411,51,174,50,100,24,77,31,41,5,107,66,41,2,2,42,12,30
"2021","Chelmsford 003C","E01021598",662,194,106,88,434,58,197,57,101,39,69,17,42,10,107,72,35,3,3,34,15,19
"2021","Chelmsford 003D","E01021600",440,77,46,31,349,69,212,74,99,39,36,19,16,1,32,17,15,0,0,14,5,9
"2021","Chelmsford 003E","E01021601",656,252,127,125,369,52,167,48,88,31,55,24,31,0,90,56,34,5,5,35,12,23
"2021","Chelmsford 004B","E01021617",586,191,92,99,364,56,185,56,89,40,57,27,26,4,63,32,31,3,3,31,12,19
"2021","Chelmsford 004C","E01021619",621,200,99,101,403,47,240,83,104,53,66,40,23,3,48,30,18,2,2,18,10,8
"2021","Chelmsford 004D","E01021620",641,217,57,160,398,57,191,49,116,26,79,54,24,1,66,50,16,5,5,26,9,17
"2021","Chelmsford 004E","E01021623",508,119,70,49,366,55,184,45,109,30,52,28,21,3,71,35,36,4,4,23,8,15
"2021","Chelmsford 004F","E01021624",492,120,90,30,349,104,189,48,100,41,30,17,11,2,25,8,17,1,1,23,12,11
"2021","Chelmsford 004G","E01034083",586,127,7,120,441,6,235,50,174,11,116,75,38,3,82,75,7,2,2,18,12,6
"2021","Chelmsford 004H","E01034084",679,121,51,70,526,67,341,100,187,54,65,34,24,7,50,27,23,3,3,32,14,18
"2021","Chelmsford 005A","E01021536",721,240,98,142,464,67,215,75,93,47,96,57,32,7,85,53,32,1,1,17,5,12
"2021","Chelmsford 005B","E01021537",910,237,115,122,640,106,323,115,149,59,121,63,51,7,85,61,24,5,5,33,13,20
"2021","Chelmsford 005D","E01021568",644,124,88,36,490,144,277,96,117,64,41,23,16,2,28,11,17,0,0,30,14,16
"2021","Chelmsford 005E","E01033142",737,130,36,94,567,43,358,67,242,49,70,29,32,9,93,59,34,3,3,40,21,19
"2021","Chelmsford 005F","E01033144",626,105,24,81,499,22,318,82,193,43,83,36,38,9,72,42,30,4,4,22,10,12
"2021","Chelmsford 006A","E01021576",638,148,58,90,438,30,161,31,99,31,72,20,39,13,165,112,53,10,10,52,21,31
"2021","Chelmsford 006B","E01021588",595,198,115,83,368,52,146,52,72,22,67,25,34,8,97,49,48,6,6,29,13,16
"2021","Chelmsford 006C","E01021589",665,207,67,140,421,39,203,58,106,39,80,41,29,10,93,60,33,6,6,37,17,20
"2021","Chelmsford 006D","E01021592",700,279,134,145,379,27,165,44,84,37,68,40,21,7,113,78,35,6,6,42,16,26
"2021","Chelmsford 006E","E01021596",675,262,113,149,366,25,166,34,102,30,50,22,22,6,118,72,46,7,7,47,25,22
"2021","Chelmsford 007A","E01021618",586,152,60,92,411,42,243,74,105,64,78,49,25,4,46,25,21,2,2,23,8,15
"2021","Chelmsford 007B","E01021621",616,148,35,113,440,28,253,61,143,49,77,39,34,4,77,55,22,5,5,28,10,18
"2021","Chelmsford 007C","E01021622",623,161,107,54,430,105,224,72,119,33,52,24,23,5,49,22,27,0,0,32,10,22
"2021","Chelmsford 007D","E01021625",603,151,94,57,429,95,223,59,123,41,58,35,17,6,52,25,27,1,1,23,12,11
"2021","Chelmsford 007E","E01021626",583,112,61,51,439,74,258,88,133,37,65,33,27,5,37,20,17,5,5,32,8,24
"2021","Chelmsford 008A","E01021544",620,227,62,165,380,38,171,65,78,28,117,84,30,3,50,28,22,4,4,13,4,9
"2021","Chelmsford 008B","E01021545",630,161,69,92,450,41,260,71,145,44,82,43,35,4,65,34,31,2,2,19,9,10
"2021","Chelmsford 008C","E01021546",603,182,74,108,395,46,221,67,109,45,80,51,19,10,46,27,19,2,2,26,6,20
"2021","Chelmsford 008D","E01021547",698,243,44,199,432,32,235,99,86,50,105,74,29,2,58,26,32,2,2,23,7,16
"2021","Chelmsford 008E","E01021628",727,175,72,103,508,54,270,74,155,41,97,60,31,6,82,48,34,5,5,44,19,25
"2021","Chelmsford 008F","E01021629",682,156,60,96,475,39,243,60,135,48,100,52,44,4,87,56,31,6,6,51,17,34
"2021","Chelmsford 009A","E01021573",699,193,75,118,453,39,275,69,156,50,79,48,25,6,57,35,22,3,3,53,19,34
"2021","Chelmsford 009B","E01021575",725,248,70,178,421,30,182,50,113,19,135,95,34,6,67,32,35,7,7,56,14,42
"2021","Chelmsford 009C","E01021599",724,153,63,90,527,98,303,85,142,76,76,42,29,5,47,26,21,3,3,44,14,30
"2021","Chelmsford 009E","E01021631",772,224,110,114,483,35,194,44,112,38,87,33,43,11,154,104,50,13,13,65,27,38
"2021","Chelmsford 009F","E01033138",629,186,63,123,405,42,205,70,101,34,92,65,24,3,59,38,21,7,7,38,9,29
"2021","Chelmsford 009G","E01033139",691,215,25,190,398,19,181,57,106,18,126,85,39,2,65,48,17,7,7,78,24,54
"2021","Chelmsford 011A","E01021551",586,144,87,57,416,71,237,91,89,57,65,32,29,4,41,22,19,2,2,26,9,17
"2021","Chelmsford 011B","E01021632",649,137,92,45,490,126,242,74,116,52,62,38,21,3,56,29,27,4,4,22,9,13
"2021","Chelmsford 011C","E01021633",524,181,106,75,321,81,166,69,68,29,41,26,14,1,32,17,15,1,1,22,10,12
"2021","Chelmsford 011D","E01021634",600,146,92,54,417,101,231,71,109,51,45,20,21,4,38,23,15,2,2,37,11,26
"2021","Chelmsford 011E","E01021635",655,227,145,82,403,119,189,67,87,35,59,36,21,2,33,17,16,3,3,25,7,18
"2021","Chelmsford 011F","E01021636",521,209,117,92,288,51,135,45,60,30,41,20,17,4,58,29,29,3,3,24,10,14
"2021","Chelmsford 012A","E01021556",919,287,102,185,588,91,305,79,182,44,115,69,41,5,75,42,33,2,2,44,14,30
"2021","Chelmsford 012B","E01021577",639,165,81,84,447,66,224,66,132,26,86,48,34,4,69,35,34,2,2,27,8,19
"2021","Chelmsford 012C","E01021579",694,187,66,121,452,31,226,57,140,29,131,87,42,2,61,39,22,3,3,55,18,37
"2021","Chelmsford 012D","E01021580",513,71,39,32,425,54,277,57,162,58,52,18,29,5,42,20,22,0,0,17,5,12
"2021","Chelmsford 012E","E01021584",477,90,63,27,368,90,211,45,118,48,35,16,14,5,31,12,19,1,1,19,7,12
"2021","Chelmsford 013A","E01021548",536,163,67,96,358,58,214,74,91,49,55,27,20,8,28,13,15,3,3,15,5,10
"2021","Chelmsford 013B","E01021560",814,306,205,101,482,118,235,78,124,33,65,44,18,3,60,34,26,4,4,26,7,19
"2021","Chelmsford 013C","E01021561",763,202,128,74,539,136,256,71,150,35,74,45,24,5,72,31,41,1,1,22,11,11
"2021","Chelmsford 013D","E01021564",645,175,118,57,445,123,212,62,109,41,66,32,30,4,40,24,16,4,4,25,11,14
"2021","Chelmsford 013E","E01021571",604,143,99,44,426,94,247,65,130,52,52,23,18,11,31,11,20,2,2,35,16,19
"2021","Chelmsford 014A","E01021562",800,306,147,159,462,81,228,53,121,54,68,36,22,10,82,45,37,3,3,32,14,18
"2021","Chelmsford 014B","E01021563",800,310,100,210,430,35,181,54,103,24,102,63,31,8,103,71,32,9,9,60,20,40
"2021","Chelmsford 014C","E01021565",687,211,112,99,442,55,175,47,83,45,81,24,52,5,126,88,38,5,5,34,14,20
"2021","Chelmsford 014D","E01021566",688,183,85,98,473,98,258,77,115,66,70,38,27,5,44,25,19,3,3,32,12,20
"2021","Chelmsford 014F","E01033137",663,169,46,123,460,53,236,64,137,35,105,56,46,3,66,41,25,0,0,34,9,25
"2021","Chelmsford 014G","E01033145",630,165,87,78,431,77,221,62,117,42,67,30,32,5,63,31,32,3,3,34,13,21
"2021","Chelmsford 015A","E01021557",492,102,55,47,371,68,214,55,109,50,44,25,17,2,44,26,18,1,1,19,8,11
"2021","Chelmsford 015B","E01021558",492,122,76,46,358,73,188,60,78,50,46,22,22,2,51,21,30,0,0,12,6,6
"2021","Chelmsford 015C","E01021583",612,128,49,79,452,56,226,60,111,55,89,46,35,8,80,53,27,1,1,32,17,15
"2021","Chelmsford 015D","E01021585",494,99,64,35,376,52,206,51,100,55,57,30,19,8,58,20,38,3,3,19,9,10
"2021","Chelmsford 015E","E01021586",608,128,81,47,450,89,208,60,109,39,85,38,38,9,65,34,31,3,3,30,12,18
"2021","Chelmsford 016A","E01021533",907,220,98,122,646,139,392,123,180,89,53,29,21,3,61,22,39,1,1,41,16,25
"2021","Chelmsford 016B","E01021535",701,127,72,55,536,93,290,107,127,56,76,41,27,8,73,46,27,4,4,38,13,25
"2021","Chelmsford 016C","E01021569",687,127,77,50,536,131,316,99,166,51,50,29,16,5,38,14,24,1,1,24,10,14
"2021","Chelmsford 016D","E01021570",784,166,120,46,584,184,296,105,134,57,50,18,23,9,50,17,33,4,4,34,11,23
"2021","Chelmsford 016E","E01021572",648,193,110,83,440,74,214,65,106,43,61,24,34,3,89,60,29,2,2,15,9,6
"2021","Chelmsford 017A","E01021552",670,188,134,54,456,108,215,74,100,41,64,37,23,4,64,28,36,5,5,26,10,16
"2021","Chelmsford 017B","E01021553",560,152,85,67,386,57,199,65,85,49,69,36,28,5,59,29,30,2,2,22,11,11
"2021","Chelmsford 017C","E01021554",640,211,75,136,407,78,165,57,80,28,49,17,27,5,107,75,32,8,8,22,10,12
"2021","Chelmsford 017D","E01021555",531,101,67,34,401,95,205,66,98,41,55,24,30,1,45,20,25,1,1,29,16,13
"2021","Chelmsford 017E","E01021559",561,123,71,52,421,103,229,76,102,51,60,28,23,9,27,16,11,2,2,17,6,11
"2021","Chelmsford 018B","E01021602",772,247,147,100,484,103,242,98,93,51,71,27,35,9,65,38,27,3,3,41,16,25
"2021","Chelmsford 018D","E01021604",884,172,104,68,656,127,387,115,183,89,70,31,32,7,69,41,28,3,3,56,19,37
"2021","Chelmsford 018F","E01034085",567,242,145,97,302,88,157,70,56,31,34,24,9,1,22,8,14,1,1,23,8,15
"2021","Chelmsford 018G","E01034086",698,161,106,55,505,142,287,99,132,56,36,18,14,4,37,16,21,3,3,32,12,20
"2021","Chelmsford 019A","E01021611",520,90,56,34,408,53,238,72,115,51,70,33,32,5,46,20,26,1,1,22,10,12
"2021","Chelmsford 019B","E01021612",608,150,101,49,438,112,227,70,101,56,58,23,27,8,41,19,22,0,0,20,8,12
"2021","Chelmsford 019C","E01021613",862,324,118,206,518,72,238,72,123,43,120,69,50,1,85,47,38,3,3,20,9,11
"2021","Chelmsford 019D","E01021614",663,127,84,43,506,92,278,84,125,69,75,27,37,11,61,30,31,0,0,30,16,14
"2021","Chelmsford 019E","E01021615",623,156,84,72,443,94,229,69,128,32,66,32,27,7,51,31,20,3,3,24,11,13
"2021","Chelmsford 020A","E01021605",464,81,42,39,360,68,224,77,91,56,32,16,13,3,35,17,18,1,1,23,9,14
"2021","Chelmsford 020B","E01021606",590,127,38,89,435,49,274,84,126,64,59,36,19,4,52,34,18,1,1,28,12,16
"2021","Chelmsford 020C","E01021607",644,191,84,107,436,39,214,73,107,34,101,65,31,5,81,54,27,1,1,17,6,11
"2021","Chelmsford 020D","E01021608",549,228,91,137,301,37,147,47,67,33,54,33,18,3,62,39,23,1,1,20,9,11
"2021","Chelmsford 020E","E01021609",516,97,56,41,394,82,236,69,112,55,45,24,17,4,31,13,18,0,0,25,11,14
"2021","Chelmsford 020F","E01021610",555,179,50,129,358,45,188,53,95,40,72,51,20,1,51,33,18,2,2,18,8,10
"2021","Chelmsford 021A","E01021593",681,170,134,36,474,112,250,87,102,61,60,30,23,7,48,16,32,4,4,37,16,21
"2021","Chelmsford 021C","E01021595",749,182,132,50,522,138,270,96,99,75,70,33,28,9,42,19,23,2,2,45,24,21
"2021","Chelmsford 021D","E01034087",655,174,113,61,452,144,216,124,55,37,49,36,9,4,39,13,26,4,4,29,12,17
"2021","Chelmsford 021E","E01034088",604,119,36,83,461,40,215,52,140,23,130,66,54,10,76,61,15,0,0,24,13,11
"2021","Chelmsford 022B","E01021627",571,224,111,113,310,53,161,52,81,28,65,45,18,2,31,16,15,0,0,37,8,29
"2021","Chelmsford 022D","E01033140",1152,552,148,404,530,31,204,80,103,21,202,159,39,4,70,48,22,23,23,70,12,58
"2021","Chelmsford 022A","E01034089",918,326,24,302,505,9,190,71,103,16,201,162,36,3,92,70,22,13,13,87,18,69
"2021","Chelmsford 022C","E01034090",729,348,117,231,349,36,115,49,58,8,140,108,26,6,44,33,11,14,14,32,3,29
"2021","Chelmsford 023D","E01021578",856,343,77,266,463,30,200,69,116,15,137,94,41,2,87,58,29,9,9,50,20,30
"2021","Chelmsford 023C","E01021582",1086,466,155,311,563,40,206,79,109,18,206,157,46,3,88,56,32,23,23,57,13,44
"2021","Chelmsford 023A","E01034091",720,357,45,312,312,7,127,59,59,9,136,120,14,2,30,20,10,12,12,51,9,42
"2021","Chelmsford 023B","E01034092",686,292,30,262,342,5,102,47,54,1,173,151,21,1,42,30,12,20,20,52,5,47
"2021","Colchester 001A","E01021655",541,108,68,40,390,91,217,76,93,48,39,21,14,4,41,22,19,2,2,43,18,25
"2021","Colchester 001B","E01021656",724,208,126,82,487,117,248,107,101,40,63,25,32,6,54,35,19,5,5,29,19,10
"2021","Colchester 001C","E01021659",865,192,99,93,624,108,360,142,155,63,92,55,34,3,56,32,24,8,8,49,17,32
"2021","Colchester 001D","E01021661",752,157,88,69,558,102,306,77,166,63,83,32,48,3,66,47,19,1,1,37,14,23
"2021","Colchester 002A","E01021668",797,368,78,290,407,32,190,74,91,25,110,78,28,4,71,50,21,4,4,22,11,11
"2021","Colchester 002B","E01021669",702,304,78,226,369,24,140,50,65,25,103,56,37,10,92,64,28,10,10,29,12,17
"2021","Colchester 002C","E01021670",615,166,59,107,434,65,190,55,106,29,76,41,31,4,101,70,31,2,2,15,5,10
"2021","Colchester 002D","E01021671",596,160,86,74,413,73,241,80,119,42,54,32,18,4,40,22,18,5,5,23,11,12
"2021","Colchester 002F","E01033720",773,173,36,137,553,16,290,66,189,35,123,65,54,4,120,92,28,4,4,47,21,26
"2021","Colchester 002G","E01033721",651,146,45,101,465,12,284,62,190,32,90,48,41,1,76,57,19,3,3,40,15,25
"2021","Colchester 003A","E01021660",588,118,78,40,438,89,256,93,111,52,56,31,22,3,36,17,19,1,1,32,15,17
"2021","Colchester 003B","E01021728",680,143,106,37,503,128,291,109,127,55,50,26,24,0,34,12,22,0,0,34,16,18
"2021","Colchester 003C","E01021729",680,183,89,94,470,80,241,63,116,62,73,35,37,1,74,43,31,2,2,27,16,11
"2021","Colchester 003D","E01021730",728,178,107,71,517,101,261,88,125,48,88,40,42,6,62,23,39,5,5,33,9,24
"2021","Colchester 007A","E01021646",1043,449,189,260,525,66,202,77,105,20,160,114,41,5,88,61,27,9,9,69,12,57
"2021","Colchester 007B","E01021647",985,275,116,159,649,85,297,96,151,50,137,88,45,4,125,90,35,5,5,61,18,43
"2021","Colchester 007C","E01021648",1167,472,177,295,612,68,267,111,123,33,133,90,34,9,130,92,38,14,14,83,21,62
"2021","Colchester 007E","E01021650",1025,366,55,311,581,33,221,86,117,18,174,118,53,3,132,92,40,21,21,78,22,56
"2021","Colchester 007F","E01035157",657,326,81,245,297,14,104,53,40,11,88,59,26,3,81,59,22,10,10,34,9,25
"2021","Colchester 007G","E01035158",682,410,86,324,230,11,67,40,24,3,103,85,15,3,42,32,10,7,7,42,5,37
"2021","Colchester 008A","E01021696",698,273,101,172,343,33,117,36,60,21,63,25,36,2,124,86,38,6,6,82,15,67
"2021","Colchester 008B","E01021697",717,243,130,113,413,53,169,48,78,43,72,21,47,4,111,80,31,8,8,61,16,45
"2021","Colchester 008C","E01021698",477,116,45,71,261,33,93,33,37,23,55,25,23,7,76,55,21,4,4,100,13,87
"2021","Colchester 008D","E01021699",598,195,90,105,328,31,118,46,40,32,68,27,30,11,106,57,49,5,5,75,9,66
"2021","Colchester 008E","E01021700",531,152,48,104,271,11,104,30,55,19,50,26,22,2,102,74,28,4,4,108,18,90
"2021","Colchester 008G","E01033719",727,250,9,241,274,6,55,26,21,8,122,113,9,0,46,39,7,45,45,203,4,199
"2021","Colchester 008H","E01033722",548,144,38,106,266,21,99,35,46,18,51,25,24,2,88,66,22,7,7,138,16,122
"2021","Colchester 009A","E01021673",637,182,117,65,429,112,229,72,104,53,45,25,18,2,41,22,19,2,2,26,8,18
"2021","Colchester 009B","E01021674",555,149,54,95,371,34,166,47,85,34,76,32,35,9,90,65,25,5,5,35,18,17
"2021","Colchester 009C","E01021675",541,138,84,54,378,73,207,56,113,38,53,23,25,5,43,23,20,2,2,25,13,12
"2021","Colchester 009D","E01021676",687,210,103,107,441,75,246,84,120,42,64,30,27,7,56,33,23,0,0,36,14,22
"2021","Colchester 010B","E01021662",639,145,87,58,464,104,268,115,103,50,49,23,22,4,43,25,18,0,0,30,12,18
"2021","Colchester 010C","E01021663",479,110,76,34,348,82,190,76,79,35,43,27,12,4,33,15,18,0,0,21,11,10
"2021","Colchester 010D","E01021677",497,115,71,44,364,84,208,68,91,49,35,16,17,2,35,19,16,2,2,18,2,16
"2021","Colchester 010E","E01021678",619,178,53,125,412,81,190,66,84,40,77,49,25,3,62,34,28,2,2,29,7,22
"2021","Colchester 010F","E01035159",978,154,22,132,782,19,385,103,250,32,245,148,92,5,127,111,16,6,6,42,22,20
"2021","Colchester 010G","E01035160",654,149,86,63,478,84,297,85,153,59,58,26,27,5,37,19,18,2,2,27,12,15
"2021","Colchester 011A","E01021683",1046,421,70,351,544,28,236,86,134,16,171,135,33,3,99,72,27,10,10,81,24,57
"2021","Colchester 011B","E01021684",702,234,107,127,438,47,183,73,85,25,124,74,45,5,79,55,24,5,5,30,7,23
"2021","Colchester 011E","E01021687",815,243,68,175,503,25,196,79,97,20,141,89,49,3,136,102,34,5,5,69,23,46
"2021","Colchester 011F","E01021688",742,214,59,155,463,29,192,63,110,19,132,72,58,2,103,71,32,7,7,65,21,44
"2021","Colchester 011G","E01035161",654,298,49,249,312,6,101,37,56,8,84,52,32,0,108,96,12,13,13,44,16,28
"2021","Colchester 011H","E01035162",593,222,38,184,308,7,115,44,58,13,84,47,34,3,91,65,26,11,11,63,25,38
"2021","Colchester 011I","E01035163",617,189,42,147,373,10,152,53,85,14,98,52,41,5,110,88,22,3,3,55,18,37
"2021","Colchester 011J","E01035164",443,127,19,108,244,5,78,20,44,14,65,31,30,4,90,65,25,6,6,72,9,63
"2021","Colchester 012A","E01021718",794,245,62,183,517,75,255,83,134,38,115,56,54,5,69,51,18,3,3,32,19,13
"2021","Colchester 012B","E01021719",720,220,133,87,455,100,207,80,83,44,88,47,39,2,57,36,21,3,3,45,18,27
"2021","Colchester 012C","E01021720",708,276,168,108,412,66,201,73,95,33,79,45,31,3,66,41,25,0,0,20,6,14
"2021","Colchester 012D","E01021721",788,169,111,58,583,126,278,86,135,57,78,32,33,13,100,74,26,1,1,36,14,22
"2021","Colchester 012E","E01021722",1001,237,129,108,718,89,374,108,213,53,151,82,63,6,97,57,40,7,7,46,30,16
"2021","Colchester 013A","E01021651",1123,423,132,291,617,37,260,79,153,28,172,102,67,3,133,97,36,15,15,83,18,65
"2021","Colchester 013B","E01021652",649,201,78,123,413,78,236,56,144,36,61,34,25,2,36,20,16,2,2,35,13,22
"2021","Colchester 013C","E01021653",496,93,42,51,372,55,212,43,137,32,58,24,32,2,46,32,14,1,1,31,15,16
"2021","Colchester 013D","E01021717",1078,264,94,170,744,68,398,107,247,44,145,90,53,2,128,81,47,5,5,70,22,48
"2021","Colchester 014A","E01021689",619,178,122,56,417,88,197,53,107,37,57,25,28,4,73,35,38,2,2,24,12,12
"2021","Colchester 014B","E01021690",503,96,51,45,383,65,213,70,97,46,57,25,25,7,46,27,19,2,2,24,8,16
"2021","Colchester 014C","E01021691",659,184,124,60,437,102,236,76,116,44,55,29,22,4,42,25,17,2,2,38,15,23
"2021","Colchester 014D","E01021692",611,171,113,58,413,102,218,79,91,48,52,20,26,6,41,27,14,0,0,27,11,16
"2021","Colchester 014E","E01021693",722,181,142,39,508,132,269,94,115,60,54,25,21,8,49,23,26,4,4,33,10,23
"2021","Colchester 015A","E01021711",583,175,89,86,385,32,154,49,70,35,84,34,44,6,111,66,45,4,4,23,13,10
"2021","Colchester 015C","E01021713",495,141,66,75,311,36,159,40,80,39,40,13,22,5,73,46,27,3,3,43,18,25
"2021","Colchester 015D","E01021714",715,165,45,120,489,30,261,70,152,39,88,41,42,5,107,78,29,3,3,61,26,35
"2021","Colchester 015E","E01021715",591,140,64,76,417,36,232,80,102,50,63,27,31,5,85,54,31,1,1,34,17,17
"2021","Colchester 015H","E01035165",667,96,11,85,522,1,356,72,267,17,61,25,35,1,102,91,11,2,2,49,30,19
"2021","Colchester 015I","E01035166",409,57,7,50,336,11,211,57,142,12,45,11,31,3,69,55,14,0,0,16,12,4
"2021","Colchester 016A","E01021657",954,279,105,174,625,84,279,121,122,36,169,104,61,4,88,60,28,5,5,50,22,28
"2021","Colchester 016B","E01021658",441,118,64,54,296,32,143,55,57,31,65,32,28,5,56,34,22,0,0,27,14,13
"2021","Colchester 016C","E01021664",917,326,123,203,511,54,235,86,111,38,121,75,42,4,90,64,26,11,11,80,14,66
"2021","Colchester 016D","E01021665",641,248,105,143,361,33,149,54,61,34,67,29,35,3,106,62,44,6,6,32,15,17
"2021","Colchester 016E","E01021666",631,253,75,178,348,39,164,63,72,29,81,47,25,9,55,35,20,9,9,30,12,18
"2021","Colchester 016F","E01021667",634,193,83,110,415,54,180,63,78,39,80,37,35,8,100,67,33,1,1,26,11,15
"2021","Colchester 017A","E01021736",414,93,44,49,294,60,155,47,83,25,37,11,23,3,40,30,10,2,2,27,8,19
"2021","Colchester 017B","E01021737",557,217,112,105,314,61,144,66,61,17,65,37,24,4,40,30,10,4,4,26,7,19
"2021","Colchester 017C","E01021738",1034,368,177,191,617,125,306,135,140,31,115,77,33,5,68,41,27,3,3,49,9,40
"2021","Colchester 017D","E01021739",668,172,110,62,468,126,240,86,106,48,60,37,23,0,40,26,14,2,2,28,8,20
"2021","Colchester 017E","E01021740",737,219,119,100,475,105,237,71,120,46,70,36,30,4,60,34,26,3,3,43,9,34
"2021","Colchester 018A","E01021637",483,106,42,64,353,54,165,63,65,37,60,29,30,1,68,40,28,6,6,24,9,15
"2021","Colchester 018B","E01021638",756,153,60,93,560,28,272,84,142,46,117,55,55,7,137,94,43,6,6,43,20,23
"2021","Colchester 018C","E01021639",949,283,67,216,615,39,251,69,152,30,140,74,59,7,177,127,50,8,8,51,18,33
"2021","Colchester 018D","E01021640",488,108,55,53,343,45,160,64,69,27,75,36,34,5,59,32,27,4,4,37,10,27
"2021","Colchester 018E","E01021641",599,137,79,58,412,56,192,82,80,30,75,39,30,6,85,51,34,4,4,50,20,30
"2021","Colchester 018F","E01021642",877,278,93,185,535,37,224,70,100,54,130,68,54,8,131,93,38,13,13,64,34,30
"2021","Colchester 019A","E01021643",954,165,94,71,760,145,450,154,215,81,102,50,44,8,61,33,28,2,2,29,8,21
"2021","Colchester 019B","E01021644",678,143,90,53,491,94,285,114,121,50,70,25,39,6,40,18,22,2,2,44,20,24
"2021","Colchester 019C","E01021645",590,106,74,32,462,111,266,91,122,53,47,28,15,4,35,25,10,3,3,22,7,15
"2021","Colchester 019D","E01021694",610,130,83,47,454,114,243,116,87,40,62,34,21,7,34,15,19,1,1,26,12,14
"2021","Colchester 019E","E01021695",484,130,84,46,334,70,182,69,68,45,52,27,18,7,29,16,13,1,1,20,10,10
"2021","Colchester 020A","E01021723",830,245,155,90,554,139,261,104,105,52,85,44,33,8,65,30,35,4,4,31,13,18
"2021","Colchester 020B","E01021724",755,258,172,86,467,109,224,60,103,61,72,35,35,2,59,24,35,3,3,30,10,20
"2021","Colchester 020C","E01021725",608,130,77,53,449,112,245,89,97,59,53,25,25,3,38,15,23,1,1,29,17,12
"2021","Colchester 020D","E01021726",648,196,79,117,424,70,168,63,73,32,93,43,37,13,87,49,38,6,6,28,12,16
"2021","Colchester 020E","E01021727",694,200,140,60,474,116,214,76,83,55,75,45,25,5,69,31,38,0,0,20,8,12
"2021","Colchester 021A","E01021731",660,190,134,56,441,152,200,100,55,45,45,22,19,4,42,18,24,2,2,29,9,20
"2021","Colchester 021B","E01021732",720,277,162,115,418,78,193,78,72,43,68,31,29,8,76,41,35,3,3,25,7,18
"2021","Colchester 021C","E01021733",675,158,107,51,489,177,205,78,84,43,51,22,21,8,56,29,27,0,0,28,9,19
"2021","Colchester 021D","E01021734",626,181,141,40,418,140,190,81,61,48,51,28,20,3,36,14,22,1,1,27,5,22
"2021","Colchester 021E","E01021735",675,247,178,69,400,134,183,77,63,43,40,20,16,4,41,17,24,2,2,28,9,19
"2021","Colchester 022D","E01021702",586,180,92,88,372,56,164,52,75,37,75,41,27,7,73,37,36,4,4,34,14,20
"2021","Colchester 022E","E01021703",491,128,65,63,314,10,120,29,74,17,77,24,48,5,102,70,32,5,5,49,20,29
"2021","Colchester 022F","E01021704",661,240,108,132,373,41,163,61,71,31,83,43,36,4,78,47,31,8,8,48,12,36
"2021","Colchester 022G","E01021705",787,193,96,97,545,103,292,118,100,74,85,39,38,8,65,43,22,0,0,49,19,30
"2021","Colchester 022H","E01021706",601,220,61,159,306,33,124,51,58,15,78,58,17,3,62,42,20,9,9,75,13,62
"2021","Colchester 022I","E01021707",586,184,99,85,373,73,181,57,75,49,67,25,32,10,49,22,27,3,3,29,8,21
"2021","Colchester 022A","E01021708",637,190,106,84,416,109,207,85,82,40,62,32,23,7,34,17,17,4,4,31,14,17
"2021","Colchester 022B","E01021709",621,173,133,40,412,127,186,72,68,46,54,23,25,6,45,16,29,0,0,36,14,22
"2021","Colchester 022C","E01021710",912,182,106,76,687,166,354,115,167,72,96,47,42,7,67,34,33,4,4,43,21,22
"2021","Colchester 023A","E01035167",482,167,9,158,285,7,120,32,83,5,82,52,30,0,73,61,12,3,3,30,13,17
"2021","Colchester 023B","E01035168",603,113,37,76,453,26,257,65,161,31,88,39,49,0,81,62,19,1,1,37,14,23
"2021","Colchester 023C","E01035169",519,89,10,79,405,8,202,52,139,11,151,95,54,2,40,36,4,4,4,25,16,9
"2021","Colchester 023D","E01035170",593,144,43,101,422,14,204,47,141,16,144,88,53,3,55,36,19,5,5,27,10,17
"2021","Colchester 023E","E01035171",450,127,34,93,308,36,171,50,106,15,66,42,24,0,34,23,11,1,1,15,7,8
"2021","Colchester 023F","E01035172",738,154,65,89,547,71,328,101,183,44,95,62,29,4,50,30,20,3,3,37,8,29
"2021","Colchester 024B","E01035173",562,181,55,126,347,50,200,77,95,28,53,38,14,1,42,25,17,2,2,34,10,24
"2021","Colchester 024C","E01035174",530,91,27,64,385,21,211,55,129,27,76,37,36,3,72,47,25,5,5,54,19,35
"2021","Colchester 024D","E01035175",646,151,14,137,423,9,213,62,134,17,104,67,35,2,93,69,24,4,4,72,18,54
"2021","Colchester 024E","E01035176",708,214,57,157,465,38,271,83,154,34,101,68,32,1,53,30,23,2,2,29,8,21
"2021","Colchester 024F","E01035177",629,184,28,156,400,12,129,53,67,9,146,105,39,2,99,79,20,14,14,45,13,32
"2021","Epping Forest 001A","E01021768",933,215,121,94,671,117,374,124,170,80,110,56,47,7,66,35,31,4,4,47,19,28
"2021","Epping Forest 001B","E01021795",1043,392,125,267,625,84,283,102,132,49,165,121,40,4,91,54,37,2,2,26,12,14
"2021","Epping Forest 001C","E01021797",530,122,71,51,367,63,201,61,81,59,56,24,23,9,45,18,27,2,2,41,19,22
"2021","Epping Forest 001D","E01021798",650,183,123,60,443,85,216,71,98,47,69,25,38,6,69,38,31,4,4,24,14,10
"2021","Epping Forest 001E","E01021799",795,256,136,120,514,72,214,63,104,47,110,54,42,14,114,72,42,4,4,25,10,15
"2021","Epping Forest 002A","E01021741",850,160,104,56,602,102,343,116,142,85,94,54,30,10,60,28,32,3,3,88,37,51
"2021","Epping Forest 002B","E01021792",541,125,87,38,361,81,203,68,82,53,39,15,20,4,36,17,19,2,2,55,24,31
"2021","Epping Forest 002C","E01021793",660,138,99,39,478,116,254,91,91,72,64,29,25,10,40,22,18,4,4,44,22,22
"2021","Epping Forest 002D","E01021794",515,141,94,47,332,60,162,61,61,40,56,27,22,7,51,27,24,3,3,42,18,24
"2021","Epping Forest 002E","E01021801",925,232,139,93,635,117,348,134,142,72,95,57,31,7,66,33,33,9,9,58,18,40
"2021","Epping Forest 003A","E01021769",943,184,88,96,689,128,374,112,155,107,100,46,41,13,86,47,39,1,1,70,24,46
"2021","Epping Forest 003B","E01021796",953,204,117,87,690,149,351,141,131,79,101,49,42,10,83,32,51,6,6,59,24,35
"2021","Epping Forest 003C","E01021800",944,185,79,106,678,127,378,128,156,94,89,42,35,12,79,41,38,5,5,81,40,41
"2021","Epping Forest 004A","E01021753",719,244,124,120,441,54,213,76,101,36,95,49,41,5,77,62,15,2,2,34,14,20
"2021","Epping Forest 004B","E01021754",618,133,102,31,459,126,252,67,110,75,41,17,20,4,39,19,20,1,1,26,13,13
"2021","Epping Forest 004C","E01021755",540,176,123,53,344,94,171,55,76,40,39,15,21,3,38,25,13,2,2,20,8,12
"2021","Epping Forest 004D","E01021802",1053,240,133,107,765,83,334,100,164,70,165,55,95,15,178,128,50,5,5,48,29,19
"2021","Epping Forest 005A","E01021760",641,177,92,85,447,85,239,70,118,51,65,32,25,8,55,27,28,3,3,17,8,9
"2021","Epping Forest 005B","E01021761",806,198,101,97,564,85,264,81,121,62,107,50,51,6,105,53,52,3,3,44,22,22
"2021","Epping Forest 005C","E01021762",647,201,133,68,409,60,187,55,97,35,72,37,28,7,87,45,42,3,3,37,13,24
"2021","Epping Forest 005D","E01021763",825,221,125,96,575,75,317,95,177,45,103,48,49,6,77,37,40,3,3,29,15,14
"2021","Epping Forest 006A","E01021756",632,142,79,63,453,69,241,79,111,51,85,35,46,4,55,25,30,3,3,37,15,22
"2021","Epping Forest 006B","E01021757",856,303,140,163,527,117,231,103,92,36,119,96,19,4,58,34,24,2,2,26,8,18
"2021","Epping Forest 006C","E01021758",708,258,129,129,426,75,173,56,85,32,106,60,38,8,67,42,25,5,5,24,15,9
"2021","Epping Forest 006D","E01021759",620,144,77,67,442,36,223,61,128,34,95,46,43,6,83,41,42,5,5,34,15,19
"2021","Epping Forest 007A","E01021811",589,195,94,101,355,42,146,46,69,31,62,18,35,9,102,53,49,3,3,39,22,17
"2021","Epping Forest 007B","E01021813",613,181,119,62,398,99,193,72,84,37,49,27,17,5,57,23,34,0,0,34,12,22
"2021","Epping Forest 007C","E01021814",691,159,80,79,500,58,228,60,110,58,102,31,56,15,110,63,47,2,2,32,12,20
"2021","Epping Forest 007D","E01021815",594,151,74,77,395,36,188,38,96,54,69,20,40,9,97,63,34,5,5,48,29,19
"2021","Epping Forest 007E","E01021816",622,259,112,147,326,18,161,42,75,44,66,29,35,2,79,41,38,2,2,37,18,19
"2021","Epping Forest 008A","E01021807",584,132,62,70,417,58,204,48,111,45,76,34,38,4,78,42,36,1,1,35,20,15
"2021","Epping Forest 008B","E01021808",619,167,83,84,417,43,158,29,90,39,73,26,40,7,137,80,57,6,6,35,21,14
"2021","Epping Forest 008C","E01021809",608,206,99,107,369,62,173,60,78,35,58,22,30,6,72,29,43,4,4,33,20,13
"2021","Epping Forest 008D","E01021810",778,232,52,180,510,39,230,74,121,35,108,52,49,7,128,87,41,5,5,36,19,17
"2021","Epping Forest 008E","E01021817",1083,280,91,189,745,69,348,87,185,76,159,70,78,11,160,104,56,9,9,58,23,35
"2021","Epping Forest 009A","E01021806",1140,389,217,172,672,128,328,107,155,66,100,43,51,6,108,63,45,8,8,79,37,42
"2021","Epping Forest 009B","E01021812",591,240,133,107,304,53,155,69,46,40,42,20,14,8,51,24,27,3,3,47,24,23
"2021","Epping Forest 009C","E01021818",989,414,112,302,508,50,188,56,90,42,138,79,50,9,121,79,42,11,11,67,18,49
"2021","Epping Forest 010A","E01021770",881,272,149,123,560,111,253,86,109,58,92,48,37,7,100,57,43,4,4,49,18,31
"2021","Epping Forest 010B","E01021803",529,135,100,35,361,69,200,55,98,47,37,16,19,2,53,13,40,2,2,33,15,18
"2021","Epping Forest 010C","E01021804",617,190,96,94,404,84,206,68,96,42,65,41,17,7,46,26,20,3,3,23,8,15
"2021","Epping Forest 010D","E01021805",497,92,64,28,372,75,237,54,128,55,36,13,20,3,24,13,11,0,0,33,14,19
"2021","Epping Forest 011A","E01021774",632,198,48,150,399,16,203,61,98,44,88,42,41,5,89,54,35,3,3,35,20,15
"2021","Epping Forest 011B","E01021775",654,196,71,125,417,18,200,48,104,48,87,40,38,9,109,59,50,3,3,41,20,21
"2021","Epping Forest 011C","E01021776",839,359,169,190,439,29,165,59,86,20,111,58,45,8,125,86,39,9,9,41,18,23
"2021","Epping Forest 011D","E01021777",568,164,77,87,365,31,180,46,93,41,66,23,33,10,82,48,34,6,6,39,18,21
"2021","Epping Forest 011E","E01021778",608,165,68,97,388,20,194,49,103,42,81,31,42,8,88,44,44,5,5,55,13,42
"2021","Epping Forest 011F","E01021779",697,235,81,154,434,31,206,53,118,35,80,38,40,2,112,75,37,5,5,28,18,10
"2021","Epping Forest 012A","E01021786",552,158,53,105,376,69,198,61,96,41,62,42,16,4,45,27,18,2,2,18,8,10
"2021","Epping Forest 012B","E01021787",661,162,81,81,468,66,280,90,125,65,74,41,27,6,48,16,32,0,0,31,14,17
"2021","Epping Forest 012C","E01021788",632,142,75,67,460,87,253,55,127,71,58,28,22,8,61,30,31,1,1,30,17,13
"2021","Epping Forest 012D","E01021789",562,93,73,20,428,87,284,80,130,74,23,10,12,1,34,14,20,0,0,41,23,18
"2021","Epping Forest 012E","E01021790",701,147,53,94,500,24,252,49,157,46,102,56,42,4,115,69,46,7,7,54,24,30
"2021","Epping Forest 012F","E01021791",719,197,96,101,482,63,241,77,132,32,105,70,30,5,64,35,29,9,9,40,18,22
"2021","Epping Forest 013A","E01021771",730,241,71,170,436,19,164,44,90,30,107,47,50,10,136,98,38,10,10,53,29,24
"2021","Epping Forest 013B","E01021772",608,155,92,63,406,70,188,52,99,37,68,40,21,7,75,38,37,5,5,47,20,27
"2021","Epping Forest 013C","E01021773",602,129,64,65,414,23,186,54,100,32,87,40,36,11,109,59,50,9,9,59,28,31
"2021","Epping Forest 013D","E01021783",650,150,72,78,461,65,245,71,121,53,79,46,29,4,66,24,42,6,6,39,17,22
"2021","Epping Forest 013E","E01021784",626,175,98,77,430,46,251,62,145,44,82,40,33,9,50,19,31,1,1,21,7,14
"2021","Epping Forest 014A","E01021780",500,73,39,34,393,76,240,57,123,60,44,18,21,5,33,16,17,0,0,34,16,18
"2021","Epping Forest 014B","E01021781",651,183,86,97,431,60,245,82,136,27,81,54,23,4,42,24,18,3,3,37,20,17
"2021","Epping Forest 014C","E01021782",634,207,116,91,389,72,198,61,104,33,65,46,15,4,51,24,27,3,3,38,17,21
"2021","Epping Forest 014D","E01021785",651,156,75,81,451,36,226,58,125,43,77,34,32,11,108,63,45,4,4,44,22,22
"2021","Epping Forest 015A","E01021742",500,120,52,68,343,38,184,35,96,53,48,16,26,6,71,48,23,2,2,37,16,21
"2021","Epping Forest 015B","E01021743",795,298,167,131,464,59,210,62,110,38,121,78,41,2,68,34,34,6,6,33,16,17
"2021","Epping Forest 015C","E01021744",663,162,62,100,451,51,232,50,130,52,81,39,35,7,83,39,44,4,4,50,22,28
"2021","Epping Forest 015D","E01021745",684,187,85,102,458,63,247,59,136,52,78,44,30,4,64,46,18,6,6,39,19,20
"2021","Epping Forest 015E","E01021746",862,289,138,151,540,80,261,75,143,43,97,56,35,6,92,48,44,10,10,33,13,20
"2021","Epping Forest 015F","E01021747",644,154,75,79,460,103,275,64,160,51,47,30,13,4,34,19,15,1,1,30,13,17
"2021","Epping Forest 015G","E01021748",728,203,79,124,481,61,261,70,142,49,93,58,32,3,65,38,27,1,1,44,20,24
"2021","Epping Forest 016A","E01021749",915,231,129,102,623,150,310,102,133,75,80,41,31,8,79,37,42,4,4,61,36,25
"2021","Epping Forest 016B","E01021750",617,134,63,71,427,63,269,70,136,63,44,22,19,3,46,27,19,5,5,56,27,29
"2021","Epping Forest 016C","E01021751",454,61,46,15,346,59,257,55,134,68,10,4,2,4,17,8,9,3,3,47,29,18
"2021","Epping Forest 016D","E01021752",562,108,57,51,406,47,232,65,107,60,51,23,22,6,71,32,39,5,5,48,28,20
"2021","Epping Forest 017A","E01021764",723,152,56,96,498,20,168,31,109,28,89,28,55,6,213,141,72,8,8,73,41,32
"2021","Epping Forest 017B","E01021765",754,163,70,93,517,68,286,71,149,66,57,27,28,2,97,65,32,9,9,74,43,31
"2021","Epping Forest 017C","E01021766",507,67,41,26,339,51,201,39,104,58,31,17,12,2,50,20,30,6,6,101,70,31
"2021","Epping Forest 017D","E01021767",690,146,76,70,469,89,282,65,147,70,40,19,15,6,47,21,26,11,11,75,43,32
"2021","Harlow 001A","E01021854",979,297,97,200,624,84,274,95,136,43,143,94,42,7,118,75,43,5,5,58,23,35
"2021","Harlow 001B","E01021855",649,201,117,84,402,59,186,59,89,38,81,40,38,3,75,43,32,1,1,46,21,25
"2021","Harlow 001C","E01021856",657,194,104,90,431,56,186,64,85,37,78,41,28,9,108,59,49,3,3,32,14,18
"2021","Harlow 001E","E01034362",592,118,25,93,436,27,188,53,113,22,156,92,57,7,61,44,17,4,4,38,22,16
"2021","Harlow 001F","E01034363",577,194,98,96,364,68,190,80,86,24,71,42,24,5,33,20,13,2,2,19,9,10
"2021","Harlow 001G","E01034364",596,82,9,73,476,15,257,63,179,15,127,51,73,3,73,61,12,4,4,38,21,17
"2021","Harlow 001H","E01034365",592,170,24,146,389,14,178,39,114,25,102,61,31,10,92,75,17,3,3,33,19,14
"2021","Harlow 002A","E01021844",522,126,58,68,342,27,156,51,66,39,64,18,31,15,93,50,43,2,2,54,26,28
"2021","Harlow 002B","E01021845",664,191,86,105,431,42,169,49,81,39,75,25,41,9,141,101,40,4,4,42,14,28
"2021","Harlow 002C","E01021846",585,179,58,121,350,20,136,50,55,31,70,26,38,6,116,84,32,8,8,56,25,31
"2021","Harlow 002D","E01021847",605,208,123,85,365,47,168,45,88,35,62,26,27,9,81,49,32,7,7,32,14,18
"2021","Harlow 002E","E01021848",844,280,86,194,514,42,224,62,112,50,105,49,50,6,137,94,43,6,6,50,20,30
"2021","Harlow 003A","E01021849",683,203,98,105,419,51,191,57,99,35,80,43,32,5,93,59,34,4,4,61,24,37
"2021","Harlow 003B","E01021850",599,195,86,109,358,23,170,45,80,45,71,27,37,7,90,59,31,4,4,46,19,27
"2021","Harlow 003C","E01021851",770,269,69,200,443,18,176,63,87,26,94,43,44,7,142,106,36,13,13,58,26,32
"2021","Harlow 003D","E01021852",670,203,88,115,417,32,191,51,94,46,84,25,47,12,106,63,43,4,4,50,24,26
"2021","Harlow 003E","E01021853",829,306,95,211,476,56,198,71,95,32,134,82,45,7,77,47,30,11,11,47,20,27
"2021","Harlow 004A","E01021839",796,204,82,122,507,45,251,92,105,54,107,56,46,5,103,63,40,1,1,85,30,55
"2021","Harlow 004B","E01021840",758,198,66,132,499,25,192,57,95,40,87,41,41,5,186,150,36,9,9,61,32,29
"2021","Harlow 004C","E01021841",550,103,55,48,393,50,198,61,94,43,64,23,31,10,77,50,27,4,4,54,28,26
"2021","Harlow 004D","E01021842",661,196,69,127,406,29,195,48,113,34,72,26,44,2,101,72,29,9,9,59,32,27
"2021","Harlow 004E","E01021843",1142,366,82,284,664,28,306,81,180,45,146,83,55,8,168,118,50,16,16,112,54,58
"2021","Harlow 005A","E01021824",637,110,49,61,496,43,280,64,159,57,93,38,48,7,74,49,25,6,6,31,16,15
"2021","Harlow 005B","E01021825",632,131,42,89,476,32,236,51,134,51,136,68,60,8,68,42,26,4,4,25,14,11
"2021","Harlow 005C","E01021826",632,152,50,102,449,69,242,84,114,44,80,38,37,5,57,28,29,1,1,31,18,13
"2021","Harlow 005D","E01021827",707,202,71,131,469,34,235,73,129,33,115,56,51,8,78,48,30,7,7,36,22,14
"2021","Harlow 005E","E01021828",876,172,59,113,654,48,348,87,201,60,152,53,83,16,102,67,35,4,4,50,21,29
"2021","Harlow 006A","E01021819",636,160,63,97,424,45,192,45,104,43,84,34,42,8,97,61,36,6,6,52,22,30
"2021","Harlow 006B","E01021820",634,169,100,69,426,59,191,60,81,50,73,28,34,11,100,58,42,3,3,39,24,15
"2021","Harlow 006C","E01021822",622,142,73,69,437,42,190,41,105,44,90,28,52,10,109,65,44,6,6,43,25,18
"2021","Harlow 006D","E01021823",756,238,77,161,469,29,189,45,96,48,98,27,62,9,147,92,55,6,6,49,21,28
"2021","Harlow 006E","E01021870",568,168,77,91,359,33,182,61,83,38,57,23,29,5,83,52,31,4,4,41,17,24
"2021","Harlow 007A","E01021831",633,262,157,105,340,44,153,55,72,26,60,20,31,9,75,39,36,8,8,31,22,9
"2021","Harlow 007B","E01021868",668,197,104,93,431,48,213,63,103,47,81,27,39,15,85,60,25,4,4,40,19,21
"2021","Harlow 007C","E01021869",553,143,73,70,374,64,177,55,94,28,54,22,31,1,73,42,31,6,6,36,17,19
"2021","Harlow 007D","E01021871",620,204,84,120,382,46,153,41,84,28,70,28,34,8,106,69,37,7,7,34,17,17
"2021","Harlow 007F","E01034366",611,288,10,278,291,2,114,42,67,5,54,29,24,1,109,97,12,12,12,32,7,25
"2021","Harlow 007G","E01034367",659,179,80,99,417,24,175,39,114,22,67,22,41,4,141,97,44,10,10,63,21,42
"2021","Harlow 008A","E01021821",634,222,103,119,381,30,152,43,76,33,79,31,45,3,109,63,46,11,11,31,12,19
"2021","Harlow 008B","E01021834",645,184,82,102,415,54,160,40,89,31,83,33,45,5,114,80,34,4,4,46,25,21
"2021","Harlow 008C","E01021835",591,155,90,65,398,56,202,56,97,49,63,22,32,9,71,48,23,6,6,38,16,22
"2021","Harlow 008D","E01021836",648,232,105,127,375,28,167,45,89,33,75,31,38,6,101,66,35,4,4,41,19,22
"2021","Harlow 008E","E01021837",660,211,100,111,415,56,185,57,86,42,94,49,37,8,77,48,29,3,3,34,16,18
"2021","Harlow 009A","E01021829",649,227,100,127,383,50,178,51,82,45,66,29,32,5,85,52,33,4,4,39,15,24
"2021","Harlow 009B","E01021830",505,120,65,55,347,66,191,59,86,46,44,20,20,4,42,21,21,4,4,38,13,25
"2021","Harlow 009C","E01021832",519,114,45,69,382,70,174,67,67,40,78,33,36,9,58,29,29,2,2,23,10,13
"2021","Harlow 009D","E01021833",533,184,105,79,325,60,159,43,69,47,49,17,23,9,56,31,25,1,1,24,15,9
"2021","Harlow 009E","E01021865",570,162,70,92,374,44,186,49,86,51,61,27,26,8,77,53,24,6,6,34,16,18
"2021","Harlow 010A","E01021838",603,156,76,80,402,58,191,61,89,41,59,20,31,8,88,47,41,6,6,45,20,25
"2021","Harlow 010B","E01021858",692,202,69,133,438,44,177,52,99,26,99,48,46,5,111,80,31,7,7,52,18,34
"2021","Harlow 010C","E01021859",624,171,66,105,389,32,173,42,104,27,70,28,35,7,103,74,29,11,11,64,28,36
"2021","Harlow 010D","E01021860",622,179,82,97,396,38,146,33,75,38,97,35,52,10,110,70,40,5,5,47,23,24
"2021","Harlow 010E","E01021861",553,123,53,70,401,40,176,49,93,34,87,34,45,8,95,71,24,3,3,29,16,13
"2021","Harlow 011A","E01021862",643,197,84,113,400,40,172,48,90,34,64,26,33,5,116,77,39,8,8,46,28,18
"2021","Harlow 011B","E01021863",650,168,54,114,412,42,183,49,98,36,69,25,42,2,108,63,45,10,10,70,34,36
"2021","Harlow 011C","E01021864",559,136,43,93,366,30,153,35,83,35,69,27,39,3,103,70,33,11,11,57,23,34
"2021","Harlow 011D","E01021866",615,221,95,126,373,28,184,76,79,29,91,51,36,4,70,49,21,0,0,21,8,13
"2021","Harlow 011E","E01021867",596,146,82,64,411,74,216,65,99,52,69,26,35,8,50,26,24,2,2,39,16,23
"2021","Maldon 001A","E01021908",872,208,115,93,634,146,322,114,145,63,81,49,25,7,83,55,28,2,2,30,12,18
"2021","Maldon 001B","E01021909",580,124,75,49,422,90,238,99,80,59,52,29,18,5,39,18,21,3,3,34,13,21
"2021","Maldon 001C","E01021910",691,197,111,86,456,81,248,93,105,50,64,35,24,5,60,30,30,3,3,38,16,22
"2021","Maldon 001D","E01021911",495,104,78,26,358,102,196,74,70,52,41,23,14,4,18,7,11,1,1,33,12,21
"2021","Maldon 002A","E01021882",874,187,130,57,639,158,350,134,146,70,84,50,31,3,44,22,22,3,3,48,22,26
"2021","Maldon 002B","E01021883",667,143,82,61,502,101,286,89,158,39,68,37,30,1,47,29,18,0,0,22,8,14
"2021","Maldon 002C","E01021912",867,197,133,64,634,196,332,120,146,66,58,28,22,8,46,28,18,2,2,36,17,19
"2021","Maldon 002D","E01021913",635,122,83,39,483,113,281,115,111,55,46,23,19,4,42,21,21,1,1,30,17,13
"2021","Maldon 003A","E01021884",617,206,81,125,382,58,200,76,93,31,95,52,40,3,29,16,13,0,0,29,15,14
"2021","Maldon 003B","E01021885",472,99,64,35,347,73,189,92,67,30,51,24,20,7,34,10,24,0,0,26,15,11
"2021","Maldon 003C","E01021886",655,147,79,68,468,87,240,88,103,49,85,47,32,6,55,25,30,1,1,40,14,26
"2021","Maldon 003D","E01021887",955,243,124,119,681,87,363,115,187,61,137,71,50,16,93,45,48,1,1,31,14,17
"2021","Maldon 003E","E01021888",987,265,127,138,688,71,279,67,144,68,155,71,77,7,178,127,51,5,5,34,13,21
"2021","Maldon 004A","E01021889",1078,308,157,151,731,87,321,107,140,74,157,86,50,21,160,103,57,6,6,39,17,22
"2021","Maldon 004B","E01021890",977,458,213,245,488,85,180,88,68,24,129,83,42,4,89,56,33,5,5,31,6,25
"2021","Maldon 004C","E01021891",781,340,249,91,422,137,154,65,50,39,78,39,30,9,53,34,19,0,0,19,5,14
"2021","Maldon 004D","E01021892",490,179,118,61,288,56,110,39,56,15,53,24,27,2,66,38,28,3,3,23,8,15
"2021","Maldon 005A","E01021893",585,119,73,46,437,97,251,80,118,53,51,24,18,9,37,17,20,1,1,29,17,12
"2021","Maldon 005B","E01021894",491,133,66,67,330,66,148,42,62,44,63,33,25,5,52,34,18,1,1,28,15,13
"2021","Maldon 005C","E01021895",487,120,65,55,340,65,145,46,64,35,60,31,27,2,70,41,29,0,0,27,8,19
"2021","Maldon 005D","E01021896",739,131,59,72,583,105,273,83,127,63,146,82,59,5,56,34,22,3,3,25,12,13
"2021","Maldon 005E","E01021897",481,127,62,65,332,77,164,71,47,46,46,21,22,3,43,18,25,2,2,22,9,13
"2021","Maldon 005F","E01021898",592,203,146,57,368,109,176,64,70,42,45,20,18,7,36,16,20,2,2,21,6,15
"2021","Maldon 006A","E01021901",807,200,119,81,559,126,293,111,123,59,89,49,26,14,49,27,22,2,2,48,17,31
"2021","Maldon 006B","E01021904",771,161,86,75,562,69,276,87,126,63,129,70,51,8,86,60,26,2,2,48,24,24
"2021","Maldon 006C","E01021905",502,127,78,49,343,68,155,52,69,34,65,19,40,6,55,28,27,0,0,32,12,20
"2021","Maldon 006D","E01021906",670,225,99,126,398,60,185,71,71,43,89,43,36,10,61,33,28,3,3,47,23,24
"2021","Maldon 006E","E01021907",940,210,126,84,666,137,334,152,117,65,119,62,47,10,71,33,38,5,5,64,29,35
"2021","Maldon 007A","E01021873",539,97,62,35,402,100,212,77,75,60,56,30,20,6,33,11,22,1,1,40,17,23
"2021","Maldon 007B","E01021874",611,145,70,75,427,42,241,102,95,44,83,36,38,9,61,44,17,0,0,39,14,25
"2021","Maldon 007C","E01021875",685,237,155,82,400,120,203,91,62,50,49,29,16,4,28,9,19,0,0,48,19,29
"2021","Maldon 007D","E01021899",531,96,59,37,399,76,232,85,97,50,48,19,24,5,41,22,19,2,2,36,15,21
"2021","Maldon 007E","E01021900",466,138,74,64,305,45,183,66,74,43,42,15,20,7,35,23,12,0,0,23,9,14
"2021","Maldon 007F","E01021902",725,108,63,45,569,125,340,128,122,90,64,36,23,5,33,14,19,7,7,48,22,26
"2021","Maldon 007G","E01021903",656,132,73,59,476,106,283,110,102,71,54,28,20,6,33,14,19,0,0,48,26,22
"2021","Maldon 008C","E01021878",640,199,140,59,418,122,186,78,69,39,57,34,20,3,53,25,28,0,0,23,11,12
"2021","Maldon 008D","E01021879",650,210,108,102,408,72,181,74,69,38,78,41,32,5,71,47,24,6,6,32,17,15
"2021","Maldon 008E","E01021880",816,328,175,153,458,107,188,97,54,37,79,46,28,5,80,51,29,4,4,30,6,24
"2021","Maldon 008F","E01021881",531,170,88,82,338,69,163,61,63,39,55,38,10,7,49,28,21,2,2,23,8,15
"2021","Maldon 008H","E01034093",673,129,69,60,517,85,300,110,144,46,92,57,34,1,40,27,13,0,0,27,12,15
"2021","Maldon 008I","E01034094",662,154,77,77,484,92,239,91,108,40,87,38,41,8,64,43,21,2,2,24,12,12
"2021","Rochford 001A","E01021942",918,407,264,143,486,186,206,122,43,41,54,37,12,5,38,18,20,2,2,25,8,17
"2021","Rochford 001B","E01021943",703,172,126,46,503,131,265,91,111,63,49,22,23,4,58,33,25,0,0,28,11,17
"2021","Rochford 001C","E01021944",654,126,93,33,489,112,259,93,98,68,61,26,25,10,55,33,22,2,2,39,18,21
"2021","Rochford 001D","E01021945",635,128,99,29,469,108,233,83,92,58,66,25,35,6,61,28,33,1,1,38,15,23
"2021","Rochford 002A","E01021914",814,178,120,58,588,133,318,118,123,77,81,37,36,8,54,26,28,2,2,48,19,29
"2021","Rochford 002B","E01021927",486,87,60,27,377,87,212,70,85,57,37,17,14,6,41,16,25,0,0,22,9,13
"2021","Rochford 002C","E01021928",687,234,153,81,422,84,206,79,75,52,72,33,38,1,57,27,30,3,3,31,12,19
"2021","Rochford 002D","E01021929",589,96,69,27,464,83,288,88,131,69,51,20,23,8,41,25,16,1,1,29,14,15
"2021","Rochford 002E","E01021931",676,180,110,70,462,103,236,89,105,42,62,30,26,6,60,32,28,1,1,34,18,16
"2021","Rochford 004A","E01021915",522,123,51,72,361,61,191,81,78,32,62,32,25,5,45,22,23,2,2,38,14,24
"2021","Rochford 004B","E01021916",467,92,53,39,362,46,183,52,90,41,63,24,31,8,68,47,21,2,2,13,6,7
"2021","Rochford 004C","E01021953",535,148,56,92,359,21,121,40,48,33,80,22,49,9,135,93,42,2,2,28,14,14
"2021","Rochford 004D","E01021955",891,413,181,232,442,46,150,45,66,39,115,67,44,4,125,85,40,6,6,36,16,20
"2021","Rochford 005A","E01021918",573,109,71,38,436,82,260,82,122,56,50,17,28,5,43,24,19,1,1,28,15,13
"2021","Rochford 005B","E01021919",537,122,84,38,396,93,215,68,90,57,53,21,29,3,34,17,17,1,1,19,6,13
"2021","Rochford 005C","E01021925",711,210,121,89,465,84,241,74,98,69,86,44,36,6,53,31,22,1,1,36,17,19
"2021","Rochford 005D","E01021960",782,136,97,39,600,159,341,80,163,98,55,26,25,4,42,20,22,3,3,46,15,31
"2021","Rochford 005E","E01021961",658,174,123,51,464,101,222,75,98,49,76,36,34,6,61,35,26,4,4,20,7,13
"2021","Rochford 006A","E01021920",827,161,67,94,613,85,327,93,159,75,111,54,50,7,88,59,29,2,2,53,22,31
"2021","Rochford 006B","E01021926",869,247,99,148,595,64,310,89,170,51,132,65,56,11,82,55,27,7,7,27,10,17
"2021","Rochford 006C","E01021957",739,242,106,136,469,54,213,66,104,43,97,43,45,9,100,68,32,5,5,28,13,15
"2021","Rochford 006D","E01021958",517,136,52,84,366,49,185,64,95,26,92,56,36,0,40,29,11,0,0,15,5,10
"2021","Rochford 006E","E01021959",631,136,79,57,473,55,257,64,136,57,92,46,40,6,63,27,36,6,6,22,13,9
"2021","Rochford 007A","E01021930",666,314,88,226,328,38,169,59,80,30,74,48,23,3,44,22,22,3,3,24,12,12
"2021","Rochford 007B","E01021932",652,165,93,72,455,81,208,73,94,41,84,44,37,3,78,44,34,4,4,32,17,15
"2021","Rochford 007C","E01021952",637,184,101,83,432,77,231,84,102,45,68,38,25,5,56,24,32,0,0,21,7,14
"2021","Rochford 007D","E01021954",1144,310,133,177,770,68,361,104,189,68,219,118,90,11,119,87,32,3,3,64,29,35
"2021","Rochford 007E","E01021956",640,208,116,92,385,60,163,64,65,34,84,31,47,6,76,45,31,2,2,47,17,30
"2021","Rochford 008A","E01021950",592,147,95,52,426,85,225,71,101,53,56,23,28,5,59,35,24,1,1,19,8,11
"2021","Rochford 008B","E01021951",516,120,84,36,375,78,211,66,98,47,34,17,16,1,51,30,21,1,1,21,6,15
"2021","Rochford 008C","E01021962",541,181,110,71,343,63,133,48,60,25,57,30,26,1,86,59,27,4,4,17,7,10
"2021","Rochford 008D","E01021963",525,98,64,34,400,91,224,65,117,42,49,21,25,3,34,19,15,2,2,27,11,16
"2021","Rochford 008E","E01021964",686,204,116,88,453,86,253,83,119,51,68,31,29,8,46,23,23,0,0,29,11,18
"2021","Rochford 008F","E01021966",825,318,200,118,484,112,208,60,97,51,85,43,34,8,76,46,30,3,3,23,12,11
"2021","Rochford 009A","E01021946",573,101,65,36,435,109,245,73,109,63,41,17,18,6,36,20,16,4,4,37,14,23
"2021","Rochford 009B","E01021947",520,121,87,34,383,100,190,63,73,54,39,13,23,3,52,35,17,2,2,16,3,13
"2021","Rochford 009C","E01021948",522,112,68,44,397,74,195,58,94,43,64,28,31,5,64,43,21,0,0,13,5,8
"2021","Rochford 009D","E01021949",586,137,106,31,423,96,241,67,125,49,42,16,22,4,42,18,24,2,2,26,15,11
"2021","Rochford 009E","E01021965",982,240,166,74,709,168,376,116,168,92,94,50,38,6,66,34,32,5,5,33,17,16
"2021","Rochford 010A","E01021917",710,169,86,83,502,93,249,103,91,55,86,43,32,11,72,42,30,2,2,39,16,23
"2021","Rochford 010B","E01021921",603,160,81,79,416,65,205,79,81,45,78,39,35,4,66,34,32,2,2,27,14,13
"2021","Rochford 010C","E01021922",695,236,159,77,426,76,203,73,83,47,74,32,34,8,68,37,31,5,5,33,11,22
"2021","Rochford 010D","E01021923",530,128,76,52,376,71,192,68,87,37,63,23,34,6,50,26,24,0,0,26,11,15
"2021","Rochford 010E","E01021924",714,134,65,69,547,78,253,73,132,48,130,57,65,8,81,49,32,5,5,33,14,19
"2021","Rochford 011B","E01021938",655,181,124,57,440,124,212,67,98,47,60,34,20,6,44,18,26,0,0,34,18,16
"2021","Rochford 011D","E01021939",681,140,107,33,514,102,295,106,123,66,66,31,29,6,50,29,21,1,1,27,15,12
"2021","Rochford 011A","E01021940",785,149,105,44,605,126,359,110,169,80,75,35,30,10,42,19,23,3,3,31,17,14
"2021","Rochford 011C","E01021941",865,156,100,56,668,125,394,97,189,108,96,45,48,3,52,33,19,1,1,41,22,19
"2021","Rochford 012E","E01021933",717,112,60,52,568,110,286,61,164,61,95,39,45,11,74,46,28,3,3,37,17,20
"2021","Rochford 012D","E01021934",560,135,98,37,404,69,234,79,86,69,53,22,23,8,45,14,31,3,3,21,12,9
"2021","Rochford 012C","E01021935",537,118,82,36,393,85,229,83,98,48,47,24,14,9,32,11,21,0,0,26,11,15
"2021","Rochford 012B","E01021936",793,320,201,119,454,95,239,77,96,66,64,29,27,8,53,34,19,3,3,19,9,10
"2021","Rochford 012A","E01021937",684,199,94,105,460,81,233,70,107,56,90,50,36,4,54,33,21,2,2,25,8,17
"2021","Tendring 001A","E01021997",677,310,105,205,341,27,124,61,36,27,76,32,35,9,109,71,38,5,5,26,8,18
"2021","Tendring 001B","E01021998",683,286,92,194,359,56,148,66,44,38,63,33,26,4,91,59,32,1,1,38,20,18
"2021","Tendring 001C","E01021999",740,236,125,111,472,92,197,70,84,43,75,34,37,4,99,66,33,9,9,32,18,14
"2021","Tendring 001D","E01022001",957,465,150,315,443,63,142,53,59,30,105,54,49,2,127,95,32,6,6,49,14,35
"2021","Tendring 002A","E01022000",688,179,95,84,477,92,201,79,81,41,105,50,50,5,78,50,28,1,1,32,18,14
"2021","Tendring 002C","E01022006",855,377,190,187,453,73,176,56,77,43,88,39,46,3,116,87,29,0,0,25,11,14
"2021","Tendring 002D","E01022007",705,156,79,77,506,65,218,69,98,51,111,41,63,7,107,76,31,5,5,43,26,17
"2021","Tendring 002F","E01033051",1149,394,211,183,708,117,263,107,99,57,140,58,74,8,181,135,46,7,7,47,26,21
"2021","Tendring 003A","E01021978",983,207,140,67,712,169,364,152,149,63,118,67,41,10,58,30,28,3,3,64,28,36
"2021","Tendring 003B","E01022013",819,218,120,98,567,107,303,106,137,60,108,68,39,1,49,31,18,0,0,34,18,16
"2021","Tendring 003C","E01022014",643,177,96,81,442,73,201,68,102,31,97,46,44,7,68,35,33,3,3,24,12,12
"2021","Tendring 003D","E01022015",613,182,75,107,415,50,205,65,100,40,91,58,30,3,67,43,24,2,2,16,3,13
"2021","Tendring 003E","E01022019",643,148,70,78,447,85,255,109,98,48,65,37,24,4,39,19,20,3,3,48,13,35
"2021","Tendring 003F","E01022020",939,480,208,272,441,97,200,93,78,29,97,68,24,5,45,27,18,2,2,18,9,9
"2021","Tendring 003G","E01022021",685,235,119,116,427,59,183,74,78,31,112,59,44,9,69,40,29,4,4,23,9,14
"2021","Tendring 004A","E01021991",442,120,78,42,307,67,184,70,77,37,40,17,19,4,16,5,11,0,0,15,6,9
"2021","Tendring 004B","E01021992",482,119,61,58,333,68,184,75,70,39,46,21,20,5,34,24,10,1,1,30,15,15
"2021","Tendring 004C","E01022002",801,198,128,70,566,123,276,110,114,52,100,38,56,6,64,33,31,3,3,37,19,18
"2021","Tendring 004D","E01022004",827,274,164,110,521,162,225,113,72,40,64,31,26,7,68,35,33,2,2,32,14,18
"2021","Tendring 004E","E01022005",776,194,118,76,550,150,268,115,110,43,77,27,43,7,55,30,25,0,0,32,12,20
"2021","Tendring 004F","E01022028",570,136,80,56,395,70,203,90,66,47,68,28,32,8,52,31,21,2,2,39,20,19
"2021","Tendring 005A","E01021971",640,125,43,82,479,72,277,87,130,60,89,52,36,1,39,20,19,2,2,36,20,16
"2021","Tendring 005B","E01021972",544,107,55,52,410,72,226,79,103,44,65,37,24,4,42,17,25,5,5,27,12,15
"2021","Tendring 005C","E01022051",609,128,76,52,439,81,251,100,98,53,60,35,17,8,43,21,22,4,4,42,13,29
"2021","Tendring 005D","E01022052",653,177,111,66,451,86,251,87,114,50,59,38,19,2,53,29,24,2,2,25,12,13
"2021","Tendring 006A","E01021985",715,269,154,115,424,173,162,96,43,23,43,23,16,4,44,26,18,2,2,22,9,13
"2021","Tendring 006B","E01021986",760,316,239,77,408,159,162,96,39,27,40,22,17,1,47,26,21,0,0,36,15,21
"2021","Tendring 006C","E01022054",698,220,133,87,450,118,181,88,51,42,74,38,32,4,75,46,29,2,2,28,11,17
"2021","Tendring 006D","E01022055",745,300,209,91,419,154,151,72,46,33,54,24,23,7,57,36,21,3,3,26,12,14
"2021","Tendring 006E","E01022056",842,370,167,203,420,67,156,75,57,24,96,46,44,6,97,63,34,4,4,52,19,33
"2021","Tendring 007A","E01021973",538,131,88,43,382,98,207,81,80,46,46,24,22,0,29,18,11,2,2,25,16,9
"2021","Tendring 007B","E01021974",548,147,57,90,370,69,177,62,85,30,70,34,28,8,50,31,19,4,4,31,15,16
"2021","Tendring 007C","E01022016",888,335,220,115,510,163,208,97,68,43,74,44,20,10,61,35,26,4,4,43,18,25
"2021","Tendring 007D","E01022017",707,159,102,57,504,113,261,112,98,51,73,46,21,6,55,33,22,2,2,44,18,26
"2021","Tendring 007E","E01022018",777,222,125,97,510,127,232,107,83,42,95,57,27,11,53,29,24,3,3,45,18,27
"2021","Tendring 008A","E01021987",638,218,161,57,401,148,158,82,43,33,53,28,23,2,42,29,13,0,0,19,8,11
"2021","Tendring 008B","E01021994",614,234,184,50,361,158,134,81,30,23,37,20,8,9,29,13,16,3,3,19,6,13
"2021","Tendring 008C","E01021995",630,194,152,42,411,147,163,69,54,40,47,20,21,6,50,22,28,4,4,25,9,16
"2021","Tendring 008D","E01021996",607,221,165,56,373,131,151,50,58,43,38,15,21,2,50,28,22,3,3,13,5,8
"2021","Tendring 008E","E01022009",694,192,126,66,471,153,202,100,63,39,73,34,33,6,40,23,17,3,3,31,15,16
"2021","Tendring 008F","E01022010",791,208,149,59,551,145,257,128,83,46,88,49,33,6,61,30,31,0,0,32,9,23
"2021","Tendring 008G","E01022011",775,200,133,67,528,140,252,107,87,58,75,37,30,8,59,40,19,2,2,47,22,25
"2021","Tendring 008H","E01022012",1030,415,314,101,580,230,211,107,64,40,64,40,19,5,71,45,26,4,4,35,8,27
"2021","Tendring 009A","E01021967",1044,240,152,88,763,183,345,129,145,71,149,67,74,8,83,39,44,3,3,41,18,23
"2021","Tendring 009B","E01021983",648,172,98,74,452,132,212,83,84,45,57,27,23,7,46,24,22,5,5,24,11,13
"2021","Tendring 009C","E01021993",1035,252,158,94,739,146,395,155,174,66,113,56,51,6,81,37,44,4,4,44,16,28
"2021","Tendring 009D","E01022053",804,174,96,78,573,144,304,143,118,43,76,36,36,4,49,26,23,0,0,57,28,29
"2021","Tendring 010A","E01021984",1040,326,225,101,652,219,268,143,65,60,98,54,33,11,63,18,45,4,4,62,19,43
"2021","Tendring 010B","E01022039",683,239,134,105,405,75,151,62,55,34,91,47,41,3,83,50,33,5,5,39,11,28
"2021","Tendring 010C","E01022040",858,273,193,80,549,197,199,99,52,48,69,30,30,9,81,32,49,3,3,36,13,23
"2021","Tendring 010D","E01022041",729,260,168,92,444,124,169,69,45,55,65,33,29,3,82,43,39,4,4,25,14,11
"2021","Tendring 011A","E01021979",642,184,110,74,426,99,211,70,93,48,59,27,27,5,54,28,26,3,3,32,20,12
"2021","Tendring 011B","E01021980",798,278,180,98,490,141,212,86,93,33,78,45,28,5,58,29,29,1,1,30,9,21
"2021","Tendring 011C","E01021981",901,320,189,131,544,126,247,86,117,44,103,52,43,8,67,44,23,1,1,37,14,23
"2021","Tendring 011D","E01021982",1007,416,146,270,550,78,228,92,106,30,120,66,46,8,122,93,29,2,2,41,13,28
"2021","Tendring 011E","E01022046",738,233,141,92,438,118,199,90,54,55,59,32,19,8,59,29,30,3,3,67,27,40
"2021","Tendring 012A","E01022008",1040,362,280,82,631,244,244,126,64,54,69,34,27,8,71,33,38,3,3,47,14,33
"2021","Tendring 012B","E01022033",750,242,184,58,485,184,192,112,37,43,48,25,20,3,61,23,38,0,0,23,2,21
"2021","Tendring 012C","E01022034",778,291,193,98,453,172,157,77,42,38,65,38,21,6,57,23,34,2,2,34,16,18
"2021","Tendring 012D","E01022035",724,250,198,52,436,177,161,81,36,44,47,27,17,3,50,19,31,1,1,38,15,23
"2021","Tendring 013A","E01021975",674,200,102,98,433,96,158,61,58,39,96,41,47,8,82,46,36,1,1,41,18,23
"2021","Tendring 013B","E01021976",666,203,124,79,428,95,197,68,71,58,85,49,31,5,51,27,24,0,0,35,20,15
"2021","Tendring 013C","E01021977",1167,311,179,132,791,170,308,113,122,73,153,57,86,10,156,107,49,4,4,65,28,37
"2021","Tendring 013D","E01022022",610,176,94,82,391,71,170,52,82,36,64,28,29,7,84,43,41,2,2,43,20,23
"2021","Tendring 013E","E01022044",731,230,144,86,465,122,201,78,64,59,66,28,25,13,71,31,40,5,5,36,17,19
"2021","Tendring 014A","E01022042",738,317,203,114,391,73,129,47,50,32,71,32,33,6,110,71,39,8,8,30,17,13
"2021","Tendring 014B","E01022043",775,242,84,158,471,40,185,70,77,38,106,44,48,14,136,101,35,4,4,62,23,39
"2021","Tendring 014C","E01022048",705,279,169,110,388,121,166,75,51,40,52,28,19,5,46,25,21,3,3,38,11,27
"2021","Tendring 014D","E01022049",638,192,102,90,400,93,170,74,59,37,52,22,25,5,82,48,34,3,3,46,18,28
"2021","Tendring 014E","E01022050",942,379,263,116,537,181,199,107,56,36,88,49,35,4,69,43,26,0,0,26,10,16
"2021","Tendring 015A","E01022023",642,202,102,100,404,53,154,63,53,38,96,48,40,8,97,64,33,4,4,36,15,21
"2021","Tendring 015B","E01022024",635,201,125,76,405,75,181,66,72,43,76,25,45,6,68,44,24,5,5,29,15,14
"2021","Tendring 015C","E01022030",778,336,169,167,402,109,137,70,40,27,62,21,37,4,88,52,36,6,6,40,16,24
"2021","Tendring 015D","E01022031",590,232,61,171,327,27,84,26,38,20,74,17,49,8,139,102,37,3,3,31,17,14
"2021","Tendring 015E","E01022032",752,207,138,69,501,82,186,70,67,49,86,24,49,13,135,80,55,12,12,44,19,25
"2021","Tendring 016A","E01021970",918,454,249,205,431,47,128,44,57,27,108,32,68,8,138,94,44,10,10,33,15,18
"2021","Tendring 016B","E01022025",997,603,191,412,334,44,76,32,34,10,95,56,36,3,110,80,30,9,9,60,23,37
"2021","Tendring 016C","E01022026",705,306,78,228,344,27,96,31,47,18,91,36,50,5,124,83,41,6,6,55,24,31
"2021","Tendring 016D","E01022027",861,431,182,249,385,56,130,57,44,29,81,44,31,6,113,73,40,5,5,45,16,29
"2021","Tendring 017A","E01021968",806,275,90,185,484,42,170,47,84,39,105,32,60,13,158,99,59,9,9,47,27,20
"2021","Tendring 017B","E01021969",599,182,97,85,386,44,165,52,76,37,77,28,37,12,96,65,31,4,4,31,14,17
"2021","Tendring 017C","E01022036",581,207,121,86,348,93,131,63,33,35,60,33,22,5,61,40,21,3,3,26,12,14
"2021","Tendring 017D","E01022037",647,279,175,104,334,111,117,55,27,35,46,30,14,2,58,31,27,2,2,34,15,19
"2021","Tendring 017E","E01022038",629,194,126,68,404,86,169,71,56,42,61,30,26,5,84,44,40,4,4,31,14,17
"2021","Tendring 018A","E01021988",1182,690,293,397,442,73,131,78,32,21,88,48,31,9,140,84,56,10,10,50,9,41
"2021","Tendring 018B","E01021989",785,319,224,95,428,177,142,88,21,33,52,29,17,6,55,26,29,2,2,38,11,27
"2021","Tendring 018C","E01021990",845,349,217,132,442,119,159,92,31,36,64,32,27,5,96,49,47,4,4,54,18,36
"2021","Tendring 018D","E01022045",828,340,174,166,447,104,188,84,61,43,73,31,32,10,76,39,37,6,6,41,19,22
"2021","Tendring 018E","E01022047",675,239,159,80,398,114,194,93,55,46,47,22,23,2,40,28,12,3,3,38,19,19
"2021","Uttlesford 001A","E01022057",710,142,77,65,533,120,308,126,134,48,62,33,24,5,39,18,21,4,4,35,16,19
"2021","Uttlesford 001B","E01022075",737,181,119,62,533,101,306,105,159,42,64,43,19,2,60,39,21,2,2,23,15,8
"2021","Uttlesford 001C","E01022077",836,201,100,101,585,84,316,95,165,56,102,60,36,6,82,53,29,1,1,50,17,33
"2021","Uttlesford 001D","E01022094",814,199,103,96,587,94,319,88,189,42,109,68,34,7,65,38,27,0,0,28,14,14
"2021","Uttlesford 002A","E01022074",594,141,73,68,428,51,219,67,113,39,80,37,37,6,77,48,29,1,1,25,10,15
"2021","Uttlesford 002B","E01022076",952,518,278,240,412,89,190,75,83,32,76,52,22,2,54,31,23,3,3,22,3,19
"2021","Uttlesford 002C","E01022078",637,202,94,108,400,53,197,57,100,40,69,27,34,8,78,47,31,3,3,35,12,23
"2021","Uttlesford 002D","E01022079",947,315,152,163,598,99,321,91,189,41,110,73,34,3,67,33,34,1,1,34,10,24
"2021","Uttlesford 002E","E01022080",626,188,61,127,421,32,243,83,119,41,85,51,34,0,59,38,21,2,2,17,4,13
"2021","Uttlesford 002F","E01022081",1125,393,229,164,695,97,375,114,207,54,114,58,49,7,106,73,33,3,3,37,10,27
"2021","Uttlesford 002G","E01022082",930,246,141,105,649,98,341,100,194,47,110,53,55,2,98,63,35,2,2,35,13,22
"2021","Uttlesford 003A","E01022061",649,127,81,46,493,117,293,115,119,59,42,25,15,2,41,22,19,0,0,29,9,20
"2021","Uttlesford 003B","E01022071",692,155,87,68,511,95,294,110,131,53,82,37,40,5,39,19,20,1,1,26,7,19
"2021","Uttlesford 003C","E01022072",837,192,106,86,610,95,384,134,196,54,76,44,21,11,52,30,22,3,3,35,15,20
"2021","Uttlesford 003D","E01022073",864,218,129,89,615,115,288,101,130,57,108,49,55,4,101,60,41,3,3,31,14,17
"2021","Uttlesford 003E","E01022098",628,116,68,48,491,106,283,101,128,54,67,38,26,3,34,17,17,1,1,21,5,16
"2021","Uttlesford 004A","E01022092",764,188,96,92,531,115,278,87,119,72,92,50,32,10,43,26,17,3,3,45,17,28
"2021","Uttlesford 004B","E01022093",909,240,146,94,631,105,317,100,162,55,110,55,46,9,96,58,38,3,3,38,19,19
"2021","Uttlesford 004C","E01022097",776,155,89,66,582,105,356,142,157,57,76,42,25,9,44,22,22,1,1,39,17,22
"2021","Uttlesford 004D","E01022099",841,142,71,71,662,107,420,135,231,54,83,56,23,4,50,25,25,2,2,37,13,24
"2021","Uttlesford 005A","E01022062",978,191,91,100,723,128,421,152,194,75,103,51,45,7,68,42,26,3,3,64,25,39
"2021","Uttlesford 005B","E01022063",992,233,110,123,707,78,364,111,201,52,150,81,62,7,107,71,36,8,8,52,21,31
"2021","Uttlesford 005C","E01022083",748,217,119,98,499,96,286,100,131,55,77,44,30,3,37,22,15,3,3,32,9,23
"2021","Uttlesford 005D","E01022084",792,165,98,67,590,114,329,96,181,52,89,39,48,2,58,36,22,0,0,37,10,27
"2021","Uttlesford 005E","E01022085",737,223,65,158,475,45,235,77,129,29,122,74,40,8,67,44,23,6,6,39,15,24
"2021","Uttlesford 005F","E01022087",1067,219,82,137,794,80,427,120,246,61,157,92,56,9,124,74,50,6,6,54,16,38
"2021","Uttlesford 005G","E01022089",635,120,65,55,489,101,270,92,136,42,68,42,25,1,50,23,27,0,0,26,8,18
"2021","Uttlesford 006A","E01022086",663,146,50,96,466,46,239,60,131,48,81,35,42,4,94,59,35,6,6,51,20,31
"2021","Uttlesford 006D","E01022095",671,145,93,52,483,101,268,98,113,57,77,37,29,11,36,17,19,1,1,43,19,24
"2021","Uttlesford 006E","E01035178",707,146,73,73,505,46,282,82,145,55,95,39,50,6,79,58,21,3,3,56,20,36
"2021","Uttlesford 006F","E01035179",457,59,17,42,370,20,231,41,149,41,69,30,34,5,50,38,12,0,0,28,15,13
"2021","Uttlesford 006G","E01035180",458,101,37,64,324,37,158,44,88,26,78,31,42,5,48,33,15,3,3,33,12,21
"2021","Uttlesford 006H","E01035181",498,98,34,64,375,34,207,60,120,27,92,33,55,4,40,27,13,2,2,25,15,10
"2021","Uttlesford 006I","E01035182",552,150,79,71,380,100,181,62,79,40,51,27,21,3,48,34,14,0,0,22,10,12
"2021","Uttlesford 007B","E01022067",1034,505,208,297,495,69,206,75,98,33,131,102,26,3,86,48,38,3,3,34,5,29
"2021","Uttlesford 007C","E01022068",789,165,80,85,583,89,301,100,143,58,104,48,47,9,88,65,23,1,1,41,17,24
"2021","Uttlesford 007D","E01033054",530,178,74,104,343,39,172,47,92,33,59,23,32,4,72,45,27,1,1,9,6,3
"2021","Uttlesford 007E","E01033055",861,149,72,77,677,88,405,127,195,83,110,37,64,9,71,43,28,3,3,35,14,21
"2021","Uttlesford 007F","E01033056",641,146,80,66,471,77,236,75,114,47,79,33,37,9,76,49,27,3,3,24,9,15
"2021","Uttlesford 008A","E01022058",653,130,73,57,503,97,305,99,128,78,53,28,22,3,44,16,28,4,4,20,6,14
"2021","Uttlesford 008B","E01022064",772,164,91,73,556,132,319,134,120,65,59,26,29,4,43,22,21,3,3,52,16,36
"2021","Uttlesford 008D","E01022069",723,238,143,95,461,115,220,84,96,40,64,42,20,2,57,32,25,5,5,24,8,16
"2021","Uttlesford 008E","E01022088",683,119,65,54,536,120,272,105,119,48,81,38,36,7,59,31,28,4,4,28,15,13
"2021","Uttlesford 008F","E01033052",668,177,99,78,459,74,264,74,136,54,63,21,35,7,57,39,18,1,1,32,21,11
"2021","Uttlesford 008G","E01033053",762,113,24,89,615,20,336,57,246,33,135,54,77,4,121,85,36,3,3,34,24,10
"2021","Uttlesford 009A","E01022059",662,189,102,87,426,74,243,67,119,57,57,33,21,3,50,25,25,2,2,47,18,29
"2021","Uttlesford 009B","E01022060",754,140,77,63,564,89,348,99,168,81,72,31,35,6,52,29,23,3,3,50,27,23
"2021","Uttlesford 009C","E01022070",765,160,104,56,560,126,311,79,169,63,63,28,29,6,60,34,26,0,0,45,18,27
"2021","Uttlesford 009D","E01022096",851,187,87,100,622,91,349,147,143,59,99,58,35,6,81,50,31,2,2,42,17,25
"2021","Broxbourne 001A","E01023316",517,93,74,19,396,95,224,50,109,65,47,15,23,9,30,15,15,0,0,28,12,16
"2021","Broxbourne 001B","E01023317",940,177,91,86,706,90,361,70,203,88,107,43,56,8,141,96,45,7,7,57,30,27
"2021","Broxbourne 001C","E01023318",609,110,76,34,468,90,237,54,121,62,73,32,35,6,65,39,26,3,3,31,12,19
"2021","Broxbourne 001D","E01023319",629,132,87,45,468,136,217,60,101,56,60,25,28,7,53,21,32,2,2,29,15,14
"2021","Broxbourne 002A","E01023327",517,120,66,54,353,40,178,37,95,46,62,26,29,7,73,41,32,0,0,44,21,23
"2021","Broxbourne 002B","E01023328",516,112,49,63,367,25,191,46,98,47,67,32,30,5,80,48,32,4,4,37,15,22
"2021","Broxbourne 002C","E01023329",511,110,66,44,365,56,195,54,94,47,41,22,16,3,69,27,42,4,4,36,18,18
"2021","Broxbourne 002D","E01023330",705,203,65,138,463,25,196,61,98,37,114,54,54,6,123,77,46,5,5,39,18,21
"2021","Broxbourne 002E","E01023331",633,150,71,79,440,47,219,49,118,52,69,22,41,6,99,49,50,6,6,43,22,21
"2021","Broxbourne 003A","E01023320",1094,457,206,251,565,68,202,62,109,31,151,93,51,7,135,88,47,9,9,72,25,47
"2021","Broxbourne 003B","E01023321",898,283,181,102,587,131,315,99,142,74,87,49,30,8,51,28,23,3,3,28,12,16
"2021","Broxbourne 003C","E01023322",808,245,77,168,516,46,245,66,128,51,107,52,48,7,109,78,31,9,9,47,14,33
"2021","Broxbourne 003D","E01023323",837,386,115,271,411,45,155,54,79,22,99,53,39,7,107,79,28,5,5,40,17,23
"2021","Broxbourne 004A","E01023289",527,61,48,13,426,74,291,69,145,77,28,11,11,6,29,16,13,4,4,40,24,16
"2021","Broxbourne 004B","E01023290",624,126,90,36,465,105,277,59,140,78,39,15,21,3,39,19,20,5,5,33,13,20
"2021","Broxbourne 004C","E01023291",659,183,97,86,441,92,232,72,108,52,74,38,30,6,37,18,19,6,6,35,12,23
"2021","Broxbourne 004D","E01023292",650,179,116,63,441,89,236,59,117,60,45,21,19,5,70,39,31,1,1,30,14,16
"2021","Broxbourne 005A","E01023340",746,206,71,135,511,59,221,53,120,48,94,48,38,8,132,99,33,5,5,29,16,13
"2021","Broxbourne 005B","E01023341",715,174,93,81,504,85,260,73,126,61,69,23,41,5,89,45,44,1,1,37,22,15
"2021","Broxbourne 005D","E01023343",823,212,74,138,548,24,221,55,127,39,95,37,50,8,204,146,58,4,4,63,39,24
"2021","Broxbourne 005E","E01023344",749,249,120,129,471,72,227,79,101,47,84,44,36,4,83,45,38,5,5,29,11,18
"2021","Broxbourne 005F","E01035583",541,134,33,101,384,41,149,31,90,28,52,20,31,1,139,105,34,3,3,23,13,10
"2021","Broxbourne 005G","E01035584",673,207,72,135,440,32,161,40,92,29,108,58,41,9,131,100,31,8,8,26,14,12
"2021","Broxbourne 006A","E01023307",539,98,47,51,398,59,241,59,114,68,43,12,25,6,54,19,35,1,1,43,23,20
"2021","Broxbourne 006B","E01023308",624,125,84,41,464,92,269,65,131,73,54,16,30,8,47,23,24,2,2,35,21,14
"2021","Broxbourne 006C","E01023309",615,113,72,41,457,94,269,63,130,76,49,15,27,7,43,19,24,2,2,45,22,23
"2021","Broxbourne 006D","E01023310",1153,322,100,222,763,50,282,60,160,62,168,68,83,17,247,166,81,16,16,68,38,30
"2021","Broxbourne 007A","E01023311",735,163,92,71,537,114,282,74,142,66,67,30,28,9,68,33,35,6,6,35,15,20
"2021","Broxbourne 007B","E01023312",590,119,50,69,425,59,262,89,93,80,51,23,22,6,52,25,27,1,1,46,22,24
"2021","Broxbourne 007C","E01023313",632,151,111,40,447,110,269,64,121,84,35,10,18,7,32,17,15,1,1,34,16,18
"2021","Broxbourne 007D","E01023315",620,89,26,63,494,41,317,62,166,89,61,25,23,13,74,33,41,1,1,37,23,14
"2021","Broxbourne 008A","E01023302",640,221,115,106,384,57,159,50,72,37,52,24,23,5,107,66,41,9,9,35,22,13
"2021","Broxbourne 008B","E01023303",643,189,65,124,401,50,191,58,84,49,69,24,37,8,87,53,34,4,4,53,26,27
"2021","Broxbourne 008C","E01023304",643,195,98,97,408,55,196,52,101,43,56,26,26,4,96,55,41,5,5,40,19,21
"2021","Broxbourne 008D","E01023305",523,127,60,67,358,33,198,49,93,56,61,21,33,7,64,33,31,2,2,38,26,12
"2021","Broxbourne 008E","E01023306",602,159,70,89,413,65,211,50,96,65,70,33,29,8,65,31,34,2,2,30,14,16
"2021","Broxbourne 009A","E01023314",601,130,59,71,426,53,225,56,125,44,59,27,26,6,85,34,51,4,4,45,25,20
"2021","Broxbourne 009B","E01023324",520,131,60,71,363,59,153,36,77,40,71,16,47,8,77,41,36,3,3,26,15,11
"2021","Broxbourne 009C","E01023325",639,231,104,127,384,39,184,56,85,43,63,28,31,4,94,61,33,4,4,24,17,7
"2021","Broxbourne 009D","E01023326",672,234,108,126,408,51,189,45,104,40,59,14,32,13,104,65,39,5,5,30,20,10
"2021","Broxbourne 010A","E01023297",508,102,64,38,371,55,206,47,94,65,62,32,27,3,47,22,25,1,1,35,17,18
"2021","Broxbourne 010B","E01023298",641,178,118,60,427,77,217,64,99,54,51,20,24,7,77,41,36,5,5,36,21,15
"2021","Broxbourne 010C","E01023299",703,179,81,98,479,76,229,66,103,60,62,35,23,4,101,59,42,11,11,45,27,18
"2021","Broxbourne 010D","E01023300",678,242,110,132,385,26,149,44,87,18,70,29,37,4,125,84,41,15,15,51,28,23
"2021","Broxbourne 010E","E01023301",778,247,70,177,484,37,200,58,98,44,103,46,45,12,129,91,38,15,15,47,20,27
"2021","Broxbourne 011A","E01023293",667,155,83,72,471,70,247,57,130,60,68,31,33,4,83,51,32,3,3,41,21,20
"2021","Broxbourne 011B","E01023294",829,297,123,174,492,52,210,52,122,36,94,50,40,4,133,89,44,3,3,40,23,17
"2021","Broxbourne 011C","E01023295",562,158,75,83,366,50,188,45,98,45,48,23,20,5,77,32,45,3,3,38,24,14
"2021","Broxbourne 011D","E01023296",723,169,101,68,515,54,254,48,134,72,74,23,39,12,131,84,47,2,2,39,25,14
"2021","Broxbourne 012A","E01023332",1018,322,180,142,631,75,294,86,148,60,104,55,43,6,146,90,56,12,12,65,36,29
"2021","Broxbourne 012B","E01023333",866,247,75,172,538,43,216,55,102,59,107,59,39,9,162,97,65,10,10,81,47,34
"2021","Broxbourne 012C","E01023334",722,218,133,85,452,84,231,56,115,60,77,33,39,5,53,25,28,7,7,52,26,26
"2021","Broxbourne 012D","E01023335",668,148,95,53,456,68,237,63,105,69,71,24,37,10,72,41,31,8,8,64,40,24
"2021","Broxbourne 013A","E01023336",829,228,64,164,504,26,223,59,109,55,91,42,41,8,155,105,50,9,9,97,40,57
"2021","Broxbourne 013B","E01023337",808,253,74,179,473,44,222,54,115,53,58,30,25,3,131,79,52,18,18,82,47,35
"2021","Broxbourne 013D","E01023339",610,182,96,86,364,22,170,35,87,48,51,22,26,3,113,66,47,8,8,64,32,32
"2021","Broxbourne 013E","E01035585",701,283,80,203,378,14,126,51,60,15,99,56,38,5,132,112,20,7,7,40,22,18
"2021","Broxbourne 013F","E01035586",616,256,88,168,323,23,125,35,66,24,69,36,29,4,93,70,23,13,13,37,12,25
"2021","Dacorum 001A","E01023430",493,115,59,56,356,56,225,69,118,38,35,18,15,2,40,17,23,0,0,22,10,12
"2021","Dacorum 001B","E01023431",513,102,42,60,386,71,218,82,94,42,56,26,25,5,40,19,21,1,1,25,10,15
"2021","Dacorum 001C","E01023432",667,157,70,87,483,76,251,65,142,44,92,50,37,5,60,34,26,4,4,27,12,15
"2021","Dacorum 001D","E01023433",694,244,73,171,436,28,195,71,92,32,124,65,54,5,86,59,27,3,3,14,6,8
"2021","Dacorum 002A","E01023423",578,143,91,52,409,65,238,77,127,34,60,25,30,5,45,20,25,1,1,26,10,16
"2021","Dacorum 002B","E01023424",628,134,67,67,464,72,273,106,126,41,62,32,25,5,54,35,19,3,3,30,8,22
"2021","Dacorum 002C","E01023425",540,115,63,52,408,84,238,56,127,55,54,25,27,2,30,22,8,2,2,17,6,11
"2021","Dacorum 002D","E01023426",778,366,150,216,393,60,167,56,91,20,95,75,19,1,64,45,19,7,7,19,0,19
"2021","Dacorum 003A","E01023418",615,216,107,109,376,41,177,43,95,39,66,31,29,6,88,57,31,4,4,23,10,13
"2021","Dacorum 003B","E01023419",829,222,98,124,578,63,321,100,174,47,109,57,47,5,82,53,29,3,3,29,19,10
"2021","Dacorum 003C","E01023420",631,167,86,81,442,97,240,63,134,43,57,24,30,3,46,20,26,2,2,22,6,16
"2021","Dacorum 004A","E01023352",1017,291,160,131,690,132,381,135,182,64,104,57,38,9,71,41,30,2,2,36,11,25
"2021","Dacorum 004B","E01023421",705,231,106,125,457,71,244,71,137,36,78,49,25,4,62,37,25,2,2,17,5,12
"2021","Dacorum 004C","E01023422",515,105,73,32,392,94,251,82,125,44,25,14,9,2,22,8,14,0,0,18,9,9
"2021","Dacorum 005A","E01023434",677,165,57,108,478,46,237,72,132,33,79,40,34,5,103,68,35,13,13,34,19,15
"2021","Dacorum 005B","E01023435",650,213,45,168,404,26,188,59,103,26,99,62,31,6,85,56,29,6,6,33,19,14
"2021","Dacorum 005C","E01023436",475,93,47,46,351,52,211,67,99,45,44,20,20,4,42,23,19,2,2,31,12,19
"2021","Dacorum 005D","E01023437",626,207,50,157,399,15,141,47,69,25,86,34,48,4,153,112,41,4,4,20,8,12
"2021","Dacorum 006A","E01023355",632,148,104,44,451,105,262,84,127,51,40,20,17,3,44,26,18,0,0,33,13,20
"2021","Dacorum 006B","E01023356",446,102,62,40,325,80,181,54,87,40,29,14,14,1,32,21,11,3,3,19,7,12
"2021","Dacorum 006C","E01023416",652,185,117,68,446,110,254,96,113,45,45,29,14,2,36,17,19,1,1,21,7,14
"2021","Dacorum 006D","E01023417",661,279,179,100,371,63,199,63,108,28,67,37,23,7,40,27,13,2,2,11,4,7
"2021","Dacorum 007A","E01023393",822,390,150,240,391,32,191,67,85,39,77,34,37,6,84,59,25,7,7,41,16,25
"2021","Dacorum 007B","E01023394",518,97,54,43,365,52,183,53,89,41,62,23,29,10,67,34,33,1,1,56,29,27
"2021","Dacorum 007C","E01023395",640,180,65,115,402,52,193,59,99,35,71,36,28,7,82,51,31,4,4,58,29,29
"2021","Dacorum 007D","E01023396",592,119,59,60,409,70,189,67,81,41,63,31,28,4,85,58,27,2,2,64,22,42
"2021","Dacorum 007E","E01023397",525,126,58,68,365,25,166,49,82,35,56,16,32,8,114,69,45,4,4,34,20,14
"2021","Dacorum 008A","E01023401",713,205,54,151,471,33,197,60,103,34,95,54,36,5,140,89,51,6,6,37,17,20
"2021","Dacorum 008B","E01023402",671,173,86,87,427,50,196,58,108,30,80,33,42,5,97,59,38,4,4,71,31,40
"2021","Dacorum 008C","E01023403",651,229,112,117,376,41,154,45,80,29,76,38,34,4,93,61,32,12,12,46,15,31
"2021","Dacorum 008D","E01023404",509,155,57,98,313,10,130,35,75,20,66,26,35,5,106,72,34,1,1,41,23,18
"2021","Dacorum 008E","E01023405",622,192,86,106,380,31,159,50,79,30,75,31,33,11,108,73,35,7,7,50,25,25
"2021","Dacorum 009A","E01023361",910,419,158,261,461,60,218,94,106,18,133,108,24,1,46,33,13,4,4,30,3,27
"2021","Dacorum 009B","E01023362",833,257,164,93,548,145,300,99,163,38,67,47,16,4,34,19,15,2,2,28,10,18
"2021","Dacorum 009C","E01023363",644,169,74,95,464,55,286,83,162,41,80,47,27,6,42,23,19,1,1,11,8,3
"2021","Dacorum 009D","E01023364",508,103,71,32,396,84,249,58,141,50,41,17,24,0,22,11,11,0,0,9,7,2
"2021","Dacorum 010A","E01023390",849,234,95,139,565,43,271,58,145,68,108,54,52,2,141,89,52,2,2,50,20,30
"2021","Dacorum 010B","E01023391",687,153,75,78,498,45,273,87,117,69,87,31,44,12,87,62,25,6,6,36,14,22
"2021","Dacorum 010C","E01023399",878,394,132,262,449,55,189,73,94,22,125,86,32,7,71,45,26,9,9,35,3,32
"2021","Dacorum 011A","E01023392",635,160,66,94,445,37,213,59,98,56,71,29,33,9,120,77,43,4,4,30,15,15
"2021","Dacorum 011B","E01023427",702,156,73,83,499,39,216,61,100,55,101,46,46,9,141,92,49,2,2,47,18,29
"2021","Dacorum 011C","E01023428",615,148,55,93,433,54,233,81,101,51,92,57,28,7,51,25,26,3,3,34,12,22
"2021","Dacorum 011D","E01023429",793,280,161,119,466,60,223,59,119,45,84,28,46,10,94,57,37,5,5,47,19,28
"2021","Dacorum 012A","E01023369",649,206,114,92,414,44,191,45,116,30,75,33,37,5,104,67,37,0,0,29,13,16
"2021","Dacorum 012B","E01023370",754,272,115,157,465,50,254,62,162,30,84,52,29,3,77,50,27,0,0,17,5,12
"2021","Dacorum 012C","E01023371",626,75,44,31,535,71,335,71,201,63,56,20,35,1,73,41,32,0,0,16,7,9
"2021","Dacorum 012D","E01023372",542,70,45,25,453,106,298,57,193,48,19,12,6,1,30,17,13,0,0,19,7,12
"2021","Dacorum 013A","E01023345",830,217,61,156,561,42,276,98,127,51,120,74,43,3,116,79,37,7,7,52,22,30
"2021","Dacorum 013B","E01023346",1031,203,63,140,765,42,345,87,222,36,162,65,92,5,211,183,28,5,5,63,32,31
"2021","Dacorum 013C","E01023347",532,144,89,55,343,71,181,59,84,38,51,20,28,3,37,25,12,3,3,45,16,29
"2021","Dacorum 013D","E01023348",675,226,118,108,406,27,156,37,86,33,82,41,38,3,131,90,41,10,10,43,21,22
"2021","Dacorum 014A","E01023365",573,202,89,113,348,46,169,55,86,28,64,44,17,3,63,36,27,6,6,23,8,15
"2021","Dacorum 014B","E01023366",656,188,63,125,452,37,219,55,131,33,83,48,30,5,111,66,45,2,2,16,3,13
"2021","Dacorum 014C","E01023367",424,57,39,18,356,71,238,59,141,38,29,11,17,1,16,7,9,2,2,11,4,7
"2021","Dacorum 014D","E01023368",718,178,98,80,523,60,335,93,207,35,82,46,32,4,43,25,18,3,3,17,7,10
"2021","Dacorum 015A","E01023349",783,254,109,145,475,40,232,61,121,50,89,46,34,9,109,71,38,5,5,54,25,29
"2021","Dacorum 015B","E01023350",709,187,95,92,464,38,233,58,123,52,82,27,46,9,105,61,44,6,6,58,22,36
"2021","Dacorum 015C","E01023351",679,173,78,95,459,57,227,66,118,43,90,44,42,4,81,43,38,4,4,47,15,32
"2021","Dacorum 015E","E01023400",1020,494,165,329,471,49,203,78,101,24,113,74,34,5,97,69,28,9,9,55,17,38
"2021","Dacorum 015F","E01035562",656,231,56,175,381,33,196,57,115,24,84,45,36,3,60,44,16,8,8,44,16,28
"2021","Dacorum 015G","E01035563",584,164,18,146,369,18,164,57,93,14,93,48,44,1,89,75,14,5,5,51,19,32
"2021","Dacorum 015H","E01035564",596,227,21,206,346,14,163,61,83,19,114,89,22,3,50,30,20,5,5,23,7,16
"2021","Dacorum 016A","E01023383",607,159,70,89,424,50,211,63,100,48,82,40,34,8,79,51,28,2,2,24,14,10
"2021","Dacorum 016B","E01023384",772,184,82,102,553,43,245,57,134,54,137,60,63,14,123,64,59,5,5,35,17,18
"2021","Dacorum 016C","E01023385",665,193,119,74,447,78,241,73,103,65,60,34,24,2,63,34,29,5,5,25,11,14
"2021","Dacorum 017A","E01023409",780,221,86,135,505,65,260,63,143,54,69,31,33,5,106,69,37,5,5,54,19,35
"2021","Dacorum 017B","E01023410",539,106,81,25,407,129,214,74,73,67,34,14,16,4,29,11,18,1,1,26,13,13
"2021","Dacorum 017C","E01023411",587,108,55,53,435,47,206,53,111,42,76,29,41,6,105,68,37,1,1,44,25,19
"2021","Dacorum 017D","E01023412",494,79,63,16,399,118,215,63,94,58,32,15,10,7,32,11,21,2,2,16,10,6
"2021","Dacorum 017E","E01023413",530,128,60,68,366,50,189,63,91,35,53,25,24,4,72,44,28,2,2,36,25,11
"2021","Dacorum 018B","E01023354",956,197,72,125,701,52,402,116,233,53,167,103,57,7,76,44,32,4,4,58,26,32
"2021","Dacorum 018C","E01023379",701,186,99,87,491,73,263,84,136,43,91,54,29,8,62,38,24,2,2,24,6,18
"2021","Dacorum 018D","E01023380",508,140,62,78,349,42,178,57,93,28,70,46,24,0,55,31,24,4,4,19,9,10
"2021","Dacorum 018E","E01023381",541,103,62,41,424,91,264,75,130,59,39,23,13,3,28,20,8,2,2,14,7,7
"2021","Dacorum 018F","E01023382",686,249,126,123,412,44,215,50,122,43,80,40,32,8,69,44,25,4,4,25,10,15
"2021","Dacorum 018G","E01033022",686,258,39,219,389,27,135,43,78,14,126,89,36,1,90,71,19,11,11,39,6,33
"2021","Dacorum 018H","E01033023",1028,388,92,296,581,30,250,100,119,31,195,143,47,5,95,66,29,11,11,59,19,40
"2021","Dacorum 019A","E01023386",602,171,69,102,397,29,207,66,94,47,74,38,24,12,82,39,43,5,5,34,17,17
"2021","Dacorum 019B","E01023387",503,112,43,69,359,36,178,38,89,51,53,22,26,5,91,55,36,1,1,32,11,21
"2021","Dacorum 019C","E01023388",634,185,71,114,407,42,222,71,109,42,61,27,32,2,76,48,28,6,6,42,14,28
"2021","Dacorum 019D","E01023389",662,142,72,70,470,66,257,90,114,53,84,34,45,5,61,30,31,2,2,50,18,32
"2021","Dacorum 020A","E01023357",645,198,113,85,399,30,198,48,109,41,72,31,33,8,96,56,40,3,3,48,22,26
"2021","Dacorum 020B","E01023358",527,114,54,60,354,26,162,27,102,33,60,16,35,9,102,72,30,4,4,59,28,31
"2021","Dacorum 020C","E01023359",661,140,68,72,478,29,254,54,145,55,78,32,38,8,113,62,51,4,4,43,20,23
"2021","Dacorum 020D","E01023360",552,100,42,58,417,41,252,65,141,46,63,32,29,2,59,28,31,2,2,35,17,18
"2021","Dacorum 020E","E01023414",1032,330,84,246,647,22,311,93,175,43,204,133,62,9,104,64,40,6,6,55,7,48
"2021","Dacorum 020F","E01023415",535,111,70,41,388,70,201,50,110,41,57,28,23,6,59,26,33,1,1,36,13,23
"2021","Dacorum 021A","E01023373",528,186,108,78,322,63,155,46,76,33,48,24,14,10,56,28,28,0,0,20,9,11
"2021","Dacorum 021B","E01023374",616,168,97,71,422,66,221,87,102,32,76,51,25,0,56,34,22,3,3,26,15,11
"2021","Dacorum 021C","E01023375",647,179,110,69,435,84,251,85,126,40,50,23,22,5,50,30,20,0,0,33,13,20
"2021","Dacorum 021D","E01023376",518,144,62,82,353,65,171,40,96,35,54,22,29,3,60,36,24,3,3,21,6,15
"2021","Dacorum 021E","E01023377",524,126,75,51,359,84,213,53,115,45,41,18,20,3,21,8,13,0,0,39,18,21
"2021","Dacorum 021F","E01023378",644,93,45,48,510,118,308,96,153,59,53,35,14,4,29,13,16,2,2,41,15,26
"2021","Dacorum 022A","E01023406",877,312,161,151,533,57,265,88,134,43,115,57,50,8,93,49,44,3,3,32,11,21
"2021","Dacorum 022B","E01023407",644,127,71,56,464,66,282,78,149,55,61,25,28,8,54,27,27,1,1,53,23,30
"2021","Dacorum 022C","E01023408",619,112,76,36,476,114,275,72,143,60,46,17,26,3,39,20,19,2,2,31,12,19
"2021","Hertsmere 001A","E01023576",597,160,107,53,392,107,205,77,72,56,46,24,17,5,31,9,22,3,3,45,10,35
"2021","Hertsmere 001B","E01023577",719,202,137,65,477,135,240,55,120,65,52,25,17,10,47,21,26,3,3,40,13,27
"2021","Hertsmere 001C","E01023578",724,210,154,56,470,116,282,80,136,66,38,28,10,0,31,11,20,3,3,44,16,28
"2021","Hertsmere 001D","E01023579",635,232,119,113,343,23,173,46,90,37,70,44,19,7,69,49,20,8,8,60,14,46
"2021","Hertsmere 001E","E01023580",700,191,103,88,459,69,237,79,111,47,62,32,25,5,87,50,37,4,4,50,17,33
"2021","Hertsmere 002A","E01023567",745,137,93,44,559,80,351,76,197,78,60,24,29,7,67,36,31,1,1,49,27,22
"2021","Hertsmere 002B","E01023568",636,154,119,35,444,109,237,57,109,71,40,24,13,3,54,25,29,4,4,38,17,21
"2021","Hertsmere 002C","E01023569",609,113,69,44,458,64,262,52,167,43,39,12,23,4,93,57,36,0,0,38,21,17
"2021","Hertsmere 002D","E01023570",622,214,113,101,358,36,174,41,88,45,57,32,19,6,87,49,38,4,4,50,15,35
"2021","Hertsmere 003A","E01023571",608,160,109,51,410,80,216,58,111,47,46,23,20,3,61,25,36,7,7,38,18,20
"2021","Hertsmere 003B","E01023572",720,228,85,143,447,59,216,61,104,51,67,38,24,5,98,62,36,7,7,45,16,29
"2021","Hertsmere 003C","E01023573",540,163,79,84,324,24,147,34,76,37,44,20,16,8,103,58,45,6,6,53,19,34
"2021","Hertsmere 003D","E01023574",667,193,86,107,430,42,187,37,98,52,56,25,26,5,138,78,60,7,7,44,24,20
"2021","Hertsmere 003E","E01023575",655,204,95,109,396,46,215,54,106,55,44,22,17,5,86,42,44,5,5,55,27,28
"2021","Hertsmere 004A","E01023581",483,82,39,43,387,72,249,64,141,44,35,16,16,3,29,17,12,2,2,14,8,6
"2021","Hertsmere 004B","E01023582",614,123,48,75,461,52,244,58,136,50,55,26,24,5,108,70,38,2,2,30,10,20
"2021","Hertsmere 004C","E01023583",555,143,66,77,392,55,204,67,99,38,54,27,19,8,76,49,27,3,3,20,9,11
"2021","Hertsmere 004D","E01023584",448,139,61,78,275,38,154,52,77,25,30,17,13,0,49,30,19,4,4,34,9,25
"2021","Hertsmere 005A","E01023523",629,96,54,42,495,113,314,83,162,69,28,20,8,0,37,21,16,3,3,38,24,14
"2021","Hertsmere 005B","E01023524",519,77,54,23,412,92,278,58,141,79,16,6,7,3,25,11,14,1,1,30,16,14
"2021","Hertsmere 005C","E01023525",771,258,120,138,466,73,273,74,167,32,59,38,16,5,55,31,24,6,6,47,21,26
"2021","Hertsmere 005D","E01023526",673,124,70,54,516,128,305,79,166,60,35,24,11,0,45,19,26,3,3,33,18,15
"2021","Hertsmere 005E","E01023527",600,188,102,86,378,51,191,38,110,43,44,18,22,4,86,56,30,6,6,34,16,18
"2021","Hertsmere 006A","E01023534",636,113,39,74,454,37,238,60,124,54,75,23,35,17,97,53,44,7,7,69,39,30
"2021","Hertsmere 006B","E01023535",678,192,84,108,433,25,237,55,128,54,62,24,33,5,100,53,47,9,9,53,25,28
"2021","Hertsmere 006C","E01023536",737,316,101,215,382,17,138,31,83,24,70,29,32,9,155,115,40,2,2,39,16,23
"2021","Hertsmere 006D","E01023537",1047,232,94,138,737,53,409,103,240,66,128,76,45,7,137,82,55,10,10,78,33,45
"2021","Hertsmere 006E","E01023538",969,399,148,251,501,25,233,69,129,35,96,43,47,6,131,81,50,16,16,69,28,41
"2021","Hertsmere 007A","E01023529",540,109,52,57,357,24,187,48,103,36,50,17,29,4,91,44,47,5,5,74,35,39
"2021","Hertsmere 007B","E01023530",533,174,66,108,304,23,121,30,73,18,49,21,25,3,99,79,20,12,12,55,20,35
"2021","Hertsmere 007C","E01023531",751,187,82,105,501,50,283,52,179,52,51,32,16,3,111,73,38,6,6,63,33,30
"2021","Hertsmere 007D","E01023532",645,158,96,62,430,58,258,69,147,42,50,29,17,4,61,34,27,3,3,57,19,38
"2021","Hertsmere 007E","E01023533",588,137,64,73,397,37,209,48,112,49,49,21,26,2,99,63,36,3,3,54,29,25
"2021","Hertsmere 008A","E01023552",645,138,71,67,464,64,287,78,136,73,47,22,23,2,61,32,29,5,5,43,20,23
"2021","Hertsmere 008B","E01023553",745,150,50,100,534,54,329,78,197,54,74,39,32,3,73,47,26,4,4,61,28,33
"2021","Hertsmere 008C","E01023554",717,196,65,131,464,36,232,66,132,34,73,41,30,2,113,62,51,10,10,57,28,29
"2021","Hertsmere 008D","E01023555",777,210,74,136,510,54,245,66,137,42,79,35,34,10,130,78,52,2,2,57,28,29
"2021","Hertsmere 009A","E01023544",488,139,63,76,328,48,181,45,95,41,50,31,16,3,49,30,19,0,0,21,11,10
"2021","Hertsmere 009B","E01023545",828,317,92,225,480,29,240,85,126,29,106,61,36,9,94,63,31,11,11,31,7,24
"2021","Hertsmere 009C","E01023546",823,247,80,167,521,32,263,64,140,59,78,44,27,7,138,98,40,10,10,55,31,24
"2021","Hertsmere 009D","E01023547",723,214,62,152,452,26,222,47,121,54,63,24,29,10,133,96,37,8,8,57,28,29
"2021","Hertsmere 010A","E01023528",592,156,62,94,404,83,225,84,99,42,48,29,16,3,45,21,24,3,3,32,14,18
"2021","Hertsmere 010B","E01023564",641,181,66,115,400,29,218,56,116,46,67,37,25,5,80,49,31,6,6,60,31,29
"2021","Hertsmere 010C","E01023565",674,142,74,68,488,72,324,73,191,60,43,26,16,1,45,29,16,4,4,44,14,30
"2021","Hertsmere 010D","E01023566",510,70,54,16,406,88,287,69,150,68,7,5,0,2,23,11,12,1,1,34,24,10
"2021","Hertsmere 011B","E01023540",660,158,92,66,447,67,272,43,177,52,36,16,15,5,67,33,34,5,5,55,29,26
"2021","Hertsmere 011C","E01023541",969,251,71,180,657,57,390,91,245,54,96,56,36,4,104,73,31,10,10,61,24,37
"2021","Hertsmere 011D","E01023542",666,107,51,56,486,36,263,58,153,52,68,25,29,14,111,59,52,8,8,73,39,34
"2021","Hertsmere 011E","E01023543",587,213,91,122,311,26,144,30,79,35,40,19,16,5,96,57,39,5,5,63,32,31
"2021","Hertsmere 011F","E01035598",636,183,64,119,386,38,219,63,135,21,53,30,21,2,64,42,22,12,12,67,25,42
"2021","Hertsmere 011G","E01035599",679,174,23,151,438,9,232,66,148,18,92,54,35,3,92,65,27,13,13,67,27,40
"2021","Hertsmere 012A","E01023558",811,275,148,127,509,79,274,76,153,45,63,39,22,2,90,59,31,3,3,27,11,16
"2021","Hertsmere 012B","E01023559",690,179,60,119,472,70,267,86,137,44,77,56,15,6,56,36,20,2,2,39,12,27
"2021","Hertsmere 012C","E01023560",751,242,113,129,460,26,239,54,142,43,76,33,38,5,116,72,44,3,3,49,29,20
"2021","Hertsmere 012D","E01023561",657,158,101,57,461,56,251,67,130,54,51,14,32,5,101,61,40,2,2,38,18,20
"2021","Hertsmere 012E","E01023562",750,197,100,97,517,104,295,78,148,69,48,29,14,5,68,32,36,2,2,36,20,16
"2021","Hertsmere 012F","E01023563",756,246,133,113,460,76,237,51,140,46,85,54,27,4,57,42,15,5,5,50,19,31
"2021","Hertsmere 013A","E01023548",927,317,209,108,562,168,285,76,148,61,40,28,11,1,62,34,28,7,7,48,18,30
"2021","Hertsmere 013B","E01023549",816,313,206,107,471,122,234,74,117,43,34,20,11,3,78,42,36,3,3,32,10,22
"2021","Hertsmere 013C","E01023550",689,159,106,53,492,97,327,98,178,51,24,14,8,2,42,21,21,2,2,38,19,19
"2021","Hertsmere 013D","E01023551",551,84,56,28,433,90,293,70,154,69,16,5,7,4,31,11,20,3,3,34,14,20
"2021","Hertsmere 013E","E01023556",716,156,75,81,528,58,312,68,189,55,57,27,21,9,97,62,35,4,4,32,18,14
"2021","Hertsmere 013F","E01023557",611,145,76,69,432,74,258,63,136,59,43,22,18,3,54,27,27,3,3,34,19,15
"2021","North Hertfordshire 001A","E01023660",1178,468,176,292,669,83,333,140,147,46,182,133,44,5,61,40,21,10,10,41,11,30
"2021","North Hertfordshire 001B","E01023661",548,155,74,81,367,58,170,50,87,33,56,19,28,9,80,50,30,3,3,26,15,11
"2021","North Hertfordshire 001C","E01023662",807,175,50,125,593,49,338,89,186,63,134,57,68,9,68,49,19,4,4,39,11,28
"2021","North Hertfordshire 002A","E01023654",670,163,75,88,491,105,269,96,126,47,77,44,28,5,37,20,17,3,3,16,3,13
"2021","North Hertfordshire 002B","E01023655",856,205,125,80,619,126,336,112,166,58,78,53,23,2,75,51,24,4,4,32,10,22
"2021","North Hertfordshire 002C","E01023656",1139,466,129,337,629,70,297,97,154,46,175,127,41,7,80,42,38,7,7,44,13,31
"2021","North Hertfordshire 002D","E01023657",1075,284,180,104,764,180,416,124,219,73,108,56,47,5,58,35,23,2,2,27,14,13
"2021","North Hertfordshire 002E","E01023658",693,147,80,67,523,83,257,63,141,53,99,40,52,7,83,59,24,1,1,23,7,16
"2021","North Hertfordshire 002F","E01023659",534,89,48,41,427,92,244,82,113,49,56,29,19,8,35,19,16,0,0,18,5,13
"2021","North Hertfordshire 003A","E01023635",629,170,99,71,433,64,208,69,104,35,82,37,40,5,76,50,26,3,3,26,12,14
"2021","North Hertfordshire 003B","E01023636",792,235,142,93,537,79,271,79,139,53,107,54,46,7,77,47,30,3,3,20,11,9
"2021","North Hertfordshire 003C","E01023637",930,438,178,260,462,64,203,75,97,31,107,52,48,7,84,50,34,4,4,30,11,19
"2021","North Hertfordshire 003D","E01023638",689,193,76,117,458,50,212,78,96,38,86,45,36,5,103,56,47,7,7,38,20,18
"2021","North Hertfordshire 004A","E01023587",491,179,54,125,307,19,173,63,85,25,78,56,19,3,37,18,19,0,0,5,2,3
"2021","North Hertfordshire 004B","E01023588",631,194,106,88,420,51,248,83,109,56,70,52,15,3,49,32,17,2,2,17,7,10
"2021","North Hertfordshire 004C","E01023589",880,404,155,249,443,63,210,85,92,33,101,67,26,8,64,39,25,5,5,33,10,23
"2021","North Hertfordshire 004D","E01023590",810,276,109,167,509,56,251,83,124,44,129,79,41,9,72,41,31,1,1,25,6,19
"2021","North Hertfordshire 004E","E01023591",662,214,108,106,425,84,226,76,106,44,69,43,25,1,45,28,17,1,1,23,7,16
"2021","North Hertfordshire 004F","E01023592",577,112,51,61,434,42,214,50,119,45,70,25,40,5,106,66,40,2,2,31,14,17
"2021","North Hertfordshire 004G","E01023593",630,200,87,113,406,52,154,42,84,28,76,35,34,7,120,74,46,4,4,24,10,14
"2021","North Hertfordshire 006A","E01023630",728,198,81,117,487,45,237,65,137,35,105,56,42,7,91,54,37,9,9,43,17,26
"2021","North Hertfordshire 006B","E01023631",720,243,89,154,437,25,188,53,105,30,110,53,52,5,113,88,25,1,1,40,20,20
"2021","North Hertfordshire 006C","E01023632",805,244,63,181,525,40,265,80,146,39,131,77,50,4,86,72,14,3,3,36,16,20
"2021","North Hertfordshire 006D","E01023633",606,227,70,157,365,33,166,53,78,35,84,47,32,5,79,45,34,3,3,14,8,6
"2021","North Hertfordshire 006E","E01023634",611,190,98,92,402,109,186,75,81,30,72,48,23,1,30,17,13,5,5,19,3,16
"2021","North Hertfordshire 007A","E01023649",675,303,91,212,356,54,165,67,70,28,94,74,14,6,40,22,18,3,3,16,5,11
"2021","North Hertfordshire 007B","E01023650",679,208,62,146,437,32,177,49,97,31,99,53,40,6,122,77,45,7,7,34,16,18
"2021","North Hertfordshire 007C","E01023651",506,130,75,55,345,56,180,58,77,45,55,32,18,5,54,29,25,0,0,31,15,16
"2021","North Hertfordshire 007D","E01023652",607,194,122,72,384,51,170,47,85,38,66,19,38,9,96,61,35,1,1,29,20,9
"2021","North Hertfordshire 008A","E01023644",833,336,181,155,460,114,235,88,102,45,75,53,21,1,32,18,14,4,4,37,11,26
"2021","North Hertfordshire 008B","E01023645",682,216,110,106,433,88,204,66,99,39,70,41,25,4,69,32,37,2,2,33,14,19
"2021","North Hertfordshire 008C","E01023646",509,79,40,39,391,34,174,43,99,32,63,21,37,5,117,73,44,3,3,39,18,21
"2021","North Hertfordshire 008D","E01023647",591,118,83,35,441,115,257,76,132,49,34,20,14,0,34,11,23,1,1,32,11,21
"2021","North Hertfordshire 008E","E01023648",469,114,64,50,322,98,191,66,85,40,18,10,8,0,15,11,4,0,0,33,14,19
"2021","North Hertfordshire 009A","E01023639",557,176,89,87,357,86,171,50,88,33,51,27,19,5,47,20,27,2,2,24,7,17
"2021","North Hertfordshire 009B","E01023640",564,226,114,112,305,49,109,41,43,25,50,13,35,2,92,64,28,5,5,33,8,25
"2021","North Hertfordshire 009C","E01023641",584,204,84,120,359,46,154,37,78,39,69,33,33,3,86,62,24,4,4,21,8,13
"2021","North Hertfordshire 009D","E01023642",494,91,74,17,377,119,209,56,94,59,29,13,14,2,20,9,11,0,0,26,12,14
"2021","North Hertfordshire 009E","E01023643",493,120,58,62,337,47,165,49,76,40,63,29,22,12,61,25,36,1,1,36,22,14
"2021","North Hertfordshire 010A","E01023601",1149,520,120,400,561,34,207,76,107,24,224,174,46,4,88,58,30,8,8,68,17,51
"2021","North Hertfordshire 010B","E01023602",651,173,46,127,442,26,248,83,137,28,113,76,35,2,49,30,19,6,6,36,14,22
"2021","North Hertfordshire 010C","E01023603",611,127,74,53,463,46,293,86,164,43,77,46,25,6,47,28,19,0,0,21,10,11
"2021","North Hertfordshire 010D","E01023604",536,115,57,58,384,47,239,62,136,41,57,36,17,4,37,20,17,4,4,37,11,26
"2021","North Hertfordshire 010E","E01023605",723,331,52,279,349,22,131,41,75,15,117,95,20,2,71,47,24,8,8,43,16,27
"2021","North Hertfordshire 011A","E01023617",623,134,89,45,457,92,263,77,146,40,63,38,25,0,38,19,19,1,1,32,14,18
"2021","North Hertfordshire 011B","E01023618",698,166,67,99,509,43,263,72,140,51,117,70,40,7,80,43,37,6,6,23,4,19
"2021","North Hertfordshire 011C","E01023619",779,257,67,190,497,42,245,76,132,37,141,118,20,3,65,43,22,4,4,25,7,18
"2021","North Hertfordshire 011D","E01023620",524,137,65,72,359,34,187,46,109,32,56,20,32,4,78,38,40,4,4,28,11,17
"2021","North Hertfordshire 011E","E01023621",580,185,61,124,374,40,190,58,94,38,65,42,19,4,76,50,26,3,3,21,9,12
"2021","North Hertfordshire 012A","E01023611",673,181,87,94,460,47,203,66,98,39,91,40,47,4,115,69,46,4,4,32,17,15
"2021","North Hertfordshire 012B","E01023612",781,213,97,116,541,58,261,80,131,50,115,74,35,6,98,57,41,9,9,27,9,18
"2021","North Hertfordshire 012C","E01023613",751,318,115,203,403,22,146,48,71,27,93,35,48,10,134,89,45,8,8,30,15,15
"2021","North Hertfordshire 012D","E01023614",808,160,73,87,616,132,379,106,203,70,60,38,21,1,43,26,17,2,2,32,12,20
"2021","North Hertfordshire 012E","E01023615",726,223,146,77,481,129,277,75,166,36,42,25,16,1,29,10,19,4,4,22,7,15
"2021","North Hertfordshire 012F","E01023616",1307,612,268,344,656,101,277,104,139,34,188,140,44,4,79,51,28,11,11,39,5,34
"2021","North Hertfordshire 013A","E01023606",783,285,105,180,473,52,217,69,127,21,117,62,51,4,85,56,29,2,2,25,6,19
"2021","North Hertfordshire 013B","E01023607",611,178,103,75,401,66,234,58,136,40,61,32,26,3,39,21,18,1,1,32,15,17
"2021","North Hertfordshire 013C","E01023608",640,138,103,35,484,119,280,81,159,40,51,25,24,2,34,21,13,0,0,18,10,8
"2021","North Hertfordshire 013D","E01023609",760,273,95,178,459,63,245,76,136,33,107,74,30,3,42,31,11,2,2,28,6,22
"2021","North Hertfordshire 013E","E01023610",515,112,36,76,387,44,265,63,160,42,47,28,15,4,28,18,10,3,3,16,3,13
"2021","North Hertfordshire 014A","E01023594",1039,299,148,151,695,148,321,121,142,58,116,59,45,12,107,65,42,3,3,45,18,27
"2021","North Hertfordshire 014B","E01023622",460,101,58,43,340,47,179,57,95,27,52,22,23,7,61,43,18,1,1,19,9,10
"2021","North Hertfordshire 014C","E01023623",633,169,90,79,437,86,234,73,117,44,60,33,24,3,53,39,14,4,4,27,11,16
"2021","North Hertfordshire 014D","E01023624",549,118,61,57,402,55,210,91,81,38,77,32,38,7,55,32,23,5,5,29,17,12
"2021","North Hertfordshire 014E","E01023625",431,94,44,50,310,79,165,64,73,28,42,24,14,4,22,10,12,2,2,27,12,15
"2021","North Hertfordshire 014F","E01023653",1042,258,154,104,746,109,418,148,200,70,133,75,47,11,86,55,31,0,0,38,16,22
"2021","North Hertfordshire 015A","E01023595",696,239,111,128,430,82,229,75,113,41,73,48,23,2,45,29,16,1,1,27,10,17
"2021","North Hertfordshire 015B","E01023596",512,172,114,58,330,62,168,53,84,31,46,20,21,5,51,32,19,3,3,10,3,7
"2021","North Hertfordshire 015C","E01023626",903,182,104,78,688,128,395,134,183,78,90,47,35,8,72,48,24,3,3,33,11,22
"2021","North Hertfordshire 015D","E01023627",732,167,85,82,523,97,299,116,124,59,79,51,24,4,47,29,18,1,1,42,22,20
"2021","North Hertfordshire 015E","E01023628",828,257,128,129,542,81,293,101,153,39,98,69,22,7,67,40,27,3,3,29,9,20
"2021","North Hertfordshire 015F","E01023629",770,241,129,112,508,73,252,85,126,41,93,60,31,2,88,54,34,2,2,21,5,16
"2021","North Hertfordshire 016A","E01023585",446,78,54,24,337,88,188,63,88,37,43,22,20,1,17,14,3,1,1,31,16,15
"2021","North Hertfordshire 016B","E01023586",730,234,127,107,470,86,248,82,133,33,66,26,33,7,69,41,28,1,1,26,10,16
"2021","North Hertfordshire 016C","E01023597",514,125,67,58,365,85,201,80,84,37,43,22,18,3,34,20,14,2,2,24,10,14
"2021","North Hertfordshire 016D","E01023598",621,136,65,71,451,91,245,82,117,46,67,33,25,9,48,30,18,0,0,34,10,24
"2021","North Hertfordshire 016E","E01023663",853,185,102,83,631,117,363,153,149,61,74,46,22,6,76,45,31,1,1,37,15,22
"2021","North Hertfordshire 017B","E01023600",583,154,76,78,405,54,205,77,86,42,70,35,32,3,71,41,30,5,5,24,12,12
"2021","North Hertfordshire 017E","E01033024",529,70,21,49,421,22,304,76,176,52,69,37,27,5,26,14,12,0,0,38,22,16
"2021","North Hertfordshire 017D","E01033025",519,109,31,78,392,21,231,64,137,30,80,54,26,0,59,45,14,1,1,18,10,8
"2021","North Hertfordshire 017A","E01033026",584,136,34,102,392,25,219,59,138,22,82,45,33,4,64,45,19,2,2,56,23,33
"2021","North Hertfordshire 017C","E01033027",596,150,26,124,402,14,202,63,123,16,103,55,44,4,82,63,19,1,1,44,15,29
"2021","Three Rivers 001A","E01023802",740,237,120,117,480,66,247,73,133,41,91,56,31,4,74,42,32,2,2,23,9,14
"2021","Three Rivers 001B","E01023803",611,158,116,42,418,78,269,68,139,62,44,23,16,5,24,9,15,3,3,35,14,21
"2021","Three Rivers 001C","E01023804",627,192,128,64,406,63,190,45,107,38,59,26,30,3,89,53,36,5,5,29,10,19
"2021","Three Rivers 001D","E01023807",620,166,95,71,403,62,209,51,98,60,55,30,16,9,71,30,41,6,6,51,26,25
"2021","Three Rivers 001F","E01035600",641,203,96,107,410,69,224,60,107,57,74,44,25,5,36,15,21,7,7,28,10,18
"2021","Three Rivers 001G","E01035601",625,262,49,213,327,16,127,44,72,11,93,69,21,3,87,63,24,4,4,36,9,27
"2021","Three Rivers 002A","E01023829",625,103,51,52,483,41,232,40,142,50,79,27,46,6,126,69,57,5,5,39,22,17
"2021","Three Rivers 002B","E01023830",731,340,150,190,364,50,159,58,73,28,86,49,31,6,67,36,31,2,2,27,9,18
"2021","Three Rivers 002C","E01023832",799,207,58,149,554,46,293,53,190,50,93,45,41,7,120,87,33,2,2,38,22,16
"2021","Three Rivers 002E","E01023834",675,148,62,86,482,60,287,70,146,71,63,29,30,4,68,46,22,4,4,45,22,23
"2021","Three Rivers 002F","E01035602",539,163,70,93,357,46,214,71,105,38,49,26,18,5,48,30,18,0,0,19,3,16
"2021","Three Rivers 002G","E01035603",833,124,29,95,647,30,386,72,260,54,86,36,47,3,139,91,48,6,6,62,37,25
"2021","Three Rivers 003A","E01023823",680,190,87,103,472,71,266,82,142,42,60,33,22,5,73,39,34,2,2,18,7,11
"2021","Three Rivers 003B","E01023824",794,142,105,37,617,108,398,93,224,81,59,24,29,6,52,29,23,0,0,35,13,22
"2021","Three Rivers 003C","E01023831",788,176,73,103,562,54,338,81,190,67,73,36,31,6,94,57,37,3,3,50,19,31
"2021","Three Rivers 003D","E01023854",803,205,117,88,542,144,299,107,116,76,47,23,23,1,47,23,24,5,5,56,23,33
"2021","Three Rivers 004A","E01023812",504,52,34,18,390,88,271,59,133,79,10,3,6,1,18,7,11,3,3,62,36,26
"2021","Three Rivers 004B","E01023813",517,50,30,20,416,69,293,73,127,93,29,19,6,4,25,13,12,0,0,51,27,24
"2021","Three Rivers 004C","E01023814",484,194,156,38,275,57,173,41,108,24,16,10,5,1,28,15,13,1,1,15,7,8
"2021","Three Rivers 004D","E01023851",920,404,170,234,487,72,254,103,124,27,105,81,22,2,55,32,23,1,1,29,7,22
"2021","Three Rivers 005A","E01023815",581,112,68,44,436,80,265,56,165,44,40,22,15,3,48,29,19,3,3,33,16,17
"2021","Three Rivers 005B","E01023816",498,111,65,46,367,55,222,55,124,43,43,21,21,1,42,21,21,5,5,20,10,10
"2021","Three Rivers 005C","E01023817",580,144,86,58,411,63,236,71,125,40,51,39,11,1,57,36,21,4,4,25,6,19
"2021","Three Rivers 005D","E01023818",531,97,79,18,416,87,295,61,160,74,17,7,10,0,16,12,4,1,1,18,4,14
"2021","Three Rivers 006A","E01023819",686,202,100,102,452,41,257,62,154,41,79,43,30,6,70,38,32,5,5,32,10,22
"2021","Three Rivers 006B","E01023820",542,161,112,49,348,63,218,57,103,58,31,12,16,3,34,20,14,2,2,33,18,15
"2021","Three Rivers 006C","E01023821",491,96,67,29,372,63,222,55,130,37,47,14,28,5,40,24,16,0,0,23,12,11
"2021","Three Rivers 006D","E01023822",534,116,80,36,393,69,240,51,145,44,39,18,20,1,45,18,27,0,0,25,14,11
"2021","Three Rivers 006E","E01023825",924,208,105,103,665,72,401,112,233,56,113,58,44,11,73,38,35,6,6,51,26,25
"2021","Three Rivers 006F","E01023826",593,124,78,46,451,68,290,52,185,53,41,10,25,6,51,23,28,1,1,18,13,5
"2021","Three Rivers 007A","E01023847",777,225,67,158,518,38,278,63,170,45,98,48,43,7,99,57,42,5,5,34,18,16
"2021","Three Rivers 007B","E01023848",662,127,54,73,490,40,258,50,158,50,73,21,42,10,115,64,51,4,4,45,25,20
"2021","Three Rivers 007C","E01023850",855,409,152,257,404,30,168,74,83,11,143,110,30,3,57,33,24,6,6,42,7,35
"2021","Three Rivers 007D","E01023852",617,168,106,62,418,52,247,72,135,40,67,27,36,4,49,30,19,3,3,31,13,18
"2021","Three Rivers 007E","E01023853",754,97,74,23,611,130,414,82,244,88,33,16,13,4,34,16,18,0,0,46,23,23
"2021","Three Rivers 008A","E01023827",886,208,95,113,597,31,336,75,196,65,85,33,44,8,137,80,57,8,8,81,43,38
"2021","Three Rivers 008B","E01023828",624,167,81,86,397,22,200,32,122,46,59,21,29,9,112,74,38,4,4,60,41,19
"2021","Three Rivers 008C","E01023845",698,157,73,84,489,69,257,49,135,73,51,16,31,4,107,67,40,5,5,52,24,28
"2021","Three Rivers 008D","E01023846",577,96,69,27,443,82,291,75,158,58,33,19,11,3,35,15,20,2,2,38,16,22
"2021","Three Rivers 009A","E01023835",536,127,68,59,380,62,203,43,119,41,51,23,24,4,60,30,30,4,4,29,10,19
"2021","Three Rivers 009B","E01023836",629,233,113,120,366,18,179,56,95,28,76,41,31,4,90,55,35,3,3,30,11,19
"2021","Three Rivers 009C","E01023837",650,162,75,87,448,41,218,58,126,34,106,52,50,4,79,44,35,4,4,40,18,22
"2021","Three Rivers 009D","E01023838",510,119,51,68,357,32,165,49,82,34,51,12,35,4,108,52,56,1,1,34,14,20
"2021","Three Rivers 010A","E01023805",633,158,70,88,413,23,220,49,133,38,54,10,33,11,111,54,57,5,5,62,37,25
"2021","Three Rivers 010B","E01023809",780,234,152,82,502,104,258,69,139,50,61,28,25,8,75,29,46,4,4,44,28,16
"2021","Three Rivers 010C","E01023810",733,196,131,65,487,113,298,72,138,88,24,10,12,2,50,14,36,2,2,50,27,23
"2021","Three Rivers 010D","E01023811",607,163,91,72,402,100,218,55,103,60,34,14,19,1,47,18,29,3,3,42,21,21
"2021","Three Rivers 011A","E01023839",785,119,89,30,568,119,387,91,191,105,22,11,11,0,35,12,23,5,5,98,64,34
"2021","Three Rivers 011B","E01023840",584,122,66,56,416,78,283,90,145,48,16,10,5,1,36,20,16,3,3,46,20,26
"2021","Three Rivers 011C","E01023841",626,93,40,53,462,100,292,78,125,89,42,32,7,3,27,15,12,1,1,71,39,32
"2021","Three Rivers 011D","E01023849",603,166,109,57,393,81,231,78,104,49,45,25,17,3,34,15,19,2,2,44,17,27
"2021","Three Rivers 012A","E01023806",877,223,85,138,599,39,346,79,193,74,96,38,47,11,109,72,37,9,9,55,30,25
"2021","Three Rivers 012B","E01023842",671,225,58,167,401,25,204,48,120,36,61,25,31,5,102,62,40,9,9,45,28,17
"2021","Three Rivers 012C","E01023843",859,287,121,166,509,27,299,69,176,54,76,30,37,9,96,52,44,11,11,63,34,29
"2021","Three Rivers 012D","E01023844",817,328,55,273,456,13,202,68,112,22,108,48,53,7,122,86,36,11,11,33,8,25
"2021","Watford 001A","E01023904",780,174,68,106,547,46,290,63,162,65,73,28,37,8,133,87,46,5,5,59,28,31
"2021","Watford 001B","E01023905",848,286,107,179,501,38,275,65,169,41,78,42,29,7,103,58,45,7,7,61,27,34
"2021","Watford 001C","E01023906",627,199,98,101,383,37,171,37,84,50,60,17,33,10,109,64,45,6,6,45,24,21
"2021","Watford 001D","E01023907",765,228,83,145,490,58,262,63,148,51,84,41,39,4,81,49,32,5,5,47,25,22
"2021","Watford 002A","E01023890",538,146,50,96,352,43,211,61,100,50,40,19,19,2,53,31,22,5,5,40,24,16
"2021","Watford 002B","E01023891",536,104,34,70,398,26,184,46,103,35,52,20,24,8,128,81,47,8,8,34,19,15
"2021","Watford 002C","E01023892",507,108,44,64,363,36,196,53,107,36,58,25,25,8,69,41,28,4,4,36,17,19
"2021","Watford 002D","E01023893",718,227,114,113,451,72,262,89,119,54,51,22,25,4,61,29,32,5,5,40,16,24
"2021","Watford 002E","E01023894",528,93,39,54,399,62,229,65,117,47,50,22,20,8,55,30,25,3,3,36,23,13
"2021","Watford 003A","E01023873",521,146,50,96,347,31,159,35,96,28,58,20,32,6,89,51,38,10,10,28,15,13
"2021","Watford 003B","E01023874",475,112,81,31,311,42,180,34,105,41,34,10,16,8,51,30,21,4,4,52,25,27
"2021","Watford 003C","E01023875",947,301,158,143,594,89,333,98,165,70,86,47,32,7,79,53,26,7,7,52,20,32
"2021","Watford 003D","E01023876",673,169,56,113,457,17,197,38,123,36,61,26,31,4,175,119,56,7,7,47,31,16
"2021","Watford 003E","E01023877",656,185,87,98,414,31,221,42,123,56,78,34,31,13,81,45,36,3,3,57,30,27
"2021","Watford 004A","E01023868",710,192,122,70,463,35,242,42,153,47,61,31,26,4,121,71,50,4,4,55,30,25
"2021","Watford 004B","E01023869",505,130,46,84,305,11,186,50,104,32,47,28,17,2,57,21,36,4,4,70,48,22
"2021","Watford 004C","E01023870",515,88,22,66,356,18,189,34,112,43,46,20,22,4,99,55,44,4,4,71,49,22
"2021","Watford 004D","E01023871",733,235,46,189,453,25,260,57,178,25,84,52,29,3,77,52,25,7,7,45,21,24
"2021","Watford 004E","E01023872",631,141,56,85,429,43,268,67,159,42,55,30,20,5,55,29,26,8,8,61,29,32
"2021","Watford 005A","E01023895",721,191,38,153,472,41,242,91,122,29,111,79,26,6,65,43,22,13,13,58,25,33
"2021","Watford 005B","E01023896",476,87,41,46,343,52,220,66,101,53,32,19,11,2,38,17,21,1,1,46,24,22
"2021","Watford 005C","E01023897",644,206,133,73,398,78,248,48,137,63,34,18,11,5,36,14,22,2,2,40,26,14
"2021","Watford 005D","E01023898",556,93,65,28,421,54,294,70,163,61,34,11,22,1,36,10,26,3,3,42,22,20
"2021","Watford 006A","E01023855",903,256,43,213,525,14,274,83,167,24,121,76,43,2,97,63,34,19,19,122,46,76
"2021","Watford 006B","E01023856",1025,241,56,185,662,32,312,94,180,38,191,126,61,4,110,65,45,17,17,122,60,62
"2021","Watford 006C","E01023857",608,146,44,102,364,26,204,44,125,35,53,30,22,1,76,30,46,5,5,98,63,35
"2021","Watford 006D","E01023858",878,333,52,281,463,18,259,80,150,29,93,59,32,2,88,51,37,5,5,82,35,47
"2021","Watford 007A","E01023878",823,184,103,81,592,119,367,95,193,79,55,28,18,9,50,21,29,1,1,47,22,25
"2021","Watford 007C","E01023880",1023,374,127,247,568,42,298,113,143,42,153,117,29,7,67,47,20,8,8,81,26,55
"2021","Watford 007D","E01023881",583,108,59,49,424,73,258,63,143,52,37,10,24,3,54,29,25,2,2,51,27,24
"2021","Watford 007E","E01035572",552,148,24,124,368,16,232,44,168,20,50,31,18,1,65,44,21,5,5,36,18,18
"2021","Watford 007F","E01035573",610,190,65,125,353,40,206,53,137,16,68,48,19,1,37,22,15,2,2,67,31,36
"2021","Watford 008A","E01023886",1087,254,67,187,742,54,439,95,278,66,117,71,41,5,114,69,45,18,18,91,41,50
"2021","Watford 008B","E01023887",625,115,84,31,458,91,311,59,183,69,31,15,14,2,25,11,14,0,0,52,25,27
"2021","Watford 008C","E01023888",601,138,66,72,387,68,247,61,137,49,36,23,9,4,34,21,13,2,2,76,34,42
"2021","Watford 008D","E01023889",623,93,81,12,486,83,346,74,184,88,23,7,10,6,33,15,18,1,1,44,27,17
"2021","Watford 009B","E01023860",953,406,45,361,461,17,189,57,107,25,122,89,27,6,118,71,47,15,15,86,38,48
"2021","Watford 009D","E01023862",1182,446,170,276,628,33,330,89,202,39,141,93,45,3,103,69,34,21,21,108,41,67
"2021","Watford 009E","E01035574",608,256,24,232,308,9,148,60,78,10,94,74,19,1,46,33,13,11,11,44,13,31
"2021","Watford 009F","E01035575",541,151,23,128,330,14,162,49,98,15,93,57,34,2,50,35,15,11,11,60,20,40
"2021","Watford 009G","E01035576",574,278,80,198,264,11,116,43,70,3,95,79,15,1,33,27,6,9,9,32,9,23
"2021","Watford 009H","E01035577",690,211,26,185,395,4,212,62,131,19,93,75,18,0,72,44,28,14,14,84,12,72
"2021","Watford 009I","E01035578",603,254,19,235,260,5,126,60,55,11,77,67,8,2,44,29,15,8,8,89,29,60
"2021","Watford 010A","E01023899",593,160,26,134,325,13,180,41,115,24,58,33,22,3,66,43,23,8,8,108,63,45
"2021","Watford 010B","E01023900",605,131,29,102,369,18,225,47,141,37,56,31,22,3,63,38,25,7,7,105,60,45
"2021","Watford 010C","E01023901",751,173,41,132,466,10,273,59,182,32,85,47,35,3,76,49,27,22,22,112,53,59
"2021","Watford 010D","E01023902",657,181,39,142,391,25,227,62,140,25,54,28,23,3,79,43,36,6,6,85,35,50
"2021","Watford 010E","E01023903",560,143,48,95,323,11,197,36,116,45,50,23,23,4,58,32,26,7,7,94,50,44
"2021","Watford 011A","E01023863",703,200,46,154,413,24,250,73,125,52,64,40,21,3,66,29,37,9,9,90,43,47
"2021","Watford 011B","E01023864",642,207,64,143,375,19,217,49,138,30,56,26,27,3,75,47,28,8,8,60,37,23
"2021","Watford 011C","E01023865",710,187,62,125,453,23,228,37,140,51,56,32,21,3,139,82,57,7,7,70,45,25
"2021","Watford 011D","E01023866",650,170,62,108,436,25,176,29,111,36,53,10,29,14,177,126,51,5,5,44,22,22
"2021","Watford 011F","E01035579",703,200,29,171,437,15,220,57,139,24,82,54,24,4,115,94,21,5,5,66,30,36
"2021","Watford 011G","E01035580",443,105,24,81,276,16,172,31,119,22,41,35,6,0,43,25,18,4,4,62,29,33
"2021","Watford 012A","E01023882",656,164,80,84,459,68,276,64,158,54,66,40,20,6,48,19,29,1,1,33,16,17
"2021","Watford 012B","E01023883",701,252,132,120,391,39,202,45,121,36,56,26,25,5,86,45,41,8,8,58,31,27
"2021","Watford 012C","E01023884",874,285,101,184,531,42,274,86,159,29,118,83,33,2,90,54,36,7,7,58,23,35
"2021","Watford 012D","E01023885",691,158,59,99,485,80,284,63,163,58,67,40,23,4,49,24,25,5,5,48,23,25
"2021","Breckland 001A","E01026436",1049,260,148,112,742,169,371,170,137,64,131,71,54,6,65,38,27,6,6,47,22,25
"2021","Breckland 001C","E01026461",692,184,118,66,485,133,237,108,90,39,71,38,30,3,43,24,19,1,1,23,6,17
"2021","Breckland 001E","E01026483",499,137,76,61,335,79,168,83,56,29,48,29,18,1,38,21,17,2,2,27,12,15
"2021","Breckland 001F","E01033042",879,196,100,96,640,120,344,143,167,34,104,57,44,3,68,35,33,4,4,43,16,27
"2021","Breckland 002A","E01026442",964,244,152,92,680,190,307,147,104,56,83,49,28,6,94,54,40,6,6,40,11,29
"2021","Breckland 002B","E01026443",884,201,118,83,641,126,356,149,144,63,98,52,39,7,58,31,27,3,3,42,20,22
"2021","Breckland 002C","E01026445",1129,305,183,122,777,200,349,165,101,83,131,72,55,4,93,56,37,4,4,47,20,27
"2021","Breckland 002D","E01026462",1015,225,134,91,729,188,373,183,117,73,113,61,45,7,52,32,20,3,3,61,29,32
"2021","Breckland 003A","E01026428",1083,252,115,137,784,136,401,147,186,68,117,60,52,5,126,83,43,4,4,47,30,17
"2021","Breckland 003B","E01026429",701,284,157,127,383,69,163,66,54,43,84,47,33,4,64,38,26,3,3,34,11,23
"2021","Breckland 003C","E01026430",927,219,130,89,661,142,313,114,145,54,116,69,41,6,89,61,28,1,1,47,23,24
"2021","Breckland 003D","E01026431",518,154,106,48,347,95,154,66,52,36,61,27,28,6,36,21,15,1,1,17,6,11
"2021","Breckland 004A","E01026446",984,277,180,97,667,214,298,141,95,62,85,43,36,6,68,37,31,2,2,40,16,24
"2021","Breckland 004B","E01026452",738,210,112,98,493,128,218,97,82,39,90,47,37,6,55,40,15,2,2,35,16,19
"2021","Breckland 004C","E01026453",652,163,98,65,440,109,226,98,71,57,55,29,21,5,44,27,17,6,6,49,20,29
"2021","Breckland 004D","E01026454",631,125,49,76,480,43,253,91,117,45,128,61,61,6,52,29,23,4,4,26,10,16
"2021","Breckland 005A","E01026425",858,267,148,119,544,109,204,60,102,42,98,38,55,5,128,72,56,5,5,47,18,29
"2021","Breckland 005B","E01026426",1198,554,204,350,601,87,252,103,107,42,128,68,54,6,128,94,34,6,6,43,10,33
"2021","Breckland 005C","E01026427",1058,284,160,124,725,186,293,100,131,62,127,60,61,6,114,66,48,5,5,49,24,25
"2021","Breckland 005D","E01026432",633,172,104,68,427,114,192,81,75,36,77,39,30,8,41,25,16,3,3,34,16,18
"2021","Breckland 005E","E01026433",625,206,47,159,405,43,147,62,72,13,122,58,55,9,92,62,30,1,1,14,4,10
"2021","Breckland 005F","E01026434",914,278,152,126,607,148,233,100,88,45,129,78,48,3,92,52,40,5,5,29,15,14
"2021","Breckland 006A","E01026479",666,191,127,64,443,108,228,102,79,47,61,37,21,3,41,23,18,5,5,32,16,16
"2021","Breckland 006B","E01026480",714,205,120,85,475,129,223,91,77,55,82,55,22,5,40,21,19,1,1,34,13,21
"2021","Breckland 006C","E01026481",536,125,69,56,368,71,189,92,70,27,73,45,23,5,33,19,14,2,2,43,16,27
"2021","Breckland 006D","E01026484",660,146,88,58,479,111,243,111,96,36,89,56,22,11,33,20,13,3,3,35,14,21
"2021","Breckland 006E","E01026485",482,87,59,28,356,76,208,105,67,36,50,31,19,0,20,10,10,2,2,39,13,26
"2021","Breckland 007B","E01026456",533,163,103,60,353,120,165,75,59,31,38,21,13,4,28,14,14,2,2,17,5,12
"2021","Breckland 007C","E01026457",653,183,128,55,448,195,175,100,45,30,43,25,12,6,34,18,16,1,1,22,4,18
"2021","Breckland 007D","E01026458",790,248,142,106,515,100,213,98,72,43,105,58,38,9,97,61,36,0,0,27,14,13
"2021","Breckland 007E","E01026459",716,269,154,115,424,111,170,81,56,33,72,37,29,6,66,41,25,5,5,23,9,14
"2021","Breckland 007F","E01035133",621,279,176,103,318,82,101,45,37,19,67,30,35,2,65,42,23,3,3,24,8,16
"2021","Breckland 007G","E01035134",657,157,44,113,468,58,210,83,96,31,109,56,53,0,86,66,20,5,5,32,13,19
"2021","Breckland 008A","E01026437",597,165,105,60,413,125,192,110,47,35,60,42,14,4,35,16,19,1,1,19,11,8
"2021","Breckland 008B","E01026438",467,110,62,48,337,73,172,94,39,39,63,39,19,5,26,14,12,3,3,20,7,13
"2021","Breckland 008C","E01026451",1046,291,173,118,708,155,352,139,139,74,121,66,46,9,77,57,20,3,3,47,19,28
"2021","Breckland 008D","E01026495",642,184,111,73,432,106,217,104,76,37,66,30,31,5,41,23,18,2,2,26,8,18
"2021","Breckland 008E","E01026496",515,154,105,49,332,117,148,69,45,34,49,29,15,5,17,10,7,1,1,29,7,22
"2021","Breckland 009A","E01026486",907,256,167,89,599,180,276,143,84,49,87,55,27,5,52,33,19,4,4,52,18,34
"2021","Breckland 009B","E01026487",884,181,73,108,641,98,287,123,118,46,157,79,71,7,97,56,41,2,2,62,31,31
"2021","Breckland 009C","E01026488",646,280,131,149,316,43,127,60,43,24,73,43,24,6,61,39,22,12,12,50,17,33
"2021","Breckland 009D","E01026489",685,200,139,61,446,156,157,76,54,27,82,37,39,6,48,24,24,3,3,39,10,29
"2021","Breckland 009E","E01026490",887,271,170,101,559,177,243,117,85,41,88,54,31,3,47,25,22,4,4,57,18,39
"2021","Breckland 010A","E01026419",515,101,59,42,378,72,212,95,77,40,65,30,29,6,27,13,14,2,2,36,9,27
"2021","Breckland 010B","E01026420",527,107,61,46,390,88,211,100,64,47,64,30,30,4,25,10,15,2,2,30,13,17
"2021","Breckland 010D","E01026464",549,113,58,55,400,95,201,96,60,45,76,44,26,6,26,12,14,2,2,36,18,18
"2021","Breckland 010E","E01026491",997,220,120,100,723,179,362,184,122,56,126,74,45,7,50,25,25,6,6,54,23,31
"2021","Breckland 010F","E01033040",635,131,19,112,456,17,200,66,107,27,144,65,70,9,91,74,17,4,4,48,29,19
"2021","Breckland 010G","E01033041",516,119,32,87,369,27,175,65,80,30,117,68,46,3,49,31,18,1,1,28,8,20
"2021","Breckland 011B","E01026423",798,218,102,116,528,90,243,99,103,41,111,61,44,6,79,49,30,5,5,52,30,22
"2021","Breckland 011C","E01026447",794,292,152,140,468,49,185,72,80,33,119,57,56,6,109,81,28,6,6,34,17,17
"2021","Breckland 011D","E01026449",859,312,149,163,502,88,240,93,104,43,96,59,30,7,71,42,29,7,7,45,21,24
"2021","Breckland 011E","E01026450",811,244,134,110,535,106,273,102,123,48,104,54,42,8,51,29,22,1,1,32,13,19
"2021","Breckland 011F","E01035135",476,91,25,66,371,27,170,60,98,12,140,89,45,6,34,30,4,0,0,14,5,9
"2021","Breckland 011G","E01035136",943,280,184,96,625,171,255,119,86,50,125,77,44,4,73,42,31,1,1,38,16,22
"2021","Breckland 012A","E01026424",933,248,136,112,638,132,345,163,127,55,104,64,36,4,53,27,26,4,4,47,18,29
"2021","Breckland 012B","E01026444",917,209,109,100,661,143,324,173,90,61,123,73,40,10,69,37,32,2,2,47,17,30
"2021","Breckland 012C","E01026492",575,164,82,82,394,85,178,84,64,30,75,36,36,3,56,32,24,0,0,17,8,9
"2021","Breckland 012D","E01026493",616,176,84,92,408,102,190,89,77,24,67,37,25,5,41,27,14,8,8,32,8,24
"2021","Breckland 013A","E01026421",778,215,124,91,529,116,274,127,100,47,83,45,30,8,54,34,20,2,2,34,13,21
"2021","Breckland 013B","E01026435",913,213,98,115,647,117,347,156,133,58,114,68,38,8,62,35,27,7,7,53,25,28
"2021","Breckland 013C","E01026448",984,201,123,78,735,152,393,122,191,80,120,73,37,10,68,43,25,2,2,48,14,34
"2021","Breckland 014A","E01026439",837,222,113,109,583,148,271,106,112,53,104,62,37,5,59,39,20,1,1,32,14,18
"2021","Breckland 014B","E01026440",478,94,39,55,357,61,195,77,85,33,74,42,28,4,27,12,15,0,0,27,7,20
"2021","Breckland 014C","E01026441",678,180,118,62,463,115,218,93,80,45,75,34,35,6,54,31,23,1,1,35,7,28
"2021","Breckland 014D","E01026494",1006,221,117,104,733,172,379,155,153,71,108,60,40,8,73,38,35,1,1,52,17,35
"2021","Breckland 015A","E01026465",811,277,111,166,462,68,173,68,68,37,129,60,59,10,85,46,39,7,7,72,30,42
"2021","Breckland 015B","E01026466",776,235,93,142,482,41,227,82,113,32,107,48,54,5,92,59,33,15,15,59,23,36
"2021","Breckland 015C","E01026467",761,162,52,110,510,25,171,38,92,41,113,33,69,11,196,151,45,5,5,89,46,43
"2021","Breckland 016A","E01026468",1127,417,176,241,635,100,250,116,85,49,171,105,55,11,97,55,42,17,17,75,21,54
"2021","Breckland 016B","E01026469",693,203,108,95,417,87,180,67,77,36,85,40,39,6,59,40,19,6,6,73,35,38
"2021","Breckland 016C","E01026470",1134,268,75,193,775,63,435,154,228,53,183,106,65,12,88,61,27,6,6,91,45,46
"2021","Breckland 016D","E01026471",516,143,55,88,347,38,174,59,81,34,92,53,33,6,41,24,17,2,2,26,9,17
"2021","Breckland 016E","E01026472",497,118,65,53,348,61,171,67,68,36,75,43,30,2,37,25,12,4,4,31,12,19
"2021","Breckland 016F","E01026473",565,133,71,62,393,51,204,70,90,44,92,42,46,4,44,22,22,2,2,39,19,20
"2021","Breckland 017A","E01026474",828,223,99,124,518,76,247,92,102,53,91,30,51,10,100,66,34,4,4,87,37,50
"2021","Breckland 017B","E01026475",668,166,90,76,474,89,232,115,79,38,81,37,43,1,71,47,24,1,1,28,10,18
"2021","Breckland 017C","E01026476",595,161,77,84,364,20,154,65,60,29,81,26,47,8,100,64,36,9,9,70,37,33
"2021","Breckland 017D","E01026477",702,167,77,90,481,34,183,70,75,38,103,22,79,2,153,104,49,8,8,54,28,26
"2021","Breckland 017E","E01026478",622,167,89,78,382,25,151,42,64,45,88,34,46,8,112,69,43,6,6,73,30,43
"2021","Broadland 001A","E01026499",789,361,199,162,403,112,164,71,62,31,50,27,21,2,75,51,24,2,2,25,9,16
"2021","Broadland 001B","E01026500",734,211,144,67,513,146,244,101,101,42,69,37,24,8,54,35,19,0,0,10,4,6
"2021","Broadland 001C","E01026501",711,203,116,87,466,116,228,108,75,45,78,41,30,7,44,30,14,0,0,42,20,22
"2021","Broadland 001D","E01026502",904,236,122,114,652,126,284,116,127,41,126,73,49,4,113,88,25,3,3,16,5,11
"2021","Broadland 001E","E01026503",935,253,163,90,651,163,274,102,134,38,122,59,61,2,88,52,36,4,4,31,17,14
"2021","Broadland 002A","E01026522",631,184,84,100,417,83,214,86,87,41,65,36,23,6,50,30,20,5,5,30,10,20
"2021","Broadland 002B","E01026523",792,205,102,103,554,102,267,120,100,47,99,42,45,12,85,44,41,1,1,33,11,22
"2021","Broadland 002C","E01026524",640,173,91,82,431,100,218,98,78,42,75,40,31,4,37,25,12,1,1,36,17,19
"2021","Broadland 002D","E01026525",536,122,61,61,381,107,179,81,65,33,66,36,24,6,26,16,10,3,3,33,13,20
"2021","Broadland 002E","E01026547",641,201,121,80,416,99,183,81,66,36,70,38,26,6,63,37,26,1,1,24,11,13
"2021","Broadland 002F","E01026548",565,153,111,42,397,84,184,71,77,36,70,39,28,3,57,41,16,2,2,15,5,10
"2021","Broadland 003A","E01026514",638,141,73,68,472,87,248,112,91,45,78,44,26,8,56,32,24,3,3,25,11,14
"2021","Broadland 003B","E01026515",489,124,77,47,338,68,194,82,72,40,52,30,21,1,22,14,8,2,2,27,9,18
"2021","Broadland 003C","E01026516",542,167,77,90,353,71,168,58,72,38,55,31,22,2,57,31,26,2,2,22,9,13
"2021","Broadland 003D","E01026517",696,178,103,75,492,128,229,99,84,46,83,50,30,3,50,30,20,2,2,26,12,14
"2021","Broadland 004A","E01026533",545,149,92,57,365,102,199,87,77,35,38,22,10,6,26,9,17,0,0,31,13,18
"2021","Broadland 004B","E01026534",653,121,62,59,501,83,270,109,107,54,84,37,42,5,60,35,25,4,4,31,13,18
"2021","Broadland 004C","E01026535",958,235,92,143,686,86,338,114,172,52,144,85,52,7,116,77,39,2,2,37,13,24
"2021","Broadland 004D","E01026536",777,181,95,86,563,93,278,93,126,59,108,61,36,11,83,59,24,1,1,33,8,25
"2021","Broadland 004E","E01026537",581,115,41,74,455,45,252,84,123,45,96,51,39,6,61,37,24,1,1,11,5,6
"2021","Broadland 005A","E01026549",821,272,147,125,523,115,263,110,103,50,88,45,41,2,52,30,22,5,5,26,7,19
"2021","Broadland 005B","E01026550",436,92,48,44,330,46,168,60,78,30,67,33,27,7,47,27,20,2,2,14,5,9
"2021","Broadland 005C","E01026551",514,141,87,54,364,83,190,76,74,40,60,36,20,4,30,18,12,1,1,9,2,7
"2021","Broadland 005D","E01026552",610,167,105,62,421,128,209,95,66,48,50,27,16,7,33,17,16,1,1,22,9,13
"2021","Broadland 006A","E01026562",457,91,54,37,347,54,214,74,106,34,45,20,21,4,34,21,13,0,0,19,5,14
"2021","Broadland 006B","E01026563",577,153,38,115,409,30,217,77,101,39,93,50,40,3,68,53,15,1,1,15,6,9
"2021","Broadland 006C","E01026564",595,123,61,62,443,64,254,85,123,46,75,32,36,7,48,32,16,2,2,29,12,17
"2021","Broadland 006D","E01026565",524,183,35,148,327,31,139,56,64,19,91,57,32,2,64,41,23,2,2,14,4,10
"2021","Broadland 006E","E01026566",640,203,90,113,409,90,198,79,92,27,65,37,25,3,53,33,20,3,3,28,12,16
"2021","Broadland 006F","E01026567",757,249,201,48,497,191,223,90,90,43,51,28,20,3,32,13,19,0,0,11,4,7
"2021","Broadland 006G","E01026568",626,127,70,57,488,96,283,99,129,55,59,29,27,3,49,32,17,1,1,11,6,5
"2021","Broadland 007A","E01026518",542,144,64,80,377,35,211,67,112,32,72,34,38,0,57,30,27,2,2,21,11,10
"2021","Broadland 007B","E01026519",744,243,71,172,470,43,232,81,116,35,112,72,34,6,80,49,31,3,3,31,11,20
"2021","Broadland 007C","E01026520",498,150,107,43,330,106,154,71,45,38,39,18,21,0,31,12,19,0,0,18,5,13
"2021","Broadland 007D","E01026521",516,115,87,28,385,130,198,66,95,37,33,20,12,1,23,13,10,1,1,16,3,13
"2021","Broadland 008A","E01026545",854,178,51,127,645,98,305,97,162,46,155,80,66,9,87,60,27,0,0,31,7,24
"2021","Broadland 008B","E01026546",603,139,91,48,442,119,258,100,113,45,44,27,13,4,19,13,6,2,2,22,8,14
"2021","Broadland 008C","E01026578",854,197,90,107,615,99,312,98,175,39,118,68,40,10,82,44,38,4,4,42,18,24
"2021","Broadland 008D","E01026579",690,160,91,69,502,138,243,106,93,44,81,43,32,6,40,23,17,0,0,28,7,21
"2021","Broadland 008E","E01026580",809,223,154,69,549,150,256,121,94,41,74,45,23,6,68,38,30,1,1,37,13,24
"2021","Broadland 009A","E01026540",645,186,128,58,438,135,214,100,73,41,54,33,18,3,34,14,20,1,1,21,11,10
"2021","Broadland 009B","E01026541",1063,320,145,175,695,93,325,116,167,42,144,67,67,10,130,87,43,3,3,48,14,34
"2021","Broadland 009C","E01026542",639,185,107,78,429,96,198,78,73,47,73,40,28,5,58,28,30,4,4,25,5,20
"2021","Broadland 009D","E01026543",674,181,96,85,469,118,229,108,84,37,77,47,28,2,43,19,24,2,2,24,9,15
"2021","Broadland 009E","E01026544",787,224,102,122,531,90,256,110,105,41,121,76,40,5,62,35,27,2,2,32,12,20
"2021","Broadland 010A","E01026526",646,223,141,82,405,116,188,83,69,36,63,38,20,5,36,17,19,2,2,18,6,12
"2021","Broadland 010B","E01026527",642,197,151,46,423,139,184,78,66,40,62,31,24,7,35,14,21,3,3,22,11,11
"2021","Broadland 010C","E01026528",596,174,119,55,393,87,200,80,74,46,56,26,25,5,49,28,21,1,1,29,9,20
"2021","Broadland 010D","E01026529",728,245,115,130,462,101,211,90,77,44,89,41,43,5,57,35,22,4,4,21,11,10
"2021","Broadland 011A","E01026530",813,229,115,114,540,115,272,112,118,42,96,61,29,6,54,25,29,3,3,44,13,31
"2021","Broadland 011B","E01026531",827,241,166,75,545,120,273,109,109,55,106,60,40,6,46,20,26,0,0,41,15,26
"2021","Broadland 011C","E01026532",748,238,120,118,483,99,232,83,99,50,94,53,35,6,56,28,28,2,2,27,13,14
"2021","Broadland 012A","E01026553",607,230,108,122,357,65,174,67,71,36,68,38,27,3,48,26,22,2,2,20,8,12
"2021","Broadland 012B","E01026554",493,131,70,61,346,77,163,78,57,28,72,46,22,4,32,14,18,2,2,16,4,12
"2021","Broadland 012C","E01026555",609,138,73,65,434,91,209,83,88,38,64,27,32,5,68,43,25,2,2,37,15,22
"2021","Broadland 012D","E01026556",655,210,91,119,423,91,175,67,81,27,94,54,35,5,63,41,22,0,0,22,11,11
"2021","Broadland 013A","E01026557",625,221,127,94,379,108,182,68,76,38,57,33,21,3,31,11,20,1,1,25,6,19
"2021","Broadland 013B","E01026558",1075,359,128,231,687,112,263,115,116,32,233,155,67,11,70,45,25,9,9,29,14,15
"2021","Broadland 013C","E01026559",612,148,84,64,446,110,238,94,91,53,70,29,33,8,26,12,14,2,2,18,6,12
"2021","Broadland 013D","E01026560",616,193,133,60,401,113,187,86,59,42,69,37,28,4,31,18,13,1,1,22,10,12
"2021","Broadland 013F","E01034765",678,154,22,132,495,16,215,60,135,20,162,104,53,5,99,79,20,3,3,29,12,17
"2021","Broadland 013G","E01034766",748,256,148,108,470,147,193,84,65,44,67,35,27,5,60,34,26,3,3,22,10,12
"2021","Broadland 014A","E01026504",629,145,82,63,453,122,229,116,73,40,56,35,19,2,43,17,26,3,3,31,14,17
"2021","Broadland 014B","E01026505",868,241,128,113,597,101,265,103,123,39,133,74,52,7,88,64,24,10,10,30,19,11
"2021","Broadland 014C","E01026506",620,133,97,36,465,138,237,104,100,33,51,28,19,4,35,15,20,4,4,22,10,12
"2021","Broadland 014D","E01026507",612,139,80,59,456,114,227,90,105,32,63,32,24,7,52,35,17,0,0,17,7,10
"2021","Broadland 014E","E01026512",567,148,91,57,392,97,173,75,69,29,67,37,25,5,52,38,14,3,3,27,8,19
"2021","Broadland 014F","E01026513",616,174,102,72,426,81,220,81,96,43,74,41,24,9,49,33,16,2,2,16,6,10
"2021","Broadland 015A","E01026569",723,289,177,112,413,92,207,92,91,24,68,33,31,4,45,28,17,1,1,21,7,14
"2021","Broadland 015B","E01026570",743,208,138,70,516,118,250,103,105,42,92,51,35,6,54,32,22,2,2,19,9,10
"2021","Broadland 015C","E01026571",661,177,113,64,455,91,228,95,90,43,90,50,35,5,44,19,25,2,2,29,6,23
"2021","Broadland 015D","E01026572",638,185,98,87,436,90,246,114,89,43,54,34,18,2,45,22,23,1,1,17,6,11
"2021","Broadland 015E","E01026573",632,217,94,123,397,80,173,59,81,33,69,29,33,7,73,39,34,2,2,18,7,11
"2021","Broadland 016A","E01026574",681,135,63,72,520,63,282,108,129,45,100,62,28,10,74,39,35,1,1,26,15,11
"2021","Broadland 016B","E01026575",795,274,142,132,493,102,219,93,99,27,89,39,44,6,79,46,33,4,4,28,10,18
"2021","Broadland 016C","E01026576",802,196,58,138,565,38,312,98,169,45,117,72,40,5,94,63,31,4,4,41,11,30
"2021","Broadland 016D","E01026577",776,271,113,158,484,90,236,108,97,31,97,60,33,4,56,36,20,5,5,21,3,18
"2021","Broadland 017A","E01026508",627,193,117,76,414,100,199,81,81,37,72,47,21,4,43,20,23,0,0,20,6,14
"2021","Broadland 017B","E01026509",825,206,123,83,595,119,295,111,131,53,103,60,35,8,74,53,21,4,4,24,11,13
"2021","Broadland 017C","E01026510",776,225,116,109,520,150,259,115,108,36,75,49,24,2,36,21,15,0,0,31,9,22
"2021","Broadland 017D","E01026511",495,112,55,57,358,71,190,85,59,46,59,28,22,9,36,22,14,2,2,25,13,12
"2021","Broadland 018A","E01026497",710,251,157,94,440,119,190,73,71,46,72,42,24,6,56,32,24,3,3,19,6,13
"2021","Broadland 018B","E01026498",605,206,139,67,367,91,135,59,50,26,72,35,29,8,67,38,29,2,2,32,8,24
"2021","Broadland 018C","E01026538",702,204,104,100,474,92,235,118,80,37,79,42,36,1,64,43,21,4,4,24,12,12
"2021","Broadland 018D","E01026539",683,157,92,65,497,105,256,113,96,47,93,44,42,7,41,22,19,2,2,29,13,16
"2021","Great Yarmouth 001A","E01026605",774,188,111,77,557,173,241,121,73,47,79,48,27,4,60,31,29,4,4,29,11,18
"2021","Great Yarmouth 001B","E01026606",664,202,123,79,430,131,194,104,42,48,51,29,19,3,53,20,33,1,1,32,12,20
"2021","Great Yarmouth 001C","E01026607",821,275,139,136,516,103,255,121,75,59,85,45,33,7,72,46,26,1,1,30,12,18
"2021","Great Yarmouth 001D","E01026627",630,175,123,52,438,122,210,108,41,61,60,33,22,5,43,22,21,3,3,17,5,12
"2021","Great Yarmouth 001E","E01026628",792,175,88,87,579,133,253,129,85,39,124,66,51,7,64,34,30,5,5,38,13,25
"2021","Great Yarmouth 001F","E01026629",665,199,117,82,440,87,213,89,76,48,81,39,36,6,57,32,25,2,2,26,7,19
"2021","Great Yarmouth 002A","E01026608",607,109,71,38,457,106,240,106,84,50,73,45,22,6,38,18,20,0,0,41,18,23
"2021","Great Yarmouth 002B","E01026609",510,128,58,70,350,64,188,82,63,43,62,33,23,6,34,23,11,2,2,32,11,21
"2021","Great Yarmouth 002C","E01026636",679,165,111,54,483,113,246,128,64,54,64,38,21,5,57,29,28,3,3,31,8,23
"2021","Great Yarmouth 002D","E01026637",923,236,139,97,655,192,292,147,90,55,108,56,47,5,57,35,22,6,6,32,14,18
"2021","Great Yarmouth 002E","E01026638",690,179,108,71,479,80,211,86,78,47,101,41,54,6,83,57,26,4,4,32,13,19
"2021","Great Yarmouth 003A","E01026589",601,198,112,86,380,70,177,72,63,42,77,35,38,4,56,35,21,0,0,23,9,14
"2021","Great Yarmouth 003B","E01026590",664,214,131,83,422,121,166,79,53,34,94,63,22,9,41,25,16,0,0,28,11,17
"2021","Great Yarmouth 003C","E01026591",795,223,155,68,546,157,231,114,67,50,91,58,25,8,65,25,40,2,2,26,8,18
"2021","Great Yarmouth 003D","E01026592",679,275,196,79,375,115,143,76,40,27,51,28,18,5,60,24,36,6,6,29,18,11
"2021","Great Yarmouth 003E","E01026593",619,183,137,46,399,119,185,93,54,38,56,29,21,6,38,16,22,1,1,37,20,17
"2021","Great Yarmouth 003F","E01026594",809,253,139,114,526,92,196,84,73,39,122,55,56,11,106,66,40,10,10,30,16,14
"2021","Great Yarmouth 004A","E01026599",589,201,70,131,334,34,133,44,58,31,84,34,43,7,78,56,22,5,5,54,26,28
"2021","Great Yarmouth 004B","E01026639",606,144,60,84,411,74,168,68,56,44,81,26,43,12,81,53,28,7,7,51,24,27
"2021","Great Yarmouth 004C","E01026640",740,297,214,83,417,127,176,76,59,41,65,24,29,12,47,29,18,2,2,26,11,15
"2021","Great Yarmouth 004D","E01026641",613,216,124,92,368,53,135,38,62,35,70,28,31,11,106,78,28,4,4,29,15,14
"2021","Great Yarmouth 005A","E01026595",845,360,109,251,442,45,130,54,45,31,100,43,51,6,159,124,35,8,8,43,21,22
"2021","Great Yarmouth 005B","E01026596",686,228,99,129,410,47,162,65,53,44,108,47,51,10,90,53,37,3,3,48,26,22
"2021","Great Yarmouth 005C","E01026597",1010,468,113,355,486,31,123,46,60,17,139,69,61,9,175,131,44,18,18,56,24,32
"2021","Great Yarmouth 005D","E01026598",857,349,72,277,413,26,123,47,58,18,123,67,51,5,131,107,24,10,10,95,32,63
"2021","Great Yarmouth 006A","E01026622",631,188,69,119,402,28,124,34,63,27,102,37,58,7,141,100,41,7,7,41,24,17
"2021","Great Yarmouth 006B","E01026623",827,337,77,260,414,30,140,69,58,13,109,65,39,5,124,89,35,11,11,76,26,50
"2021","Great Yarmouth 006C","E01026624",932,462,124,338,404,19,119,51,49,19,115,65,46,4,139,113,26,12,12,66,26,40
"2021","Great Yarmouth 006D","E01026625",794,313,90,223,431,21,84,29,39,16,117,32,78,7,203,158,45,6,6,50,31,19
"2021","Great Yarmouth 006E","E01026626",975,409,108,301,485,39,130,61,48,21,153,83,62,8,152,124,28,11,11,81,26,55
"2021","Great Yarmouth 007A","E01026600",668,249,122,127,394,55,149,56,56,37,95,36,54,5,87,53,34,8,8,25,18,7
"2021","Great Yarmouth 007B","E01026633",763,263,54,209,439,32,175,60,78,37,119,62,55,2,106,78,28,7,7,61,23,38
"2021","Great Yarmouth 007C","E01026634",623,193,78,115,373,30,140,60,54,26,95,36,54,5,103,71,32,5,5,57,26,31
"2021","Great Yarmouth 007D","E01026635",1059,388,96,292,599,32,180,56,91,33,159,67,85,7,217,159,58,11,11,72,37,35
"2021","Great Yarmouth 008A","E01026581",680,159,77,82,500,91,255,87,108,60,89,36,42,11,62,33,29,3,3,21,8,13
"2021","Great Yarmouth 008B","E01026582",920,295,161,134,604,166,283,110,120,53,108,60,40,8,45,29,16,2,2,21,7,14
"2021","Great Yarmouth 008C","E01026583",576,153,95,58,403,90,188,91,61,36,65,34,27,4,60,39,21,0,0,20,12,8
"2021","Great Yarmouth 008D","E01026584",667,167,122,45,477,169,194,75,75,44,66,34,25,7,47,26,21,1,1,23,8,15
"2021","Great Yarmouth 009A","E01026601",695,258,93,165,409,54,129,66,43,20,110,57,42,11,114,85,29,2,2,28,16,12
"2021","Great Yarmouth 009B","E01026602",737,244,148,96,466,99,182,65,76,41,94,45,40,9,88,58,30,3,3,27,11,16
"2021","Great Yarmouth 009C","E01026603",765,279,79,200,462,32,144,47,58,39,98,27,55,16,187,131,56,1,1,24,8,16
"2021","Great Yarmouth 009D","E01026604",731,270,99,171,422,35,135,45,49,41,91,33,49,9,153,114,39,8,8,39,13,26
"2021","Great Yarmouth 009E","E01026632",811,349,169,180,415,69,165,75,57,33,95,50,37,8,82,52,30,4,4,47,16,31
"2021","Great Yarmouth 010A","E01026610",662,218,72,146,406,52,157,59,66,32,109,50,52,7,85,54,31,3,3,38,15,23
"2021","Great Yarmouth 010B","E01026611",619,232,121,111,366,129,168,63,72,33,27,14,7,6,40,19,21,2,2,21,16,5
"2021","Great Yarmouth 010C","E01026612",1075,298,199,99,725,175,358,149,141,68,95,48,39,8,93,56,37,4,4,52,24,28
"2021","Great Yarmouth 010D","E01026630",666,194,88,106,426,47,190,76,69,45,84,34,39,11,100,64,36,5,5,46,21,25
"2021","Great Yarmouth 010E","E01026631",791,288,101,187,465,62,170,78,64,28,109,60,43,6,119,72,47,5,5,38,15,23
"2021","Great Yarmouth 011A","E01026617",581,178,113,65,382,71,160,79,57,24,72,23,44,5,74,37,37,5,5,21,9,12
"2021","Great Yarmouth 011B","E01026618",671,199,108,91,436,85,209,84,78,47,62,28,28,6,76,50,26,4,4,36,7,29
"2021","Great Yarmouth 011C","E01026619",599,160,65,95,411,33,157,52,76,29,86,24,46,16,135,96,39,0,0,28,12,16
"2021","Great Yarmouth 011D","E01026620",681,240,156,84,410,52,146,50,69,27,102,36,55,11,105,63,42,5,5,31,14,17
"2021","Great Yarmouth 011E","E01026621",562,105,63,42,421,57,184,64,78,42,87,28,47,12,90,53,37,3,3,36,20,16
"2021","Great Yarmouth 012A","E01026613",578,150,90,60,398,95,187,98,49,40,74,42,25,7,42,21,21,0,0,30,10,20
"2021","Great Yarmouth 012B","E01026614",862,330,181,149,494,119,239,139,53,47,91,48,38,5,45,25,20,0,0,38,13,25
"2021","Great Yarmouth 012C","E01026615",554,116,65,51,408,107,202,95,72,35,60,31,23,6,39,20,19,0,0,30,13,17
"2021","Great Yarmouth 012D","E01026616",492,120,62,58,352,56,168,69,70,29,80,31,45,4,48,30,18,0,0,20,9,11
"2021","Great Yarmouth 013C","E01026587",1188,259,113,146,887,113,428,138,220,70,242,110,118,14,101,71,30,3,3,42,23,19
"2021","Great Yarmouth 013D","E01026588",1170,382,212,170,735,164,364,171,123,70,119,62,51,6,86,50,36,2,2,53,21,32
"2021","Great Yarmouth 013E","E01034767",1075,399,271,128,642,156,248,113,83,52,124,55,53,16,110,69,41,4,4,34,9,25
"2021","King's Lynn and West Norfolk 001A","E01026680",847,350,240,110,477,179,169,91,48,30,64,34,22,8,61,33,28,4,4,20,10,10
"2021","King's Lynn and West Norfolk 001B","E01026681",625,210,135,75,407,157,179,110,26,43,41,27,13,1,27,15,12,3,3,8,3,5
"2021","King's Lynn and West Norfolk 001C","E01026682",553,214,151,63,313,131,110,69,27,14,38,30,7,1,32,16,16,2,2,26,9,17
"2021","King's Lynn and West Norfolk 001D","E01026683",671,315,170,145,326,81,112,63,28,21,68,46,19,3,61,41,20,4,4,30,11,19
"2021","King's Lynn and West Norfolk 002A","E01026645",591,208,129,79,359,137,135,82,29,24,53,31,17,5,32,15,17,2,2,24,8,16
"2021","King's Lynn and West Norfolk 002B","E01026646",750,279,187,92,455,130,208,112,60,36,54,29,20,5,58,33,25,5,5,16,4,12
"2021","King's Lynn and West Norfolk 002C","E01026656",810,242,135,107,538,155,222,105,76,41,90,50,33,7,66,39,27,5,5,30,14,16
"2021","King's Lynn and West Norfolk 002D","E01026695",978,279,155,124,659,170,306,150,95,61,113,65,41,7,67,40,27,3,3,40,15,25
"2021","King's Lynn and West Norfolk 003A","E01026676",813,277,203,74,512,199,208,123,53,32,62,37,22,3,43,21,22,0,0,24,11,13
"2021","King's Lynn and West Norfolk 003B","E01026677",719,289,185,104,405,104,174,83,48,43,65,31,32,2,61,31,30,1,1,25,4,21
"2021","King's Lynn and West Norfolk 003C","E01026678",766,253,168,85,496,183,190,107,41,42,75,49,23,3,47,19,28,1,1,17,6,11
"2021","King's Lynn and West Norfolk 003D","E01026701",834,261,184,77,549,228,209,125,51,33,60,37,21,2,52,27,25,0,0,24,11,13
"2021","King's Lynn and West Norfolk 003E","E01026702",624,222,140,82,381,116,148,73,55,20,60,33,24,3,55,37,18,2,2,21,9,12
"2021","King's Lynn and West Norfolk 003F","E01026703",499,122,70,52,357,102,168,96,41,31,49,24,20,5,38,15,23,0,0,20,11,9
"2021","King's Lynn and West Norfolk 004A","E01026653",869,261,203,58,576,229,221,112,63,46,80,45,26,9,45,18,27,1,1,32,13,19
"2021","King's Lynn and West Norfolk 004B","E01026654",748,284,189,95,447,142,158,71,58,29,66,29,30,7,78,56,22,3,3,17,6,11
"2021","King's Lynn and West Norfolk 004C","E01026655",674,212,150,62,444,146,189,85,67,37,66,38,21,7,41,20,21,2,2,18,8,10
"2021","King's Lynn and West Norfolk 004D","E01026718",1044,314,182,132,690,158,339,163,114,62,122,66,43,13,71,37,34,0,0,40,16,24
"2021","King's Lynn and West Norfolk 005A","E01026691",473,87,61,26,367,95,189,77,76,36,42,14,22,6,40,22,18,1,1,19,14,5
"2021","King's Lynn and West Norfolk 005B","E01026692",518,144,74,70,354,68,175,73,64,38,67,37,26,4,42,24,18,2,2,20,5,15
"2021","King's Lynn and West Norfolk 005C","E01026708",590,131,96,35,435,128,213,85,85,43,57,31,22,4,35,17,18,2,2,24,12,12
"2021","King's Lynn and West Norfolk 005D","E01026709",766,163,111,52,566,144,281,97,130,54,82,27,41,14,59,32,27,0,0,37,19,18
"2021","King's Lynn and West Norfolk 005E","E01026710",492,108,79,29,366,120,193,83,73,37,35,17,12,6,18,7,11,0,0,18,9,9
"2021","King's Lynn and West Norfolk 006A","E01026669",877,256,156,100,586,125,269,107,114,48,121,55,59,7,70,36,34,1,1,35,17,18
"2021","King's Lynn and West Norfolk 006B","E01026670",669,194,75,119,445,42,169,57,79,33,121,55,54,12,112,67,45,1,1,30,14,16
"2021","King's Lynn and West Norfolk 006C","E01026671",532,91,55,36,422,70,228,90,87,51,91,34,52,5,32,16,16,1,1,19,8,11
"2021","King's Lynn and West Norfolk 006D","E01026672",616,185,106,79,405,84,214,85,77,52,61,31,26,4,45,22,23,1,1,26,17,9
"2021","King's Lynn and West Norfolk 006E","E01026673",624,189,74,115,406,61,210,85,92,33,77,43,29,5,54,33,21,4,4,29,10,19
"2021","King's Lynn and West Norfolk 007A","E01026687",791,241,102,139,510,35,216,71,115,30,121,44,67,10,128,87,41,10,10,40,20,20
"2021","King's Lynn and West Norfolk 007B","E01026688",590,109,49,60,436,26,174,44,95,35,110,27,71,12,121,92,29,5,5,45,23,22
"2021","King's Lynn and West Norfolk 007C","E01026689",693,219,57,162,400,26,129,52,57,20,111,60,45,6,118,75,43,16,16,74,22,52
"2021","King's Lynn and West Norfolk 007D","E01026690",671,173,74,99,448,31,173,59,73,41,103,41,50,12,137,102,35,4,4,50,24,26
"2021","King's Lynn and West Norfolk 008A","E01026647",954,244,162,82,655,180,316,141,119,56,101,51,42,8,53,24,29,5,5,55,29,26
"2021","King's Lynn and West Norfolk 008B","E01026711",631,161,85,76,419,61,201,82,70,49,84,27,46,11,73,47,26,0,0,51,19,32
"2021","King's Lynn and West Norfolk 008C","E01026712",791,190,119,71,567,128,263,97,111,55,112,58,41,13,62,33,29,2,2,34,17,17
"2021","King's Lynn and West Norfolk 008D","E01026713",675,140,88,52,482,122,226,110,80,36,94,53,30,11,38,18,20,2,2,53,23,30
"2021","King's Lynn and West Norfolk 009A","E01026666",774,230,99,131,461,36,185,60,85,40,107,46,52,9,125,81,44,8,8,83,54,29
"2021","King's Lynn and West Norfolk 009B","E01026667",677,232,98,134,407,65,181,73,70,38,95,63,29,3,62,36,26,4,4,38,13,25
"2021","King's Lynn and West Norfolk 009C","E01026668",661,194,77,117,412,60,208,69,100,39,85,40,35,10,52,32,20,7,7,55,22,33
"2021","King's Lynn and West Norfolk 009D","E01026693",956,291,142,149,600,92,295,114,127,54,113,48,57,8,97,57,40,3,3,65,23,42
"2021","King's Lynn and West Norfolk 010A","E01026662",1093,259,64,195,748,22,289,82,177,30,220,82,122,16,207,154,53,10,10,86,40,46
"2021","King's Lynn and West Norfolk 010B","E01026663",710,218,120,98,437,51,190,47,101,42,74,17,49,8,118,75,43,4,4,55,21,34
"2021","King's Lynn and West Norfolk 010C","E01026664",966,302,95,207,605,50,317,105,180,32,125,71,47,7,97,62,35,16,16,59,27,32
"2021","King's Lynn and West Norfolk 010D","E01026714",894,209,97,112,626,99,352,136,156,60,98,54,39,5,72,50,22,5,5,59,25,34
"2021","King's Lynn and West Norfolk 011B","E01026699",962,575,168,407,341,25,107,47,55,5,110,64,45,1,89,65,24,10,10,46,12,34
"2021","King's Lynn and West Norfolk 011C","E01026700",760,390,122,268,313,30,87,42,34,11,116,71,40,5,74,52,22,6,6,57,20,37
"2021","King's Lynn and West Norfolk 011D","E01026704",720,202,66,136,453,30,170,54,74,42,118,44,67,7,125,98,27,10,10,65,32,33
"2021","King's Lynn and West Norfolk 011E","E01026705",715,176,79,97,500,70,220,78,102,40,114,39,65,10,94,64,30,2,2,39,16,23
"2021","King's Lynn and West Norfolk 011F","E01026706",861,243,87,156,546,61,223,80,119,24,146,73,67,6,109,75,34,7,7,72,17,55
"2021","King's Lynn and West Norfolk 011G","E01034768",657,375,150,225,254,46,68,42,16,10,78,53,21,4,55,40,15,7,7,28,7,21
"2021","King's Lynn and West Norfolk 011H","E01034769",576,309,110,199,211,21,68,36,21,11,66,44,18,4,49,33,16,7,7,56,15,41
"2021","King's Lynn and West Norfolk 012A","E01026665",1069,286,169,117,732,164,349,150,133,66,116,59,45,12,100,65,35,3,3,51,20,31
"2021","King's Lynn and West Norfolk 012B","E01026674",512,127,82,45,367,104,168,84,47,37,57,27,24,6,35,16,19,3,3,18,7,11
"2021","King's Lynn and West Norfolk 012C","E01026675",542,143,84,59,379,81,181,73,75,33,80,39,34,7,36,24,12,1,1,20,5,15
"2021","King's Lynn and West Norfolk 012D","E01026694",1186,353,191,162,788,183,359,171,119,69,139,74,51,14,103,56,47,4,4,45,17,28
"2021","King's Lynn and West Norfolk 013A","E01026684",551,109,54,55,399,79,206,96,67,43,70,33,30,7,43,23,20,1,1,43,23,20
"2021","King's Lynn and West Norfolk 013B","E01026685",557,159,103,56,360,85,158,85,42,31,72,32,33,7,43,23,20,2,2,38,11,27
"2021","King's Lynn and West Norfolk 013C","E01026719",997,221,110,111,707,110,349,147,125,77,172,83,81,8,73,45,28,3,3,69,35,34
"2021","King's Lynn and West Norfolk 013D","E01026720",572,134,86,48,407,80,209,85,67,57,74,30,39,5,41,26,15,3,3,31,16,15
"2021","King's Lynn and West Norfolk 013E","E01026721",579,141,83,58,379,79,180,76,65,39,70,37,27,6,48,26,22,2,2,59,34,25
"2021","King's Lynn and West Norfolk 014A","E01026642",617,178,108,70,413,105,205,88,74,43,59,34,25,0,41,23,18,3,3,26,9,17
"2021","King's Lynn and West Norfolk 014B","E01026643",611,143,89,54,443,115,220,119,55,46,67,34,28,5,39,20,19,2,2,25,10,15
"2021","King's Lynn and West Norfolk 014C","E01026644",480,67,6,61,408,13,290,75,200,15,72,49,22,1,29,23,6,4,4,5,2,3
"2021","King's Lynn and West Norfolk 014D","E01026723",683,135,87,48,513,120,285,112,120,53,60,28,31,1,45,22,23,3,3,35,18,17
"2021","King's Lynn and West Norfolk 014E","E01026724",793,195,121,74,557,128,276,125,96,55,82,35,41,6,69,34,35,2,2,41,18,23
"2021","King's Lynn and West Norfolk 014F","E01026725",647,156,100,56,455,107,225,115,64,46,78,48,23,7,45,26,19,0,0,36,11,25
"2021","King's Lynn and West Norfolk 015A","E01026696",491,115,62,53,343,62,156,66,55,35,75,41,29,5,47,26,21,3,3,33,13,20
"2021","King's Lynn and West Norfolk 015B","E01026697",586,156,83,73,393,92,173,67,74,32,80,46,28,6,43,25,18,5,5,37,12,25
"2021","King's Lynn and West Norfolk 015C","E01026722",1123,316,146,170,762,133,362,130,159,73,167,89,73,5,95,57,38,5,5,45,21,24
"2021","King's Lynn and West Norfolk 015D","E01026726",922,198,114,84,669,136,325,150,120,55,134,72,55,7,72,30,42,2,2,55,15,40
"2021","King's Lynn and West Norfolk 016A","E01026659",724,226,124,102,447,86,201,86,81,34,89,37,48,4,68,44,24,3,3,51,26,25
"2021","King's Lynn and West Norfolk 016B","E01026660",755,174,109,65,540,121,251,112,79,60,101,53,43,5,64,34,30,3,3,41,17,24
"2021","King's Lynn and West Norfolk 016C","E01026661",676,153,98,55,478,98,237,90,85,62,90,45,37,8,46,21,25,7,7,45,17,28
"2021","King's Lynn and West Norfolk 016D","E01026715",672,162,75,87,461,91,235,107,67,61,84,45,32,7,48,29,19,3,3,49,24,25
"2021","King's Lynn and West Norfolk 016E","E01026716",833,212,109,103,572,99,281,133,89,59,118,67,42,9,70,38,32,4,4,49,25,24
"2021","King's Lynn and West Norfolk 016F","E01026717",698,160,75,85,496,72,277,144,76,57,98,40,54,4,44,26,18,5,5,42,18,24
"2021","King's Lynn and West Norfolk 017E","E01033036",652,152,79,73,470,82,248,84,121,43,76,42,31,3,63,35,28,1,1,30,13,17
"2021","King's Lynn and West Norfolk 017F","E01033037",634,159,43,116,444,34,212,63,112,37,109,58,49,2,89,71,18,0,0,31,14,17
"2021","King's Lynn and West Norfolk 017G","E01033038",987,407,159,248,539,59,212,90,96,26,163,88,66,9,101,73,28,4,4,41,22,19
"2021","King's Lynn and West Norfolk 017H","E01033039",492,169,91,78,290,69,125,52,53,20,59,42,16,1,36,16,20,1,1,33,9,24
"2021","King's Lynn and West Norfolk 017I","E01034770",595,217,153,64,363,138,133,70,36,27,64,38,21,5,26,13,13,2,2,15,4,11
"2021","King's Lynn and West Norfolk 017J","E01034771",618,179,99,80,414,82,165,78,80,7,95,48,47,0,71,40,31,1,1,25,8,17
"2021","King's Lynn and West Norfolk 017K","E01034772",634,264,213,51,357,183,119,81,24,14,38,23,13,2,17,8,9,0,0,13,4,9
"2021","King's Lynn and West Norfolk 017L","E01034773",667,281,224,57,367,145,147,72,36,39,40,24,13,3,35,17,18,0,0,19,9,10
"2021","King's Lynn and West Norfolk 018A","E01026679",1073,293,152,141,732,149,387,184,135,68,111,57,49,5,84,41,43,1,1,48,21,27
"2021","King's Lynn and West Norfolk 018B","E01026727",1149,290,176,114,801,196,405,201,134,70,127,73,50,4,71,33,38,2,2,58,22,36
"2021","King's Lynn and West Norfolk 018C","E01026728",1113,283,157,126,770,162,397,195,127,75,131,75,49,7,76,47,29,4,4,60,21,39
"2021","King's Lynn and West Norfolk 019A","E01026648",724,206,94,112,486,85,254,116,106,32,92,41,43,8,53,29,24,2,2,32,13,19
"2021","King's Lynn and West Norfolk 019B","E01026649",743,195,91,104,507,91,272,119,114,39,83,42,35,6,54,31,23,7,7,41,16,25
"2021","King's Lynn and West Norfolk 019C","E01026650",458,80,35,45,355,35,251,88,143,20,47,25,17,5,21,17,4,1,1,23,11,12
"2021","King's Lynn and West Norfolk 019D","E01026651",1085,268,141,127,758,133,395,191,144,60,143,74,64,5,83,49,34,4,4,59,23,36
"2021","King's Lynn and West Norfolk 019E","E01026652",582,134,70,64,410,75,193,80,68,45,91,46,35,10,50,34,16,1,1,38,15,23
"2021","North Norfolk 001A","E01026770",920,453,268,185,431,130,177,94,53,30,70,41,26,3,49,28,21,5,5,36,7,29
"2021","North Norfolk 001B","E01026771",717,255,164,91,444,115,223,109,74,40,50,27,19,4,54,30,24,2,2,18,3,15
"2021","North Norfolk 001C","E01026772",817,221,150,71,570,218,228,119,69,40,57,29,28,0,66,41,25,1,1,26,14,12
"2021","North Norfolk 001D","E01026773",964,284,207,77,645,241,241,114,88,39,85,30,50,5,74,38,36,4,4,35,12,23
"2021","North Norfolk 002A","E01026739",931,332,212,120,568,181,255,142,77,36,82,47,28,7,48,26,22,2,2,31,10,21
"2021","North Norfolk 002B","E01026763",599,225,124,101,360,85,141,61,54,26,77,32,36,9,54,30,24,3,3,14,6,8
"2021","North Norfolk 002C","E01026764",674,286,190,96,371,120,141,84,38,19,57,29,25,3,50,30,20,3,3,17,3,14
"2021","North Norfolk 002D","E01026765",630,161,93,68,451,132,212,113,63,36,58,30,25,3,45,23,22,4,4,18,4,14
"2021","North Norfolk 003A","E01026734",599,337,111,226,236,42,87,55,24,8,63,42,19,2,39,22,17,5,5,26,9,17
"2021","North Norfolk 003B","E01026735",676,355,159,196,292,107,86,55,22,9,57,43,12,2,39,27,12,3,3,29,9,20
"2021","North Norfolk 003C","E01026736",663,272,193,79,362,106,141,76,38,27,58,26,25,7,53,30,23,4,4,29,9,20
"2021","North Norfolk 003D","E01026777",638,196,127,69,411,130,173,95,45,33,57,28,28,1,47,31,16,4,4,31,14,17
"2021","North Norfolk 003E","E01026778",743,345,264,81,386,162,133,75,32,26,45,26,11,8,43,23,20,3,3,12,3,9
"2021","North Norfolk 003F","E01026779",545,139,79,60,381,67,152,48,80,24,80,31,41,8,78,42,36,4,4,25,6,19
"2021","North Norfolk 004A","E01026741",863,270,200,70,555,211,238,145,53,40,63,39,21,3,43,19,24,0,0,38,4,34
"2021","North Norfolk 004B","E01026742",870,351,254,97,502,230,168,108,46,14,65,34,27,4,38,27,11,1,1,17,6,11
"2021","North Norfolk 004C","E01026743",1138,495,302,193,608,165,224,116,74,34,105,53,48,4,109,65,44,5,5,35,9,26
"2021","North Norfolk 005B","E01026766",1051,273,135,138,726,161,364,196,114,54,128,74,45,9,66,39,27,7,7,52,16,36
"2021","North Norfolk 005C","E01026781",966,297,171,126,627,205,292,165,74,53,78,46,27,5,49,19,30,3,3,42,15,27
"2021","North Norfolk 005D","E01034774",600,213,142,71,362,136,157,96,33,28,39,27,9,3,28,14,14,2,2,25,9,16
"2021","North Norfolk 005E","E01034775",634,184,96,88,417,104,188,96,56,36,75,32,35,8,49,33,16,1,1,33,6,27
"2021","North Norfolk 006C","E01026733",1067,302,173,129,723,186,333,153,114,66,109,56,48,5,91,60,31,4,4,42,13,29
"2021","North Norfolk 006D","E01026737",1057,286,170,116,728,189,372,166,132,74,114,68,39,7,49,27,22,4,4,43,13,30
"2021","North Norfolk 006E","E01034776",1051,308,207,101,702,224,319,164,89,66,94,59,25,10,63,34,29,2,2,41,15,26
"2021","North Norfolk 007A","E01026738",1081,285,167,118,743,242,331,167,105,59,94,60,26,8,74,40,34,2,2,53,25,28
"2021","North Norfolk 007B","E01026750",685,283,142,141,378,111,164,93,48,23,48,27,20,1,55,29,26,0,0,24,9,15
"2021","North Norfolk 007C","E01026751",697,264,169,95,399,147,139,70,44,25,66,28,33,5,46,22,24,1,1,34,12,22
"2021","North Norfolk 007D","E01026752",688,216,104,112,442,109,217,112,62,43,61,35,22,4,53,28,25,2,2,30,11,19
"2021","North Norfolk 008A","E01026729",998,287,140,147,665,160,311,164,104,43,105,60,37,8,83,43,40,6,6,46,12,34
"2021","North Norfolk 008B","E01026730",1158,352,188,164,759,178,337,147,129,61,133,69,56,8,108,73,35,3,3,47,21,26
"2021","North Norfolk 008C","E01026788",569,165,120,45,380,104,174,94,53,27,65,35,24,6,32,19,13,5,5,24,8,16
"2021","North Norfolk 009A","E01026780",1193,326,155,171,830,140,369,172,133,64,217,114,94,9,102,60,42,2,2,37,15,22
"2021","North Norfolk 009B","E01026782",993,332,179,153,623,159,293,152,96,45,106,58,41,7,62,30,32,3,3,38,11,27
"2021","North Norfolk 009C","E01026787",467,130,53,77,318,53,156,67,58,31,59,41,16,2,48,23,25,2,2,19,7,12
"2021","North Norfolk 011A","E01026745",847,291,167,124,522,115,228,96,88,44,108,41,56,11,67,38,29,4,4,34,17,17
"2021","North Norfolk 011B","E01026746",796,269,135,134,491,120,218,96,80,42,91,46,35,10,57,32,25,5,5,36,16,20
"2021","North Norfolk 011C","E01026747",692,311,130,181,351,68,124,57,52,15,80,48,29,3,75,42,33,4,4,30,9,21
"2021","North Norfolk 011D","E01026748",710,203,152,51,485,169,202,113,51,38,60,28,29,3,53,27,26,1,1,22,9,13
"2021","North Norfolk 011E","E01026749",728,273,150,123,435,75,168,62,78,28,103,53,43,7,84,53,31,5,5,20,10,10
"2021","North Norfolk 012A","E01026740",1120,340,192,148,728,187,365,224,92,49,113,72,36,5,57,30,27,6,6,52,17,35
"2021","North Norfolk 012B","E01026767",549,130,75,55,401,108,189,102,58,29,66,35,25,6,38,18,20,0,0,18,10,8
"2021","North Norfolk 012C","E01026768",573,161,39,122,389,40,169,53,93,23,111,67,44,0,64,48,16,5,5,23,8,15
"2021","North Norfolk 012D","E01026789",506,121,58,63,355,77,188,94,60,34,55,34,19,2,35,17,18,0,0,30,12,18
"2021","North Norfolk 012E","E01026790",484,110,59,51,346,62,195,98,62,35,48,25,20,3,38,20,18,3,3,28,10,18
"2021","North Norfolk 013A","E01026774",739,184,101,83,516,124,246,117,92,37,87,46,31,10,57,37,20,2,2,39,21,18
"2021","North Norfolk 013B","E01026775",587,206,116,90,348,73,122,51,44,27,81,32,45,4,71,47,24,1,1,33,15,18
"2021","North Norfolk 013C","E01026776",964,470,221,249,466,116,180,88,60,32,92,62,24,6,73,43,30,5,5,28,7,21
"2021","North Norfolk 013D","E01026786",960,294,150,144,625,163,294,177,65,52,104,70,27,7,61,27,34,3,3,41,13,28
"2021","North Norfolk 014A","E01026744",1095,340,219,121,716,246,283,136,92,55,115,63,44,8,67,37,30,5,5,39,12,27
"2021","North Norfolk 014B","E01026769",993,289,183,106,674,217,330,187,90,53,84,53,27,4,39,18,21,4,4,30,10,20
"2021","North Norfolk 014C","E01026783",854,252,162,90,570,198,236,127,55,54,86,48,32,6,48,19,29,2,2,32,13,19
"2021","North Norfolk 014D","E01026784",486,165,98,67,299,60,148,72,49,27,47,20,26,1,44,22,22,0,0,22,8,14
"2021","North Norfolk 014E","E01026785",626,181,116,65,420,125,200,111,58,31,58,34,18,6,35,13,22,2,2,25,6,19
"2021","North Norfolk 015D","E01026753",783,355,201,154,398,81,157,67,52,38,64,34,26,4,93,65,28,3,3,30,18,12
"2021","North Norfolk 015C","E01026754",638,222,101,121,388,64,177,79,66,32,74,39,32,3,71,49,22,2,2,28,11,17
"2021","North Norfolk 015E","E01026755",566,168,128,40,373,154,163,82,42,39,35,21,12,2,21,9,12,0,0,25,9,16
"2021","North Norfolk 015B","E01026756",593,221,128,93,360,61,134,45,56,33,73,28,38,7,87,57,30,5,5,12,4,8
"2021","North Norfolk 015A","E01026757",673,219,97,122,435,95,196,90,70,36,85,49,35,1,59,37,22,0,0,19,5,14
"2021","North Norfolk 016B","E01026758",681,282,116,166,383,89,154,74,54,26,77,51,24,2,61,43,18,2,2,16,4,12
"2021","North Norfolk 016C","E01026759",612,209,114,95,381,81,160,60,65,35,85,44,37,4,53,33,20,2,2,22,8,14
"2021","North Norfolk 016D","E01026760",850,278,115,163,543,88,240,100,98,42,132,78,50,4,78,46,32,5,5,29,13,16
"2021","North Norfolk 016A","E01026761",747,289,176,113,428,118,158,62,58,38,65,29,31,5,86,51,35,1,1,30,8,22
"2021","Norwich 001A","E01026797",1179,392,91,301,697,42,345,119,191,35,182,105,74,3,119,79,40,9,9,90,33,57
"2021","Norwich 001B","E01026798",691,264,80,184,390,38,133,46,60,27,90,31,52,7,127,88,39,2,2,37,13,24
"2021","Norwich 001C","E01026799",650,185,60,125,430,39,190,50,101,39,95,52,37,6,98,63,35,8,8,35,12,23
"2021","Norwich 001D","E01026800",948,393,112,281,468,31,165,64,80,21,131,68,58,5,135,103,32,6,6,87,16,71
"2021","Norwich 001E","E01026801",681,202,102,100,450,100,224,83,97,44,79,45,29,5,43,23,20,4,4,29,11,18
"2021","Norwich 001F","E01026802",804,340,93,247,415,47,154,55,72,27,110,65,38,7,92,63,29,12,12,49,14,35
"2021","Norwich 002A","E01026828",679,194,62,132,443,34,183,56,90,37,100,33,60,7,124,81,43,2,2,42,14,28
"2021","Norwich 002B","E01026829",921,287,59,228,516,43,180,66,97,17,153,73,67,13,130,102,28,10,10,118,21,97
"2021","Norwich 002C","E01026830",684,305,112,193,327,46,107,41,55,11,84,43,38,3,81,51,30,9,9,52,15,37
"2021","Norwich 002D","E01026831",674,272,56,216,328,21,122,51,57,14,142,108,31,3,38,21,17,5,5,74,9,65
"2021","Norwich 002E","E01026832",516,98,40,58,382,34,169,44,84,41,84,22,50,12,91,55,36,4,4,36,12,24
"2021","Norwich 002F","E01026833",733,307,103,204,393,17,116,38,69,9,113,41,59,13,141,94,47,6,6,33,9,24
"2021","Norwich 002G","E01026834",672,206,87,119,423,42,174,58,86,30,105,56,44,5,97,62,35,5,5,43,20,23
"2021","Norwich 003A","E01026841",733,287,50,237,365,17,108,49,48,11,175,139,35,1,56,39,17,9,9,81,14,67
"2021","Norwich 003B","E01026842",879,367,94,273,455,27,203,96,86,21,161,114,45,2,55,34,21,9,9,57,11,46
"2021","Norwich 003C","E01026843",920,361,116,245,504,48,210,92,81,37,148,94,50,4,90,59,31,8,8,55,16,39
"2021","Norwich 003D","E01026844",875,347,63,284,476,44,163,62,79,22,141,79,57,5,119,78,41,9,9,52,22,30
"2021","Norwich 003E","E01026845",801,293,49,244,434,11,139,64,61,14,193,156,35,2,80,61,19,11,11,74,10,64
"2021","Norwich 003F","E01026846",886,335,50,285,432,22,145,60,68,17,165,126,34,5,83,56,27,17,17,119,15,104
"2021","Norwich 004A","E01026803",660,209,94,115,414,46,162,50,79,33,96,45,45,6,106,71,35,4,4,37,15,22
"2021","Norwich 004B","E01026804",635,174,98,76,426,86,188,70,83,35,74,24,45,5,74,46,28,4,4,35,16,19
"2021","Norwich 004C","E01026805",655,214,107,107,424,46,180,55,82,43,88,33,46,9,106,83,23,4,4,17,6,11
"2021","Norwich 004D","E01026806",506,139,78,61,343,87,146,74,47,25,63,39,19,5,43,21,22,4,4,24,4,20
"2021","Norwich 004E","E01026807",554,170,62,108,335,32,140,52,68,20,90,49,32,9,69,42,27,4,4,49,13,36
"2021","Norwich 004F","E01026808",521,181,49,132,308,10,130,35,74,21,72,34,30,8,90,58,32,6,6,32,9,23
"2021","Norwich 004G","E01026809",751,340,134,206,381,46,125,46,64,15,96,45,43,8,110,72,38,4,4,30,10,20
"2021","Norwich 005A","E01026791",667,244,76,168,366,37,147,59,69,19,85,41,41,3,93,61,32,4,4,57,18,39
"2021","Norwich 005B","E01026792",618,200,97,103,378,65,154,58,63,33,80,40,32,8,78,49,29,1,1,40,8,32
"2021","Norwich 005C","E01026793",640,125,51,74,406,32,170,37,97,36,84,21,50,13,112,75,37,8,8,109,20,89
"2021","Norwich 005D","E01026794",839,228,86,142,550,59,274,111,121,42,125,59,53,13,88,61,27,4,4,61,21,40
"2021","Norwich 005F","E01026796",668,157,67,90,315,28,110,40,48,22,82,31,44,7,88,67,21,7,7,196,16,180
"2021","Norwich 005G","E01033435",767,198,27,171,402,13,204,66,114,24,115,73,37,5,61,41,20,9,9,167,14,153
"2021","Norwich 005H","E01033436",825,278,140,138,436,46,170,51,92,27,108,45,54,9,107,75,32,5,5,111,22,89
"2021","Norwich 006A","E01026863",806,231,83,148,428,51,181,67,92,22,119,76,37,6,64,41,23,13,13,147,14,133
"2021","Norwich 006B","E01026864",671,197,77,120,432,69,186,74,79,33,100,50,43,7,74,51,23,3,3,42,16,26
"2021","Norwich 006C","E01026865",807,254,89,165,441,17,153,43,86,24,116,56,53,7,151,107,44,4,4,112,20,92
"2021","Norwich 006D","E01026866",839,324,81,243,405,53,148,63,62,23,119,94,25,0,81,55,26,4,4,110,9,101
"2021","Norwich 006E","E01026867",567,129,44,85,347,30,141,33,74,34,71,18,44,9,101,76,25,4,4,91,20,71
"2021","Norwich 006F","E01026868",588,112,41,71,357,23,118,29,68,21,98,29,63,6,113,77,36,5,5,119,12,107
"2021","Norwich 006G","E01026869",680,267,78,189,351,30,139,36,73,30,73,29,42,2,105,71,34,4,4,62,21,41
"2021","Norwich 009A","E01026835",668,249,77,172,324,30,136,54,70,12,103,79,21,3,52,36,16,3,3,95,5,90
"2021","Norwich 009B","E01026836",637,182,50,132,373,61,175,59,96,20,98,67,24,7,36,23,13,3,3,82,8,74
"2021","Norwich 009C","E01026837",792,377,99,278,360,63,156,83,64,9,99,82,14,3,36,27,9,6,6,55,3,52
"2021","Norwich 009D","E01026838",643,159,65,94,400,45,199,75,105,19,102,69,31,2,50,38,12,4,4,84,6,78
"2021","Norwich 009E","E01026839",675,201,35,166,328,20,134,46,73,15,120,91,26,3,47,30,17,7,7,146,2,144
"2021","Norwich 009F","E01026840",767,245,68,177,428,33,157,71,71,15,164,121,40,3,71,52,19,3,3,94,5,89
"2021","Norwich 010A","E01026858",732,289,140,149,311,38,96,18,56,22,72,42,27,3,94,54,40,11,11,132,10,122
"2021","Norwich 010B","E01026859",645,191,74,117,388,45,157,41,87,29,71,26,43,2,112,77,35,3,3,66,9,57
"2021","Norwich 010C","E01026860",470,131,72,59,220,37,98,25,51,22,29,13,13,3,50,31,19,6,6,119,10,109
"2021","Norwich 010D","E01026861",542,106,42,64,276,28,110,29,49,32,56,12,39,5,75,44,31,7,7,160,7,153
"2021","Norwich 010E","E01026862",508,128,88,40,302,41,136,39,74,23,62,21,34,7,61,37,24,2,2,78,8,70
"2021","Norwich 011A","E01026852",608,223,120,103,364,76,194,79,85,30,61,37,19,5,31,15,16,2,2,21,8,13
"2021","Norwich 011B","E01026853",1087,571,217,354,433,43,168,69,87,12,122,87,26,9,91,69,22,9,9,83,15,68
"2021","Norwich 011D","E01026855",853,346,120,226,421,56,190,75,89,26,107,89,18,0,60,24,36,8,8,86,10,76
"2021","Norwich 011E","E01026856",861,323,79,244,378,33,129,58,58,13,155,124,29,2,54,31,23,7,7,160,7,153
"2021","Norwich 011F","E01026857",748,282,162,120,371,66,159,61,78,20,80,52,23,5,63,43,20,3,3,95,7,88
"2021","Norwich 011G","E01033434",665,347,79,268,260,17,98,48,38,12,101,90,8,3,37,23,14,7,7,58,7,51
"2021","Norwich 011H","E01033437",791,458,140,318,299,27,102,31,52,19,71,40,23,8,92,68,24,7,7,34,10,24
"2021","Norwich 012A","E01026810",741,265,175,90,417,123,186,73,88,25,63,39,22,2,39,32,7,6,6,59,10,49
"2021","Norwich 012B","E01026811",721,220,166,54,469,135,231,96,105,30,62,39,19,4,39,19,20,2,2,32,7,25
"2021","Norwich 012C","E01026812",711,204,103,101,477,103,248,87,119,42,81,51,26,4,42,26,16,3,3,30,9,21
"2021","Norwich 012D","E01026813",640,177,130,47,438,144,220,86,102,32,43,26,15,2,31,19,12,0,0,25,10,15
"2021","Norwich 012E","E01026814",648,193,103,90,324,49,129,35,66,28,60,26,33,1,78,46,32,8,8,131,15,116
"2021","Norwich 012F","E01026815",659,199,95,104,401,84,211,80,105,26,68,44,22,2,36,28,8,2,2,59,5,54
"2021","Norwich 013A","E01026816",1016,499,195,304,454,51,175,77,79,19,156,119,32,5,63,44,19,9,9,63,12,51
"2021","Norwich 013B","E01026817",738,306,141,165,399,85,123,42,56,25,98,54,40,4,89,57,32,4,4,33,11,22
"2021","Norwich 013C","E01026818",654,180,81,99,424,43,145,49,72,24,106,44,49,13,126,87,39,4,4,50,17,33
"2021","Norwich 013D","E01026819",638,216,48,168,382,25,145,54,70,21,96,44,47,5,109,77,32,7,7,40,13,27
"2021","Norwich 013E","E01026820",798,253,133,120,505,55,187,61,88,38,125,42,75,8,132,97,35,6,6,40,18,22
"2021","Norwich 013F","E01026821",712,249,115,134,427,53,150,44,77,29,113,39,67,7,105,72,33,6,6,36,15,21
"2021","Norwich 014A","E01033438",1177,735,282,453,361,60,121,60,49,12,124,112,11,1,49,25,24,7,7,81,8,73
"2021","Norwich 014C","E01033440",921,479,55,424,368,15,154,76,73,5,129,112,17,0,53,38,15,17,17,74,8,66
"2021","Norwich 014D","E01033441",847,441,72,369,336,28,132,72,53,7,131,118,12,1,30,19,11,15,15,70,4,66
"2021","Norwich 014E","E01035137",635,398,34,364,199,9,71,45,20,6,82,76,5,1,34,21,13,3,3,38,5,33
"2021","Norwich 014F","E01035138",723,406,39,367,274,13,75,45,23,7,134,113,17,4,43,34,9,9,9,43,1,42
"2021","Norwich 015A","E01026848",1016,523,154,369,427,40,108,48,49,11,119,58,48,13,150,104,46,10,10,66,13,53
"2021","Norwich 015B","E01026849",994,461,101,360,491,63,201,102,84,15,174,149,22,3,46,23,23,7,7,42,3,39
"2021","Norwich 015C","E01026850",1007,401,103,298,537,42,188,101,73,14,185,133,51,1,114,74,40,8,8,69,11,58
"2021","Norwich 016D","E01026824",983,504,133,371,402,32,119,49,58,12,122,72,46,4,109,79,30,20,20,77,7,70
"2021","Norwich 016A","E01026825",776,371,93,278,319,27,105,55,39,11,120,91,26,3,61,45,16,6,6,86,11,75
"2021","Norwich 016B","E01026826",986,590,164,426,336,17,91,44,38,9,148,113,29,6,74,48,26,6,6,60,10,50
"2021","Norwich 016C","E01026827",957,547,207,340,360,38,108,43,56,9,106,64,40,2,99,82,17,9,9,50,15,35
"2021","Norwich 017A","E01026823",1269,690,149,541,456,60,151,100,44,7,164,149,13,2,68,41,27,13,13,123,11,112
"2021","Norwich 017B","E01035139",902,534,166,368,297,41,80,47,26,7,124,107,17,0,44,29,15,8,8,71,2,69
"2021","Norwich 017C","E01035140",732,434,105,329,264,25,75,36,35,4,103,89,13,1,52,36,16,9,9,34,3,31
"2021","South Norfolk 002A","E01026881",808,261,82,179,514,78,274,94,157,23,86,55,31,0,71,56,15,5,5,33,12,21
"2021","South Norfolk 002C","E01026883",883,178,98,80,653,131,319,127,148,44,140,82,49,9,59,38,21,4,4,52,19,33
"2021","South Norfolk 002D","E01026895",592,141,70,71,428,89,213,89,97,27,81,40,36,5,43,25,18,2,2,23,11,12
"2021","South Norfolk 002E","E01026896",502,122,70,52,359,89,192,80,76,36,47,27,16,4,30,16,14,1,1,21,8,13
"2021","South Norfolk 002F","E01035141",701,161,36,125,509,31,306,71,207,28,100,56,42,2,70,55,15,2,2,31,6,25
"2021","South Norfolk 002G","E01035142",604,132,99,33,442,148,218,79,102,37,45,24,19,2,29,12,17,2,2,30,11,19
"2021","South Norfolk 003A","E01026905",517,208,143,65,302,102,114,39,52,23,39,20,16,3,46,27,19,1,1,7,2,5
"2021","South Norfolk 003B","E01026906",753,179,117,62,545,155,248,85,116,47,79,41,34,4,61,41,20,2,2,29,13,16
"2021","South Norfolk 003C","E01026907",831,221,126,95,576,124,288,120,133,35,97,53,35,9,64,38,26,3,3,34,13,21
"2021","South Norfolk 003D","E01026908",1005,241,58,183,737,41,381,120,221,40,205,121,77,7,105,75,30,5,5,27,16,11
"2021","South Norfolk 004A","E01026909",696,254,150,104,422,107,175,89,61,25,66,33,26,7,68,45,23,6,6,20,8,12
"2021","South Norfolk 004B","E01026910",709,172,112,60,511,122,255,103,115,37,82,53,28,1,48,23,25,4,4,26,8,18
"2021","South Norfolk 004C","E01026947",549,105,54,51,412,86,225,88,101,36,65,36,20,9,36,24,12,0,0,32,14,18
"2021","South Norfolk 004D","E01026948",518,94,60,34,402,83,245,97,102,46,41,19,20,2,32,20,12,1,1,22,10,12
"2021","South Norfolk 005A","E01026870",883,444,217,227,414,92,160,77,64,19,88,63,19,6,70,47,23,4,4,25,10,15
"2021","South Norfolk 005B","E01026871",571,173,113,60,380,105,183,78,66,39,50,34,14,2,41,14,27,1,1,18,9,9
"2021","South Norfolk 005C","E01026921",622,219,128,91,387,103,191,88,71,32,51,36,14,1,40,20,20,2,2,16,3,13
"2021","South Norfolk 005D","E01026922",678,264,158,106,400,81,187,73,76,38,71,35,32,4,57,35,22,4,4,14,7,7
"2021","South Norfolk 006A","E01026875",470,112,65,47,337,90,182,75,76,31,38,23,13,2,24,12,12,3,3,21,10,11
"2021","South Norfolk 006B","E01026876",693,208,160,48,449,111,228,102,82,44,66,37,24,5,44,18,26,0,0,36,12,24
"2021","South Norfolk 006D","E01026927",831,255,134,121,553,136,292,124,129,39,77,49,24,4,44,24,20,4,4,23,7,16
"2021","South Norfolk 006E","E01026928",856,269,127,142,554,98,263,94,120,49,107,67,36,4,82,51,31,4,4,33,14,19
"2021","South Norfolk 006F","E01026936",765,186,87,99,563,126,276,113,121,42,92,44,43,5,68,40,28,1,1,16,10,6
"2021","South Norfolk 006G","E01026937",688,198,94,104,464,79,216,91,93,32,101,60,35,6,63,39,24,5,5,26,6,20
"2021","South Norfolk 006H","E01035143",590,143,86,57,420,99,206,74,92,40,65,32,26,7,50,33,17,0,0,27,16,11
"2021","South Norfolk 006I","E01035144",714,175,60,115,514,61,234,75,139,20,147,73,70,4,70,57,13,2,2,25,13,12
"2021","South Norfolk 007A","E01026884",1049,270,91,179,754,60,339,123,175,41,217,124,86,7,136,91,45,2,2,25,10,15
"2021","South Norfolk 007B","E01026885",624,122,60,62,471,74,264,85,129,50,73,41,29,3,56,39,17,4,4,31,10,21
"2021","South Norfolk 007F","E01035145",574,129,18,111,421,22,204,61,131,12,124,72,52,0,70,57,13,1,1,24,18,6
"2021","South Norfolk 007G","E01035146",566,124,15,109,427,11,244,45,180,19,82,46,33,3,89,76,13,1,1,15,8,7
"2021","South Norfolk 007H","E01035147",497,171,94,77,312,70,152,68,53,31,42,21,20,1,46,25,21,2,2,14,5,9
"2021","South Norfolk 007I","E01035148",573,136,67,69,417,68,225,66,127,32,64,36,25,3,57,40,17,3,3,20,9,11
"2021","South Norfolk 007J","E01035149",1393,408,228,180,940,178,489,171,246,72,144,75,58,11,120,80,40,9,9,45,18,27
"2021","South Norfolk 008A","E01026879",512,143,72,71,351,81,160,59,68,33,50,26,23,1,59,33,26,1,1,18,10,8
"2021","South Norfolk 008B","E01026880",606,159,114,45,433,128,208,77,83,48,52,28,14,10,42,20,22,3,3,14,5,9
"2021","South Norfolk 008C","E01026911",675,234,120,114,419,68,155,61,64,30,99,54,43,2,92,64,28,5,5,22,10,12
"2021","South Norfolk 008D","E01026912",756,221,124,97,513,101,282,121,105,56,80,45,29,6,49,25,24,1,1,22,11,11
"2021","South Norfolk 008E","E01026929",598,146,81,65,426,108,224,83,101,40,55,39,14,2,38,20,18,1,1,26,10,16
"2021","South Norfolk 008F","E01026930",666,141,89,52,499,106,279,131,106,42,71,38,28,5,43,17,26,0,0,26,8,18
"2021","South Norfolk 009A","E01026913",746,221,118,103,503,91,244,102,109,33,101,62,37,2,60,35,25,7,7,22,8,14
"2021","South Norfolk 009B","E01026914",803,196,90,106,573,126,290,106,136,48,93,53,38,2,61,41,20,3,3,34,10,24
"2021","South Norfolk 009C","E01026915",838,195,110,85,613,129,329,103,176,50,95,45,44,6,57,34,23,3,3,30,12,18
"2021","South Norfolk 009D","E01026919",623,167,75,92,432,79,219,89,92,38,73,40,31,2,58,41,17,3,3,24,8,16
"2021","South Norfolk 009E","E01026920",500,99,52,47,380,98,197,80,77,40,49,28,14,7,35,15,20,1,1,21,9,12
"2021","South Norfolk 009F","E01026941",529,116,74,42,397,91,231,105,84,42,39,23,14,2,34,22,12,2,2,16,5,11
"2021","South Norfolk 009G","E01026942",455,114,71,43,323,64,187,75,78,34,47,23,22,2,25,15,10,0,0,18,5,13
"2021","South Norfolk 010A","E01026898",640,169,96,73,438,104,210,84,84,42,78,49,27,2,45,27,18,1,1,33,13,20
"2021","South Norfolk 010B","E01026899",679,167,82,85,485,101,258,110,98,50,74,51,22,1,46,26,20,6,6,27,16,11
"2021","South Norfolk 010C","E01026943",657,147,86,61,473,112,247,131,61,55,78,46,27,5,35,16,19,1,1,37,10,27
"2021","South Norfolk 010D","E01026944",522,115,58,57,375,73,201,80,83,38,62,37,22,3,38,16,22,1,1,32,13,19
"2021","South Norfolk 011A","E01026877",660,155,99,56,460,106,244,114,74,56,77,39,34,4,32,13,19,1,1,45,18,27
"2021","South Norfolk 011B","E01026878",488,97,48,49,371,55,214,92,85,37,60,32,24,4,40,26,14,2,2,20,7,13
"2021","South Norfolk 011C","E01026897",1185,241,131,110,905,225,465,216,173,76,140,69,57,14,74,37,37,1,1,39,20,19
"2021","South Norfolk 011D","E01026938",921,256,124,132,636,105,322,129,137,56,111,67,40,4,94,54,40,4,4,29,8,21
"2021","South Norfolk 011E","E01026939",727,177,101,76,519,102,266,111,107,48,86,41,40,5,61,38,23,4,4,31,12,19
"2021","South Norfolk 011F","E01026940",855,238,100,138,588,70,288,109,132,47,129,70,53,6,95,69,26,6,6,29,10,19
"2021","South Norfolk 012A","E01026892",572,175,105,70,385,94,174,77,57,40,72,45,24,3,44,26,18,1,1,12,5,7
"2021","South Norfolk 012B","E01026893",579,170,89,81,393,106,184,84,59,41,70,50,16,4,32,15,17,1,1,16,6,10
"2021","South Norfolk 012C","E01026894",1099,279,163,116,767,173,395,188,136,71,115,70,33,12,79,45,34,5,5,53,18,35
"2021","South Norfolk 012D","E01026903",493,134,90,44,336,71,193,80,69,44,49,29,15,5,22,12,10,1,1,23,9,14
"2021","South Norfolk 012E","E01026904",580,152,91,61,404,86,212,80,86,46,62,38,21,3,43,25,18,1,1,24,12,12
"2021","South Norfolk 013A","E01026872",1048,289,152,137,717,202,310,146,109,55,113,74,35,4,89,59,30,3,3,42,15,27
"2021","South Norfolk 013B","E01026900",705,238,155,83,443,135,178,89,63,26,75,31,41,3,54,35,19,1,1,24,8,16
"2021","South Norfolk 013C","E01026901",607,180,99,81,395,100,184,83,66,35,73,39,28,6,37,26,11,1,1,32,10,22
"2021","South Norfolk 013D","E01026902",1119,398,196,202,690,125,281,112,122,47,164,63,93,8,120,83,37,0,0,31,12,19
"2021","South Norfolk 014A","E01026873",552,130,84,46,402,97,199,90,52,57,60,38,15,7,39,20,19,7,7,20,9,11
"2021","South Norfolk 014B","E01026874",635,142,89,53,449,96,233,115,79,39,70,44,18,8,47,27,20,3,3,44,15,29
"2021","South Norfolk 014C","E01026886",596,146,78,68,429,97,242,125,72,45,60,40,19,1,30,16,14,0,0,21,7,14
"2021","South Norfolk 014D","E01026887",669,164,87,77,471,79,213,102,87,24,102,57,41,4,75,50,25,2,2,34,14,20
"2021","South Norfolk 014E","E01026934",496,174,88,86,302,81,134,69,46,19,49,28,21,0,38,24,14,0,0,20,6,14
"2021","South Norfolk 014F","E01026935",581,157,101,56,388,101,194,98,63,33,72,41,24,7,19,9,10,2,2,36,19,17
"2021","South Norfolk 015A","E01026888",786,302,184,118,451,107,184,69,72,43,75,38,31,6,80,39,41,5,5,33,11,22
"2021","South Norfolk 015B","E01026889",769,267,169,98,479,146,190,93,67,30,88,57,22,9,53,31,22,2,2,23,7,16
"2021","South Norfolk 015D","E01026891",875,369,197,172,461,87,180,68,73,39,95,58,34,3,94,61,33,5,5,45,9,36
"2021","South Norfolk 015E","E01026931",468,115,75,40,336,87,165,66,60,39,50,25,16,9,32,19,13,2,2,17,8,9
"2021","South Norfolk 015F","E01026932",594,163,85,78,405,87,177,69,80,28,77,47,27,3,61,35,26,3,3,26,10,16
"2021","South Norfolk 015G","E01033539",910,265,95,170,601,60,271,101,144,26,172,97,67,8,87,59,28,11,11,44,18,26
"2021","South Norfolk 015H","E01033541",694,246,125,121,418,90,171,84,56,31,96,54,40,2,56,38,18,5,5,30,11,19
"2021","South Norfolk 016D","E01026924",745,228,119,109,485,107,238,102,92,44,69,37,26,6,65,35,30,6,6,32,18,14
"2021","South Norfolk 016E","E01033540",664,159,72,87,468,100,219,97,92,30,89,54,30,5,59,34,25,1,1,37,16,21
"2021","South Norfolk 016A","E01035150",424,65,12,53,322,10,178,44,122,12,97,55,41,1,33,28,5,4,4,37,18,19
"2021","South Norfolk 016B","E01035151",551,144,12,132,366,10,184,51,123,10,111,57,53,1,59,44,15,2,2,41,17,24
"2021","South Norfolk 016C","E01035152",604,164,13,151,405,8,203,55,137,11,134,91,40,3,54,45,9,6,6,35,11,24
"2021","South Norfolk 016F","E01035153",559,103,6,97,421,7,218,57,152,9,128,76,47,5,65,53,12,3,3,35,16,19
"2021","South Norfolk 017A","E01026916",920,249,160,89,624,173,323,150,109,64,80,55,17,8,47,21,26,1,1,47,7,40
"2021","South Norfolk 017C","E01026917",661,227,166,61,406,105,188,85,70,33,70,41,23,6,41,13,28,2,2,28,11,17
"2021","South Norfolk 017B","E01026918",770,243,126,117,495,133,225,105,81,39,86,43,41,2,49,17,32,2,2,32,8,24
"2021","South Norfolk 017D","E01026925",1088,367,116,251,659,53,277,91,145,41,169,90,72,7,156,110,46,4,4,62,23,39
"2021","Babergh 001A","E01029876",965,266,146,120,659,144,334,156,107,71,110,59,42,9,68,38,30,3,3,40,17,23
"2021","Babergh 001B","E01029898",1003,402,231,171,574,182,239,121,68,50,80,41,33,6,68,27,41,5,5,27,12,15
"2021","Babergh 001C","E01029907",1030,262,175,87,721,201,358,186,110,62,107,57,43,7,54,30,24,1,1,47,18,29
"2021","Babergh 002A","E01029881",860,192,112,80,628,126,359,142,141,76,87,57,27,3,54,30,24,2,2,40,19,21
"2021","Babergh 002B","E01029884",745,227,106,121,493,76,200,68,88,44,122,59,54,9,94,62,32,1,1,25,9,16
"2021","Babergh 002C","E01029885",1037,262,142,120,746,195,364,172,124,68,122,63,52,7,62,33,29,3,3,29,8,21
"2021","Babergh 003A","E01029900",815,244,159,85,551,156,249,102,103,44,72,35,32,5,74,42,32,0,0,20,10,10
"2021","Babergh 003B","E01029901",1138,369,209,160,732,217,314,150,105,59,137,89,40,8,64,28,36,0,0,37,9,28
"2021","Babergh 003C","E01029917",852,206,117,89,624,160,311,112,131,68,82,41,36,5,70,45,25,1,1,22,7,15
"2021","Babergh 004A","E01029892",904,319,187,132,547,113,216,88,97,31,96,45,43,8,119,77,42,3,3,38,15,23
"2021","Babergh 004C","E01029894",520,162,90,72,348,77,178,76,69,33,53,33,19,1,40,24,16,0,0,10,3,7
"2021","Babergh 004D","E01029895",485,114,83,31,356,90,202,66,91,45,34,18,12,4,29,15,14,1,1,15,8,7
"2021","Babergh 004E","E01029896",592,197,143,54,376,95,170,73,50,47,48,27,19,2,62,39,23,1,1,19,6,13
"2021","Babergh 004F","E01029911",980,243,143,100,706,181,386,172,147,67,83,46,32,5,53,27,26,3,3,31,13,18
"2021","Babergh 004G","E01034559",596,92,54,38,477,56,301,67,197,37,73,36,31,6,46,37,9,1,1,27,14,13
"2021","Babergh 004H","E01034560",589,144,94,50,427,110,214,87,79,48,51,24,21,6,52,27,25,0,0,18,5,13
"2021","Babergh 005A","E01029877",569,128,73,55,413,96,233,82,102,49,53,36,14,3,30,16,14,1,1,28,10,18
"2021","Babergh 005B","E01029878",550,170,97,73,356,84,176,79,61,36,64,35,21,8,32,17,15,0,0,24,10,14
"2021","Babergh 005C","E01029879",713,186,104,82,496,99,256,104,107,45,91,60,26,5,46,23,23,4,4,31,11,20
"2021","Babergh 005D","E01029908",679,163,56,107,493,49,287,116,141,30,112,77,32,3,44,28,16,1,1,23,12,11
"2021","Babergh 005E","E01029909",742,262,79,183,455,30,233,105,100,28,124,85,35,4,66,42,24,2,2,25,11,14
"2021","Babergh 005F","E01029910",517,150,56,94,347,50,126,43,49,34,88,41,37,10,81,61,20,2,2,20,10,10
"2021","Babergh 006A","E01029880",824,217,134,83,558,142,273,125,106,42,83,48,34,1,59,35,24,1,1,49,12,37
"2021","Babergh 006B","E01029921",545,131,92,39,384,106,186,82,67,37,55,30,18,7,35,18,17,2,2,30,9,21
"2021","Babergh 006C","E01029922",635,133,86,47,469,107,228,87,90,51,61,25,32,4,67,38,29,6,6,33,15,18
"2021","Babergh 006D","E01029923",596,147,78,69,426,84,216,78,100,38,80,35,39,6,46,25,21,0,0,23,9,14
"2021","Babergh 007A","E01029912",835,288,123,165,505,68,215,90,92,33,127,69,52,6,89,54,35,6,6,42,14,28
"2021","Babergh 007B","E01029913",552,190,145,45,343,147,130,65,31,34,33,24,9,0,32,12,20,1,1,19,7,12
"2021","Babergh 007C","E01029914",672,204,75,129,435,37,177,66,73,38,126,49,66,11,92,69,23,3,3,33,10,23
"2021","Babergh 007D","E01029915",510,155,76,79,332,55,174,70,59,45,66,39,21,6,36,21,15,1,1,23,11,12
"2021","Babergh 007E","E01029916",510,119,53,66,355,34,163,52,69,42,68,20,45,3,89,54,35,1,1,36,17,19
"2021","Babergh 007F","E01029918",549,257,92,165,267,48,101,44,33,24,66,35,26,5,50,22,28,2,2,25,10,15
"2021","Babergh 007G","E01029919",735,261,111,150,449,87,181,78,71,32,108,63,36,9,73,41,32,0,0,25,1,24
"2021","Babergh 007H","E01029920",1087,606,311,295,441,107,137,77,41,19,103,62,36,5,88,47,41,6,6,40,6,34
"2021","Babergh 008A","E01029886",548,169,72,97,348,77,142,50,70,22,60,27,33,0,66,37,29,3,3,31,14,17
"2021","Babergh 008B","E01029887",915,284,134,150,594,119,262,87,120,55,131,67,55,9,79,42,37,3,3,37,16,21
"2021","Babergh 008C","E01029888",519,111,58,53,379,46,153,62,72,19,85,35,43,7,89,51,38,6,6,29,12,17
"2021","Babergh 008D","E01029889",522,120,74,46,371,41,150,42,65,43,74,23,40,11,106,61,45,0,0,31,17,14
"2021","Babergh 008E","E01029890",652,114,42,72,505,62,255,82,119,54,130,62,60,8,58,46,12,0,0,33,13,20
"2021","Babergh 008F","E01029891",898,222,98,124,652,93,326,109,148,69,122,54,57,11,107,77,30,4,4,24,8,16
"2021","Babergh 009A","E01029875",994,238,128,110,704,163,369,146,159,64,104,59,42,3,67,47,20,1,1,52,21,31
"2021","Babergh 009B","E01029899",795,205,135,70,564,147,303,128,125,50,75,41,30,4,36,17,19,3,3,26,9,17
"2021","Babergh 009C","E01029902",935,218,125,93,675,133,375,187,116,72,110,58,47,5,54,28,26,3,3,42,17,25
"2021","Babergh 009D","E01029906",811,241,142,99,537,142,262,114,117,31,76,42,31,3,55,32,23,2,2,33,12,21
"2021","Babergh 010A","E01029870",472,111,65,46,344,44,178,71,70,37,67,30,33,4,53,38,15,2,2,17,11,6
"2021","Babergh 010B","E01029872",603,129,80,49,448,112,256,103,98,55,50,25,19,6,28,11,17,2,2,26,5,21
"2021","Babergh 010C","E01029882",641,164,108,56,446,99,237,92,101,44,54,37,17,0,56,29,27,0,0,31,15,16
"2021","Babergh 010D","E01029883",889,222,142,80,628,199,304,130,119,55,75,34,34,7,44,24,20,6,6,39,16,23
"2021","Babergh 010E","E01029903",623,139,101,38,468,148,253,88,112,53,45,17,22,6,22,14,8,0,0,16,7,9
"2021","Babergh 010F","E01029904",705,176,113,63,509,143,210,73,87,50,89,44,40,5,65,38,27,2,2,20,9,11
"2021","Babergh 010G","E01029905",488,113,79,34,358,78,199,83,79,37,49,27,19,3,31,18,13,1,1,17,6,11
"2021","Babergh 011A","E01029871",625,193,136,57,411,109,201,80,79,42,64,36,21,7,35,19,16,2,2,21,12,9
"2021","Babergh 011B","E01029873",999,314,181,133,654,160,309,160,102,47,106,57,33,16,78,37,41,1,1,31,9,22
"2021","Babergh 011C","E01029874",744,208,114,94,512,91,260,117,96,47,93,44,42,7,68,39,29,0,0,24,5,19
"2021","Babergh 011D","E01029897",873,216,120,96,622,142,324,128,149,47,89,39,47,3,66,38,28,1,1,35,17,18
"2021","Ipswich 001A","E01030032",514,100,59,41,377,33,152,28,87,37,90,27,50,13,98,60,38,4,4,37,20,17
"2021","Ipswich 001B","E01030033",653,177,112,65,457,119,212,77,91,44,81,39,37,5,42,24,18,3,3,19,7,12
"2021","Ipswich 001C","E01030034",640,160,117,43,453,151,216,101,63,52,44,21,21,2,40,16,24,2,2,27,9,18
"2021","Ipswich 001D","E01030035",686,131,76,55,500,41,204,63,98,43,101,35,56,10,146,89,57,8,8,55,28,27
"2021","Ipswich 001E","E01030036",769,258,143,115,461,58,207,48,118,41,82,31,47,4,110,62,48,4,4,50,30,20
"2021","Ipswich 002A","E01029973",631,142,100,42,465,122,244,96,101,47,68,41,25,2,31,13,18,0,0,24,8,16
"2021","Ipswich 002B","E01029974",627,156,72,84,437,57,237,93,101,43,94,49,39,6,46,25,21,3,3,34,14,20
"2021","Ipswich 002C","E01029975",523,147,105,42,352,48,181,60,79,42,78,37,38,3,44,31,13,1,1,24,7,17
"2021","Ipswich 002D","E01029976",638,148,85,63,456,82,213,78,94,41,94,41,48,5,67,35,32,0,0,34,17,17
"2021","Ipswich 002E","E01029977",645,159,98,61,466,89,251,96,110,45,85,38,37,10,40,17,23,1,1,20,8,12
"2021","Ipswich 003A","E01030027",898,280,73,207,556,43,232,85,113,34,152,77,68,7,123,86,37,6,6,62,20,42
"2021","Ipswich 003B","E01030028",702,188,61,127,479,64,223,82,91,50,107,48,51,8,82,64,18,3,3,35,12,23
"2021","Ipswich 003C","E01030029",662,191,86,105,436,53,178,55,84,39,84,31,45,8,116,80,36,5,5,35,14,21
"2021","Ipswich 003D","E01030030",965,306,74,232,619,57,243,92,111,40,163,84,74,5,145,97,48,11,11,40,14,26
"2021","Ipswich 003E","E01030031",623,196,95,101,396,39,172,57,78,37,88,42,39,7,89,61,28,8,8,31,13,18
"2021","Ipswich 004A","E01029997",618,155,90,65,437,60,238,64,133,41,80,25,45,10,59,31,28,0,0,26,17,9
"2021","Ipswich 004B","E01029998",756,232,118,114,485,68,221,57,125,39,71,26,39,6,123,72,51,2,2,39,21,18
"2021","Ipswich 004C","E01029999",626,143,72,71,447,73,258,64,154,40,70,37,30,3,45,21,24,1,1,36,15,21
"2021","Ipswich 004D","E01030000",640,155,61,94,449,58,216,56,133,27,101,47,47,7,74,48,26,0,0,36,16,20
"2021","Ipswich 004E","E01030001",720,206,121,85,484,77,243,83,122,38,70,22,45,3,91,53,38,3,3,30,15,15
"2021","Ipswich 005A","E01030007",894,275,85,190,576,44,286,83,164,39,130,74,49,7,110,78,32,6,6,43,16,27
"2021","Ipswich 005B","E01030008",549,145,72,73,375,86,215,65,107,43,41,22,16,3,30,17,13,3,3,29,14,15
"2021","Ipswich 005C","E01030009",586,184,108,76,370,75,209,85,93,31,55,23,29,3,27,17,10,4,4,32,13,19
"2021","Ipswich 005D","E01030010",965,416,153,263,484,39,192,67,112,13,137,95,37,5,104,63,41,12,12,65,21,44
"2021","Ipswich 005E","E01030011",671,165,120,45,478,134,284,115,126,43,32,17,10,5,27,17,10,1,1,28,11,17
"2021","Ipswich 006A","E01030022",930,299,60,239,539,25,225,74,101,50,151,80,68,3,128,83,45,10,10,92,36,56
"2021","Ipswich 006B","E01030023",857,269,53,216,504,19,198,73,109,16,147,77,67,3,120,86,34,20,20,84,39,45
"2021","Ipswich 006C","E01030024",1042,518,115,403,439,25,155,61,73,21,117,78,36,3,114,86,28,28,28,85,37,48
"2021","Ipswich 006D","E01030025",912,423,91,332,412,28,188,77,86,25,113,78,35,0,77,44,33,6,6,77,31,46
"2021","Ipswich 006E","E01030026",776,196,47,149,518,32,225,59,126,40,137,68,63,6,118,87,31,6,6,62,25,37
"2021","Ipswich 007A","E01029958",644,232,73,159,376,43,148,54,75,19,107,62,41,4,72,44,28,6,6,36,9,27
"2021","Ipswich 007C","E01029960",916,380,85,295,492,27,207,59,109,39,130,75,49,6,116,75,41,12,12,44,14,30
"2021","Ipswich 007D","E01029961",610,150,44,106,408,30,186,70,84,32,105,50,53,2,85,58,27,2,2,52,16,36
"2021","Ipswich 007E","E01029962",691,230,53,177,384,18,166,58,79,29,105,61,42,2,85,65,20,10,10,77,24,53
"2021","Ipswich 007F","E01033124",682,454,45,409,183,5,61,38,18,5,95,87,8,0,15,12,3,7,7,45,6,39
"2021","Ipswich 007G","E01033125",815,463,85,378,292,9,117,51,62,4,97,77,19,1,56,36,20,13,13,60,10,50
"2021","Ipswich 007H","E01033129",837,407,50,357,342,10,141,56,78,7,110,78,31,1,69,51,18,12,12,88,18,70
"2021","Ipswich 008A","E01030002",952,414,172,242,494,48,237,94,110,33,140,72,58,10,66,55,11,3,3,44,12,32
"2021","Ipswich 008B","E01030003",732,215,106,109,478,53,247,82,130,35,94,44,44,6,77,50,27,7,7,39,16,23
"2021","Ipswich 008C","E01030004",500,112,54,58,374,55,218,74,106,38,64,28,30,6,36,12,24,1,1,14,5,9
"2021","Ipswich 008D","E01030005",1177,324,74,250,786,46,347,93,212,42,217,118,92,7,169,131,38,7,7,67,26,41
"2021","Ipswich 008E","E01030006",802,313,137,176,448,55,217,68,124,25,93,43,49,1,80,53,27,3,3,41,15,26
"2021","Ipswich 009A","E01029963",662,150,104,46,484,136,253,77,121,55,56,30,20,6,38,17,21,1,1,28,11,17
"2021","Ipswich 009B","E01029964",536,131,53,78,370,48,196,57,102,37,65,32,29,4,57,40,17,4,4,35,19,16
"2021","Ipswich 009C","E01029965",618,163,103,60,430,102,229,82,103,44,55,22,28,5,41,16,25,3,3,25,13,12
"2021","Ipswich 009D","E01029966",759,278,98,180,437,107,214,77,100,37,66,33,26,7,45,30,15,5,5,44,18,26
"2021","Ipswich 009E","E01029967",606,187,149,38,404,126,204,81,88,35,46,24,22,0,28,17,11,0,0,15,9,6
"2021","Ipswich 010A","E01029984",605,149,62,87,409,41,192,55,98,39,90,38,42,10,81,53,28,5,5,47,25,22
"2021","Ipswich 010B","E01029985",1118,393,69,324,638,53,289,106,138,45,154,101,52,1,128,86,42,14,14,87,28,59
"2021","Ipswich 010C","E01029986",631,220,76,144,377,29,147,32,82,33,100,42,49,9,98,63,35,3,3,34,24,10
"2021","Ipswich 010D","E01029987",592,186,75,111,370,49,146,36,76,34,76,25,42,9,91,59,32,8,8,36,21,15
"2021","Ipswich 010E","E01029988",1060,519,153,366,465,33,169,56,91,22,137,81,49,7,114,75,39,12,12,76,36,40
"2021","Ipswich 011B","E01029990",696,233,53,180,422,36,175,56,85,34,122,69,48,5,85,52,33,4,4,41,15,26
"2021","Ipswich 011C","E01029991",680,158,96,62,493,93,274,111,113,50,74,43,25,6,52,28,24,0,0,29,12,17
"2021","Ipswich 011D","E01029992",597,194,96,98,368,50,188,73,87,28,75,48,24,3,54,30,24,1,1,35,15,20
"2021","Ipswich 011E","E01033123",789,268,75,193,455,31,193,69,95,29,126,77,45,4,99,61,38,6,6,66,25,41
"2021","Ipswich 011F","E01033126",782,327,39,288,393,18,181,80,93,8,121,95,25,1,54,35,19,19,19,62,11,51
"2021","Ipswich 012A","E01029968",673,218,56,162,414,33,153,53,76,24,116,64,45,7,101,77,24,11,11,41,20,21
"2021","Ipswich 012B","E01029969",589,163,54,109,388,33,171,59,70,42,95,44,40,11,86,68,18,3,3,38,12,26
"2021","Ipswich 012C","E01029970",765,245,100,145,477,76,225,90,100,35,97,59,35,3,75,43,32,4,4,43,20,23
"2021","Ipswich 012D","E01029971",632,192,87,105,408,45,167,59,81,27,88,35,45,8,107,72,35,1,1,32,15,17
"2021","Ipswich 012F","E01033122",1014,371,53,318,573,6,172,48,110,14,167,98,64,5,220,192,28,8,8,70,25,45
"2021","Ipswich 012G","E01033130",628,348,55,293,230,10,72,27,39,6,78,52,21,5,56,35,21,14,14,50,22,28
"2021","Ipswich 013A","E01030012",598,301,116,185,278,39,118,42,57,19,60,31,27,2,60,35,25,1,1,19,8,11
"2021","Ipswich 013B","E01030013",615,149,75,74,426,64,158,62,71,25,101,42,50,9,99,51,48,4,4,40,19,21
"2021","Ipswich 013C","E01030014",581,181,116,65,379,49,169,49,76,44,81,30,43,8,79,42,37,1,1,21,13,8
"2021","Ipswich 013D","E01030015",531,138,76,62,368,92,201,67,89,45,44,21,20,3,31,13,18,0,0,25,11,14
"2021","Ipswich 013E","E01030016",626,211,97,114,403,84,174,64,65,45,85,42,39,4,58,33,25,2,2,12,2,10
"2021","Ipswich 014B","E01029994",619,182,87,95,386,33,158,28,94,36,69,24,34,11,116,61,55,10,10,51,25,26
"2021","Ipswich 014C","E01029995",684,168,76,92,471,66,242,83,117,42,98,55,38,5,58,28,30,7,7,45,16,29
"2021","Ipswich 014D","E01029996",625,128,76,52,442,56,190,74,81,35,74,37,31,6,116,68,48,6,6,55,31,24
"2021","Ipswich 014E","E01033127",659,178,36,142,442,20,193,69,97,27,106,69,29,8,118,89,29,5,5,39,23,16
"2021","Ipswich 014F","E01033128",505,175,66,109,304,19,153,54,76,23,82,39,39,4,46,30,16,4,4,26,14,12
"2021","Ipswich 014G","E01033131",667,177,83,94,453,28,193,47,114,32,100,43,55,2,126,76,50,6,6,37,21,16
"2021","Ipswich 015A","E01030017",634,219,92,127,381,55,156,67,59,30,59,24,30,5,110,83,27,1,1,34,20,14
"2021","Ipswich 015B","E01030018",679,242,78,164,402,41,112,31,55,26,79,24,47,8,168,124,44,2,2,35,17,18
"2021","Ipswich 015C","E01030019",634,192,111,81,409,100,191,75,67,49,64,28,30,6,53,28,25,1,1,33,17,16
"2021","Ipswich 015D","E01030020",603,146,90,56,429,120,182,74,75,33,75,40,30,5,51,23,28,1,1,28,11,17
"2021","Ipswich 015E","E01030021",621,211,86,125,389,27,135,51,59,25,87,26,53,8,140,116,24,0,0,21,12,9
"2021","Ipswich 016A","E01029978",542,151,72,79,360,58,171,61,78,32,62,19,38,5,68,44,24,1,1,31,11,20
"2021","Ipswich 016B","E01029979",624,188,113,75,380,40,134,43,63,28,80,19,55,6,122,85,37,4,4,56,24,32
"2021","Ipswich 016C","E01029980",670,211,79,132,415,23,155,47,89,19,92,34,54,4,142,97,45,3,3,44,23,21
"2021","Ipswich 016D","E01029981",520,144,75,69,347,68,172,75,64,33,65,29,32,4,39,26,13,3,3,29,16,13
"2021","Ipswich 016E","E01029982",513,95,52,43,387,29,175,45,93,37,78,17,49,12,101,67,34,4,4,31,17,14
"2021","Ipswich 016F","E01029983",653,176,75,101,429,57,228,80,119,29,102,58,40,4,40,21,19,2,2,48,23,25
"2021","Mid Suffolk 001A","E01030052",1009,355,201,154,612,166,256,102,103,51,96,49,40,7,90,55,35,4,4,42,17,25
"2021","Mid Suffolk 001B","E01030058",877,209,134,75,628,148,324,149,105,70,92,61,29,2,61,29,32,3,3,40,19,21
"2021","Mid Suffolk 001C","E01030064",1029,241,144,97,736,190,383,157,152,74,86,53,27,6,75,39,36,2,2,52,21,31
"2021","Mid Suffolk 001D","E01030088",518,105,66,39,383,94,191,89,71,31,51,33,16,2,46,27,19,1,1,30,11,19
"2021","Mid Suffolk 002A","E01030039",574,115,77,38,425,107,218,103,75,40,62,28,29,5,38,20,18,0,0,34,7,27
"2021","Mid Suffolk 002B","E01030054",594,126,71,55,433,104,248,112,97,39,47,31,11,5,33,16,17,1,1,35,22,13
"2021","Mid Suffolk 002C","E01030055",621,156,78,78,445,83,238,100,90,48,76,42,29,5,46,19,27,2,2,20,8,12
"2021","Mid Suffolk 002D","E01030066",706,203,141,62,467,124,243,112,87,44,60,36,16,8,37,21,16,3,3,36,19,17
"2021","Mid Suffolk 002E","E01030067",589,177,96,81,385,89,179,72,68,39,61,34,26,1,53,34,19,3,3,27,9,18
"2021","Mid Suffolk 002F","E01030068",764,205,106,99,533,104,292,124,115,53,81,47,28,6,55,25,30,1,1,26,11,15
"2021","Mid Suffolk 003A","E01030053",1031,263,157,106,732,214,343,162,118,63,93,55,30,8,80,36,44,2,2,36,12,24
"2021","Mid Suffolk 003C","E01030090",1024,201,109,92,776,184,393,171,147,75,120,78,32,10,77,40,37,2,2,47,24,23
"2021","Mid Suffolk 003D","E01034570",778,204,133,71,544,158,260,121,100,39,66,40,22,4,59,34,25,1,1,30,11,19
"2021","Mid Suffolk 003E","E01034571",464,144,81,63,308,66,153,73,50,30,66,35,26,5,22,13,9,1,1,12,3,9
"2021","Mid Suffolk 004A","E01030040",541,136,75,61,380,85,203,95,69,39,56,37,17,2,34,23,11,2,2,25,6,19
"2021","Mid Suffolk 004B","E01030049",764,165,95,70,562,116,330,127,139,64,69,40,23,6,43,28,15,4,4,37,19,18
"2021","Mid Suffolk 004C","E01030050",1017,272,123,149,713,110,347,119,185,43,169,100,59,10,84,52,32,3,3,32,13,19
"2021","Mid Suffolk 004D","E01030084",714,148,92,56,529,155,263,105,106,52,72,39,28,5,39,23,16,0,0,37,22,15
"2021","Mid Suffolk 004E","E01030085",724,224,133,91,478,88,248,100,109,39,84,46,32,6,58,34,24,0,0,22,7,15
"2021","Mid Suffolk 005A","E01030037",528,141,68,73,365,74,196,89,78,29,64,38,20,6,30,16,14,1,1,22,11,11
"2021","Mid Suffolk 005B","E01030038",507,127,82,45,356,92,175,79,47,49,49,29,16,4,36,17,19,4,4,24,12,12
"2021","Mid Suffolk 005C","E01030059",1061,269,160,109,751,171,386,183,137,66,120,68,47,5,71,43,28,3,3,41,11,30
"2021","Mid Suffolk 005D","E01030081",1167,320,186,134,812,171,383,174,147,62,151,84,57,10,105,63,42,2,2,35,11,24
"2021","Mid Suffolk 006A","E01030051",805,219,129,90,558,123,254,106,93,55,97,54,38,5,84,60,24,0,0,28,4,24
"2021","Mid Suffolk 006B","E01030056",984,300,173,127,645,155,335,142,131,62,91,45,38,8,59,27,32,5,5,39,13,26
"2021","Mid Suffolk 006C","E01030065",920,220,134,86,661,167,376,168,141,67,73,38,31,4,43,23,20,2,2,39,13,26
"2021","Mid Suffolk 006D","E01030086",498,99,57,42,378,68,210,110,69,31,60,29,21,10,37,24,13,3,3,21,8,13
"2021","Mid Suffolk 006E","E01030089",946,244,150,94,665,185,315,152,98,65,91,56,33,2,70,46,24,4,4,37,13,24
"2021","Mid Suffolk 007A","E01030048",1051,304,190,114,705,173,353,118,171,64,94,47,39,8,80,60,20,5,5,42,14,28
"2021","Mid Suffolk 007B","E01030057",959,220,121,99,681,136,406,192,145,69,89,42,39,8,50,26,24,0,0,58,27,31
"2021","Mid Suffolk 007C","E01030083",965,205,113,92,717,171,391,187,133,71,95,61,27,7,53,27,26,7,7,43,22,21
"2021","Mid Suffolk 007D","E01030087",519,88,56,32,404,83,235,90,86,59,44,30,10,4,36,20,16,6,6,27,10,17
"2021","Mid Suffolk 008A","E01030073",782,314,206,108,453,138,174,76,59,39,67,25,36,6,71,42,29,3,3,15,5,10
"2021","Mid Suffolk 008B","E01030077",701,279,163,116,396,72,144,53,71,20,84,46,32,6,90,54,36,6,6,26,9,17
"2021","Mid Suffolk 008C","E01030079",605,164,82,82,422,48,169,56,70,43,95,40,42,13,105,56,49,5,5,19,9,10
"2021","Mid Suffolk 008D","E01030080",683,166,95,71,491,93,235,92,79,64,96,42,47,7,64,42,22,3,3,26,12,14
"2021","Mid Suffolk 009A","E01030063",1010,261,140,121,704,139,366,140,147,79,123,67,49,7,75,41,34,1,1,45,18,27
"2021","Mid Suffolk 009B","E01030069",633,131,71,60,470,120,270,146,77,47,54,34,11,9,24,13,11,2,2,32,12,20
"2021","Mid Suffolk 009C","E01030072",764,289,126,163,455,95,209,81,83,45,98,52,42,4,52,35,17,1,1,20,11,9
"2021","Mid Suffolk 009D","E01030075",824,173,59,114,617,60,342,102,183,57,152,96,52,4,61,34,27,2,2,34,15,19
"2021","Mid Suffolk 010A","E01030060",757,270,129,141,467,72,219,118,68,33,118,78,33,7,55,36,19,3,3,20,6,14
"2021","Mid Suffolk 010B","E01030071",714,283,123,160,408,73,172,81,59,32,110,78,28,4,52,38,14,1,1,23,6,17
"2021","Mid Suffolk 010D","E01030076",740,251,80,171,459,54,181,73,78,30,132,78,48,6,88,51,37,4,4,30,14,16
"2021","Mid Suffolk 010E","E01030078",727,204,79,125,512,88,276,120,100,56,93,62,26,5,50,29,21,5,5,11,3,8
"2021","Mid Suffolk 010F","E01033316",792,197,33,164,559,30,289,86,176,27,150,85,62,3,90,71,19,0,0,36,13,23
"2021","Mid Suffolk 010G","E01033317",788,231,48,183,519,43,218,90,105,23,155,85,61,9,97,70,27,6,6,38,12,26
"2021","Mid Suffolk 010H","E01033319",1054,217,61,156,810,57,438,126,275,37,198,100,88,10,110,83,27,7,7,27,12,15
"2021","Mid Suffolk 011A","E01030041",984,238,129,109,710,172,347,178,101,68,120,69,41,10,70,28,42,1,1,36,15,21
"2021","Mid Suffolk 011B","E01030043",1073,266,68,198,777,63,330,124,174,32,289,182,103,4,89,59,30,6,6,30,11,19
"2021","Mid Suffolk 011C","E01030061",860,373,209,164,466,88,191,92,68,31,99,49,42,8,86,43,43,2,2,21,9,12
"2021","Mid Suffolk 011D","E01030062",719,253,125,128,442,106,199,93,73,33,88,49,35,4,45,25,20,4,4,24,8,16
"2021","Mid Suffolk 011E","E01030070",539,89,38,51,426,58,288,112,155,21,58,40,18,0,18,13,5,4,4,24,12,12
"2021","Mid Suffolk 012A","E01030042",756,186,98,88,525,146,236,103,83,50,84,40,34,10,56,30,26,3,3,45,18,27
"2021","Mid Suffolk 012B","E01030044",633,221,140,81,387,101,174,83,59,32,56,38,16,2,54,26,28,2,2,25,15,10
"2021","Mid Suffolk 012C","E01030045",721,203,121,82,491,108,264,91,117,56,73,35,33,5,44,27,17,2,2,27,11,16
"2021","Mid Suffolk 012D","E01030046",671,139,85,54,494,120,257,110,102,45,81,42,32,7,36,16,20,0,0,38,18,20
"2021","Mid Suffolk 012E","E01030047",551,185,89,96,349,60,169,68,69,32,68,42,22,4,51,37,14,1,1,17,11,6
"2021","St Albans 001A","E01023690",647,156,103,53,460,61,304,54,212,38,50,27,20,3,44,33,11,1,1,31,13,18
"2021","St Albans 001B","E01023691",504,62,47,15,425,74,303,67,187,49,20,3,13,4,28,15,13,0,0,17,7,10
"2021","St Albans 001C","E01023692",495,129,55,74,350,39,199,51,120,28,37,22,11,4,71,39,32,4,4,16,4,12
"2021","St Albans 001D","E01023693",626,179,62,117,432,45,256,56,156,44,64,44,18,2,63,40,23,4,4,15,8,7
"2021","St Albans 001E","E01023694",596,75,50,25,502,81,354,81,228,45,40,13,22,5,26,14,12,1,1,19,11,8
"2021","St Albans 002A","E01023685",638,127,62,65,488,44,322,62,222,38,52,25,23,4,68,48,20,2,2,23,4,19
"2021","St Albans 002B","E01023686",528,77,49,28,442,69,334,62,230,42,20,7,13,0,18,4,14,1,1,9,4,5
"2021","St Albans 002C","E01023687",619,195,72,123,391,25,193,46,112,35,69,30,36,3,102,70,32,2,2,33,18,15
"2021","St Albans 002D","E01023688",641,202,77,125,416,48,241,57,160,24,61,41,17,3,62,42,20,4,4,23,12,11
"2021","St Albans 002E","E01023689",513,118,61,57,382,58,267,53,180,34,28,14,12,2,28,20,8,1,1,13,6,7
"2021","St Albans 003A","E01023699",616,140,87,53,451,97,284,72,185,27,39,23,16,0,31,20,11,0,0,25,8,17
"2021","St Albans 003B","E01023700",471,54,43,11,400,75,289,76,164,49,15,7,6,2,21,10,11,0,0,17,8,9
"2021","St Albans 003C","E01023701",993,424,210,214,530,120,241,76,140,25,105,93,12,0,62,40,22,2,2,39,6,33
"2021","St Albans 003D","E01023702",678,203,86,117,463,47,289,57,194,38,67,42,24,1,59,43,16,1,1,12,5,7
"2021","St Albans 003E","E01023703",532,94,58,36,426,59,308,54,213,41,31,11,19,1,27,21,6,1,1,12,6,6
"2021","St Albans 004A","E01023746",631,156,76,80,444,72,197,48,120,29,72,23,44,5,101,76,25,2,2,31,19,12
"2021","St Albans 004B","E01023747",743,207,119,88,514,88,279,70,170,39,76,44,27,5,67,40,27,4,4,22,7,15
"2021","St Albans 004C","E01023748",559,113,85,28,425,124,243,78,114,51,26,12,12,2,30,19,11,2,2,21,5,16
"2021","St Albans 004D","E01023749",718,140,92,48,549,110,328,78,203,47,61,35,25,1,47,25,22,3,3,29,14,15
"2021","St Albans 005A","E01023695",622,122,84,38,482,82,319,77,201,41,47,20,24,3,34,18,16,0,0,18,7,11
"2021","St Albans 005B","E01023696",652,84,64,20,542,126,364,94,199,71,24,12,9,3,28,16,12,0,0,26,15,11
"2021","St Albans 005C","E01023697",779,219,108,111,526,72,287,84,165,38,91,60,29,2,76,55,21,0,0,34,16,18
"2021","St Albans 005D","E01023698",603,124,87,37,468,97,301,90,158,53,38,16,19,3,32,19,13,0,0,11,5,6
"2021","St Albans 006A","E01023722",589,134,86,48,426,101,230,67,129,34,47,29,15,3,45,24,21,3,3,29,7,22
"2021","St Albans 006B","E01023723",672,180,90,90,455,54,234,54,138,42,60,26,28,6,101,73,28,6,6,37,16,21
"2021","St Albans 006C","E01023724",719,228,145,83,473,112,235,70,127,38,64,37,22,5,58,31,27,4,4,18,7,11
"2021","St Albans 006D","E01023725",593,115,70,45,452,95,283,69,178,36,44,23,18,3,28,17,11,2,2,26,5,21
"2021","St Albans 007A","E01023713",735,149,53,96,534,55,323,70,220,33,60,33,25,2,92,57,35,4,4,52,32,20
"2021","St Albans 007B","E01023734",644,155,78,77,470,74,285,73,173,39,72,44,23,5,39,22,17,0,0,19,6,13
"2021","St Albans 007C","E01023735",771,283,144,139,464,55,271,90,137,44,81,51,25,5,57,38,19,0,0,24,11,13
"2021","St Albans 007D","E01023736",685,218,91,127,443,63,215,58,121,36,89,49,34,6,73,43,30,3,3,24,6,18
"2021","St Albans 008A","E01023709",710,226,117,109,455,54,259,55,168,36,57,28,27,2,80,48,32,5,5,29,15,14
"2021","St Albans 008B","E01023710",541,69,53,16,450,87,320,66,202,52,18,5,9,4,22,7,15,3,3,22,12,10
"2021","St Albans 008C","E01023711",626,158,118,40,431,81,263,44,167,52,27,9,14,4,59,30,29,1,1,37,17,20
"2021","St Albans 008D","E01023712",840,254,81,173,544,37,310,73,199,38,97,59,35,3,96,69,27,4,4,42,15,27
"2021","St Albans 009A","E01023669",671,158,51,107,475,20,213,49,126,38,79,32,39,8,156,108,48,7,7,38,18,20
"2021","St Albans 009B","E01023670",853,236,98,138,588,58,368,107,227,34,100,64,36,0,59,37,22,3,3,29,7,22
"2021","St Albans 009C","E01023671",745,196,109,87,505,53,280,61,168,51,59,25,30,4,111,62,49,2,2,44,31,13
"2021","St Albans 009D","E01023672",686,142,58,84,510,54,300,51,196,53,61,35,23,3,89,48,41,6,6,34,16,18
"2021","St Albans 010A","E01023673",520,88,54,34,409,76,269,58,162,49,32,16,15,1,30,21,9,2,2,23,10,13
"2021","St Albans 010B","E01023714",631,81,60,21,529,102,378,92,223,63,24,8,16,0,25,11,14,0,0,21,5,16
"2021","St Albans 010C","E01023715",525,67,50,17,437,56,314,63,212,39,34,6,25,3,32,15,17,1,1,21,9,12
"2021","St Albans 010D","E01023716",853,204,79,125,618,63,382,93,255,34,128,93,32,3,42,27,15,3,3,31,11,20
"2021","St Albans 011A","E01023666",856,302,45,257,486,19,231,56,150,25,153,128,23,2,72,45,27,11,11,68,20,48
"2021","St Albans 011B","E01023674",724,166,61,105,521,25,306,75,213,18,126,83,39,4,58,34,24,6,6,37,13,24
"2021","St Albans 011C","E01023675",506,88,59,29,404,76,266,63,157,46,30,16,12,2,32,17,15,0,0,14,4,10
"2021","St Albans 011D","E01023676",1197,429,86,343,713,46,358,126,199,33,204,157,41,6,97,75,22,8,8,55,10,45
"2021","St Albans 012A","E01023726",989,318,67,251,628,16,310,129,167,14,242,189,50,3,51,36,15,9,9,43,6,37
"2021","St Albans 012B","E01023727",1132,519,163,356,546,22,253,106,128,19,182,156,25,1,75,51,24,14,14,67,10,57
"2021","St Albans 012C","E01023728",960,306,91,215,617,50,355,97,221,37,148,115,32,1,61,35,26,3,3,37,6,31
"2021","St Albans 012E","E01035566",616,225,45,180,359,17,190,57,117,16,121,107,14,0,27,19,8,4,4,32,5,27
"2021","St Albans 012F","E01035567",674,276,29,247,359,14,124,59,55,10,135,112,22,1,78,54,24,8,8,39,5,34
"2021","St Albans 013A","E01023664",700,147,47,100,525,50,339,81,215,43,64,28,34,2,72,49,23,0,0,28,15,13
"2021","St Albans 013B","E01023665",670,169,52,117,470,36,284,53,197,34,77,55,22,0,67,39,28,6,6,31,13,18
"2021","St Albans 013C","E01023667",583,156,58,98,390,36,235,57,151,27,66,49,17,0,50,28,22,3,3,37,15,22
"2021","St Albans 013D","E01023668",470,69,37,32,381,40,282,44,193,45,26,5,20,1,33,12,21,0,0,20,12,8
"2021","St Albans 014A","E01023742",693,119,90,29,555,139,319,70,207,42,40,14,25,1,56,38,18,1,1,19,10,9
"2021","St Albans 014B","E01023743",890,289,154,135,567,88,326,110,176,40,102,80,19,3,48,31,17,3,3,34,10,24
"2021","St Albans 014C","E01023744",617,140,104,36,462,129,265,54,155,56,33,13,16,4,32,12,20,3,3,15,9,6
"2021","St Albans 014D","E01023745",800,240,101,139,540,71,298,94,170,34,114,88,23,3,52,21,31,5,5,20,2,18
"2021","St Albans 016A","E01023681",638,213,62,151,382,19,206,46,126,34,63,32,26,5,91,59,32,3,3,43,15,28
"2021","St Albans 016B","E01023682",735,217,117,100,467,61,273,65,182,26,67,42,21,4,64,34,30,2,2,51,18,33
"2021","St Albans 016C","E01023683",659,178,101,77,449,45,238,35,160,43,44,18,24,2,119,70,49,3,3,32,16,16
"2021","St Albans 016D","E01023684",662,194,127,67,434,84,244,68,145,31,53,34,17,2,51,26,25,2,2,34,9,25
"2021","St Albans 017A","E01023737",503,134,52,82,320,22,169,35,101,33,54,27,23,4,70,46,24,5,5,49,24,25
"2021","St Albans 017B","E01023738",619,163,66,97,409,30,216,61,121,34,69,35,30,4,90,53,37,4,4,47,25,22
"2021","St Albans 017C","E01023739",530,118,65,53,376,33,224,44,161,19,57,23,28,6,60,34,26,2,2,36,15,21
"2021","St Albans 017D","E01023740",721,290,90,200,394,24,191,61,114,16,121,93,26,2,50,31,19,8,8,37,9,28
"2021","St Albans 017E","E01023741",634,143,56,87,468,41,296,69,188,39,70,42,27,1,57,29,28,4,4,23,12,11
"2021","St Albans 018A","E01023704",737,285,86,199,411,38,201,65,90,46,91,54,31,6,77,49,28,4,4,41,19,22
"2021","St Albans 018B","E01023705",642,157,77,80,421,24,214,50,117,47,61,24,32,5,117,69,48,5,5,64,36,28
"2021","St Albans 018C","E01023706",691,174,85,89,471,52,250,83,110,57,73,37,28,8,95,51,44,1,1,46,17,29
"2021","St Albans 018E","E01023708",665,209,106,103,416,52,199,46,106,47,83,41,37,5,77,38,39,5,5,40,18,22
"2021","St Albans 018F","E01033028",522,96,45,51,383,37,220,44,121,55,56,26,25,5,66,37,29,4,4,43,21,22
"2021","St Albans 018G","E01033029",634,142,45,97,468,46,282,74,160,48,69,36,31,2,71,44,27,0,0,24,12,12
"2021","St Albans 019A","E01023718",712,174,121,53,501,119,277,71,148,58,58,25,24,9,45,21,24,2,2,37,13,24
"2021","St Albans 019B","E01023719",501,166,105,61,302,43,159,35,97,27,38,23,12,3,61,32,29,1,1,33,12,21
"2021","St Albans 019C","E01023720",857,276,106,170,544,42,259,66,143,50,117,73,38,6,121,82,39,5,5,37,12,25
"2021","St Albans 019D","E01023721",546,115,70,45,403,101,241,65,114,62,29,11,15,3,31,14,17,1,1,28,15,13
"2021","St Albans 020A","E01023717",551,148,39,109,376,61,205,47,119,39,47,25,18,4,60,36,24,3,3,27,9,18
"2021","St Albans 020B","E01023730",681,158,109,49,488,121,277,51,170,56,43,15,21,7,47,21,26,0,0,35,16,19
"2021","St Albans 020C","E01023731",635,180,83,97,419,93,243,60,125,58,54,29,21,4,28,12,16,1,1,36,12,24
"2021","St Albans 020D","E01023732",663,185,106,79,442,102,254,81,111,62,35,25,8,2,50,19,31,1,1,36,17,19
"2021","St Albans 020E","E01023733",759,163,110,53,557,129,322,97,151,74,52,33,16,3,52,26,26,2,2,39,19,20
"2021","St Albans 021B","E01023677",489,134,31,103,334,9,181,35,120,26,52,22,24,6,92,66,26,0,0,21,7,14
"2021","St Albans 021D","E01023678",728,161,71,90,528,78,316,79,187,50,81,44,34,3,50,30,20,3,3,39,18,21
"2021","St Albans 021A","E01023680",513,96,51,45,388,61,229,57,127,45,40,17,18,5,53,29,24,5,5,29,16,13
"2021","St Albans 021C","E01035581",631,157,80,77,443,61,224,66,107,51,72,32,35,5,83,47,36,3,3,31,14,17
"2021","Welwyn Hatfield 001A","E01023965",548,93,60,33,416,96,268,88,115,65,32,13,14,5,20,7,13,0,0,39,19,20
"2021","Welwyn Hatfield 001B","E01023966",662,137,96,41,479,125,280,92,135,53,48,20,24,4,26,11,15,0,0,46,17,29
"2021","Welwyn Hatfield 001C","E01023967",587,184,70,114,385,53,218,72,112,34,63,41,19,3,51,33,18,0,0,18,5,13
"2021","Welwyn Hatfield 001D","E01023971",630,111,72,39,494,105,318,101,149,68,44,22,17,5,27,11,16,0,0,25,7,18
"2021","Welwyn Hatfield 002B","E01023968",572,141,89,52,400,111,215,74,90,51,50,26,22,2,23,11,12,1,1,31,11,20
"2021","Welwyn Hatfield 002C","E01023969",659,219,137,82,417,102,205,73,94,38,60,32,23,5,46,29,17,4,4,23,7,16
"2021","Welwyn Hatfield 002D","E01023970",805,219,112,107,548,64,291,85,171,35,92,45,38,9,95,63,32,6,6,38,17,21
"2021","Welwyn Hatfield 002E","E01033310",649,136,31,105,457,35,243,48,153,42,83,41,37,5,87,51,36,9,9,56,27,29
"2021","Welwyn Hatfield 002F","E01033313",545,104,43,61,397,45,230,53,146,31,65,25,31,9,55,34,21,2,2,44,23,21
"2021","Welwyn Hatfield 003A","E01023959",571,141,93,48,409,95,261,89,122,50,31,14,16,1,21,13,8,1,1,21,6,15
"2021","Welwyn Hatfield 003B","E01023960",644,160,91,69,454,57,248,68,137,43,82,37,35,10,65,38,27,2,2,30,15,15
"2021","Welwyn Hatfield 003C","E01023961",608,162,73,89,421,41,201,60,117,24,84,29,53,2,93,61,32,2,2,25,9,16
"2021","Welwyn Hatfield 003D","E01023962",574,131,97,34,422,70,240,55,135,50,44,17,20,7,67,47,20,1,1,21,13,8
"2021","Welwyn Hatfield 004A","E01023912",660,211,106,105,413,58,234,65,134,35,80,43,34,3,40,24,16,1,1,36,8,28
"2021","Welwyn Hatfield 004B","E01023913",549,145,65,80,372,48,173,49,89,35,64,29,32,3,86,60,26,1,1,32,14,18
"2021","Welwyn Hatfield 004C","E01023914",746,273,153,120,446,64,208,59,111,38,77,32,42,3,93,47,46,4,4,27,7,20
"2021","Welwyn Hatfield 004D","E01023915",646,193,70,123,425,36,196,55,104,37,101,42,50,9,90,58,32,2,2,28,12,16
"2021","Welwyn Hatfield 005A","E01023950",628,151,44,107,452,53,266,88,115,63,68,45,22,1,63,26,37,2,2,25,9,16
"2021","Welwyn Hatfield 005B","E01023951",822,340,92,248,454,66,204,69,90,45,79,45,32,2,100,67,33,5,5,28,10,18
"2021","Welwyn Hatfield 005C","E01023952",827,379,169,210,429,39,214,94,88,32,105,73,30,2,67,40,27,4,4,19,8,11
"2021","Welwyn Hatfield 005D","E01023953",613,196,92,104,397,58,223,73,111,39,85,55,24,6,30,16,14,1,1,20,11,9
"2021","Welwyn Hatfield 006A","E01023916",693,200,95,105,471,49,261,66,145,50,65,29,30,6,92,58,34,4,4,22,8,14
"2021","Welwyn Hatfield 006B","E01023917",775,246,142,104,494,94,282,92,139,51,74,48,20,6,43,23,20,1,1,35,9,26
"2021","Welwyn Hatfield 006C","E01023918",1044,552,326,226,460,117,230,83,112,35,72,56,12,4,38,19,19,3,3,32,7,25
"2021","Welwyn Hatfield 006D","E01023919",587,95,72,23,470,102,293,78,167,48,34,13,20,1,39,19,20,2,2,22,6,16
"2021","Welwyn Hatfield 007B","E01023955",540,119,62,57,377,21,190,44,113,33,74,29,39,6,89,57,32,3,3,44,24,20
"2021","Welwyn Hatfield 007C","E01023956",504,108,39,69,354,11,188,56,96,36,55,27,22,6,96,58,38,4,4,42,17,25
"2021","Welwyn Hatfield 007D","E01023957",624,211,45,166,376,17,160,46,90,24,85,48,32,5,109,80,29,5,5,37,22,15
"2021","Welwyn Hatfield 007E","E01023958",612,185,70,115,394,18,149,54,68,27,82,37,37,8,136,97,39,9,9,33,17,16
"2021","Welwyn Hatfield 007F","E01035604",715,372,59,313,318,18,91,31,49,11,134,99,32,3,73,52,21,2,2,25,8,17
"2021","Welwyn Hatfield 007G","E01035605",740,229,37,192,456,13,208,83,107,18,124,69,47,8,105,68,37,6,6,55,28,27
"2021","Welwyn Hatfield 008A","E01023943",606,134,66,68,436,32,215,52,130,33,88,38,43,7,99,58,41,2,2,36,18,18
"2021","Welwyn Hatfield 008B","E01023944",886,217,86,131,627,56,331,95,189,47,99,44,47,8,140,94,46,1,1,42,23,19
"2021","Welwyn Hatfield 008C","E01023945",649,149,75,74,467,50,254,70,145,39,87,39,43,5,73,42,31,3,3,33,12,21
"2021","Welwyn Hatfield 008D","E01023946",897,254,58,196,588,52,305,87,178,40,135,73,55,7,93,74,19,3,3,55,32,23
"2021","Welwyn Hatfield 009A","E01023939",520,183,109,74,309,42,165,51,81,33,54,27,23,4,44,27,17,4,4,28,9,19
"2021","Welwyn Hatfield 009B","E01023940",712,192,84,108,475,62,232,53,137,42,86,35,45,6,90,57,33,5,5,45,20,25
"2021","Welwyn Hatfield 009D","E01023942",621,127,61,66,454,29,227,46,137,44,85,29,46,10,112,61,51,1,1,40,15,25
"2021","Welwyn Hatfield 009E","E01035606",709,154,58,96,524,38,266,58,171,37,95,43,46,6,117,80,37,8,8,31,18,13
"2021","Welwyn Hatfield 009F","E01035607",552,186,20,166,333,6,158,57,87,14,97,71,24,2,70,49,21,2,2,33,12,21
"2021","Welwyn Hatfield 010A","E01023929",651,150,76,74,443,49,228,55,128,45,72,31,35,6,89,42,47,5,5,58,26,32
"2021","Welwyn Hatfield 010B","E01023930",680,190,88,102,425,36,173,46,98,29,92,49,37,6,117,79,38,7,7,65,22,43
"2021","Welwyn Hatfield 010D","E01023938",609,135,56,79,407,77,223,69,108,46,62,38,23,1,38,20,18,7,7,67,28,39
"2021","Welwyn Hatfield 010E","E01033308",759,215,10,205,318,4,121,32,84,5,74,54,19,1,75,58,17,44,44,226,23,203
"2021","Welwyn Hatfield 010F","E01033311",583,149,64,85,368,36,189,48,107,34,61,26,28,7,77,49,28,5,5,66,31,35
"2021","Welwyn Hatfield 010G","E01033314",695,118,13,105,335,11,161,39,96,26,52,27,19,6,94,76,18,17,17,242,36,206
"2021","Welwyn Hatfield 011A","E01023924",680,259,116,143,283,28,112,29,58,25,62,29,26,7,68,45,23,13,13,138,29,109
"2021","Welwyn Hatfield 011B","E01023925",710,181,71,110,484,76,252,91,116,45,78,48,22,8,72,51,21,6,6,45,15,30
"2021","Welwyn Hatfield 011C","E01023926",810,213,111,102,533,88,308,111,145,52,92,61,25,6,37,16,21,8,8,64,17,47
"2021","Welwyn Hatfield 011D","E01023927",715,189,66,123,470,25,241,67,136,38,69,38,26,5,122,71,51,13,13,56,21,35
"2021","Welwyn Hatfield 012A","E01023920",707,295,87,208,347,14,135,46,58,31,82,50,26,6,109,66,43,7,7,65,23,42
"2021","Welwyn Hatfield 012B","E01023921",945,306,73,233,486,27,215,57,132,26,132,65,60,7,90,62,28,22,22,153,32,121
"2021","Welwyn Hatfield 012C","E01023922",651,130,50,80,410,25,176,36,111,29,67,17,44,6,124,93,31,18,18,111,33,78
"2021","Welwyn Hatfield 012D","E01023923",794,159,66,93,484,48,253,54,150,49,83,41,34,8,86,52,34,14,14,151,55,96
"2021","Welwyn Hatfield 013A","E01023932",649,134,56,78,398,16,183,37,105,41,70,27,40,3,112,70,42,17,17,117,39,78
"2021","Welwyn Hatfield 013B","E01023934",496,119,25,94,275,17,122,31,68,23,51,39,9,3,70,47,23,15,15,102,22,80
"2021","Welwyn Hatfield 013C","E01023935",486,141,50,91,237,22,130,33,70,27,34,9,19,6,42,26,16,9,9,108,25,83
"2021","Welwyn Hatfield 013D","E01023936",758,178,86,92,461,31,226,58,124,44,79,25,43,11,112,70,42,13,13,119,36,83
"2021","Welwyn Hatfield 013E","E01023937",446,138,57,81,195,20,94,27,55,12,37,10,22,5,39,20,19,5,5,113,21,92
"2021","Welwyn Hatfield 015A","E01023908",640,131,73,58,466,78,290,73,156,61,52,31,19,2,40,21,19,6,6,43,15,28
"2021","Welwyn Hatfield 015B","E01023909",417,51,35,16,338,92,202,51,108,43,24,13,10,1,18,6,12,2,2,28,10,18
"2021","Welwyn Hatfield 015C","E01023910",555,114,70,44,408,76,257,80,109,68,39,19,17,3,32,10,22,4,4,33,12,21
"2021","Welwyn Hatfield 015D","E01023911",719,207,123,84,482,95,251,66,132,53,52,28,20,4,81,47,34,3,3,30,7,23
"2021","Welwyn Hatfield 016A","E01023947",756,251,127,124,443,80,207,67,96,44,66,27,28,11,81,46,35,9,9,62,29,33
"2021","Welwyn Hatfield 016B","E01023948",667,127,90,37,501,134,290,83,130,77,43,18,21,4,31,15,16,3,3,39,23,16
"2021","Welwyn Hatfield 016C","E01023949",776,132,103,29,588,145,377,105,161,111,36,13,22,1,30,14,16,0,0,56,26,30
"2021","Welwyn Hatfield 017A","E01023933",636,219,110,109,343,38,147,44,73,30,48,23,19,6,104,66,38,6,6,74,21,53
"2021","Welwyn Hatfield 017B","E01023963",1043,371,166,205,627,73,319,100,132,87,117,61,50,6,110,59,51,8,8,45,14,31
"2021","Welwyn Hatfield 017C","E01035608",618,186,110,76,385,82,206,66,90,50,58,34,22,2,36,15,21,3,3,47,16,31
"2021","East Hertfordshire 001A","E01023462",551,100,59,41,421,84,259,106,103,50,43,27,12,4,31,23,8,4,4,30,10,20
"2021","East Hertfordshire 001C","E01023465",673,167,95,72,475,98,231,85,95,51,92,44,41,7,54,28,26,0,0,31,11,20
"2021","East Hertfordshire 001D","E01023466",922,295,186,109,587,87,291,89,152,50,112,58,47,7,93,54,39,4,4,40,15,25
"2021","East Hertfordshire 001E","E01035587",630,106,36,70,507,42,251,53,169,29,134,64,64,6,78,59,19,2,2,17,8,9
"2021","East Hertfordshire 001F","E01035588",489,83,37,46,397,70,219,67,117,35,63,25,35,3,45,32,13,0,0,9,6,3
"2021","East Hertfordshire 001G","E01035589",430,102,61,41,313,62,183,52,88,43,43,21,19,3,24,14,10,1,1,15,7,8
"2021","East Hertfordshire 003A","E01023452",481,82,36,46,379,39,252,67,128,57,37,16,15,6,50,32,18,1,1,20,9,11
"2021","East Hertfordshire 003B","E01023453",789,166,55,111,600,62,351,88,212,51,112,80,30,2,69,46,23,6,6,23,8,15
"2021","East Hertfordshire 003C","E01023454",876,182,53,129,659,68,380,108,225,47,128,72,50,6,77,57,20,6,6,35,18,17
"2021","East Hertfordshire 003D","E01023455",533,138,79,59,370,57,227,50,137,40,42,24,13,5,44,27,17,0,0,25,10,15
"2021","East Hertfordshire 003E","E01023463",549,130,69,61,400,76,235,84,102,49,53,27,22,4,33,20,13,3,3,19,9,10
"2021","East Hertfordshire 003F","E01023493",970,208,94,114,707,109,443,142,208,93,85,40,39,6,62,40,22,8,8,55,18,37
"2021","East Hertfordshire 004A","E01023449",748,190,96,94,527,93,284,76,161,47,90,68,19,3,51,35,16,9,9,31,8,23
"2021","East Hertfordshire 004C","E01023451",966,279,193,86,634,120,362,92,210,60,88,49,39,0,55,34,21,9,9,53,20,33
"2021","East Hertfordshire 004D","E01035590",664,200,55,145,432,29,239,59,151,29,104,67,34,3,59,48,11,1,1,32,10,22
"2021","East Hertfordshire 004E","E01035591",610,287,99,188,257,28,102,38,57,7,69,59,9,1,42,30,12,16,16,66,7,59
"2021","East Hertfordshire 005A","E01023438",604,141,62,79,410,42,200,53,112,35,88,50,30,8,75,47,28,5,5,53,15,38
"2021","East Hertfordshire 005B","E01023439",519,101,55,46,361,56,188,38,86,64,47,20,25,2,66,37,29,4,4,57,13,44
"2021","East Hertfordshire 005C","E01023440",688,159,104,55,490,114,277,75,156,46,46,24,20,2,49,25,24,4,4,39,15,24
"2021","East Hertfordshire 005D","E01023441",500,111,37,74,340,24,199,60,117,22,81,56,22,3,33,16,17,3,3,49,15,34
"2021","East Hertfordshire 005E","E01023442",888,228,71,157,587,53,328,84,189,55,104,55,41,8,93,66,27,9,9,73,13,60
"2021","East Hertfordshire 006B","E01023506",629,156,83,73,448,77,254,71,126,57,56,23,29,4,59,31,28,2,2,25,11,14
"2021","East Hertfordshire 006C","E01023507",659,137,76,61,490,86,294,105,137,52,68,37,25,6,42,23,19,0,0,32,12,20
"2021","East Hertfordshire 006D","E01035592",444,116,44,72,313,40,143,39,83,21,84,44,37,3,41,35,6,5,5,15,5,10
"2021","East Hertfordshire 006E","E01035593",791,213,135,78,554,89,302,108,139,55,76,31,39,6,82,54,28,5,5,24,10,14
"2021","East Hertfordshire 007A","E01023443",613,186,91,95,409,50,233,81,104,48,67,39,24,4,58,33,25,1,1,18,3,15
"2021","East Hertfordshire 007B","E01023444",803,211,72,139,533,44,293,83,166,44,112,81,30,1,75,46,29,9,9,59,8,51
"2021","East Hertfordshire 007C","E01023445",722,220,133,87,462,61,233,68,118,47,89,39,37,13,76,38,38,3,3,40,13,27
"2021","East Hertfordshire 007E","E01023447",521,145,60,85,319,25,140,32,73,35,43,11,21,11,107,65,42,4,4,57,42,15
"2021","East Hertfordshire 007F","E01023448",579,140,46,94,414,31,271,83,142,46,62,30,29,3,49,35,14,1,1,25,11,14
"2021","East Hertfordshire 007G","E01035594",698,253,101,152,408,36,159,56,88,15,144,107,34,3,62,37,25,7,7,37,6,31
"2021","East Hertfordshire 007H","E01035595",591,247,87,160,282,8,94,42,45,7,130,113,16,1,33,24,9,17,17,62,7,55
"2021","East Hertfordshire 008A","E01023456",504,102,51,51,382,37,263,78,132,53,38,22,14,2,42,28,14,2,2,20,10,10
"2021","East Hertfordshire 008B","E01023457",602,152,71,81,432,57,253,59,149,45,63,39,21,3,58,35,23,1,1,18,7,11
"2021","East Hertfordshire 008C","E01023458",561,156,68,88,369,39,211,55,118,38,63,34,22,7,50,29,21,6,6,36,15,21
"2021","East Hertfordshire 008D","E01023459",512,119,66,53,369,68,217,75,105,37,46,26,19,1,36,21,15,2,2,24,9,15
"2021","East Hertfordshire 008E","E01023460",547,93,51,42,425,49,255,49,152,54,68,30,33,5,52,25,27,1,1,29,10,19
"2021","East Hertfordshire 008F","E01023461",519,63,32,31,419,32,330,80,182,68,31,15,12,4,26,17,9,0,0,37,23,14
"2021","East Hertfordshire 009A","E01023491",559,135,70,65,397,58,217,78,88,51,75,44,29,2,46,28,18,1,1,27,10,17
"2021","East Hertfordshire 009B","E01023492",846,164,76,88,634,82,352,109,179,64,116,65,46,5,79,43,36,5,5,48,19,29
"2021","East Hertfordshire 009C","E01023496",483,105,47,58,345,68,192,66,89,37,46,23,21,2,39,19,20,0,0,33,12,21
"2021","East Hertfordshire 009D","E01023497",683,175,113,62,481,97,267,76,139,52,71,45,25,1,46,29,17,0,0,27,6,21
"2021","East Hertfordshire 010A","E01023485",954,236,111,125,685,149,389,146,167,76,84,39,33,12,63,32,31,0,0,33,14,19
"2021","East Hertfordshire 010B","E01023486",1052,217,120,97,771,151,427,145,195,87,88,58,28,2,99,61,38,6,6,64,27,37
"2021","East Hertfordshire 010E","E01033609",1086,273,136,137,779,136,403,108,216,79,142,77,55,10,93,62,31,5,5,34,12,22
"2021","East Hertfordshire 011A","E01023499",896,265,123,142,581,72,278,81,156,41,104,39,52,13,122,90,32,5,5,50,23,27
"2021","East Hertfordshire 011B","E01023500",644,140,101,39,478,127,276,81,133,62,45,17,20,8,26,5,21,4,4,26,11,15
"2021","East Hertfordshire 011C","E01023501",671,192,85,107,460,94,238,74,118,46,69,32,30,7,58,36,22,1,1,19,8,11
"2021","East Hertfordshire 011D","E01023502",801,275,118,157,505,76,262,94,126,42,101,62,33,6,65,41,24,1,1,21,7,14
"2021","East Hertfordshire 011E","E01023503",648,148,97,51,476,124,273,70,139,64,45,25,19,1,34,16,18,0,0,24,11,13
"2021","East Hertfordshire 012A","E01023512",934,313,112,201,593,62,311,107,157,47,137,93,39,5,79,54,25,4,4,28,7,21
"2021","East Hertfordshire 012B","E01023513",595,154,93,61,422,66,228,61,121,46,55,20,30,5,69,42,27,4,4,19,10,9
"2021","East Hertfordshire 012C","E01023514",1079,513,193,320,523,64,209,74,110,25,161,124,35,2,81,61,20,8,8,43,7,36
"2021","East Hertfordshire 012D","E01023518",780,165,81,84,580,66,261,66,146,49,102,41,54,7,148,95,53,3,3,35,13,22
"2021","East Hertfordshire 012E","E01023519",667,139,54,85,502,34,266,77,136,53,110,56,42,12,90,52,38,2,2,26,9,17
"2021","East Hertfordshire 012F","E01023520",659,190,92,98,449,86,246,60,137,49,68,27,34,7,48,19,29,1,1,20,6,14
"2021","East Hertfordshire 013A","E01023510",663,159,74,85,477,75,267,84,142,41,80,51,28,1,52,29,23,3,3,27,9,18
"2021","East Hertfordshire 013B","E01023511",887,389,118,271,456,40,171,75,75,21,168,132,34,2,68,47,21,9,9,42,7,35
"2021","East Hertfordshire 013C","E01023515",719,200,62,138,493,60,246,83,122,41,120,71,47,2,66,43,23,1,1,26,11,15
"2021","East Hertfordshire 013D","E01023516",860,255,109,146,588,109,301,113,123,65,106,63,37,6,69,37,32,3,3,17,6,11
"2021","East Hertfordshire 013E","E01023517",682,213,94,119,434,61,202,65,96,41,104,52,44,8,65,35,30,2,2,35,14,21
"2021","East Hertfordshire 014A","E01023470",900,386,131,255,488,53,236,95,109,32,148,110,34,4,48,28,20,3,3,26,8,18
"2021","East Hertfordshire 014B","E01023471",558,121,61,60,419,72,238,69,138,31,71,41,28,2,36,20,16,2,2,18,9,9
"2021","East Hertfordshire 014C","E01023472",603,209,102,107,376,49,157,39,85,33,65,29,33,3,104,62,42,1,1,18,6,12
"2021","East Hertfordshire 014D","E01023473",694,141,98,43,524,137,280,71,165,44,59,27,30,2,48,23,25,0,0,29,14,15
"2021","East Hertfordshire 014E","E01023474",631,139,63,76,472,71,265,73,152,40,83,48,33,2,52,32,20,1,1,20,6,14
"2021","East Hertfordshire 015A","E01023487",706,253,92,161,425,41,183,58,84,41,83,37,42,4,115,80,35,3,3,28,12,16
"2021","East Hertfordshire 015B","E01023488",715,228,58,170,453,37,174,51,100,23,99,42,53,4,140,106,34,3,3,34,19,15
"2021","East Hertfordshire 015C","E01023489",637,207,85,122,413,61,196,63,100,33,102,75,26,1,48,28,20,6,6,17,4,13
"2021","East Hertfordshire 015D","E01023490",480,77,33,44,380,42,217,60,117,40,68,26,29,13,51,31,20,2,2,23,12,11
"2021","East Hertfordshire 016A","E01023482",748,175,51,124,556,27,348,88,193,67,95,49,40,6,85,68,17,1,1,17,10,7
"2021","East Hertfordshire 016B","E01023483",955,230,73,157,687,66,377,83,221,73,148,84,53,11,89,57,32,7,7,38,16,22
"2021","East Hertfordshire 016C","E01023484",670,198,58,140,440,30,217,46,126,45,110,54,45,11,79,54,25,4,4,32,15,17
"2021","East Hertfordshire 017A","E01023475",608,164,81,83,424,45,180,49,101,30,83,42,36,5,112,81,31,4,4,20,2,18
"2021","East Hertfordshire 017B","E01023476",725,195,111,84,504,114,286,79,163,44,59,36,21,2,44,25,19,1,1,26,11,15
"2021","East Hertfordshire 017C","E01023477",969,293,83,210,628,48,312,90,181,41,162,100,58,4,94,56,38,12,12,48,11,37
"2021","East Hertfordshire 017E","E01023479",697,205,80,125,451,54,230,77,114,39,104,74,26,4,58,33,25,5,5,41,12,29
"2021","East Hertfordshire 017F","E01035596",751,311,45,266,405,26,115,63,48,4,194,167,27,0,63,42,21,7,7,35,3,32
"2021","East Hertfordshire 017G","E01035597",777,463,212,251,281,44,97,38,50,9,101,83,18,0,34,24,10,5,5,33,1,32
"2021","East Hertfordshire 018A","E01023468",536,147,45,102,372,65,227,79,95,53,47,30,14,3,31,17,14,2,2,17,8,9
"2021","East Hertfordshire 018B","E01023469",600,161,84,77,415,76,218,69,103,46,53,19,27,7,67,37,30,1,1,24,15,9
"2021","East Hertfordshire 018C","E01023480",700,196,114,82,477,100,228,55,121,52,63,29,28,6,84,43,41,2,2,27,7,20
"2021","East Hertfordshire 018D","E01023481",511,101,42,59,376,57,214,71,111,32,64,40,23,1,41,29,12,0,0,34,16,18
"2021","East Hertfordshire 018E","E01023504",608,211,104,107,373,49,210,68,105,37,51,34,13,4,57,33,24,6,6,24,10,14
"2021","East Hertfordshire 018F","E01023505",736,238,85,153,472,75,230,81,106,43,94,60,31,3,69,47,22,4,4,26,6,20
"2021","East Hertfordshire 019E","E01023467",986,230,126,104,710,185,376,113,165,98,79,46,26,7,69,30,39,1,1,46,11,35
"2021","East Hertfordshire 019A","E01023494",663,143,72,71,489,105,259,94,121,44,61,26,30,5,61,40,21,3,3,31,11,20
"2021","East Hertfordshire 019D","E01023495",503,109,58,51,370,64,212,71,93,48,61,27,27,7,31,16,15,2,2,24,10,14
"2021","East Hertfordshire 019B","E01023509",564,141,64,77,397,56,211,72,107,32,78,41,33,4,49,36,13,3,3,26,10,16
"2021","East Hertfordshire 019C","E01035609",581,100,50,50,452,79,237,89,98,50,75,42,29,4,61,35,26,0,0,29,12,17
"2021","Stevenage 001A","E01023787",543,132,46,86,362,43,182,45,105,32,66,31,26,9,65,39,26,6,6,49,16,33
"2021","Stevenage 001B","E01023788",618,172,76,96,399,43,205,42,116,47,62,34,22,6,86,50,36,3,3,47,25,22
"2021","Stevenage 001D","E01023790",627,158,45,113,414,37,184,46,90,48,93,37,46,10,93,71,22,7,7,55,27,28
"2021","Stevenage 001E","E01035568",653,230,10,220,385,4,174,41,125,8,124,73,49,2,79,67,12,4,4,38,22,16
"2021","Stevenage 001F","E01035569",662,137,52,85,461,41,229,72,114,43,82,30,44,8,108,74,34,1,1,64,33,31
"2021","Stevenage 002A","E01023776",1158,346,131,215,733,95,368,127,178,63,155,92,53,10,106,65,41,9,9,79,19,60
"2021","Stevenage 002B","E01023777",772,222,117,105,520,70,251,94,108,49,117,60,50,7,79,41,38,3,3,30,5,25
"2021","Stevenage 002C","E01023778",670,162,71,91,467,40,193,44,101,48,104,36,60,8,123,80,43,7,7,41,17,24
"2021","Stevenage 002D","E01023799",510,86,44,42,394,65,232,79,98,55,42,21,16,5,54,30,24,1,1,30,17,13
"2021","Stevenage 002E","E01023800",821,199,83,116,512,88,272,92,129,51,80,48,27,5,67,44,23,5,5,110,16,94
"2021","Stevenage 002F","E01023801",924,189,52,137,687,47,388,92,230,66,130,70,55,5,118,75,43,4,4,48,21,27
"2021","Stevenage 003A","E01023771",685,181,72,109,472,68,210,65,98,47,105,58,39,8,86,45,41,3,3,32,14,18
"2021","Stevenage 003B","E01023772",770,306,85,221,403,50,203,73,94,36,64,25,37,2,82,38,44,4,4,61,25,36
"2021","Stevenage 003C","E01023773",507,117,37,80,363,30,177,52,78,47,56,21,30,5,99,63,36,1,1,27,9,18
"2021","Stevenage 003D","E01023774",666,252,77,175,363,36,167,49,92,26,87,45,38,4,70,41,29,3,3,51,21,30
"2021","Stevenage 005A","E01023795",729,226,114,112,459,69,225,84,98,43,80,43,31,6,80,56,24,5,5,44,15,29
"2021","Stevenage 005B","E01023796",716,290,133,157,400,45,174,52,78,44,94,53,38,3,79,50,29,8,8,26,5,21
"2021","Stevenage 005C","E01023797",564,169,96,73,378,46,177,59,85,33,75,32,33,10,74,50,24,6,6,17,8,9
"2021","Stevenage 005D","E01023798",663,188,59,129,440,49,215,78,99,38,91,42,39,10,76,43,33,9,9,35,17,18
"2021","Stevenage 006A","E01023775",1112,473,220,253,583,74,247,96,116,35,164,102,54,8,88,64,24,10,10,56,20,36
"2021","Stevenage 006B","E01023779",721,214,69,145,444,36,192,50,101,41,77,39,36,2,130,81,49,9,9,63,21,42
"2021","Stevenage 006C","E01023780",626,227,99,128,356,45,173,54,78,41,63,31,28,4,72,45,27,3,3,43,13,30
"2021","Stevenage 006D","E01023781",803,295,109,186,468,46,199,63,107,29,106,44,56,6,114,84,30,3,3,40,14,26
"2021","Stevenage 006E","E01023782",631,220,104,116,386,70,171,54,70,47,71,37,29,5,67,41,26,7,7,25,12,13
"2021","Stevenage 007A","E01023759",576,134,66,68,391,36,193,49,114,30,66,26,30,10,90,41,49,6,6,51,26,25
"2021","Stevenage 007B","E01023760",610,135,74,61,440,53,212,63,105,44,85,33,42,10,87,51,36,3,3,35,11,24
"2021","Stevenage 007C","E01023761",855,213,68,145,576,47,273,79,149,45,124,55,61,8,128,86,42,4,4,66,27,39
"2021","Stevenage 007D","E01023762",628,166,87,79,416,51,212,65,107,40,65,21,38,6,87,49,38,1,1,46,25,21
"2021","Stevenage 008A","E01023755",663,148,60,88,447,49,220,70,110,40,74,37,36,1,95,49,46,9,9,68,27,41
"2021","Stevenage 008B","E01023756",599,114,51,63,420,33,196,50,98,48,70,26,38,6,111,66,45,10,10,65,31,34
"2021","Stevenage 008C","E01023757",736,176,80,96,488,33,243,55,133,55,85,36,38,11,120,76,44,7,7,72,37,35
"2021","Stevenage 008E","E01035570",739,386,93,293,323,18,107,42,58,7,114,85,28,1,70,59,11,14,14,30,7,23
"2021","Stevenage 008F","E01035571",684,329,116,213,322,23,146,48,78,20,68,36,29,3,77,49,28,8,8,33,5,28
"2021","Stevenage 009A","E01023750",587,265,105,160,305,28,146,58,58,30,54,29,19,6,74,45,29,3,3,17,8,9
"2021","Stevenage 009B","E01023751",475,113,57,56,332,40,162,56,69,37,67,32,28,7,60,32,28,3,3,30,17,13
"2021","Stevenage 009C","E01023752",523,94,44,50,387,37,203,54,109,40,67,24,38,5,75,46,29,5,5,42,16,26
"2021","Stevenage 009D","E01023753",716,206,78,128,483,57,273,97,113,63,97,54,39,4,56,34,22,0,0,27,10,17
"2021","Stevenage 009E","E01023754",460,85,47,38,349,21,195,52,98,45,64,25,30,9,68,43,25,1,1,26,12,14
"2021","Stevenage 010A","E01023791",650,147,71,76,451,47,245,69,134,42,70,36,25,9,85,39,46,4,4,52,25,27
"2021","Stevenage 010B","E01023792",606,129,64,65,435,29,207,51,115,41,91,30,52,9,104,66,38,4,4,42,22,20
"2021","Stevenage 010C","E01023793",612,174,75,99,393,42,171,58,86,27,72,32,33,7,103,58,45,5,5,45,20,25
"2021","Stevenage 010D","E01023794",628,159,55,104,424,40,222,69,111,42,68,28,28,12,88,52,36,6,6,45,23,22
"2021","Stevenage 011A","E01023783",718,259,67,192,412,39,219,68,106,45,87,40,39,8,64,34,30,3,3,47,19,28
"2021","Stevenage 011B","E01023784",650,167,112,55,446,78,223,69,98,56,67,31,32,4,75,41,34,3,3,37,13,24
"2021","Stevenage 011C","E01023785",784,220,76,144,521,37,235,66,119,50,112,46,58,8,130,89,41,7,7,43,20,23
"2021","Stevenage 011D","E01023786",763,232,85,147,479,37,245,67,137,41,102,56,40,6,84,52,32,11,11,52,25,27
"2021","Stevenage 012A","E01023763",603,139,49,90,425,68,233,75,110,48,67,38,27,2,56,31,25,1,1,39,13,26
"2021","Stevenage 012B","E01023764",570,185,78,107,354,46,212,101,67,44,48,23,22,3,47,22,25,1,1,31,10,21
"2021","Stevenage 012C","E01023765",611,149,91,58,418,49,202,51,102,49,79,33,37,9,84,50,34,4,4,44,22,22
"2021","Stevenage 012D","E01023766",623,160,71,89,421,44,210,64,110,36,86,38,43,5,75,47,28,6,6,42,26,16
"2021","Stevenage 013D","E01023767",649,181,55,126,438,46,254,85,117,52,99,58,38,3,35,17,18,4,4,30,13,17
"2021","Stevenage 013B","E01023769",725,211,100,111,476,52,247,72,130,45,91,49,37,5,85,46,39,1,1,38,17,21
"2021","Stevenage 013C","E01023770",627,141,72,69,468,80,260,103,104,53,85,53,27,5,42,19,23,1,1,18,9,9
"2021","Stevenage 013A","E01035582",686,154,56,98,504,73,302,104,140,58,93,62,25,6,34,18,16,2,2,28,11,17
"2021","East Suffolk 016A","E01030201",970,265,157,108,664,165,332,177,84,71,108,63,39,6,57,31,26,2,2,41,15,26
"2021","East Suffolk 016B","E01030219",928,287,182,105,602,183,273,137,103,33,91,51,34,6,51,22,29,4,4,39,17,22
"2021","East Suffolk 016C","E01030222",1009,304,197,107,665,215,295,177,66,52,95,61,27,7,55,27,28,5,5,40,16,24
"2021","East Suffolk 017A","E01030154",956,238,132,106,681,176,351,171,118,62,87,45,30,12,65,43,22,2,2,37,11,26
"2021","East Suffolk 017B","E01030172",953,301,165,136,625,124,295,114,132,49,117,54,58,5,85,61,24,4,4,27,8,19
"2021","East Suffolk 017C","E01030173",933,336,193,143,576,117,265,89,123,53,97,45,45,7,95,71,24,2,2,21,9,12
"2021","East Suffolk 017D","E01030174",570,121,69,52,429,104,213,98,71,44,71,36,34,1,37,25,12,4,4,20,7,13
"2021","East Suffolk 017E","E01030176",888,218,130,88,626,145,327,152,119,56,79,47,25,7,70,38,32,5,5,44,17,27
"2021","East Suffolk 018A","E01030186",733,202,133,69,512,141,250,126,77,47,75,37,34,4,46,22,24,0,0,19,9,10
"2021","East Suffolk 018B","E01030208",607,196,120,76,378,112,158,81,48,29,53,26,18,9,54,28,26,1,1,33,11,22
"2021","East Suffolk 018C","E01030209",1120,442,210,232,641,142,240,110,98,32,141,72,63,6,110,76,34,8,8,37,10,27
"2021","East Suffolk 018D","E01030210",1055,339,140,199,677,123,300,93,167,40,139,56,74,9,112,76,36,3,3,39,19,20
"2021","East Suffolk 018E","E01030212",935,255,163,92,640,190,311,175,83,53,80,55,23,2,59,29,30,0,0,40,15,25
"2021","East Suffolk 019A","E01030152",1039,382,283,99,629,263,259,153,62,44,71,48,18,5,35,13,22,1,1,28,5,23
"2021","East Suffolk 019B","E01030153",590,258,155,103,313,82,128,63,46,19,60,33,24,3,39,23,16,4,4,19,4,15
"2021","East Suffolk 019C","E01030187",719,245,135,110,440,84,195,86,75,34,92,42,45,5,65,41,24,4,4,34,14,20
"2021","East Suffolk 019D","E01030188",856,371,133,238,446,66,172,85,58,29,131,73,56,2,74,47,27,3,3,39,16,23
"2021","East Suffolk 019E","E01030189",734,271,143,128,433,82,185,87,64,34,101,49,46,6,62,46,16,3,3,30,10,20
"2021","East Suffolk 020A","E01030193",918,233,124,109,654,144,307,125,128,54,117,70,40,7,82,60,22,4,4,31,10,21
"2021","East Suffolk 020B","E01030194",939,439,228,211,478,96,209,86,93,30,92,56,31,5,79,49,30,2,2,22,8,14
"2021","East Suffolk 020C","E01030195",692,150,97,53,535,143,276,115,103,58,73,42,25,6,43,22,21,0,0,7,3,4
"2021","East Suffolk 020D","E01030220",1048,334,207,127,690,195,270,127,85,58,124,56,65,3,95,57,38,6,6,24,9,15
"2021","East Suffolk 021A","E01030175",1012,263,155,108,711,172,384,138,180,66,82,41,36,5,70,43,27,3,3,38,16,22
"2021","East Suffolk 021B","E01030200",917,180,115,65,688,164,376,169,145,62,90,54,29,7,58,30,28,0,0,49,20,29
"2021","East Suffolk 021C","E01030221",904,223,133,90,636,140,348,150,128,70,101,56,39,6,45,22,23,2,2,45,19,26
"2021","East Suffolk 023A","E01030199",847,259,147,112,566,142,284,162,74,48,83,48,27,8,54,28,26,3,3,22,6,16
"2021","East Suffolk 023B","E01033443",515,95,52,43,405,60,264,93,140,31,44,19,21,4,37,25,12,0,0,15,5,10
"2021","East Suffolk 023C","E01033445",669,163,64,99,483,54,279,83,158,38,85,48,34,3,64,48,16,1,1,23,7,16
"2021","East Suffolk 023D","E01033446",971,263,145,118,670,177,335,150,124,61,93,61,28,4,63,37,26,2,2,38,19,19
"2021","East Suffolk 023E","E01033448",557,134,68,66,397,112,196,94,63,39,58,28,23,7,31,17,14,0,0,26,12,14
"2021","East Suffolk 023F","E01033449",770,202,78,124,533,81,286,100,146,40,91,40,47,4,72,52,20,3,3,35,13,22
"2021","East Suffolk 022A","E01030155",870,256,147,109,592,135,255,85,124,46,100,51,39,10,101,54,47,1,1,22,6,16
"2021","East Suffolk 022B","E01030185",871,267,176,91,576,119,226,71,100,55,96,49,41,6,133,82,51,2,2,28,13,15
"2021","East Suffolk 022C","E01030203",979,395,296,99,564,204,263,108,113,42,57,34,22,1,39,21,18,1,1,20,11,9
"2021","East Suffolk 022D","E01030211",1105,566,328,238,520,143,200,105,60,35,98,69,28,1,75,50,25,4,4,19,8,11
"2021","East Suffolk 024A","E01030179",1062,269,97,172,743,66,418,107,251,60,126,60,63,3,132,96,36,1,1,50,19,31
"2021","East Suffolk 024B","E01030180",563,131,63,68,410,76,232,72,113,47,55,34,18,3,47,29,18,0,0,22,11,11
"2021","East Suffolk 024C","E01030183",856,246,178,68,580,192,279,101,103,75,58,25,29,4,49,24,25,2,2,30,11,19
"2021","East Suffolk 024D","E01030184",800,274,191,83,493,149,199,80,80,39,62,26,26,10,77,46,31,6,6,33,18,15
"2021","East Suffolk 024E","E01030207",703,205,123,82,464,143,223,80,100,43,58,28,24,6,40,17,23,0,0,34,15,19
"2021","East Suffolk 025A","E01030181",814,249,69,180,530,52,334,104,178,52,53,24,27,2,86,63,23,5,5,35,16,19
"2021","East Suffolk 025B","E01030190",1021,240,160,80,763,241,354,132,147,75,92,48,41,3,73,43,30,3,3,18,8,10
"2021","East Suffolk 025C","E01030191",761,320,144,176,425,99,207,81,79,47,59,32,25,2,56,37,19,4,4,16,5,11
"2021","East Suffolk 025D","E01030192",606,151,97,54,440,131,233,104,81,48,47,24,16,7,25,11,14,4,4,15,8,7
"2021","East Suffolk 025E","E01030198",594,156,96,60,406,105,218,110,70,38,54,31,18,5,27,19,8,2,2,32,10,22
"2021","East Suffolk 025F","E01033442",553,85,18,67,451,15,267,53,182,32,93,46,40,7,74,56,18,2,2,17,12,5
"2021","East Suffolk 025G","E01033444",523,96,14,82,395,5,237,39,168,30,87,40,40,7,66,46,20,0,0,32,18,14
"2021","East Suffolk 025H","E01033447",589,143,99,44,416,96,248,79,136,33,34,12,18,4,38,23,15,0,0,30,14,16
"2021","East Suffolk 026A","E01030196",687,196,66,130,452,81,257,97,100,60,75,49,22,4,38,25,13,1,1,39,7,32
"2021","East Suffolk 026B","E01030197",766,195,111,84,534,161,292,136,103,53,60,37,17,6,21,11,10,0,0,37,13,24
"2021","East Suffolk 026C","E01030204",764,165,95,70,567,124,322,107,147,68,73,31,32,10,48,27,21,0,0,32,14,18
"2021","East Suffolk 026D","E01030205",490,80,44,36,386,61,259,87,113,59,41,24,13,4,25,13,12,0,0,24,9,15
"2021","East Suffolk 026E","E01030206",644,171,144,27,453,150,242,80,99,63,37,17,17,3,22,8,14,2,2,20,10,10
"2021","East Suffolk 027A","E01030171",787,211,100,111,541,94,265,100,108,57,108,61,39,8,68,32,36,6,6,35,16,19
"2021","East Suffolk 027B","E01030214",532,148,49,99,370,58,194,82,70,42,63,31,26,6,52,32,20,3,3,14,5,9
"2021","East Suffolk 027C","E01030215",792,287,109,178,484,67,240,111,99,30,107,67,34,6,66,42,24,4,4,21,7,14
"2021","East Suffolk 027D","E01030216",649,169,104,65,461,119,238,97,91,50,66,39,24,3,36,22,14,2,2,19,6,13
"2021","East Suffolk 027E","E01030217",618,137,80,57,451,109,237,114,84,39,65,32,24,9,40,26,14,0,0,30,11,19
"2021","East Suffolk 027F","E01030218",662,183,83,100,460,81,233,101,87,45,96,57,36,3,49,34,15,1,1,19,4,15
"2021","East Suffolk 028A","E01030158",738,215,140,75,498,250,180,105,38,37,34,25,7,2,34,22,12,0,0,25,9,16
"2021","East Suffolk 028B","E01030159",660,194,104,90,439,99,211,88,76,47,62,24,33,5,64,34,30,3,3,27,7,20
"2021","East Suffolk 028C","E01030164",692,225,156,69,440,132,220,104,75,41,59,35,20,4,29,13,16,0,0,27,12,15
"2021","East Suffolk 028D","E01030166",667,194,151,43,458,178,220,111,78,31,36,18,13,5,22,13,9,2,2,15,6,9
"2021","East Suffolk 028E","E01033450",1121,348,248,100,754,283,336,161,98,77,73,42,27,4,61,34,27,1,1,19,6,13
"2021","East Suffolk 029A","E01030160",807,359,186,173,420,77,182,79,69,34,77,45,28,4,81,50,31,3,3,28,4,24
"2021","East Suffolk 029B","E01030161",736,221,73,148,484,43,176,64,86,26,126,64,56,6,135,88,47,4,4,31,14,17
"2021","East Suffolk 029C","E01030168",654,271,120,151,354,62,143,59,62,22,63,34,27,2,83,61,22,3,3,29,14,15
"2021","East Suffolk 029D","E01030169",820,384,115,269,413,30,185,87,68,30,106,58,45,3,86,56,30,6,6,23,7,16
"2021","East Suffolk 029E","E01030170",759,246,144,102,490,82,210,84,84,42,78,29,38,11,115,61,54,5,5,23,10,13
"2021","East Suffolk 030A","E01030162",742,378,154,224,317,66,109,53,36,20,80,56,20,4,57,35,22,5,5,47,16,31
"2021","East Suffolk 030B","E01030163",779,247,103,144,468,65,192,88,70,34,84,37,38,9,123,91,32,4,4,64,27,37
"2021","East Suffolk 030C","E01030165",878,406,196,210,430,85,178,83,60,35,92,59,28,5,68,39,29,7,7,42,17,25
"2021","East Suffolk 030D","E01030167",619,225,152,73,371,117,167,75,58,34,47,30,12,5,37,20,17,3,3,23,6,17
"2021","East Suffolk 001A","E01030240",749,238,134,104,469,175,188,96,53,39,65,42,17,6,39,10,29,2,2,42,20,22
"2021","East Suffolk 001B","E01030241",702,217,147,70,461,149,212,106,65,41,63,32,26,5,36,15,21,1,1,24,6,18
"2021","East Suffolk 001C","E01030242",600,145,103,42,440,134,231,98,81,52,47,22,22,3,28,12,16,0,0,15,7,8
"2021","East Suffolk 001D","E01030259",490,127,60,67,340,74,187,89,68,30,53,29,18,6,25,9,16,1,1,23,6,17
"2021","East Suffolk 001E","E01030260",461,119,45,74,328,57,165,77,60,28,77,41,32,4,28,17,11,1,1,14,6,8
"2021","East Suffolk 002A","E01030261",627,231,90,141,358,38,121,38,53,30,88,29,54,5,101,64,37,10,10,38,16,22
"2021","East Suffolk 002B","E01030262",569,204,111,93,330,73,113,34,66,13,79,35,42,2,62,41,21,3,3,35,17,18
"2021","East Suffolk 002C","E01030277",491,165,93,72,299,34,130,53,50,27,53,17,31,5,78,48,30,4,4,27,16,11
"2021","East Suffolk 002D","E01030279",602,232,105,127,327,35,118,33,53,32,93,28,50,15,77,48,29,4,4,43,18,25
"2021","East Suffolk 002E","E01030281",1036,265,126,139,737,100,352,129,164,59,147,49,88,10,133,94,39,5,5,34,18,16
"2021","East Suffolk 003A","E01030266",706,219,130,89,458,91,209,87,73,49,89,47,41,1,69,35,34,0,0,29,16,13
"2021","East Suffolk 003B","E01030267",910,214,99,115,660,94,287,110,132,45,184,99,79,6,95,62,33,0,0,36,15,21
"2021","East Suffolk 003C","E01030271",708,230,160,70,457,186,169,87,48,34,71,34,31,6,31,12,19,0,0,21,8,13
"2021","East Suffolk 003D","E01030278",727,231,170,61,482,168,184,89,55,40,64,26,32,6,63,36,27,3,3,14,5,9
"2021","East Suffolk 003E","E01030280",617,163,118,45,438,135,210,86,76,48,64,33,28,3,28,11,17,1,1,16,4,12
"2021","East Suffolk 004A","E01030246",631,224,77,147,369,35,126,44,57,25,102,40,55,7,103,71,32,3,3,38,15,23
"2021","East Suffolk 004B","E01030248",636,184,52,132,417,37,156,61,69,26,101,45,49,7,122,85,37,1,1,35,17,18
"2021","East Suffolk 004C","E01030249",824,326,108,218,458,32,143,56,61,26,128,55,66,7,149,98,51,6,6,40,13,27
"2021","East Suffolk 004D","E01030250",1021,484,99,385,484,26,124,55,46,23,155,77,72,6,168,124,44,11,11,53,15,38
"2021","East Suffolk 004E","E01030264",632,222,76,146,381,29,133,54,60,19,105,35,66,4,110,72,38,4,4,29,11,18
"2021","East Suffolk 004F","E01030265",627,220,79,141,369,37,140,54,65,21,97,40,52,5,93,57,36,2,2,38,14,24
"2021","East Suffolk 005A","E01030255",512,129,65,64,357,38,154,57,62,35,94,39,47,8,67,42,25,4,4,26,9,17
"2021","East Suffolk 005B","E01030263",714,254,130,124,431,124,187,79,69,39,76,37,31,8,44,27,17,0,0,29,12,17
"2021","East Suffolk 005C","E01030270",686,226,123,103,422,82,168,72,67,29,92,44,39,9,77,46,31,3,3,38,15,23
"2021","East Suffolk 005D","E01030289",708,277,116,161,400,59,164,65,62,37,100,44,46,10,74,50,24,3,3,31,5,26
"2021","East Suffolk 005E","E01030290",698,267,153,114,409,126,170,58,72,40,72,39,28,5,40,20,20,1,1,22,15,7
"2021","East Suffolk 007A","E01030233",635,147,96,51,457,158,216,91,83,42,54,24,23,7,29,11,18,0,0,31,13,18
"2021","East Suffolk 007B","E01030235",655,180,109,71,448,132,203,89,65,49,76,38,33,5,36,19,17,1,1,27,8,19
"2021","East Suffolk 007C","E01030268",533,113,85,28,400,94,205,67,85,53,64,24,32,8,37,20,17,0,0,20,6,14
"2021","East Suffolk 007D","E01030269",772,273,139,134,477,150,189,81,68,40,74,39,26,9,62,34,28,2,2,22,5,17
"2021","East Suffolk 007E","E01030288",635,157,114,43,456,152,211,92,70,49,59,35,20,4,33,12,21,1,1,22,7,15
"2021","East Suffolk 006A","E01030247",1029,584,197,387,406,22,97,45,37,15,112,48,56,8,165,126,39,10,10,39,15,24
"2021","East Suffolk 006B","E01030254",624,215,79,136,376,39,139,58,59,22,86,40,40,6,109,77,32,3,3,33,12,21
"2021","East Suffolk 006C","E01030256",694,329,120,209,324,58,140,58,52,30,67,31,33,3,57,28,29,2,2,41,23,18
"2021","East Suffolk 006D","E01030258",907,558,164,394,308,36,119,51,49,19,81,61,18,2,69,47,22,3,3,41,11,30
"2021","East Suffolk 006E","E01030276",586,231,104,127,334,54,131,49,58,24,79,40,35,4,67,43,24,3,3,21,6,15
"2021","East Suffolk 009A","E01030257",640,213,126,87,389,72,165,66,66,33,81,41,35,5,67,47,20,4,4,38,19,19
"2021","East Suffolk 009B","E01030274",612,303,188,115,294,73,107,43,35,29,52,24,22,6,62,43,19,0,0,15,8,7
"2021","East Suffolk 009C","E01030275",506,132,80,52,351,77,161,71,51,39,68,37,28,3,44,28,16,1,1,23,9,14
"2021","East Suffolk 009D","E01030287",660,245,168,77,385,114,165,74,57,34,52,25,21,6,53,30,23,1,1,30,16,14
"2021","East Suffolk 009E","E01030291",604,199,88,111,363,64,152,51,57,44,60,16,36,8,86,58,28,1,1,42,18,24
"2021","East Suffolk 008A","E01030234",665,203,54,149,431,31,173,66,72,35,114,43,64,7,109,78,31,4,4,31,8,23
"2021","East Suffolk 008B","E01030236",852,268,145,123,557,108,232,94,94,44,119,63,47,9,94,63,31,4,4,27,9,18
"2021","East Suffolk 008C","E01030237",1191,300,165,135,844,144,448,160,210,78,143,69,71,3,105,70,35,4,4,47,22,25
"2021","East Suffolk 008D","E01030238",737,173,100,73,542,104,275,91,120,64,107,55,48,4,56,37,19,0,0,22,9,13
"2021","East Suffolk 010A","E01030223",854,318,150,168,514,110,223,90,81,52,79,39,32,8,97,67,30,5,5,22,10,12
"2021","East Suffolk 010B","E01030224",787,286,181,105,474,154,197,94,68,35,73,45,24,4,48,24,24,2,2,27,10,17
"2021","East Suffolk 010C","E01030225",865,412,165,247,430,91,158,73,59,26,94,55,36,3,85,53,32,2,2,23,6,17
"2021","East Suffolk 010D","E01030227",629,210,103,107,401,72,155,42,73,40,77,29,43,5,94,56,38,3,3,18,11,7
"2021","East Suffolk 010E","E01030228",764,236,147,89,505,147,220,94,88,38,67,34,33,0,69,38,31,2,2,23,13,10
"2021","East Suffolk 011A","E01030226",808,239,103,136,535,88,241,105,90,46,102,38,52,12,100,50,50,4,4,34,14,20
"2021","East Suffolk 011B","E01030286",930,215,113,102,669,158,348,188,97,63,91,55,31,5,71,35,36,1,1,46,16,30
"2021","East Suffolk 011C","E01030292",655,191,133,58,452,123,235,83,96,56,60,29,27,4,33,19,14,1,1,12,5,7
"2021","East Suffolk 011D","E01030293",698,166,106,60,511,136,277,96,121,60,68,38,29,1,30,17,13,0,0,21,10,11
"2021","East Suffolk 011E","E01030294",653,194,115,79,435,111,196,87,72,37,80,45,31,4,48,33,15,0,0,24,6,18
"2021","East Suffolk 012A","E01030239",731,128,39,89,566,57,301,105,147,49,116,56,55,5,92,63,29,0,0,37,17,20
"2021","East Suffolk 012B","E01030251",719,241,133,108,447,118,198,108,51,39,66,42,19,5,64,29,35,1,1,31,14,17
"2021","East Suffolk 012C","E01030252",846,305,194,111,512,167,213,111,67,35,74,38,30,6,56,35,21,2,2,29,12,17
"2021","East Suffolk 012D","E01030253",797,245,141,104,523,85,223,87,89,47,97,40,46,11,112,70,42,6,6,29,14,15
"2021","East Suffolk 012E","E01030272",790,306,201,105,458,143,186,95,61,30,73,38,25,10,55,29,26,1,1,26,11,15
"2021","East Suffolk 012F","E01030273",740,263,177,86,453,158,175,84,53,38,63,39,21,3,54,19,35,3,3,24,7,17
"2021","East Suffolk 013A","E01030230",938,425,226,199,481,121,195,100,69,26,94,58,31,5,65,43,22,6,6,32,7,25
"2021","East Suffolk 013B","E01030231",667,206,104,102,435,90,188,75,72,41,93,35,52,6,64,46,18,0,0,26,13,13
"2021","East Suffolk 013C","E01030232",689,181,117,64,474,107,207,75,86,46,83,30,48,5,71,45,26,6,6,34,13,21
"2021","East Suffolk 013D","E01030285",1031,322,168,154,650,178,348,176,107,65,74,43,26,5,47,25,22,3,3,59,23,36
"2021","East Suffolk 014A","E01030283",596,220,137,83,362,75,145,70,50,25,74,31,39,4,65,38,27,3,3,14,7,7
"2021","East Suffolk 014B","E01030295",1048,294,154,140,709,167,350,170,108,72,111,61,40,10,76,46,30,5,5,45,17,28
"2021","East Suffolk 014C","E01035154",1167,462,326,136,675,276,247,151,49,47,83,49,27,7,63,37,26,6,6,30,9,21
"2021","East Suffolk 015A","E01030229",976,296,187,109,639,150,315,158,97,60,105,54,46,5,66,37,29,3,3,41,17,24
"2021","East Suffolk 015B","E01030243",703,220,115,105,462,118,178,79,69,30,105,56,43,6,61,37,24,0,0,21,8,13
"2021","East Suffolk 015C","E01030244",947,449,262,187,473,140,174,85,55,34,84,50,29,5,74,45,29,1,1,25,6,19
"2021","East Suffolk 015D","E01030245",765,275,186,89,473,140,196,93,76,27,75,34,34,7,60,33,27,2,2,17,6,11
"2021","West Suffolk 002A","E01029926",813,267,174,93,514,151,244,139,65,40,72,45,18,9,47,29,18,0,0,32,12,20
"2021","West Suffolk 002B","E01029927",1110,431,165,266,616,81,229,92,101,36,143,61,73,9,157,110,47,6,6,63,20,43
"2021","West Suffolk 002C","E01029928",842,279,102,177,524,87,246,102,104,40,127,72,46,9,60,33,27,4,4,39,18,21
"2021","West Suffolk 002D","E01029929",1024,369,172,197,616,110,306,142,113,51,111,63,36,12,84,59,25,5,5,39,22,17
"2021","West Suffolk 002E","E01029930",709,233,101,132,442,96,232,102,82,48,67,34,32,1,45,22,23,2,2,34,12,22
"2021","West Suffolk 001A","E01029942",718,233,89,144,455,111,240,106,97,37,60,29,25,6,42,21,21,2,2,30,14,16
"2021","West Suffolk 001B","E01029944",779,224,119,105,523,122,228,102,84,42,91,55,34,2,78,39,39,4,4,32,11,21
"2021","West Suffolk 001C","E01034561",771,301,85,216,439,54,240,105,97,38,77,47,26,4,62,36,26,6,6,31,10,21
"2021","West Suffolk 001D","E01034562",529,96,0,96,427,0,388,44,341,3,13,4,9,0,25,24,1,1,1,6,2,4
"2021","West Suffolk 001E","E01034563",529,154,2,152,365,2,253,89,161,3,76,44,32,0,34,27,7,0,0,10,5,5
"2021","West Suffolk 003A","E01029945",990,243,117,126,705,115,378,150,167,61,150,88,56,6,60,35,25,2,2,42,20,22
"2021","West Suffolk 003B","E01032523",696,179,10,169,492,16,329,113,198,18,77,36,38,3,69,59,10,1,1,25,11,14
"2021","West Suffolk 003C","E01032524",510,150,46,104,329,46,193,70,99,24,53,33,15,5,36,25,11,1,1,31,13,18
"2021","West Suffolk 003D","E01032526",829,243,81,162,550,77,303,138,124,41,110,67,35,8,60,41,19,0,0,36,17,19
"2021","West Suffolk 003E","E01034564",598,217,35,182,327,29,208,107,77,24,63,32,25,6,24,15,9,3,3,54,39,15
"2021","West Suffolk 003F","E01034565",607,209,72,137,372,40,176,72,82,22,85,50,31,4,68,47,21,3,3,26,9,17
"2021","West Suffolk 004A","E01029938",555,131,49,82,386,30,167,62,84,21,82,21,49,12,102,72,30,5,5,38,19,19
"2021","West Suffolk 004B","E01029939",804,340,85,255,445,72,266,111,116,39,63,43,14,6,41,26,15,3,3,19,3,16
"2021","West Suffolk 004C","E01029940",591,189,99,90,380,65,167,66,76,25,74,33,32,9,72,47,25,2,2,22,5,17
"2021","West Suffolk 004D","E01029946",942,321,129,192,569,74,314,118,145,51,99,50,38,11,80,49,31,2,2,52,26,26
"2021","West Suffolk 004E","E01029947",1161,513,207,306,615,144,280,128,108,44,106,71,28,7,74,47,27,11,11,33,14,19
"2021","West Suffolk 007A","E01029941",814,215,94,121,566,117,305,135,126,44,96,65,28,3,45,20,25,3,3,33,12,21
"2021","West Suffolk 007B","E01029957",978,262,138,124,691,136,356,154,163,39,119,72,43,4,79,53,26,1,1,25,5,20
"2021","West Suffolk 007C","E01033452",734,224,60,164,487,44,258,119,108,31,110,65,40,5,73,56,17,2,2,23,14,9
"2021","West Suffolk 007D","E01033454",755,212,38,174,519,27,312,118,158,36,129,72,56,1,48,33,15,3,3,24,4,20
"2021","West Suffolk 007E","E01034566",782,213,15,198,541,11,314,91,209,14,141,76,57,8,72,63,9,3,3,28,11,17
"2021","West Suffolk 007F","E01034567",476,120,4,116,340,8,164,65,96,3,114,76,37,1,52,47,5,2,2,16,10,6
"2021","West Suffolk 008A","E01029937",1038,318,141,177,669,118,327,123,151,53,129,84,42,3,92,69,23,3,3,51,15,36
"2021","West Suffolk 008B","E01029953",612,187,78,109,374,37,160,66,74,20,96,65,29,2,75,41,34,6,6,51,13,38
"2021","West Suffolk 008C","E01029955",894,391,103,288,462,73,209,80,102,27,120,80,35,5,53,32,21,7,7,41,11,30
"2021","West Suffolk 008D","E01029956",616,209,30,179,348,21,162,53,88,21,107,55,50,2,51,27,24,7,7,59,26,33
"2021","West Suffolk 008E","E01034568",611,275,115,160,300,56,144,62,58,24,61,47,12,2,34,20,14,5,5,36,10,26
"2021","West Suffolk 008F","E01034569",646,307,82,225,318,15,123,54,59,10,70,33,35,2,105,76,29,5,5,21,8,13
"2021","West Suffolk 005A","E01030095",541,145,101,44,374,93,211,101,82,28,48,30,17,1,22,10,12,0,0,22,8,14
"2021","West Suffolk 005B","E01030096",625,125,81,44,475,116,248,121,67,60,69,40,23,6,41,22,19,1,1,25,12,13
"2021","West Suffolk 005C","E01030097",534,149,100,49,362,83,182,81,62,39,61,21,34,6,36,22,14,0,0,23,13,10
"2021","West Suffolk 005D","E01030145",636,200,126,74,413,82,190,75,72,43,83,40,34,9,58,33,25,0,0,23,9,14
"2021","West Suffolk 005E","E01030146",720,270,125,145,430,133,176,61,88,27,54,22,28,4,66,49,17,1,1,20,9,11
"2021","West Suffolk 006A","E01030094",601,137,73,64,439,73,227,101,86,40,75,50,22,3,60,36,24,4,4,25,10,15
"2021","West Suffolk 006B","E01030121",975,318,180,138,625,136,328,114,144,70,97,41,49,7,63,45,18,1,1,32,19,13
"2021","West Suffolk 006C","E01030132",457,155,43,112,290,42,179,73,94,12,41,18,21,2,27,18,9,1,1,12,4,8
"2021","West Suffolk 006D","E01030133",611,176,111,65,408,81,197,88,77,32,77,49,22,6,52,33,19,1,1,27,10,17
"2021","West Suffolk 009A","E01030130",589,147,85,62,407,65,171,67,76,28,78,39,34,5,88,60,28,5,5,35,13,22
"2021","West Suffolk 009B","E01030131",501,145,70,75,331,34,111,31,61,19,75,21,45,9,102,74,28,9,9,25,10,15
"2021","West Suffolk 009C","E01030139",721,261,115,146,422,47,170,50,76,44,93,33,46,14,108,71,37,4,4,38,10,28
"2021","West Suffolk 009D","E01030140",495,117,60,57,348,43,174,64,63,47,61,33,21,7,68,39,29,2,2,30,10,20
"2021","West Suffolk 009E","E01030141",617,188,83,105,391,39,187,69,86,32,88,37,42,9,72,37,35,5,5,38,16,22
"2021","West Suffolk 016A","E01030104",1060,239,139,100,785,220,406,129,197,80,88,41,38,9,68,46,22,3,3,36,16,20
"2021","West Suffolk 016B","E01030138",1027,232,129,103,752,157,370,151,153,66,123,68,43,12,96,45,51,6,6,43,15,28
"2021","West Suffolk 016C","E01034572",759,280,100,180,460,156,203,87,71,45,64,38,24,2,33,19,14,4,4,19,3,16
"2021","West Suffolk 016D","E01034573",676,186,57,129,469,46,206,76,115,15,127,84,39,4,87,71,16,3,3,21,6,15
"2021","West Suffolk 012A","E01030127",518,163,52,111,330,47,179,74,71,34,72,55,15,2,29,22,7,3,3,25,11,14
"2021","West Suffolk 012B","E01030128",597,191,56,135,381,33,219,84,98,37,77,50,24,3,47,35,12,5,5,25,6,19
"2021","West Suffolk 012C","E01030129",582,161,91,70,407,78,239,93,103,43,51,31,19,1,36,23,13,3,3,14,6,8
"2021","West Suffolk 012D","E01033044",545,141,26,115,372,14,229,59,149,21,64,30,34,0,62,49,13,3,3,32,8,24
"2021","West Suffolk 012E","E01033045",526,150,59,91,345,26,201,57,124,20,56,26,28,2,62,49,13,0,0,31,14,17
"2021","West Suffolk 012F","E01033050",507,144,54,90,350,41,201,56,112,33,65,41,20,4,43,28,15,0,0,13,6,7
"2021","West Suffolk 011A","E01030091",996,486,159,327,450,104,183,94,65,24,93,73,17,3,55,38,17,15,15,60,11,49
"2021","West Suffolk 011B","E01030093",906,448,160,288,432,88,172,94,62,16,93,70,21,2,69,44,25,10,10,26,2,24
"2021","West Suffolk 011C","E01030137",857,375,75,300,446,66,205,97,80,28,87,69,14,4,84,63,21,4,4,36,5,31
"2021","West Suffolk 011D","E01033043",607,277,116,161,303,31,124,49,60,15,76,56,19,1,72,48,24,0,0,27,8,19
"2021","West Suffolk 011E","E01033046",652,399,94,305,229,25,90,48,34,8,69,52,15,2,40,20,20,5,5,24,10,14
"2021","West Suffolk 011F","E01033047",503,183,60,123,300,50,148,58,68,22,59,35,21,3,42,22,20,1,1,20,3,17
"2021","West Suffolk 014A","E01030092",789,354,138,216,396,78,177,87,68,22,92,58,27,7,47,25,22,2,2,39,9,30
"2021","West Suffolk 014B","E01030123",793,351,99,252,417,59,190,76,76,38,67,31,31,5,98,70,28,3,3,25,9,16
"2021","West Suffolk 014C","E01030124",741,231,138,93,480,133,236,101,106,29,66,40,21,5,40,16,24,5,5,30,5,25
"2021","West Suffolk 014D","E01030125",612,180,120,60,408,92,179,74,77,28,57,23,30,4,76,32,44,4,4,24,6,18
"2021","West Suffolk 014E","E01030148",507,133,90,43,359,94,166,62,72,32,54,29,24,1,43,18,25,2,2,15,5,10
"2021","West Suffolk 014F","E01030149",623,158,104,54,433,118,224,81,94,49,56,25,26,5,34,16,18,1,1,32,14,18
"2021","West Suffolk 010A","E01030098",1106,290,191,99,774,174,390,147,181,62,117,58,51,8,91,53,38,2,2,42,18,24
"2021","West Suffolk 010B","E01030100",953,236,120,116,681,171,351,146,131,74,82,42,34,6,75,31,44,2,2,36,15,21
"2021","West Suffolk 010C","E01030119",934,241,147,94,645,153,334,114,147,73,90,42,41,7,68,38,30,0,0,48,17,31
"2021","West Suffolk 010D","E01030134",483,112,67,45,353,91,185,67,92,26,42,23,15,4,35,23,12,0,0,18,10,8
"2021","West Suffolk 010E","E01030135",552,118,71,47,401,94,237,85,102,50,45,24,16,5,23,10,13,2,2,33,13,20
"2021","West Suffolk 013A","E01030142",750,211,153,58,496,171,236,88,103,45,45,28,16,1,42,18,24,2,2,43,3,40
"2021","West Suffolk 013B","E01030143",646,218,92,126,392,73,177,55,83,39,71,33,33,5,65,36,29,6,6,36,7,29
"2021","West Suffolk 013C","E01030144",557,169,106,63,360,107,158,62,70,26,47,20,20,7,46,18,28,2,2,28,11,17
"2021","West Suffolk 013D","E01030147",715,245,150,95,446,167,190,82,74,34,47,35,10,2,37,21,16,5,5,24,1,23
"2021","West Suffolk 013E","E01033048",703,313,115,198,370,51,158,80,70,8,69,43,23,3,88,64,24,4,4,20,5,15
"2021","West Suffolk 013F","E01033049",677,403,193,210,250,56,100,57,35,8,63,48,13,2,29,14,15,2,2,24,5,19
"2021","West Suffolk 017A","E01030099",884,258,159,99,595,171,318,156,94,68,63,38,24,1,42,22,20,1,1,31,10,21
"2021","West Suffolk 017B","E01030101",1118,427,229,198,652,194,280,125,114,41,89,44,38,7,84,57,27,5,5,39,11,28
"2021","West Suffolk 017C","E01030150",1004,268,127,141,687,173,357,161,134,62,90,52,36,2,65,42,23,2,2,49,15,34
"2021","West Suffolk 018A","E01030122",859,185,112,73,633,143,335,114,163,58,91,49,41,1,60,38,22,4,4,41,11,30
"2021","West Suffolk 018B","E01030151",1090,233,94,139,797,125,421,190,166,65,174,103,65,6,74,48,26,3,3,60,25,35
"2021","West Suffolk 018C","E01034574",468,108,60,48,339,68,189,86,67,36,40,24,14,2,39,18,21,3,3,21,10,11
"2021","West Suffolk 018D","E01034575",493,133,90,43,340,94,171,80,65,26,45,26,16,3,29,19,10,1,1,20,8,12
"2021","West Suffolk 019A","E01030109",756,208,128,80,502,59,197,57,106,34,112,47,57,8,131,91,40,3,3,46,16,30
"2021","West Suffolk 019B","E01030110",1162,337,143,194,765,93,349,115,178,56,187,99,71,17,132,88,44,4,4,60,23,37
"2021","West Suffolk 019C","E01030111",525,121,80,41,375,74,233,88,87,58,45,18,23,4,22,9,13,1,1,29,15,14
"2021","West Suffolk 019D","E01030112",839,300,103,197,512,87,251,102,96,53,115,58,51,6,50,41,9,9,9,27,13,14
"2021","West Suffolk 021A","E01030115",900,236,92,144,610,50,278,71,147,60,150,62,77,11,126,87,39,6,6,54,25,29
"2021","West Suffolk 021B","E01030116",859,205,80,125,611,70,370,107,199,64,99,57,34,8,70,40,30,2,2,43,23,20
"2021","West Suffolk 021C","E01030117",649,160,62,98,455,61,221,83,103,35,111,60,48,3,57,33,24,5,5,34,11,23
"2021","West Suffolk 021D","E01030118",616,180,55,125,405,45,207,67,105,35,83,36,45,2,65,48,17,5,5,31,14,17
"2021","West Suffolk 020A","E01030105",795,287,73,214,458,47,199,66,99,34,131,67,52,12,77,47,30,4,4,50,15,35
"2021","West Suffolk 020B","E01030106",993,326,136,190,613,64,266,76,144,46,152,76,68,8,126,90,36,5,5,54,28,26
"2021","West Suffolk 020C","E01030107",632,117,75,42,482,121,263,89,118,56,59,29,25,5,37,15,22,2,2,33,15,18
"2021","West Suffolk 020D","E01030108",701,168,74,94,465,50,207,69,97,41,85,37,44,4,115,76,39,8,8,68,25,43
"2021","West Suffolk 020E","E01030113",911,285,133,152,571,90,252,83,123,46,131,62,59,10,92,58,34,6,6,55,17,38
"2021","West Suffolk 020F","E01030114",540,127,57,70,357,35,159,47,78,34,73,21,46,6,86,55,31,4,4,56,24,32
"2021","West Suffolk 015A","E01029925",1020,511,134,377,443,81,215,104,99,12,97,69,26,2,41,26,15,9,9,66,9,57
"2021","West Suffolk 015B","E01029949",699,236,93,143,422,41,197,73,93,31,88,54,29,5,88,59,29,8,8,41,8,33
"2021","West Suffolk 015C","E01029950",853,373,109,264,420,35,172,49,100,23,103,56,41,6,100,75,25,10,10,60,22,38
"2021","West Suffolk 015D","E01029951",625,197,98,99,383,89,177,71,76,30,68,45,18,5,46,21,25,3,3,45,17,28
"2021","West Suffolk 015E","E01029952",526,179,73,106,313,64,137,45,66,26,61,39,21,1,46,28,18,5,5,34,8,26
"2021","West Suffolk 015F","E01032612",1095,518,103,415,504,43,210,86,99,25,159,126,28,5,85,51,34,7,7,73,18,55
"2021","City of London 001A","E01000001",841,373,129,244,417,82,192,111,68,13,112,99,13,0,17,10,7,14,14,51,1,50
"2021","City of London 001B","E01000002",824,409,101,308,369,57,162,104,46,12,107,93,11,3,25,13,12,18,18,46,3,43
"2021","City of London 001C","E01000003",1017,582,160,422,379,31,165,106,42,17,122,105,14,3,44,23,21,17,17,56,1,55
"2021","City of London 001E","E01000005",477,219,47,172,202,7,87,26,46,15,45,28,13,4,52,29,23,11,11,56,20,36
"2021","City of London 001F","E01032739",879,424,17,407,319,7,126,90,27,9,149,148,1,0,16,7,9,21,21,136,4,132
"2021","City of London 001G","E01032740",877,501,42,459,293,15,114,86,24,4,129,125,4,0,18,8,10,17,17,83,3,80
"2021","Barking and Dagenham 001A","E01000027",661,131,61,70,429,23,181,25,118,38,69,11,46,12,152,107,45,4,4,101,76,25
"2021","Barking and Dagenham 001B","E01000028",622,190,85,105,359,16,170,24,118,28,35,11,17,7,129,91,38,9,9,73,51,22
"2021","Barking and Dagenham 001C","E01000029",682,184,125,59,439,79,222,43,137,42,34,7,19,8,100,49,51,4,4,59,33,26
"2021","Barking and Dagenham 001D","E01000030",905,219,62,157,606,18,246,30,190,26,86,23,60,3,244,191,53,12,12,80,48,32
"2021","Barking and Dagenham 002A","E01000031",596,154,82,72,345,33,206,46,114,46,29,9,14,6,72,37,35,5,5,97,59,38
"2021","Barking and Dagenham 002B","E01000032",722,178,76,102,448,31,242,44,147,51,50,20,25,5,105,60,45,20,20,96,56,40
"2021","Barking and Dagenham 002C","E01000110",522,98,49,49,340,31,187,40,104,43,31,14,13,4,80,55,25,11,11,84,54,30
"2021","Barking and Dagenham 002D","E01000111",749,241,126,115,405,20,194,39,114,41,43,12,28,3,137,96,41,11,11,103,80,23
"2021","Barking and Dagenham 002E","E01000112",700,182,66,116,417,15,230,57,131,42,46,23,20,3,116,87,29,10,10,101,54,47
"2021","Barking and Dagenham 002F","E01000113",642,121,44,77,395,22,210,46,122,42,37,18,16,3,114,79,35,12,12,126,95,31
"2021","Barking and Dagenham 003A","E01000034",517,124,63,61,318,21,157,36,77,44,41,13,21,7,87,53,34,12,12,75,34,41
"2021","Barking and Dagenham 003B","E01000037",590,128,66,62,393,45,234,58,110,66,34,13,15,6,76,37,39,4,4,69,41,28
"2021","Barking and Dagenham 003C","E01000038",560,123,78,45,365,42,209,42,106,61,46,9,25,12,64,33,31,4,4,72,42,30
"2021","Barking and Dagenham 003D","E01000039",645,164,76,88,418,45,198,53,105,40,73,29,37,7,97,55,42,5,5,63,44,19
"2021","Barking and Dagenham 004A","E01000063",626,142,60,82,405,19,191,29,122,40,56,15,31,10,131,70,61,8,8,79,54,25
"2021","Barking and Dagenham 004B","E01000100",655,118,43,75,455,21,180,39,100,41,64,17,41,6,178,126,52,12,12,82,61,21
"2021","Barking and Dagenham 004C","E01000101",582,133,56,77,366,16,190,34,116,40,51,17,25,9,101,59,42,8,8,83,54,29
"2021","Barking and Dagenham 004E","E01000114",758,145,55,90,529,27,298,53,199,46,56,18,30,8,134,87,47,14,14,84,63,21
"2021","Barking and Dagenham 004F","E01034469",544,89,25,64,396,12,257,27,213,17,47,18,29,0,76,57,19,4,4,59,38,21
"2021","Barking and Dagenham 004G","E01034470",471,79,30,49,309,17,173,28,113,32,24,9,13,2,89,52,37,6,6,83,54,29
"2021","Barking and Dagenham 006A","E01000033",555,153,66,87,351,23,149,26,91,32,55,19,29,7,118,86,32,6,6,51,32,19
"2021","Barking and Dagenham 006B","E01000060",814,250,79,171,481,27,186,40,121,25,62,20,37,5,196,130,66,10,10,83,58,25
"2021","Barking and Dagenham 006C","E01000061",754,270,45,225,432,11,160,39,94,27,61,21,36,4,195,157,38,5,5,52,30,22
"2021","Barking and Dagenham 006D","E01000062",767,189,95,94,466,32,205,42,110,53,57,14,40,3,159,102,57,13,13,112,66,46
"2021","Barking and Dagenham 006E","E01000064",792,212,59,153,482,25,244,51,137,56,55,18,36,1,147,98,49,11,11,98,63,35
"2021","Barking and Dagenham 007A","E01000065",786,282,127,155,420,29,182,39,99,44,70,21,40,9,127,82,45,12,12,84,51,33
"2021","Barking and Dagenham 007B","E01000078",621,115,41,74,424,19,205,36,131,38,55,14,37,4,139,82,57,6,6,82,55,27
"2021","Barking and Dagenham 007C","E01000080",611,116,35,81,423,17,173,29,105,39,57,18,29,10,167,80,87,9,9,72,51,21
"2021","Barking and Dagenham 007D","E01000081",653,136,50,86,421,23,205,35,134,36,65,21,37,7,122,65,57,6,6,96,60,36
"2021","Barking and Dagenham 007E","E01000082",699,168,51,117,458,20,207,48,124,35,91,55,29,7,131,83,48,9,9,73,39,34
"2021","Barking and Dagenham 007F","E01000083",633,117,47,70,426,17,199,54,118,27,58,16,36,6,143,93,50,9,9,90,55,35
"2021","Barking and Dagenham 007G","E01000102",629,143,66,77,423,18,187,31,118,38,62,18,37,7,151,98,53,5,5,63,44,19
"2021","Barking and Dagenham 008A","E01000021",595,161,49,112,365,17,186,25,132,29,51,17,24,10,106,73,33,5,5,69,43,26
"2021","Barking and Dagenham 008B","E01000022",477,91,43,48,309,17,150,23,95,32,33,11,17,5,102,55,47,7,7,77,50,27
"2021","Barking and Dagenham 008D","E01000024",462,74,28,46,310,15,139,24,85,30,30,7,20,3,118,54,64,8,8,78,49,29
"2021","Barking and Dagenham 008E","E01000025",697,231,105,126,388,14,198,34,130,34,56,17,32,7,110,66,44,10,10,78,55,23
"2021","Barking and Dagenham 008F","E01000077",596,138,41,97,372,24,178,29,102,47,53,14,34,5,110,58,52,7,7,86,58,28
"2021","Barking and Dagenham 008G","E01034471",775,154,37,117,486,13,242,42,175,25,82,26,51,5,140,107,33,9,9,135,93,42
"2021","Barking and Dagenham 008H","E01034472",665,163,14,149,443,5,210,31,149,30,63,30,32,1,148,124,24,17,17,59,38,21
"2021","Barking and Dagenham 009A","E01000015",831,185,48,137,529,20,227,36,143,48,73,22,48,3,200,149,51,9,9,117,73,44
"2021","Barking and Dagenham 009B","E01000016",627,122,51,71,421,24,194,47,106,41,48,10,31,7,143,90,53,12,12,84,60,24
"2021","Barking and Dagenham 009C","E01000017",598,145,48,97,378,16,178,35,103,40,54,21,25,8,115,67,48,15,15,75,44,31
"2021","Barking and Dagenham 009D","E01000018",644,155,39,116,403,17,186,45,103,38,53,10,33,10,143,86,57,4,4,86,46,40
"2021","Barking and Dagenham 009E","E01000079",619,177,78,99,368,17,182,33,108,41,51,14,34,3,112,70,42,6,6,74,47,27
"2021","Barking and Dagenham 010A","E01000035",594,142,49,93,374,28,202,38,111,53,44,13,25,6,91,57,34,9,9,78,54,24
"2021","Barking and Dagenham 010B","E01000036",472,95,49,46,298,26,170,33,96,41,28,9,15,4,64,38,26,10,10,79,44,35
"2021","Barking and Dagenham 010C","E01000107",603,126,71,55,404,42,203,44,119,40,49,9,29,11,102,65,37,8,8,73,45,28
"2021","Barking and Dagenham 010D","E01000108",682,165,51,114,445,42,198,40,117,41,68,18,43,7,128,95,33,9,9,72,38,34
"2021","Barking and Dagenham 011A","E01000066",710,201,90,111,362,22,218,29,144,45,25,10,12,3,87,57,30,10,10,147,115,32
"2021","Barking and Dagenham 011B","E01000067",659,125,68,57,412,28,251,39,155,57,32,7,19,6,94,66,28,7,7,122,82,40
"2021","Barking and Dagenham 011C","E01000069",535,83,42,41,343,19,233,36,125,72,23,3,16,4,58,43,15,10,10,109,73,36
"2021","Barking and Dagenham 011D","E01000070",579,102,47,55,348,38,222,29,125,68,23,7,12,4,58,31,27,7,7,129,84,45
"2021","Barking and Dagenham 011E","E01000071",805,186,88,98,466,37,282,38,188,56,45,24,18,3,91,56,35,11,11,153,105,48
"2021","Barking and Dagenham 012A","E01000057",530,95,42,53,357,20,149,33,81,35,44,5,34,5,139,95,44,5,5,78,49,29
"2021","Barking and Dagenham 012B","E01000073",665,180,92,88,401,16,193,37,125,31,54,15,32,7,135,91,44,3,3,84,51,33
"2021","Barking and Dagenham 012C","E01000074",626,162,64,98,402,18,183,39,116,28,53,12,35,6,141,83,58,7,7,62,44,18
"2021","Barking and Dagenham 012D","E01000075",638,125,65,60,404,31,205,37,119,49,62,13,44,5,97,41,56,9,9,109,70,39
"2021","Barking and Dagenham 012E","E01000076",795,228,65,163,483,28,210,45,127,38,63,24,35,4,168,94,74,14,14,84,49,35
"2021","Barking and Dagenham 013A","E01000013",616,115,49,66,398,21,184,37,112,35,42,14,27,1,137,83,54,14,14,103,65,38
"2021","Barking and Dagenham 013B","E01000014",634,165,58,107,397,21,191,42,117,32,69,19,37,13,107,64,43,9,9,72,43,29
"2021","Barking and Dagenham 013C","E01000059",571,126,63,63,354,22,159,32,82,45,49,14,29,6,114,71,43,10,10,91,56,35
"2021","Barking and Dagenham 013D","E01000084",499,111,46,65,316,25,131,23,81,27,42,10,26,6,105,62,43,13,13,72,42,30
"2021","Barking and Dagenham 013E","E01000085",577,141,55,86,353,26,135,26,84,25,64,15,41,8,121,74,47,7,7,83,39,44
"2021","Barking and Dagenham 013F","E01000086",488,97,43,54,334,15,140,23,74,43,42,11,27,4,126,85,41,11,11,57,39,18
"2021","Barking and Dagenham 014A","E01000103",532,91,33,58,345,13,175,26,111,38,38,10,20,8,108,65,43,11,11,96,69,27
"2021","Barking and Dagenham 014B","E01000104",693,221,56,165,399,19,155,29,102,24,77,23,51,3,140,94,46,8,8,73,48,25
"2021","Barking and Dagenham 014C","E01000105",935,320,95,225,522,31,198,40,122,36,87,31,48,8,184,127,57,22,22,93,62,31
"2021","Barking and Dagenham 014D","E01000106",873,304,92,212,476,30,186,40,128,18,68,16,45,7,187,147,40,5,5,93,57,36
"2021","Barking and Dagenham 015A","E01000007",1190,436,28,408,643,8,330,86,220,24,111,62,45,4,174,134,40,20,20,111,54,57
"2021","Barking and Dagenham 015B","E01000008",551,134,17,117,335,3,147,21,105,21,56,13,40,3,118,84,34,11,11,82,58,24
"2021","Barking and Dagenham 015D","E01000012",783,163,28,135,522,7,258,52,180,26,61,27,33,1,162,136,26,34,34,98,63,35
"2021","Barking and Dagenham 015E","E01034473",428,97,9,88,264,4,181,33,120,28,28,18,10,0,36,23,13,15,15,67,43,24
"2021","Barking and Dagenham 015F","E01034474",866,212,14,198,568,0,351,94,244,13,82,48,33,1,119,84,35,16,16,86,42,44
"2021","Barking and Dagenham 016A","E01000006",554,93,26,67,320,24,171,27,104,40,38,13,23,2,76,53,23,11,11,141,77,64
"2021","Barking and Dagenham 016B","E01000009",601,173,44,129,310,15,177,41,96,40,39,15,20,4,61,33,28,18,18,118,74,44
"2021","Barking and Dagenham 016C","E01000011",474,96,19,77,242,10,153,23,97,33,16,6,10,0,50,25,25,13,13,136,94,42
"2021","Barking and Dagenham 016D","E01000044",659,193,36,157,361,10,210,24,144,42,40,14,23,3,88,58,30,13,13,105,70,35
"2021","Barking and Dagenham 016E","E01000068",475,64,30,34,260,16,149,20,83,46,19,9,6,4,42,14,28,34,34,151,95,56
"2021","Barking and Dagenham 017A","E01000041",603,108,47,61,394,29,196,33,129,34,42,8,25,9,121,76,45,6,6,101,67,34
"2021","Barking and Dagenham 017B","E01000042",654,189,61,128,390,8,183,25,130,28,43,17,25,1,142,98,44,14,14,75,44,31
"2021","Barking and Dagenham 017C","E01000045",576,117,47,70,366,23,175,29,113,33,55,16,34,5,109,72,37,4,4,93,45,48
"2021","Barking and Dagenham 017D","E01000046",662,143,54,89,425,20,196,39,113,44,70,19,41,10,128,82,46,11,11,94,61,33
"2021","Barking and Dagenham 017E","E01000072",736,158,64,94,487,17,188,33,115,40,62,15,41,6,210,154,56,10,10,91,55,36
"2021","Barking and Dagenham 018A","E01000054",639,124,53,71,434,41,190,30,113,47,54,16,31,7,145,108,37,4,4,81,56,25
"2021","Barking and Dagenham 018B","E01000055",569,91,38,53,395,23,177,31,105,41,46,15,22,9,136,78,58,13,13,83,50,33
"2021","Barking and Dagenham 018C","E01000056",566,112,41,71,386,18,166,25,104,37,56,15,33,8,139,81,58,7,7,68,42,26
"2021","Barking and Dagenham 018D","E01000058",698,122,43,79,481,16,261,51,134,76,51,15,27,9,144,99,45,9,9,95,63,32
"2021","Barking and Dagenham 018E","E01000095",737,141,42,99,514,11,242,52,156,34,87,23,60,4,165,134,31,9,9,82,55,27
"2021","Barking and Dagenham 019A","E01000040",656,154,55,99,416,22,192,27,133,32,68,25,37,6,118,72,46,16,16,86,53,33
"2021","Barking and Dagenham 019B","E01000043",469,102,50,52,279,25,142,18,92,32,28,9,14,5,75,40,35,9,9,88,51,37
"2021","Barking and Dagenham 019C","E01000050",628,156,60,96,376,13,204,50,124,30,47,21,23,3,101,74,27,11,11,96,57,39
"2021","Barking and Dagenham 019D","E01000052",794,167,66,101,507,21,288,51,200,37,46,19,23,4,137,102,35,15,15,120,67,53
"2021","Barking and Dagenham 019F","E01034475",587,152,68,84,340,16,166,27,109,30,40,12,23,5,102,64,38,16,16,95,54,41
"2021","Barking and Dagenham 019G","E01034476",510,67,9,58,356,4,183,20,141,22,47,13,30,4,114,88,26,8,8,87,64,23
"2021","Barking and Dagenham 019H","E01034477",551,109,3,106,387,1,211,42,159,10,49,20,28,1,114,93,21,12,12,55,35,20
"2021","Barking and Dagenham 019I","E01034478",472,141,0,141,290,0,185,54,126,5,59,33,26,0,35,31,4,11,11,41,25,16
"2021","Barking and Dagenham 020A","E01000053",648,232,89,143,351,21,146,34,87,25,47,18,26,3,133,89,44,4,4,65,42,23
"2021","Barking and Dagenham 020B","E01000087",517,91,39,52,343,15,157,24,98,35,46,11,31,4,106,68,38,19,19,83,56,27
"2021","Barking and Dagenham 020C","E01000088",603,120,43,77,394,19,196,28,120,48,48,13,30,5,122,89,33,9,9,89,62,27
"2021","Barking and Dagenham 020D","E01000089",600,112,41,71,425,25,196,42,116,38,56,18,34,4,140,94,46,8,8,63,42,21
"2021","Barking and Dagenham 020E","E01000090",558,107,35,72,377,21,178,33,105,40,43,13,29,1,124,74,50,11,11,74,54,20
"2021","Barking and Dagenham 021C","E01000049",577,117,38,79,386,4,173,16,124,33,36,7,26,3,155,111,44,18,18,74,55,19
"2021","Barking and Dagenham 021D","E01000051",433,132,11,121,277,1,152,46,99,7,54,31,22,1,64,54,10,6,6,24,9,15
"2021","Barking and Dagenham 021E","E01033587",1039,343,22,321,613,2,264,72,178,14,113,70,42,1,206,172,34,28,28,83,41,42
"2021","Barking and Dagenham 021G","E01034479",750,165,35,130,524,6,221,34,164,23,61,22,34,5,216,160,56,20,20,61,39,22
"2021","Barking and Dagenham 022A","E01000091",672,172,42,130,413,12,199,28,140,31,47,13,31,3,147,111,36,8,8,87,62,25
"2021","Barking and Dagenham 022B","E01000093",667,214,41,173,380,13,155,29,103,23,57,27,26,4,142,103,39,13,13,73,41,32
"2021","Barking and Dagenham 022C","E01000094",843,163,11,152,595,3,272,46,199,27,95,40,50,5,208,168,40,17,17,85,58,27
"2021","Barking and Dagenham 022D","E01000096",487,75,17,58,338,13,160,11,133,16,33,5,27,1,127,95,32,5,5,74,44,30
"2021","Barking and Dagenham 023A","E01000019",498,73,30,43,348,19,189,21,131,37,33,13,14,6,100,70,30,7,7,77,52,25
"2021","Barking and Dagenham 023B","E01000020",663,144,63,81,435,11,279,30,186,63,39,12,22,5,95,54,41,11,11,84,49,35
"2021","Barking and Dagenham 023C","E01000097",685,200,109,91,411,16,214,43,131,40,56,13,29,14,117,79,38,8,8,74,48,26
"2021","Barking and Dagenham 023D","E01000098",621,147,52,95,386,17,208,34,137,37,56,13,35,8,101,68,33,4,4,88,56,32
"2021","Barking and Dagenham 023E","E01000099",934,194,50,144,617,19,337,63,221,53,84,35,42,7,166,114,52,11,11,123,87,36
"2021","Barking and Dagenham 023F","E01032580",487,87,25,62,324,14,177,27,121,29,36,9,20,7,90,51,39,7,7,76,47,29
"2021","Barnet 001A","E01000248",719,228,120,108,458,52,256,81,131,44,90,35,51,4,58,37,21,2,2,33,9,24
"2021","Barnet 001B","E01000249",620,123,74,49,468,71,297,70,148,79,44,24,14,6,53,33,20,3,3,29,8,21
"2021","Barnet 001C","E01000250",1142,403,146,257,650,55,320,107,166,47,129,79,47,3,132,73,59,14,14,89,17,72
"2021","Barnet 001D","E01000254",633,169,90,79,412,73,225,55,128,42,65,36,25,4,43,20,23,6,6,52,14,38
"2021","Barnet 001E","E01000292",650,192,105,87,411,81,190,50,99,41,59,37,20,2,75,37,38,6,6,47,20,27
"2021","Barnet 001F","E01000293",708,186,79,107,462,65,273,66,150,57,52,34,14,4,60,27,33,12,12,60,21,39
"2021","Barnet 002A","E01000167",526,126,49,77,351,25,173,37,89,47,46,16,23,7,96,55,41,11,11,49,25,24
"2021","Barnet 002B","E01000246",642,190,106,84,416,51,256,74,117,65,53,33,18,2,54,27,27,2,2,36,14,22
"2021","Barnet 002C","E01000247",730,247,63,184,440,36,250,65,132,53,79,50,26,3,73,49,24,2,2,43,23,20
"2021","Barnet 002D","E01000251",1056,457,150,307,500,48,234,76,133,25,81,56,22,3,115,75,40,22,22,99,55,44
"2021","Barnet 002E","E01000252",794,294,131,163,445,46,196,50,112,34,115,88,24,3,79,49,30,9,9,55,18,37
"2021","Barnet 003A","E01000166",653,191,77,114,411,57,209,39,122,48,48,26,19,3,95,54,41,2,2,51,24,27
"2021","Barnet 003B","E01000168",559,117,80,37,381,84,230,52,103,75,25,11,12,2,40,14,26,2,2,61,29,32
"2021","Barnet 003C","E01000169",693,220,70,150,430,52,216,52,125,39,71,51,18,2,86,59,27,5,5,43,18,25
"2021","Barnet 003D","E01000172",608,125,76,49,448,54,296,61,171,64,42,16,21,5,50,22,28,6,6,35,18,17
"2021","Barnet 004A","E01000285",612,184,89,95,389,51,211,48,111,52,41,21,16,4,82,51,31,4,4,39,23,16
"2021","Barnet 004B","E01000287",609,154,78,76,395,42,166,35,94,37,49,24,16,9,134,78,56,4,4,60,35,25
"2021","Barnet 004C","E01000288",565,134,87,47,381,38,236,36,130,70,49,21,22,6,55,33,22,3,3,50,24,26
"2021","Barnet 004D","E01000289",549,116,51,65,377,28,166,31,92,43,45,15,18,12,129,70,59,9,9,56,29,27
"2021","Barnet 004E","E01000291",619,194,64,130,385,23,182,31,114,37,54,25,19,10,119,68,51,7,7,40,24,16
"2021","Barnet 004F","E01000294",733,220,112,108,469,67,279,69,154,56,48,26,20,2,68,40,28,7,7,44,18,26
"2021","Barnet 005A","E01000267",580,138,67,71,387,47,237,55,124,58,39,24,11,4,60,30,30,4,4,55,24,31
"2021","Barnet 005B","E01000268",933,321,95,226,558,39,265,86,145,34,100,70,26,4,138,112,26,16,16,54,20,34
"2021","Barnet 005C","E01000269",543,122,66,56,381,59,219,51,106,62,39,23,15,1,57,26,31,7,7,40,18,22
"2021","Barnet 005D","E01000270",634,189,88,101,401,63,223,60,125,38,55,30,20,5,49,29,20,11,11,44,21,23
"2021","Barnet 006A","E01000170",695,165,67,98,471,32,259,50,169,40,76,33,34,9,95,57,38,9,9,59,30,29
"2021","Barnet 006B","E01000171",997,313,71,242,623,16,280,90,156,34,100,53,46,1,217,167,50,10,10,61,24,37
"2021","Barnet 006C","E01000173",610,119,60,59,456,43,265,53,150,62,45,20,22,3,97,59,38,6,6,35,22,13
"2021","Barnet 006D","E01000174",761,263,103,160,445,31,216,55,128,33,85,26,55,4,104,75,29,9,9,53,18,35
"2021","Barnet 006E","E01000175",638,130,66,64,447,63,272,67,153,52,52,21,25,6,54,30,24,6,6,61,42,19
"2021","Barnet 007A","E01000228",460,63,38,25,347,39,228,42,127,59,14,8,5,1,62,25,37,4,4,50,25,25
"2021","Barnet 007B","E01000253",707,148,88,60,495,91,327,79,178,70,37,20,16,1,35,13,22,5,5,64,26,38
"2021","Barnet 007C","E01000279",506,90,62,28,366,99,219,63,103,53,17,9,7,1,29,14,15,2,2,50,22,28
"2021","Barnet 007D","E01000280",507,83,59,24,385,87,247,69,122,56,19,12,4,3,29,12,17,3,3,39,13,26
"2021","Barnet 007E","E01000286",665,173,83,90,433,23,203,55,102,46,59,21,34,4,142,55,87,6,6,59,29,30
"2021","Barnet 007F","E01000290",669,206,131,75,417,68,226,50,123,53,28,12,11,5,90,37,53,5,5,46,15,31
"2021","Barnet 008A","E01000271",614,141,90,51,403,76,244,53,128,63,25,20,3,2,53,24,29,5,5,70,26,44
"2021","Barnet 008B","E01000272",503,89,52,37,380,82,243,65,118,60,23,14,7,2,28,15,13,4,4,34,22,12
"2021","Barnet 008C","E01000273",743,265,104,161,422,63,197,49,105,43,64,42,18,4,90,44,46,8,8,56,16,40
"2021","Barnet 008D","E01000281",780,270,71,199,474,22,278,96,156,26,94,67,26,1,74,53,21,6,6,36,16,20
"2021","Barnet 008E","E01000282",692,172,79,93,462,49,297,63,174,60,45,30,12,3,60,25,35,11,11,58,21,37
"2021","Barnet 009A","E01000115",476,79,49,30,344,55,243,51,108,84,14,6,5,3,31,9,22,1,1,53,23,30
"2021","Barnet 009B","E01000116",617,135,80,55,432,53,275,47,157,71,37,9,23,5,65,28,37,2,2,50,20,30
"2021","Barnet 009C","E01000119",628,99,54,45,445,64,269,60,140,69,28,18,8,2,80,41,39,4,4,84,40,44
"2021","Barnet 009D","E01000120",498,79,47,32,359,61,231,31,128,72,21,7,14,0,43,18,25,3,3,60,26,34
"2021","Barnet 009E","E01000122",520,95,57,38,369,40,244,41,136,67,26,8,18,0,58,29,29,1,1,56,28,28
"2021","Barnet 010A","E01000117",695,180,103,77,461,70,255,56,137,62,50,21,24,5,83,43,40,3,3,54,20,34
"2021","Barnet 010B","E01000118",751,176,91,85,500,51,304,63,169,72,57,24,24,9,85,35,50,3,3,75,45,30
"2021","Barnet 010C","E01000121",524,115,29,86,366,22,163,30,88,45,40,15,23,2,134,64,70,7,7,43,22,21
"2021","Barnet 010D","E01000123",732,204,65,139,473,43,262,104,110,48,68,37,28,3,93,51,42,7,7,55,27,28
"2021","Barnet 010E","E01000124",793,303,71,232,404,27,162,40,94,28,78,29,41,8,119,81,38,18,18,86,35,51
"2021","Barnet 011A","E01000265",771,217,74,143,479,34,254,61,149,44,68,36,28,4,112,70,42,11,11,75,29,46
"2021","Barnet 011B","E01000266",504,81,49,32,388,71,259,48,132,79,13,6,4,3,42,16,26,3,3,35,13,22
"2021","Barnet 011C","E01000274",697,170,68,102,444,32,249,49,143,57,45,20,21,4,111,60,51,7,7,83,35,48
"2021","Barnet 011D","E01000320",807,244,113,131,483,58,262,70,142,50,77,54,21,2,74,41,33,12,12,80,30,50
"2021","Barnet 011E","E01000322",803,261,97,164,480,53,221,58,131,32,72,47,19,6,117,89,28,17,17,62,29,33
"2021","Barnet 012A","E01000275",668,158,74,84,453,69,232,55,134,43,76,63,9,4,68,31,37,8,8,57,23,34
"2021","Barnet 012B","E01000277",744,317,123,194,368,34,176,54,101,21,54,42,9,3,89,40,49,15,15,59,16,43
"2021","Barnet 012C","E01000283",471,68,50,18,371,67,262,57,136,69,12,6,6,0,30,12,18,0,0,32,15,17
"2021","Barnet 012D","E01000284",812,289,105,184,427,29,212,75,108,29,77,61,12,4,102,54,48,7,7,96,48,48
"2021","Barnet 012E","E01000321",828,279,61,218,469,35,256,74,134,48,89,65,20,4,70,42,28,19,19,80,22,58
"2021","Barnet 013A","E01000195",720,214,60,154,422,22,214,42,130,42,39,14,21,4,133,95,38,14,14,84,57,27
"2021","Barnet 013B","E01000229",586,122,53,69,401,36,211,42,125,44,32,11,16,5,112,54,58,10,10,63,28,35
"2021","Barnet 013C","E01000230",658,158,101,57,444,87,282,61,157,64,14,5,9,0,58,24,34,3,3,56,34,22
"2021","Barnet 013D","E01000231",619,123,51,72,420,30,254,48,137,69,32,12,15,5,98,59,39,6,6,76,45,31
"2021","Barnet 013E","E01000232",704,189,85,104,457,72,270,57,149,64,27,13,13,1,79,44,35,9,9,58,29,29
"2021","Barnet 013F","E01000233",655,125,55,70,441,45,282,55,173,54,33,15,17,1,74,35,39,7,7,89,38,51
"2021","Barnet 014A","E01000186",507,62,35,27,387,86,257,39,151,67,5,2,3,0,39,19,20,0,0,58,35,23
"2021","Barnet 014B","E01000187",597,150,100,50,413,68,254,53,150,51,24,6,13,5,63,31,32,4,4,34,21,13
"2021","Barnet 014C","E01000188",509,72,45,27,389,87,257,46,146,65,10,2,7,1,30,18,12,5,5,48,22,26
"2021","Barnet 014D","E01000189",981,262,50,212,657,6,362,103,215,44,79,55,17,7,191,112,79,19,19,62,29,33
"2021","Barnet 014E","E01000190",573,100,66,34,411,74,262,48,146,68,21,7,14,0,54,32,22,0,0,62,33,29
"2021","Barnet 014F","E01000191",555,134,97,37,374,74,239,52,137,50,10,8,2,0,46,21,25,5,5,47,24,23
"2021","Barnet 015A","E01000158",542,126,38,88,364,28,188,42,107,39,56,28,23,5,91,53,38,1,1,52,20,32
"2021","Barnet 015B","E01000159",648,140,52,88,443,57,248,54,117,77,48,19,27,2,87,49,38,3,3,65,34,31
"2021","Barnet 015C","E01000160",801,233,43,190,483,26,261,85,143,33,91,59,28,4,93,65,28,12,12,85,36,49
"2021","Barnet 015D","E01000161",812,236,67,169,506,49,253,61,146,46,67,37,28,2,126,93,33,11,11,70,27,43
"2021","Barnet 015E","E01000162",552,137,64,73,342,37,197,36,102,59,31,12,15,4,72,39,33,5,5,73,33,40
"2021","Barnet 015F","E01000324",651,148,57,91,423,47,241,41,144,56,43,22,17,4,86,47,39,6,6,80,35,45
"2021","Barnet 016A","E01000256",677,157,69,88,461,70,282,49,179,54,41,23,13,5,63,41,22,5,5,59,23,36
"2021","Barnet 016B","E01000258",782,230,105,125,485,93,256,60,145,51,73,55,18,0,56,30,26,7,7,67,21,46
"2021","Barnet 016C","E01000263",502,71,45,26,395,66,284,43,171,70,9,4,5,0,35,12,23,1,1,36,21,15
"2021","Barnet 016D","E01000264",720,217,57,160,418,34,249,56,152,41,39,24,12,3,78,42,36,18,18,85,41,44
"2021","Barnet 017A","E01000255",630,158,63,95,414,51,210,55,112,43,43,23,15,5,97,51,46,13,13,58,35,23
"2021","Barnet 017B","E01000257",914,316,112,204,503,30,228,66,140,22,95,66,23,6,135,74,61,15,15,95,35,60
"2021","Barnet 017C","E01000261",680,236,156,80,405,89,237,51,144,42,31,22,6,3,43,18,25,5,5,39,16,23
"2021","Barnet 017E","E01033911",648,126,56,70,464,62,296,84,158,54,38,23,13,2,62,39,23,6,6,58,28,30
"2021","Barnet 017F","E01033912",638,160,16,144,429,16,279,69,196,14,65,46,19,0,64,49,15,5,5,49,21,28
"2021","Barnet 018A","E01000192",709,165,91,74,443,70,271,76,152,43,21,13,6,2,67,42,25,14,14,101,36,65
"2021","Barnet 018B","E01000193",706,179,70,109,424,50,243,55,120,68,38,25,12,1,80,52,28,13,13,103,47,56
"2021","Barnet 018C","E01000194",704,190,66,124,413,30,212,49,119,44,38,20,18,0,121,96,25,12,12,101,45,56
"2021","Barnet 018D","E01000226",601,153,67,86,357,15,179,33,99,47,39,19,16,4,117,58,59,7,7,91,50,41
"2021","Barnet 018E","E01000227",600,93,50,43,420,54,287,65,151,71,13,7,3,3,56,13,43,10,10,87,62,25
"2021","Barnet 019A","E01000299",905,306,104,202,482,30,255,57,163,35,83,61,21,1,91,59,32,23,23,117,56,61
"2021","Barnet 019B","E01000300",682,193,73,120,425,37,222,63,123,36,90,48,39,3,66,41,25,10,10,64,23,41
"2021","Barnet 019C","E01000302",836,356,93,263,419,34,221,52,141,28,71,48,21,2,79,42,37,14,14,61,23,38
"2021","Barnet 019D","E01000317",639,190,72,118,391,37,218,49,134,35,46,36,8,2,79,40,39,11,11,58,16,42
"2021","Barnet 019E","E01000318",634,115,62,53,439,58,256,48,133,75,35,18,10,7,69,32,37,21,21,80,42,38
"2021","Barnet 019F","E01000323",1019,384,88,296,512,30,276,75,139,62,92,74,16,2,98,57,41,16,16,123,39,84
"2021","Barnet 020A","E01000276",497,60,39,21,397,61,294,44,196,54,13,6,5,2,28,12,16,1,1,40,21,19
"2021","Barnet 020B","E01000278",500,79,46,33,381,59,264,41,174,49,25,9,12,4,30,15,15,3,3,40,13,27
"2021","Barnet 020C","E01000301",529,116,55,61,360,46,246,47,154,45,25,12,11,2,40,15,25,3,3,53,29,24
"2021","Barnet 020D","E01000303",535,115,48,67,360,37,240,48,148,44,30,17,12,1,50,19,31,3,3,60,32,28
"2021","Barnet 020E","E01000304",603,146,40,106,375,34,181,44,107,30,79,56,21,2,73,41,32,8,8,82,17,65
"2021","Barnet 021A","E01000130",658,148,36,112,401,21,201,49,100,52,34,19,11,4,129,73,56,16,16,109,57,52
"2021","Barnet 021B","E01000132",505,80,24,56,346,10,180,28,109,43,27,7,17,3,120,66,54,9,9,79,44,35
"2021","Barnet 021C","E01000133",577,152,52,100,349,17,170,29,101,40,31,11,13,7,123,59,64,8,8,76,45,31
"2021","Barnet 021D","E01000234",676,155,65,90,460,52,274,63,164,47,45,31,10,4,81,47,34,8,8,61,24,37
"2021","Barnet 021E","E01000235",654,145,36,109,420,26,202,49,99,54,51,23,21,7,129,71,58,12,12,89,51,38
"2021","Barnet 022A","E01000156",750,179,73,106,476,27,276,48,198,30,79,32,44,3,88,60,28,6,6,95,22,73
"2021","Barnet 022B","E01000157",672,218,64,154,409,28,193,44,113,36,87,43,37,7,95,64,31,6,6,45,19,26
"2021","Barnet 022C","E01000163",797,337,58,279,418,13,171,41,104,26,75,45,28,2,146,95,51,13,13,42,18,24
"2021","Barnet 022D","E01000164",647,181,54,127,395,20,188,41,118,29,56,28,21,7,124,71,53,7,7,71,34,37
"2021","Barnet 022E","E01000165",707,202,63,139,440,42,222,54,125,43,52,21,27,4,108,69,39,16,16,65,27,38
"2021","Barnet 022F","E01000315",634,174,61,113,393,25,173,26,88,59,34,11,12,11,149,76,73,12,12,67,35,32
"2021","Barnet 023A","E01000197",731,193,53,140,429,46,208,55,121,32,86,47,37,2,73,48,25,16,16,109,37,72
"2021","Barnet 023B","E01000295",652,184,62,122,382,33,230,61,124,45,62,47,13,2,47,23,24,10,10,86,21,65
"2021","Barnet 023C","E01000296",761,208,58,150,455,30,226,60,131,35,104,64,40,0,74,42,32,21,21,98,31,67
"2021","Barnet 023D","E01000298",729,230,80,150,417,33,244,72,131,41,76,57,17,2,47,31,16,17,17,82,23,59
"2021","Barnet 024B","E01000127",515,110,30,80,303,21,156,27,87,42,23,9,7,7,95,51,44,8,8,102,61,41
"2021","Barnet 024C","E01000128",641,115,52,63,393,24,220,34,131,55,24,5,14,5,113,45,68,12,12,133,68,65
"2021","Barnet 024D","E01000129",571,149,70,79,341,10,153,32,86,35,32,13,12,7,128,70,58,18,18,81,36,45
"2021","Barnet 024E","E01000131",711,159,56,103,429,39,206,39,110,57,46,27,18,1,121,82,39,17,17,123,54,69
"2021","Barnet 024F","E01000134",632,156,63,93,379,17,204,28,125,51,33,16,13,4,114,77,37,11,11,97,56,41
"2021","Barnet 024G","E01033913",539,132,51,81,340,3,155,29,104,22,24,10,14,0,152,123,29,6,6,67,35,32
"2021","Barnet 024H","E01033914",596,136,40,96,379,20,164,24,102,38,42,17,22,3,150,105,45,3,3,81,53,28
"2021","Barnet 025A","E01000198",779,201,79,122,491,63,324,53,213,58,27,17,10,0,69,47,22,8,8,87,38,49
"2021","Barnet 025B","E01000199",659,195,109,86,413,107,226,53,132,41,29,18,10,1,47,27,20,4,4,51,19,32
"2021","Barnet 025C","E01000204",695,195,101,94,432,79,244,62,138,44,41,30,11,0,61,32,29,7,7,68,24,44
"2021","Barnet 025D","E01000259",979,243,113,130,648,65,395,85,225,85,68,43,23,2,114,66,48,6,6,88,43,45
"2021","Barnet 025E","E01000260",847,210,73,137,527,35,299,69,173,57,66,40,25,1,116,71,45,11,11,110,40,70
"2021","Barnet 026A","E01000126",770,191,40,151,458,9,246,45,132,69,49,27,18,4,144,77,67,10,10,121,56,65
"2021","Barnet 026B","E01000151",656,218,38,180,388,4,136,13,102,21,27,3,21,3,212,167,45,9,9,50,34,16
"2021","Barnet 026C","E01000152",928,182,31,151,638,10,337,92,205,40,93,49,41,3,182,109,73,16,16,108,56,52
"2021","Barnet 026D","E01000153",739,245,75,170,427,21,199,35,126,38,52,22,25,5,144,93,51,11,11,67,43,24
"2021","Barnet 026E","E01000154",707,188,40,148,417,14,195,47,101,47,54,32,20,2,133,74,59,21,21,102,43,59
"2021","Barnet 027A","E01000176",721,270,153,117,394,32,194,40,77,77,43,28,10,5,119,70,49,6,6,57,24,33
"2021","Barnet 027B","E01000178",676,201,86,115,421,40,240,48,143,49,57,30,26,1,78,51,27,6,6,54,20,34
"2021","Barnet 027C","E01000184",710,225,46,179,411,30,182,35,115,32,64,43,16,5,123,69,54,12,12,74,27,47
"2021","Barnet 027D","E01000297",536,123,41,82,345,29,183,45,106,32,59,41,18,0,61,24,37,13,13,68,24,44
"2021","Barnet 027E","E01000316",887,236,46,190,543,39,280,61,155,64,75,47,26,2,138,81,57,11,11,108,50,58
"2021","Barnet 027F","E01000319",496,90,42,48,356,37,242,42,154,46,26,14,8,4,51,19,32,0,0,50,18,32
"2021","Barnet 028A","E01000196",1093,483,129,354,508,61,223,80,126,17,124,102,19,3,79,51,28,21,21,102,15,87
"2021","Barnet 028B","E01000200",873,320,198,122,481,109,256,51,163,42,53,37,15,1,53,26,27,10,10,72,21,51
"2021","Barnet 028C","E01000201",528,99,66,33,372,95,240,41,142,57,13,6,5,2,23,9,14,1,1,57,29,28
"2021","Barnet 028D","E01000202",617,134,61,73,415,61,260,62,139,59,46,35,11,0,41,24,17,7,7,68,25,43
"2021","Barnet 028E","E01000203",682,158,64,94,450,48,227,49,133,45,25,20,4,1,140,94,46,10,10,74,32,42
"2021","Barnet 029A","E01000177",687,210,98,112,422,33,232,51,168,13,82,51,27,4,69,45,24,6,6,55,15,40
"2021","Barnet 029B","E01000179",771,239,55,184,472,19,279,83,176,20,100,69,27,4,66,43,23,8,8,60,19,41
"2021","Barnet 029C","E01000180",671,211,128,83,382,35,179,37,111,31,70,48,22,0,90,48,42,8,8,78,21,57
"2021","Barnet 029D","E01000181",684,177,56,121,413,54,224,62,131,31,83,64,18,1,44,24,20,8,8,94,17,77
"2021","Barnet 029E","E01000182",731,243,96,147,431,42,240,73,139,28,89,70,17,2,44,24,20,16,16,57,10,47
"2021","Barnet 029F","E01000185",642,241,106,135,326,11,127,21,80,26,51,41,7,3,127,68,59,10,10,75,17,58
"2021","Barnet 031A","E01000239",934,374,65,309,456,9,219,67,125,27,100,76,21,3,103,57,46,25,25,104,38,66
"2021","Barnet 031B","E01000240",625,152,60,92,337,40,183,41,97,45,34,16,14,4,67,36,31,13,13,136,45,91
"2021","Barnet 031C","E01000241",700,207,76,131,402,48,246,65,140,41,30,20,10,0,65,33,32,13,13,91,32,59
"2021","Barnet 031D","E01000309",708,193,60,133,373,35,215,45,118,52,45,29,14,2,65,31,34,13,13,142,67,75
"2021","Barnet 032A","E01000237",727,152,50,102,434,38,266,72,157,37,35,24,8,3,74,45,29,21,21,141,36,105
"2021","Barnet 032B","E01000242",595,189,90,99,362,62,230,49,138,43,11,6,5,0,55,30,25,4,4,44,23,21
"2021","Barnet 032C","E01000243",900,313,94,219,440,36,221,64,130,27,73,62,11,0,86,51,35,24,24,147,34,113
"2021","Barnet 032D","E01000244",630,196,58,138,342,41,174,44,91,39,36,26,9,1,73,38,35,18,18,92,29,63
"2021","Barnet 032E","E01000245",877,295,70,225,468,16,196,41,121,34,67,49,14,4,148,94,54,41,41,114,26,88
"2021","Barnet 032F","E01000314",783,190,50,140,393,34,234,53,126,55,45,34,9,2,58,35,23,22,22,200,51,149
"2021","Barnet 033A","E01000183",602,193,113,80,371,41,216,51,146,19,49,33,14,2,59,30,29,6,6,38,13,25
"2021","Barnet 033B","E01000206",525,95,43,52,341,94,192,51,96,45,17,13,2,2,35,17,18,3,3,89,41,48
"2021","Barnet 033C","E01000207",644,196,146,50,397,83,244,53,142,49,23,13,10,0,45,26,19,2,2,51,17,34
"2021","Barnet 033D","E01000208",635,147,76,71,404,72,244,57,151,36,35,27,6,2,42,21,21,11,11,84,26,58
"2021","Barnet 033E","E01000210",586,130,66,64,401,44,254,57,174,23,42,32,8,2,57,37,20,4,4,55,17,38
"2021","Barnet 033F","E01000213",450,85,41,44,334,58,238,40,152,46,15,5,8,2,19,10,9,4,4,31,20,11
"2021","Barnet 034A","E01000236",697,205,66,139,418,46,286,55,201,30,29,18,11,0,50,30,20,7,7,74,30,44
"2021","Barnet 034B","E01000238",645,113,41,72,422,36,268,41,176,51,22,9,12,1,74,48,26,22,22,110,39,71
"2021","Barnet 034C","E01000310",844,254,70,184,446,30,218,48,122,48,55,40,12,3,129,55,74,14,14,144,36,108
"2021","Barnet 034D","E01000311",520,115,47,68,358,41,259,45,177,37,17,9,7,1,35,21,14,6,6,47,21,26
"2021","Barnet 035A","E01000205",604,162,99,63,421,59,279,69,167,43,34,17,15,2,49,19,30,0,0,21,10,11
"2021","Barnet 035B","E01000209",740,329,219,110,390,102,209,57,123,29,31,17,11,3,44,24,20,4,4,21,4,17
"2021","Barnet 035C","E01000211",925,330,122,208,441,21,209,57,132,20,56,38,15,3,134,90,44,21,21,154,35,119
"2021","Barnet 035D","E01000212",548,149,65,84,340,68,189,60,100,29,40,34,6,0,36,21,15,7,7,59,12,47
"2021","Barnet 035E","E01000216",721,243,85,158,409,40,264,46,176,42,56,47,6,3,37,20,17,12,12,69,23,46
"2021","Barnet 035F","E01000217",552,116,44,72,377,34,290,92,171,27,12,8,3,1,36,16,20,5,5,59,28,31
"2021","Barnet 036A","E01000150",772,186,59,127,463,46,279,51,142,86,38,16,21,1,88,51,37,12,12,123,60,63
"2021","Barnet 036B","E01000305",650,222,57,165,325,18,174,54,81,39,60,46,8,6,63,30,33,10,10,103,46,57
"2021","Barnet 036C","E01000306",618,134,42,92,298,31,157,36,77,44,37,24,11,2,61,26,35,12,12,186,95,91
"2021","Barnet 036D","E01000308",960,353,80,273,530,21,274,105,125,44,99,72,19,8,114,57,57,22,22,77,26,51
"2021","Barnet 036E","E01000312",723,226,47,179,429,7,266,105,118,43,64,46,17,1,82,37,45,10,10,68,35,33
"2021","Barnet 036F","E01000313",712,213,53,160,363,26,207,55,100,52,48,26,22,0,66,47,19,16,16,136,38,98
"2021","Barnet 037A","E01000145",489,113,48,65,302,36,193,31,119,43,14,9,3,2,49,27,22,10,10,74,19,55
"2021","Barnet 037B","E01000215",711,230,122,108,426,55,299,51,218,30,18,12,6,0,47,30,17,7,7,55,24,31
"2021","Barnet 037C","E01000218",586,142,48,94,365,38,235,59,155,21,22,14,8,0,58,27,31,12,12,79,22,57
"2021","Barnet 037D","E01000219",658,182,52,130,387,21,264,43,176,45,36,26,9,1,45,21,24,21,21,89,33,56
"2021","Barnet 037E","E01000220",675,261,94,167,327,29,224,51,147,26,19,12,7,0,52,28,24,3,3,87,25,62
"2021","Barnet 037F","E01000225",582,176,96,80,373,43,283,50,193,40,11,6,4,1,32,15,17,4,4,33,13,20
"2021","Barnet 038A","E01000135",626,181,57,124,386,58,232,34,140,58,43,28,14,1,47,20,27,6,6,59,18,41
"2021","Barnet 038B","E01000136",562,148,65,83,347,63,195,60,107,28,32,17,11,4,51,29,22,6,6,67,29,38
"2021","Barnet 038C","E01000144",746,323,61,262,330,23,188,55,111,22,55,41,12,2,51,24,27,13,13,93,24,69
"2021","Barnet 038D","E01000146",870,346,72,274,398,36,203,77,110,16,82,77,5,0,54,30,24,23,23,126,32,94
"2021","Barnet 038E","E01000214",774,308,67,241,401,55,224,66,121,37,61,52,9,0,54,30,24,7,7,65,13,52
"2021","Barnet 039A","E01000141",789,287,63,224,383,14,175,44,99,32,61,43,13,5,111,61,50,22,22,119,31,88
"2021","Barnet 039B","E01000221",528,179,32,147,300,5,126,16,91,19,23,5,15,3,141,69,72,5,5,49,25,24
"2021","Barnet 039C","E01000223",746,220,46,174,433,16,229,52,138,39,46,23,20,3,131,89,42,11,11,93,42,51
"2021","Barnet 039D","E01000307",556,126,58,68,326,20,181,33,92,56,36,21,12,3,79,39,40,10,10,104,44,60
"2021","Barnet 040A","E01000138",655,244,60,184,336,26,180,44,99,37,42,26,12,4,77,45,32,11,11,75,28,47
"2021","Barnet 040B","E01000142",893,284,59,225,520,25,279,69,160,50,82,56,23,3,112,77,35,22,22,89,34,55
"2021","Barnet 040C","E01000222",729,200,44,156,417,23,200,31,115,54,43,23,18,2,134,84,50,17,17,112,40,72
"2021","Barnet 040D","E01000224",558,128,50,78,334,29,197,35,112,50,21,10,8,3,74,37,37,13,13,96,44,52
"2021","Barnet 041A","E01000137",669,189,75,114,421,21,153,31,90,32,45,19,22,4,191,128,63,11,11,59,20,39
"2021","Barnet 041B","E01000139",545,143,61,82,316,39,178,42,104,32,45,36,7,2,46,27,19,8,8,86,21,65
"2021","Barnet 041C","E01000140",867,277,73,204,469,38,245,75,145,25,69,57,9,3,96,50,46,21,21,121,14,107
"2021","Barnet 041D","E01000143",680,224,46,178,387,17,141,33,89,19,48,37,7,4,163,110,53,18,18,69,25,44
"2021","Barnet 042A","E01033915",581,159,3,156,391,1,161,27,117,17,65,45,18,2,153,123,30,11,11,31,18,13
"2021","Barnet 042B","E01033916",653,228,39,189,358,9,177,56,108,13,66,44,21,1,97,76,21,9,9,67,27,40
"2021","Barnet 042C","E01033917",704,248,10,238,395,4,209,82,114,13,86,73,11,2,82,50,32,14,14,61,17,44
"2021","Barnet 042D","E01033918",631,260,14,246,328,4,182,83,91,8,63,54,9,0,54,32,22,25,25,43,8,35
"2021","Barnet 042E","E01033919",648,220,5,215,388,5,194,97,81,16,113,102,11,0,56,31,25,20,20,40,7,33
"2021","Barnet 042F","E01033920",640,161,16,145,400,10,236,86,128,22,82,69,10,3,35,18,17,37,37,79,24,55
"2021","Barnet 043F","E01000147",559,111,59,52,290,41,179,25,94,60,23,13,8,2,41,18,23,6,6,158,74,84
"2021","Barnet 043A","E01033921",693,200,8,192,421,5,214,74,133,7,70,51,17,2,95,70,25,37,37,72,14,58
"2021","Barnet 043B","E01033922",682,199,9,190,394,2,222,77,129,16,60,44,15,1,55,39,16,55,55,89,37,52
"2021","Barnet 043C","E01033923",588,164,40,124,368,12,225,51,122,52,40,25,14,1,80,58,22,11,11,56,27,29
"2021","Barnet 043D","E01033924",578,192,28,164,312,7,156,32,91,33,36,27,9,0,103,59,44,10,10,74,36,38
"2021","Barnet 043E","E01033925",617,150,48,102,369,29,201,49,114,38,65,38,21,6,63,33,30,11,11,98,41,57
"2021","Bexley 001A","E01000466",601,178,43,135,345,23,140,26,82,32,41,12,26,3,125,85,40,16,16,78,42,36
"2021","Bexley 001B","E01000467",594,125,30,95,406,10,190,71,89,30,44,10,29,5,147,99,48,15,15,63,41,22
"2021","Bexley 001C","E01000468",942,186,29,157,624,9,286,58,174,54,95,25,59,11,219,183,36,15,15,132,86,46
"2021","Bexley 001D","E01000469",637,168,42,126,400,12,191,45,101,45,58,26,28,4,125,97,28,14,14,69,34,35
"2021","Bexley 002A","E01000416",509,87,31,56,319,24,144,30,69,45,41,19,16,6,107,60,47,3,3,103,47,56
"2021","Bexley 002B","E01000418",729,194,79,115,459,32,231,57,122,52,87,38,41,8,103,58,45,6,6,76,46,30
"2021","Bexley 002C","E01000422",503,178,34,144,267,2,97,20,58,19,38,10,24,4,121,82,39,9,9,58,33,25
"2021","Bexley 002D","E01000464",556,185,71,114,301,14,145,37,65,43,33,10,18,5,102,65,37,7,7,70,42,28
"2021","Bexley 002E","E01000465",730,303,90,213,370,17,144,43,73,28,51,17,30,4,147,91,56,11,11,57,33,24
"2021","Bexley 002F","E01000470",526,182,50,132,293,18,92,23,44,25,45,10,33,2,131,96,35,7,7,51,29,22
"2021","Bexley 003A","E01000333",810,274,130,144,471,41,194,56,110,28,101,44,47,10,132,83,49,3,3,65,26,39
"2021","Bexley 003B","E01000335",1044,286,50,236,618,18,266,76,144,46,129,73,53,3,177,123,54,28,28,140,65,75
"2021","Bexley 003C","E01000336",791,275,89,186,426,17,149,36,86,27,79,29,38,12,172,130,42,9,9,90,46,44
"2021","Bexley 003D","E01000337",651,136,50,86,441,31,195,54,95,46,72,36,32,4,132,93,39,11,11,74,40,34
"2021","Bexley 003E","E01000338",693,159,57,102,450,25,235,63,120,52,76,40,27,9,105,67,38,9,9,84,45,39
"2021","Bexley 004A","E01000403",1059,404,199,205,574,52,210,58,107,45,91,38,47,6,210,156,54,11,11,81,47,34
"2021","Bexley 004B","E01000404",990,325,53,272,598,8,211,48,137,26,109,46,58,5,252,214,38,18,18,67,35,32
"2021","Bexley 004C","E01000405",565,129,33,96,382,8,176,43,103,30,68,23,42,3,122,86,36,8,8,54,37,17
"2021","Bexley 004D","E01000408",585,100,28,72,400,23,203,41,105,57,50,13,31,6,118,82,36,6,6,85,42,43
"2021","Bexley 005A","E01000332",617,159,93,66,383,74,168,55,69,44,58,30,26,2,78,37,41,5,5,75,43,32
"2021","Bexley 005B","E01000402",653,198,80,118,397,34,167,48,81,38,71,37,30,4,119,86,33,6,6,58,32,26
"2021","Bexley 005C","E01000406",789,186,44,142,531,25,252,63,151,38,110,46,55,9,134,89,45,10,10,72,39,33
"2021","Bexley 005D","E01000407",758,239,134,105,453,68,230,64,113,53,79,34,40,5,70,39,31,6,6,66,33,33
"2021","Bexley 006A","E01000334",636,166,97,69,420,52,219,55,107,57,67,29,34,4,78,45,33,4,4,50,28,22
"2021","Bexley 006B","E01000417",703,197,80,117,443,56,226,65,118,43,62,37,16,9,95,54,41,4,4,63,31,32
"2021","Bexley 006C","E01000419",584,136,102,34,402,91,216,45,112,59,42,17,19,6,49,17,32,4,4,46,21,25
"2021","Bexley 006D","E01000420",589,138,71,67,406,70,217,70,94,53,51,22,22,7,65,38,27,3,3,45,25,20
"2021","Bexley 006E","E01000442",626,152,90,62,432,68,245,57,110,78,54,16,30,8,60,35,25,5,5,42,33,9
"2021","Bexley 007A","E01000437",501,119,77,42,349,38,201,54,88,59,53,14,31,8,54,25,29,3,3,33,18,15
"2021","Bexley 007B","E01000438",605,118,65,53,440,41,200,45,107,48,76,23,45,8,120,70,50,3,3,47,23,24
"2021","Bexley 007C","E01000439",516,116,44,72,355,30,171,37,86,48,53,16,27,10,96,59,37,5,5,45,24,21
"2021","Bexley 007D","E01000440",515,116,84,32,347,66,212,59,84,69,37,12,22,3,30,12,18,2,2,52,28,24
"2021","Bexley 007E","E01000441",703,187,74,113,470,36,186,46,101,39,83,31,44,8,160,109,51,5,5,46,25,21
"2021","Bexley 008A","E01000373",460,110,30,80,316,5,144,22,102,20,71,25,43,3,92,70,22,4,4,34,22,12
"2021","Bexley 008B","E01000429",709,240,41,199,414,14,133,30,80,23,82,40,39,3,168,134,34,17,17,55,29,26
"2021","Bexley 008C","E01000430",706,126,42,84,525,26,260,57,149,54,85,28,53,4,141,97,44,13,13,55,32,23
"2021","Bexley 008D","E01000431",430,111,43,68,271,19,129,32,73,24,30,8,14,8,89,60,29,4,4,48,31,17
"2021","Bexley 008F","E01000433",713,181,51,130,468,30,174,32,103,39,75,25,39,11,177,125,52,12,12,64,41,23
"2021","Bexley 008G","E01000434",581,150,67,83,373,19,155,36,75,44,56,9,34,13,133,85,48,10,10,58,30,28
"2021","Bexley 008H","E01033789",605,100,21,79,448,8,261,67,174,20,68,37,26,5,97,70,27,14,14,57,32,25
"2021","Bexley 008I","E01033790",488,129,66,63,312,19,134,29,72,33,57,24,25,8,98,58,40,4,4,47,33,14
"2021","Bexley 009A","E01000356",629,170,114,56,412,89,232,51,135,46,43,22,15,6,44,15,29,4,4,47,27,20
"2021","Bexley 009B","E01000357",490,85,61,24,372,49,251,55,128,68,32,5,19,8,39,17,22,1,1,33,19,14
"2021","Bexley 009C","E01000359",496,102,60,42,359,82,206,58,91,57,35,16,15,4,32,15,17,4,4,35,16,19
"2021","Bexley 009D","E01000421",600,137,104,33,426,105,241,65,105,71,44,14,22,8,34,12,22,2,2,37,19,18
"2021","Bexley 009E","E01000450",634,133,71,62,458,45,252,52,138,62,61,20,34,7,94,56,38,6,6,43,28,15
"2021","Bexley 009F","E01000451",625,102,54,48,467,67,246,54,124,68,79,31,35,13,71,31,40,4,4,56,29,27
"2021","Bexley 009G","E01000452",494,83,47,36,367,47,220,49,114,57,55,23,25,7,41,22,19,4,4,44,26,18
"2021","Bexley 010A","E01000367",797,188,65,123,525,37,212,44,115,53,91,26,56,9,178,130,48,7,7,84,52,32
"2021","Bexley 010B","E01000368",624,139,45,94,420,25,162,34,87,41,80,31,42,7,147,93,54,6,6,65,41,24
"2021","Bexley 010C","E01000372",590,124,57,67,399,43,201,49,93,59,44,9,27,8,107,61,46,4,4,67,40,27
"2021","Bexley 010D","E01000380",903,420,184,236,451,50,191,84,70,37,101,66,27,8,101,67,34,8,8,32,16,16
"2021","Bexley 010E","E01000435",587,167,77,90,383,34,153,48,69,36,69,21,43,5,122,77,45,5,5,37,26,11
"2021","Bexley 011A","E01000353",656,149,117,32,463,122,259,74,113,72,46,24,16,6,33,14,19,3,3,44,24,20
"2021","Bexley 011B","E01000354",603,162,85,77,396,54,189,45,98,46,56,22,25,9,93,48,45,4,4,45,23,22
"2021","Bexley 011C","E01000355",600,146,103,43,421,104,209,56,93,60,61,32,20,9,46,19,27,1,1,33,9,24
"2021","Bexley 011D","E01000358",662,163,94,69,453,74,247,69,115,63,57,30,26,1,70,36,34,5,5,46,26,20
"2021","Bexley 011E","E01000436",627,107,74,33,475,92,287,60,147,80,42,15,24,3,52,22,30,2,2,45,27,18
"2021","Bexley 013A","E01000401",690,200,95,105,427,41,187,37,100,50,56,28,25,3,135,79,56,8,8,63,37,26
"2021","Bexley 013B","E01000453",516,86,47,39,384,51,218,47,119,52,57,22,28,7,54,27,27,4,4,46,23,23
"2021","Bexley 013C","E01000454",633,179,92,87,393,45,209,56,102,51,65,32,26,7,70,36,34,4,4,61,36,25
"2021","Bexley 013D","E01000455",619,96,59,37,451,57,274,59,144,71,58,20,34,4,55,24,31,7,7,72,30,42
"2021","Bexley 013E","E01000456",483,59,34,25,388,56,241,51,122,68,43,14,21,8,46,26,20,2,2,36,21,15
"2021","Bexley 014A","E01000325",582,92,56,36,446,83,254,55,130,69,53,19,24,10,53,24,29,3,3,44,22,22
"2021","Bexley 014B","E01000326",545,119,47,72,386,37,179,61,91,27,100,54,45,1,67,46,21,3,3,40,19,21
"2021","Bexley 014C","E01000369",628,131,57,74,436,67,227,62,107,58,62,33,23,6,77,36,41,3,3,61,34,27
"2021","Bexley 014D","E01000370",634,176,107,69,406,79,231,67,106,58,54,26,24,4,40,15,25,2,2,52,27,25
"2021","Bexley 014E","E01000371",630,136,68,68,461,60,236,66,118,52,91,36,48,7,68,43,25,6,6,33,16,17
"2021","Bexley 015A","E01000360",770,211,97,114,489,55,219,62,125,32,104,52,46,6,103,62,41,8,8,70,23,47
"2021","Bexley 015B","E01000362",776,230,124,106,493,70,224,58,106,60,94,55,32,7,97,58,39,8,8,53,28,25
"2021","Bexley 015C","E01000365",709,228,139,89,433,68,217,50,124,43,59,25,25,9,84,59,25,5,5,48,23,25
"2021","Bexley 015D","E01000366",657,169,62,107,441,48,262,81,143,38,63,41,21,1,64,31,33,4,4,47,27,20
"2021","Bexley 015E","E01000394",672,211,113,98,420,59,211,48,122,41,71,44,25,2,74,38,36,5,5,41,16,25
"2021","Bexley 016A","E01000388",602,149,101,48,406,90,221,57,112,52,43,20,19,4,49,19,30,3,3,47,23,24
"2021","Bexley 016B","E01000392",763,215,67,148,457,22,200,46,118,36,71,29,35,7,156,108,48,8,8,91,33,58
"2021","Bexley 016C","E01000409",654,150,91,59,454,54,268,66,145,57,79,35,35,9,49,25,24,4,4,50,32,18
"2021","Bexley 016D","E01000411",555,115,74,41,400,55,210,57,99,54,60,20,31,9,72,35,37,3,3,40,27,13
"2021","Bexley 016E","E01000414",724,207,115,92,421,45,229,52,118,59,48,20,25,3,85,51,34,14,14,96,41,55
"2021","Bexley 016F","E01000415",514,95,63,32,370,63,231,54,103,74,38,15,16,7,34,10,24,4,4,49,25,24
"2021","Bexley 017A","E01000327",628,146,105,41,439,88,262,62,137,63,38,17,16,5,46,23,23,5,5,43,27,16
"2021","Bexley 017B","E01000328",611,132,80,52,446,75,252,64,139,49,58,22,31,5,59,36,23,2,2,33,18,15
"2021","Bexley 017C","E01000329",660,170,81,89,445,43,235,58,122,55,63,25,31,7,98,63,35,6,6,45,24,21
"2021","Bexley 017D","E01000330",769,308,176,132,412,58,185,63,74,48,77,46,27,4,85,49,36,7,7,49,28,21
"2021","Bexley 017E","E01000331",621,145,75,70,428,44,202,45,111,46,78,30,38,10,99,62,37,5,5,48,35,13
"2021","Bexley 018A","E01000340",628,157,90,67,430,67,223,50,119,54,66,25,32,9,72,35,37,2,2,41,19,22
"2021","Bexley 018B","E01000395",547,88,53,35,417,57,273,76,123,74,39,12,24,3,48,20,28,0,0,42,25,17
"2021","Bexley 018C","E01000396",506,92,57,35,365,54,225,46,111,68,44,18,20,6,41,15,26,1,1,49,33,16
"2021","Bexley 018D","E01000410",599,122,78,44,424,42,260,55,136,69,60,25,30,5,58,38,20,4,4,53,28,25
"2021","Bexley 018E","E01000412",643,151,67,84,436,38,260,63,137,60,78,27,39,12,56,35,21,4,4,56,31,25
"2021","Bexley 018F","E01000413",525,119,62,57,381,51,182,53,85,44,78,34,36,8,69,41,28,1,1,25,16,9
"2021","Bexley 019A","E01000374",523,98,45,53,370,27,173,31,114,28,49,16,28,5,119,68,51,2,2,55,31,24
"2021","Bexley 019B","E01000375",784,171,54,117,535,34,257,59,147,51,122,68,47,7,110,72,38,12,12,78,45,33
"2021","Bexley 019C","E01000376",612,144,75,69,431,45,221,47,126,48,92,45,42,5,70,47,23,3,3,37,14,23
"2021","Bexley 019D","E01000377",652,203,93,110,412,53,189,62,95,32,90,48,33,9,77,42,35,3,3,37,20,17
"2021","Bexley 019F","E01000379",669,163,73,90,457,45,228,62,121,45,84,50,31,3,95,46,49,5,5,49,26,23
"2021","Bexley 019G","E01033791",630,243,60,183,350,14,143,48,75,20,83,48,32,3,103,79,24,7,7,37,14,23
"2021","Bexley 019H","E01033792",572,174,76,98,363,39,173,40,100,33,89,54,32,3,56,35,21,6,6,35,18,17
"2021","Bexley 020A","E01000348",525,74,54,20,418,71,274,57,131,86,42,14,19,9,31,14,17,0,0,33,16,17
"2021","Bexley 020B","E01000349",657,142,94,48,483,95,281,71,158,52,46,19,24,3,58,30,28,3,3,32,14,18
"2021","Bexley 020C","E01000361",599,118,56,62,432,46,228,60,105,63,82,36,38,8,74,35,39,2,2,49,29,20
"2021","Bexley 020D","E01000363",567,115,75,40,396,67,228,62,108,58,49,24,18,7,49,30,19,3,3,56,34,22
"2021","Bexley 020E","E01000389",710,225,107,118,439,72,226,58,123,45,64,38,22,4,73,42,31,4,4,46,19,27
"2021","Bexley 020F","E01000390",515,127,77,50,360,54,190,47,99,44,62,22,31,9,50,23,27,4,4,28,16,12
"2021","Bexley 020G","E01000393",626,135,66,69,438,38,254,69,128,57,80,40,34,6,63,28,35,3,3,53,32,21
"2021","Bexley 021A","E01000346",618,141,80,61,444,69,220,62,119,39,102,46,46,10,53,23,30,0,0,33,21,12
"2021","Bexley 021B","E01000347",627,191,112,79,395,58,193,51,94,48,74,29,42,3,70,41,29,0,0,41,17,24
"2021","Bexley 021C","E01000350",523,87,50,37,394,64,230,41,121,68,50,20,22,8,49,21,28,1,1,42,19,23
"2021","Bexley 021D","E01000352",665,202,102,100,417,57,200,55,101,44,62,30,29,3,96,64,32,2,2,46,28,18
"2021","Bexley 021E","E01000391",638,123,75,48,455,47,244,60,134,50,76,27,37,12,86,41,45,2,2,60,31,29
"2021","Bexley 022A","E01000341",625,148,99,49,443,87,218,64,91,63,70,24,41,5,68,30,38,0,0,34,16,18
"2021","Bexley 022B","E01000342",637,186,83,103,428,44,210,53,100,57,96,44,47,5,75,31,44,3,3,23,16,7
"2021","Bexley 022C","E01000343",558,124,70,54,394,61,216,37,117,62,62,23,30,9,51,33,18,4,4,40,27,13
"2021","Bexley 022D","E01000345",489,77,42,35,374,63,207,48,94,65,55,27,24,4,48,23,25,1,1,38,18,20
"2021","Bexley 022E","E01000460",481,93,43,50,363,68,239,72,106,61,32,10,21,1,23,7,16,1,1,25,13,12
"2021","Bexley 023A","E01000364",653,167,84,83,432,64,237,44,140,53,67,29,35,3,62,33,29,2,2,54,24,30
"2021","Bexley 023B","E01000444",636,122,74,48,478,108,274,83,130,61,51,24,23,4,44,25,19,1,1,36,19,17
"2021","Bexley 023C","E01000447",882,293,134,159,545,47,225,67,129,29,162,94,62,6,102,57,45,9,9,44,14,30
"2021","Bexley 023D","E01000448",511,110,84,26,375,82,226,55,127,44,34,16,11,7,32,12,20,1,1,26,9,17
"2021","Bexley 023E","E01000449",643,178,128,50,437,91,256,68,138,50,55,26,24,5,33,10,23,2,2,28,8,20
"2021","Bexley 024A","E01000351",624,125,79,46,458,90,239,71,109,59,74,27,44,3,49,25,24,6,6,41,25,16
"2021","Bexley 024B","E01000443",513,132,64,68,347,35,191,51,101,39,50,21,20,9,68,33,35,3,3,34,13,21
"2021","Bexley 024C","E01000445",679,172,118,54,475,87,256,70,132,54,73,31,37,5,56,34,22,3,3,32,15,17
"2021","Bexley 024D","E01000446",597,122,58,64,450,52,227,61,112,54,100,59,36,5,65,34,31,6,6,25,9,16
"2021","Bexley 024E","E01000461",568,74,49,25,450,74,284,72,146,66,39,13,23,3,53,14,39,0,0,44,16,28
"2021","Bexley 025A","E01000339",598,122,67,55,446,66,232,55,114,63,64,27,32,5,84,49,35,0,0,30,11,19
"2021","Bexley 025B","E01000344",638,160,97,63,448,62,253,61,135,57,63,29,27,7,69,41,28,1,1,30,9,21
"2021","Bexley 025C","E01000423",605,125,86,39,441,81,268,60,152,56,56,26,26,4,36,16,20,0,0,39,13,26
"2021","Bexley 025D","E01000425",608,91,60,31,478,85,304,77,163,64,43,14,29,0,45,15,30,1,1,39,19,20
"2021","Bexley 025E","E01000463",451,83,50,33,339,48,206,37,118,51,44,14,23,7,39,16,23,2,2,29,15,14
"2021","Bexley 026A","E01000424",746,253,99,154,443,65,229,79,91,59,85,58,23,4,61,26,35,3,3,50,13,37
"2021","Bexley 026B","E01000426",711,192,86,106,473,46,230,65,115,50,112,73,33,6,82,45,37,3,3,46,19,27
"2021","Bexley 026C","E01000427",910,339,196,143,523,94,235,53,128,54,86,38,41,7,100,48,52,8,8,48,16,32
"2021","Bexley 026D","E01000457",991,389,136,253,496,46,181,53,109,19,147,99,45,3,102,70,32,20,20,106,13,93
"2021","Bexley 026E","E01000462",836,312,138,174,458,58,186,52,97,37,115,85,25,5,90,69,21,9,9,66,17,49
"2021","Bexley 027A","E01000382",587,119,83,36,432,76,266,67,130,69,46,20,23,3,43,22,21,1,1,36,20,16
"2021","Bexley 027B","E01000384",755,259,146,113,440,45,231,65,130,36,79,47,31,1,82,53,29,3,3,56,23,33
"2021","Bexley 027C","E01000387",622,159,102,57,428,66,245,74,112,59,59,27,26,6,57,23,34,1,1,35,17,18
"2021","Bexley 027D","E01000428",910,405,185,220,443,54,166,49,87,30,103,57,40,6,111,79,32,9,9,62,24,38
"2021","Bexley 027E","E01000458",687,243,172,71,411,88,228,55,110,63,47,22,21,4,43,18,25,5,5,33,13,20
"2021","Bexley 027F","E01000459",883,353,212,141,475,78,210,67,96,47,92,55,33,4,87,53,34,8,8,55,10,45
"2021","Bexley 028A","E01000381",659,182,78,104,438,48,201,52,101,48,68,33,25,10,113,76,37,8,8,39,16,23
"2021","Bexley 028B","E01000383",626,147,89,58,434,82,225,68,96,61,57,23,29,5,63,26,37,7,7,45,22,23
"2021","Bexley 028C","E01000385",778,214,74,140,503,44,181,42,109,30,77,31,41,5,196,131,65,5,5,61,32,29
"2021","Bexley 028D","E01000386",646,233,110,123,359,20,145,45,65,35,64,32,26,6,123,83,40,7,7,54,23,31
"2021","Bexley 029A","E01000398",610,145,80,65,402,49,201,63,88,50,69,32,29,8,79,36,43,4,4,63,37,26
"2021","Bexley 029B","E01000399",622,165,106,59,405,82,221,63,115,43,41,21,13,7,54,23,31,7,7,52,32,20
"2021","Bexley 029C","E01000400",590,144,74,70,382,49,220,73,101,46,41,15,22,4,66,29,37,6,6,64,32,32
"2021","Bexley 029D","E01032566",752,214,81,133,462,43,232,62,121,49,73,31,33,9,107,58,49,7,7,76,44,32
"2021","Brent 001A","E01000587",462,63,32,31,275,38,183,28,86,69,13,4,6,3,33,12,21,8,8,124,63,61
"2021","Brent 001B","E01000589",805,137,48,89,522,48,318,63,159,96,43,29,11,3,101,50,51,12,12,146,85,61
"2021","Brent 001C","E01000590",629,149,82,67,357,37,214,42,104,68,33,19,12,2,58,25,33,15,15,123,74,49
"2021","Brent 001D","E01000592",618,140,42,98,343,45,177,37,80,60,28,17,10,1,77,41,36,16,16,135,72,63
"2021","Brent 001E","E01000593",669,111,53,58,434,40,215,40,98,77,39,23,13,3,130,58,72,10,10,124,72,52
"2021","Brent 001F","E01000594",558,91,38,53,322,31,199,49,86,64,17,11,4,2,39,18,21,36,36,145,80,65
"2021","Brent 002A","E01000513",470,78,42,36,288,30,194,30,101,63,15,6,6,3,46,18,28,3,3,104,62,42
"2021","Brent 002B","E01000514",493,94,32,62,290,20,172,33,88,51,20,9,9,2,71,37,34,7,7,109,62,47
"2021","Brent 002C","E01000516",750,142,39,103,447,34,281,63,141,77,55,41,14,0,64,32,32,13,13,161,68,93
"2021","Brent 002D","E01000520",608,182,71,111,343,33,216,32,131,53,22,10,9,3,64,39,25,8,8,83,39,44
"2021","Brent 002F","E01033929",552,141,3,138,368,0,188,72,107,9,76,57,18,1,87,73,14,17,17,43,20,23
"2021","Brent 002G","E01033930",588,96,44,52,363,25,166,26,64,76,25,7,15,3,141,80,61,6,6,129,59,70
"2021","Brent 003A","E01000515",646,156,57,99,390,17,202,37,124,41,32,16,14,2,129,65,64,10,10,100,47,53
"2021","Brent 003B","E01000517",486,78,43,35,300,50,186,31,94,61,19,11,6,2,37,10,27,8,8,108,56,52
"2021","Brent 003E","E01000543",495,91,46,45,275,34,178,30,86,62,8,3,3,2,49,19,30,6,6,129,65,64
"2021","Brent 003F","E01000591",642,119,61,58,359,36,244,43,130,71,19,9,6,4,49,20,29,11,11,164,98,66
"2021","Brent 003G","E01033463",909,131,84,47,519,80,317,42,134,141,26,13,5,8,89,26,63,7,7,259,143,116
"2021","Brent 004A","E01000536",502,76,54,22,327,60,214,48,104,62,8,3,5,0,42,22,20,3,3,99,53,46
"2021","Brent 004B","E01000538",484,57,35,22,349,73,235,49,111,75,9,6,2,1,26,10,16,6,6,78,44,34
"2021","Brent 004C","E01000539",536,139,89,50,314,53,205,35,110,60,16,12,3,1,33,12,21,7,7,83,45,38
"2021","Brent 004D","E01000540",484,81,50,31,306,58,190,38,79,73,13,6,4,3,36,14,22,9,9,97,46,51
"2021","Brent 004E","E01000541",484,111,59,52,271,28,178,38,91,49,11,5,5,1,45,19,26,9,9,102,54,48
"2021","Brent 005A","E01000518",629,167,68,99,342,23,188,35,89,64,30,17,9,4,90,39,51,11,11,120,73,47
"2021","Brent 005B","E01000519",629,121,54,67,394,27,256,50,136,70,20,10,8,2,84,43,41,7,7,114,74,40
"2021","Brent 005C","E01000623",569,76,37,39,371,51,233,43,121,69,16,9,5,2,60,27,33,11,11,122,51,71
"2021","Brent 005D","E01000624",589,144,81,63,323,46,172,33,82,57,32,15,14,3,66,24,42,7,7,122,67,55
"2021","Brent 005E","E01000629",625,130,64,66,370,37,231,48,115,68,29,14,13,2,63,24,39,10,10,125,61,64
"2021","Brent 006A","E01000480",514,86,39,47,319,41,202,37,103,62,21,12,6,3,48,22,26,7,7,109,56,53
"2021","Brent 006B","E01000484",611,129,38,91,404,11,169,34,91,44,17,5,10,2,198,83,115,9,9,78,46,32
"2021","Brent 006C","E01000485",533,137,70,67,315,46,168,32,95,41,15,4,8,3,77,34,43,9,9,81,38,43
"2021","Brent 006D","E01000486",521,73,36,37,344,41,221,45,119,57,14,8,6,0,60,25,35,8,8,104,50,54
"2021","Brent 006E","E01000487",694,195,130,65,389,46,212,30,131,51,44,30,12,2,66,39,27,21,21,110,54,56
"2021","Brent 007A","E01000572",459,71,38,33,294,42,182,32,94,56,11,4,7,0,53,23,30,6,6,94,46,48
"2021","Brent 007B","E01000573",482,82,41,41,285,33,184,31,94,59,15,4,10,1,38,18,20,15,15,115,56,59
"2021","Brent 007C","E01000574",455,79,35,44,265,29,168,24,100,44,25,12,12,1,40,15,25,3,3,111,56,55
"2021","Brent 007D","E01000575",659,151,61,90,336,25,214,50,122,42,27,18,7,2,56,36,20,14,14,172,87,85
"2021","Brent 007E","E01000577",862,174,45,129,583,8,299,50,204,45,55,29,19,7,197,145,52,24,24,105,62,43
"2021","Brent 008A","E01000562",481,76,52,24,300,52,169,26,66,77,20,10,7,3,56,20,36,3,3,105,57,48
"2021","Brent 008B","E01000563",481,68,43,25,314,64,198,39,82,77,9,5,1,3,37,11,26,6,6,99,51,48
"2021","Brent 008C","E01000566",467,84,56,28,267,36,170,24,85,61,11,5,4,2,46,11,35,4,4,116,58,58
"2021","Brent 008D","E01000568",663,211,24,187,291,18,191,42,105,44,28,18,8,2,45,22,23,9,9,161,61,100
"2021","Brent 008E","E01000569",481,77,48,29,312,61,177,35,73,69,10,5,4,1,59,19,40,5,5,92,43,49
"2021","Brent 009A","E01000479",514,89,46,43,325,47,202,21,105,76,19,13,2,4,47,19,28,10,10,100,52,48
"2021","Brent 009B","E01000481",604,165,65,100,365,14,187,31,116,40,36,21,14,1,114,70,44,14,14,74,37,37
"2021","Brent 009D","E01000483",658,179,51,128,389,9,192,40,112,40,28,16,6,6,149,103,46,11,11,90,47,43
"2021","Brent 009E","E01000625",591,152,71,81,365,29,197,43,101,53,37,20,13,4,92,56,36,10,10,74,35,39
"2021","Brent 009F","E01033931",500,151,45,106,291,5,174,52,106,16,28,18,10,0,78,48,30,6,6,58,28,30
"2021","Brent 009G","E01033932",522,136,37,99,277,9,140,32,65,43,15,6,9,0,106,51,55,7,7,109,46,63
"2021","Brent 010B","E01000498",515,110,31,79,307,24,180,33,93,54,16,7,8,1,78,48,30,9,9,98,55,43
"2021","Brent 010D","E01000622",707,213,54,159,388,8,181,41,113,27,88,29,54,5,97,68,29,14,14,106,58,48
"2021","Brent 010E","E01000626",602,193,65,128,353,13,144,25,82,37,50,13,28,9,138,73,65,8,8,56,33,23
"2021","Brent 010G","E01033933",416,100,41,59,238,18,148,23,80,45,12,5,3,4,52,32,20,8,8,78,49,29
"2021","Brent 010H","E01033934",444,76,32,44,291,30,181,25,107,49,12,6,4,2,64,37,27,4,4,77,37,40
"2021","Brent 011A","E01000497",685,141,41,100,430,34,231,89,88,54,66,52,9,5,83,37,46,16,16,114,38,76
"2021","Brent 011B","E01000499",585,101,31,70,386,19,191,29,114,48,35,15,18,2,131,89,42,10,10,98,35,63
"2021","Brent 011C","E01000501",762,220,74,146,458,21,209,37,119,53,45,17,13,15,170,102,68,13,13,84,36,48
"2021","Brent 011D","E01000502",660,164,60,104,413,21,220,35,135,50,44,22,20,2,121,93,28,7,7,83,30,53
"2021","Brent 011E","E01000503",776,258,81,177,430,38,219,29,120,70,35,17,13,5,124,67,57,14,14,88,50,38
"2021","Brent 012A","E01000570",510,105,42,63,314,25,175,36,76,63,23,11,9,3,80,24,56,11,11,91,36,55
"2021","Brent 012B","E01000571",492,86,29,57,265,28,150,28,57,65,26,14,7,5,49,19,30,12,12,141,59,82
"2021","Brent 012C","E01000576",571,130,61,69,318,29,191,29,85,77,22,8,13,1,62,24,38,14,14,123,70,53
"2021","Brent 012D","E01000578",834,294,96,198,413,33,229,45,147,37,30,15,13,2,116,65,51,5,5,127,55,72
"2021","Brent 013A","E01000564",489,82,30,52,292,17,184,31,112,41,26,14,11,1,60,34,26,5,5,115,67,48
"2021","Brent 013B","E01000565",483,101,39,62,285,26,163,30,90,43,17,7,7,3,71,35,36,8,8,97,56,41
"2021","Brent 013C","E01000607",687,106,44,62,365,33,211,37,121,53,21,6,11,4,75,35,40,25,25,216,140,76
"2021","Brent 013D","E01000608",809,212,96,116,449,27,269,54,160,55,33,18,12,3,107,53,54,13,13,148,79,69
"2021","Brent 013E","E01000613",638,183,53,130,360,15,217,59,121,37,32,18,12,2,88,61,27,8,8,95,46,49
"2021","Brent 014A","E01000506",662,219,45,174,364,9,148,36,79,33,53,32,17,4,129,90,39,25,25,79,28,51
"2021","Brent 014B","E01000509",457,130,44,86,223,24,131,24,60,47,20,10,5,5,42,21,21,6,6,104,54,50
"2021","Brent 014C","E01000510",575,173,75,98,290,23,142,27,83,32,18,11,5,2,99,64,35,8,8,112,49,63
"2021","Brent 014D","E01000511",559,119,37,82,344,27,163,26,96,41,46,18,28,0,102,82,20,6,6,96,56,40
"2021","Brent 014E","E01000627",683,166,52,114,387,29,178,49,91,38,38,17,15,6,129,72,57,13,13,130,61,69
"2021","Brent 014F","E01000628",639,209,50,159,310,18,145,32,72,41,39,26,12,1,89,50,39,19,19,120,51,69
"2021","Brent 015A","E01000553",740,238,49,189,326,6,150,40,89,21,59,40,15,4,99,53,46,12,12,176,54,122
"2021","Brent 015B","E01000554",756,227,61,166,415,21,203,46,127,30,72,41,29,2,103,57,46,16,16,114,39,75
"2021","Brent 015C","E01000555",525,105,38,67,310,34,155,27,94,34,33,22,10,1,82,56,26,6,6,110,36,74
"2021","Brent 015D","E01000556",859,324,56,268,384,8,183,89,76,18,91,75,11,5,82,49,33,20,20,151,50,101
"2021","Brent 015E","E01000557",832,358,49,309,361,22,171,46,96,29,65,46,18,1,84,45,39,19,19,113,27,86
"2021","Brent 015F","E01000558",644,247,67,180,306,21,130,37,72,21,51,45,6,0,86,53,33,18,18,91,22,69
"2021","Brent 016A","E01000567",460,79,49,30,305,32,188,31,113,44,19,5,9,5,61,25,36,5,5,76,35,41
"2021","Brent 016B","E01000606",577,132,63,69,326,20,192,37,112,43,25,13,10,2,61,37,24,28,28,119,55,64
"2021","Brent 016C","E01000609",631,107,35,72,397,37,220,40,114,66,34,14,14,6,95,55,40,11,11,127,75,52
"2021","Brent 016D","E01000611",604,117,36,81,361,17,229,50,140,39,21,19,2,0,80,34,46,14,14,126,74,52
"2021","Brent 018A","E01000504",696,209,62,147,388,17,210,52,123,35,76,56,17,3,70,44,26,15,15,99,30,69
"2021","Brent 018B","E01000505",571,163,55,108,297,27,139,30,67,42,37,9,26,2,88,35,53,6,6,111,44,67
"2021","Brent 018C","E01000507",521,99,41,58,305,39,168,30,87,51,31,13,15,3,57,29,28,10,10,117,39,78
"2021","Brent 018D","E01000512",651,203,92,111,329,21,182,50,98,34,50,36,13,1,65,34,31,11,11,119,41,78
"2021","Brent 018E","E01000559",658,253,76,177,327,15,156,48,87,21,85,66,14,5,60,25,35,11,11,78,9,69
"2021","Brent 019A","E01000610",690,144,43,101,404,28,253,45,148,60,26,10,14,2,84,45,39,13,13,142,73,69
"2021","Brent 019B","E01000612",543,106,39,67,285,22,173,31,111,31,14,6,7,1,66,27,39,10,10,152,83,69
"2021","Brent 019C","E01000631",580,110,31,79,316,34,202,27,107,68,17,9,8,0,49,16,33,14,14,154,85,69
"2021","Brent 019D","E01000633",616,103,45,58,307,13,202,38,118,46,18,7,11,0,60,33,27,14,14,206,137,69
"2021","Brent 019E","E01000634",762,128,42,86,448,12,276,60,152,64,24,6,16,2,121,66,55,15,15,186,106,80
"2021","Brent 020A","E01000616",591,139,38,101,287,16,157,33,89,35,38,33,5,0,63,31,32,13,13,165,88,77
"2021","Brent 020B","E01000620",511,100,41,59,283,29,162,32,66,64,18,8,8,2,66,24,42,8,8,128,71,57
"2021","Brent 020C","E01000621",512,90,40,50,274,22,135,29,57,49,24,12,11,1,74,33,41,19,19,148,77,71
"2021","Brent 020E","E01000636",770,128,53,75,463,45,265,58,137,70,48,32,12,4,81,51,30,24,24,179,98,81
"2021","Brent 020F","E01033935",565,96,28,68,310,13,181,41,102,38,20,11,7,2,77,44,33,19,19,159,94,65
"2021","Brent 020G","E01033936",547,96,20,76,317,5,182,61,93,28,61,60,1,0,56,38,18,13,13,134,64,70
"2021","Brent 021A","E01000596",627,167,62,105,377,8,185,18,119,48,16,2,9,5,160,94,66,8,8,83,48,35
"2021","Brent 021B","E01000601",513,135,29,106,324,5,97,15,56,26,17,9,7,1,197,110,87,8,8,54,34,20
"2021","Brent 021C","E01000602",501,141,45,96,289,17,98,13,51,34,27,8,13,6,111,59,52,36,36,71,45,26
"2021","Brent 021D","E01000603",562,164,54,110,359,13,142,27,97,18,23,10,11,2,163,116,47,18,18,39,14,25
"2021","Brent 021E","E01000604",513,105,46,59,330,11,152,15,90,47,24,7,8,9,133,57,76,10,10,78,48,30
"2021","Brent 021F","E01000605",572,127,37,90,366,11,136,16,85,35,24,11,7,6,184,68,116,11,11,79,39,40
"2021","Brent 022A","E01000488",550,165,47,118,297,10,161,38,87,36,35,26,8,1,78,43,35,13,13,88,35,53
"2021","Brent 022B","E01000637",614,188,56,132,328,16,132,36,68,28,69,49,18,2,92,56,36,19,19,98,19,79
"2021","Brent 022C","E01000639",744,266,37,229,371,8,183,85,87,11,70,55,13,2,93,49,44,17,17,107,21,86
"2021","Brent 022D","E01000642",1031,390,78,312,486,21,192,91,82,19,119,100,17,2,124,65,59,30,30,155,34,121
"2021","Brent 022E","E01000644",763,234,60,174,393,19,149,39,81,29,87,61,22,4,117,73,44,21,21,136,37,99
"2021","Brent 023A","E01000490",888,370,51,319,427,16,179,70,100,9,140,117,20,3,79,34,45,13,13,91,10,81
"2021","Brent 023B","E01000494",722,246,104,142,385,34,179,50,119,10,67,51,16,0,83,45,38,22,22,91,23,68
"2021","Brent 023C","E01000495",778,379,138,241,309,16,123,44,65,14,82,64,18,0,77,38,39,11,11,90,8,82
"2021","Brent 023D","E01000560",662,238,70,168,322,20,153,41,85,27,74,55,15,4,63,35,28,12,12,102,17,85
"2021","Brent 023E","E01000561",819,255,65,190,449,19,180,56,107,17,102,76,21,5,127,54,73,21,21,115,22,93
"2021","Brent 024A","E01000638",791,210,66,144,476,12,232,41,153,38,55,36,16,3,159,116,43,18,18,105,35,70
"2021","Brent 024B","E01000640",818,218,52,166,478,9,219,58,124,37,58,36,20,2,170,122,48,22,22,122,44,78
"2021","Brent 024C","E01000641",736,211,57,154,409,16,170,36,107,27,72,38,30,4,140,91,49,11,11,116,41,75
"2021","Brent 024D","E01000643",895,312,86,226,494,6,197,56,102,39,44,24,15,5,231,143,88,16,16,89,48,41
"2021","Brent 025A","E01000508",862,268,83,185,504,21,229,29,156,44,50,27,18,5,188,96,92,16,16,90,51,39
"2021","Brent 025B","E01000521",921,371,67,304,460,6,152,28,100,24,45,20,19,6,236,145,91,21,21,90,41,49
"2021","Brent 025C","E01000522",696,152,42,110,466,15,197,28,125,44,46,16,24,6,190,109,81,18,18,78,46,32
"2021","Brent 025D","E01000526",808,281,70,211,444,13,170,18,101,51,30,7,20,3,213,117,96,18,18,83,51,32
"2021","Brent 025E","E01000527",737,246,69,177,396,25,149,24,99,26,37,16,16,5,170,115,55,15,15,95,40,55
"2021","Brent 025F","E01000528",736,293,61,232,381,15,160,49,85,26,39,18,18,3,158,92,66,9,9,62,32,30
"2021","Brent 026A","E01000471",490,82,36,46,260,22,156,16,73,67,15,4,9,2,58,21,37,9,9,148,68,80
"2021","Brent 026B","E01000474",521,58,34,24,260,22,151,21,71,59,15,4,6,5,67,23,44,5,5,203,131,72
"2021","Brent 026C","E01000476",559,93,44,49,278,31,169,30,53,86,16,7,5,4,55,19,36,7,7,188,121,67
"2021","Brent 026D","E01000477",682,140,40,100,377,17,241,55,127,59,33,14,14,5,77,41,36,9,9,165,113,52
"2021","Brent 026E","E01000630",908,232,55,177,473,15,273,60,161,52,34,24,10,0,130,61,69,21,21,203,94,109
"2021","Brent 027A","E01000595",653,196,50,146,397,10,141,19,89,33,25,12,12,1,212,154,58,9,9,60,34,26
"2021","Brent 027D","E01000599",700,209,48,161,419,9,162,36,92,34,41,25,11,5,186,103,83,21,21,72,45,27
"2021","Brent 027F","E01033456",876,250,78,172,526,15,185,29,113,43,50,24,23,3,260,146,114,16,16,100,64,36
"2021","Brent 027G","E01033937",480,215,43,172,203,4,73,12,45,16,21,15,4,2,96,52,44,9,9,62,31,31
"2021","Brent 027H","E01033938",446,168,36,132,242,5,98,19,65,14,31,18,10,3,100,63,37,8,8,36,17,19
"2021","Brent 027I","E01033939",798,217,7,210,498,3,259,74,172,13,102,79,22,1,112,88,24,22,22,83,23,60
"2021","Brent 028A","E01000545",911,382,80,302,398,9,164,64,81,19,99,79,20,0,97,50,47,29,29,131,26,105
"2021","Brent 028B","E01000546",753,279,70,209,357,21,150,62,71,17,90,55,30,5,73,43,30,23,23,117,33,84
"2021","Brent 028C","E01000547",688,228,50,178,376,13,175,46,106,23,97,78,16,3,72,48,24,19,19,84,22,62
"2021","Brent 028D","E01000548",1002,451,99,352,427,18,135,56,68,11,131,115,14,2,124,80,44,19,19,124,22,102
"2021","Brent 028E","E01000549",890,360,81,279,436,20,193,81,101,11,134,113,18,3,64,34,30,25,25,94,17,77
"2021","Brent 029A","E01000472",914,234,47,187,570,13,304,92,176,36,107,84,21,2,130,97,33,16,16,110,47,63
"2021","Brent 029B","E01000473",792,173,43,130,435,21,256,54,130,72,23,11,12,0,117,70,47,18,18,184,125,59
"2021","Brent 029C","E01000475",613,113,37,76,345,18,203,37,101,65,37,7,28,2,74,22,52,13,13,155,84,71
"2021","Brent 029D","E01000478",717,148,45,103,382,22,217,40,117,60,32,16,12,4,101,45,56,10,10,187,120,67
"2021","Brent 029E","E01000632",594,66,28,38,316,29,201,34,94,73,14,7,4,3,59,24,35,13,13,212,123,89
"2021","Brent 030A","E01000489",690,246,129,117,342,36,172,39,97,36,37,27,10,0,86,49,37,11,11,102,26,76
"2021","Brent 030B","E01000491",864,320,73,247,417,25,194,45,130,19,84,62,18,4,102,64,38,12,12,127,42,85
"2021","Brent 030C","E01000492",455,96,42,54,285,26,168,32,103,33,34,8,20,6,53,19,34,4,4,74,25,49
"2021","Brent 030D","E01000493",563,123,58,65,344,28,182,34,92,56,47,19,26,2,78,31,47,9,9,96,38,58
"2021","Brent 030E","E01000581",597,162,40,122,331,17,163,35,104,24,64,43,16,5,74,47,27,13,13,104,41,63
"2021","Brent 031A","E01000523",871,248,47,201,513,20,192,43,122,27,69,29,33,7,212,150,62,20,20,110,50,60
"2021","Brent 031B","E01000524",986,351,83,268,515,17,179,38,102,39,63,41,16,6,217,149,68,39,39,120,58,62
"2021","Brent 031C","E01000525",758,253,65,188,417,13,130,32,78,20,65,37,19,9,196,112,84,13,13,88,42,46
"2021","Brent 031E","E01000533",880,306,86,220,456,13,171,34,108,29,57,19,32,6,195,112,83,20,20,118,40,78
"2021","Brent 031F","E01000535",846,260,78,182,470,16,192,36,117,39,66,43,19,4,166,96,70,30,30,116,30,86
"2021","Brent 031G","E01033455",495,177,31,146,271,7,112,29,69,14,32,17,14,1,113,69,44,7,7,47,11,36
"2021","Brent 031H","E01033485",708,279,49,230,334,17,111,29,60,22,47,30,15,2,145,91,54,14,14,95,26,69
"2021","Brent 032A","E01000579",634,189,43,146,329,11,136,38,72,26,80,47,29,4,93,49,44,9,9,116,32,84
"2021","Brent 032B","E01000580",854,257,91,166,499,50,242,60,154,28,92,52,36,4,107,67,40,8,8,98,34,64
"2021","Brent 032C","E01000582",689,138,47,91,452,39,241,42,169,30,77,43,32,2,85,57,28,10,10,99,44,55
"2021","Brent 032D","E01000583",900,300,81,219,490,62,204,56,126,22,109,84,20,5,100,63,37,15,15,110,23,87
"2021","Brent 032E","E01000586",1090,403,62,341,517,6,215,79,117,19,144,115,27,2,121,75,46,31,31,170,37,133
"2021","Brent 033A","E01000530",674,158,56,102,402,27,211,39,122,50,68,39,28,1,84,42,42,12,12,114,29,85
"2021","Brent 033B","E01000531",858,395,119,276,367,23,153,39,91,23,63,45,15,3,111,69,42,17,17,96,27,69
"2021","Brent 033C","E01000532",609,197,49,148,310,14,125,32,69,24,80,57,21,2,80,37,43,11,11,102,36,66
"2021","Brent 033D","E01000534",656,171,50,121,380,19,192,38,119,35,59,31,24,4,97,54,43,13,13,105,31,74
"2021","Brent 033E","E01000584",549,115,47,68,342,25,192,33,117,42,53,30,21,2,58,25,33,14,14,92,38,54
"2021","Brent 033F","E01000585",597,146,36,110,349,13,169,29,124,16,72,51,18,3,79,51,28,16,16,102,19,83
"2021","Brent 034A","E01000544",741,252,50,202,390,4,163,42,97,24,80,63,15,2,109,64,45,34,34,99,29,70
"2021","Brent 034B","E01000550",910,365,96,269,443,15,167,44,92,31,89,65,22,2,159,83,76,13,13,102,20,82
"2021","Brent 034C","E01000551",1176,450,68,382,620,19,235,48,145,42,82,58,20,4,261,123,138,23,23,106,55,51
"2021","Brent 034D","E01000552",578,203,41,162,309,4,139,18,99,22,41,22,16,3,111,64,47,14,14,66,25,41
"2021","Brent 035A","E01033457",581,117,38,79,335,15,238,63,128,47,14,10,3,1,52,24,28,16,16,129,81,48
"2021","Brent 035B","E01033940",709,201,2,199,435,1,231,121,100,10,124,113,11,0,60,51,9,19,19,73,11,62
"2021","Brent 035C","E01033941",729,273,25,248,419,1,234,92,136,6,74,60,11,3,92,67,25,18,18,37,13,24
"2021","Brent 035D","E01033942",685,234,3,231,392,3,154,91,54,9,153,148,5,0,63,52,11,19,19,59,6,53
"2021","Brent 036A","E01000615",824,176,41,135,520,27,303,87,165,51,75,56,17,2,93,52,41,22,22,128,64,64
"2021","Brent 036B","E01000617",720,170,81,89,375,28,200,47,90,63,55,41,12,2,82,38,44,10,10,175,81,94
"2021","Brent 036D","E01000618",478,84,56,28,272,31,151,33,66,52,11,6,3,2,71,32,39,8,8,122,68,54
"2021","Brent 036C","E01000619",478,84,39,45,273,26,151,27,68,56,27,7,13,7,65,24,41,4,4,121,72,49
"2021","Bromley 001A","E01000779",587,173,71,102,356,59,169,58,75,36,52,32,19,1,71,44,27,5,5,58,17,41
"2021","Bromley 001B","E01000780",647,176,89,87,422,34,197,53,109,35,68,39,23,6,113,74,39,10,10,49,28,21
"2021","Bromley 001C","E01000781",626,183,66,117,397,16,157,34,93,30,73,31,30,12,149,97,52,2,2,46,31,15
"2021","Bromley 001D","E01000782",654,241,64,177,354,21,147,38,73,36,59,21,35,3,120,83,37,7,7,59,32,27
"2021","Bromley 001E","E01000783",634,191,72,119,388,17,165,47,90,28,69,27,40,2,131,91,40,6,6,55,31,24
"2021","Bromley 001F","E01000785",630,181,55,126,400,23,156,41,83,32,86,32,46,8,129,86,43,6,6,49,27,22
"2021","Bromley 002A","E01000689",615,182,76,106,397,52,178,55,81,42,70,35,29,6,93,59,34,4,4,36,22,14
"2021","Bromley 002B","E01000690",538,119,62,57,399,58,232,49,124,59,59,29,28,2,49,26,23,1,1,20,11,9
"2021","Bromley 002C","E01000691",639,185,97,88,419,49,220,53,119,48,72,33,29,10,76,44,32,2,2,35,12,23
"2021","Bromley 002D","E01000692",682,180,88,92,472,71,250,63,143,44,86,50,32,4,65,44,21,0,0,30,8,22
"2021","Bromley 002E","E01000784",592,109,41,68,446,48,245,71,141,33,76,40,30,6,73,44,29,4,4,37,22,15
"2021","Bromley 004A","E01000799",752,213,53,160,474,33,224,67,123,34,98,58,33,7,109,69,40,10,10,65,25,40
"2021","Bromley 004B","E01000802",801,228,53,175,519,34,278,126,114,38,104,61,39,4,91,56,35,12,12,54,17,37
"2021","Bromley 004C","E01000803",745,292,125,167,404,28,200,54,112,34,96,72,22,2,72,37,35,8,8,49,10,39
"2021","Bromley 004D","E01000804",565,117,61,56,409,67,238,65,137,36,54,27,23,4,47,21,26,3,3,39,15,24
"2021","Bromley 004E","E01000805",797,296,108,188,457,30,176,64,97,15,117,83,32,2,124,84,40,10,10,44,11,33
"2021","Bromley 005B","E01000741",929,379,54,325,502,10,159,73,72,14,218,162,56,0,104,70,34,11,11,48,10,38
"2021","Bromley 005C","E01000742",1022,383,55,328,560,14,199,92,86,21,193,155,36,2,139,104,35,15,15,79,24,55
"2021","Bromley 005D","E01000745",900,328,64,264,507,15,208,87,102,19,156,117,38,1,113,85,28,15,15,65,11,54
"2021","Bromley 005E","E01000746",965,332,76,256,585,30,220,88,110,22,200,158,38,4,118,86,32,17,17,48,14,34
"2021","Bromley 005F","E01034383",627,255,32,223,321,4,104,41,51,12,89,73,16,0,117,85,32,7,7,51,9,42
"2021","Bromley 005G","E01034384",620,198,16,182,371,2,120,49,63,8,129,100,27,2,111,97,14,9,9,51,14,37
"2021","Bromley 006A","E01000709",737,361,159,202,347,41,172,67,81,24,82,63,19,0,51,29,22,1,1,29,11,18
"2021","Bromley 006B","E01000710",1159,432,117,315,660,45,304,130,149,25,206,163,40,3,84,56,28,21,21,67,18,49
"2021","Bromley 006C","E01000711",1030,478,161,317,514,46,234,112,104,18,140,114,25,1,83,49,34,11,11,38,10,28
"2021","Bromley 006D","E01000714",1091,423,155,268,603,41,254,101,131,22,165,129,33,3,128,97,31,15,15,65,12,53
"2021","Bromley 006E","E01000718",930,345,83,262,514,38,223,73,127,23,101,61,37,3,142,103,39,10,10,71,25,46
"2021","Bromley 007A","E01000645",544,87,55,32,422,82,265,79,136,50,43,25,18,0,29,17,12,3,3,35,17,18
"2021","Bromley 007B","E01000649",817,197,111,86,576,84,339,90,205,44,76,50,24,2,66,35,31,11,11,44,20,24
"2021","Bromley 007C","E01000694",887,184,101,83,655,96,399,118,232,49,97,56,38,3,59,42,17,4,4,48,19,29
"2021","Bromley 007D","E01000695",620,158,89,69,440,75,261,77,135,49,61,38,20,3,43,24,19,0,0,22,7,15
"2021","Bromley 007E","E01000696",690,215,132,83,448,99,256,79,128,49,45,25,18,2,46,21,25,2,2,27,14,13
"2021","Bromley 007F","E01000697",779,244,93,151,500,56,287,89,152,46,90,68,21,1,64,43,21,3,3,35,14,21
"2021","Bromley 008A","E01000674",800,327,124,203,404,24,203,59,123,21,91,61,30,0,77,52,25,9,9,69,19,50
"2021","Bromley 008B","E01000676",967,353,96,257,531,22,225,86,114,25,170,133,33,4,104,77,27,10,10,83,26,57
"2021","Bromley 008C","E01000820",703,248,96,152,421,45,226,62,129,35,59,38,18,3,84,63,21,7,7,34,13,21
"2021","Bromley 008D","E01000822",710,242,61,181,429,32,213,67,122,24,84,46,37,1,97,71,26,3,3,39,19,20
"2021","Bromley 008E","E01000823",734,220,65,155,470,42,253,82,137,34,92,58,34,0,76,47,29,7,7,44,14,30
"2021","Bromley 008F","E01000824",578,139,36,103,395,22,191,56,104,31,94,62,29,3,81,53,28,7,7,44,15,29
"2021","Bromley 008G","E01000825",814,309,114,195,463,37,190,77,97,16,125,85,35,5,107,79,28,4,4,42,13,29
"2021","Bromley 009A","E01000743",852,329,93,236,457,18,159,58,67,34,102,67,28,7,170,100,70,8,8,66,19,47
"2021","Bromley 009B","E01000744",661,239,68,171,369,4,131,57,51,23,71,30,32,9,152,100,52,11,11,53,21,32
"2021","Bromley 009C","E01000796",619,183,34,149,381,16,117,27,63,27,54,29,20,5,181,104,77,13,13,55,37,18
"2021","Bromley 009D","E01000798",735,330,63,267,359,14,135,44,57,34,65,41,21,3,135,86,49,10,10,46,12,34
"2021","Bromley 009E","E01000800",797,330,54,276,407,12,145,54,74,17,114,84,22,8,124,89,35,12,12,60,25,35
"2021","Bromley 009F","E01000806",777,268,57,211,459,5,145,56,79,10,112,71,34,7,184,142,42,13,13,50,14,36
"2021","Bromley 010A","E01000693",646,256,182,74,363,108,194,59,96,39,32,13,13,6,29,19,10,0,0,27,9,18
"2021","Bromley 010B","E01000698",434,75,57,18,330,86,185,43,94,48,25,9,13,3,32,11,21,2,2,29,13,16
"2021","Bromley 010C","E01000736",628,164,60,104,421,31,202,55,98,49,71,26,35,10,111,72,39,6,6,43,25,18
"2021","Bromley 010D","E01000737",584,171,81,90,379,32,176,55,86,35,61,29,28,4,106,59,47,4,4,34,18,16
"2021","Bromley 011A","E01000672",695,213,83,130,440,62,223,63,129,31,99,60,34,5,51,34,17,5,5,42,19,23
"2021","Bromley 011B","E01000673",636,126,54,72,476,37,282,77,158,47,87,55,29,3,67,45,22,3,3,34,17,17
"2021","Bromley 011C","E01000716",707,242,100,142,436,99,231,60,130,41,70,45,21,4,33,19,14,3,3,29,13,16
"2021","Bromley 011D","E01000717",864,364,140,224,464,54,205,72,112,21,127,94,30,3,72,45,27,6,6,36,12,24
"2021","Bromley 011E","E01000828",771,274,136,138,471,79,229,58,138,33,78,52,23,3,75,41,34,10,10,26,11,15
"2021","Bromley 012A","E01000712",876,328,141,187,500,65,233,97,106,30,125,95,25,5,60,35,25,17,17,48,19,29
"2021","Bromley 012B","E01000713",888,328,112,216,510,54,253,86,146,21,126,95,28,3,70,44,26,7,7,50,20,30
"2021","Bromley 012C","E01000715",927,422,187,235,467,59,238,106,114,18,106,74,31,1,61,31,30,3,3,38,9,29
"2021","Bromley 012D","E01000770",689,237,157,80,422,113,213,65,109,39,57,38,18,1,34,16,18,5,5,30,13,17
"2021","Bromley 012E","E01000772",755,284,181,103,435,114,214,68,102,44,62,41,17,4,43,20,23,2,2,36,16,20
"2021","Bromley 013A","E01000700",667,193,65,128,443,31,211,75,120,16,101,67,28,6,94,54,40,6,6,31,12,19
"2021","Bromley 013B","E01000702",639,195,44,151,401,24,203,72,111,20,109,78,27,4,57,30,27,8,8,43,15,28
"2021","Bromley 013C","E01000703",700,215,68,147,439,35,246,52,156,38,84,45,37,2,67,42,25,7,7,46,18,28
"2021","Bromley 013D","E01000706",610,222,73,149,356,27,191,63,101,27,72,40,25,7,61,39,22,5,5,32,14,18
"2021","Bromley 013E","E01000797",689,214,67,147,444,43,250,75,147,28,93,56,33,4,54,27,27,4,4,31,11,20
"2021","Bromley 014A","E01000729",834,337,82,255,458,18,188,36,114,38,75,22,45,8,173,130,43,4,4,39,18,21
"2021","Bromley 014B","E01000730",669,180,60,120,426,19,161,36,86,39,79,19,47,13,165,111,54,2,2,63,40,23
"2021","Bromley 014C","E01000735",554,127,47,80,381,37,188,43,104,41,50,13,29,8,103,66,37,3,3,46,25,21
"2021","Bromley 014D","E01000738",646,150,82,68,441,60,227,60,114,53,69,25,37,7,79,38,41,6,6,55,25,30
"2021","Bromley 014E","E01000739",637,193,75,118,403,22,163,30,89,44,78,36,36,6,138,106,32,2,2,41,24,17
"2021","Bromley 015A","E01000699",665,236,44,192,387,14,147,41,82,24,112,66,33,13,105,72,33,9,9,42,18,24
"2021","Bromley 015B","E01000701",612,176,46,130,403,18,203,53,116,34,110,57,47,6,69,45,24,3,3,33,14,19
"2021","Bromley 015C","E01000704",600,161,78,83,398,35,208,59,112,37,76,31,40,5,76,38,38,3,3,41,14,27
"2021","Bromley 015D","E01000705",571,159,52,107,353,30,163,58,78,27,68,42,21,5,84,55,29,8,8,59,19,40
"2021","Bromley 015E","E01000801",653,231,80,151,363,29,159,46,90,23,76,39,28,9,91,49,42,8,8,59,33,26
"2021","Bromley 016A","E01000646",779,281,129,152,450,34,228,63,133,32,103,58,37,8,75,48,27,10,10,48,17,31
"2021","Bromley 016B","E01000647",646,137,55,82,476,49,248,54,159,35,89,47,36,6,88,55,33,2,2,33,19,14
"2021","Bromley 016C","E01000648",729,174,61,113,518,65,309,72,172,65,69,37,29,3,74,51,23,1,1,37,15,22
"2021","Bromley 016D","E01000653",596,147,94,53,419,87,257,50,141,66,34,17,12,5,41,20,21,0,0,30,14,16
"2021","Bromley 016E","E01000678",699,159,70,89,484,44,280,60,169,51,91,48,37,6,59,27,32,10,10,56,23,33
"2021","Bromley 018A","E01000670",833,257,87,170,519,63,304,84,160,60,82,56,23,3,63,27,36,7,7,57,24,33
"2021","Bromley 018C","E01000677",805,214,68,146,527,20,282,87,170,25,115,76,35,4,95,62,33,15,15,64,18,46
"2021","Bromley 018D","E01000762",744,235,114,121,470,61,256,70,143,43,74,39,31,4,73,44,29,6,6,39,18,21
"2021","Bromley 018E","E01000829",703,171,71,100,474,48,269,61,163,45,96,60,33,3,54,35,19,7,7,58,29,29
"2021","Bromley 018F","E01034385",577,159,78,81,363,50,210,56,123,31,56,36,17,3,42,22,20,5,5,55,17,38
"2021","Bromley 018G","E01034386",645,262,25,237,336,5,156,60,87,9,115,100,14,1,48,38,10,12,12,47,9,38
"2021","Bromley 019A","E01000719",861,262,96,166,536,43,211,49,124,38,93,48,39,6,182,128,54,7,7,63,31,32
"2021","Bromley 019B","E01000720",682,181,53,128,453,28,203,54,119,30,65,27,35,3,146,95,51,11,11,48,28,20
"2021","Bromley 019C","E01000721",614,191,64,127,379,23,153,32,85,36,64,25,32,7,131,84,47,8,8,44,30,14
"2021","Bromley 019D","E01000724",653,199,74,125,410,19,154,35,87,32,77,22,44,11,157,105,52,3,3,44,29,15
"2021","Bromley 019E","E01000728",699,208,106,102,444,66,181,63,73,45,82,42,34,6,109,71,38,6,6,47,24,23
"2021","Bromley 020A","E01000651",627,177,95,82,415,36,269,74,146,49,53,31,16,6,50,27,23,7,7,35,12,23
"2021","Bromley 020B","E01000668",973,335,140,195,594,41,316,67,210,39,134,86,40,8,95,51,44,8,8,44,17,27
"2021","Bromley 020C","E01000669",748,219,82,137,492,34,243,69,153,21,118,68,44,6,94,48,46,3,3,37,17,20
"2021","Bromley 020D","E01000671",1017,365,139,226,583,45,290,64,188,38,130,82,41,7,106,64,42,12,12,69,22,47
"2021","Bromley 020E","E01000679",674,149,52,97,484,29,285,69,173,43,85,39,39,7,80,46,34,5,5,41,15,26
"2021","Bromley 021A","E01000826",560,79,53,26,452,88,315,66,169,80,24,8,13,3,24,13,11,1,1,29,16,13
"2021","Bromley 021B","E01000827",782,255,139,116,490,81,242,63,139,40,85,52,26,7,80,50,30,2,2,37,21,16
"2021","Bromley 021C","E01000830",556,79,60,19,435,87,294,64,164,66,21,3,17,1,32,21,11,1,1,42,25,17
"2021","Bromley 021D","E01000831",774,296,163,133,455,78,263,75,146,42,60,28,28,4,48,24,24,6,6,23,11,12
"2021","Bromley 021E","E01000833",497,72,53,19,396,61,274,61,145,68,29,8,17,4,32,11,21,0,0,29,14,15
"2021","Bromley 022A","E01000650",749,217,131,86,500,101,285,75,156,54,49,26,19,4,60,36,24,5,5,32,15,17
"2021","Bromley 022B","E01000652",672,148,95,53,484,86,281,71,145,65,54,31,20,3,62,32,30,1,1,40,20,20
"2021","Bromley 022C","E01000807",640,124,60,64,477,69,276,69,167,40,57,26,25,6,69,42,27,6,6,39,16,23
"2021","Bromley 022D","E01000809",640,183,124,59,435,83,250,66,138,46,54,30,19,5,44,24,20,4,4,22,8,14
"2021","Bromley 023A","E01000722",757,211,89,122,487,48,231,70,118,43,93,51,38,4,111,63,48,4,4,59,23,36
"2021","Bromley 023B","E01000725",791,299,100,199,469,36,194,55,97,42,100,52,40,8,134,74,60,5,5,23,8,15
"2021","Bromley 023C","E01000731",513,122,57,65,338,33,171,37,97,37,52,21,22,9,81,52,29,1,1,53,33,20
"2021","Bromley 023D","E01000732",584,129,73,56,415,57,239,72,113,54,69,32,31,6,49,21,28,1,1,40,25,15
"2021","Bromley 023E","E01000733",634,135,69,66,446,57,221,55,119,47,80,36,39,5,81,47,34,7,7,53,25,28
"2021","Bromley 024A","E01000769",451,73,51,22,346,37,215,48,106,61,37,8,21,8,54,22,32,3,3,32,19,13
"2021","Bromley 024B","E01000773",608,165,129,36,412,65,251,42,153,56,48,19,26,3,45,17,28,3,3,31,18,13
"2021","Bromley 024C","E01000775",856,172,98,74,629,85,367,90,189,88,76,22,41,13,99,61,38,2,2,55,24,31
"2021","Bromley 024D","E01000777",558,81,53,28,422,58,257,50,144,63,41,14,26,1,65,43,22,1,1,55,27,28
"2021","Bromley 024E","E01000778",638,163,64,99,437,41,247,59,124,64,50,18,24,8,95,50,45,4,4,38,15,23
"2021","Bromley 025A","E01000808",619,141,91,50,453,80,272,70,157,45,52,25,22,5,42,20,22,7,7,25,9,16
"2021","Bromley 025B","E01000810",592,110,76,34,460,109,282,67,170,45,34,14,16,4,34,20,14,1,1,22,7,15
"2021","Bromley 025C","E01000811",566,152,80,72,387,49,225,56,145,24,64,40,22,2,48,29,19,1,1,27,12,15
"2021","Bromley 025D","E01000813",622,153,100,53,437,87,256,58,144,54,52,18,30,4,42,17,25,0,0,32,16,16
"2021","Bromley 025E","E01000815",560,82,57,25,456,117,296,74,157,65,32,20,9,3,10,4,6,1,1,22,12,10
"2021","Bromley 026A","E01000661",1181,384,159,225,714,30,275,71,164,40,127,62,56,9,268,189,79,14,14,83,43,40
"2021","Bromley 026B","E01000662",652,141,75,66,462,35,262,57,146,59,71,33,28,10,89,41,48,5,5,49,36,13
"2021","Bromley 026C","E01000663",665,182,121,61,451,48,233,58,139,36,65,24,32,9,98,65,33,7,7,32,21,11
"2021","Bromley 026D","E01000664",600,118,68,50,436,47,239,44,142,53,45,15,22,8,101,50,51,4,4,46,23,23
"2021","Bromley 027A","E01000763",528,86,64,22,401,70,239,42,146,51,48,16,26,6,42,15,27,2,2,41,15,26
"2021","Bromley 027B","E01000764",660,145,82,63,462,64,265,40,169,56,52,19,26,7,79,37,42,2,2,53,25,28
"2021","Bromley 027C","E01000766",647,110,84,26,503,102,325,59,201,65,41,8,26,7,33,17,16,2,2,34,16,18
"2021","Bromley 027D","E01000767",606,115,84,31,470,80,300,61,164,75,44,15,26,3,40,21,19,6,6,21,10,11
"2021","Bromley 027E","E01000834",462,63,41,22,369,56,247,37,145,65,31,6,17,8,35,18,17,0,0,30,19,11
"2021","Bromley 028A","E01000727",764,265,157,108,458,69,228,68,120,40,74,44,26,4,80,44,36,7,7,41,15,26
"2021","Bromley 028B","E01000734",508,107,51,56,370,37,207,42,124,41,57,26,28,3,67,47,20,2,2,31,19,12
"2021","Bromley 028C","E01000790",1048,356,118,238,616,59,320,111,152,57,131,92,32,7,99,65,34,7,7,76,16,60
"2021","Bromley 028D","E01000812",674,180,81,99,451,78,244,65,128,51,64,42,21,1,60,28,32,5,5,43,16,27
"2021","Bromley 028E","E01000814",580,88,64,24,466,106,310,86,162,62,26,14,11,1,22,5,17,2,2,26,13,13
"2021","Bromley 029A","E01000723",551,167,123,44,354,86,173,60,64,49,45,22,18,5,45,22,23,5,5,30,14,16
"2021","Bromley 029B","E01000726",581,195,95,100,351,54,173,52,85,36,56,28,21,7,65,25,40,3,3,35,9,26
"2021","Bromley 029C","E01000787",671,235,113,122,406,73,183,64,79,40,62,38,23,1,83,41,42,5,5,30,16,14
"2021","Bromley 029D","E01000788",612,140,70,70,418,55,217,59,109,49,67,27,32,8,74,37,37,5,5,54,28,26
"2021","Bromley 029E","E01000791",622,161,117,44,425,92,233,72,111,50,49,29,14,6,49,17,32,2,2,36,20,16
"2021","Bromley 030A","E01000832",585,133,97,36,414,80,267,63,145,59,33,16,14,3,32,15,17,2,2,38,19,19
"2021","Bromley 030B","E01000835",698,191,100,91,451,57,244,55,138,51,44,22,18,4,97,61,36,9,9,56,25,31
"2021","Bromley 030C","E01000836",494,77,44,33,396,51,257,49,143,65,45,11,32,2,42,16,26,1,1,21,7,14
"2021","Bromley 030D","E01000837",651,210,124,86,411,53,235,70,131,34,49,21,21,7,73,41,32,1,1,30,18,12
"2021","Bromley 030E","E01000838",539,119,80,39,385,71,212,58,103,51,46,22,18,6,56,30,26,0,0,35,16,19
"2021","Bromley 030F","E01000839",538,112,72,40,395,89,247,66,109,72,22,11,9,2,34,14,20,3,3,31,13,18
"2021","Bromley 030G","E01000840",685,215,183,32,446,143,229,80,92,57,33,15,14,4,39,14,25,2,2,24,5,19
"2021","Bromley 030H","E01000841",663,134,99,35,491,86,286,71,147,68,60,35,22,3,54,26,28,5,5,38,13,25
"2021","Bromley 031A","E01000753",754,171,127,44,545,121,300,71,158,71,58,27,28,3,65,33,32,1,1,38,16,22
"2021","Bromley 031B","E01000754",736,215,121,94,486,69,272,73,156,43,71,34,30,7,70,44,26,4,4,35,16,19
"2021","Bromley 031C","E01000755",636,142,102,40,473,88,290,59,158,73,34,17,15,2,60,33,27,1,1,21,12,9
"2021","Bromley 031D","E01000757",603,95,69,26,489,133,292,70,150,72,25,12,13,0,39,16,23,0,0,19,4,15
"2021","Bromley 031E","E01000758",552,108,75,33,421,74,260,57,152,51,43,19,21,3,44,17,27,0,0,23,6,17
"2021","Bromley 032A","E01000786",635,167,125,42,440,130,217,73,98,46,40,27,9,4,52,19,33,1,1,28,13,15
"2021","Bromley 032B","E01000789",661,172,50,122,442,14,155,25,100,30,86,25,49,12,186,142,44,1,1,47,30,17
"2021","Bromley 032C","E01000792",573,119,61,58,416,66,214,50,132,32,51,23,23,5,75,40,35,10,10,38,19,19
"2021","Bromley 032D","E01000793",627,132,102,30,463,102,295,91,148,56,30,19,10,1,35,14,21,1,1,32,15,17
"2021","Bromley 032E","E01000795",536,125,71,54,391,68,224,60,125,39,36,11,21,4,59,26,33,4,4,20,13,7
"2021","Bromley 033A","E01000665",741,195,106,89,498,60,242,57,136,49,90,46,35,9,100,63,37,6,6,48,22,26
"2021","Bromley 033B","E01000666",800,210,137,73,554,144,278,88,115,75,67,37,25,5,63,28,35,2,2,36,14,22
"2021","Bromley 033C","E01000667",628,109,77,32,479,109,269,80,131,58,54,20,28,6,45,16,29,2,2,40,13,27
"2021","Bromley 033D","E01000756",649,146,106,40,458,97,262,57,137,68,38,7,26,5,57,30,27,4,4,45,18,27
"2021","Bromley 034A","E01000759",576,81,46,35,462,73,276,63,149,64,59,21,26,12,50,20,30,4,4,33,14,19
"2021","Bromley 034B","E01000760",585,128,88,40,412,71,237,48,130,59,49,27,18,4,55,34,21,0,0,45,19,26
"2021","Bromley 034C","E01000761",568,105,73,32,439,86,265,63,139,63,48,14,31,3,39,18,21,1,1,24,17,7
"2021","Bromley 034D","E01000765",700,178,95,83,479,76,269,58,144,67,59,21,35,3,69,40,29,6,6,43,17,26
"2021","Bromley 034E","E01000768",607,165,110,55,419,73,244,67,119,58,53,15,35,3,45,29,16,4,4,23,6,17
"2021","Bromley 035A","E01000681",648,118,69,49,506,70,330,80,193,57,56,28,22,6,50,23,27,0,0,24,11,13
"2021","Bromley 035B","E01000682",639,164,124,40,448,81,277,59,164,54,37,18,12,7,53,26,27,0,0,27,15,12
"2021","Bromley 035C","E01000683",706,216,97,119,460,42,239,51,151,37,83,54,26,3,92,52,40,4,4,30,12,18
"2021","Bromley 035D","E01000684",746,122,68,54,584,100,377,65,247,65,56,30,26,0,47,23,24,4,4,40,19,21
"2021","Bromley 035E","E01000794",605,121,92,29,448,109,263,70,134,59,32,18,13,1,42,16,26,2,2,36,19,17
"2021","Bromley 036A","E01000749",637,148,101,47,457,102,253,72,120,61,46,18,24,4,54,26,28,2,2,32,14,18
"2021","Bromley 036B","E01000750",651,242,145,97,376,49,144,42,66,36,48,22,13,13,128,80,48,7,7,33,17,16
"2021","Bromley 036C","E01000751",888,255,161,94,588,81,343,62,220,61,77,31,42,4,82,48,34,5,5,45,20,25
"2021","Bromley 036D","E01000752",788,287,179,108,461,105,231,58,126,47,55,25,24,6,65,38,27,5,5,40,18,22
"2021","Bromley 037A","E01000680",647,134,68,66,470,116,259,83,113,63,50,33,12,5,44,19,25,1,1,43,21,22
"2021","Bromley 037B","E01000685",612,138,74,64,426,37,254,58,156,40,60,22,29,9,72,42,30,3,3,48,22,26
"2021","Bromley 037C","E01000686",639,207,137,70,406,84,237,66,132,39,33,14,18,1,52,27,25,0,0,26,10,16
"2021","Bromley 037D","E01000687",662,166,109,57,462,91,253,80,123,50,52,29,18,5,62,37,25,4,4,34,11,23
"2021","Bromley 037E","E01000688",507,88,60,28,379,70,244,73,132,39,37,19,15,3,27,10,17,1,1,40,24,16
"2021","Bromley 039A","E01000654",487,88,48,40,359,58,186,60,99,27,59,25,28,6,55,29,26,1,1,40,21,19
"2021","Bromley 039B","E01000655",493,85,48,37,372,54,190,59,96,35,65,24,38,3,62,31,31,1,1,36,13,23
"2021","Bromley 039C","E01000656",566,110,59,51,416,78,229,66,104,59,68,24,38,6,39,16,23,2,2,40,19,21
"2021","Bromley 039D","E01000657",678,196,89,107,450,56,212,72,91,49,89,41,40,8,86,54,32,7,7,32,12,20
"2021","Bromley 039E","E01000659",522,90,48,42,392,50,220,58,110,52,57,19,32,6,64,26,38,1,1,40,18,22
"2021","Bromley 040A","E01000816",614,151,76,75,426,66,247,72,132,43,38,17,13,8,74,31,43,1,1,37,10,27
"2021","Bromley 040B","E01000818",641,130,65,65,464,83,269,85,125,59,54,24,22,8,55,16,39,3,3,47,22,25
"2021","Bromley 040C","E01000819",756,234,92,142,462,40,204,52,114,38,77,38,35,4,132,82,50,9,9,60,21,39
"2021","Bromley 040D","E01032562",619,171,56,115,397,19,148,25,86,37,52,13,31,8,165,109,56,13,13,51,24,27
"2021","Bromley 040E","E01032563",563,144,85,59,365,83,198,50,99,49,42,24,15,3,41,17,24,1,1,54,31,23
"2021","Bromley 041A","E01000707",530,86,36,50,420,31,287,54,203,30,58,21,31,6,42,24,18,2,2,24,9,15
"2021","Bromley 041B","E01000708",711,221,101,120,450,48,252,70,152,30,77,46,31,0,66,45,21,7,7,40,17,23
"2021","Bromley 041C","E01000771",620,128,73,55,450,79,277,58,165,54,42,16,26,0,50,22,28,2,2,42,18,24
"2021","Bromley 041D","E01000774",581,136,65,71,416,50,240,44,143,53,65,31,28,6,57,40,17,4,4,29,15,14
"2021","Bromley 041E","E01032568",641,204,83,121,384,23,180,55,93,32,66,39,22,5,103,57,46,12,12,53,27,26
"2021","Bromley 042A","E01000658",561,139,115,24,382,126,185,65,62,58,32,17,14,1,38,24,14,1,1,40,16,24
"2021","Bromley 042B","E01000747",793,190,99,91,549,82,279,96,135,48,98,55,39,4,88,53,35,2,2,54,36,18
"2021","Bromley 042C","E01000748",706,160,114,46,496,145,233,79,70,84,64,32,24,8,52,28,24,2,2,50,26,24
"2021","Bromley 042D","E01032570",730,205,137,68,487,120,202,60,96,46,72,31,37,4,90,60,30,3,3,38,14,24
"2021","Camden 001A","E01000907",615,194,74,120,353,17,129,33,76,20,67,37,26,4,133,80,53,7,7,68,23,45
"2021","Camden 001B","E01000908",771,383,105,278,339,26,129,45,65,19,78,56,18,4,101,61,40,5,5,49,22,27
"2021","Camden 001C","E01000909",642,171,87,84,397,71,203,58,105,40,59,33,23,3,59,29,30,5,5,74,8,66
"2021","Camden 001D","E01000912",683,250,104,146,341,19,122,39,55,28,59,39,15,5,134,67,67,7,7,92,27,65
"2021","Camden 001E","E01000913",684,199,104,95,431,97,226,76,114,36,67,48,19,0,37,17,20,4,4,54,17,37
"2021","Camden 002A","E01000893",655,252,98,154,355,45,203,86,100,17,68,55,10,3,33,21,12,6,6,48,11,37
"2021","Camden 002B","E01000894",568,177,65,112,361,56,201,71,113,17,67,55,9,3,33,23,10,4,4,30,7,23
"2021","Camden 002C","E01000895",781,368,142,226,369,38,186,60,110,16,86,70,15,1,54,29,25,5,5,44,8,36
"2021","Camden 002D","E01000896",663,228,86,142,380,52,218,70,126,22,73,58,13,2,34,25,9,3,3,55,9,46
"2021","Camden 002E","E01000899",705,248,95,153,413,66,239,92,125,22,62,42,17,3,41,25,16,5,5,44,17,27
"2021","Camden 003A","E01000910",557,164,73,91,325,46,189,45,109,35,55,39,14,2,32,13,19,3,3,68,12,56
"2021","Camden 003B","E01000911",632,231,86,145,337,31,164,41,95,28,54,39,13,2,82,48,34,6,6,64,20,44
"2021","Camden 003C","E01000921",920,381,59,322,410,10,152,58,78,16,159,129,28,2,79,50,29,10,10,129,16,113
"2021","Camden 003D","E01000923",628,213,58,155,354,19,152,53,74,25,99,69,23,7,73,38,35,11,11,61,9,52
"2021","Camden 003E","E01000928",754,264,64,200,396,26,159,51,81,27,104,76,22,6,95,58,37,12,12,94,21,73
"2021","Camden 004A","E01000878",764,250,79,171,464,65,223,72,130,21,74,58,15,1,95,63,32,7,7,50,16,34
"2021","Camden 004B","E01000879",573,191,69,122,348,26,199,60,120,19,88,66,19,3,29,13,16,6,6,34,8,26
"2021","Camden 004C","E01000880",580,146,47,99,391,38,247,77,145,25,55,35,19,1,44,23,21,7,7,43,13,30
"2021","Camden 004D","E01000884",582,158,47,111,374,46,233,56,150,27,45,31,11,3,47,30,17,3,3,50,22,28
"2021","Camden 004E","E01000885",528,135,67,68,343,73,191,51,113,27,37,25,11,1,40,24,16,2,2,50,15,35
"2021","Camden 005A","E01000871",649,193,70,123,368,45,203,54,119,30,56,42,12,2,63,35,28,1,1,88,30,58
"2021","Camden 005B","E01000872",855,362,63,299,387,20,156,62,73,21,108,91,16,1,82,48,34,21,21,106,20,86
"2021","Camden 005C","E01000873",668,165,54,111,413,28,213,61,125,27,95,84,10,1,68,38,30,9,9,90,12,78
"2021","Camden 005D","E01000874",630,191,62,129,375,41,219,55,140,24,68,57,11,0,39,15,24,8,8,64,14,50
"2021","Camden 005E","E01000877",663,248,60,188,332,23,191,64,115,12,77,71,6,0,32,20,12,9,9,83,17,66
"2021","Camden 006A","E01000886",595,196,63,133,344,38,157,56,73,28,84,57,24,3,62,25,37,3,3,55,13,42
"2021","Camden 006B","E01000887",655,250,63,187,322,19,130,42,71,17,98,83,14,1,63,34,29,12,12,83,14,69
"2021","Camden 006C","E01000888",638,223,68,155,355,25,183,56,106,21,70,48,15,7,64,42,22,13,13,60,12,48
"2021","Camden 006D","E01000892",815,302,104,198,432,29,190,76,103,11,91,71,15,5,108,55,53,14,14,81,26,55
"2021","Camden 006E","E01000903",623,238,106,132,307,24,155,54,81,20,73,51,16,6,49,31,18,6,6,78,18,60
"2021","Camden 007A","E01000889",709,227,79,148,402,10,152,35,72,45,62,33,20,9,172,105,67,6,6,80,27,53
"2021","Camden 007B","E01000890",603,283,99,184,267,14,109,21,77,11,42,24,13,5,95,57,38,7,7,53,21,32
"2021","Camden 007C","E01000891",617,260,57,203,285,10,103,25,63,15,60,42,17,1,101,59,42,11,11,72,21,51
"2021","Camden 007D","E01000901",734,210,34,176,436,7,173,19,127,27,57,36,19,2,186,113,73,13,13,88,33,55
"2021","Camden 007E","E01000922",691,252,57,195,347,12,149,46,92,11,90,74,16,0,83,46,37,13,13,92,13,79
"2021","Camden 007F","E01000927",689,224,75,149,356,32,142,47,74,21,103,69,29,5,72,31,41,7,7,109,19,90
"2021","Camden 008A","E01000881",604,242,50,192,306,19,161,37,113,11,80,69,8,3,38,24,14,8,8,56,17,39
"2021","Camden 008B","E01000882",665,230,63,167,388,41,232,93,127,12,70,54,16,0,40,28,12,5,5,47,10,37
"2021","Camden 008C","E01000883",756,338,59,279,334,23,189,62,116,11,74,60,13,1,30,17,13,18,18,84,11,73
"2021","Camden 008D","E01000897",653,197,89,108,419,48,244,58,169,17,84,63,21,0,38,27,11,5,5,37,8,29
"2021","Camden 008E","E01000898",826,419,96,323,339,27,160,63,83,14,79,69,8,2,62,33,29,11,11,68,18,50
"2021","Camden 009A","E01000866",925,361,98,263,459,27,191,70,90,31,78,61,14,3,149,88,61,14,14,105,19,86
"2021","Camden 009B","E01000870",726,272,57,215,380,22,148,58,66,24,109,76,29,4,96,49,47,5,5,74,21,53
"2021","Camden 009C","E01000924",727,258,52,206,374,27,125,49,66,10,139,121,17,1,72,42,30,11,11,95,16,79
"2021","Camden 009D","E01000925",566,184,80,104,314,19,120,20,78,22,48,26,17,5,118,70,48,9,9,68,14,54
"2021","Camden 009E","E01000926",608,196,40,156,307,12,95,31,46,18,91,69,22,0,97,69,28,12,12,105,16,89
"2021","Camden 010A","E01000969",891,326,69,257,427,29,223,95,113,15,123,107,16,0,35,20,15,17,17,138,7,131
"2021","Camden 010B","E01000970",759,326,61,265,347,11,154,78,70,6,137,128,9,0,36,23,13,9,9,86,4,82
"2021","Camden 010C","E01000971",576,189,53,136,327,24,191,54,119,18,71,60,11,0,37,22,15,4,4,60,13,47
"2021","Camden 010D","E01000972",956,467,116,351,388,17,145,38,80,27,72,49,21,2,136,71,65,18,18,101,13,88
"2021","Camden 010E","E01000973",1120,398,49,349,576,10,217,89,100,28,188,163,22,3,137,79,58,24,24,146,30,116
"2021","Camden 011A","E01000842",703,312,97,215,347,28,195,76,105,14,75,64,10,1,43,24,19,6,6,44,11,33
"2021","Camden 011B","E01000844",817,361,72,289,409,22,239,87,144,8,87,75,12,0,52,35,17,9,9,47,10,37
"2021","Camden 011C","E01000848",740,303,78,225,398,31,214,81,116,17,104,87,17,0,39,21,18,10,10,39,11,28
"2021","Camden 011D","E01000849",737,369,90,279,318,15,147,70,71,6,92,69,22,1,47,22,25,17,17,50,10,40
"2021","Camden 012A","E01000900",716,234,73,161,374,25,148,50,78,20,79,63,14,2,112,58,54,10,10,108,27,81
"2021","Camden 012B","E01000902",545,183,65,118,287,8,105,25,60,20,57,34,19,4,111,60,51,6,6,75,23,52
"2021","Camden 012C","E01000904",897,310,101,209,452,28,150,45,82,23,102,84,15,3,142,64,78,30,30,135,31,104
"2021","Camden 012D","E01000905",763,289,109,180,367,11,130,24,74,32,46,32,11,3,164,105,59,16,16,107,37,70
"2021","Camden 012E","E01000906",735,314,71,243,347,21,153,66,76,11,113,103,10,0,49,29,20,11,11,74,10,64
"2021","Camden 013A","E01000875",772,308,63,245,349,14,142,58,71,13,93,81,10,2,83,46,37,17,17,115,13,102
"2021","Camden 013B","E01000876",828,287,70,217,420,22,164,43,94,27,113,92,18,3,105,61,44,16,16,121,20,101
"2021","Camden 013C","E01000931",926,341,90,251,477,11,179,52,108,19,109,87,18,4,157,105,52,21,21,108,29,79
"2021","Camden 013D","E01000932",880,356,80,276,408,13,163,74,72,17,156,139,17,0,60,32,28,16,16,116,18,98
"2021","Camden 013E","E01000974",764,318,67,251,340,9,133,52,59,22,101,86,12,3,79,52,27,18,18,106,21,85
"2021","Camden 014A","E01000843",650,314,109,205,290,16,157,66,77,14,76,65,10,1,33,19,14,8,8,46,5,41
"2021","Camden 014B","E01000845",697,269,73,196,367,25,194,76,99,19,90,73,15,2,51,31,20,7,7,61,18,43
"2021","Camden 014C","E01000846",584,203,94,109,324,22,152,33,93,26,40,24,13,3,109,62,47,1,1,57,27,30
"2021","Camden 014D","E01000847",619,186,77,109,367,24,197,35,129,33,38,26,7,5,94,50,44,14,14,66,19,47
"2021","Camden 015C","E01000867",769,287,70,217,324,11,120,47,57,16,90,72,11,7,87,50,37,16,16,158,25,133
"2021","Camden 015D","E01000868",744,283,46,237,389,8,141,41,74,26,87,61,24,2,136,90,46,17,17,72,23,49
"2021","Camden 015E","E01000869",879,317,87,230,400,29,159,57,81,21,106,82,18,6,85,47,38,21,21,162,11,151
"2021","Camden 015F","E01035707",1128,401,106,295,552,33,232,85,109,38,173,146,20,7,94,52,42,20,20,175,15,160
"2021","Camden 016A","E01000962",759,267,64,203,398,17,211,93,108,10,125,110,13,2,28,17,11,17,17,94,5,89
"2021","Camden 016B","E01000964",753,260,79,181,397,24,194,54,119,21,81,63,16,2,79,44,35,19,19,96,20,76
"2021","Camden 016C","E01000965",816,310,61,249,423,10,192,71,110,11,122,98,21,3,83,47,36,16,16,83,10,73
"2021","Camden 016D","E01000966",698,191,52,139,437,29,255,86,147,22,111,95,15,1,35,21,14,7,7,70,8,62
"2021","Camden 016E","E01000968",725,268,76,192,368,21,160,60,87,13,114,105,9,0,58,25,33,15,15,89,8,81
"2021","Camden 017A","E01000960",891,365,76,289,427,33,207,73,122,12,98,83,14,1,78,53,25,11,11,99,14,85
"2021","Camden 017B","E01000961",724,219,64,155,410,24,194,47,115,32,55,39,13,3,121,64,57,16,16,95,25,70
"2021","Camden 017C","E01000963",828,312,89,223,439,23,269,59,186,24,44,30,10,4,88,56,32,15,15,77,12,65
"2021","Camden 017D","E01000967",638,204,75,129,370,41,218,55,140,23,53,37,16,0,47,33,14,11,11,64,15,49
"2021","Camden 018A","E01000857",637,247,93,154,334,18,177,64,85,28,68,57,11,0,63,30,33,8,8,56,17,39
"2021","Camden 018B","E01000858",800,255,49,206,432,20,171,68,69,34,82,64,17,1,145,71,74,14,14,113,29,84
"2021","Camden 018C","E01000859",699,284,80,204,353,40,188,52,109,27,84,73,8,3,38,22,16,3,3,62,15,47
"2021","Camden 018D","E01000860",672,426,229,197,222,28,95,41,43,11,43,32,9,2,53,25,28,3,3,24,8,16
"2021","Camden 018E","E01000862",806,323,99,224,421,36,222,73,126,23,101,84,16,1,55,37,18,7,7,62,11,51
"2021","Camden 019A","E01000856",642,223,41,182,313,12,134,44,60,30,54,46,5,3,99,51,48,14,14,106,24,82
"2021","Camden 019B","E01000861",696,307,48,259,273,12,89,41,35,13,66,61,4,1,80,35,45,26,26,116,14,102
"2021","Camden 019C","E01000957",653,245,60,185,317,15,121,52,54,15,90,76,12,2,70,46,24,21,21,91,9,82
"2021","Camden 019D","E01000958",953,316,41,275,473,9,186,58,95,33,84,67,15,2,170,102,68,24,24,164,24,140
"2021","Camden 019E","E01000959",687,233,62,171,306,8,123,25,64,34,34,22,8,4,125,60,65,16,16,148,20,128
"2021","Camden 020A","E01000929",725,236,71,165,407,22,191,44,115,32,47,27,15,5,134,81,53,13,13,82,25,57
"2021","Camden 020B","E01000930",1102,603,235,368,406,21,156,47,96,13,75,54,17,4,135,87,48,19,19,93,23,70
"2021","Camden 020C","E01000933",810,307,90,217,364,24,148,54,79,15,90,74,14,2,77,51,26,25,25,139,22,117
"2021","Camden 020D","E01000934",720,355,119,236,303,13,126,34,71,21,52,33,15,4,103,58,45,9,9,62,23,39
"2021","Camden 020E","E01000935",703,248,56,192,399,14,142,43,82,17,71,48,18,5,163,102,61,9,9,56,23,33
"2021","Camden 021A","E01000863",691,297,36,261,276,12,121,62,46,13,72,65,7,0,54,29,25,17,17,118,9,109
"2021","Camden 021B","E01000946",684,272,65,207,321,22,151,56,71,24,50,38,11,1,83,45,38,15,15,91,26,65
"2021","Camden 021C","E01000947",819,330,38,292,337,8,113,57,36,20,105,95,10,0,73,39,34,38,38,152,21,131
"2021","Camden 021D","E01000948",746,312,93,219,347,27,142,49,70,23,85,70,11,4,79,43,36,14,14,87,13,74
"2021","Camden 022A","E01000952",656,205,59,146,324,7,127,24,75,28,48,33,8,7,124,63,61,18,18,127,28,99
"2021","Camden 022C","E01000954",648,172,47,125,400,13,148,20,103,25,39,20,16,3,193,109,84,7,7,76,21,55
"2021","Camden 022D","E01000955",537,203,70,133,279,15,124,25,77,22,33,21,6,6,97,51,46,10,10,55,17,38
"2021","Camden 022E","E01000956",602,221,29,192,267,4,94,22,61,11,43,34,7,2,107,62,45,19,19,114,26,88
"2021","Camden 022F","E01035708",735,326,31,295,361,15,142,55,73,14,100,85,14,1,91,73,18,13,13,48,9,39
"2021","Camden 022G","E01035709",640,246,97,149,295,10,120,32,64,24,37,23,12,2,107,61,46,21,21,99,28,71
"2021","Camden 023A","E01000944",568,203,59,144,242,10,101,20,58,23,30,21,7,2,89,39,50,12,12,123,37,86
"2021","Camden 023C","E01000949",691,259,65,194,371,10,154,46,86,22,78,59,15,4,116,64,52,13,13,61,19,42
"2021","Camden 023E","E01000951",562,175,54,121,280,8,127,14,89,24,28,14,12,2,106,60,46,11,11,107,34,73
"2021","Camden 023F","E01035710",896,301,68,233,429,12,163,20,100,43,75,48,21,6,157,85,72,22,22,166,42,124
"2021","Camden 026A","E01000850",573,276,41,235,215,12,91,47,29,15,72,66,5,1,19,9,10,21,21,82,7,75
"2021","Camden 026B","E01000851",633,325,35,290,213,7,81,45,26,10,78,71,5,2,35,18,17,12,12,95,9,86
"2021","Camden 026E","E01035711",903,467,104,363,299,37,113,55,38,20,60,54,6,0,71,37,34,18,18,137,27,110
"2021","Camden 027A","E01000915",590,177,57,120,319,20,121,18,77,26,55,41,13,1,104,57,47,19,19,94,27,67
"2021","Camden 027B","E01000916",934,402,71,331,404,17,147,74,51,22,128,104,19,5,89,46,43,23,23,128,14,114
"2021","Camden 027C","E01000917",750,356,81,275,326,5,137,42,73,22,52,41,9,2,118,68,50,14,14,68,24,44
"2021","Camden 027D","E01000920",820,372,107,265,337,20,155,65,62,28,79,68,9,2,59,22,37,24,24,111,20,91
"2021","Camden 028A","E01000855",806,491,91,400,231,16,91,53,32,6,58,56,2,0,44,14,30,22,22,84,8,76
"2021","Camden 028B","E01000914",764,362,82,280,299,26,100,55,36,9,80,68,8,4,65,28,37,28,28,103,7,96
"2021","Camden 028C","E01000918",817,429,82,347,291,21,116,59,37,20,70,61,4,5,70,36,34,14,14,97,19,78
"2021","Camden 028D","E01000919",717,349,75,274,283,8,101,56,29,16,71,62,7,2,83,39,44,20,20,85,13,72
"2021","Camden 029H","E01000853",722,363,164,199,281,24,86,25,48,13,52,37,12,3,100,43,57,19,19,78,13,65
"2021","Camden 029G","E01000937",419,231,45,186,136,8,56,18,24,14,33,26,7,0,27,12,15,12,12,52,4,48
"2021","Camden 029A","E01000938",627,244,23,221,261,6,92,30,45,17,65,56,8,1,77,44,33,21,21,122,19,103
"2021","Camden 029B","E01000939",487,171,43,128,213,3,94,18,57,19,33,18,11,4,66,38,28,17,17,103,31,72
"2021","Camden 029D","E01000941",532,233,48,185,242,14,95,18,50,27,41,29,10,2,82,42,40,10,10,57,21,36
"2021","Camden 029C","E01000942",510,265,60,205,174,11,69,44,20,5,44,38,4,2,31,18,13,19,19,71,0,71
"2021","Camden 029F","E01000943",434,220,44,176,151,10,42,27,11,4,52,48,3,1,35,16,19,12,12,63,8,55
"2021","Camden 029E","E01035712",740,304,107,197,310,24,118,28,45,45,43,37,5,1,104,51,53,21,21,126,32,94
"2021","Croydon 001A","E01001137",974,364,119,245,555,34,235,85,133,17,166,122,39,5,107,81,26,13,13,55,19,36
"2021","Croydon 001B","E01001138",718,267,74,193,406,27,155,58,83,14,115,76,37,2,104,74,30,5,5,45,16,29
"2021","Croydon 001C","E01001156",721,250,67,183,408,25,176,42,104,30,95,51,37,7,102,61,41,10,10,63,31,32
"2021","Croydon 001D","E01001162",801,262,58,204,486,29,180,53,102,25,84,57,25,2,182,108,74,11,11,53,21,32
"2021","Croydon 001E","E01001164",990,382,102,280,515,14,179,78,84,17,202,155,45,2,107,75,32,13,13,93,11,82
"2021","Croydon 002A","E01001084",665,130,67,63,440,75,252,56,134,62,41,24,13,4,61,30,31,11,11,95,41,54
"2021","Croydon 002B","E01001157",624,127,49,78,409,49,197,35,105,57,64,19,34,11,93,55,38,6,6,88,48,40
"2021","Croydon 002C","E01001159",742,207,70,137,452,52,225,46,127,52,64,32,28,4,104,68,36,7,7,83,41,42
"2021","Croydon 002D","E01001160",626,118,55,63,385,68,192,40,91,61,33,9,17,7,81,33,48,11,11,123,76,47
"2021","Croydon 002E","E01001163",837,243,77,166,522,48,235,71,130,34,96,55,37,4,134,71,63,9,9,72,21,51
"2021","Croydon 003A","E01001083",546,110,69,41,349,66,199,48,84,67,24,7,15,2,50,27,23,10,10,87,44,43
"2021","Croydon 003B","E01001086",590,130,63,67,341,35,179,33,84,62,50,23,19,8,67,25,42,10,10,119,57,62
"2021","Croydon 003C","E01001087",1124,366,128,238,601,32,223,69,115,39,99,54,40,5,217,158,59,30,30,157,79,78
"2021","Croydon 003D","E01001161",549,101,36,65,339,24,128,23,62,43,38,16,14,8,138,64,74,11,11,109,54,55
"2021","Croydon 004A","E01001085",649,196,75,121,366,32,185,33,98,54,52,30,20,2,82,43,39,15,15,87,44,43
"2021","Croydon 004B","E01001088",574,103,45,58,383,31,168,28,86,54,56,28,17,11,119,56,63,9,9,88,50,38
"2021","Croydon 004C","E01001089",646,165,53,112,389,20,163,29,91,43,60,31,26,3,131,74,57,15,15,92,41,51
"2021","Croydon 004D","E01001090",886,255,83,172,524,25,217,55,115,47,84,38,40,6,172,110,62,26,26,107,53,54
"2021","Croydon 004E","E01001091",565,123,58,65,372,49,195,55,79,61,29,16,9,4,87,44,43,12,12,70,33,37
"2021","Croydon 005A","E01001147",671,201,33,168,386,10,158,33,90,35,50,21,23,6,159,107,52,9,9,84,42,42
"2021","Croydon 005B","E01001148",701,226,67,159,406,20,172,29,92,51,70,34,30,6,132,79,53,12,12,69,34,35
"2021","Croydon 005C","E01001151",672,207,63,144,382,26,146,33,76,37,39,14,22,3,160,94,66,11,11,83,39,44
"2021","Croydon 005D","E01001152",784,242,56,186,441,8,175,36,107,32,59,34,21,4,180,132,48,19,19,101,40,61
"2021","Croydon 005E","E01001158",671,225,51,174,381,25,147,48,75,24,84,41,38,5,118,79,39,7,7,65,23,42
"2021","Croydon 006A","E01001146",607,180,68,112,367,27,170,41,81,48,64,22,37,5,100,52,48,6,6,60,30,30
"2021","Croydon 006B","E01001149",626,173,42,131,389,19,172,45,106,21,71,32,33,6,123,68,55,4,4,64,24,40
"2021","Croydon 006C","E01001150",637,145,39,106,424,24,208,52,110,46,78,33,42,3,104,51,53,10,10,68,25,43
"2021","Croydon 006D","E01001153",612,153,46,107,356,23,153,30,75,48,46,25,14,7,113,60,53,21,21,103,35,68
"2021","Croydon 006E","E01001154",726,181,47,134,441,15,176,39,102,35,67,26,33,8,163,101,62,20,20,104,44,60
"2021","Croydon 007A","E01001136",982,427,83,344,470,7,177,75,79,23,140,91,45,4,132,96,36,14,14,85,29,56
"2021","Croydon 007B","E01001139",712,228,63,165,421,24,178,45,103,30,80,43,33,4,128,70,58,11,11,63,24,39
"2021","Croydon 007C","E01001140",759,277,49,228,442,25,171,65,86,20,122,79,38,5,117,83,34,7,7,40,14,26
"2021","Croydon 007D","E01001142",749,192,60,132,495,44,239,65,130,44,82,52,27,3,117,71,46,13,13,62,19,43
"2021","Croydon 007E","E01001144",799,309,57,252,411,7,168,78,70,20,81,49,30,2,119,81,38,36,36,79,38,41
"2021","Croydon 008A","E01001141",571,218,39,179,311,13,120,35,66,19,70,44,20,6,104,64,40,4,4,42,16,26
"2021","Croydon 008B","E01001143",826,297,100,197,457,31,179,50,93,36,73,39,31,3,162,101,61,12,12,72,32,40
"2021","Croydon 008C","E01001145",871,353,75,278,473,11,143,54,76,13,68,41,22,5,227,169,58,24,24,45,17,28
"2021","Croydon 008D","E01001191",863,295,40,255,464,12,195,47,117,31,87,46,36,5,157,111,46,13,13,104,42,62
"2021","Croydon 008E","E01001192",693,214,49,165,428,15,163,62,76,25,86,47,31,8,153,85,68,11,11,51,16,35
"2021","Croydon 009A","E01000994",535,124,40,84,311,25,159,37,78,44,36,17,18,1,79,47,32,12,12,100,59,41
"2021","Croydon 009B","E01000995",606,159,54,105,342,14,172,44,90,38,41,21,17,3,103,67,36,12,12,105,58,47
"2021","Croydon 009C","E01000996",450,93,51,42,272,20,148,34,67,47,25,12,8,5,69,25,44,10,10,85,43,42
"2021","Croydon 009D","E01000997",492,110,42,68,298,21,151,31,73,47,23,13,8,2,94,60,34,9,9,84,41,43
"2021","Croydon 009E","E01000999",433,91,46,45,255,18,145,32,68,45,16,6,8,2,70,33,37,6,6,87,44,43
"2021","Croydon 009F","E01001002",521,148,46,102,288,14,151,38,86,27,30,13,16,1,86,47,39,7,7,85,49,36
"2021","Croydon 010A","E01000998",586,193,34,159,299,14,144,45,61,38,44,29,14,1,90,60,30,7,7,94,35,59
"2021","Croydon 010B","E01001000",515,178,43,135,265,18,111,25,55,31,38,16,19,3,87,51,36,11,11,72,33,39
"2021","Croydon 010C","E01001003",599,175,44,131,353,21,155,34,92,29,51,22,24,5,118,79,39,8,8,71,36,35
"2021","Croydon 010D","E01001111",643,163,41,122,389,18,187,43,108,36,57,31,21,5,120,61,59,7,7,91,45,46
"2021","Croydon 010E","E01001155",782,339,112,227,373,23,138,36,76,26,41,23,17,1,151,111,40,20,20,70,35,35
"2021","Croydon 011A","E01001174",508,96,44,52,306,32,163,28,83,52,20,6,10,4,76,39,37,15,15,106,62,44
"2021","Croydon 011B","E01001175",556,160,50,110,302,9,145,23,86,36,36,18,14,4,94,58,36,18,18,94,39,55
"2021","Croydon 011C","E01001176",620,142,34,108,363,18,172,19,106,47,33,14,16,3,130,65,65,10,10,115,57,58
"2021","Croydon 011D","E01001182",460,95,34,61,259,20,122,28,57,37,30,8,7,15,82,41,41,5,5,106,53,53
"2021","Croydon 011E","E01001183",637,158,45,113,376,21,167,32,91,44,27,3,21,3,129,91,38,32,32,103,50,53
"2021","Croydon 011F","E01001184",449,95,48,47,269,32,148,43,47,58,11,2,6,3,67,21,46,11,11,85,53,32
"2021","Croydon 013A","E01001001",580,181,44,137,341,9,118,33,61,24,63,40,19,4,139,92,47,12,12,58,27,31
"2021","Croydon 013B","E01001109",965,342,111,231,535,19,190,52,102,36,94,46,45,3,218,158,60,14,14,88,30,58
"2021","Croydon 013C","E01001112",854,311,69,242,455,16,163,39,94,30,92,45,41,6,170,115,55,14,14,88,42,46
"2021","Croydon 013D","E01001113",859,311,34,277,467,18,162,54,67,41,119,47,70,2,151,97,54,17,17,81,43,38
"2021","Croydon 013E","E01001114",602,177,27,150,361,7,122,15,85,22,54,23,26,5,166,119,47,12,12,64,27,37
"2021","Croydon 013F","E01001116",606,174,34,140,354,17,135,35,69,31,65,37,23,5,121,84,37,16,16,78,48,30
"2021","Croydon 014A","E01000992",681,180,53,127,413,22,185,42,96,47,52,21,22,9,149,78,71,5,5,88,47,41
"2021","Croydon 014B","E01001185",745,267,60,207,419,24,184,39,114,31,90,64,23,3,113,71,42,8,8,59,26,33
"2021","Croydon 014C","E01001186",815,353,100,253,395,17,142,45,63,34,66,43,18,5,152,110,42,18,18,67,25,42
"2021","Croydon 014D","E01001188",749,194,41,153,466,18,153,46,79,28,115,54,54,7,172,115,57,8,8,89,37,52
"2021","Croydon 014E","E01001193",575,94,23,71,409,13,146,21,73,52,52,24,20,8,188,95,93,10,10,72,39,33
"2021","Croydon 015A","E01001004",781,195,52,143,474,12,204,47,118,39,62,23,34,5,183,110,73,13,13,112,49,63
"2021","Croydon 015B","E01001115",648,193,80,113,366,25,151,25,87,39,36,15,19,2,144,100,44,10,10,89,60,29
"2021","Croydon 015D","E01001178",600,198,33,165,315,3,130,22,89,19,47,23,15,9,128,106,22,7,7,87,49,38
"2021","Croydon 015E","E01001181",891,302,55,247,486,11,157,26,115,16,58,23,21,14,248,203,45,12,12,103,68,35
"2021","Croydon 015F","E01034139",656,207,37,170,354,7,169,28,102,39,33,12,18,3,132,85,47,13,13,95,44,51
"2021","Croydon 015G","E01034140",519,178,11,167,295,5,143,45,84,14,48,24,22,2,94,65,29,5,5,46,22,24
"2021","Croydon 016A","E01001006",692,170,28,142,472,15,216,57,118,41,54,26,28,0,178,130,48,9,9,50,27,23
"2021","Croydon 016B","E01001007",593,95,43,52,391,27,246,31,137,78,24,7,13,4,86,46,40,8,8,107,61,46
"2021","Croydon 016C","E01001177",552,122,25,97,349,12,167,20,96,51,25,5,15,5,124,58,66,21,21,81,45,36
"2021","Croydon 016D","E01001179",548,117,55,62,341,22,197,31,112,54,28,8,18,2,80,38,42,14,14,90,47,43
"2021","Croydon 016E","E01001180",674,141,42,99,441,19,227,48,124,55,31,11,18,2,142,91,51,22,22,92,48,44
"2021","Croydon 017A","E01000980",577,152,39,113,366,20,169,53,84,32,51,31,14,6,115,71,44,11,11,59,32,27
"2021","Croydon 017B","E01000981",656,157,55,102,444,24,220,48,119,53,74,44,24,6,109,58,51,17,17,55,31,24
"2021","Croydon 017C","E01000982",679,176,52,124,443,16,201,59,111,31,97,59,33,5,118,74,44,11,11,60,30,30
"2021","Croydon 017D","E01000983",722,184,61,123,448,29,241,94,104,43,79,52,23,4,91,47,44,8,8,90,43,47
"2021","Croydon 017E","E01001187",811,264,70,194,476,22,192,51,102,39,93,60,30,3,159,102,57,10,10,71,34,37
"2021","Croydon 018A","E01000989",627,119,62,57,447,60,243,59,119,65,57,22,27,8,82,35,47,5,5,61,28,33
"2021","Croydon 018B","E01000991",685,156,96,60,471,111,235,64,101,70,46,16,23,7,74,28,46,5,5,58,26,32
"2021","Croydon 018C","E01001131",659,216,134,82,401,30,182,36,114,32,80,37,37,6,103,68,35,6,6,42,20,22
"2021","Croydon 018D","E01001132",644,144,102,42,442,98,224,65,96,63,53,27,21,5,65,32,33,2,2,58,30,28
"2021","Croydon 018E","E01001134",677,225,110,115,415,58,233,63,111,59,62,35,20,7,61,28,33,1,1,37,23,14
"2021","Croydon 019A","E01001005",601,145,45,100,347,13,171,33,100,38,38,17,20,1,108,64,44,17,17,109,53,56
"2021","Croydon 019B","E01001008",531,74,38,36,385,20,194,43,106,45,37,8,27,2,130,59,71,4,4,72,57,15
"2021","Croydon 019C","E01001009",664,111,31,80,441,12,245,45,160,40,39,12,23,4,132,83,49,13,13,112,56,56
"2021","Croydon 019D","E01001010",609,139,55,84,389,7,158,26,83,49,50,22,19,9,158,79,79,16,16,81,46,35
"2021","Croydon 019E","E01001011",858,247,45,202,513,13,201,40,122,39,84,40,39,5,199,155,44,16,16,98,52,46
"2021","Croydon 020A","E01001012",810,293,37,256,392,9,153,36,89,28,62,36,25,1,150,109,41,18,18,125,57,68
"2021","Croydon 020B","E01001013",904,348,95,253,462,19,162,33,100,29,52,20,20,12,216,142,74,13,13,94,40,54
"2021","Croydon 020D","E01001110",892,285,46,239,512,12,195,58,114,23,83,57,23,3,207,142,65,15,15,95,41,54
"2021","Croydon 020E","E01001118",882,300,92,208,488,20,188,57,91,40,64,31,29,4,204,141,63,12,12,94,46,48
"2021","Croydon 020F","E01034141",591,157,16,141,373,5,178,61,108,9,103,67,35,1,61,43,18,26,26,61,16,45
"2021","Croydon 020G","E01034142",644,247,47,200,349,10,137,36,90,11,94,51,41,2,91,61,30,17,17,48,21,27
"2021","Croydon 020H","E01034143",669,257,4,253,357,2,150,67,74,9,111,89,21,1,74,43,31,20,20,55,9,46
"2021","Croydon 021A","E01000985",518,92,44,48,373,75,202,50,90,62,37,13,18,6,52,23,29,7,7,53,24,29
"2021","Croydon 021B","E01000986",687,178,95,83,440,66,238,70,112,56,63,35,25,3,66,33,33,7,7,69,35,34
"2021","Croydon 021C","E01000987",517,96,53,43,378,52,223,59,94,70,45,22,16,7,55,22,33,3,3,43,23,20
"2021","Croydon 021D","E01000993",604,115,56,59,432,48,232,54,125,53,57,27,24,6,92,45,47,3,3,57,34,23
"2021","Croydon 022A","E01000975",1040,351,65,286,567,23,251,100,126,25,153,117,33,3,118,84,34,22,22,122,35,87
"2021","Croydon 022B","E01000976",875,250,83,167,511,23,245,101,124,20,91,61,29,1,135,96,39,17,17,114,42,72
"2021","Croydon 022C","E01000977",949,450,118,332,436,28,179,64,86,29,103,61,40,2,116,77,39,10,10,63,25,38
"2021","Croydon 022D","E01000978",838,349,103,246,419,27,178,72,86,20,104,67,32,5,87,61,26,23,23,70,37,33
"2021","Croydon 022E","E01000979",776,240,64,176,462,31,204,79,104,21,121,82,27,12,87,63,24,19,19,74,19,55
"2021","Croydon 022F","E01000984",787,282,101,181,405,16,156,60,83,13,87,50,29,8,130,83,47,16,16,100,53,47
"2021","Croydon 023A","E01001044",833,267,127,140,495,49,299,66,198,35,77,53,21,3,62,31,31,8,8,71,36,35
"2021","Croydon 023B","E01001046",797,258,94,164,486,32,304,73,205,26,93,66,25,2,47,34,13,10,10,53,25,28
"2021","Croydon 023C","E01001049",520,88,50,38,375,76,225,73,96,56,27,15,11,1,39,16,23,8,8,57,23,34
"2021","Croydon 023D","E01001050",794,326,198,128,419,32,193,45,134,14,72,46,18,8,106,54,52,16,16,49,18,31
"2021","Croydon 024B","E01001042",945,295,41,254,550,5,207,76,112,19,147,109,34,4,174,123,51,17,17,100,38,62
"2021","Croydon 024C","E01001165",723,209,45,164,428,13,236,61,125,50,62,40,19,3,103,64,39,14,14,86,41,45
"2021","Croydon 024D","E01001166",875,368,139,229,437,19,169,51,101,17,91,48,34,9,149,105,44,9,9,70,35,35
"2021","Croydon 024E","E01001168",735,202,63,139,434,35,196,55,103,38,98,50,39,9,95,60,35,10,10,99,29,70
"2021","Croydon 024F","E01034144",589,199,36,163,334,3,164,60,89,15,70,44,21,5,83,57,26,14,14,56,22,34
"2021","Croydon 024G","E01034145",562,192,38,154,301,7,111,37,58,16,53,27,26,0,110,81,29,20,20,69,33,36
"2021","Croydon 024H","E01034146",597,187,17,170,359,0,158,37,116,5,78,46,29,3,112,93,19,11,11,51,18,33
"2021","Croydon 025A","E01001127",585,109,59,50,427,93,258,50,122,86,37,12,18,7,39,11,28,0,0,49,25,24
"2021","Croydon 025B","E01001128",572,105,41,64,421,26,143,20,89,34,36,11,20,5,210,131,79,6,6,46,30,16
"2021","Croydon 025C","E01001130",561,88,27,61,423,12,131,19,88,24,42,9,29,4,228,172,56,10,10,50,41,9
"2021","Croydon 025D","E01001135",641,157,101,56,420,79,227,67,94,66,36,15,17,4,73,39,34,5,5,64,34,30
"2021","Croydon 026A","E01001062",557,118,72,46,393,105,195,66,69,60,32,14,14,4,59,26,33,2,2,46,26,20
"2021","Croydon 026B","E01001063",571,112,62,50,409,72,231,57,106,68,43,14,25,4,58,34,24,5,5,50,30,20
"2021","Croydon 026C","E01001064",610,145,96,49,404,90,218,66,94,58,40,18,16,6,50,23,27,6,6,61,33,28
"2021","Croydon 026D","E01001129",509,79,55,24,390,87,237,66,101,70,35,9,19,7,30,7,23,1,1,40,19,21
"2021","Croydon 026E","E01001133",730,262,188,74,418,105,191,63,74,54,54,29,18,7,62,27,35,6,6,50,23,27
"2021","Croydon 028A","E01001167",821,167,58,109,538,29,285,60,160,65,76,38,32,6,139,87,52,9,9,116,67,49
"2021","Croydon 028B","E01001169",641,160,57,103,405,16,187,42,100,45,40,15,21,4,155,95,60,7,7,76,40,36
"2021","Croydon 028C","E01001171",685,244,68,176,381,29,163,41,90,32,51,31,19,1,130,88,42,8,8,60,42,18
"2021","Croydon 028D","E01001172",728,171,59,112,474,8,205,32,114,59,58,10,28,20,197,126,71,6,6,83,59,24
"2021","Croydon 028E","E01001173",1120,353,105,248,680,43,325,75,203,47,99,51,38,10,199,133,66,14,14,87,43,44
"2021","Croydon 029A","E01001036",660,202,68,134,415,72,227,66,120,41,72,54,18,0,43,24,19,1,1,43,20,23
"2021","Croydon 029B","E01001037",685,216,64,152,417,18,156,48,88,20,130,83,45,2,108,80,28,5,5,52,19,33
"2021","Croydon 029C","E01001038",950,396,59,337,502,18,182,71,91,20,171,118,49,4,120,89,31,11,11,52,18,34
"2021","Croydon 029D","E01001039",601,128,56,72,425,63,249,63,141,45,50,28,15,7,60,35,25,3,3,48,20,28
"2021","Croydon 029E","E01001040",742,232,46,186,453,24,203,59,113,31,119,82,36,1,95,67,28,12,12,57,25,32
"2021","Croydon 030A","E01001051",562,180,110,70,334,29,120,19,72,29,46,10,33,3,135,93,42,4,4,48,25,23
"2021","Croydon 030B","E01001052",456,69,40,29,339,19,122,22,69,31,36,6,18,12,157,100,57,5,5,48,28,20
"2021","Croydon 030C","E01001054",594,115,65,50,412,20,175,41,82,52,53,14,30,9,158,97,61,6,6,67,41,26
"2021","Croydon 030D","E01001056",576,102,28,74,418,3,136,16,83,37,47,12,29,6,228,176,52,4,4,56,38,18
"2021","Croydon 030E","E01001057",602,114,40,74,447,6,138,16,103,19,53,11,35,7,245,179,66,5,5,41,25,16
"2021","Croydon 031A","E01001033",683,199,67,132,409,26,223,61,129,33,66,50,15,1,82,42,40,12,12,75,29,46
"2021","Croydon 031B","E01001034",665,177,35,142,431,34,211,58,120,33,99,61,33,5,75,52,23,12,12,57,24,33
"2021","Croydon 031C","E01001041",724,245,44,201,422,14,180,55,110,15,88,60,27,1,126,84,42,14,14,57,31,26
"2021","Croydon 031D","E01001095",592,158,42,116,393,23,198,45,116,37,67,40,22,5,95,71,24,10,10,41,17,24
"2021","Croydon 031E","E01001100",604,159,75,84,399,40,218,49,126,43,70,42,25,3,68,30,38,3,3,46,11,35
"2021","Croydon 032A","E01001053",534,101,61,40,387,38,190,41,91,58,43,6,28,9,109,72,37,7,7,46,32,14
"2021","Croydon 032B","E01001055",577,172,100,72,358,26,154,29,76,49,45,13,25,7,123,70,53,10,10,47,28,19
"2021","Croydon 032C","E01001077",517,117,56,61,356,54,176,52,89,35,47,17,21,9,76,45,31,3,3,44,16,28
"2021","Croydon 032D","E01001078",513,104,44,60,369,34,144,31,67,46,64,32,28,4,124,76,48,3,3,40,21,19
"2021","Croydon 032E","E01001082",523,89,45,44,378,27,162,31,79,52,58,12,32,14,122,71,51,9,9,56,29,27
"2021","Croydon 033A","E01001120",507,108,64,44,354,51,197,57,97,43,38,15,17,6,65,29,36,3,3,45,25,20
"2021","Croydon 033B","E01001122",458,69,40,29,332,81,210,58,90,62,16,9,5,2,24,9,15,1,1,57,31,26
"2021","Croydon 033C","E01001123",608,111,71,40,435,77,258,61,124,73,41,18,20,3,58,19,39,1,1,62,32,30
"2021","Croydon 033D","E01001124",604,138,105,33,425,121,251,66,114,71,27,11,14,2,22,11,11,4,4,41,22,19
"2021","Croydon 033E","E01001125",606,137,75,62,404,82,226,56,119,51,30,11,14,5,60,39,21,6,6,65,32,33
"2021","Croydon 034A","E01001058",528,118,65,53,378,50,180,44,94,42,52,20,28,4,94,44,50,2,2,32,20,12
"2021","Croydon 034B","E01001059",667,252,94,158,385,39,137,38,79,20,98,57,36,5,106,71,35,5,5,30,15,15
"2021","Croydon 034C","E01001060",644,184,82,102,412,48,204,61,112,31,66,28,32,6,94,53,41,0,0,48,29,19
"2021","Croydon 034D","E01001061",653,208,70,138,382,25,181,47,81,53,65,30,26,9,102,57,45,9,9,63,34,29
"2021","Croydon 034E","E01001065",650,269,108,161,347,52,157,65,56,36,69,50,17,2,65,34,31,4,4,34,19,15
"2021","Croydon 034F","E01001066",526,137,62,75,338,13,128,22,68,38,38,13,18,7,150,91,59,9,9,51,32,19
"2021","Croydon 034G","E01001119",578,150,102,48,397,82,215,55,109,51,46,20,20,6,49,20,29,5,5,31,16,15
"2021","Croydon 034H","E01001126",599,159,91,68,409,74,201,66,86,49,58,21,29,8,73,39,34,3,3,31,17,14
"2021","Croydon 035A","E01001032",557,95,57,38,423,92,251,66,139,46,42,20,19,3,36,23,13,2,2,39,22,17
"2021","Croydon 035B","E01001101",509,66,51,15,409,69,269,61,139,69,42,16,18,8,29,9,20,0,0,34,21,13
"2021","Croydon 035C","E01001102",633,206,166,40,397,94,227,63,117,47,27,8,16,3,46,25,21,3,3,30,16,14
"2021","Croydon 035D","E01001107",667,156,69,87,445,93,262,81,133,48,39,23,14,2,50,23,27,1,1,66,17,49
"2021","Croydon 035E","E01001108",645,105,73,32,497,109,311,60,175,76,31,16,13,2,45,17,28,1,1,43,20,23
"2021","Croydon 036A","E01001076",566,108,51,57,412,24,180,45,97,38,47,8,28,11,152,102,50,9,9,46,29,17
"2021","Croydon 036B","E01001079",588,135,69,66,399,27,172,48,73,51,53,18,27,8,137,86,51,10,10,54,36,18
"2021","Croydon 036C","E01001080",586,235,110,125,299,14,113,19,66,28,31,10,15,6,135,92,43,6,6,52,28,24
"2021","Croydon 036D","E01001081",498,81,35,46,369,33,147,32,72,43,58,13,38,7,127,77,50,4,4,48,27,21
"2021","Croydon 037A","E01001073",583,172,74,98,361,38,193,53,107,33,58,37,20,1,66,40,26,6,6,50,20,30
"2021","Croydon 037B","E01001092",702,201,76,125,437,62,252,71,120,61,60,38,20,2,58,37,21,5,5,64,32,32
"2021","Croydon 037C","E01001093",712,189,66,123,456,49,238,64,112,62,57,29,23,5,104,61,43,8,8,67,32,35
"2021","Croydon 037D","E01001096",531,83,46,37,405,74,255,59,138,58,38,27,8,3,35,8,27,3,3,43,20,23
"2021","Croydon 037E","E01001097",1171,498,193,305,585,39,247,92,125,30,125,90,32,3,164,118,46,10,10,88,21,67
"2021","Croydon 037F","E01001098",536,73,41,32,426,66,282,84,146,52,39,24,12,3,38,21,17,1,1,37,11,26
"2021","Croydon 038A","E01001028",539,72,42,30,406,85,257,57,125,75,25,12,10,3,34,13,21,5,5,61,36,25
"2021","Croydon 038B","E01001029",634,163,44,119,409,46,221,66,105,50,56,31,24,1,81,50,31,5,5,62,21,41
"2021","Croydon 038C","E01001030",490,75,45,30,365,56,231,52,126,53,38,18,13,7,36,22,14,4,4,50,27,23
"2021","Croydon 038D","E01001031",516,82,39,43,382,64,244,64,123,57,32,11,17,4,39,14,25,3,3,52,23,29
"2021","Croydon 038E","E01001094",566,103,59,44,397,79,260,65,126,69,24,18,4,2,29,14,15,5,5,66,30,36
"2021","Croydon 039A","E01001103",644,154,106,48,439,116,234,60,125,49,37,12,22,3,51,17,34,1,1,51,29,22
"2021","Croydon 039B","E01001105",621,135,86,49,428,37,225,48,116,61,65,12,37,16,93,53,40,8,8,58,31,27
"2021","Croydon 039C","E01001106",561,112,64,48,410,60,214,48,110,56,58,24,28,6,77,36,41,1,1,39,19,20
"2021","Croydon 039D","E01001121",540,122,97,25,374,128,188,52,89,47,22,10,9,3,34,12,22,2,2,44,20,24
"2021","Croydon 040A","E01001069",505,101,48,53,364,53,201,54,116,31,65,34,27,4,42,18,24,3,3,40,17,23
"2021","Croydon 040B","E01001070",646,136,70,66,451,62,246,67,136,43,47,22,20,5,93,53,40,3,3,59,35,24
"2021","Croydon 040C","E01001075",644,157,60,97,450,39,193,46,119,28,127,76,45,6,88,57,31,3,3,37,17,20
"2021","Croydon 040D","E01001099",600,133,32,101,422,41,214,52,127,35,57,31,24,2,105,61,44,5,5,45,23,22
"2021","Croydon 041A","E01001015",557,119,56,63,397,46,186,50,95,41,33,10,18,5,131,79,52,1,1,41,27,14
"2021","Croydon 041B","E01001016",655,142,92,50,457,70,253,66,135,52,56,25,27,4,75,32,43,3,3,56,29,27
"2021","Croydon 041C","E01001023",1119,379,117,262,685,33,340,97,203,40,163,110,47,6,148,109,39,1,1,55,24,31
"2021","Croydon 041D","E01001067",575,78,51,27,450,85,293,89,147,57,37,16,18,3,35,16,19,0,0,47,29,18
"2021","Croydon 041E","E01001074",816,245,111,134,516,40,244,76,124,44,89,51,33,5,135,97,38,8,8,55,26,29
"2021","Croydon 042A","E01001068",754,180,58,122,520,66,256,84,120,52,79,46,27,6,115,71,44,4,4,54,20,34
"2021","Croydon 042B","E01001071",723,148,58,90,527,61,281,81,143,57,88,34,44,10,94,54,40,3,3,48,27,21
"2021","Croydon 042C","E01001072",540,95,56,39,413,106,241,69,119,53,36,13,11,12,29,11,18,1,1,32,12,20
"2021","Croydon 042D","E01001104",645,121,59,62,481,74,283,85,134,64,63,29,28,6,56,27,29,5,5,43,21,22
"2021","Croydon 043A","E01001017",630,133,78,55,451,76,276,83,144,49,63,31,24,8,35,13,22,1,1,46,23,23
"2021","Croydon 043B","E01001024",527,118,64,54,375,51,202,58,104,40,55,31,21,3,63,24,39,4,4,34,20,14
"2021","Croydon 043C","E01001025",493,75,43,32,387,62,229,62,123,44,48,21,25,2,45,18,27,3,3,31,17,14
"2021","Croydon 043D","E01001026",666,109,63,46,513,53,281,63,158,60,70,32,34,4,109,70,39,0,0,44,24,20
"2021","Croydon 043E","E01001027",989,125,52,73,793,58,504,120,322,62,128,56,58,14,96,60,36,7,7,71,40,31
"2021","Croydon 044A","E01001018",634,123,75,48,477,87,263,69,140,54,71,34,32,5,56,22,34,0,0,34,16,18
"2021","Croydon 044B","E01001019",594,136,97,39,434,100,247,68,117,62,47,21,20,6,37,12,25,3,3,24,10,14
"2021","Croydon 044C","E01001020",638,163,107,56,440,79,242,55,142,45,56,18,34,4,63,29,34,0,0,35,18,17
"2021","Croydon 044D","E01001021",547,160,100,60,355,42,144,44,69,31,56,21,31,4,107,72,35,6,6,32,14,18
"2021","Croydon 044E","E01001022",620,176,127,49,413,93,240,77,113,50,43,16,22,5,34,14,20,3,3,31,14,17
"2021","Croydon 045A","E01000990",532,138,71,67,329,30,112,22,58,32,32,14,14,4,146,79,67,9,9,65,35,30
"2021","Croydon 045B","E01001189",457,97,39,58,314,22,156,35,83,38,38,24,11,3,93,56,37,5,5,46,25,21
"2021","Croydon 045C","E01001190",601,147,41,106,382,10,159,37,89,33,81,41,28,12,125,68,57,7,7,72,27,45
"2021","Croydon 045D","E01001194",616,130,38,92,430,17,198,55,103,40,85,43,37,5,124,65,59,6,6,56,29,27
"2021","Croydon 045E","E01032569",682,182,45,137,440,13,141,27,85,29,54,16,30,8,225,137,88,7,7,60,36,24
"2021","Croydon 046A","E01034147",640,264,3,261,327,0,138,89,41,8,132,126,6,0,36,27,9,21,21,49,7,42
"2021","Croydon 046B","E01034148",836,338,10,328,438,2,192,97,67,28,159,140,17,2,50,35,15,35,35,60,4,56
"2021","Croydon 046C","E01034149",1091,476,126,350,541,31,201,81,108,12,164,134,25,5,131,72,59,14,14,74,34,40
"2021","Croydon 046D","E01034150",672,274,20,254,337,4,121,41,73,7,92,68,24,0,101,74,27,19,19,61,13,48
"2021","Croydon 046E","E01034151",640,300,7,293,291,3,101,54,44,3,100,84,15,1,72,54,18,15,15,49,7,42
"2021","Croydon 047C","E01001035",840,324,57,267,456,27,198,68,113,17,104,78,24,2,110,81,29,17,17,60,18,42
"2021","Croydon 047A","E01001047",846,350,75,275,416,17,186,76,99,11,107,80,26,1,90,65,25,16,16,80,32,48
"2021","Croydon 047D","E01001170",896,390,146,244,456,21,180,47,117,16,110,65,42,3,129,95,34,16,16,50,24,26
"2021","Croydon 047B","E01034152",729,280,28,252,380,10,139,40,83,16,91,47,40,4,131,107,24,9,9,69,30,39
"2021","Ealing 001A","E01001269",794,181,53,128,500,31,291,54,165,72,73,35,38,0,93,49,44,12,12,113,55,58
"2021","Ealing 001B","E01001271",629,127,43,84,391,23,229,34,132,63,40,12,22,6,94,51,43,5,5,111,60,51
"2021","Ealing 001C","E01001309",595,104,51,53,390,27,249,39,145,65,38,23,12,3,69,31,38,7,7,101,57,44
"2021","Ealing 001D","E01001310",757,156,64,92,500,28,245,53,135,57,50,22,22,6,102,55,47,75,75,101,60,41
"2021","Ealing 001E","E01001311",954,313,55,258,494,20,265,72,140,53,67,44,16,7,130,67,63,12,12,147,86,61
"2021","Ealing 002A","E01001307",605,112,54,58,376,36,231,42,125,64,43,21,18,4,59,26,33,7,7,117,54,63
"2021","Ealing 002B","E01001308",684,156,72,84,395,60,233,69,98,66,32,23,8,1,50,17,33,20,20,133,75,58
"2021","Ealing 002C","E01001312",606,92,41,51,380,43,220,35,128,57,35,16,17,2,62,22,40,20,20,134,64,70
"2021","Ealing 002D","E01001313",520,79,43,36,306,35,172,29,85,58,21,9,7,5,66,29,37,12,12,135,78,57
"2021","Ealing 002E","E01001314",511,96,47,49,307,32,183,27,98,58,26,14,12,0,64,31,33,2,2,108,51,57
"2021","Ealing 003A","E01001315",501,106,43,63,312,27,180,35,102,43,30,11,11,8,67,32,35,8,8,83,54,29
"2021","Ealing 003B","E01001316",616,128,42,86,413,13,202,53,108,41,37,16,16,5,149,95,54,12,12,75,39,36
"2021","Ealing 003C","E01001317",727,149,60,89,458,28,236,44,150,42,56,13,37,6,131,71,60,7,7,120,59,61
"2021","Ealing 003D","E01001318",717,191,95,96,439,21,214,54,117,43,48,23,16,9,151,85,66,5,5,87,50,37
"2021","Ealing 003E","E01001320",550,125,39,86,364,16,160,29,99,32,28,7,18,3,152,91,61,8,8,61,38,23
"2021","Ealing 003F","E01001321",796,162,82,80,515,45,240,55,119,66,45,11,21,13,178,116,62,7,7,119,76,43
"2021","Ealing 004A","E01001270",584,103,42,61,383,26,239,46,130,63,38,15,16,7,73,31,42,7,7,98,53,45
"2021","Ealing 004B","E01001319",503,93,44,49,304,28,191,36,99,56,29,10,9,10,46,21,25,10,10,106,55,51
"2021","Ealing 004C","E01001322",735,170,60,110,459,37,248,66,123,59,49,20,21,8,113,72,41,12,12,106,54,52
"2021","Ealing 004D","E01001323",772,212,67,145,463,31,246,51,144,51,48,29,13,6,129,94,35,9,9,97,50,47
"2021","Ealing 005A","E01001341",588,112,38,74,366,31,219,33,122,64,49,29,18,2,59,34,25,8,8,110,48,62
"2021","Ealing 005B","E01001342",643,126,41,85,385,26,241,61,127,53,39,22,13,4,70,29,41,9,9,132,54,78
"2021","Ealing 005C","E01001343",478,91,44,47,288,40,161,38,74,49,27,10,13,4,49,15,34,11,11,99,48,51
"2021","Ealing 005D","E01001345",524,80,33,47,338,22,210,34,101,75,22,12,6,4,77,29,48,7,7,106,54,52
"2021","Ealing 006A","E01001265",628,166,46,120,360,17,209,51,119,39,40,21,15,4,82,46,36,12,12,102,45,57
"2021","Ealing 006B","E01001266",596,102,52,50,362,43,198,39,93,66,36,18,13,5,78,33,45,7,7,132,57,75
"2021","Ealing 006C","E01001267",819,298,134,164,423,44,208,39,131,38,49,20,27,2,113,63,50,9,9,98,50,48
"2021","Ealing 006D","E01001272",589,154,42,112,323,20,191,36,109,46,27,14,11,2,71,23,48,14,14,112,55,57
"2021","Ealing 006E","E01001349",490,127,57,70,285,17,147,39,62,46,22,9,11,2,91,54,37,8,8,78,43,35
"2021","Ealing 007A","E01001344",900,287,82,205,506,35,293,72,161,60,70,35,25,10,94,55,39,14,14,107,50,57
"2021","Ealing 007B","E01001346",680,159,61,98,433,46,264,42,160,62,42,24,14,4,78,35,43,3,3,88,38,50
"2021","Ealing 007C","E01001347",684,164,42,122,376,32,222,36,117,69,37,24,12,1,75,30,45,10,10,144,52,92
"2021","Ealing 007D","E01001348",667,212,58,154,377,33,192,50,100,42,51,29,18,4,93,61,32,8,8,78,35,43
"2021","Ealing 008A","E01001257",811,223,48,175,525,21,272,49,165,58,48,24,21,3,169,123,46,15,15,63,38,25
"2021","Ealing 008B","E01001324",644,182,45,137,386,13,208,51,120,37,39,26,12,1,115,77,38,11,11,76,37,39
"2021","Ealing 008C","E01001326",673,151,64,87,430,18,186,28,115,43,42,20,19,3,157,107,50,27,27,92,47,45
"2021","Ealing 008D","E01001330",646,168,48,120,404,10,201,38,126,37,38,15,18,5,143,94,49,12,12,74,52,22
"2021","Ealing 008E","E01001332",580,140,43,97,376,10,184,26,116,42,31,14,14,3,138,92,46,13,13,64,33,31
"2021","Ealing 009A","E01001325",618,117,64,53,402,26,234,31,139,64,32,8,16,8,101,54,47,9,9,99,64,35
"2021","Ealing 009B","E01001327",589,125,51,74,363,20,210,32,122,56,31,17,13,1,88,46,42,14,14,101,57,44
"2021","Ealing 009C","E01001328",593,128,58,70,374,23,191,22,118,51,26,7,15,4,127,69,58,7,7,91,55,36
"2021","Ealing 009D","E01001329",637,113,47,66,439,28,226,41,134,51,39,10,20,9,133,82,51,13,13,85,43,42
"2021","Ealing 009E","E01001331",630,149,36,113,423,6,188,33,123,32,38,16,17,5,180,117,63,11,11,58,36,22
"2021","Ealing 010B","E01001258",649,160,79,81,405,31,226,36,128,62,38,10,26,2,98,56,42,12,12,84,54,30
"2021","Ealing 010C","E01001262",542,150,67,83,307,17,155,23,90,42,30,9,18,3,99,51,48,6,6,85,45,40
"2021","Ealing 010D","E01001263",734,226,66,160,433,30,210,40,132,38,59,24,29,6,122,86,36,12,12,75,42,33
"2021","Ealing 010E","E01001264",627,111,50,61,440,44,208,33,109,66,49,23,21,5,130,71,59,9,9,76,34,42
"2021","Ealing 010F","E01032743",818,189,17,172,572,9,313,74,212,27,56,19,32,5,183,128,55,11,11,57,37,20
"2021","Ealing 010G","E01032744",524,128,35,93,334,13,201,42,120,39,28,9,14,5,82,43,39,10,10,62,34,28
"2021","Ealing 011A","E01001276",700,242,70,172,351,28,180,46,86,48,46,30,14,2,78,38,40,19,19,107,46,61
"2021","Ealing 011B","E01001277",717,162,54,108,432,38,252,49,164,39,45,19,21,5,79,52,27,18,18,123,28,95
"2021","Ealing 011C","E01001278",801,226,78,148,452,34,237,50,149,38,54,30,24,0,108,79,29,19,19,123,30,93
"2021","Ealing 011D","E01001280",776,258,112,146,450,31,267,69,168,30,62,48,13,1,73,44,29,17,17,68,22,46
"2021","Ealing 012A","E01001218",728,192,101,91,408,21,188,33,109,46,41,10,23,8,146,79,67,12,12,128,85,43
"2021","Ealing 012B","E01001260",689,162,71,91,396,32,230,37,137,56,37,17,16,4,80,32,48,17,17,131,64,67
"2021","Ealing 012C","E01001261",860,242,69,173,472,25,244,42,141,61,58,29,25,4,122,56,66,23,23,146,72,74
"2021","Ealing 012D","E01001268",641,139,67,72,402,50,238,39,148,51,41,13,23,5,64,27,37,9,9,100,55,45
"2021","Ealing 013A","E01001209",651,144,74,70,440,53,271,63,159,49,54,34,17,3,55,26,29,7,7,67,23,44
"2021","Ealing 013B","E01001211",718,232,115,117,413,43,241,55,151,35,62,43,17,2,62,39,23,5,5,73,18,55
"2021","Ealing 013C","E01001279",561,123,86,37,384,79,241,49,146,46,28,13,14,1,34,16,18,2,2,54,22,32
"2021","Ealing 013D","E01001281",618,163,93,70,404,39,234,54,152,28,57,43,14,0,64,37,27,10,10,51,10,41
"2021","Ealing 014A","E01001217",440,73,46,27,274,28,174,22,85,67,12,0,7,5,55,24,31,5,5,93,51,42
"2021","Ealing 014B","E01001259",516,111,56,55,303,25,174,37,93,44,26,14,11,1,68,30,38,10,10,102,56,46
"2021","Ealing 014C","E01001291",514,74,32,42,327,31,205,37,108,60,21,5,9,7,67,24,43,3,3,113,72,41
"2021","Ealing 014D","E01001292",508,74,42,32,315,41,185,35,78,72,17,3,12,2,66,21,45,6,6,119,60,59
"2021","Ealing 014E","E01001293",569,132,40,92,332,29,207,22,120,65,17,11,5,1,72,31,41,7,7,105,64,41
"2021","Ealing 015A","E01001196",697,273,97,176,348,22,134,31,80,23,47,35,10,2,132,87,45,13,13,76,22,54
"2021","Ealing 015C","E01001239",566,167,32,135,306,11,135,32,77,26,36,26,8,2,111,54,57,13,13,93,32,61
"2021","Ealing 015D","E01001246",819,380,33,347,345,15,156,40,71,45,64,33,20,11,92,52,40,18,18,94,30,64
"2021","Ealing 015E","E01001247",810,209,73,136,453,71,198,44,111,43,40,23,14,3,130,70,60,14,14,148,42,106
"2021","Ealing 015F","E01034026",627,258,14,244,296,1,122,67,50,5,109,101,8,0,47,30,17,17,17,73,4,69
"2021","Ealing 015G","E01034027",900,358,49,309,427,11,184,77,84,23,84,57,24,3,132,92,40,16,16,115,32,83
"2021","Ealing 016A","E01001210",760,261,125,136,432,28,180,36,105,39,31,10,18,3,180,110,70,13,13,67,40,27
"2021","Ealing 016B","E01001282",610,186,101,85,343,28,174,24,113,37,40,17,19,4,94,44,50,7,7,81,60,21
"2021","Ealing 016C","E01001283",770,288,139,149,431,33,188,30,118,40,48,25,17,6,148,76,72,14,14,51,23,28
"2021","Ealing 016D","E01001285",575,119,42,77,389,16,198,33,129,36,58,20,32,6,98,49,49,19,19,67,29,38
"2021","Ealing 016E","E01001286",615,137,69,68,432,21,223,42,134,47,50,22,22,6,127,76,51,11,11,46,24,22
"2021","Ealing 016F","E01001287",502,99,43,56,357,19,180,18,119,43,32,8,21,3,119,63,56,7,7,46,21,25
"2021","Ealing 017A","E01001294",572,61,31,30,359,26,229,45,108,76,19,5,10,4,73,30,43,12,12,152,95,57
"2021","Ealing 017B","E01001295",525,67,37,30,333,28,223,33,110,80,18,6,8,4,57,27,30,7,7,125,76,49
"2021","Ealing 017C","E01001296",419,60,24,36,264,20,172,21,81,70,12,4,5,3,50,18,32,10,10,95,53,42
"2021","Ealing 017D","E01001297",520,85,46,39,318,18,217,14,123,80,10,0,7,3,64,21,43,9,9,117,71,46
"2021","Ealing 017E","E01001298",584,110,61,49,317,23,206,38,98,70,12,3,6,3,68,24,44,8,8,157,111,46
"2021","Ealing 018A","E01001204",591,119,53,66,403,57,234,55,126,53,41,25,12,4,64,33,31,7,7,69,18,51
"2021","Ealing 018B","E01001205",655,192,51,141,395,21,199,40,128,31,55,28,24,3,108,62,46,12,12,68,31,37
"2021","Ealing 018C","E01001206",554,145,31,114,366,11,136,13,103,20,28,9,13,6,178,133,45,13,13,43,23,20
"2021","Ealing 018D","E01001207",758,210,59,151,478,18,236,60,138,38,139,112,27,0,69,38,31,16,16,70,17,53
"2021","Ealing 018E","E01001208",508,100,61,39,366,64,221,47,116,58,35,19,12,4,44,21,23,2,2,42,12,30
"2021","Ealing 018F","E01001212",722,276,106,170,387,54,225,64,128,33,54,40,13,1,50,26,24,4,4,59,19,40
"2021","Ealing 019B","E01001224",579,112,51,61,411,55,252,56,129,67,57,34,21,2,40,20,20,7,7,56,10,46
"2021","Ealing 019C","E01001226",672,240,80,160,363,35,204,74,110,20,71,58,11,2,43,28,15,10,10,69,20,49
"2021","Ealing 019D","E01001227",601,129,51,78,403,43,234,65,126,43,70,56,12,2,51,26,25,5,5,69,20,49
"2021","Ealing 019E","E01001228",826,261,82,179,428,28,224,81,109,34,92,79,12,1,59,37,22,25,25,137,10,127
"2021","Ealing 019F","E01034028",645,295,31,264,288,7,113,43,53,17,83,72,10,1,70,54,16,15,15,62,8,54
"2021","Ealing 019G","E01034029",701,226,48,178,397,10,203,69,113,21,93,81,12,0,78,51,27,13,13,78,9,69
"2021","Ealing 021A","E01001195",617,136,53,83,391,23,250,43,156,51,29,17,11,1,72,37,35,17,17,90,30,60
"2021","Ealing 021B","E01001197",717,245,69,176,389,23,238,50,161,27,54,37,15,2,67,32,35,7,7,83,24,59
"2021","Ealing 021C","E01001198",596,157,48,109,338,15,182,51,111,20,76,64,12,0,55,34,21,10,10,101,40,61
"2021","Ealing 021D","E01001199",669,204,54,150,371,18,178,56,89,33,58,44,14,0,99,67,32,18,18,94,23,71
"2021","Ealing 022A","E01001284",588,110,53,57,407,41,213,34,124,55,34,9,20,5,112,63,49,7,7,71,36,35
"2021","Ealing 022B","E01001288",535,118,36,82,354,28,196,43,119,34,47,22,23,2,77,41,36,6,6,63,26,37
"2021","Ealing 022C","E01001289",479,94,35,59,328,21,189,36,115,38,48,23,22,3,68,36,32,2,2,57,18,39
"2021","Ealing 022D","E01001290",792,177,54,123,528,43,290,69,163,58,93,69,22,2,96,63,33,6,6,87,28,59
"2021","Ealing 023A","E01001213",535,98,49,49,305,25,177,22,101,54,5,0,5,0,90,21,69,8,8,132,84,48
"2021","Ealing 023B","E01001214",496,74,44,30,299,43,187,28,84,75,10,5,5,0,53,16,37,6,6,123,74,49
"2021","Ealing 023C","E01001215",624,146,81,65,345,25,212,29,118,65,23,7,16,0,79,37,42,6,6,133,79,54
"2021","Ealing 023D","E01001216",495,74,40,34,318,24,207,28,130,49,10,5,5,0,68,26,42,9,9,103,74,29
"2021","Ealing 023E","E01001361",605,100,31,69,340,14,220,36,132,52,16,7,9,0,78,38,40,12,12,165,103,62
"2021","Ealing 024A","E01001240",654,195,45,150,319,23,130,28,59,43,60,49,9,2,80,23,57,26,26,140,38,102
"2021","Ealing 024B","E01001241",660,189,49,140,328,24,152,36,75,41,49,35,11,3,76,42,34,27,27,143,34,109
"2021","Ealing 024C","E01001242",616,165,60,105,373,26,167,44,97,26,46,34,12,0,128,86,42,6,6,78,22,56
"2021","Ealing 024D","E01001243",959,312,83,229,517,15,260,72,150,38,96,72,19,5,114,71,43,32,32,130,29,101
"2021","Ealing 024E","E01001244",1172,390,87,303,673,25,254,73,142,39,163,104,57,2,208,103,105,23,23,109,37,72
"2021","Ealing 024F","E01001245",919,283,52,231,518,18,240,58,149,33,122,80,41,1,119,80,39,19,19,118,24,94
"2021","Ealing 025A","E01001200",631,168,40,128,361,23,198,42,126,30,70,46,20,4,53,30,23,17,17,102,19,83
"2021","Ealing 025B","E01001201",631,170,41,129,374,14,206,58,106,42,83,60,20,3,65,34,31,6,6,87,18,69
"2021","Ealing 025C","E01001202",1002,314,69,245,563,21,269,72,165,32,122,86,32,4,120,72,48,31,31,125,42,83
"2021","Ealing 025D","E01001203",855,399,91,308,388,10,162,55,89,18,112,81,27,4,84,49,35,20,20,68,21,47
"2021","Ealing 025E","E01001351",832,320,104,216,408,15,198,52,125,21,86,65,21,0,90,59,31,19,19,104,26,78
"2021","Ealing 026A","E01001359",622,94,32,62,342,27,226,21,151,54,11,3,6,2,71,27,44,7,7,186,125,61
"2021","Ealing 026B","E01001360",552,63,32,31,299,22,191,31,86,74,8,6,2,0,63,19,44,15,15,190,118,72
"2021","Ealing 026C","E01001362",716,139,28,111,376,11,229,28,152,49,30,13,14,3,92,53,39,14,14,201,132,69
"2021","Ealing 026D","E01001363",526,68,31,37,333,18,234,18,151,65,11,3,5,3,60,31,29,10,10,125,85,40
"2021","Ealing 026E","E01001364",550,146,77,69,290,15,152,21,85,46,24,7,15,2,88,36,52,11,11,114,73,41
"2021","Ealing 026F","E01001365",678,123,40,83,328,25,216,27,113,76,19,8,8,3,58,25,33,10,10,227,154,73
"2021","Ealing 027A","E01001231",785,194,63,131,427,78,208,54,110,44,63,45,13,5,61,37,24,17,17,164,25,139
"2021","Ealing 027B","E01001234",606,202,48,154,314,20,138,61,64,13,85,69,13,3,48,29,19,23,23,90,15,75
"2021","Ealing 027C","E01001350",616,211,80,131,344,35,190,51,102,37,53,41,12,0,48,23,25,18,18,61,11,50
"2021","Ealing 027D","E01001352",642,192,48,144,349,20,200,58,106,36,65,54,10,1,53,26,27,11,11,101,6,95
"2021","Ealing 027E","E01001354",891,341,58,283,450,35,240,69,131,40,97,72,21,4,64,37,27,14,14,100,17,83
"2021","Ealing 028A","E01001249",1090,388,89,299,591,13,241,70,136,35,124,96,25,3,183,125,58,30,30,111,21,90
"2021","Ealing 028B","E01001250",979,354,89,265,533,18,204,70,112,22,113,84,27,2,185,110,75,13,13,92,20,72
"2021","Ealing 028C","E01001255",588,133,54,79,400,33,246,46,158,42,53,30,23,0,64,32,32,4,4,55,21,34
"2021","Ealing 028D","E01001383",646,132,43,89,408,19,251,79,124,48,69,42,22,5,65,28,37,4,4,106,29,77
"2021","Ealing 028E","E01001388",667,282,112,170,325,15,149,41,82,26,54,43,10,1,97,66,31,10,10,60,15,45
"2021","Ealing 028F","E01001389",761,255,93,162,407,19,189,54,118,17,108,83,24,1,86,56,30,5,5,99,27,72
"2021","Ealing 029A","E01001219",764,232,47,185,440,19,207,35,129,43,35,14,18,3,167,95,72,12,12,92,53,39
"2021","Ealing 029B","E01001220",468,95,33,62,301,11,137,21,87,29,26,7,16,3,114,56,58,13,13,72,53,19
"2021","Ealing 029C","E01001334",516,131,69,62,298,15,164,28,97,39,16,5,9,2,100,51,49,3,3,87,59,28
"2021","Ealing 029D","E01001337",765,212,33,179,449,18,220,56,118,46,79,46,27,6,119,63,56,13,13,104,48,56
"2021","Ealing 029E","E01001338",533,111,40,71,286,29,156,27,88,41,25,15,9,1,70,24,46,6,6,136,93,43
"2021","Ealing 029F","E01001339",700,124,26,98,477,20,251,39,145,67,41,23,13,5,156,80,76,9,9,99,64,35
"2021","Ealing 029G","E01001340",548,165,21,144,322,3,179,40,112,27,39,27,10,2,97,56,41,4,4,61,25,36
"2021","Ealing 030A","E01001251",733,199,62,137,471,21,243,70,140,33,92,52,37,3,105,64,41,10,10,63,16,47
"2021","Ealing 030B","E01001252",965,258,73,185,524,21,254,62,159,33,98,54,42,2,132,90,42,19,19,183,61,122
"2021","Ealing 030C","E01001253",775,150,47,103,545,34,284,68,177,39,105,62,38,5,112,75,37,10,10,80,24,56
"2021","Ealing 030D","E01001254",747,243,111,132,433,28,224,60,131,33,92,50,37,5,85,62,23,4,4,71,26,45
"2021","Ealing 031A","E01001229",592,155,57,98,362,23,148,35,79,34,53,26,18,9,125,64,61,13,13,75,24,51
"2021","Ealing 031B","E01001230",606,197,55,142,335,35,182,70,77,35,73,61,9,3,42,21,21,3,3,74,11,63
"2021","Ealing 031C","E01001232",618,175,78,97,364,39,185,46,104,35,50,33,13,4,83,32,51,7,7,79,19,60
"2021","Ealing 031D","E01001233",621,215,90,125,326,26,166,52,88,26,51,35,12,4,68,26,42,15,15,80,21,59
"2021","Ealing 031E","E01001237",671,216,59,157,385,40,180,59,89,32,112,95,17,0,43,24,19,10,10,70,10,60
"2021","Ealing 031F","E01001386",755,210,67,143,464,46,287,89,165,33,78,57,18,3,44,20,24,9,9,81,20,61
"2021","Ealing 032A","E01001303",649,144,61,83,434,32,269,58,162,49,64,47,15,2,65,41,24,4,4,71,10,61
"2021","Ealing 032B","E01001382",564,125,64,61,402,46,266,63,164,39,47,23,20,4,38,16,22,5,5,37,10,27
"2021","Ealing 032C","E01001384",700,155,52,103,441,23,275,81,165,29,78,54,21,3,59,36,23,6,6,104,18,86
"2021","Ealing 032D","E01001385",667,167,76,91,435,24,272,68,164,40,77,49,25,3,52,28,24,10,10,65,13,52
"2021","Ealing 032E","E01001387",726,293,59,234,375,30,193,74,86,33,109,94,11,4,38,25,13,5,5,58,16,42
"2021","Ealing 033A","E01001353",635,225,75,150,330,17,157,60,79,18,66,52,14,0,73,48,25,17,17,80,21,59
"2021","Ealing 033B","E01001355",891,319,97,222,458,18,218,74,129,15,121,99,20,2,79,44,35,22,22,114,12,102
"2021","Ealing 033C","E01001356",631,264,66,198,317,13,141,23,96,22,31,16,11,4,121,81,40,11,11,50,14,36
"2021","Ealing 033D","E01001357",1140,334,44,290,704,17,300,93,173,34,214,158,50,6,148,84,64,25,25,102,35,67
"2021","Ealing 033E","E01001358",819,243,34,209,497,4,242,72,145,25,117,88,28,1,114,67,47,20,20,79,28,51
"2021","Ealing 034A","E01001375",709,166,69,97,491,50,311,105,170,36,78,58,19,1,43,28,15,9,9,52,8,44
"2021","Ealing 034B","E01001377",695,208,99,109,433,59,269,90,142,37,57,45,10,2,46,24,22,2,2,54,22,32
"2021","Ealing 034C","E01001379",716,186,81,105,470,32,302,107,171,24,77,54,21,2,48,28,20,11,11,60,21,39
"2021","Ealing 034D","E01001381",861,304,66,238,462,26,234,91,123,20,117,96,18,3,75,49,26,10,10,95,27,68
"2021","Ealing 035A","E01001248",568,131,61,70,367,45,196,43,103,50,35,18,14,3,83,39,44,8,8,70,28,42
"2021","Ealing 035B","E01001299",642,139,73,66,440,60,276,59,150,67,40,16,20,4,60,28,32,4,4,63,26,37
"2021","Ealing 035C","E01001305",630,125,63,62,449,52,275,54,177,44,60,38,19,3,54,24,30,8,8,56,16,40
"2021","Ealing 035D","E01001306",696,228,98,130,428,29,250,52,167,31,84,56,24,4,57,34,23,8,8,40,14,26
"2021","Ealing 038A","E01001333",714,158,47,111,388,23,223,38,136,49,27,17,10,0,104,71,33,11,11,168,113,55
"2021","Ealing 038B","E01001335",519,97,47,50,293,35,193,34,87,72,11,4,5,2,45,20,25,9,9,129,77,52
"2021","Ealing 038C","E01001336",564,112,39,73,324,33,179,35,80,64,26,11,10,5,78,33,45,8,8,128,74,54
"2021","Ealing 038D","E01001369",550,74,33,41,322,14,221,50,118,53,12,2,8,2,70,37,33,5,5,154,114,40
"2021","Ealing 039A","E01001300",600,127,59,68,405,32,263,62,168,33,61,35,26,0,46,21,25,3,3,68,16,52
"2021","Ealing 039B","E01001301",808,243,83,160,426,18,199,70,109,20,109,80,27,2,85,57,28,15,15,139,19,120
"2021","Ealing 039C","E01001302",618,129,61,68,420,25,256,74,147,35,72,51,17,4,58,32,26,9,9,69,18,51
"2021","Ealing 039D","E01001304",697,207,75,132,418,17,217,54,145,18,92,65,24,3,86,61,25,6,6,72,13,59
"2021","Ealing 040A","E01001374",898,337,73,264,482,28,271,101,140,30,117,83,29,5,56,30,26,10,10,79,17,62
"2021","Ealing 040B","E01001376",735,265,77,188,392,18,178,45,113,20,105,77,25,3,77,37,40,14,14,78,28,50
"2021","Ealing 040C","E01001380",1058,336,108,228,650,37,333,119,182,32,188,163,23,2,76,33,43,16,16,72,17,55
"2021","Ealing 040D","E01032572",754,282,71,211,400,17,213,68,113,32,97,80,14,3,54,29,25,19,19,72,13,59
"2021","Ealing 041B","E01001223",636,215,80,135,352,43,208,70,103,35,52,48,4,0,40,29,11,9,9,69,27,42
"2021","Ealing 041A","E01001225",847,327,108,219,426,32,209,67,107,35,74,64,9,1,98,68,30,13,13,94,15,79
"2021","Ealing 041C","E01001273",586,116,69,47,394,46,278,60,169,49,33,24,7,2,32,19,13,5,5,76,21,55
"2021","Ealing 041E","E01001274",589,163,73,90,351,28,245,38,184,23,35,20,14,1,41,18,23,2,2,75,22,53
"2021","Ealing 041D","E01001275",908,392,104,288,433,34,217,101,102,14,109,96,11,2,63,37,26,10,10,83,15,68
"2021","Ealing 042D","E01001235",778,262,46,216,389,17,185,70,98,17,116,103,12,1,55,33,22,16,16,127,16,111
"2021","Ealing 042C","E01001236",689,242,79,163,370,28,182,76,82,24,84,67,15,2,60,28,32,16,16,77,15,62
"2021","Ealing 042A","E01034030",876,321,83,238,460,22,218,95,108,15,150,143,7,0,51,31,20,19,19,95,12,83
"2021","Ealing 042B","E01034031",636,264,46,218,343,10,228,68,150,10,73,65,8,0,23,14,9,9,9,29,6,23
"2021","Ealing 043B","E01001367",745,129,31,98,445,15,301,29,204,68,22,8,12,2,99,57,42,8,8,171,115,56
"2021","Ealing 043C","E01001372",695,101,29,72,426,22,294,37,196,61,20,6,14,0,73,40,33,17,17,168,108,60
"2021","Ealing 043A","E01001373",586,97,30,67,350,13,225,32,143,50,27,11,13,3,80,37,43,5,5,139,86,53
"2021","Ealing 044C","E01001366",559,84,36,48,359,18,241,27,144,70,10,0,5,5,81,42,39,9,9,116,79,37
"2021","Ealing 044D","E01001368",471,63,27,36,262,18,164,18,87,59,11,1,8,2,63,28,35,6,6,146,85,61
"2021","Ealing 044A","E01001370",570,71,25,46,319,23,203,33,106,64,14,2,8,4,61,25,36,18,18,180,123,57
"2021","Ealing 044B","E01001371",618,77,31,46,390,24,240,33,149,58,18,6,9,3,96,46,50,12,12,151,107,44
"2021","Enfield 001A","E01001444",651,130,57,73,441,35,180,39,91,50,42,12,21,9,173,129,44,11,11,80,52,28
"2021","Enfield 001B","E01001446",709,166,62,104,477,35,182,50,82,50,63,22,37,4,155,106,49,42,42,66,43,23
"2021","Enfield 001C","E01001546",608,112,45,67,438,24,185,27,92,66,38,13,21,4,181,106,75,10,10,58,44,14
"2021","Enfield 001D","E01001552",663,131,52,79,454,54,217,43,112,62,34,11,19,4,144,90,54,5,5,78,45,33
"2021","Enfield 002A","E01001442",635,180,60,120,401,16,156,29,85,42,32,12,16,4,189,138,51,8,8,54,30,24
"2021","Enfield 002B","E01001545",665,167,59,108,430,15,182,40,90,52,42,13,25,4,186,124,62,5,5,68,45,23
"2021","Enfield 002C","E01001547",723,161,56,105,480,35,226,49,106,71,42,14,20,8,163,103,60,14,14,82,57,25
"2021","Enfield 002D","E01001548",675,151,50,101,464,26,201,39,120,42,41,16,20,5,189,125,64,7,7,60,37,23
"2021","Enfield 002E","E01001551",640,168,55,113,401,32,154,25,82,47,42,13,22,7,164,94,70,9,9,71,37,34
"2021","Enfield 003B","E01001445",1146,354,50,304,715,22,266,65,164,37,117,52,58,7,292,227,65,18,18,77,46,31
"2021","Enfield 003C","E01001447",741,205,89,116,461,33,177,36,93,48,44,15,20,9,199,131,68,8,8,75,43,32
"2021","Enfield 003D","E01001448",671,159,53,106,434,22,185,25,97,63,49,13,31,5,170,118,52,8,8,78,50,28
"2021","Enfield 003E","E01001449",542,106,42,64,371,25,187,28,102,57,34,10,20,4,118,77,41,7,7,65,38,27
"2021","Enfield 003F","E01033148",675,124,36,88,443,11,184,29,104,51,49,20,21,8,185,145,40,14,14,108,82,26
"2021","Enfield 003G","E01033150",647,142,18,124,447,1,144,32,92,20,54,27,19,8,241,198,43,7,7,58,31,27
"2021","Enfield 004A","E01001408",711,201,73,128,478,42,235,79,127,29,84,43,37,4,111,69,42,6,6,32,14,18
"2021","Enfield 004B","E01001411",741,197,87,110,491,49,258,56,171,31,74,27,44,3,110,67,43,0,0,53,23,30
"2021","Enfield 004C","E01001412",660,152,80,72,439,61,193,44,79,70,52,20,27,5,131,75,56,2,2,69,32,37
"2021","Enfield 004D","E01001413",611,142,91,51,433,67,254,62,138,54,55,22,28,5,53,20,33,4,4,36,15,21
"2021","Enfield 004E","E01001414",692,237,122,115,412,38,142,28,87,27,47,16,24,7,180,108,72,5,5,43,24,19
"2021","Enfield 005A","E01001407",596,128,63,65,423,46,216,48,123,45,59,19,32,8,99,53,46,3,3,45,20,25
"2021","Enfield 005B","E01001409",784,263,84,179,458,19,187,42,109,36,58,28,27,3,186,127,59,8,8,63,43,20
"2021","Enfield 005C","E01001410",815,242,48,194,522,22,202,34,138,30,67,24,39,4,221,164,57,10,10,51,30,21
"2021","Enfield 005D","E01001516",670,126,54,72,454,33,214,50,119,45,48,17,23,8,150,89,61,9,9,90,69,21
"2021","Enfield 005E","E01001537",687,185,72,113,458,47,193,52,103,38,84,34,45,5,127,94,33,7,7,44,26,18
"2021","Enfield 006A","E01001439",771,178,52,126,507,28,183,44,107,32,47,14,25,8,242,186,56,7,7,86,52,34
"2021","Enfield 006B","E01001441",623,199,40,159,377,16,170,34,103,33,28,14,11,3,148,122,26,15,15,47,25,22
"2021","Enfield 006C","E01001517",686,180,52,128,446,25,173,23,99,51,33,9,21,3,205,139,66,10,10,60,44,16
"2021","Enfield 006D","E01001549",814,210,71,139,533,22,204,31,125,48,42,6,31,5,253,200,53,12,12,71,48,23
"2021","Enfield 006E","E01001550",574,101,43,58,412,26,177,31,93,53,37,6,22,9,161,105,56,11,11,61,36,25
"2021","Enfield 007A","E01001433",578,95,38,57,430,19,188,31,108,49,46,10,31,5,167,110,57,10,10,53,33,20
"2021","Enfield 007B","E01001434",541,114,48,66,362,24,177,37,94,46,30,13,11,6,127,90,37,4,4,65,41,24
"2021","Enfield 007C","E01001435",485,71,40,31,355,39,167,33,82,52,20,7,11,2,119,71,48,10,10,59,31,28
"2021","Enfield 007D","E01001436",649,104,50,54,460,43,199,35,109,55,30,11,16,3,178,118,60,10,10,85,43,42
"2021","Enfield 007E","E01001438",550,97,24,73,395,24,186,30,92,64,27,12,10,5,144,96,48,14,14,58,27,31
"2021","Enfield 008A","E01001469",673,169,68,101,432,45,217,48,119,50,63,26,30,7,100,61,39,7,7,72,33,39
"2021","Enfield 008B","E01001536",851,266,114,152,535,64,237,70,131,36,99,65,29,5,125,81,44,10,10,50,18,32
"2021","Enfield 008C","E01001540",798,254,90,164,486,48,244,66,142,36,76,42,26,8,106,69,37,12,12,58,35,23
"2021","Enfield 008D","E01001541",647,199,80,119,425,40,230,59,133,38,79,37,36,6,74,51,23,2,2,23,10,13
"2021","Enfield 008E","E01001542",658,201,95,106,416,36,171,42,98,31,58,31,24,3,144,92,52,7,7,41,17,24
"2021","Enfield 009A","E01001538",599,97,58,39,456,75,269,64,129,76,44,14,23,7,64,28,36,4,4,46,27,19
"2021","Enfield 009B","E01001539",642,153,78,75,455,57,264,61,142,61,54,24,28,2,71,37,34,9,9,34,18,16
"2021","Enfield 009C","E01001543",578,100,58,42,419,63,244,56,119,69,35,19,14,2,71,37,34,6,6,59,35,24
"2021","Enfield 009D","E01001544",639,146,88,58,440,66,269,59,128,82,39,21,16,2,64,30,34,2,2,53,26,27
"2021","Enfield 010A","E01001457",843,342,128,214,469,65,258,74,149,35,69,45,24,0,69,49,20,8,8,32,13,19
"2021","Enfield 010B","E01001468",579,172,98,74,364,60,198,44,120,34,45,15,26,4,56,32,24,5,5,43,15,28
"2021","Enfield 010C","E01001471",970,414,167,247,519,71,201,75,102,24,95,66,25,4,149,100,49,3,3,37,19,18
"2021","Enfield 010D","E01001472",757,254,108,146,459,63,217,70,110,37,75,53,18,4,98,66,32,6,6,44,17,27
"2021","Enfield 010E","E01001474",861,294,125,169,520,104,251,72,129,50,73,45,26,2,86,54,32,6,6,47,21,26
"2021","Enfield 011A","E01001415",871,293,156,137,513,65,274,62,160,52,68,49,17,2,98,65,33,8,8,65,25,40
"2021","Enfield 011B","E01001417",664,117,64,53,488,100,294,78,156,60,36,17,13,6,54,15,39,4,4,59,32,27
"2021","Enfield 011C","E01001418",722,231,137,94,441,64,240,38,127,75,40,21,15,4,90,61,29,7,7,50,24,26
"2021","Enfield 011D","E01001422",615,128,83,45,436,103,270,60,124,86,27,11,13,3,30,13,17,6,6,51,32,19
"2021","Enfield 012A","E01001440",572,142,72,70,351,31,184,25,102,57,26,11,12,3,107,74,33,3,3,79,41,38
"2021","Enfield 012B","E01001504",560,90,34,56,375,32,200,30,119,51,22,9,8,5,115,76,39,6,6,95,77,18
"2021","Enfield 012C","E01001505",597,118,29,89,373,12,179,32,94,53,27,8,15,4,148,89,59,7,7,106,74,32
"2021","Enfield 012D","E01001507",810,263,75,188,465,28,235,26,155,54,40,17,19,4,157,121,36,5,5,82,40,42
"2021","Enfield 012E","E01001508",786,184,45,139,500,23,237,34,159,44,45,17,25,3,180,129,51,15,15,102,55,47
"2021","Enfield 012F","E01001513",723,174,68,106,486,19,194,35,101,58,55,18,28,9,212,158,54,6,6,63,43,20
"2021","Enfield 013A","E01001416",592,104,73,31,434,60,315,69,150,96,21,7,11,3,35,11,24,3,3,54,31,23
"2021","Enfield 013B","E01001470",650,155,100,55,450,87,245,60,125,60,47,21,21,5,68,36,32,3,3,45,22,23
"2021","Enfield 013C","E01001473",545,104,72,32,390,56,211,45,109,57,35,15,15,5,85,38,47,3,3,51,33,18
"2021","Enfield 013D","E01001475",638,103,70,33,483,93,287,50,162,75,35,15,17,3,63,29,34,5,5,52,23,29
"2021","Enfield 014A","E01001437",897,268,83,185,556,27,213,44,118,51,53,16,29,8,252,198,54,11,11,73,46,27
"2021","Enfield 014C","E01001509",645,174,51,123,403,18,162,30,101,31,31,12,17,2,178,138,40,14,14,68,43,25
"2021","Enfield 014E","E01033926",980,287,51,236,614,11,235,54,137,44,83,42,37,4,261,192,69,24,24,79,46,33
"2021","Enfield 015A","E01001405",829,364,183,181,425,97,183,56,93,34,71,44,25,2,70,37,33,4,4,40,21,19
"2021","Enfield 015B","E01001406",654,162,43,119,420,34,194,40,106,48,59,39,17,3,126,72,54,7,7,72,39,33
"2021","Enfield 015C","E01001450",1112,390,156,234,653,49,254,95,125,34,112,78,28,6,228,162,66,10,10,69,29,40
"2021","Enfield 015D","E01001512",993,339,82,257,594,29,294,85,172,37,117,74,37,6,148,107,41,6,6,60,25,35
"2021","Enfield 015E","E01001515",748,214,36,178,445,17,162,31,104,27,57,23,29,5,203,132,71,6,6,89,56,33
"2021","Enfield 016A","E01001401",500,107,59,48,352,41,202,29,115,58,36,15,18,3,70,39,31,3,3,41,20,21
"2021","Enfield 016B","E01001478",571,133,60,73,366,29,171,36,79,56,34,10,23,1,127,66,61,5,5,72,46,26
"2021","Enfield 016C","E01001484",502,112,57,55,331,32,161,28,92,41,22,5,16,1,106,65,41,10,10,59,33,26
"2021","Enfield 016D","E01001511",670,150,69,81,430,28,217,40,127,50,56,24,29,3,124,87,37,5,5,90,48,42
"2021","Enfield 016E","E01001514",670,152,47,105,451,27,211,44,122,45,68,40,26,2,143,98,45,2,2,67,36,31
"2021","Enfield 016F","E01001518",661,177,63,114,427,45,212,46,115,51,50,33,11,6,113,71,42,7,7,57,30,27
"2021","Enfield 017A","E01001451",694,204,92,112,441,85,231,55,114,62,56,30,21,5,67,33,34,2,2,49,21,28
"2021","Enfield 017B","E01001452",484,84,40,44,355,73,206,45,104,57,35,12,21,2,40,18,22,1,1,45,21,24
"2021","Enfield 017C","E01001453",647,156,88,68,452,95,270,69,140,61,39,18,15,6,45,25,20,3,3,39,16,23
"2021","Enfield 017D","E01001454",667,173,118,55,452,88,264,56,148,60,32,12,17,3,65,37,28,3,3,42,19,23
"2021","Enfield 018A","E01001476",612,122,61,61,424,39,209,39,111,59,37,15,22,0,132,91,41,7,7,66,34,32
"2021","Enfield 018B","E01001477",612,122,56,66,392,35,189,27,103,59,21,5,16,0,135,88,47,12,12,98,62,36
"2021","Enfield 018C","E01001481",559,116,52,64,372,28,172,19,94,59,31,8,20,3,120,69,51,21,21,71,45,26
"2021","Enfield 018D","E01001502",657,144,59,85,435,26,201,31,105,65,36,16,19,1,164,100,64,8,8,78,41,37
"2021","Enfield 018E","E01001503",644,130,71,59,446,46,203,42,107,54,35,15,16,4,155,101,54,7,7,68,41,27
"2021","Enfield 019A","E01001520",697,200,71,129,404,49,209,46,110,53,47,26,15,6,89,59,30,10,10,93,64,29
"2021","Enfield 019B","E01001522",746,224,60,164,484,24,248,54,159,35,65,33,31,1,140,106,34,7,7,38,21,17
"2021","Enfield 019C","E01001523",725,212,129,83,456,58,261,51,162,48,47,26,18,3,85,52,33,5,5,57,33,24
"2021","Enfield 019D","E01001524",551,124,46,78,368,31,198,30,106,62,39,19,12,8,98,41,57,2,2,59,30,29
"2021","Enfield 019E","E01001526",636,173,105,68,407,58,250,58,121,71,39,17,19,3,57,36,21,3,3,56,25,31
"2021","Enfield 020A","E01001419",769,201,97,104,484,73,253,59,137,57,55,29,22,4,96,62,34,7,7,84,40,44
"2021","Enfield 020B","E01001420",634,162,77,85,396,29,206,46,108,52,36,11,19,6,117,63,54,8,8,76,48,28
"2021","Enfield 020C","E01001421",626,197,109,88,369,34,205,40,126,39,44,19,20,5,79,45,34,7,7,60,31,29
"2021","Enfield 020E","E01001525",760,213,98,115,464,47,245,53,154,38,69,35,29,5,96,63,33,7,7,83,34,49
"2021","Enfield 020F","E01033927",679,212,68,144,379,13,187,54,113,20,63,40,22,1,101,79,22,15,15,88,37,51
"2021","Enfield 020G","E01033928",574,187,51,136,342,20,173,51,96,26,60,41,17,2,75,51,24,14,14,45,18,27
"2021","Enfield 021A","E01001398",496,93,51,42,373,46,221,53,109,59,46,23,20,3,58,31,27,2,2,30,14,16
"2021","Enfield 021B","E01001399",500,105,60,45,327,53,207,45,82,80,22,9,10,3,41,16,25,4,4,68,45,23
"2021","Enfield 021C","E01001400",576,122,87,35,413,98,229,55,94,80,25,10,11,4,58,28,30,3,3,41,19,22
"2021","Enfield 021D","E01001402",699,182,92,90,436,57,267,69,124,74,47,32,9,6,61,30,31,4,4,81,34,47
"2021","Enfield 021E","E01001403",644,222,129,93,348,53,186,40,88,58,32,12,17,3,75,41,34,2,2,74,43,31
"2021","Enfield 021F","E01001455",564,140,62,78,366,56,199,52,98,49,36,17,16,3,71,33,38,4,4,58,23,35
"2021","Enfield 022A","E01001456",492,80,46,34,375,55,255,48,136,71,28,14,10,4,30,14,16,7,7,37,13,24
"2021","Enfield 022B","E01001564",640,168,69,99,439,34,266,63,153,50,68,44,18,6,66,39,27,5,5,33,12,21
"2021","Enfield 022C","E01001567",607,161,99,62,406,61,259,61,143,55,39,21,13,5,45,23,22,2,2,40,15,25
"2021","Enfield 022D","E01001568",570,92,65,27,374,77,244,46,119,79,12,7,2,3,38,7,31,3,3,104,68,36
"2021","Enfield 022E","E01001569",750,232,85,147,457,48,227,63,123,41,86,48,33,5,86,54,32,10,10,61,17,44
"2021","Enfield 023A","E01001479",641,185,64,121,379,23,160,29,88,43,51,17,30,4,131,87,44,14,14,77,40,37
"2021","Enfield 023B","E01001482",657,155,64,91,433,26,206,33,115,58,45,9,29,7,150,98,52,6,6,69,43,26
"2021","Enfield 023C","E01001487",668,173,76,97,408,16,178,26,104,48,33,7,21,5,170,112,58,11,11,87,47,40
"2021","Enfield 023D","E01001489",655,167,70,97,406,26,180,30,116,34,40,13,25,2,144,101,43,16,16,82,51,31
"2021","Enfield 023E","E01001491",687,167,56,111,436,13,197,34,105,58,42,17,20,5,172,105,67,12,12,84,40,44
"2021","Enfield 024A","E01001459",556,109,48,61,366,50,201,36,107,58,21,7,9,5,89,49,40,5,5,81,52,29
"2021","Enfield 024B","E01001460",672,173,36,137,382,14,156,35,84,37,58,19,37,2,136,100,36,18,18,117,79,38
"2021","Enfield 024C","E01001462",530,143,36,107,324,15,124,19,68,37,25,7,12,6,154,78,76,6,6,63,32,31
"2021","Enfield 024D","E01001480",577,168,53,115,348,30,186,41,95,50,27,13,13,1,99,66,33,6,6,61,44,17
"2021","Enfield 024E","E01001488",665,166,65,101,404,16,170,29,87,54,54,13,34,7,156,105,51,8,8,95,56,39
"2021","Enfield 025A","E01001483",532,207,41,166,298,15,89,31,40,18,30,15,14,1,153,121,32,11,11,27,15,12
"2021","Enfield 025B","E01001485",663,196,90,106,387,21,167,30,99,38,27,8,16,3,160,93,67,12,12,80,43,37
"2021","Enfield 025C","E01001486",806,214,86,128,514,16,220,61,90,69,52,12,29,11,215,143,72,11,11,78,46,32
"2021","Enfield 025E","E01001492",666,138,58,80,431,37,194,32,108,54,27,11,9,7,157,100,57,16,16,97,50,47
"2021","Enfield 025F","E01033146",559,151,34,117,351,10,142,30,82,30,37,10,20,7,153,99,54,9,9,57,41,16
"2021","Enfield 025G","E01033151",502,125,41,84,339,20,129,21,77,31,36,10,21,5,151,104,47,3,3,38,26,12
"2021","Enfield 026A","E01001404",514,109,52,57,342,40,208,35,110,63,29,9,13,7,55,33,22,10,10,63,35,28
"2021","Enfield 026B","E01001493",731,222,85,137,399,57,181,53,89,39,47,21,24,2,109,61,48,5,5,110,57,53
"2021","Enfield 026C","E01001494",501,88,52,36,347,62,186,31,102,53,29,5,22,2,64,22,42,6,6,66,32,34
"2021","Enfield 026D","E01001496",638,141,71,70,405,59,221,46,110,65,48,20,25,3,63,26,37,14,14,92,45,47
"2021","Enfield 026E","E01001570",726,192,80,112,462,28,227,45,145,37,62,27,29,6,138,74,64,7,7,72,39,33
"2021","Enfield 027A","E01001423",623,183,87,96,376,33,174,33,103,38,43,8,31,4,113,68,45,13,13,64,38,26
"2021","Enfield 027B","E01001425",739,225,56,169,433,15,173,28,112,33,49,15,26,8,177,127,50,19,19,81,51,30
"2021","Enfield 027C","E01001428",569,144,47,97,339,11,156,25,92,39,38,9,24,5,124,72,52,10,10,86,51,35
"2021","Enfield 027D","E01001461",629,224,75,149,339,27,133,32,71,30,21,7,12,2,145,90,55,13,13,66,35,31
"2021","Enfield 027E","E01001464",420,88,43,45,262,13,135,29,60,46,22,8,10,4,84,36,48,8,8,70,41,29
"2021","Enfield 028A","E01001521",684,129,58,71,493,57,300,62,183,55,54,29,23,2,76,40,36,6,6,62,24,38
"2021","Enfield 028B","E01001531",530,112,51,61,361,50,226,57,114,55,38,21,14,3,42,21,21,5,5,57,23,34
"2021","Enfield 028C","E01001532",663,175,86,89,433,62,263,67,137,59,56,37,17,2,44,19,25,8,8,55,25,30
"2021","Enfield 028D","E01001533",542,94,66,28,385,83,250,46,121,83,17,8,8,1,34,10,24,1,1,63,39,24
"2021","Enfield 028E","E01001535",500,99,58,41,327,62,185,35,93,57,25,5,17,3,49,14,35,6,6,74,33,41
"2021","Enfield 029A","E01001495",724,186,50,136,441,46,224,63,122,39,87,59,21,7,72,46,26,12,12,97,44,53
"2021","Enfield 029B","E01001498",695,169,55,114,430,29,228,58,120,50,88,42,45,1,72,38,34,13,13,96,34,62
"2021","Enfield 029C","E01001563",702,196,63,133,436,26,236,60,138,38,86,46,34,6,73,45,28,15,15,70,22,48
"2021","Enfield 029D","E01001565",707,224,96,128,418,51,211,54,113,44,65,42,21,2,78,41,37,13,13,65,32,33
"2021","Enfield 029E","E01001566",626,149,52,97,413,36,240,75,105,60,70,32,34,4,59,36,23,8,8,64,25,39
"2021","Enfield 030A","E01001424",476,129,34,95,310,6,103,24,54,25,47,20,23,4,148,93,55,6,6,37,23,14
"2021","Enfield 030B","E01001426",621,145,49,96,392,12,169,33,90,46,40,16,19,5,161,101,60,10,10,84,45,39
"2021","Enfield 030C","E01001427",644,207,64,143,366,13,144,24,80,40,29,11,9,9,173,106,67,7,7,71,51,20
"2021","Enfield 030D","E01001429",1014,410,146,264,549,27,212,48,128,36,55,15,32,8,235,164,71,20,20,55,26,29
"2021","Enfield 030E","E01001430",650,136,45,91,443,6,190,28,115,47,37,6,29,2,200,120,80,10,10,71,41,30
"2021","Enfield 031A","E01001463",515,86,40,46,362,34,182,33,85,64,32,9,17,6,106,48,58,8,8,67,39,28
"2021","Enfield 031B","E01001465",504,90,49,41,341,37,186,35,86,65,28,10,16,2,84,46,38,6,6,73,28,45
"2021","Enfield 031C","E01001466",624,131,44,87,391,25,171,31,104,36,46,11,26,9,140,96,44,9,9,102,67,35
"2021","Enfield 031D","E01001467",666,115,42,73,465,17,233,34,150,49,30,11,14,5,180,136,44,5,5,86,50,36
"2021","Enfield 031E","E01001497",508,120,69,51,324,26,193,33,98,62,24,7,14,3,74,40,34,7,7,64,42,22
"2021","Enfield 031F","E01001499",539,124,56,68,340,41,201,37,88,76,20,14,4,2,72,27,45,6,6,75,36,39
"2021","Enfield 032A","E01001392",666,149,76,73,392,47,213,47,117,49,55,31,21,3,69,34,35,8,8,125,40,85
"2021","Enfield 032B","E01001528",678,199,36,163,411,12,155,42,85,28,64,39,20,5,172,105,67,8,8,68,32,36
"2021","Enfield 032C","E01001529",654,216,43,173,322,14,138,32,86,20,48,29,17,2,106,65,41,16,16,116,59,57
"2021","Enfield 032D","E01001530",617,147,40,107,387,33,179,28,111,40,48,23,23,2,120,76,44,7,7,83,36,47
"2021","Enfield 032E","E01001534",603,119,51,68,394,61,208,48,106,54,49,23,21,5,58,29,29,18,18,90,42,48
"2021","Enfield 033A","E01001431",651,197,36,161,385,16,157,32,103,22,32,11,18,3,162,109,53,18,18,69,42,27
"2021","Enfield 033B","E01001432",730,284,131,153,347,11,143,26,79,38,28,6,16,6,144,84,60,21,21,99,62,37
"2021","Enfield 033C","E01001555",770,158,47,111,514,26,260,40,177,43,46,16,23,7,173,107,66,9,9,98,46,52
"2021","Enfield 033D","E01001557",548,95,33,62,362,30,166,28,97,41,39,8,28,3,118,63,55,9,9,91,55,36
"2021","Enfield 033E","E01001558",606,109,36,73,405,5,197,40,120,37,38,11,19,8,146,100,46,19,19,92,55,37
"2021","Enfield 033F","E01001559",672,132,38,94,428,21,189,33,110,46,33,11,17,5,172,125,47,13,13,112,65,47
"2021","Enfield 035A","E01001394",671,185,74,111,341,37,166,30,93,43,39,22,15,2,75,43,32,24,24,145,46,99
"2021","Enfield 035B","E01001395",598,148,51,97,361,28,156,27,86,43,31,12,15,4,142,76,66,4,4,89,40,49
"2021","Enfield 035C","E01001397",770,184,48,136,473,24,237,47,134,56,60,34,23,3,138,93,45,14,14,113,72,41
"2021","Enfield 035D","E01001500",550,115,58,57,344,34,183,53,84,46,45,25,15,5,76,37,39,6,6,91,60,31
"2021","Enfield 035E","E01001556",532,103,51,52,333,40,175,28,75,72,23,10,9,4,87,49,38,8,8,96,57,39
"2021","Enfield 035F","E01001560",511,86,38,48,337,35,158,26,68,64,17,4,10,3,115,58,57,12,12,88,55,33
"2021","Enfield 036A","E01001390",715,178,56,122,423,25,240,76,114,50,76,50,25,1,67,36,31,15,15,114,23,91
"2021","Enfield 036B","E01001391",734,212,43,169,400,19,183,67,86,30,84,54,28,2,99,62,37,15,15,122,32,90
"2021","Enfield 036C","E01001393",816,257,55,202,443,25,197,54,113,30,111,71,37,3,87,56,31,23,23,116,29,87
"2021","Enfield 036D","E01001396",523,113,51,62,314,32,157,33,73,51,43,27,12,4,67,36,31,15,15,96,36,60
"2021","Enfield 036E","E01001501",920,296,94,202,532,20,253,74,134,45,104,60,41,3,136,84,52,19,19,92,38,54
"2021","Enfield 036F","E01001527",784,213,95,118,461,45,243,64,127,52,70,45,22,3,89,52,37,14,14,110,64,46
"2021","Enfield 037A","E01001458",642,167,63,104,396,12,144,27,86,31,52,17,30,5,166,95,71,22,22,79,46,33
"2021","Enfield 037B","E01001553",544,118,35,83,336,20,171,24,102,45,22,8,13,1,110,58,52,13,13,90,61,29
"2021","Enfield 037C","E01001554",686,203,54,149,418,5,171,30,84,57,37,15,18,4,194,125,69,11,11,65,43,22
"2021","Enfield 037D","E01001562",823,225,37,188,509,12,205,43,128,34,52,19,29,4,225,139,86,15,15,89,56,33
"2021","Enfield 037E","E01032574",693,160,64,96,428,24,195,33,115,47,44,12,26,6,155,99,56,10,10,105,53,52
"2021","Greenwich 001A","E01001690",815,417,81,336,337,23,128,36,64,28,55,20,30,5,121,84,37,10,10,61,33,28
"2021","Greenwich 001B","E01001692",555,169,37,132,336,9,117,20,61,36,38,8,23,7,161,116,45,11,11,50,23,27
"2021","Greenwich 001C","E01001693",615,212,47,165,331,10,100,23,62,15,39,8,27,4,171,125,46,11,11,72,33,39
"2021","Greenwich 001D","E01001694",610,168,39,129,355,13,182,35,106,41,44,17,21,6,108,69,39,8,8,87,52,35
"2021","Greenwich 002A","E01001687",511,196,54,142,270,9,123,29,66,28,37,18,16,3,93,60,33,8,8,45,26,19
"2021","Greenwich 002B","E01001688",935,249,47,202,585,8,253,44,167,42,91,22,65,4,214,163,51,19,19,101,48,53
"2021","Greenwich 002E","E01033739",650,152,10,142,415,3,161,47,101,13,79,35,43,1,148,94,54,24,24,83,48,35
"2021","Greenwich 002F","E01033740",548,121,10,111,337,8,173,33,113,27,44,15,25,4,101,79,22,11,11,90,53,37
"2021","Greenwich 002G","E01033741",637,168,9,159,380,2,181,53,106,22,51,20,27,4,133,88,45,13,13,89,54,35
"2021","Greenwich 002H","E01033743",664,147,47,100,429,6,190,41,120,29,60,19,35,6,160,122,38,13,13,88,51,37
"2021","Greenwich 002I","E01033745",589,97,20,77,432,8,232,48,135,49,47,13,30,4,134,99,35,11,11,60,32,28
"2021","Greenwich 003A","E01001575",620,155,52,103,402,13,152,29,98,25,50,14,30,6,174,124,50,13,13,63,40,23
"2021","Greenwich 003B","E01001576",668,175,54,121,398,17,168,26,101,41,62,19,40,3,144,94,50,7,7,95,53,42
"2021","Greenwich 003C","E01001577",728,222,67,155,430,15,190,30,125,35,51,16,30,5,160,110,50,14,14,76,48,28
"2021","Greenwich 003D","E01001578",848,211,57,154,473,23,185,44,107,34,92,47,41,4,149,96,53,24,24,164,80,84
"2021","Greenwich 003E","E01001579",623,152,53,99,403,18,163,31,93,39,46,11,34,1,163,87,76,13,13,68,40,28
"2021","Greenwich 005A","E01001705",845,235,26,209,516,8,193,48,106,39,90,48,33,9,201,143,58,24,24,94,41,53
"2021","Greenwich 005C","E01001708",682,182,50,132,435,34,205,62,110,33,76,51,20,5,112,69,43,8,8,65,27,38
"2021","Greenwich 005D","E01001710",648,198,58,140,373,8,131,29,77,25,48,13,31,4,168,111,57,18,18,77,42,35
"2021","Greenwich 005F","E01034173",637,164,39,125,381,21,143,29,70,44,56,17,34,5,148,91,57,13,13,92,48,44
"2021","Greenwich 006A","E01001672",640,156,42,114,346,12,177,45,91,41,38,16,16,6,105,68,37,14,14,138,80,58
"2021","Greenwich 006B","E01001673",799,272,102,170,360,30,163,52,70,41,34,21,11,2,117,66,51,16,16,167,106,61
"2021","Greenwich 006C","E01001674",712,154,59,95,418,43,194,53,99,42,58,30,27,1,115,75,40,8,8,140,79,61
"2021","Greenwich 006D","E01001675",699,159,34,125,374,12,170,43,89,38,36,22,10,4,117,69,48,39,39,166,104,62
"2021","Greenwich 006E","E01001677",730,182,54,128,419,20,192,46,94,52,68,43,21,4,126,83,43,13,13,129,82,47
"2021","Greenwich 007B","E01001631",788,251,43,208,445,6,144,25,98,21,85,42,38,5,192,115,77,18,18,92,53,39
"2021","Greenwich 007C","E01001632",664,153,38,115,364,10,189,55,92,42,51,31,15,5,100,48,52,14,14,147,74,73
"2021","Greenwich 007D","E01001635",643,190,53,137,364,16,172,41,95,36,68,39,27,2,96,43,53,12,12,89,46,43
"2021","Greenwich 007E","E01001636",599,182,65,117,313,22,156,41,80,35,50,31,16,3,73,47,26,12,12,104,54,50
"2021","Greenwich 007F","E01033742",566,148,23,125,329,3,134,60,68,6,100,66,32,2,79,55,24,13,13,89,19,70
"2021","Greenwich 007G","E01033744",659,188,30,158,384,10,154,48,78,28,86,44,40,2,122,86,36,12,12,87,34,53
"2021","Greenwich 008A","E01001571",627,145,54,91,374,23,167,36,81,50,66,32,29,5,111,74,37,7,7,108,61,47
"2021","Greenwich 008B","E01001572",651,158,55,103,406,33,194,49,95,50,76,45,27,4,92,53,39,11,11,87,44,43
"2021","Greenwich 008C","E01001573",526,111,35,76,341,24,188,46,74,68,48,25,17,6,72,37,35,9,9,74,37,37
"2021","Greenwich 008D","E01001574",753,266,65,201,433,16,147,32,89,26,81,23,53,5,178,138,40,11,11,54,32,22
"2021","Greenwich 009A","E01001629",839,243,67,176,493,21,173,42,98,33,103,59,40,4,184,126,58,12,12,103,46,57
"2021","Greenwich 009B","E01001633",773,255,59,196,408,18,153,36,83,34,68,39,27,2,158,104,54,11,11,110,55,55
"2021","Greenwich 009C","E01001634",657,206,56,150,381,14,141,35,79,27,50,19,22,9,161,102,59,15,15,70,37,33
"2021","Greenwich 009D","E01001637",684,227,46,181,357,18,149,38,77,34,59,25,31,3,122,78,44,9,9,100,55,45
"2021","Greenwich 011A","E01001695",562,187,44,143,273,9,108,24,64,20,54,27,20,7,93,56,37,9,9,102,47,55
"2021","Greenwich 011B","E01001696",1142,386,39,347,651,8,221,89,115,17,165,130,33,2,219,158,61,38,38,105,35,70
"2021","Greenwich 011C","E01001697",938,266,37,229,532,11,234,56,127,51,97,48,47,2,172,118,54,18,18,140,68,72
"2021","Greenwich 011D","E01001700",798,240,43,197,401,13,165,48,102,15,91,50,36,5,122,83,39,10,10,157,92,65
"2021","Greenwich 011E","E01001703",763,250,37,213,444,6,186,20,142,24,61,20,35,6,178,121,57,13,13,69,37,32
"2021","Greenwich 011F","E01001704",618,177,54,123,354,30,157,49,77,31,65,25,36,4,94,56,38,8,8,87,38,49
"2021","Greenwich 012A","E01001588",635,208,103,105,337,29,156,39,74,43,69,45,19,5,79,40,39,4,4,90,44,46
"2021","Greenwich 012B","E01001589",677,175,51,124,403,19,180,60,85,35,77,42,31,4,113,67,46,14,14,99,39,60
"2021","Greenwich 012C","E01001591",808,281,70,211,432,25,174,44,105,25,82,47,32,3,139,89,50,12,12,95,52,43
"2021","Greenwich 012D","E01001595",732,150,48,102,485,29,205,38,125,42,65,26,34,5,175,125,50,11,11,97,60,37
"2021","Greenwich 014A","E01001590",716,217,54,163,405,21,200,76,85,39,86,59,21,6,85,56,29,13,13,94,30,64
"2021","Greenwich 014B","E01001592",738,172,51,121,481,28,264,67,168,29,99,67,30,2,73,40,33,17,17,85,23,62
"2021","Greenwich 014C","E01001593",763,232,96,136,463,25,269,90,150,29,107,61,42,4,58,28,30,4,4,68,23,45
"2021","Greenwich 014D","E01001594",834,240,72,168,476,14,180,28,118,34,85,45,34,6,185,107,78,12,12,118,33,85
"2021","Greenwich 015A","E01001698",755,264,34,230,414,5,154,47,85,22,60,31,25,4,180,122,58,15,15,77,44,33
"2021","Greenwich 015B","E01001699",664,285,14,271,332,0,147,54,79,14,78,55,18,5,100,69,31,7,7,47,19,28
"2021","Greenwich 015C","E01001701",777,288,98,190,438,19,221,77,130,14,104,77,24,3,87,56,31,7,7,51,21,30
"2021","Greenwich 015D","E01001702",438,81,35,46,283,13,110,19,57,34,29,8,13,8,126,73,53,5,5,74,38,36
"2021","Greenwich 016A","E01001581",728,262,100,162,407,26,197,77,94,26,103,76,22,5,70,34,36,11,11,59,14,45
"2021","Greenwich 016B","E01001585",601,149,51,98,411,25,248,73,147,28,75,50,24,1,59,39,20,4,4,41,8,33
"2021","Greenwich 016C","E01001586",663,263,104,159,360,42,159,47,87,25,73,49,22,2,80,40,40,6,6,40,11,29
"2021","Greenwich 016D","E01001587",951,355,93,262,529,46,260,116,117,27,145,120,21,4,75,47,28,3,3,67,23,44
"2021","Greenwich 017A","E01001678",645,139,58,81,433,41,213,45,102,66,53,20,27,6,122,80,42,4,4,73,39,34
"2021","Greenwich 017B","E01001683",599,193,56,137,342,24,175,38,107,30,49,24,20,5,89,49,40,5,5,64,34,30
"2021","Greenwich 017C","E01001684",566,147,66,81,370,40,164,52,72,40,52,20,25,7,107,63,44,7,7,49,25,24
"2021","Greenwich 017D","E01001685",651,198,69,129,373,45,165,51,77,37,57,28,21,8,99,54,45,7,7,80,31,49
"2021","Greenwich 019A","E01001646",1134,323,63,260,689,13,286,82,155,49,139,74,57,8,227,149,78,24,24,122,54,68
"2021","Greenwich 019B","E01001650",611,133,70,63,380,28,190,30,111,49,55,19,29,7,102,49,53,5,5,98,60,38
"2021","Greenwich 019C","E01001651",746,263,71,192,392,25,158,35,94,29,78,25,47,6,125,87,38,6,6,91,39,52
"2021","Greenwich 019D","E01001652",707,239,112,127,397,32,211,76,98,37,97,59,28,10,51,32,19,6,6,71,26,45
"2021","Greenwich 020A","E01001679",554,171,59,112,342,27,189,51,97,41,65,31,30,4,58,38,20,3,3,41,18,23
"2021","Greenwich 020B","E01001680",616,160,77,83,415,68,224,63,116,45,63,35,24,4,54,27,27,6,6,41,17,24
"2021","Greenwich 020C","E01001681",526,138,55,83,331,19,156,48,82,26,91,19,64,8,59,36,23,6,6,57,28,29
"2021","Greenwich 020D","E01001682",550,148,66,82,352,46,163,63,76,24,51,27,22,2,86,46,40,6,6,50,20,30
"2021","Greenwich 020E","E01001686",754,242,63,179,423,16,200,89,82,29,66,32,30,4,112,86,26,29,29,89,37,52
"2021","Greenwich 021A","E01001580",790,277,72,205,460,40,243,105,118,20,120,101,15,4,50,31,19,7,7,53,12,41
"2021","Greenwich 021B","E01001582",661,242,102,140,367,41,181,49,105,27,45,16,23,6,91,60,31,9,9,52,24,28
"2021","Greenwich 021C","E01001583",766,301,90,211,432,34,203,84,99,20,136,105,22,9,50,32,18,9,9,33,8,25
"2021","Greenwich 021D","E01001584",663,212,73,139,414,56,232,85,128,19,81,66,15,0,42,23,19,3,3,37,8,29
"2021","Greenwich 022A","E01001645",707,188,73,115,442,38,222,59,99,64,62,20,34,8,114,68,46,6,6,77,33,44
"2021","Greenwich 022B","E01001647",565,139,71,68,356,34,191,57,97,37,47,21,21,5,83,38,45,1,1,70,29,41
"2021","Greenwich 022C","E01001648",695,210,54,156,406,33,212,61,108,43,76,50,26,0,73,47,26,12,12,79,34,45
"2021","Greenwich 022D","E01001649",573,152,45,107,367,29,184,40,96,48,48,15,27,6,100,58,42,6,6,54,27,27
"2021","Greenwich 023A","E01001605",566,111,69,42,417,66,251,58,128,65,49,23,24,2,47,17,30,4,4,38,17,21
"2021","Greenwich 023B","E01001606",608,106,66,40,464,48,271,66,147,58,82,37,37,8,60,25,35,3,3,38,18,20
"2021","Greenwich 023C","E01001610",702,167,88,79,501,63,256,73,143,40,93,43,44,6,87,46,41,2,2,34,13,21
"2021","Greenwich 023D","E01001611",712,224,103,121,428,41,222,57,125,40,67,23,38,6,92,47,45,6,6,60,33,27
"2021","Greenwich 025A","E01001620",501,90,49,41,327,30,150,29,76,45,46,10,28,8,96,49,47,5,5,84,48,36
"2021","Greenwich 025B","E01001621",669,201,85,116,403,32,190,51,97,42,73,42,23,8,100,50,50,8,8,65,38,27
"2021","Greenwich 025C","E01001623",670,143,54,89,455,23,215,61,122,32,85,58,21,6,122,63,59,10,10,72,33,39
"2021","Greenwich 025D","E01001624",624,160,85,75,399,38,178,50,90,38,76,40,29,7,103,42,61,4,4,65,41,24
"2021","Greenwich 025E","E01001625",617,141,74,67,410,29,191,43,107,41,53,21,24,8,131,70,61,6,6,66,36,30
"2021","Greenwich 027A","E01001604",599,152,69,83,385,42,211,57,115,39,66,32,29,5,62,36,26,4,4,62,26,36
"2021","Greenwich 027B","E01001607",669,195,96,99,435,49,220,66,109,45,81,41,34,6,81,38,43,4,4,39,23,16
"2021","Greenwich 027C","E01001608",585,182,103,79,370,70,217,44,119,54,38,19,16,3,42,22,20,3,3,33,14,19
"2021","Greenwich 027D","E01001609",739,289,142,147,392,48,220,53,101,66,62,42,19,1,59,36,23,3,3,58,24,34
"2021","Greenwich 028A","E01001613",798,325,134,191,410,49,185,52,99,34,79,38,34,7,88,62,26,9,9,63,38,25
"2021","Greenwich 028B","E01001614",546,97,53,44,400,86,234,63,109,62,41,18,17,6,36,14,22,3,3,49,17,32
"2021","Greenwich 028C","E01001615",939,393,124,269,477,36,233,86,116,31,117,79,32,6,82,61,21,9,9,69,27,42
"2021","Greenwich 028D","E01001617",735,265,149,116,429,80,186,45,94,47,91,47,38,6,62,31,31,10,10,41,16,25
"2021","Greenwich 029A","E01001653",600,153,63,90,378,25,152,37,85,30,46,16,24,6,145,95,50,10,10,69,37,32
"2021","Greenwich 029B","E01001654",570,140,51,89,369,25,148,32,82,34,56,19,33,4,132,87,45,8,8,61,32,29
"2021","Greenwich 029C","E01001655",632,215,53,162,358,19,156,38,88,30,56,26,23,7,120,81,39,7,7,59,35,24
"2021","Greenwich 029D","E01001660",564,113,47,66,385,35,156,30,85,41,64,27,32,5,119,65,54,11,11,66,40,26
"2021","Greenwich 029E","E01001661",578,109,59,50,401,46,183,43,109,31,41,19,14,8,126,84,42,5,5,68,42,26
"2021","Greenwich 030C","E01001618",758,193,84,109,506,53,251,71,125,55,82,34,40,8,116,76,40,4,4,59,22,37
"2021","Greenwich 030D","E01001619",828,227,72,155,542,44,267,84,146,37,117,76,37,4,110,59,51,4,4,59,18,41
"2021","Greenwich 030E","E01033729",759,280,101,179,400,27,166,43,87,36,74,16,51,7,126,81,45,7,7,79,43,36
"2021","Greenwich 031A","E01001597",635,185,84,101,391,53,212,70,100,42,62,42,17,3,59,28,31,5,5,59,25,34
"2021","Greenwich 031B","E01001598",606,139,77,62,410,67,236,59,112,65,51,24,24,3,53,20,33,3,3,57,28,29
"2021","Greenwich 031C","E01001602",716,161,79,82,473,29,241,55,116,70,60,12,37,11,137,72,65,6,6,82,57,25
"2021","Greenwich 031D","E01001603",742,265,108,157,435,12,169,49,93,27,74,24,41,9,174,95,79,6,6,42,20,22
"2021","Greenwich 032A","E01001596",635,115,75,40,482,76,271,69,142,60,73,30,37,6,62,30,32,0,0,38,21,17
"2021","Greenwich 032B","E01001599",604,132,60,72,415,50,227,64,121,42,51,17,26,8,85,47,38,2,2,57,38,19
"2021","Greenwich 032C","E01001600",641,202,70,132,391,54,184,49,94,41,76,40,31,5,73,43,30,4,4,48,19,29
"2021","Greenwich 032D","E01001601",564,150,86,64,374,53,219,52,116,51,60,33,23,4,39,14,25,3,3,40,16,24
"2021","Greenwich 033A","E01001669",917,226,54,172,570,32,228,49,116,63,71,32,32,7,231,176,55,8,8,121,70,51
"2021","Greenwich 033B","E01001671",684,209,74,135,418,20,184,49,113,22,86,42,37,7,117,69,48,11,11,57,32,25
"2021","Greenwich 033C","E01001676",670,185,39,146,392,14,158,46,70,42,55,21,31,3,149,105,44,16,16,93,51,42
"2021","Greenwich 033D","E01032567",600,157,65,92,359,41,171,47,63,61,56,26,23,7,91,51,40,0,0,84,44,40
"2021","Greenwich 034A","E01001656",587,190,87,103,358,40,163,48,93,22,57,30,25,2,91,55,36,7,7,39,15,24
"2021","Greenwich 034B","E01001657",704,242,91,151,421,44,213,70,116,27,91,57,27,7,66,46,20,7,7,41,12,29
"2021","Greenwich 034C","E01001658",729,254,122,132,419,39,209,56,119,34,59,38,19,2,100,63,37,12,12,56,15,41
"2021","Greenwich 034D","E01001659",553,134,82,52,354,46,225,39,128,58,26,14,6,6,49,20,29,8,8,65,37,28
"2021","Greenwich 034F","E01034174",602,228,114,114,343,33,206,83,113,10,66,56,10,0,27,17,10,11,11,31,11,20
"2021","Greenwich 034G","E01034175",657,206,5,201,393,5,181,92,78,11,165,146,19,0,27,19,8,15,15,58,8,50
"2021","Greenwich 034H","E01034176",606,95,43,52,393,22,196,52,98,46,57,21,25,11,115,70,45,3,3,118,73,45
"2021","Greenwich 034I","E01034177",651,190,37,153,398,6,177,53,103,21,96,70,23,3,108,74,34,11,11,63,27,36
"2021","Greenwich 035B","E01033727",966,290,39,251,524,12,199,76,105,18,145,118,22,5,146,95,51,22,22,152,25,127
"2021","Greenwich 035C","E01033728",864,292,28,264,460,14,196,106,83,7,177,159,18,0,52,38,14,21,21,112,11,101
"2021","Greenwich 035E","E01034178",862,318,20,298,475,8,176,94,77,5,164,146,16,2,115,91,24,12,12,69,14,55
"2021","Greenwich 035F","E01034179",557,161,21,140,317,12,103,46,45,12,76,67,7,2,112,73,39,14,14,79,15,64
"2021","Greenwich 035G","E01034180",536,172,29,143,295,6,97,22,55,20,28,9,18,1,152,110,42,12,12,69,23,46
"2021","Greenwich 035H","E01034181",753,210,6,204,446,2,164,87,76,1,190,174,16,0,72,57,15,18,18,97,4,93
"2021","Greenwich 035I","E01034182",727,279,31,248,375,9,155,80,68,7,124,116,7,1,70,58,12,17,17,73,9,64
"2021","Greenwich 037B","E01001664",883,255,69,186,461,38,212,77,118,17,135,113,19,3,73,43,30,3,3,167,21,146
"2021","Greenwich 037C","E01001665",773,210,47,163,453,11,226,73,130,23,100,75,23,2,105,35,70,11,11,110,21,89
"2021","Greenwich 037D","E01033738",740,195,48,147,415,11,216,60,132,24,106,80,24,2,62,43,19,20,20,130,22,108
"2021","Greenwich 037E","E01034183",695,204,28,176,440,5,185,76,101,8,145,125,19,1,97,70,27,8,8,51,11,40
"2021","Greenwich 037F","E01034184",575,189,6,183,347,6,171,63,102,6,101,83,18,0,61,51,10,8,8,39,10,29
"2021","Greenwich 037G","E01034185",559,178,41,137,329,18,146,56,80,10,128,106,21,1,32,18,14,5,5,52,9,43
"2021","Greenwich 038A","E01001638",682,191,47,144,392,11,162,74,68,20,50,25,21,4,155,106,49,14,14,99,33,66
"2021","Greenwich 038B","E01001641",818,272,86,186,464,33,202,78,109,15,150,132,15,3,71,41,30,8,8,82,12,70
"2021","Greenwich 038C","E01001642",758,201,71,130,497,55,276,114,136,26,110,86,20,4,48,29,19,8,8,60,11,49
"2021","Greenwich 038D","E01001644",1181,377,41,336,645,24,292,115,161,16,222,190,30,2,81,45,36,26,26,159,12,147
"2021","Greenwich 038E","E01033746",704,277,141,136,374,33,179,70,97,12,109,86,21,2,44,29,15,9,9,53,15,38
"2021","Greenwich 039B","E01033734",633,175,10,165,379,1,179,96,76,7,106,84,18,4,76,51,25,17,17,79,20,59
"2021","Greenwich 039A","E01033736",1166,372,11,361,650,8,271,164,95,12,307,275,30,2,42,25,17,22,22,144,17,127
"2021","Greenwich 039C","E01034186",733,283,22,261,383,9,161,99,53,9,165,149,15,1,23,16,7,25,25,67,4,63
"2021","Greenwich 039D","E01034187",695,328,62,266,328,26,127,79,40,8,121,106,14,1,48,31,17,6,6,39,13,26
"2021","Greenwich 040A","E01034188",672,246,0,246,364,3,142,69,68,5,151,129,22,0,53,45,8,15,15,62,9,53
"2021","Greenwich 040B","E01034189",560,133,2,131,391,2,209,95,113,1,119,107,12,0,49,35,14,12,12,36,10,26
"2021","Greenwich 040C","E01034190",721,253,84,169,371,11,127,39,66,22,68,40,27,1,153,91,62,12,12,97,32,65
"2021","Greenwich 040D","E01034191",760,215,16,199,481,7,220,113,101,6,162,144,17,1,83,65,18,9,9,64,15,49
"2021","Greenwich 040E","E01034192",1061,370,119,251,610,38,246,107,111,28,189,148,38,3,129,79,50,8,8,81,18,63
"2021","Greenwich 041G","E01001666",744,218,62,156,405,13,187,68,94,25,106,79,26,1,86,59,27,13,13,121,55,66
"2021","Greenwich 041E","E01033732",452,103,8,95,281,4,117,48,62,7,89,69,15,5,62,45,17,9,9,68,7,61
"2021","Greenwich 041A","E01034193",735,291,3,288,398,3,137,72,60,5,141,120,21,0,96,81,15,21,21,46,8,38
"2021","Greenwich 041B","E01034194",607,165,7,158,362,4,161,85,69,7,130,114,16,0,50,39,11,17,17,80,10,70
"2021","Greenwich 041C","E01034195",508,176,3,173,295,2,102,39,59,4,91,78,13,0,93,79,14,7,7,37,8,29
"2021","Greenwich 041D","E01034196",577,148,7,141,345,5,150,63,82,5,124,102,22,0,51,32,19,15,15,84,9,75
"2021","Greenwich 042A","E01001712",913,347,59,288,458,8,185,34,126,25,80,42,33,5,162,128,34,23,23,108,46,62
"2021","Greenwich 042D","E01033735",590,199,46,153,317,8,134,49,77,8,85,59,24,2,68,48,20,22,22,74,13,61
"2021","Greenwich 042B","E01033737",814,274,36,238,445,8,184,60,94,30,99,75,20,4,136,98,38,18,18,95,36,59
"2021","Greenwich 042C","E01034198",967,352,64,288,506,11,211,56,115,40,124,66,49,9,143,86,57,17,17,109,45,64
"2021","Hackney 001A","E01001808",545,184,78,106,316,19,207,35,160,12,28,16,10,2,49,38,11,13,13,45,23,22
"2021","Hackney 001B","E01001809",569,192,72,120,315,27,194,23,150,21,21,16,5,0,59,32,27,14,14,62,30,32
"2021","Hackney 001C","E01001814",555,150,31,119,359,15,218,30,161,27,41,24,15,2,71,49,22,14,14,46,18,28
"2021","Hackney 001D","E01001823",522,140,30,110,331,25,186,33,127,26,38,26,12,0,71,41,30,11,11,51,25,26
"2021","Hackney 001E","E01001825",402,81,33,48,302,36,213,65,134,14,18,13,4,1,32,24,8,3,3,19,6,13
"2021","Hackney 002A","E01001714",858,249,46,203,485,9,171,55,92,24,159,139,15,5,129,81,48,17,17,124,38,86
"2021","Hackney 002D","E01001811",672,178,52,126,403,8,131,36,83,12,66,47,14,5,179,131,48,19,19,91,32,59
"2021","Hackney 002E","E01001813",795,261,60,201,437,14,124,49,56,19,49,22,25,2,230,167,63,20,20,97,50,47
"2021","Hackney 002G","E01035638",850,262,58,204,454,9,163,77,66,20,133,116,13,4,130,89,41,19,19,134,22,112
"2021","Hackney 002H","E01035639",807,279,44,235,436,13,145,55,65,25,128,103,21,4,136,85,51,14,14,92,15,77
"2021","Hackney 003A","E01001799",453,111,38,73,297,16,193,33,146,14,40,33,5,2,43,27,16,5,5,45,10,35
"2021","Hackney 003B","E01001802",458,121,33,88,264,9,135,24,92,19,42,31,10,1,71,45,26,7,7,73,23,50
"2021","Hackney 003C","E01001804",458,93,33,60,320,16,214,28,166,20,25,18,7,0,54,35,19,11,11,45,21,24
"2021","Hackney 003D","E01001807",654,204,51,153,380,14,177,38,121,18,53,38,12,3,118,54,64,18,18,70,18,52
"2021","Hackney 003E","E01001812",565,188,56,132,310,24,184,27,135,22,44,25,18,1,51,31,20,7,7,67,34,33
"2021","Hackney 004A","E01001725",563,147,32,115,345,21,193,32,142,19,29,19,9,1,88,60,28,14,14,71,33,38
"2021","Hackney 004B","E01001726",464,107,27,80,297,5,124,18,82,24,20,10,7,3,137,94,43,11,11,60,14,46
"2021","Hackney 004C","E01001800",659,253,59,194,366,6,203,35,148,20,44,26,13,5,97,68,29,16,16,40,18,22
"2021","Hackney 004D","E01001824",506,144,55,89,326,23,178,27,138,13,38,18,19,1,77,47,30,10,10,36,18,18
"2021","Hackney 004E","E01001826",526,179,65,114,300,9,181,28,135,18,26,9,16,1,80,48,32,4,4,47,21,26
"2021","Hackney 006A","E01001723",683,202,31,171,331,15,180,44,116,20,71,52,18,1,47,29,18,18,18,150,44,106
"2021","Hackney 006B","E01001724",1070,361,52,309,514,11,250,53,147,50,154,126,28,0,85,69,16,14,14,195,25,170
"2021","Hackney 006C","E01001727",559,115,24,91,336,19,204,41,139,24,50,37,12,1,51,23,28,12,12,108,40,68
"2021","Hackney 006D","E01001768",748,226,46,180,366,17,130,37,79,14,117,83,31,3,76,42,34,26,26,156,35,121
"2021","Hackney 006E","E01001769",637,198,36,162,341,7,127,34,80,13,97,66,24,7,100,43,57,10,10,98,21,77
"2021","Hackney 007A","E01001715",657,274,41,233,269,3,88,35,48,5,118,106,12,0,45,26,19,15,15,114,10,104
"2021","Hackney 007B","E01001716",829,337,46,291,401,11,107,30,61,16,96,77,19,0,177,132,45,10,10,91,26,65
"2021","Hackney 007C","E01001717",425,115,23,92,227,10,112,28,52,32,41,31,9,1,53,19,34,11,11,83,19,64
"2021","Hackney 007D","E01001718",826,289,35,254,381,17,167,62,96,9,146,128,17,1,36,22,14,15,15,156,14,142
"2021","Hackney 007E","E01001719",697,199,58,141,400,10,146,45,76,25,114,82,29,3,115,63,52,15,15,98,19,79
"2021","Hackney 007F","E01001720",790,255,44,211,379,16,143,60,70,13,147,114,31,2,56,39,17,17,17,156,5,151
"2021","Hackney 008A","E01001742",783,254,49,205,442,8,140,36,80,24,121,79,37,5,160,105,55,13,13,87,13,74
"2021","Hackney 008B","E01001801",546,155,73,82,332,19,174,29,132,13,44,29,15,0,90,61,29,5,5,59,16,43
"2021","Hackney 008C","E01001803",685,198,58,140,378,19,178,43,112,23,100,66,27,7,74,49,25,7,7,109,12,97
"2021","Hackney 008D","E01001806",674,251,77,174,355,20,143,34,88,21,79,51,26,2,107,60,47,6,6,68,8,60
"2021","Hackney 009A","E01001741",579,149,43,106,360,18,194,45,117,32,88,60,26,2,49,25,24,11,11,70,15,55
"2021","Hackney 009B","E01001805",507,161,36,125,269,7,114,24,68,22,70,49,21,0,71,27,44,7,7,77,19,58
"2021","Hackney 009C","E01001829",663,157,34,123,406,24,210,45,142,23,110,64,39,7,59,22,37,3,3,100,18,82
"2021","Hackney 009D","E01001831",785,279,64,215,364,18,118,43,58,17,139,119,17,3,70,32,38,19,19,142,14,128
"2021","Hackney 009E","E01001832",627,164,28,136,321,12,125,36,72,17,91,74,16,1,84,47,37,9,9,142,31,111
"2021","Hackney 010A","E01001764",671,209,45,164,364,12,136,33,70,33,94,54,39,1,112,57,55,10,10,98,23,75
"2021","Hackney 010B","E01001765",751,328,85,243,323,11,112,24,68,20,50,31,16,3,137,84,53,13,13,100,45,55
"2021","Hackney 010D","E01001767",630,162,36,126,355,7,150,33,95,22,89,60,28,1,95,60,35,14,14,113,23,90
"2021","Hackney 010E","E01001770",771,302,45,257,371,10,134,45,66,23,72,49,22,1,137,89,48,18,18,98,28,70
"2021","Hackney 010F","E01033703",556,215,52,163,210,5,72,27,34,11,72,56,14,2,56,36,20,5,5,131,38,93
"2021","Hackney 010G","E01033713",611,220,27,193,293,4,98,46,45,7,119,95,20,4,63,42,21,9,9,98,20,78
"2021","Hackney 011A","E01001792",715,203,52,151,379,28,156,38,89,29,71,28,35,8,114,68,46,10,10,133,41,92
"2021","Hackney 011B","E01001793",603,162,36,126,345,12,134,16,87,31,80,46,29,5,112,76,36,7,7,96,12,84
"2021","Hackney 011C","E01001794",644,159,37,122,333,18,152,40,85,27,99,70,26,3,54,25,29,10,10,152,46,106
"2021","Hackney 011D","E01001795",514,138,25,113,269,5,122,27,77,18,76,57,14,5,53,30,23,13,13,107,20,87
"2021","Hackney 011E","E01001796",634,242,32,210,280,4,102,27,54,21,92,60,28,4,69,43,26,13,13,112,18,94
"2021","Hackney 012A","E01001736",677,238,29,209,346,14,155,46,89,20,91,62,23,6,81,39,42,5,5,93,16,77
"2021","Hackney 012B","E01001737",706,169,25,144,435,15,189,65,106,18,131,87,36,8,92,61,31,8,8,102,24,78
"2021","Hackney 012C","E01001738",793,263,51,212,449,15,172,59,97,16,147,117,25,5,100,45,55,15,15,81,13,68
"2021","Hackney 012D","E01001739",881,281,90,191,485,22,200,63,118,19,181,148,31,2,69,40,29,13,13,115,13,102
"2021","Hackney 013A","E01001786",840,245,60,185,460,6,130,25,83,22,84,47,35,2,221,151,70,19,19,135,50,85
"2021","Hackney 013B","E01001787",646,236,134,102,320,26,99,21,53,25,34,18,13,3,152,71,81,9,9,90,42,48
"2021","Hackney 013C","E01001788",646,278,107,171,306,16,97,23,56,18,43,27,12,4,137,75,62,13,13,62,23,39
"2021","Hackney 013D","E01001790",583,178,42,136,342,8,94,11,58,25,38,12,18,8,184,123,61,18,18,63,25,38
"2021","Hackney 014A","E01001740",628,205,50,155,340,6,114,23,63,28,52,32,17,3,154,91,63,14,14,83,25,58
"2021","Hackney 014B","E01001747",1078,378,70,308,494,14,171,77,82,12,160,136,22,2,132,71,61,17,17,206,14,192
"2021","Hackney 014C","E01001830",901,348,78,270,408,11,131,48,62,21,102,81,21,0,148,64,84,16,16,145,29,116
"2021","Hackney 014D","E01001833",922,331,53,278,452,9,191,69,97,25,111,75,34,2,127,83,44,14,14,139,39,100
"2021","Hackney 014E","E01001834",807,213,34,179,419,6,165,52,95,18,113,94,19,0,125,66,59,10,10,175,27,148
"2021","Hackney 014F","E01001835",492,138,22,116,253,8,116,40,62,14,74,54,17,3,43,22,21,12,12,101,15,86
"2021","Hackney 015A","E01001733",736,209,27,182,377,13,159,32,105,22,98,75,22,1,87,47,40,20,20,150,25,125
"2021","Hackney 015B","E01001785",587,156,61,95,326,16,129,25,83,21,64,35,27,2,105,69,36,12,12,105,28,77
"2021","Hackney 015C","E01001789",625,138,39,99,362,15,143,27,94,22,92,65,25,2,102,54,48,10,10,125,49,76
"2021","Hackney 015D","E01001791",491,104,37,67,303,16,116,18,76,22,44,25,17,2,121,63,58,6,6,84,29,55
"2021","Hackney 016A","E01001745",918,291,44,247,510,6,153,39,91,23,115,85,24,6,204,130,74,32,32,117,31,86
"2021","Hackney 016B","E01001746",601,129,44,85,403,9,138,20,93,25,54,22,24,8,190,124,66,12,12,69,42,27
"2021","Hackney 016C","E01001757",608,174,50,124,357,7,125,11,92,22,45,21,21,3,170,105,65,10,10,77,30,47
"2021","Hackney 016D","E01001758",1080,364,79,285,568,6,207,55,121,31,139,101,33,5,195,149,46,21,21,148,27,121
"2021","Hackney 016E","E01001759",725,254,75,179,366,9,128,38,70,20,114,89,19,6,105,58,47,10,10,105,20,85
"2021","Hackney 016F","E01001761",923,460,93,367,365,12,120,37,60,23,98,75,20,3,120,72,48,15,15,98,22,76
"2021","Hackney 017A","E01001731",1158,413,40,373,507,9,167,45,107,15,156,112,41,3,158,109,49,17,17,238,59,179
"2021","Hackney 017B","E01001734",854,328,51,277,391,9,129,44,51,34,127,94,30,3,104,71,33,22,22,135,17,118
"2021","Hackney 017C","E01001760",872,300,59,241,411,15,120,37,59,24,121,103,18,0,130,68,62,25,25,161,18,143
"2021","Hackney 017D","E01001762",801,286,51,235,351,6,102,38,50,14,133,102,27,4,88,48,40,22,22,164,23,141
"2021","Hackney 018A","E01001846",539,204,75,129,265,19,79,21,39,19,42,30,12,0,114,57,57,11,11,70,20,50
"2021","Hackney 018B","E01001847",558,149,41,108,327,15,99,29,52,18,108,87,16,5,98,59,39,7,7,82,17,65
"2021","Hackney 018C","E01001848",694,218,86,132,369,14,139,24,95,20,56,34,18,4,151,105,46,9,9,107,33,74
"2021","Hackney 018D","E01001849",1011,286,26,260,541,4,163,60,87,16,195,167,26,2,166,104,62,13,13,184,28,156
"2021","Hackney 019A","E01001729",495,154,14,140,237,3,96,26,55,15,47,30,15,2,84,65,19,7,7,104,16,88
"2021","Hackney 019B","E01001730",1131,373,62,311,670,9,225,40,145,40,127,67,55,5,287,196,91,22,22,88,17,71
"2021","Hackney 019C","E01001732",756,225,47,178,417,6,101,21,65,15,72,43,24,5,218,133,85,20,20,114,52,62
"2021","Hackney 019D","E01001735",650,206,69,137,346,20,127,52,60,15,83,63,16,4,109,63,46,7,7,98,19,79
"2021","Hackney 019E","E01001838",694,219,53,166,387,11,141,37,87,17,47,20,24,3,183,114,69,5,5,88,35,53
"2021","Hackney 019F","E01001850",706,165,50,115,455,13,123,25,74,24,58,22,32,4,251,157,94,10,10,86,23,63
"2021","Hackney 020B","E01001749",665,216,53,163,349,10,122,51,59,12,102,88,12,2,102,63,39,13,13,100,18,82
"2021","Hackney 020C","E01001763",815,326,95,231,399,16,124,35,74,15,105,73,28,4,140,86,54,14,14,90,13,77
"2021","Hackney 020D","E01001816",618,155,48,107,375,36,147,31,90,26,67,45,21,1,119,57,62,6,6,88,24,64
"2021","Hackney 020E","E01001819",746,307,117,190,362,33,149,54,75,20,79,47,25,7,92,27,65,9,9,77,18,59
"2021","Hackney 020F","E01035640",632,238,44,194,296,8,92,28,53,11,90,69,19,2,97,49,48,9,9,98,15,83
"2021","Hackney 020G","E01035641",613,213,13,200,240,0,63,25,37,1,109,99,10,0,51,41,10,17,17,160,29,131
"2021","Hackney 022A","E01001836",814,269,60,209,422,20,150,47,79,24,119,94,23,2,119,70,49,14,14,123,26,97
"2021","Hackney 022B","E01001840",660,239,94,145,335,19,106,28,57,21,72,37,29,6,131,76,55,7,7,86,27,59
"2021","Hackney 022C","E01001841",631,275,76,199,298,23,117,24,73,20,59,39,16,4,95,42,53,4,4,58,25,33
"2021","Hackney 022D","E01001844",710,192,49,143,387,15,164,46,94,24,92,66,25,1,103,61,42,13,13,131,31,100
"2021","Hackney 022E","E01001845",728,334,74,260,331,10,97,27,50,20,45,24,17,4,162,91,71,17,17,63,17,46
"2021","Hackney 023B","E01001837",638,210,56,154,361,16,150,45,87,18,113,87,25,1,71,36,35,11,11,67,11,56
"2021","Hackney 023C","E01001839",1040,357,49,308,451,5,137,57,65,15,170,138,27,5,111,72,39,28,28,232,24,208
"2021","Hackney 023D","E01001842",640,199,47,152,356,3,93,26,44,23,95,73,18,4,150,89,61,15,15,85,26,59
"2021","Hackney 023E","E01001843",473,140,33,107,282,13,104,16,65,23,61,38,19,4,95,53,42,9,9,51,17,34
"2021","Hackney 023F","E01033704",1103,354,17,337,493,8,155,71,80,4,206,174,31,1,95,71,24,29,29,256,7,249
"2021","Hackney 023G","E01033712",693,247,46,201,352,11,109,33,62,14,105,76,25,4,110,69,41,17,17,94,14,80
"2021","Hackney 024A","E01001772",766,259,52,207,395,7,158,32,87,39,87,68,18,1,128,78,50,15,15,112,27,85
"2021","Hackney 024B","E01001774",856,240,32,208,428,11,129,52,66,11,138,111,24,3,131,84,47,19,19,188,16,172
"2021","Hackney 024C","E01001775",705,269,93,176,346,5,112,22,68,22,72,54,14,4,133,76,57,24,24,90,20,70
"2021","Hackney 024D","E01001815",671,241,79,162,320,21,117,29,66,22,51,28,21,2,124,60,64,7,7,110,43,67
"2021","Hackney 024E","E01001820",574,203,61,142,287,10,104,34,54,16,51,30,18,3,112,55,57,10,10,84,21,63
"2021","Hackney 024F","E01001821",581,204,60,144,301,17,95,31,47,17,47,26,17,4,131,62,69,11,11,76,22,54
"2021","Hackney 025B","E01001753",629,180,33,147,380,7,119,25,75,19,67,33,28,6,171,120,51,16,16,69,19,50
"2021","Hackney 025D","E01001755",689,221,46,175,359,3,128,28,75,25,87,69,13,5,130,71,59,11,11,109,30,79
"2021","Hackney 025E","E01001773",1043,304,48,256,536,12,167,58,82,27,197,156,35,6,136,79,57,24,24,203,34,169
"2021","Hackney 025F","E01001776",751,264,66,198,354,17,120,37,62,21,84,61,20,3,121,51,70,12,12,133,23,110
"2021","Hackney 025G","E01035642",855,275,22,253,478,3,153,56,84,13,203,183,20,0,100,73,27,19,19,102,13,89
"2021","Hackney 025H","E01035643",743,246,57,189,361,11,136,44,77,15,100,75,22,3,96,69,27,18,18,136,21,115
"2021","Hackney 025I","E01035644",606,216,18,198,290,5,93,50,33,10,137,126,10,1,46,24,22,9,9,100,8,92
"2021","Hackney 025J","E01035645",616,221,58,163,313,11,88,42,31,15,80,59,18,3,126,78,48,8,8,82,15,67
"2021","Hackney 026B","E01001781",683,229,50,179,319,6,85,22,38,25,52,34,10,8,159,107,52,17,17,135,30,105
"2021","Hackney 026D","E01001783",669,222,48,174,336,4,108,27,58,23,46,29,15,2,164,100,64,14,14,111,31,80
"2021","Hackney 026E","E01035646",663,200,53,147,355,8,117,43,46,28,106,86,17,3,112,51,61,12,12,108,17,91
"2021","Hackney 026F","E01035647",598,219,11,208,312,12,116,66,48,2,146,138,8,0,19,13,6,19,19,67,3,64
"2021","Hackney 026G","E01035648",703,297,36,261,325,3,123,40,64,19,62,52,8,2,130,83,47,7,7,81,27,54
"2021","Hackney 026H","E01035649",670,247,16,231,312,5,114,50,53,11,98,83,15,0,87,70,17,8,8,111,12,99
"2021","Hackney 028A","E01001798",725,224,66,158,360,5,161,25,112,24,57,31,20,6,126,77,49,11,11,141,71,70
"2021","Hackney 028B","E01001828",816,282,66,216,442,8,142,26,93,23,80,50,27,3,198,102,96,14,14,92,42,50
"2021","Hackney 028C","E01033702",566,179,23,156,344,7,134,31,94,9,90,65,24,1,103,81,22,10,10,43,15,28
"2021","Hackney 028D","E01033705",552,166,32,134,312,2,110,34,58,18,76,56,20,0,114,72,42,10,10,74,26,48
"2021","Hackney 028E","E01033710",514,172,16,156,280,0,86,31,48,7,95,83,11,1,90,80,10,9,9,62,9,53
"2021","Hackney 029A","E01001722",924,350,88,262,449,11,213,44,150,19,76,49,25,2,130,84,46,19,19,125,35,90
"2021","Hackney 029B","E01001728",590,111,32,79,424,20,273,28,225,20,30,15,15,0,87,55,32,14,14,55,32,23
"2021","Hackney 029C","E01001822",676,224,59,165,360,14,185,21,154,10,45,24,18,3,106,63,43,10,10,92,48,44
"2021","Hackney 029D","E01001827",592,212,72,140,320,15,137,19,94,24,40,22,14,4,120,82,38,8,8,60,23,37
"2021","Hackney 030C","E01001756",956,342,79,263,459,16,176,75,79,22,164,136,25,3,87,56,31,16,16,155,6,149
"2021","Hackney 030A","E01033699",715,275,20,255,298,2,88,53,32,3,141,121,19,1,46,26,20,21,21,142,11,131
"2021","Hackney 030B","E01033700",1135,357,39,318,496,6,169,86,70,13,202,179,22,1,84,50,34,35,35,282,13,269
"2021","Hackney 031A","E01001744",812,250,74,176,423,12,148,38,85,25,110,74,28,8,140,80,60,13,13,139,30,109
"2021","Hackney 031D","E01001750",925,290,52,238,480,19,157,47,83,27,152,126,24,2,138,88,50,14,14,155,29,126
"2021","Hackney 031B","E01001751",645,193,54,139,357,24,164,62,88,14,119,101,17,1,46,26,20,4,4,95,11,84
"2021","Hackney 031C","E01035650",914,338,83,255,455,14,156,71,52,33,119,91,24,4,147,64,83,19,19,121,26,95
"2021","Hackney 032D","E01001780",848,338,87,251,387,11,155,49,52,54,82,55,23,4,125,86,39,14,14,123,22,101
"2021","Hackney 032A","E01001784",754,256,67,189,387,8,140,40,77,23,80,64,13,3,138,88,50,21,21,111,18,93
"2021","Hackney 032B","E01033709",872,392,29,363,365,5,147,46,85,16,97,79,12,6,98,57,41,18,18,115,16,99
"2021","Hackney 032C","E01033711",882,396,25,371,325,3,99,62,33,4,148,140,6,2,39,25,14,36,36,161,5,156
"2021","Hackney 033A","E01001777",1146,350,55,295,559,8,167,77,74,16,212,181,28,3,140,83,57,32,32,237,24,213
"2021","Hackney 033B","E01033706",731,292,11,281,283,1,98,63,34,1,121,114,6,1,44,29,15,19,19,156,2,154
"2021","Hackney 033C","E01033708",935,412,10,402,349,4,97,70,21,6,172,160,10,2,41,22,19,35,35,174,6,168
"2021","Hammersmith and Fulham 001B","E01001875",654,145,56,89,393,13,147,36,70,41,49,26,19,4,163,79,84,21,21,116,34,82
"2021","Hammersmith and Fulham 001C","E01001876",814,358,54,304,376,12,176,45,100,31,33,16,11,6,139,81,58,16,16,80,32,48
"2021","Hammersmith and Fulham 001D","E01001877",610,242,41,201,296,10,117,41,52,24,62,46,14,2,97,51,46,10,10,72,19,53
"2021","Hammersmith and Fulham 001E","E01001878",589,126,49,77,371,18,134,23,72,39,40,21,10,9,167,74,93,12,12,92,24,68
"2021","Hammersmith and Fulham 001F","E01035484",623,264,77,187,276,10,102,29,49,24,56,36,15,5,84,49,35,24,24,83,14,69
"2021","Hammersmith and Fulham 001G","E01035485",582,273,24,249,232,2,102,56,29,17,51,50,1,0,55,24,31,22,22,77,10,67
"2021","Hammersmith and Fulham 002A","E01001955",825,255,57,198,463,20,213,50,123,40,56,35,16,5,156,88,68,18,18,107,29,78
"2021","Hammersmith and Fulham 002B","E01001957",584,150,37,113,365,12,130,20,79,31,31,15,9,7,181,105,76,11,11,69,30,39
"2021","Hammersmith and Fulham 002C","E01001958",601,142,29,113,358,5,115,17,73,25,39,12,22,5,178,98,80,21,21,101,46,55
"2021","Hammersmith and Fulham 002D","E01001961",530,115,44,71,339,8,133,19,85,29,22,5,15,2,164,99,65,12,12,76,27,49
"2021","Hammersmith and Fulham 003A","E01001954",665,231,91,140,347,15,154,44,91,19,49,33,11,5,119,69,50,10,10,87,19,68
"2021","Hammersmith and Fulham 003B","E01001956",597,164,74,90,347,23,160,44,87,29,36,23,10,3,119,62,57,9,9,86,27,59
"2021","Hammersmith and Fulham 003C","E01001959",579,131,47,84,339,23,151,15,96,40,38,21,15,2,118,54,64,9,9,109,46,63
"2021","Hammersmith and Fulham 003D","E01001960",773,231,42,189,377,6,154,49,90,15,90,69,18,3,92,57,35,35,35,165,24,141
"2021","Hammersmith and Fulham 004A","E01001943",1101,470,67,403,480,10,176,64,90,22,123,107,12,4,152,102,50,19,19,151,21,130
"2021","Hammersmith and Fulham 004B","E01001944",796,379,84,295,346,7,112,30,67,15,44,29,15,0,165,101,64,18,18,71,31,40
"2021","Hammersmith and Fulham 004C","E01001945",753,276,59,217,368,16,164,54,78,32,77,60,15,2,94,56,38,17,17,109,22,87
"2021","Hammersmith and Fulham 004D","E01001946",851,283,53,230,422,16,175,61,87,27,108,90,16,2,103,65,38,20,20,146,18,128
"2021","Hammersmith and Fulham 005A","E01001862",837,327,62,265,420,8,142,60,61,21,117,100,13,4,124,70,54,29,29,90,17,73
"2021","Hammersmith and Fulham 005B","E01001940",708,260,77,183,367,16,121,42,60,19,96,79,12,5,115,50,65,19,19,81,21,60
"2021","Hammersmith and Fulham 005C","E01001941",770,314,45,269,331,6,132,66,48,18,93,83,4,6,65,33,32,35,35,125,13,112
"2021","Hammersmith and Fulham 005D","E01001942",867,362,56,306,367,8,141,52,74,15,119,100,17,2,70,27,43,29,29,138,30,108
"2021","Hammersmith and Fulham 006A","E01001858",723,271,75,196,345,18,118,41,58,19,77,61,10,6,114,57,57,18,18,107,20,87
"2021","Hammersmith and Fulham 006B","E01001860",773,293,59,234,367,8,132,40,70,22,89,70,12,7,123,69,54,15,15,113,17,96
"2021","Hammersmith and Fulham 006C","E01001861",628,240,61,179,314,12,132,36,82,14,63,51,11,1,97,50,47,10,10,74,10,64
"2021","Hammersmith and Fulham 006D","E01001863",628,230,59,171,309,9,137,43,80,14,82,60,17,5,69,41,28,12,12,89,15,74
"2021","Hammersmith and Fulham 006E","E01001864",695,283,77,206,336,8,170,53,96,21,77,59,16,2,68,39,29,13,13,76,21,55
"2021","Hammersmith and Fulham 007A","E01001852",917,439,79,360,406,15,150,81,51,18,145,134,9,2,71,44,27,25,25,72,11,61
"2021","Hammersmith and Fulham 007B","E01001853",660,213,42,171,360,15,169,58,93,18,99,84,13,2,58,23,35,19,19,87,16,71
"2021","Hammersmith and Fulham 007C","E01001854",884,366,65,301,396,8,149,63,72,14,132,118,14,0,84,46,38,23,23,122,16,106
"2021","Hammersmith and Fulham 007D","E01001857",782,360,93,267,330,15,120,47,59,14,70,55,15,0,107,63,44,18,18,92,17,75
"2021","Hammersmith and Fulham 008A","E01001859",1146,366,63,303,672,18,313,97,195,21,144,111,31,2,180,119,61,17,17,108,27,81
"2021","Hammersmith and Fulham 008B","E01001865",673,196,50,146,395,18,206,56,125,25,87,66,20,1,73,29,44,11,11,82,18,64
"2021","Hammersmith and Fulham 008C","E01001927",520,123,57,66,349,58,222,55,136,31,31,20,8,3,32,11,21,6,6,48,19,29
"2021","Hammersmith and Fulham 008D","E01001930",772,351,152,199,337,23,173,45,104,24,56,42,12,2,77,36,41,8,8,84,26,58
"2021","Hammersmith and Fulham 009A","E01001895",641,221,54,167,335,21,160,59,84,17,73,59,12,2,70,39,31,11,11,85,24,61
"2021","Hammersmith and Fulham 009B","E01001896",704,301,94,207,339,13,157,64,66,27,93,83,8,2,61,31,30,15,15,64,9,55
"2021","Hammersmith and Fulham 009C","E01001897",558,180,55,125,319,25,175,54,97,24,53,40,13,0,54,33,21,12,12,59,13,46
"2021","Hammersmith and Fulham 009D","E01001929",590,204,83,121,328,20,186,54,118,14,63,42,19,2,52,35,17,7,7,58,10,48
"2021","Hammersmith and Fulham 010A","E01001851",647,227,49,178,366,20,219,75,123,21,65,52,11,2,52,29,23,10,10,54,15,39
"2021","Hammersmith and Fulham 010B","E01001855",882,389,59,330,415,13,185,73,95,17,127,113,13,1,71,40,31,19,19,78,10,68
"2021","Hammersmith and Fulham 010C","E01001856",720,279,44,235,364,19,154,52,89,13,92,70,18,4,88,57,31,11,11,77,23,54
"2021","Hammersmith and Fulham 010D","E01001869",585,218,103,115,314,40,190,52,109,29,49,42,6,1,31,21,10,4,4,53,18,35
"2021","Hammersmith and Fulham 010E","E01001873",703,260,64,196,369,15,137,47,76,14,97,66,24,7,106,66,40,14,14,74,13,61
"2021","Hammersmith and Fulham 011A","E01001928",683,230,94,136,388,16,222,59,133,30,59,42,14,3,77,36,41,14,14,65,22,43
"2021","Hammersmith and Fulham 011B","E01001931",655,283,56,227,312,8,156,68,78,10,94,78,16,0,45,29,16,9,9,60,11,49
"2021","Hammersmith and Fulham 011C","E01001932",746,270,53,217,366,15,157,62,80,15,87,74,13,0,92,57,35,15,15,110,9,101
"2021","Hammersmith and Fulham 011D","E01001933",687,256,77,179,376,38,172,69,68,35,71,58,10,3,83,40,43,12,12,55,15,40
"2021","Hammersmith and Fulham 012A","E01001866",657,211,53,158,325,26,158,52,84,22,64,53,9,2,57,19,38,20,20,121,18,103
"2021","Hammersmith and Fulham 012B","E01001867",535,240,99,141,225,21,96,37,49,10,50,44,5,1,35,18,17,23,23,70,2,68
"2021","Hammersmith and Fulham 012C","E01001868",593,248,65,183,279,11,68,13,37,18,44,24,15,5,139,65,74,17,17,66,17,49
"2021","Hammersmith and Fulham 012D","E01001870",905,430,64,366,326,13,127,62,52,13,107,96,8,3,50,24,26,29,29,149,14,135
"2021","Hammersmith and Fulham 012E","E01001871",705,269,100,169,333,23,168,62,87,19,63,59,4,0,59,30,29,20,20,103,13,90
"2021","Hammersmith and Fulham 012F","E01001872",715,305,64,241,327,19,144,71,59,14,97,89,3,5,47,31,16,20,20,83,9,74
"2021","Hammersmith and Fulham 013A","E01001893",641,216,48,168,334,18,132,44,67,21,59,36,17,6,114,64,50,11,11,91,15,76
"2021","Hammersmith and Fulham 013B","E01001894",704,297,62,235,307,8,103,53,40,10,87,76,10,1,93,45,48,16,16,100,11,89
"2021","Hammersmith and Fulham 013C","E01001898",950,378,62,316,468,19,205,84,105,16,144,125,15,4,74,46,28,26,26,104,14,90
"2021","Hammersmith and Fulham 013D","E01001899",791,337,103,234,362,20,119,51,52,16,80,68,10,2,120,81,39,23,23,92,22,70
"2021","Hammersmith and Fulham 013E","E01001900",717,274,54,220,319,14,124,39,56,29,55,36,15,4,110,71,39,16,16,124,22,102
"2021","Hammersmith and Fulham 014A","E01001889",574,179,51,128,269,15,138,44,77,17,67,57,9,1,34,18,16,15,15,126,8,118
"2021","Hammersmith and Fulham 014B","E01001910",732,352,56,296,295,14,115,64,44,7,117,108,7,2,38,21,17,11,11,85,8,77
"2021","Hammersmith and Fulham 014C","E01001913",711,270,70,200,269,11,89,36,50,3,107,98,8,1,31,18,13,31,31,172,5,167
"2021","Hammersmith and Fulham 014D","E01001914",829,385,38,347,297,10,98,48,39,11,119,111,7,1,57,34,23,13,13,147,4,143
"2021","Hammersmith and Fulham 015A","E01001885",515,162,46,116,305,11,91,13,48,30,35,18,13,4,155,73,82,13,13,48,18,30
"2021","Hammersmith and Fulham 015B","E01001908",761,340,45,295,317,9,109,52,50,7,140,131,9,0,38,24,14,21,21,104,3,101
"2021","Hammersmith and Fulham 015C","E01001909",859,354,110,244,362,20,137,60,54,23,95,80,12,3,92,42,50,18,18,143,19,124
"2021","Hammersmith and Fulham 015D","E01001911",705,230,66,164,375,14,123,25,73,25,42,31,7,4,180,107,73,16,16,100,30,70
"2021","Hammersmith and Fulham 015E","E01001912",524,148,41,107,292,4,101,20,52,29,35,25,7,3,137,72,65,15,15,84,34,50
"2021","Hammersmith and Fulham 016A","E01001886",626,167,51,116,336,19,127,41,55,31,61,43,11,7,118,63,55,11,11,123,16,107
"2021","Hammersmith and Fulham 016B","E01001887",634,240,98,142,287,17,132,38,71,23,43,29,11,3,78,32,46,17,17,107,13,94
"2021","Hammersmith and Fulham 016C","E01001890",740,321,43,278,262,4,117,42,67,8,65,57,7,1,62,32,30,14,14,157,15,142
"2021","Hammersmith and Fulham 016D","E01001892",584,205,56,149,280,9,121,41,64,16,40,24,14,2,93,55,38,17,17,99,15,84
"2021","Hammersmith and Fulham 017A","E01001880",743,308,82,226,363,16,136,63,51,22,106,86,15,5,81,51,30,24,24,72,13,59
"2021","Hammersmith and Fulham 017B","E01001881",819,259,47,212,403,23,180,73,87,20,109,94,14,1,58,32,26,33,33,157,21,136
"2021","Hammersmith and Fulham 017C","E01001882",710,213,32,181,326,18,159,47,98,14,80,70,7,3,41,15,26,28,28,171,14,157
"2021","Hammersmith and Fulham 017D","E01001883",941,381,101,280,432,23,187,81,91,15,105,91,8,6,83,41,42,34,34,128,14,114
"2021","Hammersmith and Fulham 017E","E01001884",919,431,143,288,359,11,143,58,61,24,100,86,11,3,83,49,34,22,22,129,16,113
"2021","Hammersmith and Fulham 018A","E01001888",616,173,61,112,311,25,170,56,89,25,54,46,6,2,48,21,27,14,14,132,15,117
"2021","Hammersmith and Fulham 018B","E01001891",1153,379,65,314,566,34,278,116,133,29,168,140,24,4,59,39,20,27,27,208,20,188
"2021","Hammersmith and Fulham 018C","E01001917",696,272,137,135,341,26,175,66,87,22,54,41,13,0,68,41,27,18,18,83,13,70
"2021","Hammersmith and Fulham 018D","E01001918",615,166,67,99,378,20,200,50,128,22,72,50,18,4,71,36,35,15,15,71,14,57
"2021","Hammersmith and Fulham 018E","E01001919",597,139,81,58,386,48,247,70,138,39,42,25,14,3,44,12,32,5,5,72,21,51
"2021","Hammersmith and Fulham 019A","E01001879",633,229,61,168,298,10,134,45,68,21,66,52,9,5,69,31,38,19,19,106,16,90
"2021","Hammersmith and Fulham 019B","E01001901",683,198,44,154,384,12,220,55,147,18,92,78,11,3,50,27,23,10,10,101,12,89
"2021","Hammersmith and Fulham 019C","E01001902",804,297,73,224,332,18,133,55,68,10,95,73,19,3,67,31,36,19,19,175,12,163
"2021","Hammersmith and Fulham 019D","E01001903",593,176,51,125,306,16,119,35,62,22,82,73,9,0,76,43,33,13,13,111,18,93
"2021","Hammersmith and Fulham 020A","E01001920",776,386,99,287,317,25,114,48,49,17,64,54,7,3,93,48,45,21,21,73,11,62
"2021","Hammersmith and Fulham 020B","E01001921",604,176,48,128,327,19,185,64,94,27,64,54,10,0,50,23,27,9,9,101,19,82
"2021","Hammersmith and Fulham 020C","E01001922",641,169,57,112,393,30,218,55,139,24,71,59,10,2,64,31,33,10,10,79,23,56
"2021","Hammersmith and Fulham 020D","E01001923",648,195,70,125,356,24,179,52,106,21,63,52,10,1,76,39,37,14,14,97,19,78
"2021","Hammersmith and Fulham 020E","E01001924",611,180,54,126,314,18,204,49,131,24,51,43,8,0,32,17,15,9,9,117,31,86
"2021","Hammersmith and Fulham 021A","E01001947",587,198,47,151,315,13,100,19,52,29,32,16,13,3,150,91,59,20,20,74,21,53
"2021","Hammersmith and Fulham 021B","E01001948",841,309,55,254,439,20,203,55,125,23,131,112,14,5,65,36,29,20,20,93,12,81
"2021","Hammersmith and Fulham 021C","E01001949",643,219,46,173,329,10,192,51,128,13,89,79,8,2,29,18,11,9,9,95,14,81
"2021","Hammersmith and Fulham 021D","E01001950",596,153,37,116,349,22,211,49,145,17,71,62,9,0,35,19,16,10,10,94,17,77
"2021","Hammersmith and Fulham 021E","E01001951",694,244,55,189,339,11,162,67,80,15,80,65,12,3,67,37,30,19,19,111,19,92
"2021","Hammersmith and Fulham 021F","E01001953",679,272,66,206,273,4,115,49,53,13,75,60,9,6,61,41,20,18,18,134,17,117
"2021","Hammersmith and Fulham 022A","E01001904",712,217,47,170,380,24,182,56,113,13,115,96,18,1,35,18,17,24,24,115,11,104
"2021","Hammersmith and Fulham 022B","E01001905",708,207,77,130,375,26,200,64,120,16,89,75,14,0,47,23,24,13,13,126,22,104
"2021","Hammersmith and Fulham 022C","E01001906",623,168,43,125,343,13,167,46,109,12,101,84,17,0,45,30,15,17,17,112,14,98
"2021","Hammersmith and Fulham 022D","E01001907",544,167,44,123,324,23,177,52,105,20,65,57,8,0,50,32,18,9,9,53,6,47
"2021","Hammersmith and Fulham 023A","E01001935",921,316,85,231,447,18,198,54,113,31,109,98,9,2,100,49,51,22,22,158,19,139
"2021","Hammersmith and Fulham 023D","E01032788",716,224,34,190,391,4,146,35,90,21,124,105,14,5,101,68,33,16,16,101,14,87
"2021","Hammersmith and Fulham 023E","E01032789",594,245,10,235,298,5,135,49,75,11,48,38,8,2,98,70,28,12,12,51,11,40
"2021","Hammersmith and Fulham 023F","E01032790",488,161,41,120,269,14,117,30,73,14,44,29,15,0,83,55,28,11,11,58,9,49
"2021","Hammersmith and Fulham 023G","E01035486",882,384,38,346,459,24,196,77,99,20,116,94,21,1,99,71,28,24,24,39,16,23
"2021","Hammersmith and Fulham 023H","E01035487",749,318,98,220,336,16,129,53,59,17,66,48,14,4,102,56,46,23,23,95,23,72
"2021","Hammersmith and Fulham 024A","E01001915",628,194,85,109,356,35,212,65,122,25,48,42,4,2,44,24,20,17,17,78,16,62
"2021","Hammersmith and Fulham 024B","E01001916",602,233,133,100,308,89,141,50,67,24,40,32,8,0,30,14,16,8,8,61,11,50
"2021","Hammersmith and Fulham 024C","E01001926",579,162,58,104,334,31,202,65,115,22,58,56,1,1,34,23,11,9,9,83,11,72
"2021","Hammersmith and Fulham 024D","E01001952",827,306,58,248,350,12,118,49,58,11,138,126,11,1,57,31,26,25,25,171,13,158
"2021","Hammersmith and Fulham 025A","E01001925",618,170,52,118,370,27,249,64,149,36,39,28,10,1,46,24,22,9,9,78,26,52
"2021","Hammersmith and Fulham 025B","E01001934",795,262,73,189,430,17,203,65,108,30,73,45,22,6,129,72,57,8,8,103,34,69
"2021","Hammersmith and Fulham 025C","E01001937",728,174,51,123,430,43,226,51,144,31,75,61,12,2,67,34,33,19,19,124,16,108
"2021","Hammersmith and Fulham 025D","E01001938",634,185,59,126,355,17,132,42,73,17,67,41,19,7,120,67,53,19,19,94,25,69
"2021","Haringey 001A","E01001969",870,338,109,229,428,27,179,69,90,20,91,55,33,3,110,71,39,21,21,104,32,72
"2021","Haringey 001B","E01001971",814,313,95,218,427,10,153,43,87,23,72,37,28,7,172,98,74,20,20,74,29,45
"2021","Haringey 001C","E01001974",976,297,62,235,553,25,265,100,141,24,133,88,39,6,111,76,35,19,19,126,32,94
"2021","Haringey 001D","E01001975",815,283,51,232,431,10,181,60,100,21,112,78,30,4,104,74,30,24,24,101,29,72
"2021","Haringey 002A","E01002036",696,215,56,159,352,11,139,28,81,30,40,12,20,8,157,102,55,5,5,129,44,85
"2021","Haringey 002B","E01002037",688,243,53,190,363,13,121,28,62,31,51,19,26,6,155,91,64,23,23,82,44,38
"2021","Haringey 002C","E01002039",621,161,36,125,400,8,139,19,98,22,28,8,14,6,197,110,87,28,28,60,32,28
"2021","Haringey 002D","E01002040",876,322,104,218,423,23,157,43,83,31,55,25,29,1,171,109,62,17,17,131,71,60
"2021","Haringey 004A","E01001962",639,129,67,62,458,35,254,34,179,41,62,12,39,11,102,68,34,5,5,52,21,31
"2021","Haringey 004B","E01001970",747,229,48,181,397,14,141,29,75,37,57,32,18,7,170,75,95,15,15,121,36,85
"2021","Haringey 004C","E01001972",731,240,83,157,423,21,179,63,84,32,74,45,22,7,135,74,61,14,14,68,28,40
"2021","Haringey 004D","E01001973",1003,274,111,163,626,47,273,46,161,66,98,52,41,5,188,123,65,20,20,103,35,68
"2021","Haringey 005A","E01002090",638,160,45,115,389,21,177,51,80,46,46,23,13,10,121,59,62,24,24,89,41,48
"2021","Haringey 005B","E01002093",659,158,54,104,419,15,180,23,105,52,37,14,19,4,172,79,93,15,15,82,38,44
"2021","Haringey 005C","E01002096",585,146,72,74,358,9,167,43,72,52,42,12,22,8,127,68,59,13,13,81,49,32
"2021","Haringey 005D","E01002097",592,151,45,106,380,4,146,28,83,35,57,28,21,8,158,80,78,15,15,61,32,29
"2021","Haringey 006A","E01002091",635,176,85,91,358,18,151,25,74,52,37,13,18,6,134,69,65,18,18,101,62,39
"2021","Haringey 006B","E01002092",648,212,41,171,380,11,143,29,86,28,39,21,14,4,175,136,39,12,12,56,32,24
"2021","Haringey 006C","E01002094",530,116,37,79,336,10,125,20,65,40,42,21,16,5,150,79,71,9,9,78,35,43
"2021","Haringey 006D","E01002095",620,170,55,115,377,9,141,28,71,42,48,25,16,7,171,92,79,8,8,73,44,29
"2021","Haringey 007A","E01002098",649,200,65,135,358,20,161,56,80,25,106,66,40,0,56,34,22,15,15,91,23,68
"2021","Haringey 007B","E01002101",738,189,63,126,406,15,213,53,125,35,81,45,33,3,77,40,37,20,20,143,65,78
"2021","Haringey 007C","E01002102",718,208,55,153,375,17,164,49,89,26,62,40,17,5,112,73,39,20,20,135,53,82
"2021","Haringey 007D","E01002105",890,287,59,228,453,16,181,68,83,30,119,95,21,3,104,51,53,33,33,150,41,109
"2021","Haringey 008A","E01002099",801,273,59,214,430,11,185,35,103,47,53,34,14,5,155,91,64,26,26,98,38,60
"2021","Haringey 008B","E01002100",659,165,49,116,376,26,159,40,87,32,51,27,23,1,120,71,49,20,20,118,40,78
"2021","Haringey 008C","E01002103",689,173,48,125,370,34,166,52,74,40,59,34,21,4,83,55,28,28,28,146,49,97
"2021","Haringey 008D","E01002104",510,127,39,88,273,24,112,27,50,35,33,22,10,1,84,31,53,20,20,110,47,63
"2021","Haringey 009A","E01001963",679,147,67,80,482,43,289,59,188,42,67,37,29,1,60,40,20,23,23,50,18,32
"2021","Haringey 009B","E01001964",638,173,53,120,383,23,215,49,132,34,74,52,20,2,63,32,31,8,8,82,42,40
"2021","Haringey 009C","E01001965",630,162,63,99,423,21,265,50,183,32,63,30,33,0,72,44,28,2,2,45,15,30
"2021","Haringey 009D","E01001966",514,104,52,52,364,47,241,51,140,50,35,18,14,3,37,23,14,4,4,46,14,32
"2021","Haringey 010A","E01002027",552,152,56,96,289,13,104,26,55,23,50,30,13,7,101,28,73,21,21,111,26,85
"2021","Haringey 010B","E01002028",625,162,41,121,332,12,136,25,81,30,56,38,14,4,109,46,63,19,19,131,31,100
"2021","Haringey 010C","E01002032",731,227,51,176,405,8,147,30,83,34,62,37,21,4,167,80,87,21,21,99,29,70
"2021","Haringey 010D","E01002033",691,185,53,132,394,18,137,29,76,32,60,33,15,12,153,77,76,26,26,112,46,66
"2021","Haringey 011A","E01001976",687,195,48,147,340,7,125,32,74,19,74,44,26,4,120,75,45,14,14,152,81,71
"2021","Haringey 011B","E01001977",606,180,54,126,340,10,119,24,62,33,58,33,23,2,138,90,48,15,15,86,33,53
"2021","Haringey 011C","E01001978",783,268,73,195,409,13,144,49,76,19,73,46,25,2,162,95,67,17,17,106,36,70
"2021","Haringey 011D","E01001979",927,316,66,250,487,7,177,34,112,31,89,58,23,8,193,120,73,21,21,124,42,82
"2021","Haringey 012A","E01002074",856,281,82,199,470,18,181,43,112,26,61,28,25,8,178,112,66,32,32,105,54,51
"2021","Haringey 012B","E01002077",856,227,49,178,513,15,169,50,94,25,66,36,27,3,242,141,101,21,21,116,63,53
"2021","Haringey 012C","E01002079",607,127,44,83,372,11,159,32,91,36,59,41,15,3,125,58,67,18,18,108,45,63
"2021","Haringey 012D","E01002081",680,216,78,138,355,15,119,29,54,36,37,11,23,3,146,75,71,38,38,109,54,55
"2021","Haringey 013A","E01002082",570,185,50,135,328,16,101,20,45,36,49,14,13,22,146,74,72,16,16,57,25,32
"2021","Haringey 013B","E01002086",618,217,30,187,328,17,142,40,70,32,84,56,25,3,75,37,38,10,10,73,24,49
"2021","Haringey 013C","E01002088",668,153,52,101,377,32,163,40,86,37,59,34,20,5,99,61,38,24,24,138,49,89
"2021","Haringey 013D","E01002089",512,156,55,101,309,9,107,15,59,33,24,7,15,2,158,97,61,11,11,47,20,27
"2021","Haringey 014A","E01001967",604,162,51,111,399,60,240,59,136,45,51,32,16,3,46,21,25,2,2,43,13,30
"2021","Haringey 014B","E01001968",694,216,58,158,415,35,227,49,154,24,80,57,21,2,59,40,19,14,14,63,17,46
"2021","Haringey 014C","E01001996",618,166,63,103,405,32,208,56,124,28,91,56,30,5,66,40,26,8,8,47,15,32
"2021","Haringey 014D","E01001997",703,212,57,155,415,23,201,50,138,13,107,81,25,1,71,44,27,13,13,76,17,59
"2021","Haringey 015A","E01002075",723,211,68,143,415,6,146,31,86,29,65,23,41,1,183,121,62,15,15,97,25,72
"2021","Haringey 015B","E01002076",680,167,54,113,404,22,146,34,72,40,43,21,18,4,175,115,60,18,18,109,58,51
"2021","Haringey 015C","E01002078",1133,389,97,292,622,10,233,100,90,43,166,102,54,10,184,105,79,29,29,122,36,86
"2021","Haringey 015E","E01033943",722,169,22,147,367,10,135,48,69,18,93,72,20,1,109,51,58,20,20,186,80,106
"2021","Haringey 015F","E01033944",695,167,12,155,420,4,146,33,100,13,79,47,27,5,169,120,49,22,22,108,54,54
"2021","Haringey 016A","E01002026",757,313,63,250,349,17,138,30,64,44,42,21,18,3,137,84,53,15,15,95,30,65
"2021","Haringey 016B","E01002029",730,269,42,227,360,7,139,39,72,28,72,48,22,2,126,66,60,16,16,101,35,66
"2021","Haringey 016C","E01002030",640,182,43,139,321,15,120,48,50,22,79,60,18,1,90,52,38,17,17,137,27,110
"2021","Haringey 016D","E01002031",750,206,44,162,382,17,140,50,63,27,88,62,20,6,105,59,46,32,32,162,22,140
"2021","Haringey 017A","E01001991",736,285,76,209,409,19,194,43,136,15,116,85,29,2,77,60,17,3,3,42,10,32
"2021","Haringey 017B","E01001992",674,159,80,79,463,60,274,62,171,41,78,53,20,5,46,28,18,5,5,52,16,36
"2021","Haringey 017C","E01001993",603,126,78,48,441,54,316,70,196,50,39,20,14,5,30,17,13,2,2,36,13,23
"2021","Haringey 017D","E01001995",945,183,77,106,660,21,312,50,207,55,88,39,40,9,224,116,108,15,15,102,50,52
"2021","Haringey 018A","E01001980",698,214,52,162,352,13,158,36,82,40,69,43,24,2,103,58,45,9,9,132,33,99
"2021","Haringey 018B","E01001981",647,162,44,118,309,12,117,29,64,24,57,38,15,4,107,62,45,16,16,176,61,115
"2021","Haringey 018C","E01001982",718,217,71,146,378,18,138,35,83,20,88,60,24,4,121,74,47,13,13,123,43,80
"2021","Haringey 018D","E01001983",649,174,38,136,381,18,165,39,89,37,68,37,30,1,111,57,54,19,19,94,29,65
"2021","Haringey 019A","E01002083",535,135,50,85,268,24,116,31,55,30,68,45,21,2,49,28,21,11,11,132,47,85
"2021","Haringey 019B","E01002084",656,183,53,130,359,22,171,43,96,32,71,44,22,5,77,53,24,18,18,114,36,78
"2021","Haringey 019C","E01002085",796,200,56,144,428,22,175,48,98,29,98,59,35,4,118,67,51,15,15,168,53,115
"2021","Haringey 019D","E01002087",849,323,57,266,400,15,186,55,106,25,76,54,16,6,106,63,43,17,17,126,27,99
"2021","Haringey 020B","E01002014",838,333,82,251,394,17,152,50,82,20,139,107,31,1,75,47,28,11,11,111,17,94
"2021","Haringey 020C","E01002015",633,216,73,143,374,37,133,29,65,39,84,51,30,3,111,46,65,9,9,43,16,27
"2021","Haringey 020D","E01002018",595,191,81,110,356,22,163,46,88,29,70,41,28,1,95,51,44,6,6,48,17,31
"2021","Haringey 020F","E01033086",512,191,43,148,278,9,108,24,59,25,36,18,16,2,113,59,54,12,12,43,19,24
"2021","Haringey 020G","E01033945",672,278,34,244,355,9,116,47,57,12,139,124,13,2,86,53,33,5,5,39,10,29
"2021","Haringey 020H","E01033946",671,217,10,207,400,3,136,68,65,3,185,165,20,0,62,57,5,14,14,54,7,47
"2021","Haringey 021A","E01002020",701,245,77,168,384,31,176,60,95,21,93,63,23,7,78,37,41,6,6,72,21,51
"2021","Haringey 021B","E01002022",980,362,115,247,524,57,235,66,148,21,135,111,23,1,87,56,31,10,10,94,16,78
"2021","Haringey 021C","E01002023",589,191,109,82,355,59,200,50,112,38,59,39,15,5,34,20,14,3,3,43,12,31
"2021","Haringey 021D","E01002025",600,154,61,93,406,54,243,63,141,39,78,51,20,7,29,17,12,2,2,40,12,28
"2021","Haringey 022A","E01002013",569,153,58,95,361,33,172,46,110,16,90,57,30,3,62,36,26,4,4,55,9,46
"2021","Haringey 022B","E01002019",545,96,49,47,399,65,219,83,106,30,60,45,12,3,50,32,18,5,5,50,20,30
"2021","Haringey 022C","E01002021",564,141,76,65,361,74,206,49,119,38,50,27,18,5,27,13,14,4,4,62,19,43
"2021","Haringey 022D","E01002024",524,135,50,85,340,40,181,48,94,39,63,46,13,4,51,27,24,5,5,49,10,39
"2021","Haringey 023A","E01001998",824,241,50,191,441,19,171,47,104,20,157,123,32,2,81,36,45,13,13,142,22,120
"2021","Haringey 023B","E01001999",963,284,55,229,488,22,222,66,135,21,127,86,37,4,97,58,39,20,20,191,53,138
"2021","Haringey 023C","E01002003",1136,382,54,328,597,10,222,83,105,34,137,114,21,2,193,119,74,35,35,157,41,116
"2021","Haringey 023D","E01002004",721,202,55,147,370,15,169,57,92,20,90,56,32,2,88,33,55,8,8,149,24,125
"2021","Haringey 024A","E01002067",734,262,87,175,359,16,129,36,50,43,71,42,22,7,128,59,69,15,15,113,43,70
"2021","Haringey 024B","E01002069",967,416,147,269,432,12,154,55,70,29,94,72,17,5,146,88,58,26,26,119,28,91
"2021","Haringey 024C","E01002070",1076,318,82,236,570,15,226,75,113,38,174,129,41,4,124,80,44,31,31,188,48,140
"2021","Haringey 024D","E01002073",660,190,45,145,356,13,130,39,71,20,53,37,11,5,143,86,57,17,17,114,31,83
"2021","Haringey 025A","E01002066",909,265,50,215,528,11,204,70,105,29,64,37,20,7,227,142,85,22,22,116,55,61
"2021","Haringey 025B","E01002068",860,265,51,214,409,12,157,37,98,22,77,53,21,3,141,81,60,22,22,186,38,148
"2021","Haringey 025C","E01002071",700,235,73,162,368,7,116,21,66,29,75,35,36,4,149,97,52,21,21,97,41,56
"2021","Haringey 025D","E01002072",680,251,67,184,337,12,108,33,55,20,48,33,12,3,143,71,72,26,26,92,30,62
"2021","Haringey 026A","E01002043",702,192,41,151,390,18,170,35,101,34,98,59,34,5,87,61,26,17,17,120,35,85
"2021","Haringey 026B","E01002045",825,245,55,190,477,9,194,30,133,31,83,46,32,5,160,105,55,31,31,103,38,65
"2021","Haringey 026C","E01002046",662,240,78,162,320,9,117,28,58,31,50,32,14,4,131,68,63,13,13,102,37,65
"2021","Haringey 026D","E01002049",699,202,65,137,373,13,162,40,85,37,53,29,19,5,123,67,56,22,22,124,49,75
"2021","Haringey 027A","E01002042",592,180,51,129,284,13,129,27,76,26,67,39,26,2,59,30,29,16,16,128,28,100
"2021","Haringey 027B","E01002044",710,217,38,179,318,10,128,43,62,23,79,62,12,5,81,46,35,20,20,175,53,122
"2021","Haringey 027C","E01002047",629,137,30,107,309,10,117,28,66,23,79,52,23,4,87,28,59,16,16,183,18,165
"2021","Haringey 027D","E01002048",739,221,55,166,353,11,159,49,76,34,72,53,15,4,96,51,45,15,15,165,34,131
"2021","Haringey 028A","E01002016",877,317,66,251,474,23,198,71,106,21,137,101,32,4,108,61,47,8,8,86,22,64
"2021","Haringey 028B","E01002017",651,206,57,149,374,21,160,54,94,12,117,83,28,6,70,46,24,6,6,71,17,54
"2021","Haringey 028C","E01002059",698,231,83,148,406,22,206,71,112,23,92,69,19,4,80,37,43,6,6,61,18,43
"2021","Haringey 028D","E01002060",750,230,53,177,432,17,205,73,102,30,131,92,35,4,74,38,36,5,5,88,16,72
"2021","Haringey 029A","E01002050",473,66,25,41,348,14,229,27,180,22,22,12,9,1,75,25,50,8,8,59,21,38
"2021","Haringey 029B","E01002051",684,222,50,172,365,11,148,28,98,22,30,21,9,0,136,72,64,40,40,97,33,64
"2021","Haringey 029C","E01002052",505,80,32,48,359,18,251,21,201,29,30,16,12,2,56,27,29,4,4,66,40,26
"2021","Haringey 029D","E01002055",500,93,22,71,341,17,220,24,176,20,45,15,29,1,50,28,22,9,9,66,33,33
"2021","Haringey 030A","E01001994",742,210,89,121,436,63,237,69,132,36,80,59,18,3,42,24,18,14,14,96,24,72
"2021","Haringey 030B","E01002008",527,150,83,67,334,64,194,39,126,29,40,26,12,2,32,21,11,4,4,43,18,25
"2021","Haringey 030C","E01002010",698,241,91,150,412,51,204,56,111,37,62,36,24,2,90,52,38,5,5,45,16,29
"2021","Haringey 030D","E01002011",781,261,66,195,444,42,193,60,116,17,127,93,29,5,72,30,42,10,10,76,11,65
"2021","Haringey 031A","E01002000",738,224,46,178,378,11,170,53,95,22,114,81,32,1,67,37,30,16,16,136,22,114
"2021","Haringey 031B","E01002001",685,203,34,169,372,14,187,87,76,24,101,76,25,0,59,26,33,11,11,110,13,97
"2021","Haringey 031C","E01002002",798,300,48,252,365,11,148,66,68,14,113,85,23,5,73,30,43,20,20,133,12,121
"2021","Haringey 031D","E01002058",648,200,42,158,332,10,147,45,79,23,77,59,15,3,81,37,44,17,17,116,29,87
"2021","Haringey 032A","E01002053",725,233,77,156,400,12,170,28,100,42,62,35,20,7,140,83,57,16,16,92,35,57
"2021","Haringey 032B","E01002054",678,194,45,149,402,5,133,26,77,30,40,27,11,2,207,114,93,17,17,82,32,50
"2021","Haringey 032C","E01002056",923,282,73,209,450,5,193,42,126,25,106,70,34,2,133,75,58,13,13,191,40,151
"2021","Haringey 032D","E01002057",594,137,39,98,299,24,133,27,78,28,50,34,12,4,74,41,33,18,18,158,32,126
"2021","Haringey 033A","E01001984",955,479,142,337,428,32,182,72,96,14,138,110,24,4,63,40,23,13,13,48,11,37
"2021","Haringey 033B","E01001985",725,247,68,179,427,29,235,69,139,27,109,87,21,1,51,33,18,3,3,51,19,32
"2021","Haringey 033C","E01001987",762,242,104,138,445,50,240,70,145,25,112,86,24,2,38,21,17,5,5,75,12,63
"2021","Haringey 033D","E01001989",760,248,96,152,455,52,260,77,158,25,95,72,18,5,45,25,20,3,3,57,12,45
"2021","Haringey 034A","E01001986",698,243,65,178,394,27,196,50,119,27,115,87,23,5,55,28,27,1,1,61,11,50
"2021","Haringey 034B","E01001988",788,311,92,219,418,25,176,43,118,15,150,115,33,2,61,33,28,6,6,59,16,43
"2021","Haringey 034C","E01001990",934,357,67,290,457,25,180,72,93,15,158,128,24,6,80,58,22,14,14,120,17,103
"2021","Haringey 034D","E01002062",826,311,58,253,416,28,166,65,83,18,153,126,24,3,62,35,27,7,7,99,19,80
"2021","Haringey 035A","E01002005",737,250,39,211,391,13,171,93,70,8,155,141,14,0,36,23,13,16,16,96,7,89
"2021","Haringey 035B","E01002006",771,295,69,226,408,13,159,53,88,18,166,143,21,2,62,47,15,8,8,68,7,61
"2021","Haringey 035C","E01002007",686,238,75,163,391,58,184,63,98,23,102,86,16,0,40,24,16,7,7,57,3,54
"2021","Haringey 035D","E01002009",654,232,78,154,345,44,176,64,97,15,81,65,15,1,38,21,17,6,6,77,13,64
"2021","Haringey 036A","E01002061",692,197,45,152,393,32,170,70,82,18,142,122,17,3,41,15,26,8,8,102,8,94
"2021","Haringey 036B","E01002063",711,280,75,205,345,12,135,45,74,16,108,77,25,6,76,35,41,14,14,86,11,75
"2021","Haringey 036C","E01002064",652,220,43,177,336,11,132,44,63,25,85,71,11,3,90,44,46,18,18,96,11,85
"2021","Haringey 036D","E01002065",740,285,58,227,349,9,139,58,72,9,120,105,15,0,72,23,49,9,9,106,15,91
"2021","Haringey 037A","E01002034",1018,319,56,263,592,5,208,46,140,22,70,27,39,4,291,219,72,18,18,107,37,70
"2021","Haringey 037B","E01002038",712,250,70,180,371,10,134,30,80,24,58,30,21,7,154,107,47,15,15,91,39,52
"2021","Haringey 037C","E01002041",731,225,77,148,407,17,153,43,82,28,57,28,27,2,164,89,75,16,16,99,47,52
"2021","Haringey 037D","E01032575",663,174,46,128,394,7,142,23,85,34,37,17,17,3,188,122,66,20,20,95,66,29
"2021","Harrow 001A","E01002112",735,152,93,59,519,86,331,75,172,84,30,18,11,1,66,25,41,6,6,64,35,29
"2021","Harrow 001B","E01002114",1013,402,260,142,536,103,262,79,145,38,41,31,9,1,110,57,53,20,20,75,36,39
"2021","Harrow 001C","E01002225",692,170,115,55,476,165,244,79,116,49,18,14,3,1,42,17,25,7,7,46,21,25
"2021","Harrow 001D","E01002226",1104,375,170,205,633,126,321,89,166,66,58,44,11,3,117,59,58,11,11,96,45,51
"2021","Harrow 002A","E01002113",595,158,75,83,377,61,232,45,118,69,20,11,7,2,59,24,35,5,5,60,29,31
"2021","Harrow 002B","E01002115",509,97,59,38,348,42,221,50,104,67,20,12,3,5,56,12,44,9,9,64,29,35
"2021","Harrow 002C","E01002116",625,169,99,70,377,81,245,74,115,56,15,9,6,0,33,18,15,3,3,79,30,49
"2021","Harrow 002E","E01002118",677,184,83,101,380,50,193,42,111,40,41,17,23,1,79,45,34,17,17,113,53,60
"2021","Harrow 002F","E01034589",617,85,50,35,437,65,281,54,148,79,23,10,7,6,61,33,28,7,7,95,52,43
"2021","Harrow 002G","E01034590",616,227,28,199,355,21,224,69,139,16,47,35,11,1,48,32,16,15,15,34,15,19
"2021","Harrow 003A","E01002227",650,152,68,84,368,36,170,23,95,52,27,9,9,9,118,59,59,17,17,130,85,45
"2021","Harrow 003B","E01002228",784,167,77,90,533,89,331,79,182,70,26,16,9,1,77,32,45,10,10,84,49,35
"2021","Harrow 003C","E01002229",745,230,114,116,445,79,242,65,138,39,37,27,7,3,78,32,46,9,9,70,34,36
"2021","Harrow 003D","E01002230",629,121,71,50,422,89,261,60,132,69,14,9,1,4,47,18,29,11,11,86,42,44
"2021","Harrow 004A","E01002144",573,122,82,40,385,87,207,40,112,55,27,13,12,2,63,26,37,1,1,66,24,42
"2021","Harrow 004B","E01002146",508,81,58,23,380,59,268,60,141,67,19,8,5,6,31,12,19,3,3,47,26,21
"2021","Harrow 004C","E01002147",490,81,60,21,344,102,190,50,84,56,15,8,5,2,30,9,21,7,7,65,29,36
"2021","Harrow 004D","E01002149",473,55,41,14,378,100,239,53,113,73,6,3,2,1,33,9,24,0,0,40,15,25
"2021","Harrow 005A","E01002140",614,136,77,59,394,51,219,45,115,59,27,9,13,5,90,39,51,7,7,84,46,38
"2021","Harrow 005B","E01002141",652,184,119,65,389,60,241,60,118,63,22,9,10,3,59,26,33,7,7,79,54,25
"2021","Harrow 005C","E01002142",658,135,71,64,430,63,249,52,123,74,27,15,10,2,85,48,37,6,6,93,51,42
"2021","Harrow 005D","E01002143",536,103,38,65,366,26,220,42,109,69,27,7,14,6,88,42,46,5,5,67,37,30
"2021","Harrow 005E","E01002145",623,195,118,77,368,71,188,44,96,48,26,16,10,0,73,39,34,10,10,60,33,27
"2021","Harrow 006A","E01002139",499,104,64,40,324,17,156,30,81,45,25,12,9,4,119,48,71,7,7,71,43,28
"2021","Harrow 006B","E01002148",490,62,41,21,358,57,247,58,120,69,9,2,5,2,40,12,28,5,5,70,37,33
"2021","Harrow 006C","E01002150",895,292,140,152,534,56,333,72,215,46,64,44,18,2,73,44,29,8,8,69,29,40
"2021","Harrow 006D","E01002151",526,145,82,63,309,19,164,26,90,48,26,7,14,5,95,47,48,5,5,72,49,23
"2021","Harrow 006E","E01002152",634,153,107,46,441,76,288,77,157,54,21,11,8,2,53,28,25,3,3,40,19,21
"2021","Harrow 007A","E01002119",870,215,48,167,517,26,298,64,175,59,46,31,11,4,124,68,56,23,23,138,83,55
"2021","Harrow 007B","E01002120",468,126,63,63,266,23,137,24,87,26,18,11,6,1,79,42,37,9,9,76,40,36
"2021","Harrow 007C","E01002121",529,70,34,36,342,41,229,40,121,68,19,12,2,5,50,20,30,3,3,117,70,47
"2021","Harrow 007D","E01002122",561,102,54,48,327,35,215,31,124,60,21,10,6,5,53,28,25,3,3,132,77,55
"2021","Harrow 007E","E01002123",513,95,39,56,282,37,168,26,87,55,14,8,4,2,45,23,22,18,18,136,80,56
"2021","Harrow 008A","E01002106",645,107,56,51,431,66,273,57,137,79,26,11,12,3,57,19,38,9,9,107,69,38
"2021","Harrow 008B","E01002108",548,72,43,29,390,47,292,32,168,92,7,4,3,0,39,12,27,5,5,86,55,31
"2021","Harrow 008C","E01002109",646,124,66,58,445,66,301,62,168,71,19,11,6,2,57,27,30,2,2,77,41,36
"2021","Harrow 008D","E01002110",534,82,49,33,373,48,265,59,129,77,10,5,3,2,42,17,25,8,8,79,43,36
"2021","Harrow 008E","E01002111",683,91,48,43,443,47,298,49,163,86,17,9,5,3,71,37,34,10,10,149,73,76
"2021","Harrow 009A","E01002185",642,164,56,108,411,18,224,42,128,54,34,16,13,5,129,63,66,6,6,67,39,28
"2021","Harrow 009B","E01002186",786,263,118,145,449,44,244,61,152,31,55,34,19,2,98,61,37,8,8,74,33,41
"2021","Harrow 009C","E01002187",757,191,116,75,496,86,294,60,175,59,31,17,13,1,80,39,41,5,5,70,38,32
"2021","Harrow 009D","E01002190",606,111,85,26,434,99,291,61,149,81,15,7,6,2,21,8,13,8,8,61,29,32
"2021","Harrow 010A","E01002124",495,65,38,27,300,27,187,26,100,61,20,8,10,2,57,25,32,9,9,130,77,53
"2021","Harrow 010B","E01002125",558,90,36,54,320,29,192,30,111,51,26,5,17,4,64,31,33,9,9,148,75,73
"2021","Harrow 010C","E01002198",498,62,34,28,290,22,218,46,96,76,10,2,6,2,37,10,27,3,3,146,75,71
"2021","Harrow 010D","E01002200",572,106,36,70,282,30,189,33,92,64,15,9,5,1,39,17,22,9,9,184,113,71
"2021","Harrow 010E","E01002203",552,85,35,50,351,34,243,40,126,77,15,10,4,1,53,24,29,6,6,116,65,51
"2021","Harrow 011A","E01002232",737,194,86,108,441,36,261,36,112,113,41,19,17,5,94,51,43,9,9,102,44,58
"2021","Harrow 011B","E01002233",829,199,86,113,481,25,276,76,158,42,49,29,16,4,113,73,40,18,18,149,72,77
"2021","Harrow 011C","E01002234",617,109,47,62,412,23,272,23,199,50,26,9,10,7,86,55,31,5,5,96,61,35
"2021","Harrow 011D","E01002235",604,139,85,54,367,34,189,30,113,46,28,14,10,4,107,49,58,9,9,98,56,42
"2021","Harrow 011E","E01002236",759,141,40,101,512,25,295,62,184,49,54,31,20,3,122,71,51,16,16,106,58,48
"2021","Harrow 012A","E01002107",567,85,53,32,397,48,280,34,157,89,13,6,4,3,51,28,23,5,5,85,45,40
"2021","Harrow 012B","E01002197",419,64,45,19,272,44,187,35,88,64,10,6,3,1,28,13,15,3,3,83,53,30
"2021","Harrow 012C","E01002199",477,71,38,33,312,37,202,43,95,64,15,4,8,3,48,20,28,10,10,94,57,37
"2021","Harrow 012D","E01002201",508,75,41,34,323,40,239,47,94,98,8,4,3,1,33,10,23,3,3,110,56,54
"2021","Harrow 012E","E01002202",702,121,50,71,442,37,252,31,183,38,35,15,19,1,101,65,36,17,17,139,82,57
"2021","Harrow 013A","E01002179",912,210,56,154,562,30,322,69,203,50,47,24,20,3,145,93,52,18,18,140,70,70
"2021","Harrow 013C","E01002183",668,134,64,70,410,44,225,46,115,64,31,19,9,3,89,44,45,21,21,124,77,47
"2021","Harrow 013D","E01002184",650,162,73,89,372,30,218,39,127,52,39,20,13,6,84,47,37,1,1,116,69,47
"2021","Harrow 013E","E01002231",665,129,49,80,454,29,294,38,176,80,31,15,15,1,94,46,48,6,6,82,50,32
"2021","Harrow 013F","E01034591",518,99,28,71,321,12,195,33,88,74,27,18,7,2,80,48,32,7,7,98,57,41
"2021","Harrow 013G","E01034592",400,140,37,103,200,8,117,23,76,18,19,7,10,2,49,31,18,7,7,60,33,27
"2021","Harrow 015B","E01002156",521,73,45,28,390,64,246,43,119,84,22,15,6,1,56,13,43,2,2,58,35,23
"2021","Harrow 015C","E01002162",680,156,60,96,439,27,263,53,145,65,43,24,14,5,98,51,47,8,8,85,46,39
"2021","Harrow 015D","E01002163",538,81,56,25,386,55,269,47,135,87,17,8,5,4,42,20,22,3,3,71,32,39
"2021","Harrow 015E","E01034593",528,107,67,40,360,45,230,43,132,55,18,8,8,2,61,35,26,6,6,61,36,25
"2021","Harrow 015F","E01034594",479,46,20,26,372,14,294,51,195,48,22,11,10,1,39,24,15,3,3,61,38,23
"2021","Harrow 016A","E01002188",630,149,105,44,445,106,277,72,148,57,31,18,13,0,30,9,21,1,1,36,22,14
"2021","Harrow 016B","E01002189",719,216,111,105,448,82,257,61,146,50,43,31,12,0,63,36,27,3,3,55,29,26
"2021","Harrow 016C","E01002192",668,182,127,55,441,96,281,66,165,50,27,20,5,2,34,11,23,3,3,45,23,22
"2021","Harrow 016D","E01002193",742,179,77,102,501,51,305,52,214,39,46,28,15,3,95,61,34,4,4,62,36,26
"2021","Harrow 017A","E01002165",533,80,40,40,316,25,200,39,84,77,23,11,11,1,55,25,30,13,13,137,69,68
"2021","Harrow 017B","E01002166",488,77,45,32,277,41,174,33,80,61,12,6,3,3,41,16,25,9,9,134,82,52
"2021","Harrow 017C","E01002167",472,78,53,25,273,26,180,31,68,81,18,9,5,4,45,17,28,4,4,121,64,57
"2021","Harrow 017D","E01002168",508,109,61,48,320,18,181,28,97,56,17,6,8,3,97,35,62,7,7,79,41,38
"2021","Harrow 017E","E01002169",530,101,51,50,304,49,170,33,73,64,14,4,7,3,62,30,32,9,9,125,70,55
"2021","Harrow 019A","E01002153",623,121,78,43,408,65,279,58,144,77,26,17,9,0,36,19,17,2,2,94,57,37
"2021","Harrow 019B","E01002155",631,142,93,49,434,59,296,72,165,59,24,9,13,2,47,22,25,8,8,55,24,31
"2021","Harrow 019C","E01002157",590,118,57,61,381,37,242,48,125,69,26,16,8,2,68,30,38,8,8,91,45,46
"2021","Harrow 019D","E01002158",493,74,46,28,365,55,257,56,124,77,18,6,10,2,34,12,22,1,1,54,27,27
"2021","Harrow 020A","E01002128",807,232,56,176,450,28,251,85,145,21,81,55,21,5,82,52,30,8,8,125,48,77
"2021","Harrow 020B","E01002130",1112,332,60,272,631,19,344,96,206,42,85,60,23,2,155,112,43,28,28,149,71,78
"2021","Harrow 020C","E01002181",848,208,53,155,531,20,341,80,194,67,77,50,25,2,75,41,34,18,18,109,48,61
"2021","Harrow 020D","E01002182",693,135,40,95,429,29,275,55,161,59,45,30,15,0,63,33,30,17,17,129,68,61
"2021","Harrow 021A","E01002159",686,146,47,99,454,50,285,56,158,71,33,21,10,2,73,36,37,13,13,86,33,53
"2021","Harrow 021B","E01002160",939,217,44,173,612,29,390,114,235,41,82,63,16,3,101,67,34,10,10,110,48,62
"2021","Harrow 021C","E01002161",712,173,67,106,434,46,276,68,141,67,24,11,13,0,76,51,25,12,12,105,53,52
"2021","Harrow 021D","E01002164",709,156,58,98,471,42,270,58,146,66,72,42,28,2,76,53,23,11,11,82,45,37
"2021","Harrow 022A","E01002191",657,96,56,40,482,55,348,46,211,91,15,7,7,1,62,26,36,2,2,79,42,37
"2021","Harrow 022B","E01002194",655,122,75,47,483,95,321,61,201,59,19,12,6,1,45,24,21,3,3,50,28,22
"2021","Harrow 022C","E01002195",601,118,76,42,450,65,320,64,185,71,13,7,5,1,49,21,28,3,3,33,18,15
"2021","Harrow 022D","E01002196",607,86,57,29,466,92,316,47,198,71,21,8,9,4,33,12,21,4,4,55,32,23
"2021","Harrow 023B","E01002127",648,163,89,74,387,52,256,67,139,50,26,14,11,1,42,15,27,11,11,98,37,61
"2021","Harrow 023C","E01002129",1196,429,80,349,643,27,403,120,246,37,91,72,9,10,89,51,38,33,33,124,43,81
"2021","Harrow 023D","E01002131",611,187,101,86,327,26,174,34,84,56,25,8,12,5,92,41,51,10,10,97,53,44
"2021","Harrow 023E","E01034595",516,121,51,70,328,20,220,45,149,26,26,15,11,0,49,29,20,13,13,67,34,33
"2021","Harrow 023F","E01034596",581,176,24,152,378,9,249,87,153,9,52,45,7,0,50,37,13,18,18,27,8,19
"2021","Harrow 023G","E01034597",605,199,93,106,359,23,218,78,120,20,47,37,10,0,52,37,15,19,19,47,21,26
"2021","Harrow 023H","E01034598",604,189,7,182,362,3,235,113,114,8,76,67,9,0,30,20,10,18,18,53,8,45
"2021","Harrow 024A","E01002237",811,296,41,255,415,21,258,53,128,77,48,33,14,1,77,49,28,11,11,100,50,50
"2021","Harrow 024B","E01002238",618,117,64,53,402,31,259,58,136,65,48,16,25,7,54,22,32,10,10,99,53,46
"2021","Harrow 024C","E01002240",667,184,78,106,369,43,207,50,103,54,35,18,12,5,79,29,50,5,5,114,73,41
"2021","Harrow 024D","E01002242",626,124,69,55,411,58,281,52,144,85,9,2,3,4,58,23,35,5,5,91,55,36
"2021","Harrow 025A","E01002208",484,90,70,20,341,75,216,35,122,59,14,9,3,2,31,12,19,5,5,53,24,29
"2021","Harrow 025B","E01002209",666,152,50,102,427,43,269,63,141,65,45,29,11,5,62,32,30,8,8,87,49,38
"2021","Harrow 025C","E01002239",755,180,74,106,501,73,298,74,156,68,53,41,9,3,61,31,30,16,16,74,32,42
"2021","Harrow 025D","E01002241",657,134,44,90,446,29,277,49,143,85,30,16,12,2,100,45,55,10,10,77,37,40
"2021","Harrow 027A","E01002133",807,282,112,170,441,32,187,32,108,47,37,25,8,4,169,93,76,16,16,84,55,29
"2021","Harrow 027B","E01002136",707,125,71,54,486,44,252,43,145,64,119,96,17,6,65,36,29,6,6,96,52,44
"2021","Harrow 027C","E01002138",507,90,46,44,335,23,236,48,128,60,16,13,2,1,56,31,25,4,4,82,49,33
"2021","Harrow 027E","E01034599",572,129,50,79,366,29,207,36,120,51,30,15,11,4,85,41,44,15,15,77,42,35
"2021","Harrow 027F","E01034600",816,242,57,185,509,14,284,83,180,21,77,52,24,1,106,69,37,28,28,65,32,33
"2021","Harrow 028A","E01002211",469,80,33,47,320,24,153,21,88,44,30,5,17,8,107,52,55,6,6,69,34,35
"2021","Harrow 028B","E01002212",646,149,65,84,414,19,271,45,168,58,29,11,14,4,84,44,40,11,11,83,50,33
"2021","Harrow 028C","E01002216",518,64,31,33,376,27,277,39,170,68,24,6,14,4,48,23,25,0,0,78,50,28
"2021","Harrow 028D","E01002217",782,195,43,152,506,8,297,75,172,50,45,21,17,7,140,76,64,16,16,81,48,33
"2021","Harrow 029A","E01002132",817,238,82,156,492,45,292,92,162,38,56,42,11,3,87,53,34,12,12,87,36,51
"2021","Harrow 029B","E01002134",586,181,67,114,339,33,206,52,104,50,30,24,4,2,56,30,26,14,14,66,28,38
"2021","Harrow 029C","E01002135",709,175,84,91,429,35,249,61,135,53,38,19,15,4,83,47,36,24,24,105,51,54
"2021","Harrow 029D","E01002137",446,137,39,98,281,19,165,68,75,22,63,52,10,1,30,18,12,4,4,28,8,20
"2021","Harrow 030A","E01002218",645,189,85,104,354,33,231,50,118,63,32,17,13,2,55,31,24,3,3,102,70,32
"2021","Harrow 030B","E01002219",624,137,64,73,363,41,204,34,118,52,31,15,14,2,75,42,33,12,12,124,70,54
"2021","Harrow 030C","E01002221",520,90,39,51,328,31,192,26,106,60,29,16,9,4,63,36,27,13,13,102,45,57
"2021","Harrow 030D","E01002222",496,82,34,48,328,35,224,38,118,68,15,6,8,1,52,22,30,2,2,86,52,34
"2021","Harrow 031A","E01002214",614,113,51,62,422,34,245,40,136,69,24,6,15,3,107,53,54,12,12,79,50,29
"2021","Harrow 031B","E01002215",615,149,92,57,394,30,233,43,144,46,17,5,8,4,110,61,49,4,4,72,45,27
"2021","Harrow 031C","E01002220",494,69,35,34,343,35,216,32,116,68,20,8,6,6,63,28,35,9,9,82,47,35
"2021","Harrow 031D","E01002223",578,86,40,46,415,34,268,63,120,85,30,13,14,3,75,27,48,8,8,77,50,27
"2021","Harrow 031E","E01002224",528,103,37,66,345,21,203,36,124,43,34,12,16,6,82,43,39,5,5,80,52,28
"2021","Harrow 032A","E01002204",638,128,61,67,401,33,267,48,170,49,26,12,13,1,61,35,26,14,14,109,55,54
"2021","Harrow 032B","E01002206",455,83,49,34,307,33,209,38,104,67,22,8,8,6,38,14,24,5,5,65,40,25
"2021","Harrow 032C","E01002207",545,67,42,25,410,32,294,45,171,78,27,8,13,6,54,18,36,3,3,68,45,23
"2021","Harrow 032D","E01002210",491,68,38,30,333,38,236,50,116,70,12,2,5,5,39,14,25,8,8,90,50,40
"2021","Harrow 032E","E01032576",513,63,37,26,370,41,255,42,133,80,22,10,9,3,51,17,34,1,1,80,50,30
"2021","Harrow 033A","E01002170",402,65,34,31,243,27,160,32,66,62,5,0,4,1,46,20,26,5,5,94,53,41
"2021","Harrow 033B","E01002171",538,91,46,45,336,53,193,34,109,50,17,7,8,2,61,25,36,12,12,111,62,49
"2021","Harrow 033C","E01002172",490,93,47,46,304,27,203,32,98,73,16,7,9,0,54,21,33,4,4,93,68,25
"2021","Harrow 033D","E01002173",568,66,43,23,322,49,204,45,87,72,14,4,7,3,49,10,39,6,6,180,69,111
"2021","Harrow 033E","E01002174",494,67,39,28,314,65,190,30,80,80,14,9,5,0,38,14,24,7,7,113,60,53
"2021","Harrow 033F","E01002175",402,52,35,17,236,36,158,31,61,66,3,2,0,1,31,12,19,8,8,114,63,51
"2021","Harrow 033G","E01002176",514,62,36,26,332,49,215,46,94,75,17,8,6,3,44,14,30,7,7,120,53,67
"2021","Harrow 033H","E01002177",475,75,35,40,307,29,197,39,89,69,18,11,7,0,55,14,41,8,8,93,50,43
"2021","Harrow 033I","E01002178",508,71,36,35,348,49,236,40,103,93,8,1,2,5,51,17,34,4,4,89,47,42
"2021","Havering 001A","E01002276",692,129,57,72,487,46,229,59,97,73,81,28,44,9,125,77,48,6,6,76,49,27
"2021","Havering 001B","E01002278",628,156,74,82,420,27,175,35,102,38,66,17,34,15,148,97,51,4,4,52,30,22
"2021","Havering 001C","E01002312",702,218,126,92,435,84,189,45,100,44,68,26,37,5,94,55,39,0,0,49,29,20
"2021","Havering 001D","E01002313",850,237,99,138,518,25,271,70,155,46,96,40,43,13,120,73,47,6,6,95,50,45
"2021","Havering 002A","E01002277",614,158,73,85,387,31,178,56,66,56,75,29,33,13,97,60,37,6,6,69,47,22
"2021","Havering 002B","E01002279",653,171,65,106,417,35,192,43,95,54,83,27,45,11,105,62,43,2,2,65,39,26
"2021","Havering 002C","E01002281",970,309,80,229,601,7,275,56,185,34,130,50,71,9,179,141,38,10,10,60,36,24
"2021","Havering 002D","E01002283",604,160,77,83,380,21,191,47,96,48,54,20,31,3,110,59,51,4,4,64,39,25
"2021","Havering 002E","E01002299",659,149,55,94,449,34,236,53,128,55,83,25,45,13,85,45,40,11,11,61,35,26
"2021","Havering 003A","E01002301",624,134,72,62,433,87,212,55,92,65,68,34,27,7,65,23,42,1,1,57,35,22
"2021","Havering 003B","E01002303",815,198,103,95,558,50,221,50,116,55,77,30,41,6,204,110,94,6,6,59,34,25
"2021","Havering 003C","E01002304",530,117,75,42,367,71,188,59,77,52,49,20,25,4,56,26,30,3,3,46,20,26
"2021","Havering 003D","E01002306",665,145,53,92,475,32,168,39,87,42,90,21,58,11,180,117,63,5,5,45,25,20
"2021","Havering 003E","E01002307",666,117,56,61,492,32,246,60,122,64,77,30,36,11,127,87,40,10,10,57,38,19
"2021","Havering 004A","E01002280",663,176,47,129,433,17,154,29,92,33,94,31,56,7,167,124,43,1,1,54,28,26
"2021","Havering 004B","E01002282",719,211,54,157,458,11,183,43,110,30,87,32,51,4,173,135,38,4,4,50,30,20
"2021","Havering 004C","E01002284",771,214,89,125,481,22,238,54,138,46,75,24,39,12,137,90,47,9,9,76,49,27
"2021","Havering 004D","E01002297",674,244,62,182,362,18,152,46,63,43,74,37,28,9,115,85,30,3,3,68,41,27
"2021","Havering 004E","E01002314",646,160,84,76,431,29,187,42,95,50,74,20,48,6,135,92,43,6,6,55,37,18
"2021","Havering 004F","E01002316",812,286,116,170,455,23,158,43,93,22,96,26,66,4,174,136,38,4,4,71,39,32
"2021","Havering 005A","E01002302",627,132,60,72,442,51,245,60,126,59,59,22,32,5,84,42,42,3,3,53,29,24
"2021","Havering 005B","E01002305",615,133,72,61,428,54,212,56,106,50,61,21,36,4,97,49,48,4,4,54,41,13
"2021","Havering 005C","E01002308",670,180,80,100,430,52,206,42,117,47,53,23,26,4,114,66,48,5,5,60,40,20
"2021","Havering 005D","E01002326",645,149,71,78,446,54,201,49,105,47,74,30,32,12,110,67,43,7,7,50,31,19
"2021","Havering 005E","E01002331",610,135,80,55,429,60,227,52,112,63,51,21,21,9,84,42,42,7,7,46,26,20
"2021","Havering 006A","E01002309",653,170,85,85,416,44,177,49,93,35,78,20,53,5,113,61,52,4,4,67,44,23
"2021","Havering 006B","E01002310",729,227,101,126,431,46,177,41,96,40,64,24,34,6,134,79,55,10,10,71,33,38
"2021","Havering 006C","E01002311",676,152,69,83,448,43,182,32,116,34,85,25,50,10,132,75,57,6,6,76,43,33
"2021","Havering 006D","E01002315",639,161,65,96,405,32,191,40,113,38,59,22,27,10,119,78,41,4,4,73,41,32
"2021","Havering 007B","E01002294",632,162,106,56,438,97,228,67,110,51,69,29,31,9,39,20,19,5,5,32,13,19
"2021","Havering 007C","E01002296",693,191,112,79,454,86,222,74,95,53,78,38,27,13,63,29,34,5,5,48,20,28
"2021","Havering 007D","E01002298",642,150,94,56,431,61,195,54,95,46,89,51,33,5,83,46,37,3,3,61,31,30
"2021","Havering 007E","E01002300",842,233,131,102,545,95,264,91,114,59,99,61,31,7,74,40,34,13,13,64,27,37
"2021","Havering 007F","E01033784",679,220,86,134,424,29,204,65,112,27,102,65,33,4,84,52,32,5,5,35,19,16
"2021","Havering 007G","E01033785",635,232,17,215,370,6,175,55,111,9,131,93,37,1,47,38,9,11,11,33,11,22
"2021","Havering 008A","E01002333",518,128,96,32,348,77,196,56,80,60,32,12,14,6,43,18,25,0,0,42,17,25
"2021","Havering 008B","E01002334",667,125,95,30,487,115,273,87,103,83,40,16,21,3,55,30,25,4,4,55,25,30
"2021","Havering 008C","E01002336",617,136,90,46,427,89,218,61,94,63,47,15,25,7,72,39,33,1,1,54,26,28
"2021","Havering 008D","E01002339",597,104,73,31,456,101,281,75,145,61,33,10,16,7,40,15,25,1,1,37,20,17
"2021","Havering 008E","E01002341",544,118,88,30,384,73,217,45,118,54,47,13,25,9,44,16,28,3,3,42,25,17
"2021","Havering 009A","E01002327",604,139,89,50,408,62,212,58,97,57,47,24,18,5,80,41,39,7,7,57,28,29
"2021","Havering 009B","E01002328",639,111,68,43,464,56,250,65,125,60,61,27,26,8,86,54,32,11,11,64,37,27
"2021","Havering 009C","E01002332",690,169,101,68,480,87,242,63,118,61,59,18,32,9,87,49,38,5,5,41,26,15
"2021","Havering 009D","E01002335",572,141,85,56,388,52,201,62,89,50,44,15,27,2,88,56,32,3,3,43,24,19
"2021","Havering 009E","E01002338",517,123,66,57,345,50,190,45,112,33,50,19,25,6,48,28,20,7,7,49,33,16
"2021","Havering 009F","E01002340",508,89,50,39,374,45,235,53,123,59,42,21,16,5,50,20,30,2,2,45,23,22
"2021","Havering 010A","E01002268",531,102,60,42,387,53,207,47,105,55,56,24,24,8,70,34,36,1,1,42,28,14
"2021","Havering 010B","E01002269",680,153,94,59,480,70,275,60,137,78,54,22,22,10,78,41,37,3,3,47,30,17
"2021","Havering 010C","E01002295",806,226,71,155,530,63,250,65,137,48,115,66,47,2,100,65,35,2,2,50,22,28
"2021","Havering 010D","E01002377",748,238,96,142,456,56,231,68,118,45,102,49,49,4,57,43,14,10,10,54,31,23
"2021","Havering 010E","E01002378",604,99,52,47,466,57,277,60,152,65,64,27,30,7,63,33,30,5,5,39,27,12
"2021","Havering 010F","E01002383",649,141,71,70,466,71,265,81,131,53,62,29,27,6,62,40,22,6,6,42,16,26
"2021","Havering 011A","E01002244",727,227,69,158,432,19,231,62,131,38,80,42,31,7,96,62,34,6,6,68,41,27
"2021","Havering 011B","E01002245",627,180,97,83,388,33,209,63,113,33,75,33,34,8,71,32,39,0,0,59,35,24
"2021","Havering 011C","E01002325",829,249,157,92,506,53,203,49,98,56,98,26,60,12,149,110,39,3,3,74,54,20
"2021","Havering 011D","E01002329",649,154,90,64,434,59,231,47,127,57,67,34,26,7,66,36,30,11,11,61,31,30
"2021","Havering 011E","E01002330",704,191,81,110,453,41,225,55,134,36,63,21,34,8,117,73,44,7,7,60,33,27
"2021","Havering 012A","E01002337",494,120,69,51,340,102,184,48,77,59,30,14,14,2,20,7,13,4,4,34,12,22
"2021","Havering 012B","E01002354",568,146,84,62,392,93,203,55,113,35,43,25,16,2,51,27,24,2,2,30,12,18
"2021","Havering 012C","E01002376",526,79,43,36,417,78,247,54,123,70,47,22,19,6,44,19,25,1,1,30,13,17
"2021","Havering 012D","E01002379",666,188,97,91,431,62,222,64,113,45,68,37,28,3,68,48,20,11,11,47,19,28
"2021","Havering 012E","E01002380",1069,417,127,290,585,63,223,71,119,33,131,77,47,7,151,96,55,17,17,67,25,42
"2021","Havering 012F","E01002381",623,164,77,87,428,64,204,62,85,57,58,24,28,6,100,71,29,2,2,31,15,16
"2021","Havering 013A","E01002243",833,295,114,181,476,24,202,54,110,38,85,41,43,1,154,111,43,11,11,62,26,36
"2021","Havering 013B","E01002353",859,261,131,130,535,88,266,78,128,60,74,47,21,6,90,57,33,17,17,63,34,29
"2021","Havering 013C","E01002356",945,338,63,275,524,16,198,56,124,18,126,67,53,6,172,122,50,12,12,83,41,42
"2021","Havering 013E","E01032741",730,317,54,263,353,11,157,64,83,10,107,73,31,3,64,47,17,14,14,60,20,40
"2021","Havering 013F","E01032742",832,322,137,185,455,55,212,73,111,28,92,53,34,5,83,59,24,13,13,55,15,40
"2021","Havering 014A","E01002272",539,126,67,59,370,58,191,52,93,46,70,30,33,7,48,21,27,3,3,43,20,23
"2021","Havering 014B","E01002274",678,178,107,71,454,82,250,70,110,70,60,30,23,7,59,25,34,3,3,46,24,22
"2021","Havering 014C","E01002317",552,98,73,25,406,74,243,59,111,73,40,17,17,6,43,17,26,6,6,48,21,27
"2021","Havering 014D","E01002318",624,121,82,39,461,102,232,47,115,70,61,25,27,9,62,27,35,4,4,42,21,21
"2021","Havering 014E","E01002355",570,101,55,46,443,64,256,75,129,52,69,34,28,7,53,28,25,1,1,26,12,14
"2021","Havering 014F","E01002382",754,203,87,116,497,56,253,80,123,50,95,53,32,10,87,51,36,6,6,54,29,25
"2021","Havering 015A","E01002270",647,185,124,61,382,98,225,51,101,73,20,6,8,6,37,22,15,2,2,80,53,27
"2021","Havering 015B","E01002271",521,70,50,20,392,110,234,54,102,78,21,10,10,1,24,10,14,3,3,59,36,23
"2021","Havering 015C","E01002273",484,80,59,21,369,89,202,56,85,61,38,13,18,7,38,17,21,2,2,35,21,14
"2021","Havering 015D","E01002275",503,114,74,40,340,99,189,47,74,68,20,13,4,3,30,7,23,2,2,49,31,18
"2021","Havering 016A","E01002319",731,219,96,123,449,52,223,51,108,64,60,23,31,6,105,77,28,9,9,63,34,29
"2021","Havering 016B","E01002350",681,238,70,168,362,18,187,57,99,31,65,32,28,5,88,74,14,4,4,81,33,48
"2021","Havering 016C","E01002351",696,174,60,114,461,36,225,56,123,46,94,48,42,4,101,62,39,5,5,61,27,34
"2021","Havering 016D","E01002352",809,257,85,172,496,31,242,68,135,39,101,57,39,5,119,77,42,3,3,56,29,27
"2021","Havering 016E","E01002358",873,242,63,179,562,18,259,93,136,30,145,83,53,9,128,85,43,12,12,69,29,40
"2021","Havering 017A","E01002246",635,147,73,74,425,63,236,58,99,79,49,18,19,12,73,27,46,4,4,63,41,22
"2021","Havering 017B","E01002247",893,195,53,142,603,25,283,73,163,47,113,51,51,11,172,126,46,10,10,95,58,37
"2021","Havering 017C","E01002248",630,143,62,81,410,38,176,40,104,32,58,24,29,5,131,98,33,7,7,77,47,30
"2021","Havering 017E","E01002250",699,204,57,147,436,29,229,54,120,55,67,30,30,7,106,62,44,5,5,59,33,26
"2021","Havering 017F","E01002251",515,102,42,60,356,23,165,28,96,41,53,10,33,10,108,59,49,7,7,57,42,15
"2021","Havering 017G","E01033786",560,163,9,154,350,3,163,48,103,12,88,54,34,0,81,64,17,15,15,47,16,31
"2021","Havering 017H","E01033787",566,152,4,148,330,1,149,44,94,11,71,45,25,1,101,78,23,8,8,84,25,59
"2021","Havering 017I","E01033788",515,99,34,65,339,45,161,33,84,44,49,16,29,4,79,45,34,5,5,77,49,28
"2021","Havering 018A","E01002252",636,147,102,45,456,105,224,60,100,64,52,17,31,4,73,33,40,2,2,33,17,16
"2021","Havering 018B","E01002256",612,158,107,51,425,80,228,52,115,61,52,17,27,8,64,32,32,1,1,29,14,15
"2021","Havering 018C","E01002258",769,229,130,99,504,70,215,55,114,46,80,30,38,12,134,87,47,5,5,36,19,17
"2021","Havering 018D","E01002259",604,147,98,49,428,58,220,60,109,51,63,20,37,6,81,41,40,6,6,29,16,13
"2021","Havering 018E","E01002391",630,139,94,45,443,92,247,58,127,62,53,20,25,8,48,18,30,3,3,48,24,24
"2021","Havering 019A","E01002253",609,124,87,37,456,106,278,63,146,69,39,20,19,0,33,14,19,0,0,29,12,17
"2021","Havering 019B","E01002254",634,144,109,35,467,125,264,53,141,70,43,21,18,4,34,12,22,1,1,23,13,10
"2021","Havering 019C","E01002257",654,170,124,46,460,93,302,56,173,73,34,13,17,4,30,11,19,1,1,24,13,11
"2021","Havering 019D","E01002384",678,194,124,70,455,74,256,66,141,49,66,32,28,6,55,29,26,4,4,29,12,17
"2021","Havering 020A","E01002359",519,141,116,25,345,60,209,52,99,58,44,14,25,5,30,13,17,2,2,33,20,13
"2021","Havering 020B","E01002360",730,316,235,81,376,81,171,57,67,47,52,26,23,3,68,33,35,4,4,38,18,20
"2021","Havering 020C","E01002361",898,312,142,170,524,53,217,64,106,47,106,54,47,5,137,82,55,11,11,62,21,41
"2021","Havering 020D","E01002363",627,186,108,78,404,48,198,60,87,51,54,26,26,2,102,59,43,2,2,37,16,21
"2021","Havering 020E","E01002367",702,180,72,108,467,53,239,69,108,62,97,50,36,11,71,44,27,7,7,55,26,29
"2021","Havering 021A","E01002320",540,95,59,36,404,51,258,69,112,77,56,23,26,7,34,15,19,5,5,41,22,19
"2021","Havering 021B","E01002321",703,176,100,76,478,73,280,74,138,68,61,25,28,8,59,27,32,5,5,49,24,25
"2021","Havering 021C","E01002322",729,173,84,89,503,60,275,65,126,84,83,31,44,8,81,40,41,4,4,53,33,20
"2021","Havering 021D","E01002323",628,114,69,45,468,56,280,71,133,76,57,28,26,3,69,37,32,6,6,46,24,22
"2021","Havering 021E","E01002324",656,219,108,111,391,70,188,57,76,55,57,26,23,8,72,36,36,4,4,46,26,20
"2021","Havering 022A","E01002255",630,158,90,68,430,62,225,71,105,49,79,53,24,2,63,40,23,1,1,42,20,22
"2021","Havering 022B","E01002289",633,135,75,60,460,63,245,47,126,72,73,35,33,5,73,26,47,6,6,38,19,19
"2021","Havering 022C","E01002292",649,140,83,57,454,66,213,38,132,43,74,38,31,5,93,57,36,8,8,55,26,29
"2021","Havering 022D","E01002362",628,157,90,67,443,68,251,75,107,69,55,30,20,5,64,34,30,5,5,28,15,13
"2021","Havering 022E","E01002386",914,296,132,164,568,92,258,61,141,56,113,86,21,6,100,71,29,5,5,50,14,36
"2021","Havering 023A","E01002287",602,133,74,59,424,67,229,65,110,54,72,34,28,10,53,22,31,3,3,45,25,20
"2021","Havering 023B","E01002291",753,294,120,174,443,92,193,62,60,71,83,51,27,5,69,41,28,6,6,16,5,11
"2021","Havering 023C","E01002364",538,130,84,46,388,77,220,68,84,68,52,23,24,5,37,8,29,2,2,20,8,12
"2021","Havering 023D","E01002365",531,145,83,62,343,41,186,57,80,49,45,26,16,3,68,39,29,3,3,43,22,21
"2021","Havering 023E","E01002366",564,121,64,57,392,44,220,67,103,50,72,32,29,11,56,30,26,0,0,51,30,21
"2021","Havering 024A","E01002385",600,121,85,36,444,84,255,76,106,73,58,29,20,9,46,19,27,1,1,35,14,21
"2021","Havering 024B","E01002387",603,112,86,26,462,115,274,71,135,68,41,15,21,5,31,14,17,1,1,29,13,16
"2021","Havering 024C","E01002388",596,97,74,23,474,95,312,79,151,82,37,14,20,3,29,10,19,1,1,25,13,12
"2021","Havering 024D","E01002389",618,123,89,34,457,133,258,57,112,89,34,19,9,6,27,11,16,5,5,38,18,20
"2021","Havering 024E","E01002390",526,68,54,14,434,104,266,50,140,76,32,11,17,4,32,13,19,0,0,24,11,13
"2021","Havering 025A","E01002265",623,200,88,112,381,61,190,56,77,57,76,28,40,8,53,22,31,1,1,42,28,14
"2021","Havering 025B","E01002285",544,126,84,42,389,83,207,66,85,56,64,31,28,5,32,14,18,3,3,29,12,17
"2021","Havering 025C","E01002286",605,114,76,38,453,98,261,69,120,72,55,20,29,6,39,16,23,0,0,38,22,16
"2021","Havering 025D","E01002288",609,111,67,44,466,80,269,76,108,85,55,29,20,6,61,35,26,1,1,32,17,15
"2021","Havering 025E","E01002290",621,167,127,40,429,94,233,61,98,74,54,28,23,3,47,18,29,1,1,25,13,12
"2021","Havering 026A","E01002260",623,97,54,43,461,66,254,71,120,63,56,23,30,3,73,37,36,12,12,65,40,25
"2021","Havering 026B","E01002261",655,154,81,73,433,45,254,72,123,59,52,18,27,7,72,45,27,10,10,68,32,36
"2021","Havering 026C","E01002262",675,157,81,76,467,58,247,61,107,79,60,27,24,9,88,46,42,14,14,51,25,26
"2021","Havering 026D","E01002263",607,119,73,46,449,84,247,84,102,61,62,22,32,8,54,21,33,2,2,39,22,17
"2021","Havering 026E","E01002264",701,233,125,108,423,28,137,37,79,21,83,28,49,6,170,105,65,5,5,45,27,18
"2021","Havering 027A","E01002266",605,145,97,48,416,57,213,60,98,55,59,29,27,3,79,36,43,8,8,44,25,19
"2021","Havering 027B","E01002267",752,249,147,102,451,68,177,38,98,41,73,33,35,5,128,61,67,5,5,52,31,21
"2021","Havering 027C","E01002372",613,141,83,58,429,64,234,53,115,66,58,16,31,11,70,35,35,3,3,43,27,16
"2021","Havering 027D","E01002373",629,143,90,53,421,64,215,50,112,53,61,20,36,5,76,41,35,5,5,65,33,32
"2021","Havering 027E","E01002374",633,154,71,83,419,49,199,48,91,60,62,15,40,7,105,65,40,4,4,60,34,26
"2021","Havering 028A","E01002368",982,306,68,238,588,35,222,54,122,46,103,37,60,6,214,155,59,14,14,88,48,40
"2021","Havering 028B","E01002369",737,164,75,89,483,54,234,60,116,58,64,32,25,7,122,84,38,9,9,90,53,37
"2021","Havering 028C","E01002370",867,201,85,116,574,24,283,63,153,67,109,43,54,12,152,87,65,6,6,92,57,35
"2021","Havering 028D","E01002371",653,164,84,80,411,76,211,55,110,46,38,18,13,7,80,50,30,6,6,78,45,33
"2021","Havering 028E","E01002375",693,179,82,97,460,33,200,43,109,48,88,32,46,10,135,82,53,4,4,54,25,29
"2021","Havering 029A","E01002343",634,126,86,40,451,91,227,56,105,66,58,24,26,8,72,31,41,3,3,57,29,28
"2021","Havering 029B","E01002344",745,190,91,99,490,73,225,50,117,58,79,34,36,9,106,75,31,7,7,65,33,32
"2021","Havering 029C","E01002348",645,184,120,64,426,94,207,59,81,67,66,22,37,7,54,22,32,5,5,35,24,11
"2021","Havering 029D","E01002349",597,146,99,47,404,69,209,58,76,75,62,21,25,16,61,32,29,3,3,47,24,23
"2021","Havering 030A","E01002342",615,172,94,78,378,33,188,46,95,47,62,18,35,9,89,60,29,6,6,65,42,23
"2021","Havering 030B","E01002345",789,218,60,158,506,19,187,46,105,36,108,46,52,10,188,141,47,4,4,65,36,29
"2021","Havering 030C","E01002346",552,126,52,74,363,30,167,43,82,42,64,18,38,8,92,55,37,10,10,63,41,22
"2021","Havering 030D","E01002347",547,121,74,47,366,58,205,55,100,50,44,11,27,6,54,24,30,5,5,60,36,24
"2021","Hillingdon 001A","E01002473",680,191,91,100,425,110,264,81,119,64,15,10,4,1,34,18,16,2,2,64,32,32
"2021","Hillingdon 001B","E01002475",710,271,112,159,401,80,207,53,126,28,47,33,11,3,63,40,23,4,4,38,18,20
"2021","Hillingdon 001C","E01002476",633,144,84,60,438,96,269,67,145,57,24,15,6,3,46,23,23,3,3,51,27,24
"2021","Hillingdon 001D","E01002477",568,185,85,100,341,57,204,64,111,29,27,22,4,1,46,23,23,7,7,42,26,16
"2021","Hillingdon 001E","E01002482",623,124,83,41,452,86,311,72,166,73,16,8,8,0,38,12,26,1,1,47,26,21
"2021","Hillingdon 002A","E01002472",800,329,172,157,434,83,206,69,112,25,62,43,19,0,73,57,16,10,10,37,17,20
"2021","Hillingdon 002B","E01002474",691,180,95,85,438,68,237,57,140,40,55,34,20,1,66,35,31,12,12,73,34,39
"2021","Hillingdon 002C","E01002478",668,215,90,125,407,70,222,65,121,36,43,27,12,4,66,38,28,6,6,46,27,19
"2021","Hillingdon 002D","E01002483",728,194,107,87,444,48,277,64,167,46,46,23,19,4,63,34,29,10,10,90,42,48
"2021","Hillingdon 002E","E01002484",580,189,94,95,344,31,179,42,103,34,48,21,23,4,79,41,38,7,7,47,22,25
"2021","Hillingdon 002F","E01002485",840,259,91,168,515,48,293,84,160,49,54,29,21,4,111,68,43,9,9,66,30,36
"2021","Hillingdon 003A","E01002438",564,135,58,77,389,45,230,82,112,36,60,38,18,4,52,28,24,2,2,40,16,24
"2021","Hillingdon 003B","E01002439",622,191,108,83,396,50,187,52,90,45,65,31,27,7,90,60,30,4,4,35,9,26
"2021","Hillingdon 003C","E01002440",632,178,103,75,409,49,196,56,85,55,76,27,41,8,83,41,42,5,5,45,23,22
"2021","Hillingdon 003D","E01002441",706,265,111,154,398,54,180,70,78,32,77,43,30,4,85,61,24,2,2,43,15,28
"2021","Hillingdon 003E","E01002442",653,171,62,109,441,48,202,60,95,47,102,50,41,11,80,49,31,9,9,41,17,24
"2021","Hillingdon 004A","E01002433",1013,306,126,180,641,68,344,98,178,68,88,50,31,7,136,79,57,5,5,66,32,34
"2021","Hillingdon 004B","E01002436",677,190,104,86,443,73,245,65,132,48,50,19,22,9,74,37,37,1,1,44,27,17
"2021","Hillingdon 004C","E01002479",655,157,67,90,449,45,261,57,141,63,46,15,24,7,94,44,50,3,3,49,26,23
"2021","Hillingdon 004D","E01002480",694,147,91,56,495,78,312,71,178,63,48,24,18,6,51,26,25,6,6,52,23,29
"2021","Hillingdon 004E","E01002481",653,190,102,88,411,45,219,56,109,54,49,20,20,9,92,54,38,6,6,52,22,30
"2021","Hillingdon 005A","E01002533",583,156,52,104,400,42,188,51,95,42,76,41,29,6,89,52,37,5,5,27,18,9
"2021","Hillingdon 005B","E01002534",596,159,104,55,396,66,233,63,126,44,35,16,16,3,58,26,32,4,4,41,21,20
"2021","Hillingdon 005C","E01002538",763,271,142,129,443,80,213,59,115,39,73,45,24,4,73,37,36,4,4,49,24,25
"2021","Hillingdon 005D","E01002539",694,177,113,64,475,90,273,73,145,55,51,25,22,4,59,29,30,2,2,42,17,25
"2021","Hillingdon 006A","E01002418",658,146,85,61,465,49,288,62,156,70,55,34,16,5,67,28,39,6,6,47,22,25
"2021","Hillingdon 006B","E01002419",644,145,63,82,456,53,287,66,169,52,44,26,15,3,65,25,40,7,7,43,24,19
"2021","Hillingdon 006C","E01002431",489,85,62,23,366,79,230,45,128,57,20,5,13,2,33,8,25,4,4,38,18,20
"2021","Hillingdon 006D","E01002432",635,187,109,78,395,69,231,78,109,44,48,32,15,1,42,23,19,5,5,53,19,34
"2021","Hillingdon 006E","E01002437",592,160,130,30,388,116,235,71,102,62,12,7,4,1,22,3,19,3,3,44,25,19
"2021","Hillingdon 007A","E01002430",525,93,65,28,409,90,265,76,123,66,23,14,5,4,28,10,18,3,3,23,14,9
"2021","Hillingdon 007B","E01002434",495,88,69,19,375,85,231,61,92,78,27,8,14,5,29,12,17,3,3,32,16,16
"2021","Hillingdon 007C","E01002435",574,133,92,41,397,84,256,56,135,65,24,9,10,5,33,15,18,0,0,44,21,23
"2021","Hillingdon 007D","E01002470",711,192,97,95,443,56,238,52,116,70,58,29,23,6,82,55,27,9,9,76,30,46
"2021","Hillingdon 007E","E01002535",1002,337,139,198,592,78,316,118,145,53,105,80,21,4,78,37,41,15,15,73,20,53
"2021","Hillingdon 008A","E01002416",595,92,55,37,457,57,280,54,149,77,49,19,23,7,67,38,29,4,4,46,29,17
"2021","Hillingdon 008B","E01002417",753,217,113,104,475,68,282,91,142,49,59,44,13,2,60,31,29,6,6,61,25,36
"2021","Hillingdon 008C","E01002420",672,193,90,103,437,45,242,71,134,37,65,41,20,4,82,46,36,3,3,42,18,24
"2021","Hillingdon 008D","E01002421",626,134,80,54,447,49,271,63,149,59,52,30,21,1,66,35,31,9,9,45,19,26
"2021","Hillingdon 008E","E01002471",632,143,72,71,443,56,269,61,154,54,60,33,22,5,54,29,25,4,4,46,16,30
"2021","Hillingdon 009A","E01002465",641,152,60,92,430,22,222,46,134,42,72,40,27,5,110,69,41,4,4,59,29,30
"2021","Hillingdon 009B","E01002467",627,165,121,44,425,88,241,51,137,53,51,10,35,6,42,25,17,3,3,37,17,20
"2021","Hillingdon 009C","E01002494",639,123,51,72,441,32,240,52,141,47,60,29,27,4,100,44,56,9,9,75,41,34
"2021","Hillingdon 009D","E01002536",587,217,73,144,340,19,215,75,120,20,65,47,18,0,36,25,11,5,5,30,15,15
"2021","Hillingdon 009E","E01002537",1034,334,153,181,633,68,363,93,213,57,115,78,34,3,72,50,22,15,15,67,35,32
"2021","Hillingdon 010A","E01002415",640,136,73,63,440,44,276,74,157,45,51,26,22,3,63,31,32,6,6,64,27,37
"2021","Hillingdon 010B","E01002466",630,113,61,52,468,44,282,63,162,57,88,43,37,8,50,25,25,4,4,49,25,24
"2021","Hillingdon 010C","E01002468",637,130,64,66,448,40,277,71,146,60,66,36,25,5,58,29,29,7,7,59,32,27
"2021","Hillingdon 010D","E01002469",642,142,70,72,454,66,270,74,132,64,65,33,21,11,47,21,26,6,6,46,18,28
"2021","Hillingdon 010E","E01002495",701,140,55,85,497,28,281,74,157,50,82,53,20,9,92,45,47,14,14,64,36,28
"2021","Hillingdon 011A","E01002458",532,97,66,31,402,83,247,67,118,62,30,15,12,3,36,12,24,6,6,33,21,12
"2021","Hillingdon 011B","E01002459",630,131,98,33,455,107,266,56,145,65,42,14,20,8,37,15,22,3,3,44,21,23
"2021","Hillingdon 011C","E01002460",615,217,129,88,358,59,200,52,105,43,52,31,17,4,42,17,25,5,5,40,14,26
"2021","Hillingdon 011D","E01002462",522,87,45,42,395,53,266,67,146,53,34,12,20,2,39,19,20,3,3,40,22,18
"2021","Hillingdon 011E","E01002464",622,146,73,73,435,43,276,66,158,52,51,27,18,6,63,28,35,2,2,41,17,24
"2021","Hillingdon 013A","E01002461",532,102,47,55,350,66,215,53,94,68,16,7,5,4,53,22,31,0,0,80,41,39
"2021","Hillingdon 013B","E01002463",523,91,65,26,389,69,238,59,113,66,35,16,12,7,44,19,25,3,3,43,23,20
"2021","Hillingdon 013C","E01002512",766,166,84,82,527,69,334,79,190,65,53,27,19,7,63,35,28,8,8,73,30,43
"2021","Hillingdon 013D","E01002513",585,174,99,75,363,66,214,68,81,65,28,17,5,6,54,25,29,1,1,48,26,22
"2021","Hillingdon 013E","E01002516",496,92,45,47,331,58,201,49,95,57,31,18,9,4,36,10,26,5,5,73,42,31
"2021","Hillingdon 014A","E01002450",496,75,39,36,377,24,239,48,139,52,53,22,25,6,56,31,25,5,5,44,25,19
"2021","Hillingdon 014B","E01002451",502,76,42,34,366,40,223,51,115,57,30,13,15,2,68,33,35,5,5,60,27,33
"2021","Hillingdon 014C","E01002452",510,89,43,46,349,33,226,50,121,55,32,18,10,4,52,24,28,6,6,72,39,33
"2021","Hillingdon 014D","E01002453",620,120,58,62,446,36,277,64,158,55,51,21,22,8,77,36,41,5,5,54,33,21
"2021","Hillingdon 014E","E01002454",653,149,78,71,436,27,239,41,154,44,62,16,39,7,100,62,38,8,8,68,37,31
"2021","Hillingdon 015A","E01002414",531,182,56,126,274,23,139,48,67,24,46,31,12,3,52,26,26,14,14,75,23,52
"2021","Hillingdon 015C","E01002514",883,313,131,182,498,30,239,79,123,37,118,86,27,5,95,63,32,16,16,72,25,47
"2021","Hillingdon 015G","E01034601",595,185,76,109,363,17,196,44,125,27,51,24,25,2,78,58,20,21,21,47,17,30
"2021","Hillingdon 015H","E01034602",627,199,40,159,377,9,176,66,101,9,104,77,26,1,59,40,19,29,29,51,13,38
"2021","Hillingdon 015I","E01034603",518,108,7,101,372,10,274,80,178,16,53,40,13,0,29,23,6,6,6,38,14,24
"2021","Hillingdon 015J","E01034604",606,239,72,167,297,20,134,41,73,20,58,37,15,6,74,42,32,11,11,70,23,47
"2021","Hillingdon 015K","E01034605",578,118,24,94,386,20,239,43,161,35,54,27,24,3,59,36,23,14,14,74,27,47
"2021","Hillingdon 016B","E01002520",785,215,52,163,470,21,208,63,121,24,95,56,33,6,134,91,43,12,12,100,53,47
"2021","Hillingdon 016C","E01002521",1020,474,141,333,451,20,205,71,114,20,97,71,23,3,116,73,43,13,13,95,22,73
"2021","Hillingdon 016D","E01002523",545,126,38,88,320,23,179,45,97,37,61,32,23,6,44,23,21,13,13,99,44,55
"2021","Hillingdon 016G","E01034606",482,137,45,92,280,31,146,48,74,24,56,34,16,6,41,24,17,6,6,65,11,54
"2021","Hillingdon 016H","E01034607",574,130,54,76,346,31,165,34,96,35,67,35,31,1,76,55,21,7,7,98,26,72
"2021","Hillingdon 017A","E01002410",678,164,71,93,429,48,259,58,139,62,42,12,25,5,76,44,32,4,4,85,52,33
"2021","Hillingdon 017B","E01002412",795,180,59,121,511,49,307,69,157,81,64,35,23,6,82,39,43,9,9,104,36,68
"2021","Hillingdon 017C","E01002456",637,166,104,62,414,33,247,62,133,52,49,29,19,1,82,48,34,3,3,57,29,28
"2021","Hillingdon 017D","E01002509",509,81,61,20,369,66,242,51,121,70,27,9,11,7,31,7,24,3,3,59,38,21
"2021","Hillingdon 017E","E01002511",643,203,100,103,385,34,208,54,112,42,42,21,20,1,95,49,46,6,6,55,32,23
"2021","Hillingdon 018A","E01002422",493,85,42,43,326,34,197,16,112,69,30,14,10,6,61,38,23,4,4,82,46,36
"2021","Hillingdon 018B","E01002423",602,132,53,79,389,42,259,46,153,60,33,16,11,6,47,17,30,8,8,81,52,29
"2021","Hillingdon 018C","E01002424",537,89,40,49,364,33,227,35,138,54,30,7,15,8,69,38,31,5,5,84,52,32
"2021","Hillingdon 018D","E01002425",604,170,54,116,380,27,213,38,131,44,46,19,22,5,89,56,33,5,5,54,33,21
"2021","Hillingdon 018E","E01002427",516,112,67,45,334,35,207,36,121,50,24,10,11,3,63,24,39,5,5,70,44,26
"2021","Hillingdon 018F","E01002428",511,91,47,44,334,38,197,33,109,55,26,11,13,2,68,41,27,5,5,86,54,32
"2021","Hillingdon 019A","E01002408",662,222,68,154,362,21,165,43,95,27,62,34,24,4,105,54,51,9,9,78,41,37
"2021","Hillingdon 019B","E01002409",702,162,90,72,440,35,231,41,138,52,48,26,19,3,113,62,51,13,13,100,58,42
"2021","Hillingdon 019C","E01002429",521,134,37,97,313,17,172,35,99,38,36,16,18,2,85,56,29,3,3,74,41,33
"2021","Hillingdon 019D","E01002455",696,162,72,90,459,38,252,57,151,44,49,19,22,8,106,70,36,14,14,75,48,27
"2021","Hillingdon 019E","E01002457",525,79,29,50,373,17,199,30,114,55,36,12,20,4,110,58,52,11,11,73,31,42
"2021","Hillingdon 020A","E01002392",615,133,43,90,429,13,203,34,126,43,48,8,30,10,155,109,46,10,10,53,28,25
"2021","Hillingdon 020B","E01002393",716,142,40,102,479,27,246,33,164,49,57,23,28,6,136,71,65,13,13,95,61,34
"2021","Hillingdon 020C","E01002540",643,173,41,132,397,14,199,35,135,29,64,29,31,4,115,69,46,5,5,73,37,36
"2021","Hillingdon 020D","E01002542",703,137,46,91,488,22,268,38,201,29,46,16,27,3,142,93,49,10,10,78,45,33
"2021","Hillingdon 020E","E01002543",646,142,55,87,432,12,255,49,158,48,31,8,16,7,126,84,42,8,8,72,47,25
"2021","Hillingdon 021A","E01002394",518,90,40,50,329,26,205,26,129,50,30,7,20,3,63,31,32,5,5,99,67,32
"2021","Hillingdon 021B","E01002395",429,75,26,49,280,22,179,34,100,45,17,4,8,5,57,24,33,5,5,74,50,24
"2021","Hillingdon 021C","E01002397",576,90,23,67,344,23,217,41,125,51,29,10,18,1,67,38,29,8,8,142,65,77
"2021","Hillingdon 021D","E01002398",511,71,24,47,322,22,229,32,130,67,18,9,8,1,47,27,20,6,6,118,73,45
"2021","Hillingdon 021E","E01002399",494,73,38,35,304,24,198,37,108,53,16,6,10,0,57,21,36,9,9,117,72,45
"2021","Hillingdon 021F","E01002426",653,100,57,43,457,52,289,33,211,45,33,11,15,7,80,50,30,3,3,96,69,27
"2021","Hillingdon 022A","E01002411",712,156,55,101,442,35,234,45,161,28,61,20,36,5,104,64,40,8,8,114,26,88
"2021","Hillingdon 022B","E01002413",598,159,72,87,369,18,184,35,104,45,44,17,22,5,118,72,46,5,5,70,29,41
"2021","Hillingdon 022C","E01002518",484,107,52,55,301,40,180,47,79,54,42,27,12,3,31,16,15,8,8,76,24,52
"2021","Hillingdon 022D","E01002519",955,432,127,305,458,31,197,72,90,35,131,84,41,6,87,59,28,12,12,65,26,39
"2021","Hillingdon 022E","E01002550",799,297,56,241,445,10,227,77,125,25,84,47,31,6,112,85,27,12,12,57,29,28
"2021","Hillingdon 022G","E01034608",944,240,30,210,613,11,304,84,190,30,122,79,38,5,154,118,36,22,22,91,34,57
"2021","Hillingdon 022H","E01034609",847,274,34,240,490,7,256,76,169,11,93,66,27,0,118,93,25,16,16,83,28,55
"2021","Hillingdon 023A","E01002541",804,240,82,158,497,34,275,73,153,49,68,45,14,9,111,60,51,9,9,67,40,27
"2021","Hillingdon 023B","E01002544",557,121,52,69,324,28,204,39,119,46,30,12,16,2,60,29,31,2,2,112,64,48
"2021","Hillingdon 023C","E01002545",492,81,21,60,341,11,133,20,75,38,23,9,14,0,170,109,61,4,4,70,43,27
"2021","Hillingdon 023D","E01002546",456,34,14,20,292,17,195,32,117,46,13,5,6,2,55,24,31,12,12,130,80,50
"2021","Hillingdon 023E","E01002547",507,74,22,52,324,18,184,34,110,40,27,11,14,2,87,45,42,8,8,109,82,27
"2021","Hillingdon 024A","E01002400",638,130,71,59,407,27,233,46,132,55,52,24,22,6,88,41,47,7,7,101,57,44
"2021","Hillingdon 024B","E01002401",762,159,60,99,497,25,286,46,195,45,55,27,20,8,126,79,47,5,5,106,69,37
"2021","Hillingdon 024C","E01002402",516,80,33,47,366,24,192,34,100,58,56,10,12,34,88,38,50,6,6,70,45,25
"2021","Hillingdon 024D","E01002403",730,125,45,80,477,27,281,42,187,52,50,19,26,5,108,59,49,11,11,128,93,35
"2021","Hillingdon 024E","E01002404",680,166,60,106,426,19,221,48,141,32,48,18,24,6,134,89,45,4,4,88,55,33
"2021","Hillingdon 025A","E01002548",734,178,96,82,457,24,197,48,110,39,48,21,19,8,182,140,42,6,6,99,39,60
"2021","Hillingdon 025B","E01002549",715,206,112,94,442,42,222,53,124,45,58,29,23,6,111,67,44,9,9,67,35,32
"2021","Hillingdon 025C","E01002551",686,123,66,57,460,24,229,49,119,61,57,24,26,7,138,89,49,12,12,103,53,50
"2021","Hillingdon 025D","E01002552",568,95,40,55,396,28,203,43,120,40,59,23,27,9,95,56,39,11,11,77,41,36
"2021","Hillingdon 025E","E01002553",628,151,66,85,400,20,192,40,95,57,43,11,26,6,127,70,57,18,18,77,38,39
"2021","Hillingdon 026A","E01002396",574,132,75,57,332,31,196,32,107,57,18,4,11,3,79,39,40,8,8,110,74,36
"2021","Hillingdon 026B","E01002501",513,88,41,47,312,31,195,39,85,71,18,8,8,2,60,31,29,8,8,113,80,33
"2021","Hillingdon 026C","E01002502",568,71,37,34,387,18,213,24,144,45,26,8,15,3,121,74,47,9,9,110,75,35
"2021","Hillingdon 026D","E01002505",659,173,59,114,414,19,211,42,126,43,41,24,15,2,130,73,57,13,13,72,43,29
"2021","Hillingdon 026E","E01002508",708,191,108,83,410,37,219,34,135,50,33,11,18,4,115,62,53,6,6,107,71,36
"2021","Hillingdon 027A","E01002405",643,151,64,87,380,14,221,47,128,46,52,20,22,10,86,53,33,7,7,112,68,44
"2021","Hillingdon 027C","E01002503",550,105,52,53,322,12,176,18,110,48,27,10,12,5,93,49,44,14,14,123,77,46
"2021","Hillingdon 027E","E01002506",648,165,41,124,349,9,180,31,113,36,30,11,18,1,116,68,48,14,14,134,78,56
"2021","Hillingdon 027F","E01002507",551,96,28,68,310,15,193,32,112,49,14,6,7,1,81,37,44,7,7,145,109,36
"2021","Hillingdon 027G","E01034610",566,115,32,83,378,23,213,43,128,42,38,14,19,5,97,65,32,7,7,73,45,28
"2021","Hillingdon 027H","E01034611",427,96,32,64,284,10,160,46,98,16,39,16,21,2,65,47,18,10,10,47,28,19
"2021","Hillingdon 027I","E01034612",621,110,44,66,388,22,231,29,123,79,30,10,16,4,92,49,43,13,13,123,76,47
"2021","Hillingdon 027J","E01034613",449,129,5,124,273,0,142,64,71,7,77,69,7,1,42,28,14,12,12,47,12,35
"2021","Hillingdon 028A","E01002486",692,132,39,93,444,22,265,34,149,82,37,13,18,6,109,59,50,11,11,116,74,42
"2021","Hillingdon 028B","E01002487",627,167,56,111,346,23,212,33,122,57,29,16,10,3,73,34,39,9,9,114,78,36
"2021","Hillingdon 028C","E01002526",1000,190,32,158,698,18,407,83,250,74,99,56,28,15,160,84,76,14,14,112,59,53
"2021","Hillingdon 028D","E01002528",579,93,43,50,389,30,195,24,113,58,45,16,21,8,109,53,56,10,10,97,46,51
"2021","Hillingdon 028F","E01034614",757,163,18,145,533,3,301,76,200,25,93,56,35,2,127,96,31,9,9,61,23,38
"2021","Hillingdon 028G","E01034615",699,117,36,81,500,12,309,49,211,49,58,21,31,6,106,65,41,15,15,82,44,38
"2021","Hillingdon 029A","E01002445",625,156,51,105,398,19,184,25,116,43,57,18,34,5,134,100,34,4,4,71,38,33
"2021","Hillingdon 029B","E01002525",688,175,71,104,437,46,243,74,120,49,59,35,20,4,78,50,28,11,11,76,36,40
"2021","Hillingdon 029C","E01002529",907,181,37,144,605,26,298,65,196,37,127,87,39,1,145,90,55,9,9,121,58,63
"2021","Hillingdon 029D","E01002530",616,155,65,90,388,12,197,30,112,55,34,6,23,5,138,81,57,7,7,73,45,28
"2021","Hillingdon 029E","E01002531",651,181,85,96,389,48,236,79,110,47,39,21,13,5,59,28,31,7,7,81,36,45
"2021","Hillingdon 030B","E01002488",528,79,40,39,341,32,202,32,112,58,25,10,12,3,75,35,40,7,7,108,67,41
"2021","Hillingdon 030C","E01002489",553,99,44,55,314,20,208,26,124,58,18,5,11,2,56,25,31,12,12,140,84,56
"2021","Hillingdon 030D","E01002490",677,127,46,81,437,26,254,41,143,70,51,24,19,8,93,47,46,13,13,113,63,50
"2021","Hillingdon 030E","E01002492",498,62,26,36,319,16,207,26,111,70,18,6,9,3,69,32,37,9,9,117,70,47
"2021","Hillingdon 030F","E01034616",698,279,14,265,360,1,222,95,113,14,66,52,12,2,61,39,22,10,10,59,22,37
"2021","Hillingdon 030G","E01034617",730,112,31,81,467,21,275,71,149,55,51,28,18,5,107,64,43,13,13,151,72,79
"2021","Hillingdon 031A","E01002444",664,205,62,143,341,31,196,69,81,46,42,26,14,2,62,38,24,10,10,118,53,65
"2021","Hillingdon 031B","E01002446",630,139,59,80,363,22,209,45,115,49,45,23,19,3,77,42,35,10,10,128,66,62
"2021","Hillingdon 031C","E01002447",717,162,31,131,415,10,227,73,113,41,75,44,30,1,91,50,41,12,12,140,68,72
"2021","Hillingdon 031D","E01002527",625,192,73,119,380,26,170,47,92,31,67,43,23,1,111,70,41,6,6,53,24,29
"2021","Hillingdon 032A","E01002443",686,151,31,120,405,20,226,57,127,42,68,45,22,1,83,47,36,8,8,130,66,64
"2021","Hillingdon 032B","E01002448",762,205,90,115,435,36,253,64,143,46,51,26,25,0,88,55,33,7,7,122,71,51
"2021","Hillingdon 032C","E01002449",732,175,49,126,399,12,249,55,160,34,45,29,16,0,80,50,30,13,13,158,78,80
"2021","Hillingdon 032D","E01002491",531,101,36,65,336,21,173,28,93,52,27,2,22,3,109,72,37,6,6,94,62,32
"2021","Hillingdon 032E","E01002493",610,87,29,58,446,13,241,31,163,47,36,9,21,6,147,89,58,9,9,77,48,29
"2021","Hillingdon 033A","E01002496",777,225,69,156,502,32,282,55,175,52,83,38,36,9,99,59,40,6,6,50,29,21
"2021","Hillingdon 033B","E01002497",990,249,84,165,646,48,344,97,196,51,106,58,37,11,134,91,43,14,14,95,45,50
"2021","Hillingdon 033C","E01002498",524,114,63,51,370,43,237,56,125,56,38,15,17,6,48,14,34,4,4,40,23,17
"2021","Hillingdon 033D","E01002499",679,159,77,82,449,36,256,59,145,52,63,36,24,3,86,44,42,8,8,71,35,36
"2021","Hillingdon 033E","E01032577",610,98,54,44,468,36,297,67,174,56,47,18,22,7,85,35,50,3,3,44,23,21
"2021","Hounslow 001A","E01002569",961,357,82,275,538,40,316,119,178,19,110,86,24,0,59,33,26,13,13,66,18,48
"2021","Hounslow 001B","E01002570",667,222,56,166,351,23,185,67,95,23,74,56,14,4,54,28,26,15,15,94,16,78
"2021","Hounslow 001C","E01002573",638,194,66,128,394,61,236,70,139,27,57,43,11,3,33,18,15,7,7,50,15,35
"2021","Hounslow 001D","E01002574",682,166,67,99,440,41,283,70,189,24,61,48,11,2,47,20,27,8,8,76,13,63
"2021","Hounslow 001E","E01002575",663,179,70,109,410,54,242,71,139,32,59,45,14,0,45,24,21,10,10,74,14,60
"2021","Hounslow 004A","E01002620",898,187,50,137,601,20,371,43,263,65,52,23,24,5,144,84,60,14,14,110,69,41
"2021","Hounslow 004B","E01002625",487,78,40,38,281,26,185,30,90,65,8,3,3,2,52,24,28,10,10,128,77,51
"2021","Hounslow 004C","E01002626",484,89,33,56,274,31,186,30,84,72,16,3,8,5,37,12,25,4,4,121,61,60
"2021","Hounslow 004D","E01002627",608,140,44,96,391,13,207,29,135,43,32,7,22,3,132,81,51,7,7,77,37,40
"2021","Hounslow 004E","E01002631",556,93,26,67,307,23,205,34,118,53,18,8,7,3,52,23,29,9,9,156,112,44
"2021","Hounslow 005A","E01002633",745,200,69,131,446,13,229,30,159,40,29,6,16,7,150,83,67,25,25,99,74,25
"2021","Hounslow 005B","E01002634",544,70,23,47,405,12,195,26,127,42,25,6,16,3,166,91,75,7,7,69,35,34
"2021","Hounslow 005C","E01002637",615,174,43,131,320,20,196,34,106,56,13,3,8,2,82,43,39,9,9,121,74,47
"2021","Hounslow 005D","E01002638",618,83,34,49,417,21,241,21,156,64,23,6,12,5,120,61,59,12,12,118,80,38
"2021","Hounslow 006A","E01002563",746,201,67,134,435,45,230,55,131,44,79,56,21,2,71,44,27,10,10,110,33,77
"2021","Hounslow 006B","E01002565",1054,335,108,227,624,34,326,92,204,30,125,89,28,8,122,76,46,17,17,95,28,67
"2021","Hounslow 006C","E01002567",871,336,95,241,487,32,264,123,111,30,100,76,21,3,79,50,29,12,12,48,10,38
"2021","Hounslow 006E","E01002686",666,189,58,131,392,21,168,37,95,36,57,21,24,12,137,63,74,9,9,85,37,48
"2021","Hounslow 006G","E01034032",753,256,67,189,420,28,184,76,92,16,94,60,31,3,97,72,25,17,17,77,36,41
"2021","Hounslow 006H","E01034033",841,291,38,253,490,21,240,97,122,21,145,112,27,6,69,43,26,15,15,60,13,47
"2021","Hounslow 007A","E01002571",590,210,100,110,337,46,196,77,100,19,68,46,19,3,24,13,11,3,3,43,11,32
"2021","Hounslow 007B","E01002572",619,189,71,118,361,28,156,32,101,23,54,33,17,4,118,76,42,5,5,69,30,39
"2021","Hounslow 007C","E01002577",681,163,66,97,455,52,222,59,124,39,125,108,16,1,47,20,27,9,9,63,17,46
"2021","Hounslow 007D","E01002578",591,140,65,75,410,61,235,58,145,32,47,28,12,7,58,38,20,9,9,41,21,20
"2021","Hounslow 007E","E01002689",754,311,123,188,395,42,192,71,103,18,57,43,13,1,97,56,41,7,7,48,14,34
"2021","Hounslow 007F","E01002690",583,184,44,140,351,41,224,69,117,38,46,29,15,2,36,19,17,4,4,48,12,36
"2021","Hounslow 008A","E01002576",700,214,63,151,429,31,201,59,116,26,64,37,25,2,121,59,62,12,12,57,13,44
"2021","Hounslow 008B","E01002579",769,262,138,124,471,80,239,69,135,35,88,62,26,0,57,32,25,7,7,36,14,22
"2021","Hounslow 008C","E01002580",677,266,89,177,332,25,165,47,106,12,66,47,16,3,63,43,20,13,13,79,16,63
"2021","Hounslow 008D","E01002581",843,264,81,183,497,43,255,79,155,21,125,94,29,2,60,40,20,14,14,82,14,68
"2021","Hounslow 008E","E01002582",692,208,101,107,430,43,254,66,155,33,74,47,27,0,53,39,14,6,6,54,15,39
"2021","Hounslow 009A","E01002675",876,153,53,100,596,59,366,72,204,90,64,37,27,0,102,50,52,5,5,127,63,64
"2021","Hounslow 009B","E01002678",759,208,53,155,442,49,277,63,149,65,62,42,16,4,44,23,21,10,10,109,46,63
"2021","Hounslow 009C","E01002679",624,131,49,82,375,44,236,36,133,67,38,16,21,1,48,21,27,9,9,118,46,72
"2021","Hounslow 009D","E01002680",741,179,64,115,437,40,257,45,162,50,60,40,18,2,73,38,35,7,7,125,46,79
"2021","Hounslow 010A","E01002619",634,144,94,50,322,42,199,37,99,63,12,2,9,1,60,20,40,9,9,168,105,63
"2021","Hounslow 010B","E01002622",573,104,35,69,343,23,226,27,136,63,20,4,13,3,70,31,39,4,4,126,67,59
"2021","Hounslow 010C","E01002632",624,172,116,56,336,38,228,24,121,83,10,5,5,0,49,15,34,11,11,116,66,50
"2021","Hounslow 010D","E01002635",557,76,41,35,319,24,219,43,103,73,18,7,8,3,49,21,28,9,9,162,98,64
"2021","Hounslow 010E","E01002636",618,100,54,46,362,33,223,30,122,71,19,8,9,2,77,35,42,10,10,156,95,61
"2021","Hounslow 011A","E01002618",558,72,34,38,364,26,272,42,149,81,13,7,4,2,47,17,30,6,6,122,75,47
"2021","Hounslow 011B","E01002621",607,125,38,87,345,17,226,33,132,61,20,8,11,1,78,42,36,4,4,137,82,55
"2021","Hounslow 011C","E01002623",535,111,26,85,282,22,159,21,82,56,7,6,0,1,88,39,49,6,6,142,86,56
"2021","Hounslow 011D","E01002628",651,101,48,53,374,40,228,32,123,73,22,6,14,2,70,35,35,14,14,176,117,59
"2021","Hounslow 011E","E01002629",883,182,65,117,558,35,326,47,200,79,51,18,31,2,130,77,53,16,16,143,76,67
"2021","Hounslow 012A","E01002630",680,126,43,83,398,30,219,38,123,58,22,12,9,1,87,47,40,40,40,156,57,99
"2021","Hounslow 012B","E01002639",548,98,39,59,301,34,184,36,92,56,12,5,7,0,61,18,43,10,10,149,77,72
"2021","Hounslow 012C","E01002640",622,97,41,56,308,28,211,35,122,54,14,4,9,1,47,22,25,8,8,217,121,96
"2021","Hounslow 012D","E01002674",748,155,57,98,496,42,323,62,202,59,44,25,17,2,73,34,39,14,14,97,45,52
"2021","Hounslow 012E","E01002676",558,111,45,66,324,58,178,33,69,76,31,18,13,0,46,14,32,11,11,123,54,69
"2021","Hounslow 013A","E01002583",541,94,39,55,309,26,197,36,97,64,16,7,8,1,61,36,25,9,9,138,83,55
"2021","Hounslow 013B","E01002584",633,95,37,58,371,12,211,34,118,59,67,57,8,2,65,32,33,16,16,167,98,69
"2021","Hounslow 013C","E01002585",525,80,40,40,301,20,191,25,108,58,20,8,10,2,62,27,35,8,8,144,72,72
"2021","Hounslow 013D","E01002586",498,92,38,54,233,22,146,20,78,48,17,7,7,3,40,9,31,8,8,173,105,68
"2021","Hounslow 013E","E01002589",815,166,74,92,504,14,305,81,164,60,44,15,24,5,127,72,55,14,14,145,76,69
"2021","Hounslow 014A","E01002668",980,323,84,239,607,34,276,80,166,30,148,106,41,1,138,85,53,11,11,50,25,25
"2021","Hounslow 014B","E01002669",713,155,55,100,494,19,221,51,124,46,75,34,32,9,162,85,77,17,17,64,33,31
"2021","Hounslow 014C","E01002681",875,200,42,158,559,23,253,51,143,59,118,73,39,6,153,87,66,12,12,116,46,70
"2021","Hounslow 014D","E01002682",896,241,84,157,560,38,304,75,183,46,99,48,40,11,99,56,43,20,20,95,35,60
"2021","Hounslow 014F","E01034034",621,130,25,105,442,9,276,73,185,18,63,36,26,1,86,56,30,8,8,49,21,28
"2021","Hounslow 014G","E01034035",656,206,90,116,404,21,239,63,148,28,80,53,25,2,58,35,23,6,6,46,15,31
"2021","Hounslow 015B","E01002643",1044,330,161,169,598,37,326,69,183,74,64,35,25,4,151,102,49,20,20,116,59,57
"2021","Hounslow 015C","E01002645",781,211,80,131,398,28,227,58,132,37,39,21,18,0,87,57,30,17,17,172,83,89
"2021","Hounslow 015D","E01002658",496,100,48,52,335,36,193,53,101,39,51,25,21,5,49,21,28,6,6,61,25,36
"2021","Hounslow 015E","E01002677",839,239,51,188,506,24,263,90,141,32,104,64,36,4,97,67,30,18,18,94,41,53
"2021","Hounslow 015F","E01034036",677,150,15,135,443,6,244,57,169,18,66,37,26,3,109,73,36,18,18,84,37,47
"2021","Hounslow 015G","E01034037",652,148,48,100,404,16,223,46,147,30,44,33,9,2,110,85,25,11,11,100,49,51
"2021","Hounslow 016A","E01002587",740,107,52,55,490,30,243,26,134,83,33,15,15,3,169,34,135,15,15,143,91,52
"2021","Hounslow 016B","E01002588",745,211,57,154,452,13,212,40,147,25,58,25,29,4,158,103,55,11,11,82,51,31
"2021","Hounslow 016C","E01002660",616,114,53,61,342,16,210,38,116,56,28,12,16,0,81,20,61,7,7,160,91,69
"2021","Hounslow 016D","E01002661",613,90,44,46,294,29,189,41,97,51,20,13,6,1,49,19,30,7,7,229,140,89
"2021","Hounslow 016E","E01002665",566,138,64,74,310,31,176,33,96,47,19,7,10,2,80,38,42,4,4,118,66,52
"2021","Hounslow 017A","E01002624",515,101,38,63,299,24,181,26,112,43,12,2,6,4,69,30,39,13,13,115,79,36
"2021","Hounslow 017B","E01002646",749,191,70,121,447,17,276,39,188,49,33,14,17,2,111,74,37,10,10,111,62,49
"2021","Hounslow 017C","E01002662",916,301,70,231,432,35,261,78,123,60,56,37,17,2,60,30,30,20,20,183,97,86
"2021","Hounslow 017D","E01002663",690,170,98,72,336,36,178,30,103,45,28,10,16,2,84,34,50,10,10,184,110,74
"2021","Hounslow 017F","E01034038",547,98,16,82,375,8,256,31,198,27,40,20,17,3,66,50,16,5,5,74,43,31
"2021","Hounslow 017G","E01034039",532,100,33,67,349,8,229,21,183,25,27,13,9,5,79,61,18,6,6,83,51,32
"2021","Hounslow 018A","E01002641",985,248,59,189,584,35,314,103,167,44,62,47,13,2,153,115,38,20,20,153,60,93
"2021","Hounslow 018D","E01002649",733,204,41,163,417,19,252,52,167,33,47,26,19,2,91,58,33,8,8,112,51,61
"2021","Hounslow 018E","E01002657",682,143,61,82,447,41,276,57,153,66,52,28,17,7,70,36,34,8,8,92,41,51
"2021","Hounslow 018F","E01033083",788,137,11,126,552,2,443,115,315,13,41,31,10,0,52,32,20,14,14,99,49,50
"2021","Hounslow 018G","E01033084",707,154,28,126,457,13,241,59,148,34,51,28,23,0,140,109,31,12,12,96,52,44
"2021","Hounslow 018H","E01034040",556,132,31,101,315,10,195,40,128,27,30,18,11,1,69,42,27,11,11,109,59,50
"2021","Hounslow 018I","E01034041",443,79,30,49,241,14,146,24,94,28,24,10,12,2,51,27,24,6,6,123,72,51
"2021","Hounslow 019A","E01002653",598,97,42,55,381,43,264,43,138,83,20,10,10,0,45,17,28,9,9,120,61,59
"2021","Hounslow 019B","E01002654",660,135,64,71,422,59,270,65,130,75,39,20,16,3,50,25,25,4,4,103,52,51
"2021","Hounslow 019C","E01002655",626,122,64,58,396,42,242,42,131,69,35,21,12,2,63,26,37,14,14,108,52,56
"2021","Hounslow 019D","E01002656",525,98,50,48,377,38,230,79,118,33,33,16,14,3,57,24,33,19,19,50,27,23
"2021","Hounslow 019E","E01002659",512,111,46,65,327,34,200,40,112,48,45,20,15,10,45,14,31,3,3,74,35,39
"2021","Hounslow 020A","E01002667",917,302,97,205,521,38,238,77,131,30,127,89,34,4,112,75,37,6,6,94,39,55
"2021","Hounslow 020B","E01002670",730,180,60,120,463,43,255,53,163,39,82,45,34,3,75,39,36,8,8,87,39,48
"2021","Hounslow 020C","E01002671",668,123,51,72,474,49,246,46,161,39,58,28,25,5,118,76,42,3,3,71,32,39
"2021","Hounslow 020D","E01002672",659,243,72,171,353,10,173,45,91,37,72,54,17,1,94,58,36,4,4,63,28,35
"2021","Hounslow 020E","E01002673",586,162,43,119,375,10,152,23,102,27,38,12,25,1,169,121,48,6,6,49,26,23
"2021","Hounslow 021A","E01002647",757,167,63,104,511,24,303,48,191,64,44,18,22,4,132,74,58,8,8,79,46,33
"2021","Hounslow 021B","E01002650",793,138,44,94,527,24,313,49,203,61,46,19,24,3,136,80,56,8,8,128,92,36
"2021","Hounslow 021C","E01002651",564,97,45,52,319,31,198,28,119,51,28,16,12,0,49,27,22,13,13,148,79,69
"2021","Hounslow 021D","E01002652",562,95,39,56,313,31,182,33,93,56,37,22,14,1,53,17,36,10,10,154,78,76
"2021","Hounslow 021E","E01002666",481,59,32,27,297,24,184,26,96,62,21,7,13,1,60,21,39,8,8,125,74,51
"2021","Hounslow 022A","E01002555",702,144,71,73,436,37,258,60,124,74,40,21,19,0,93,39,54,8,8,122,58,64
"2021","Hounslow 022B","E01002556",663,140,64,76,435,33,232,34,134,64,54,14,35,5,107,68,39,9,9,88,52,36
"2021","Hounslow 022C","E01002590",999,353,205,148,512,39,270,57,163,50,67,32,29,6,129,69,60,7,7,134,81,53
"2021","Hounslow 022D","E01002592",776,198,116,82,456,33,237,49,133,55,50,15,29,6,125,75,50,11,11,122,56,66
"2021","Hounslow 022E","E01002595",714,164,57,107,412,30,217,43,116,58,46,14,26,6,112,70,42,7,7,138,82,56
"2021","Hounslow 023A","E01002557",732,187,75,112,450,34,248,55,132,61,74,48,22,4,80,49,31,14,14,95,50,45
"2021","Hounslow 023B","E01002558",819,236,84,152,501,36,271,67,155,49,58,20,31,7,125,81,44,11,11,82,40,42
"2021","Hounslow 023C","E01002559",918,265,58,207,532,32,272,60,160,52,98,43,47,8,120,83,37,10,10,121,73,48
"2021","Hounslow 023D","E01002560",654,164,84,80,382,26,198,48,98,52,54,18,26,10,100,50,50,4,4,108,58,50
"2021","Hounslow 023E","E01002561",598,181,31,150,343,8,141,39,67,35,61,23,32,6,127,89,38,6,6,74,58,16
"2021","Hounslow 024A","E01002591",614,104,52,52,403,23,221,45,122,54,44,14,22,8,105,46,59,10,10,107,49,58
"2021","Hounslow 024B","E01002593",698,156,71,85,383,41,235,50,116,69,37,15,18,4,60,31,29,10,10,159,82,77
"2021","Hounslow 024C","E01002594",647,119,72,47,378,36,225,40,123,62,38,17,13,8,71,28,43,8,8,150,80,70
"2021","Hounslow 024D","E01002611",674,136,59,77,438,38,250,54,127,69,39,19,16,4,103,69,34,8,8,100,48,52
"2021","Hounslow 024E","E01002612",824,253,91,162,464,28,259,68,140,51,62,34,22,6,104,66,38,11,11,107,47,60
"2021","Hounslow 024F","E01002613",631,114,55,59,411,35,238,51,118,69,43,17,18,8,90,44,46,5,5,106,65,41
"2021","Hounslow 025B","E01002598",656,136,43,93,425,20,246,54,127,65,54,15,32,7,94,48,46,11,11,95,56,39
"2021","Hounslow 025C","E01002599",559,115,55,60,373,17,187,46,104,37,46,19,22,5,114,66,48,9,9,71,27,44
"2021","Hounslow 025D","E01002600",512,76,37,39,352,26,183,34,104,45,45,13,19,13,92,41,51,6,6,84,47,37
"2021","Hounslow 025E","E01002603",645,109,34,75,446,15,252,54,147,51,67,28,34,5,99,49,50,13,13,90,52,38
"2021","Hounslow 025F","E01033000",619,159,40,119,390,15,159,25,105,29,46,8,27,11,163,107,56,7,7,70,35,35
"2021","Hounslow 025G","E01033030",719,158,9,149,489,6,345,87,244,14,63,29,30,4,68,48,20,7,7,72,32,40
"2021","Hounslow 026A","E01002604",555,118,24,94,373,14,151,22,88,41,56,17,29,10,145,85,60,7,7,64,36,28
"2021","Hounslow 026B","E01002605",832,221,76,145,506,38,232,41,145,46,81,36,40,5,146,99,47,9,9,105,74,31
"2021","Hounslow 026C","E01002606",611,185,88,97,365,24,185,33,112,40,30,12,14,4,119,71,48,7,7,61,31,30
"2021","Hounslow 026D","E01002607",778,137,55,82,492,29,262,52,150,60,72,31,36,5,116,67,49,13,13,149,77,72
"2021","Hounslow 026E","E01002615",632,215,83,132,350,18,152,35,84,33,52,22,24,6,122,75,47,6,6,67,31,36
"2021","Hounslow 027A","E01002596",760,231,22,209,473,4,238,61,140,37,82,41,38,3,137,100,37,12,12,56,27,29
"2021","Hounslow 027B","E01002601",666,144,45,99,461,16,273,66,163,44,83,41,40,2,86,54,32,3,3,61,39,22
"2021","Hounslow 027C","E01002602",549,105,46,59,385,32,236,74,121,41,52,20,26,6,62,29,33,3,3,59,30,29
"2021","Hounslow 027D","E01002614",821,235,73,162,483,38,267,68,170,29,79,36,41,2,88,54,34,11,11,103,46,57
"2021","Hounslow 027E","E01002616",564,114,64,50,370,35,214,50,114,50,32,14,16,2,81,43,38,8,8,80,38,42
"2021","Hounslow 028A","E01002608",668,172,57,115,411,39,202,47,116,39,60,16,39,5,104,64,40,6,6,85,50,35
"2021","Hounslow 028B","E01002609",664,160,81,79,438,39,249,58,128,63,58,25,23,10,88,46,42,4,4,66,37,29
"2021","Hounslow 028C","E01002610",634,163,73,90,408,34,201,34,120,47,43,10,29,4,124,85,39,6,6,63,29,34
"2021","Hounslow 028D","E01002617",634,168,74,94,420,48,247,60,124,63,55,18,33,4,62,29,33,8,8,46,28,18
"2021","Hounslow 029A","E01002687",756,274,81,193,414,28,229,61,147,21,92,70,19,3,49,31,18,16,16,68,11,57
"2021","Hounslow 029B","E01002691",587,142,56,86,314,30,191,52,106,33,39,28,11,0,38,23,15,16,16,131,19,112
"2021","Hounslow 029C","E01002692",1013,391,95,296,532,27,275,109,144,22,140,120,19,1,74,49,25,16,16,90,17,73
"2021","Hounslow 029D","E01002693",884,413,208,205,402,39,202,60,121,21,91,74,12,5,61,35,26,9,9,69,11,58
"2021","Hounslow 029E","E01032573",899,366,111,255,463,41,232,94,115,23,128,113,14,1,50,35,15,12,12,70,7,63
"2021","Hounslow 030D","E01002562",523,144,52,92,311,25,151,24,88,39,39,14,20,5,86,47,39,10,10,68,26,42
"2021","Hounslow 030A","E01034042",595,216,30,186,350,6,132,55,66,11,67,54,12,1,139,101,38,6,6,29,7,22
"2021","Hounslow 030B","E01034043",641,224,40,184,367,13,186,81,87,18,71,48,21,2,89,65,24,8,8,50,16,34
"2021","Hounslow 030C","E01034044",576,190,28,162,361,30,192,83,87,22,59,49,10,0,72,51,21,8,8,25,6,19
"2021","Hounslow 031E","E01002564",726,203,63,140,435,20,183,37,110,36,75,36,34,5,142,73,69,15,15,88,34,54
"2021","Hounslow 031D","E01033081",777,319,81,238,410,11,211,86,109,16,94,72,19,3,81,53,28,13,13,48,10,38
"2021","Hounslow 031C","E01033082",652,306,142,164,290,36,107,40,55,12,63,45,16,2,73,48,25,11,11,56,11,45
"2021","Hounslow 031A","E01034045",841,267,19,248,521,5,227,103,110,14,152,112,40,0,124,69,55,13,13,53,12,41
"2021","Hounslow 031B","E01034046",735,220,95,125,439,27,188,39,111,38,42,15,17,10,177,98,79,5,5,76,36,40
"2021","Islington 001A","E01002755",613,254,73,181,299,7,110,23,60,27,44,30,11,3,120,63,57,18,18,60,23,37
"2021","Islington 001B","E01002756",586,187,45,142,332,11,134,42,70,22,99,72,22,5,81,33,48,7,7,67,14,53
"2021","Islington 001C","E01002758",755,259,52,207,437,14,139,28,82,29,85,55,29,1,184,129,55,15,15,59,9,50
"2021","Islington 001D","E01002804",712,287,62,225,327,13,105,32,57,16,78,56,19,3,118,72,46,13,13,98,22,76
"2021","Islington 001E","E01002807",807,328,65,263,353,10,107,33,53,21,79,53,23,3,137,86,51,20,20,126,17,109
"2021","Islington 001F","E01002811",736,245,71,174,420,10,143,36,85,22,114,70,43,1,136,74,62,17,17,71,12,59
"2021","Islington 002A","E01002753",625,215,65,150,307,20,107,46,43,18,62,51,9,2,102,55,47,16,16,103,22,81
"2021","Islington 002B","E01002754",634,188,60,128,343,18,185,47,111,27,74,55,16,3,57,32,25,9,9,103,18,85
"2021","Islington 002C","E01002757",598,175,53,122,360,14,161,48,84,29,67,52,12,3,111,70,41,7,7,63,16,47
"2021","Islington 002D","E01002759",614,180,56,124,350,35,138,52,69,17,88,60,22,6,76,38,38,13,13,84,14,70
"2021","Islington 002E","E01002760",690,212,58,154,391,15,134,25,88,21,92,61,28,3,142,81,61,8,8,87,27,60
"2021","Islington 002F","E01002772",874,311,76,235,407,11,125,60,52,13,126,105,20,1,125,61,64,20,20,156,14,142
"2021","Islington 003A","E01002735",1132,388,49,339,557,11,152,62,72,18,240,222,14,4,130,80,50,24,24,187,50,137
"2021","Islington 003B","E01002805",715,271,46,225,325,9,96,46,38,12,139,123,15,1,67,39,28,14,14,119,7,112
"2021","Islington 003C","E01002806",701,213,69,144,370,12,168,46,99,23,107,77,24,6,70,34,36,13,13,118,18,100
"2021","Islington 003D","E01002808",868,287,63,224,432,23,149,54,78,17,126,97,27,2,119,78,41,15,15,149,21,128
"2021","Islington 003E","E01002809",735,289,74,215,329,10,116,34,62,20,99,81,14,4,91,45,46,13,13,117,37,80
"2021","Islington 003F","E01002810",786,300,60,240,360,15,131,60,54,17,81,64,17,0,117,51,66,16,16,126,18,108
"2021","Islington 004A","E01002768",852,387,102,285,373,25,119,50,54,15,106,79,26,1,113,54,59,10,10,92,15,77
"2021","Islington 004B","E01002770",910,378,68,310,416,15,177,79,84,14,139,121,16,2,68,39,29,17,17,116,13,103
"2021","Islington 004C","E01002771",670,220,57,163,353,14,106,28,55,23,101,76,18,7,117,62,55,15,15,97,11,86
"2021","Islington 004D","E01002773",684,295,89,206,315,20,111,28,57,26,54,41,10,3,116,62,54,14,14,74,25,49
"2021","Islington 004E","E01002774",1027,350,80,270,526,12,182,81,76,25,147,118,25,4,164,93,71,21,21,151,14,137
"2021","Islington 005A","E01002732",816,337,83,254,386,9,144,55,60,29,72,58,11,3,144,74,70,17,17,93,26,67
"2021","Islington 005B","E01002734",936,307,42,265,484,11,166,53,92,21,102,83,15,4,181,132,49,24,24,145,45,100
"2021","Islington 005C","E01002736",572,197,68,129,306,16,119,33,62,24,36,22,14,0,122,73,49,13,13,69,23,46
"2021","Islington 005D","E01002737",759,229,66,163,400,14,149,31,90,28,78,46,27,5,145,93,52,14,14,130,20,110
"2021","Islington 005E","E01002751",873,356,70,286,422,16,122,42,63,17,112,76,30,6,152,105,47,20,20,95,22,73
"2021","Islington 006A","E01002742",715,177,45,132,436,31,231,61,149,21,115,84,28,3,49,21,28,10,10,102,7,95
"2021","Islington 006B","E01002747",650,192,47,145,354,17,168,48,102,18,84,56,26,2,78,37,41,7,7,104,13,91
"2021","Islington 006C","E01002748",692,242,38,204,349,2,141,45,77,19,69,56,11,2,121,71,50,16,16,101,30,71
"2021","Islington 006D","E01002749",602,172,42,130,348,18,144,30,98,16,76,56,16,4,101,67,34,9,9,82,19,63
"2021","Islington 006F","E01033493",688,230,20,210,402,3,157,93,58,6,204,188,16,0,25,8,17,13,13,56,2,54
"2021","Islington 006G","E01033494",651,210,45,165,351,16,197,57,115,25,96,67,28,1,31,18,13,11,11,90,10,80
"2021","Islington 007A","E01002730",795,281,52,229,356,20,103,46,46,11,126,110,14,2,88,47,41,19,19,158,22,136
"2021","Islington 007C","E01002733",604,171,37,134,317,9,119,46,57,16,107,83,22,2,65,34,31,17,17,116,15,101
"2021","Islington 007D","E01002763",571,215,58,157,276,15,101,39,47,15,83,70,12,1,59,39,20,18,18,80,6,74
"2021","Islington 007E","E01035651",692,218,37,181,359,7,124,52,59,13,125,104,20,1,86,57,29,17,17,115,16,99
"2021","Islington 007F","E01035652",606,216,35,181,287,5,89,49,31,9,135,118,15,2,46,31,15,12,12,103,6,97
"2021","Islington 008A","E01002769",710,253,78,175,359,26,174,50,93,31,89,56,28,5,61,38,23,9,9,98,26,72
"2021","Islington 008B","E01002785",780,214,51,163,426,41,187,61,102,24,121,94,25,2,71,42,29,6,6,140,21,119
"2021","Islington 008C","E01002788",888,358,70,288,447,21,157,59,78,20,178,142,31,5,79,46,33,12,12,83,10,73
"2021","Islington 008D","E01002789",783,213,64,149,463,35,227,69,128,30,122,101,19,2,64,30,34,15,15,107,17,90
"2021","Islington 009A","E01002738",847,309,95,214,443,28,190,75,98,17,122,104,15,3,89,57,32,14,14,95,18,77
"2021","Islington 009B","E01002741",634,223,63,160,330,10,117,23,71,23,66,41,20,5,122,69,53,15,15,81,20,61
"2021","Islington 009C","E01002743",629,204,55,149,355,17,142,41,88,13,114,90,22,2,74,47,27,8,8,70,17,53
"2021","Islington 009D","E01002744",676,276,70,206,329,11,146,57,74,15,107,92,12,3,60,22,38,5,5,71,9,62
"2021","Islington 009E","E01002752",703,218,48,170,394,21,157,56,73,28,113,87,23,3,98,50,48,5,5,91,13,78
"2021","Islington 010A","E01002764",797,264,70,194,414,23,141,43,74,24,88,64,16,8,153,94,59,9,9,119,18,101
"2021","Islington 010B","E01002783",795,359,87,272,351,11,103,39,48,16,73,58,12,3,146,99,47,18,18,85,10,75
"2021","Islington 010C","E01002784",752,259,88,171,409,14,140,39,74,27,89,68,17,4,153,90,63,13,13,84,19,65
"2021","Islington 010D","E01002786",888,339,78,261,437,9,144,49,76,19,123,94,28,1,146,89,57,15,15,112,19,93
"2021","Islington 010E","E01002787",625,207,40,167,306,4,119,44,57,18,80,60,17,3,84,57,27,19,19,112,18,94
"2021","Islington 011C","E01002762",857,269,59,210,403,17,133,53,56,24,150,127,18,5,73,39,34,30,30,185,18,167
"2021","Islington 011D","E01002767",941,344,96,248,429,27,132,49,56,27,98,83,12,3,150,88,62,22,22,168,20,148
"2021","Islington 011E","E01033486",422,130,25,105,211,6,91,31,47,13,37,28,8,1,74,46,28,3,3,81,15,66
"2021","Islington 011F","E01033487",596,185,7,178,302,1,120,68,49,3,119,107,12,0,46,33,13,16,16,109,5,104
"2021","Islington 011G","E01033488",618,210,47,163,311,7,101,31,42,28,97,79,12,6,87,55,32,19,19,97,12,85
"2021","Islington 011H","E01033491",967,390,51,339,451,16,146,62,69,15,177,156,19,2,85,55,30,27,27,126,13,113
"2021","Islington 011J","E01035653",756,312,9,303,354,1,135,74,59,2,172,139,32,1,27,18,9,19,19,90,3,87
"2021","Islington 011K","E01035654",506,179,24,155,278,4,92,34,52,6,93,55,38,0,84,69,15,5,5,49,10,39
"2021","Islington 012A","E01002777",765,269,51,218,377,16,119,47,66,6,128,104,21,3,97,52,45,17,17,119,11,108
"2021","Islington 012B","E01002778",754,229,63,166,412,10,128,35,72,21,86,67,18,1,175,113,62,13,13,113,27,86
"2021","Islington 012C","E01002779",778,300,42,258,397,18,142,49,80,13,128,103,23,2,96,63,33,13,13,81,6,75
"2021","Islington 012D","E01002781",639,195,51,144,327,15,113,23,65,25,90,76,12,2,103,60,43,6,6,117,16,101
"2021","Islington 012E","E01002782",558,169,40,129,305,9,98,19,57,22,55,23,22,10,138,85,53,5,5,84,25,59
"2021","Islington 013A","E01002739",818,282,79,203,456,34,202,67,106,29,129,100,27,2,80,50,30,11,11,80,11,69
"2021","Islington 013B","E01002740",979,302,63,239,550,31,278,86,166,26,159,127,30,2,70,41,29,12,12,127,12,115
"2021","Islington 013C","E01002745",683,250,69,181,356,17,134,61,57,16,124,93,26,5,73,36,37,8,8,77,7,70
"2021","Islington 013D","E01002795",853,268,47,221,458,23,176,64,80,32,128,106,19,3,102,66,36,29,29,127,20,107
"2021","Islington 013E","E01002796",505,204,35,169,242,16,89,23,50,16,64,53,11,0,48,27,21,25,25,59,12,47
"2021","Islington 014A","E01002716",1034,364,111,253,541,21,154,52,80,22,127,95,24,8,220,109,111,19,19,129,31,98
"2021","Islington 014B","E01002718",750,247,42,205,389,20,175,96,60,19,138,123,15,0,45,23,22,11,11,114,24,90
"2021","Islington 014C","E01002721",799,285,61,224,426,25,139,49,78,12,154,114,38,2,101,48,53,7,7,88,15,73
"2021","Islington 014D","E01002775",663,226,44,182,332,6,125,52,59,14,139,122,14,3,52,32,20,10,10,105,18,87
"2021","Islington 014E","E01002776",885,328,72,256,451,16,149,52,78,19,132,113,18,1,139,94,45,15,15,106,12,94
"2021","Islington 014F","E01002780",764,255,45,210,416,14,181,51,57,73,128,106,16,6,83,47,36,10,10,93,18,75
"2021","Islington 015A","E01002708",1001,370,67,303,481,18,169,62,82,25,113,94,16,3,155,99,56,26,26,150,19,131
"2021","Islington 015B","E01002712",613,208,65,143,303,6,110,43,49,18,82,66,12,4,89,61,28,16,16,102,16,86
"2021","Islington 015C","E01002713",1051,411,132,279,476,28,160,40,93,27,98,76,17,5,170,112,58,20,20,164,20,144
"2021","Islington 015D","E01002765",1071,395,81,314,531,13,182,90,70,22,120,85,30,5,180,115,65,36,36,145,29,116
"2021","Islington 015E","E01002766",934,356,78,278,450,16,181,45,104,32,89,65,20,4,143,78,65,21,21,128,27,101
"2021","Islington 016A","E01002717",535,152,39,113,311,23,133,48,65,20,69,50,17,2,73,42,31,13,13,72,8,64
"2021","Islington 016B","E01002719",689,226,83,143,392,34,184,61,102,21,110,87,21,2,53,28,25,11,11,71,10,61
"2021","Islington 016C","E01002720",934,338,80,258,505,13,132,31,77,24,94,63,26,5,247,164,83,19,19,91,24,67
"2021","Islington 016D","E01002790",692,292,78,214,342,18,94,30,40,24,72,50,17,5,147,95,52,11,11,58,13,45
"2021","Islington 016E","E01002791",850,268,70,198,454,31,189,62,111,16,144,116,25,3,73,48,25,17,17,128,11,117
"2021","Islington 016F","E01002793",902,367,96,271,427,9,112,51,44,17,124,95,25,4,164,87,77,18,18,108,20,88
"2021","Islington 017A","E01002698",1037,420,50,370,524,28,198,107,72,19,180,162,17,1,102,69,33,16,16,93,16,77
"2021","Islington 017B","E01002699",746,296,81,215,383,28,154,78,55,21,97,71,21,5,93,45,48,11,11,67,5,62
"2021","Islington 017C","E01002700",615,184,51,133,371,63,182,67,90,25,84,68,16,0,34,20,14,8,8,60,17,43
"2021","Islington 017D","E01002714",719,266,48,218,340,25,161,72,75,14,101,79,19,3,44,24,20,9,9,113,20,93
"2021","Islington 017E","E01002792",885,300,49,251,483,32,183,81,81,21,157,131,21,5,97,56,41,14,14,102,14,88
"2021","Islington 018A","E01002722",698,282,64,218,354,11,134,39,81,14,89,64,22,3,112,63,49,8,8,62,17,45
"2021","Islington 018B","E01002797",871,326,67,259,399,17,127,63,48,16,116,92,20,4,126,77,49,13,13,146,12,134
"2021","Islington 018C","E01002798",901,296,79,217,518,29,272,107,144,21,145,121,17,7,58,39,19,14,14,87,10,77
"2021","Islington 018D","E01002799",857,302,73,229,456,19,157,46,92,19,102,73,28,1,164,114,50,14,14,99,20,79
"2021","Islington 018E","E01002800",796,310,60,250,392,14,122,38,57,27,122,105,14,3,125,79,46,9,9,94,44,50
"2021","Islington 019A","E01002694",664,201,59,142,359,9,93,17,57,19,57,34,17,6,188,109,79,12,12,104,24,80
"2021","Islington 019B","E01002697",829,308,73,235,342,15,111,30,59,22,70,45,20,5,131,75,56,15,15,179,28,151
"2021","Islington 019C","E01002709",702,229,72,157,327,20,124,31,62,31,72,55,13,4,96,43,53,15,15,146,23,123
"2021","Islington 019D","E01002710",644,193,53,140,339,20,122,25,68,29,68,50,12,6,120,56,64,9,9,112,23,89
"2021","Islington 019E","E01002715",687,252,48,204,350,9,119,25,79,15,66,42,20,4,144,93,51,12,12,85,20,65
"2021","Islington 020A","E01002696",860,289,69,220,455,35,183,90,72,21,135,117,13,5,86,39,47,16,16,116,7,109
"2021","Islington 020B","E01002794",1016,400,75,325,478,26,184,98,66,20,149,128,21,0,98,52,46,21,21,138,11,127
"2021","Islington 020C","E01002801",757,306,70,236,382,27,163,84,62,17,125,114,9,2,54,23,31,13,13,69,5,64
"2021","Islington 020D","E01002802",821,294,48,246,433,21,173,77,78,18,145,116,27,2,78,54,24,16,16,94,16,78
"2021","Islington 020F","E01035655",750,256,59,197,410,30,170,62,89,19,104,82,15,7,85,56,29,21,21,84,14,70
"2021","Islington 020G","E01035656",722,317,11,306,343,5,105,61,38,6,143,111,31,1,78,63,15,12,12,62,3,59
"2021","Islington 021A","E01002695",745,323,47,276,304,12,96,44,41,11,118,107,8,3,65,32,33,13,13,118,13,105
"2021","Islington 021B","E01002711",964,403,45,358,422,25,151,73,61,17,121,111,8,2,97,53,44,28,28,139,17,122
"2021","Islington 021C","E01002727",801,337,55,282,383,21,123,68,36,19,130,106,19,5,98,54,44,11,11,81,7,74
"2021","Islington 021D","E01002728",438,190,34,156,199,9,70,34,31,5,59,41,12,6,57,35,22,4,4,49,13,36
"2021","Islington 021E","E01002729",658,242,65,177,335,38,149,59,59,31,77,55,16,6,62,35,27,9,9,81,9,72
"2021","Islington 022B","E01002707",894,390,69,321,376,20,134,57,49,28,111,91,16,4,94,53,41,17,17,128,15,113
"2021","Islington 022C","E01002723",732,298,75,223,350,9,114,37,60,17,83,63,16,4,129,84,45,15,15,84,8,76
"2021","Islington 022D","E01002724",964,399,62,337,442,17,173,108,55,10,164,152,11,1,65,44,21,23,23,123,6,117
"2021","Islington 022E","E01002725",559,220,39,181,275,8,89,24,42,23,48,27,16,5,119,79,40,11,11,64,11,53
"2021","Islington 022F","E01002726",788,288,68,220,386,11,170,58,99,13,103,85,12,6,96,51,45,6,6,114,11,103
"2021","Islington 022G","E01033489",674,285,25,260,318,11,130,83,41,6,133,123,9,1,32,18,14,12,12,71,5,66
"2021","Islington 022H","E01033490",554,230,43,187,259,10,96,54,30,12,78,61,14,3,59,44,15,16,16,65,6,59
"2021","Islington 023A","E01002701",675,260,89,171,328,22,121,56,44,21,66,46,16,4,102,63,39,17,17,87,12,75
"2021","Islington 023B","E01002702",1116,416,59,357,559,7,200,82,92,26,135,107,20,8,197,146,51,20,20,141,20,121
"2021","Islington 023C","E01002703",1128,432,82,350,567,23,191,81,81,29,142,114,24,4,188,128,60,23,23,129,22,107
"2021","Islington 023D","E01002704",1119,478,88,390,523,18,201,93,81,27,131,101,26,4,151,106,45,22,22,118,17,101
"2021","Islington 023E","E01002706",915,342,92,250,453,23,145,53,67,25,94,61,31,2,167,110,57,24,24,120,16,104
"2021","Kensington and Chelsea 001A","E01002852",845,323,84,239,446,14,187,49,78,60,53,30,18,5,178,101,77,14,14,76,32,44
"2021","Kensington and Chelsea 001B","E01002853",588,222,52,170,318,16,100,26,50,24,36,31,5,0,154,43,111,12,12,48,21,27
"2021","Kensington and Chelsea 001C","E01002854",461,165,56,109,251,19,101,25,56,20,24,16,5,3,94,53,41,13,13,45,22,23
"2021","Kensington and Chelsea 001D","E01002855",723,316,87,229,343,18,123,23,52,48,55,41,12,2,136,59,77,11,11,64,23,41
"2021","Kensington and Chelsea 001E","E01002857",556,211,48,163,271,9,102,24,47,31,23,10,9,4,126,64,62,11,11,74,24,50
"2021","Kensington and Chelsea 002A","E01002904",497,164,52,112,276,10,99,16,41,42,29,11,13,5,133,75,58,5,5,57,29,28
"2021","Kensington and Chelsea 002B","E01002905",651,270,55,215,286,17,97,29,46,22,35,22,12,1,114,63,51,23,23,95,64,31
"2021","Kensington and Chelsea 002C","E01002906",646,212,55,157,354,20,146,33,75,38,42,26,15,1,132,65,67,14,14,80,34,46
"2021","Kensington and Chelsea 002D","E01002907",514,177,70,107,285,9,82,8,47,27,25,5,16,4,162,106,56,7,7,52,35,17
"2021","Kensington and Chelsea 003A","E01002876",693,222,80,142,370,38,193,51,102,40,51,25,22,4,77,36,41,11,11,101,63,38
"2021","Kensington and Chelsea 003B","E01002877",765,208,60,148,437,19,169,38,85,46,51,25,19,7,176,99,77,22,22,120,77,43
"2021","Kensington and Chelsea 003C","E01002878",754,367,113,254,318,15,137,49,70,18,79,67,11,1,69,35,34,18,18,69,14,55
"2021","Kensington and Chelsea 003D","E01002908",589,217,67,150,317,24,158,37,76,45,50,30,18,2,73,45,28,12,12,55,20,35
"2021","Kensington and Chelsea 003E","E01002909",1021,482,117,365,434,22,184,73,74,37,97,84,9,4,110,50,60,21,21,105,49,56
"2021","Kensington and Chelsea 004A","E01002829",722,377,79,298,283,14,105,34,50,21,59,48,8,3,91,30,61,14,14,62,10,52
"2021","Kensington and Chelsea 004B","E01002830",822,389,114,275,318,14,112,50,43,19,63,43,16,4,115,61,54,14,14,115,43,72
"2021","Kensington and Chelsea 004C","E01002831",889,439,124,315,369,14,138,49,66,23,67,45,20,2,139,52,87,11,11,81,19,62
"2021","Kensington and Chelsea 004D","E01002832",790,349,94,255,368,18,144,44,57,43,76,54,13,9,118,62,56,12,12,73,24,49
"2021","Kensington and Chelsea 004E","E01002856",768,396,79,317,278,5,99,48,39,12,70,59,10,1,88,43,45,16,16,94,18,76
"2021","Kensington and Chelsea 005A","E01002870",695,301,104,197,309,21,117,27,50,40,37,21,8,8,121,66,55,13,13,85,13,72
"2021","Kensington and Chelsea 005B","E01002872",655,284,151,133,319,29,138,59,55,24,43,23,13,7,101,47,54,8,8,52,25,27
"2021","Kensington and Chelsea 005C","E01002879",704,259,91,168,356,16,122,27,73,22,89,41,46,2,120,61,59,9,9,89,52,37
"2021","Kensington and Chelsea 005D","E01002880",455,156,35,121,238,7,96,25,47,24,21,13,7,1,113,49,64,1,1,61,19,42
"2021","Kensington and Chelsea 005E","E01002881",516,158,51,107,298,14,135,10,73,52,32,15,13,4,107,54,53,10,10,60,23,37
"2021","Kensington and Chelsea 006A","E01002882",562,296,110,186,231,15,113,36,65,12,45,34,9,2,54,29,25,4,4,35,9,26
"2021","Kensington and Chelsea 006B","E01002883",653,270,80,190,319,28,179,70,93,16,57,48,8,1,48,27,21,7,7,64,15,49
"2021","Kensington and Chelsea 006C","E01002884",593,324,74,250,219,12,108,51,46,11,63,57,6,0,28,14,14,8,8,50,9,41
"2021","Kensington and Chelsea 006D","E01002885",805,459,78,381,275,6,117,49,59,9,91,81,9,1,44,31,13,17,17,71,4,67
"2021","Kensington and Chelsea 006E","E01002886",667,311,70,241,302,28,167,48,85,34,60,56,1,3,39,17,22,8,8,54,17,37
"2021","Kensington and Chelsea 007A","E01002833",650,333,73,260,266,11,128,47,63,18,63,55,8,0,51,30,21,13,13,51,13,38
"2021","Kensington and Chelsea 007B","E01002871",643,202,67,135,381,28,253,108,116,29,58,49,8,1,38,21,17,4,4,60,16,44
"2021","Kensington and Chelsea 007C","E01002873",656,251,54,197,362,47,166,77,68,21,50,42,6,2,91,22,69,8,8,43,17,26
"2021","Kensington and Chelsea 007D","E01002874",587,299,67,232,241,8,129,40,58,31,43,39,3,1,57,30,27,4,4,47,13,34
"2021","Kensington and Chelsea 007E","E01002875",579,240,97,143,275,30,163,67,71,25,42,37,5,0,33,16,17,7,7,64,21,43
"2021","Kensington and Chelsea 008A","E01002824",552,210,59,151,298,35,167,64,90,13,43,39,3,1,46,21,25,7,7,44,13,31
"2021","Kensington and Chelsea 008B","E01002825",728,238,81,157,431,48,244,66,147,31,41,28,12,1,84,58,26,14,14,59,25,34
"2021","Kensington and Chelsea 008C","E01002826",636,259,72,187,339,42,185,84,91,10,48,43,5,0,51,28,23,13,13,38,8,30
"2021","Kensington and Chelsea 008D","E01002827",793,310,81,229,409,32,237,88,130,19,81,66,14,1,52,32,20,7,7,74,12,62
"2021","Kensington and Chelsea 008E","E01002828",626,308,86,222,277,35,144,56,79,9,50,39,9,2,39,23,16,9,9,41,12,29
"2021","Kensington and Chelsea 009A","E01002864",531,147,64,83,301,38,198,41,119,38,20,17,2,1,43,22,21,2,2,83,52,31
"2021","Kensington and Chelsea 009B","E01002866",769,296,63,233,364,18,166,67,77,22,77,68,7,2,79,40,39,24,24,109,56,53
"2021","Kensington and Chelsea 009C","E01002867",811,340,87,253,378,21,169,55,84,30,74,70,3,1,85,47,38,29,29,93,19,74
"2021","Kensington and Chelsea 009D","E01002868",529,163,71,92,302,49,185,58,93,34,39,29,9,1,27,16,11,2,2,64,46,18
"2021","Kensington and Chelsea 009E","E01002869",749,307,74,233,345,29,170,57,94,19,66,49,16,1,65,35,30,15,15,97,49,48
"2021","Kensington and Chelsea 010A","E01002887",556,289,53,236,225,16,121,59,51,11,51,45,5,1,20,9,11,17,17,42,8,34
"2021","Kensington and Chelsea 010B","E01002889",565,207,48,159,244,19,144,59,75,10,35,33,2,0,32,19,13,14,14,114,12,102
"2021","Kensington and Chelsea 010C","E01002890",564,160,67,93,357,57,228,81,131,16,31,24,6,1,36,20,16,5,5,47,20,27
"2021","Kensington and Chelsea 010D","E01002891",558,223,56,167,284,27,179,84,69,26,37,34,3,0,32,16,16,9,9,51,8,43
"2021","Kensington and Chelsea 010E","E01002892",641,267,50,217,317,21,164,64,79,21,58,50,7,1,54,31,23,20,20,57,10,47
"2021","Kensington and Chelsea 011A","E01002813",682,235,79,156,397,44,217,60,103,54,60,52,8,0,52,31,21,24,24,50,16,34
"2021","Kensington and Chelsea 011B","E01002815",633,303,87,216,273,19,147,83,54,10,57,50,6,1,36,15,21,14,14,57,4,53
"2021","Kensington and Chelsea 011C","E01002816",546,258,49,209,258,23,149,53,82,14,39,32,6,1,35,19,16,12,12,30,6,24
"2021","Kensington and Chelsea 011D","E01002817",608,220,78,142,330,49,188,66,94,28,38,32,6,0,36,17,19,19,19,58,13,45
"2021","Kensington and Chelsea 011E","E01002865",563,141,34,107,353,31,253,98,99,56,20,14,6,0,39,25,14,10,10,69,30,39
"2021","Kensington and Chelsea 012A","E01002818",716,291,67,224,332,26,174,98,60,16,70,66,4,0,45,22,23,17,17,93,18,75
"2021","Kensington and Chelsea 012B","E01002819",573,272,51,221,254,20,161,85,71,5,28,21,6,1,32,15,17,13,13,47,14,33
"2021","Kensington and Chelsea 012C","E01002859",661,296,60,236,315,25,158,69,68,21,61,53,6,2,44,26,18,27,27,50,10,40
"2021","Kensington and Chelsea 012D","E01002860",565,267,62,205,266,28,154,44,87,23,38,34,4,0,32,15,17,14,14,32,6,26
"2021","Kensington and Chelsea 012E","E01002863",555,230,66,164,274,29,157,74,69,14,40,33,6,1,40,19,21,8,8,51,16,35
"2021","Kensington and Chelsea 013A","E01002812",735,301,62,239,381,18,249,147,87,15,53,43,10,0,43,24,19,18,18,53,9,44
"2021","Kensington and Chelsea 013B","E01002834",612,283,66,217,282,19,157,48,89,20,66,57,9,0,29,15,14,11,11,47,13,34
"2021","Kensington and Chelsea 013C","E01002839",856,509,80,429,289,11,122,42,68,12,65,57,5,3,57,11,46,34,34,58,9,49
"2021","Kensington and Chelsea 013D","E01002850",628,285,45,240,234,8,113,46,53,14,59,52,5,2,41,19,22,13,13,109,19,90
"2021","Kensington and Chelsea 013E","E01002888",827,417,60,357,291,21,144,66,65,13,67,56,10,1,30,18,12,29,29,119,8,111
"2021","Kensington and Chelsea 014A","E01002821",538,245,47,198,249,28,131,51,59,21,45,38,7,0,23,13,10,22,22,44,5,39
"2021","Kensington and Chelsea 014B","E01002823",607,268,95,173,296,33,129,42,54,33,37,25,10,2,92,42,50,5,5,43,17,26
"2021","Kensington and Chelsea 014C","E01002858",639,341,78,263,237,26,86,24,36,26,33,17,6,10,81,33,48,11,11,61,38,23
"2021","Kensington and Chelsea 014D","E01002861",553,243,69,174,231,27,130,48,65,17,30,26,4,0,33,17,16,11,11,79,44,35
"2021","Kensington and Chelsea 014E","E01002862",714,489,121,368,179,19,67,30,24,13,31,26,3,2,48,16,32,14,14,46,8,38
"2021","Kensington and Chelsea 015A","E01002814",1016,406,81,325,521,23,255,75,138,42,63,49,10,4,148,81,67,32,32,89,25,64
"2021","Kensington and Chelsea 015B","E01002847",716,352,55,297,292,13,141,67,63,11,90,84,5,1,29,14,15,19,19,72,7,65
"2021","Kensington and Chelsea 015C","E01002848",710,373,64,309,268,11,110,46,52,12,79,71,8,0,48,25,23,20,20,69,10,59
"2021","Kensington and Chelsea 015D","E01002851",793,458,151,307,263,14,101,55,29,17,60,51,8,1,66,28,38,22,22,72,8,64
"2021","Kensington and Chelsea 016C","E01002835",644,270,57,213,299,21,168,58,91,19,65,57,7,1,30,17,13,15,15,75,14,61
"2021","Kensington and Chelsea 016D","E01002836",708,353,68,285,318,15,168,70,82,16,83,77,6,0,35,24,11,17,17,37,9,28
"2021","Kensington and Chelsea 016E","E01002837",491,215,39,176,234,22,126,49,64,13,46,40,5,1,27,18,9,13,13,42,14,28
"2021","Kensington and Chelsea 016F","E01035713",993,449,99,350,448,50,255,84,133,38,67,60,7,0,56,34,22,20,20,96,13,83
"2021","Kensington and Chelsea 017A","E01002846",716,363,68,295,240,9,84,52,23,9,74,66,6,2,56,35,21,17,17,113,5,108
"2021","Kensington and Chelsea 017B","E01002849",739,321,77,244,337,9,199,56,125,18,61,57,2,2,42,23,19,26,26,81,14,67
"2021","Kensington and Chelsea 017C","E01002893",905,482,100,382,343,23,129,50,61,18,88,74,13,1,58,36,22,45,45,80,5,75
"2021","Kensington and Chelsea 017D","E01002894",654,298,55,243,268,14,137,59,65,13,70,66,4,0,30,14,16,17,17,88,10,78
"2021","Kensington and Chelsea 017E","E01002898",674,261,111,150,311,21,185,48,126,11,53,36,17,0,40,27,13,12,12,102,67,35
"2021","Kensington and Chelsea 018A","E01002899",636,299,115,184,275,24,143,61,56,26,35,29,6,0,66,33,33,7,7,62,17,45
"2021","Kensington and Chelsea 018B","E01002900",569,215,73,142,253,43,145,57,62,26,30,26,4,0,29,17,12,6,6,101,10,91
"2021","Kensington and Chelsea 018C","E01002901",438,246,112,134,171,30,90,41,39,10,28,24,3,1,17,9,8,6,6,21,6,15
"2021","Kensington and Chelsea 018D","E01002902",713,378,107,271,310,45,136,67,55,14,61,52,8,1,53,31,22,15,15,25,6,19
"2021","Kensington and Chelsea 018E","E01002903",567,196,72,124,316,44,189,66,90,33,32,23,7,2,43,25,18,8,8,55,17,38
"2021","Kensington and Chelsea 019A","E01002844",614,317,98,219,246,34,123,37,66,20,50,39,7,4,29,9,20,10,10,51,15,36
"2021","Kensington and Chelsea 019B","E01002845",613,313,79,234,237,28,116,44,54,18,42,37,5,0,40,22,18,11,11,63,15,48
"2021","Kensington and Chelsea 019C","E01002910",635,319,123,196,249,27,127,48,59,20,42,33,6,3,41,19,22,12,12,67,31,36
"2021","Kensington and Chelsea 019D","E01002911",594,219,60,159,314,36,177,50,85,42,53,46,6,1,36,26,10,12,12,61,21,40
"2021","Kensington and Chelsea 019E","E01002914",572,273,77,196,253,37,136,43,69,24,39,32,7,0,30,18,12,11,11,46,18,28
"2021","Kensington and Chelsea 020C","E01002896",754,298,66,232,401,16,190,68,110,12,132,123,8,1,45,26,19,18,18,55,12,43
"2021","Kensington and Chelsea 020D","E01002897",697,310,65,245,277,20,116,46,56,14,77,69,7,1,46,27,19,18,18,110,40,70
"2021","Kensington and Chelsea 020E","E01002912",683,278,81,197,275,27,103,45,47,11,62,49,10,3,67,39,28,16,16,130,16,114
"2021","Kensington and Chelsea 020F","E01035714",935,416,106,310,428,47,243,80,128,35,70,58,6,6,47,23,24,21,21,91,20,71
"2021","Kensington and Chelsea 021A","E01002840",537,257,116,141,240,18,83,22,37,24,15,8,6,1,115,50,65,9,9,40,16,24
"2021","Kensington and Chelsea 021B","E01002841",608,275,66,209,268,13,121,46,58,17,56,44,10,2,65,27,38,13,13,65,17,48
"2021","Kensington and Chelsea 021C","E01002842",401,138,65,73,210,16,76,13,44,19,15,9,5,1,96,41,55,7,7,53,20,33
"2021","Kensington and Chelsea 021D","E01002843",631,296,119,177,298,21,114,20,51,43,34,14,18,2,118,55,63,11,11,37,10,27
"2021","Kensington and Chelsea 021E","E01002913",814,323,73,250,413,16,228,81,97,50,76,56,18,2,84,46,38,9,9,78,23,55
"2021","Kingston upon Thames 001A","E01003006",597,159,76,83,405,58,264,61,158,45,31,21,7,3,48,24,24,4,4,33,11,22
"2021","Kingston upon Thames 001B","E01003007",558,83,56,27,435,50,303,50,199,54,28,14,10,4,53,35,18,1,1,40,14,26
"2021","Kingston upon Thames 001C","E01003008",507,92,68,24,382,40,277,51,182,44,25,8,15,2,39,21,18,1,1,33,18,15
"2021","Kingston upon Thames 001D","E01003009",777,183,94,89,547,55,324,70,211,43,66,33,29,4,97,59,38,5,5,47,24,23
"2021","Kingston upon Thames 001E","E01003010",530,105,50,55,389,49,264,60,159,45,30,16,10,4,45,25,20,1,1,36,18,18
"2021","Kingston upon Thames 002A","E01002952",474,73,48,25,354,80,231,55,110,66,14,6,5,3,25,8,17,4,4,47,24,23
"2021","Kingston upon Thames 002B","E01002953",436,73,39,34,301,47,192,47,94,51,24,14,8,2,32,17,15,6,6,62,28,34
"2021","Kingston upon Thames 002C","E01002955",529,131,54,77,330,23,209,50,102,57,39,23,13,3,55,31,24,4,4,68,28,40
"2021","Kingston upon Thames 002D","E01002956",441,96,65,31,288,57,164,37,84,43,15,3,9,3,49,21,28,3,3,57,32,25
"2021","Kingston upon Thames 002E","E01002959",477,64,50,14,382,68,271,51,162,58,15,4,8,3,26,8,18,2,2,31,15,16
"2021","Kingston upon Thames 003A","E01002935",810,257,81,176,470,24,278,73,175,30,96,77,17,2,66,47,19,6,6,83,21,62
"2021","Kingston upon Thames 003B","E01002938",784,205,92,113,529,51,330,61,238,31,74,45,25,4,66,42,24,8,8,50,20,30
"2021","Kingston upon Thames 003C","E01002951",574,136,68,68,390,48,236,46,165,25,51,31,19,1,48,29,19,7,7,48,16,32
"2021","Kingston upon Thames 003D","E01002954",630,257,90,167,320,33,156,45,101,10,47,34,13,0,75,58,17,9,9,53,11,42
"2021","Kingston upon Thames 003E","E01002957",572,116,40,76,338,16,139,22,89,28,38,20,17,1,134,82,52,11,11,118,20,98
"2021","Kingston upon Thames 004A","E01002933",809,251,106,145,498,26,288,65,183,40,84,39,40,5,94,60,34,6,6,60,17,43
"2021","Kingston upon Thames 004B","E01002934",660,99,49,50,514,40,364,68,251,45,58,36,22,0,49,26,23,3,3,47,21,26
"2021","Kingston upon Thames 004D","E01002937",661,119,49,70,502,25,344,71,238,35,77,45,27,5,52,31,21,4,4,40,12,28
"2021","Kingston upon Thames 004E","E01003011",701,189,94,95,472,62,290,75,173,42,57,43,11,3,58,37,21,5,5,40,15,25
"2021","Kingston upon Thames 004G","E01033569",806,252,40,212,496,27,262,92,152,18,111,84,23,4,76,52,24,20,20,58,19,39
"2021","Kingston upon Thames 004H","E01034576",584,192,35,157,365,30,202,71,115,16,78,62,16,0,42,33,9,13,13,27,5,22
"2021","Kingston upon Thames 004I","E01034577",634,206,26,180,382,6,186,69,107,10,86,67,19,0,90,68,22,14,14,46,14,32
"2021","Kingston upon Thames 005A","E01002964",1050,441,149,292,506,22,257,97,137,23,115,88,24,3,100,62,38,12,12,103,14,89
"2021","Kingston upon Thames 005B","E01002969",660,204,56,148,405,9,155,25,104,26,55,20,32,3,178,125,53,8,8,51,21,30
"2021","Kingston upon Thames 005C","E01002971",727,197,52,145,453,26,251,72,161,18,110,76,33,1,59,39,20,7,7,77,16,61
"2021","Kingston upon Thames 005D","E01002972",892,299,103,196,478,23,220,68,138,14,115,79,33,3,99,65,34,21,21,115,24,91
"2021","Kingston upon Thames 005E","E01002974",718,161,53,108,476,46,293,72,176,45,48,29,16,3,73,40,33,16,16,81,33,48
"2021","Kingston upon Thames 006A","E01002932",677,183,37,146,433,17,202,36,117,49,65,34,24,7,141,96,45,8,8,61,32,29
"2021","Kingston upon Thames 006B","E01002960",583,129,63,66,392,48,269,48,150,71,34,16,16,2,38,23,15,3,3,62,23,39
"2021","Kingston upon Thames 006C","E01002962",526,83,48,35,374,38,212,37,126,49,42,18,20,4,74,39,35,8,8,69,41,28
"2021","Kingston upon Thames 006D","E01002970",645,137,38,99,396,20,200,44,121,35,69,28,37,4,97,54,43,10,10,112,38,74
"2021","Kingston upon Thames 006E","E01002973",525,90,27,63,351,23,175,27,107,41,39,13,24,2,102,55,47,12,12,84,36,48
"2021","Kingston upon Thames 007A","E01002929",675,161,73,88,476,75,300,76,172,52,53,38,15,0,41,21,20,7,7,38,12,26
"2021","Kingston upon Thames 007B","E01002930",795,218,73,145,495,42,271,81,147,43,89,60,26,3,83,57,26,10,10,82,28,54
"2021","Kingston upon Thames 007C","E01002931",720,155,55,100,519,53,339,76,204,59,69,32,34,3,56,38,18,2,2,46,27,19
"2021","Kingston upon Thames 007D","E01002963",774,237,93,144,459,27,278,69,172,37,63,40,21,2,80,52,28,11,11,78,20,58
"2021","Kingston upon Thames 007E","E01002985",600,123,59,64,400,28,261,51,157,53,39,16,19,4,63,42,21,9,9,77,33,44
"2021","Kingston upon Thames 008A","E01002927",640,160,94,66,413,49,245,45,143,57,48,27,18,3,64,38,26,7,7,67,23,44
"2021","Kingston upon Thames 008B","E01002928",742,247,107,140,429,33,241,56,146,39,77,47,27,3,67,47,20,11,11,66,23,43
"2021","Kingston upon Thames 008C","E01002958",652,138,59,79,468,35,317,81,194,42,64,34,26,4,43,23,20,9,9,46,19,27
"2021","Kingston upon Thames 008D","E01002961",597,80,52,28,471,77,309,64,187,58,38,17,19,2,44,17,27,3,3,46,22,24
"2021","Kingston upon Thames 008E","E01002986",478,105,60,45,317,48,190,41,106,43,25,12,8,5,49,24,25,5,5,56,26,30
"2021","Kingston upon Thames 009A","E01002965",1142,430,104,326,559,51,267,79,158,30,120,100,20,0,93,58,35,28,28,153,19,134
"2021","Kingston upon Thames 009B","E01002967",953,380,123,257,498,42,216,85,112,19,167,138,28,1,64,41,23,9,9,75,8,67
"2021","Kingston upon Thames 009C","E01002968",1149,390,100,290,582,45,293,119,140,34,138,111,24,3,72,47,25,34,34,177,26,151
"2021","Kingston upon Thames 009D","E01002990",886,358,86,272,468,35,198,86,102,10,182,155,27,0,42,24,18,11,11,60,9,51
"2021","Kingston upon Thames 009E","E01002991",679,203,59,144,413,29,232,73,129,30,100,85,13,2,46,28,18,6,6,63,18,45
"2021","Kingston upon Thames 010A","E01002922",718,237,104,133,439,75,256,67,150,39,65,46,15,4,38,20,18,5,5,42,9,33
"2021","Kingston upon Thames 010B","E01002926",600,140,65,75,411,45,266,50,178,38,55,30,23,2,42,23,19,3,3,49,16,33
"2021","Kingston upon Thames 010C","E01002966",778,193,48,145,492,19,294,100,163,31,120,74,39,7,55,34,21,4,4,93,13,80
"2021","Kingston upon Thames 010D","E01002992",487,167,50,117,262,10,157,50,81,26,52,35,15,2,34,16,18,9,9,58,20,38
"2021","Kingston upon Thames 011A","E01002921",906,398,99,299,433,15,190,84,91,15,155,121,34,0,52,35,17,21,21,75,10,65
"2021","Kingston upon Thames 011B","E01002987",956,407,127,280,462,19,161,74,79,8,198,176,22,0,58,41,17,26,26,87,9,78
"2021","Kingston upon Thames 011C","E01002988",627,232,46,186,363,26,162,44,97,21,116,100,16,0,52,35,17,7,7,32,5,27
"2021","Kingston upon Thames 011D","E01002989",914,326,61,265,548,22,287,106,152,29,187,161,25,1,48,27,21,4,4,40,4,36
"2021","Kingston upon Thames 012A","E01002975",500,77,45,32,351,56,204,28,112,64,21,7,10,4,62,32,30,8,8,72,37,35
"2021","Kingston upon Thames 012B","E01002977",648,187,82,105,399,43,212,44,111,57,46,18,20,8,89,61,28,9,9,62,30,32
"2021","Kingston upon Thames 012C","E01002980",480,82,57,25,344,67,231,47,109,75,20,7,11,2,23,5,18,3,3,54,27,27
"2021","Kingston upon Thames 012D","E01002981",523,96,61,35,347,46,245,53,116,76,13,8,5,0,39,15,24,4,4,80,36,44
"2021","Kingston upon Thames 012E","E01002984",589,204,105,99,335,54,184,40,104,40,33,16,16,1,52,33,19,12,12,50,22,28
"2021","Kingston upon Thames 013A","E01002923",857,461,181,280,310,30,103,39,53,11,85,63,20,2,86,58,28,6,6,86,22,64
"2021","Kingston upon Thames 013B","E01002925",794,319,82,237,436,15,197,84,93,20,161,130,28,3,58,36,22,5,5,39,6,33
"2021","Kingston upon Thames 013C","E01002993",817,341,83,258,422,26,176,65,103,8,159,133,26,0,51,36,15,10,10,54,10,44
"2021","Kingston upon Thames 013D","E01002995",634,182,67,115,409,54,228,65,125,38,77,63,11,3,44,25,19,6,6,43,12,31
"2021","Kingston upon Thames 013E","E01002999",766,300,63,237,403,6,157,54,96,7,145,120,24,1,86,66,20,9,9,63,12,51
"2021","Kingston upon Thames 014A","E01002915",483,87,58,29,342,66,197,43,97,57,29,12,16,1,47,23,24,3,3,54,29,25
"2021","Kingston upon Thames 014B","E01002916",533,121,75,46,360,54,234,44,136,54,32,18,12,2,38,17,21,2,2,52,29,23
"2021","Kingston upon Thames 014C","E01002917",495,70,50,20,379,67,252,54,138,60,26,8,16,2,32,10,22,2,2,46,21,25
"2021","Kingston upon Thames 014D","E01002920",587,109,74,35,445,60,282,60,163,59,47,12,26,9,52,21,31,4,4,33,15,18
"2021","Kingston upon Thames 014E","E01002924",555,99,55,44,423,89,282,57,168,57,31,13,16,2,18,4,14,3,3,33,14,19
"2021","Kingston upon Thames 015A","E01002976",652,136,74,62,473,61,288,70,163,55,60,31,22,7,58,37,21,6,6,43,14,29
"2021","Kingston upon Thames 015B","E01002978",722,169,90,79,498,98,291,82,150,59,49,25,21,3,56,25,31,4,4,55,22,33
"2021","Kingston upon Thames 015C","E01002979",597,143,51,92,411,80,236,67,115,54,44,28,14,2,49,26,23,2,2,43,22,21
"2021","Kingston upon Thames 015D","E01002982",516,111,72,39,350,66,218,51,114,53,21,9,7,5,44,16,28,1,1,55,24,31
"2021","Kingston upon Thames 015E","E01002983",598,93,70,23,456,82,305,72,160,73,37,16,19,2,28,9,19,4,4,49,17,32
"2021","Kingston upon Thames 016A","E01002994",597,160,53,107,406,57,225,60,131,34,77,49,28,0,44,26,18,3,3,31,5,26
"2021","Kingston upon Thames 016B","E01002996",594,135,48,87,418,31,232,55,142,35,91,56,31,4,55,36,19,9,9,41,16,25
"2021","Kingston upon Thames 016C","E01002997",602,144,44,100,420,45,276,79,154,43,65,46,17,2,30,23,7,4,4,38,10,28
"2021","Kingston upon Thames 016D","E01002998",601,135,48,87,413,32,211,29,158,24,77,39,35,3,89,62,27,4,4,53,22,31
"2021","Kingston upon Thames 016E","E01003002",800,240,102,138,498,38,234,59,147,28,100,62,35,3,115,73,42,11,11,62,21,41
"2021","Kingston upon Thames 017A","E01002918",609,101,55,46,448,31,254,47,139,68,65,29,25,11,91,53,38,7,7,60,31,29
"2021","Kingston upon Thames 017B","E01002919",797,231,76,155,468,41,245,69,131,45,70,48,21,1,104,62,42,8,8,98,45,53
"2021","Kingston upon Thames 017C","E01003000",671,138,51,87,466,43,268,64,156,48,78,39,31,8,72,38,34,5,5,67,30,37
"2021","Kingston upon Thames 017D","E01003001",634,111,63,48,444,52,279,54,150,75,44,15,23,6,65,25,40,4,4,79,44,35
"2021","Kingston upon Thames 017E","E01003003",658,154,64,90,422,37,230,55,139,36,68,39,21,8,78,48,30,9,9,82,26,56
"2021","Kingston upon Thames 018A","E01002939",599,132,63,69,404,30,209,54,113,42,79,39,29,11,82,55,27,4,4,63,29,34
"2021","Kingston upon Thames 018B","E01002941",639,164,101,63,414,58,235,68,115,52,59,24,31,4,57,34,23,5,5,61,25,36
"2021","Kingston upon Thames 018C","E01002942",531,119,70,49,368,60,226,52,128,46,40,18,12,10,39,19,20,3,3,44,19,25
"2021","Kingston upon Thames 018D","E01003004",607,138,65,73,410,45,234,52,139,43,70,40,23,7,58,32,26,3,3,59,25,34
"2021","Kingston upon Thames 018E","E01003005",581,110,56,54,419,54,235,62,126,47,59,28,28,3,68,36,32,3,3,52,22,30
"2021","Kingston upon Thames 019A","E01002944",530,127,59,68,370,33,186,49,104,33,56,31,20,5,88,48,40,7,7,33,15,18
"2021","Kingston upon Thames 019B","E01002945",640,177,67,110,417,37,221,61,116,44,89,50,39,0,64,41,23,6,6,46,20,26
"2021","Kingston upon Thames 019C","E01002946",604,139,70,69,425,49,217,64,109,44,85,43,33,9,71,24,47,3,3,40,12,28
"2021","Kingston upon Thames 019D","E01002947",614,116,58,58,457,58,269,59,149,61,60,29,21,10,67,38,29,3,3,41,20,21
"2021","Kingston upon Thames 020A","E01002940",614,145,75,70,408,51,207,35,118,54,63,27,31,5,83,36,47,4,4,61,31,30
"2021","Kingston upon Thames 020B","E01002943",510,95,60,35,357,43,201,38,110,53,40,20,15,5,69,39,30,4,4,58,27,31
"2021","Kingston upon Thames 020C","E01002948",819,192,76,116,556,47,294,73,147,74,107,48,49,10,104,54,50,4,4,71,35,36
"2021","Kingston upon Thames 020D","E01002949",690,154,77,77,476,53,273,65,142,66,78,31,41,6,65,38,27,7,7,60,30,30
"2021","Kingston upon Thames 020E","E01002950",711,229,103,126,422,44,177,55,94,28,96,49,36,11,101,58,43,4,4,60,32,28
"2021","Lambeth 002A","E01003015",803,323,86,237,379,13,122,44,54,24,91,75,11,5,131,60,71,22,22,101,28,73
"2021","Lambeth 002B","E01003108",711,274,78,196,354,9,115,33,60,22,67,49,12,6,140,88,52,23,23,83,31,52
"2021","Lambeth 002C","E01003110",923,316,92,224,445,31,182,87,74,21,124,107,14,3,89,46,43,19,19,162,26,136
"2021","Lambeth 002D","E01003111",804,303,88,215,398,14,133,39,72,22,42,23,14,5,196,119,77,13,13,103,37,66
"2021","Lambeth 002E","E01003112",815,322,63,259,382,10,129,45,66,18,78,56,17,5,146,102,44,19,19,111,26,85
"2021","Lambeth 003A","E01003101",637,190,34,156,323,10,83,31,35,17,81,66,12,3,136,80,56,13,13,124,19,105
"2021","Lambeth 003B","E01003105",747,276,100,176,353,15,113,44,49,20,65,46,13,6,134,83,51,26,26,118,29,89
"2021","Lambeth 003C","E01003106",970,340,81,259,491,27,181,80,78,23,102,84,16,2,166,111,55,15,15,139,24,115
"2021","Lambeth 003D","E01003107",885,300,71,229,420,16,152,88,47,17,145,127,15,3,84,47,37,23,23,165,16,149
"2021","Lambeth 003F","E01033862",746,389,42,347,278,4,109,71,31,7,101,94,5,2,37,21,16,27,27,79,12,67
"2021","Lambeth 003G","E01033863",606,242,58,184,265,2,70,21,34,15,61,41,15,5,114,61,53,18,18,99,13,86
"2021","Lambeth 004A","E01003102",783,331,46,285,290,8,98,58,30,10,93,78,12,3,65,32,33,26,26,162,12,150
"2021","Lambeth 004C","E01003104",871,362,81,281,351,8,89,37,38,14,133,104,29,0,100,72,28,21,21,158,11,147
"2021","Lambeth 004D","E01003122",896,308,58,250,430,5,147,76,55,16,155,137,14,4,103,62,41,20,20,158,15,143
"2021","Lambeth 004E","E01003129",795,262,40,222,374,13,131,61,49,21,110,93,11,6,103,51,52,17,17,159,23,136
"2021","Lambeth 004G","E01033208",953,454,21,433,389,9,158,90,62,6,119,106,11,2,74,51,23,29,29,110,3,107
"2021","Lambeth 004H","E01033864",498,221,99,122,213,19,68,18,37,13,33,25,5,3,78,40,38,15,15,64,16,48
"2021","Lambeth 004I","E01033865",597,254,13,241,226,8,76,41,30,5,98,92,6,0,31,19,12,13,13,117,8,109
"2021","Lambeth 004J","E01033866",624,254,4,250,268,3,110,80,28,2,87,84,3,0,34,23,11,34,34,102,4,98
"2021","Lambeth 005A","E01003098",646,217,66,151,332,14,124,47,57,20,78,66,12,0,90,53,37,26,26,97,15,82
"2021","Lambeth 005B","E01003099",758,267,82,185,352,7,122,37,59,26,95,79,13,3,115,72,43,13,13,139,17,122
"2021","Lambeth 005C","E01003100",890,244,23,221,332,5,96,54,38,4,149,134,15,0,48,28,20,34,34,314,19,295
"2021","Lambeth 005D","E01003180",654,217,38,179,312,11,118,35,60,23,80,59,18,3,91,38,53,12,12,125,23,102
"2021","Lambeth 005E","E01003183",681,234,56,178,351,17,107,34,47,26,66,46,13,7,143,77,66,18,18,96,22,74
"2021","Lambeth 006A","E01003097",688,242,94,148,321,18,103,34,43,26,57,41,10,6,126,68,58,17,17,125,17,108
"2021","Lambeth 006B","E01003121",639,190,49,141,370,8,115,24,53,38,47,19,17,11,185,113,72,15,15,79,18,61
"2021","Lambeth 006C","E01003123",699,221,41,180,331,16,119,42,57,20,93,73,15,5,83,36,47,20,20,147,21,126
"2021","Lambeth 006D","E01003124",612,217,32,185,292,20,91,40,31,20,53,39,11,3,107,64,43,21,21,103,20,83
"2021","Lambeth 006E","E01003125",697,233,54,179,366,9,114,25,58,31,48,23,18,7,177,100,77,18,18,98,36,62
"2021","Lambeth 007A","E01003181",697,269,61,208,302,11,77,26,36,15,74,55,17,2,125,59,66,15,15,126,23,103
"2021","Lambeth 007B","E01003184",599,172,32,140,345,8,85,20,47,18,76,50,21,5,153,95,58,23,23,82,17,65
"2021","Lambeth 007C","E01003185",794,258,63,195,345,2,102,40,47,15,109,93,11,5,114,74,40,18,18,191,30,161
"2021","Lambeth 007D","E01003186",1191,430,52,378,535,17,171,81,63,27,185,165,16,4,115,78,37,47,47,226,15,211
"2021","Lambeth 007E","E01003187",990,324,51,273,530,4,162,52,89,21,185,150,29,6,148,86,62,31,31,136,28,108
"2021","Lambeth 008A","E01003089",737,175,24,151,414,7,121,41,61,19,79,59,12,8,165,100,65,42,42,148,30,118
"2021","Lambeth 008B","E01003091",675,181,42,139,315,8,95,25,45,25,69,48,16,5,117,78,39,26,26,179,24,155
"2021","Lambeth 008C","E01003092",950,316,26,290,439,3,131,36,75,20,102,76,22,4,171,116,55,32,32,195,39,156
"2021","Lambeth 008D","E01003126",713,225,44,181,359,6,103,37,37,29,100,81,14,5,124,69,55,26,26,129,33,96
"2021","Lambeth 008E","E01003128",710,261,44,217,332,7,95,22,52,21,79,52,20,7,129,81,48,22,22,117,34,83
"2021","Lambeth 009A","E01003046",744,265,38,227,362,2,115,47,48,20,54,35,16,3,172,114,58,19,19,117,24,93
"2021","Lambeth 009B","E01003048",739,253,46,207,400,7,134,17,92,25,48,19,23,6,186,117,69,25,25,86,34,52
"2021","Lambeth 009C","E01003075",674,212,52,160,363,5,110,17,59,34,66,41,20,5,165,104,61,17,17,99,41,58
"2021","Lambeth 009D","E01003182",743,239,49,190,387,5,136,50,63,23,100,75,22,3,127,81,46,19,19,117,37,80
"2021","Lambeth 009E","E01003188",552,196,49,147,283,8,72,17,29,26,65,47,15,3,120,57,63,18,18,73,22,51
"2021","Lambeth 010A","E01003088",657,174,44,130,321,4,100,34,50,16,84,63,17,4,117,73,44,16,16,162,20,142
"2021","Lambeth 010B","E01003093",954,282,65,217,542,11,136,43,71,22,94,55,32,7,271,156,115,30,30,130,35,95
"2021","Lambeth 010C","E01003094",654,216,53,163,269,14,78,24,38,16,65,55,9,1,96,35,61,16,16,169,24,145
"2021","Lambeth 010D","E01003096",859,270,53,217,335,15,114,64,39,11,137,122,14,1,45,18,27,24,24,254,14,240
"2021","Lambeth 010E","E01003127",795,223,50,173,383,15,162,56,79,27,87,70,13,4,98,64,34,21,21,189,52,137
"2021","Lambeth 011A","E01003045",699,235,62,173,364,9,99,23,41,35,44,26,8,10,191,117,74,21,21,100,46,54
"2021","Lambeth 011B","E01003047",818,292,59,233,330,7,86,32,41,13,97,81,12,4,121,72,49,19,19,196,15,181
"2021","Lambeth 011C","E01003049",753,257,49,208,387,3,104,29,54,21,104,78,21,5,142,86,56,34,34,109,25,84
"2021","Lambeth 011D","E01003059",872,291,57,234,413,6,129,42,50,37,125,95,25,5,133,84,49,20,20,168,49,119
"2021","Lambeth 011E","E01003060",685,195,35,160,348,6,109,30,53,26,55,40,12,3,159,81,78,19,19,142,32,110
"2021","Lambeth 011F","E01003061",649,273,56,217,264,6,75,33,26,16,92,80,8,4,67,34,33,24,24,112,16,96
"2021","Lambeth 012A","E01003034",696,208,50,158,350,12,131,39,81,11,94,76,16,2,96,53,43,17,17,138,21,117
"2021","Lambeth 012B","E01003035",765,246,52,194,295,9,93,34,49,10,115,99,14,2,54,28,26,24,24,224,18,206
"2021","Lambeth 012C","E01003036",756,229,59,170,355,9,121,38,59,24,109,95,12,2,75,37,38,41,41,172,10,162
"2021","Lambeth 012D","E01003090",1104,338,48,290,460,8,128,58,51,19,192,173,11,8,98,43,55,34,34,306,33,273
"2021","Lambeth 012E","E01003095",690,178,34,144,361,19,155,47,77,31,109,100,9,0,68,26,42,10,10,151,18,133
"2021","Lambeth 013A","E01003037",596,192,51,141,310,6,100,36,45,19,70,52,12,6,120,64,56,14,14,94,15,79
"2021","Lambeth 013B","E01003038",771,220,51,169,391,48,153,56,77,20,125,116,8,1,50,28,22,15,15,160,13,147
"2021","Lambeth 013C","E01003039",963,320,55,265,475,29,201,90,95,16,166,141,19,6,58,34,24,21,21,168,13,155
"2021","Lambeth 013D","E01003040",591,210,43,167,287,23,118,51,58,9,94,82,9,3,45,26,19,7,7,94,9,85
"2021","Lambeth 013E","E01003042",507,174,41,133,207,8,73,29,34,10,55,40,12,3,61,31,30,10,10,126,8,118
"2021","Lambeth 014A","E01003072",703,199,87,112,402,45,223,51,128,44,75,59,10,6,54,29,25,5,5,102,22,80
"2021","Lambeth 014B","E01003073",662,204,49,155,359,16,129,35,70,24,70,52,15,3,124,72,52,20,20,99,33,66
"2021","Lambeth 014C","E01003076",968,246,25,221,483,4,162,62,83,17,182,139,38,5,111,68,43,24,24,239,67,172
"2021","Lambeth 014D","E01003077",789,206,30,176,375,8,117,42,58,17,137,103,27,7,94,49,45,19,19,208,30,178
"2021","Lambeth 014E","E01003078",621,148,70,78,379,25,216,60,117,39,75,43,25,7,59,36,23,4,4,94,24,70
"2021","Lambeth 015A","E01003019",887,236,47,189,399,16,115,54,52,9,164,143,18,3,81,45,36,23,23,252,11,241
"2021","Lambeth 015B","E01003053",742,214,31,183,314,4,92,38,36,18,145,133,11,1,60,21,39,13,13,214,8,206
"2021","Lambeth 015C","E01003054",1003,285,28,257,366,10,82,42,31,9,176,164,9,3,65,35,30,33,33,352,8,344
"2021","Lambeth 015D","E01003056",766,224,30,194,301,3,76,32,29,15,113,96,14,3,75,33,42,34,34,241,10,231
"2021","Lambeth 015E","E01003058",856,230,51,179,351,5,93,41,42,10,140,127,12,1,90,45,45,23,23,275,12,263
"2021","Lambeth 016A","E01003020",826,273,45,228,398,9,122,51,56,15,123,104,18,1,116,79,37,28,28,155,15,140
"2021","Lambeth 016B","E01003050",748,279,63,216,261,3,90,50,28,12,78,70,7,1,74,49,25,16,16,208,10,198
"2021","Lambeth 016C","E01003052",784,256,64,192,373,6,110,21,50,39,50,30,14,6,185,83,102,22,22,155,78,77
"2021","Lambeth 016D","E01003055",828,377,100,277,300,8,84,51,23,10,116,99,15,2,66,41,25,26,26,151,18,133
"2021","Lambeth 016E","E01003176",763,218,63,155,375,7,111,28,64,19,58,32,22,4,178,102,76,21,21,170,45,125
"2021","Lambeth 017A","E01003029",895,330,64,266,363,18,130,55,59,16,133,118,15,0,66,45,21,16,16,202,16,186
"2021","Lambeth 017B","E01003032",817,304,97,207,348,18,117,47,47,23,95,80,14,1,105,57,48,13,13,165,24,141
"2021","Lambeth 017C","E01003041",679,247,50,197,308,7,85,24,50,11,64,53,7,4,136,70,66,16,16,124,13,111
"2021","Lambeth 017D","E01003057",723,244,42,202,304,6,84,34,39,11,82,64,16,2,119,74,45,13,13,175,21,154
"2021","Lambeth 018A","E01003043",675,207,64,143,288,5,126,46,69,11,75,63,11,1,67,40,27,15,15,180,32,148
"2021","Lambeth 018B","E01003044",683,303,43,260,312,8,80,22,46,12,60,40,17,3,155,99,56,9,9,68,11,57
"2021","Lambeth 018C","E01003051",880,250,33,217,414,2,121,58,48,15,134,122,9,3,133,69,64,24,24,216,33,183
"2021","Lambeth 018D","E01003071",1004,301,49,252,537,17,214,66,122,26,183,146,32,5,98,51,47,25,25,166,15,151
"2021","Lambeth 018E","E01003074",1094,386,75,311,550,11,177,55,92,30,231,184,38,9,111,65,46,20,20,158,23,135
"2021","Lambeth 019A","E01003026",624,179,44,135,280,15,119,39,61,19,101,93,8,0,35,14,21,10,10,165,33,132
"2021","Lambeth 019B","E01003027",523,117,22,95,316,36,192,46,126,20,60,48,10,2,20,5,15,8,8,90,10,80
"2021","Lambeth 019C","E01003028",601,144,36,108,333,17,163,44,101,18,87,66,20,1,55,36,19,11,11,124,13,111
"2021","Lambeth 019D","E01003030",748,200,43,157,356,8,148,61,72,15,134,121,10,3,42,24,18,24,24,192,12,180
"2021","Lambeth 019E","E01003033",588,112,34,78,356,24,180,43,103,34,78,60,15,3,60,34,26,14,14,120,25,95
"2021","Lambeth 020A","E01003018",934,292,41,251,387,17,118,49,55,14,169,148,19,2,57,27,30,26,26,255,20,235
"2021","Lambeth 020B","E01003171",784,276,44,232,370,15,124,54,60,10,131,108,21,2,78,48,30,22,22,138,19,119
"2021","Lambeth 020C","E01003173",671,195,52,143,313,18,121,37,67,17,95,73,19,3,64,32,32,15,15,163,39,124
"2021","Lambeth 020D","E01003177",669,176,25,151,322,10,98,44,46,8,115,95,17,3,79,45,34,20,20,171,33,138
"2021","Lambeth 020E","E01003178",650,177,37,140,331,11,123,46,66,11,120,98,19,3,53,20,33,24,24,142,9,133
"2021","Lambeth 021A","E01003021",638,224,55,169,300,20,95,31,46,18,70,46,21,3,104,53,51,11,11,114,16,98
"2021","Lambeth 021B","E01003022",729,246,48,198,329,12,122,41,66,15,106,88,15,3,73,42,31,16,16,154,10,144
"2021","Lambeth 021C","E01003023",1104,323,54,269,499,5,184,66,96,22,135,111,21,3,140,99,41,35,35,282,38,244
"2021","Lambeth 021D","E01003024",787,241,48,193,409,2,132,46,65,21,71,51,12,8,178,123,55,26,26,137,23,114
"2021","Lambeth 021E","E01003025",847,234,59,175,483,11,169,50,87,32,128,102,22,4,151,94,57,24,24,130,25,105
"2021","Lambeth 022A","E01003136",748,259,40,219,363,12,127,44,63,20,103,76,20,7,101,67,34,20,20,126,23,103
"2021","Lambeth 022B","E01003137",749,298,51,247,334,10,87,33,39,15,74,58,14,2,152,99,53,11,11,117,22,95
"2021","Lambeth 022C","E01003159",841,313,58,255,359,10,120,44,52,24,104,85,15,4,100,43,57,25,25,169,23,146
"2021","Lambeth 022D","E01003160",643,216,25,191,316,7,86,25,42,19,60,47,10,3,124,59,65,39,39,111,17,94
"2021","Lambeth 022E","E01003162",744,227,48,179,373,7,143,39,79,25,57,34,19,4,139,74,65,27,27,144,40,104
"2021","Lambeth 023A","E01003031",709,227,48,179,297,5,89,33,49,7,86,70,14,2,98,70,28,19,19,185,9,176
"2021","Lambeth 023B","E01003156",657,179,45,134,363,15,164,46,94,24,94,72,20,2,78,45,33,12,12,115,15,100
"2021","Lambeth 023C","E01003157",569,108,35,73,367,15,190,34,137,19,90,56,33,1,61,39,22,11,11,94,14,80
"2021","Lambeth 023D","E01003158",728,204,50,154,413,14,173,56,101,16,182,143,37,2,38,23,15,6,6,111,6,105
"2021","Lambeth 023E","E01003161",530,123,54,69,277,16,112,37,68,7,79,61,14,4,52,33,19,18,18,130,16,114
"2021","Lambeth 023F","E01003163",603,145,50,95,351,30,159,36,95,28,69,50,16,3,81,42,39,12,12,107,20,87
"2021","Lambeth 024A","E01003132",541,153,43,110,288,7,101,34,46,21,57,31,22,4,118,67,51,5,5,100,32,68
"2021","Lambeth 024B","E01003172",780,247,52,195,420,7,140,38,89,13,102,78,21,3,152,98,54,19,19,113,21,92
"2021","Lambeth 024C","E01003174",829,250,43,207,464,2,142,45,61,36,69,38,26,5,227,147,80,24,24,115,50,65
"2021","Lambeth 024D","E01003175",612,175,42,133,344,11,110,28,64,18,38,16,19,3,178,82,96,7,7,93,36,57
"2021","Lambeth 024E","E01003179",637,199,42,157,349,3,99,23,59,17,45,27,15,3,187,119,68,15,15,89,34,55
"2021","Lambeth 025A","E01003164",1011,314,58,256,555,12,182,67,95,20,151,121,24,6,192,103,89,18,18,142,26,116
"2021","Lambeth 025B","E01003165",701,224,91,133,417,50,168,48,101,19,82,53,26,3,101,63,38,16,16,60,20,40
"2021","Lambeth 025C","E01003168",663,194,54,140,396,23,100,36,41,23,63,39,19,5,200,109,91,10,10,73,33,40
"2021","Lambeth 025D","E01003169",1029,308,50,258,587,19,245,87,131,27,172,128,40,4,133,85,48,18,18,134,24,110
"2021","Lambeth 025E","E01003170",770,249,143,106,445,38,260,44,174,42,88,59,26,3,53,26,27,6,6,76,23,53
"2021","Lambeth 026A","E01003130",785,241,55,186,400,20,173,56,93,24,100,73,23,4,93,53,40,14,14,144,36,108
"2021","Lambeth 026B","E01003131",945,296,45,251,496,22,199,63,109,27,169,141,23,5,84,51,33,22,22,153,14,139
"2021","Lambeth 026C","E01003135",754,237,50,187,341,5,138,48,67,23,85,72,10,3,102,45,57,11,11,176,57,119
"2021","Lambeth 026D","E01003138",642,174,35,139,347,10,164,58,96,10,134,114,18,2,32,23,9,7,7,121,13,108
"2021","Lambeth 026E","E01003151",815,305,97,208,393,6,102,26,61,15,79,54,21,4,187,115,72,19,19,117,25,92
"2021","Lambeth 027A","E01003079",732,261,44,217,375,11,140,36,81,23,91,60,26,5,124,92,32,9,9,96,27,69
"2021","Lambeth 027B","E01003080",676,185,45,140,397,12,175,38,110,27,101,64,35,2,104,68,36,5,5,94,24,70
"2021","Lambeth 027C","E01003133",705,208,43,165,384,9,156,50,87,19,115,87,24,4,93,65,28,11,11,113,23,90
"2021","Lambeth 027D","E01003134",619,151,43,108,366,17,153,37,91,25,94,68,24,2,87,48,39,15,15,102,17,85
"2021","Lambeth 027E","E01003152",759,180,46,134,424,33,195,60,109,26,107,79,26,2,78,44,34,11,11,155,44,111
"2021","Lambeth 028A","E01003064",626,166,36,130,410,21,189,49,122,18,113,88,24,1,81,58,23,6,6,50,9,41
"2021","Lambeth 028B","E01003066",807,239,58,181,488,15,135,34,82,19,116,67,44,5,166,102,64,56,56,80,26,54
"2021","Lambeth 028C","E01003081",817,283,43,240,443,7,176,46,104,26,127,89,32,6,115,76,39,18,18,91,27,64
"2021","Lambeth 028D","E01003166",1115,368,50,318,577,31,221,77,118,26,166,125,33,8,140,100,40,19,19,170,35,135
"2021","Lambeth 028E","E01003167",680,155,62,93,471,43,264,56,167,41,92,53,33,6,67,38,29,5,5,54,14,40
"2021","Lambeth 029A","E01003116",634,160,49,111,369,37,181,31,108,42,71,45,24,2,74,41,33,6,6,105,49,56
"2021","Lambeth 029B","E01003117",822,281,64,217,388,19,157,70,77,10,101,82,19,0,94,69,25,17,17,153,21,132
"2021","Lambeth 029C","E01003118",703,175,70,105,417,21,219,45,148,26,74,54,19,1,93,69,24,10,10,111,33,78
"2021","Lambeth 029D","E01003153",1021,318,46,272,472,13,166,91,62,13,198,161,35,2,63,35,28,32,32,231,22,209
"2021","Lambeth 029E","E01003155",727,207,59,148,412,19,203,58,118,27,114,79,31,4,69,34,35,7,7,108,18,90
"2021","Lambeth 030A","E01003083",573,155,73,82,337,23,172,50,98,24,69,38,26,5,66,41,25,7,7,81,37,44
"2021","Lambeth 030B","E01003084",632,189,50,139,383,19,176,50,108,18,99,69,26,4,78,40,38,11,11,60,15,45
"2021","Lambeth 030C","E01003085",693,196,96,100,425,35,224,59,127,38,81,35,39,7,83,48,35,2,2,72,30,42
"2021","Lambeth 030D","E01003149",693,195,59,136,402,29,204,67,102,35,96,71,23,2,67,40,27,6,6,96,18,78
"2021","Lambeth 030E","E01003154",823,256,73,183,490,24,186,45,112,29,89,62,23,4,177,127,50,14,14,77,29,48
"2021","Lambeth 031A","E01003065",685,248,75,173,383,7,146,56,78,12,59,30,27,2,163,121,42,8,8,54,30,24
"2021","Lambeth 031B","E01003068",642,188,62,126,400,11,144,37,91,16,91,64,25,2,142,93,49,12,12,54,21,33
"2021","Lambeth 031C","E01003082",634,248,61,187,329,21,130,40,69,21,58,38,17,3,112,73,39,8,8,57,17,40
"2021","Lambeth 031D","E01003086",623,187,34,153,378,16,127,23,75,29,78,33,30,15,142,67,75,15,15,58,25,33
"2021","Lambeth 031E","E01003087",601,141,37,104,386,8,113,27,69,17,49,18,23,8,208,120,88,8,8,74,37,37
"2021","Lambeth 032A","E01003113",740,204,38,166,401,11,138,53,69,16,145,106,35,4,79,55,24,28,28,135,25,110
"2021","Lambeth 032B","E01003114",1006,299,40,259,531,7,227,82,128,17,180,143,36,1,90,63,27,27,27,176,24,152
"2021","Lambeth 032C","E01003119",852,250,40,210,477,10,182,48,119,15,153,128,22,3,90,70,20,42,42,125,28,97
"2021","Lambeth 032D","E01003120",1111,436,60,376,513,8,180,67,92,21,164,135,29,0,131,97,34,30,30,162,25,137
"2021","Lambeth 032E","E01003148",758,197,46,151,452,14,203,73,113,17,122,88,31,3,98,62,36,15,15,109,24,85
"2021","Lambeth 032F","E01003150",838,283,79,204,427,11,145,54,74,17,108,81,24,3,127,82,45,36,36,128,32,96
"2021","Lambeth 033A","E01003062",861,282,56,226,506,13,168,62,83,23,204,175,27,2,113,70,43,8,8,73,21,52
"2021","Lambeth 033B","E01003063",601,244,43,201,287,6,101,27,49,25,65,45,17,3,109,64,45,6,6,70,29,41
"2021","Lambeth 033C","E01003067",634,174,54,120,399,23,181,36,120,25,86,51,33,2,103,65,38,6,6,61,19,42
"2021","Lambeth 033D","E01003069",520,118,39,79,359,17,137,37,75,25,74,33,37,4,124,73,51,7,7,43,17,26
"2021","Lambeth 033E","E01003070",660,224,48,176,358,18,109,32,55,22,78,50,24,4,141,82,59,12,12,78,36,42
"2021","Lambeth 034A","E01003115",667,196,43,153,374,10,149,38,81,30,105,75,27,3,93,69,24,17,17,97,22,75
"2021","Lambeth 034B","E01003141",741,216,79,137,417,30,177,58,99,20,82,44,36,2,122,70,52,6,6,108,44,64
"2021","Lambeth 034C","E01003144",524,114,43,71,331,30,198,39,103,56,56,33,18,5,38,14,24,9,9,79,21,58
"2021","Lambeth 034D","E01003145",748,263,62,201,398,19,161,58,84,19,121,97,22,2,83,57,26,14,14,87,19,68
"2021","Lambeth 034E","E01003147",801,247,63,184,430,18,185,51,110,24,100,70,27,3,105,56,49,22,22,124,57,67
"2021","Lambeth 035A","E01003139",538,123,40,83,315,25,168,33,101,34,37,19,14,4,74,37,37,11,11,100,41,59
"2021","Lambeth 035B","E01003140",493,111,52,59,276,24,151,31,86,34,32,19,9,4,61,29,32,8,8,106,53,53
"2021","Lambeth 035C","E01003142",451,93,48,45,256,25,120,20,72,28,35,15,14,6,71,31,40,5,5,102,46,56
"2021","Lambeth 035D","E01003143",511,121,44,77,289,20,109,22,60,27,30,16,11,3,122,68,54,8,8,101,42,59
"2021","Lambeth 035E","E01003146",549,125,34,91,301,12,136,26,72,38,45,29,15,1,93,42,51,15,15,123,42,81
"2021","Lambeth 036A","E01003013",717,295,26,269,265,18,93,55,32,6,97,95,2,0,24,17,7,33,33,157,25,132
"2021","Lambeth 036B","E01003014",640,243,96,147,296,27,101,29,57,15,64,41,17,6,85,51,34,19,19,101,16,85
"2021","Lambeth 036C","E01003016",422,162,34,128,194,13,68,33,22,13,47,37,5,5,52,18,34,14,14,66,18,48
"2021","Lambeth 036D","E01003017",768,320,97,223,341,27,142,81,38,23,70,52,15,3,83,44,39,19,19,107,19,88
"2021","Lambeth 036E","E01032582",1169,504,72,432,480,19,141,63,56,22,125,109,13,3,128,71,57,67,67,185,23,162
"2021","Lewisham 001A","E01003244",730,200,27,173,429,4,143,30,90,23,79,45,29,5,173,118,55,30,30,101,27,74
"2021","Lewisham 001B","E01003245",637,154,27,127,403,3,171,24,116,31,44,20,20,4,174,115,59,11,11,80,35,45
"2021","Lewisham 001C","E01003247",874,263,36,227,438,12,162,75,61,26,155,133,18,4,85,35,50,24,24,173,34,139
"2021","Lewisham 001D","E01003249",855,268,50,218,451,11,182,66,88,28,96,68,20,8,149,87,62,13,13,136,32,104
"2021","Lewisham 001F","E01034387",844,316,45,271,402,1,188,122,63,3,169,153,16,0,21,14,7,23,23,126,8,118
"2021","Lewisham 001G","E01034388",617,207,27,180,331,2,128,64,50,14,138,128,10,0,44,24,20,19,19,79,14,65
"2021","Lewisham 001H","E01034389",731,271,23,248,364,3,131,47,67,17,96,72,17,7,114,69,45,20,20,96,24,72
"2021","Lewisham 002A","E01003246",1017,295,27,268,564,8,171,65,66,40,199,169,25,5,174,118,56,12,12,158,32,126
"2021","Lewisham 002B","E01003248",681,223,29,194,368,3,105,35,49,21,104,50,27,27,139,103,36,17,17,90,31,59
"2021","Lewisham 002C","E01003251",642,179,36,143,372,13,115,21,70,24,49,21,19,9,178,122,56,17,17,91,28,63
"2021","Lewisham 002D","E01003252",606,188,50,138,342,9,93,19,51,23,40,18,18,4,192,111,81,8,8,76,41,35
"2021","Lewisham 002E","E01003253",651,247,62,185,313,11,105,35,53,17,85,66,17,2,98,57,41,14,14,91,20,71
"2021","Lewisham 003A","E01003297",787,326,23,303,380,1,141,57,75,9,138,97,35,6,75,53,22,25,25,81,8,73
"2021","Lewisham 003B","E01003299",701,190,30,160,366,11,100,28,54,18,111,71,32,8,128,71,57,16,16,145,21,124
"2021","Lewisham 003C","E01003301",935,239,29,210,461,3,180,69,90,21,142,117,19,6,117,69,48,19,19,235,57,178
"2021","Lewisham 003D","E01003302",801,298,60,238,403,11,121,41,62,18,97,72,22,3,161,108,53,13,13,100,43,57
"2021","Lewisham 003E","E01003305",790,186,43,143,450,7,155,36,92,27,111,60,39,12,166,101,65,11,11,154,45,109
"2021","Lewisham 005A","E01003207",998,357,72,285,460,15,147,52,72,23,105,78,23,4,176,99,77,17,17,181,31,150
"2021","Lewisham 005B","E01003209",724,204,39,165,407,8,141,63,60,18,92,62,24,6,148,98,50,18,18,113,24,89
"2021","Lewisham 005C","E01003210",805,289,35,254,404,12,176,70,91,15,133,107,23,3,69,48,21,14,14,112,30,82
"2021","Lewisham 005D","E01003212",825,230,79,151,450,18,161,47,88,26,156,120,32,4,101,54,47,14,14,145,28,117
"2021","Lewisham 005E","E01003215",638,210,39,171,288,10,103,34,51,18,93,77,16,0,70,49,21,12,12,140,35,105
"2021","Lewisham 006A","E01003338",843,283,64,219,435,14,136,52,62,22,93,70,20,3,177,109,68,15,15,125,50,75
"2021","Lewisham 006B","E01003339",678,206,41,165,348,13,144,50,74,20,87,56,21,10,86,53,33,18,18,124,30,94
"2021","Lewisham 006C","E01003340",762,169,31,138,388,15,183,87,73,23,122,101,17,4,54,32,22,14,14,205,27,178
"2021","Lewisham 006D","E01003341",565,140,32,108,339,24,136,44,64,28,102,67,28,7,68,29,39,9,9,86,19,67
"2021","Lewisham 006E","E01003343",610,164,39,125,368,17,128,43,62,23,99,58,38,3,114,55,59,10,10,78,12,66
"2021","Lewisham 007A","E01003199",902,283,65,218,548,32,262,110,132,20,150,119,27,4,97,52,45,7,7,71,15,56
"2021","Lewisham 007B","E01003201",687,222,47,175,387,15,155,45,81,29,88,63,22,3,119,55,64,10,10,78,16,62
"2021","Lewisham 007C","E01003204",735,251,51,200,416,8,140,73,56,11,127,99,24,4,121,91,30,20,20,68,9,59
"2021","Lewisham 007D","E01003205",580,160,42,118,364,12,130,52,63,15,84,57,24,3,124,72,52,14,14,56,21,35
"2021","Lewisham 007E","E01003206",636,174,33,141,410,39,171,66,87,18,136,118,16,2,57,32,25,7,7,52,14,38
"2021","Lewisham 008B","E01003211",702,222,30,192,375,5,130,46,67,17,161,134,27,0,73,43,30,6,6,105,21,84
"2021","Lewisham 008C","E01003213",792,227,46,181,471,15,183,55,114,14,168,132,34,2,95,66,29,10,10,94,15,79
"2021","Lewisham 008D","E01003214",764,247,43,204,412,14,152,42,84,26,119,91,23,5,115,76,39,12,12,105,17,88
"2021","Lewisham 008E","E01033324",629,186,63,123,363,36,140,36,70,34,90,61,19,10,91,49,42,6,6,80,26,54
"2021","Lewisham 008F","E01033325",719,263,3,260,389,0,157,84,69,4,163,149,13,1,46,33,13,23,23,67,8,59
"2021","Lewisham 009A","E01003198",643,201,66,135,371,31,170,43,105,22,76,56,15,5,87,51,36,7,7,71,20,51
"2021","Lewisham 009B","E01003200",691,235,59,176,398,30,176,63,84,29,142,112,29,1,42,22,20,8,8,58,16,42
"2021","Lewisham 009C","E01003202",747,262,115,147,400,58,198,75,99,24,83,67,16,0,56,30,26,5,5,85,15,70
"2021","Lewisham 009D","E01003203",968,438,72,366,454,17,160,51,84,25,131,86,40,5,133,88,45,13,13,76,27,49
"2021","Lewisham 010A","E01003336",580,172,50,122,322,9,106,20,69,17,56,23,30,3,137,85,52,14,14,86,26,60
"2021","Lewisham 010B","E01003337",566,180,33,147,320,11,87,18,49,20,44,19,24,1,170,103,67,8,8,66,39,27
"2021","Lewisham 010C","E01003342",696,170,28,142,427,5,149,41,89,19,156,101,53,2,104,56,48,13,13,99,21,78
"2021","Lewisham 010D","E01003344",677,198,39,159,381,14,163,49,92,22,107,79,24,4,86,44,42,11,11,98,27,71
"2021","Lewisham 010E","E01003345",783,201,28,173,458,5,204,57,123,24,137,98,33,6,101,59,42,11,11,124,34,90
"2021","Lewisham 011A","E01003273",580,138,46,92,366,27,185,46,87,52,62,30,26,6,81,44,37,11,11,76,24,52
"2021","Lewisham 011B","E01003277",758,260,43,217,404,10,171,64,87,20,124,104,18,2,85,47,38,14,14,94,12,82
"2021","Lewisham 011C","E01003278",883,285,51,234,477,8,190,70,95,25,131,103,24,4,123,75,48,25,25,121,35,86
"2021","Lewisham 011D","E01003279",602,160,65,95,369,28,172,48,90,34,88,52,29,7,76,39,37,5,5,73,26,47
"2021","Lewisham 013A","E01003282",1020,323,88,235,571,23,235,98,122,15,184,144,35,5,111,56,55,18,18,126,32,94
"2021","Lewisham 013B","E01003283",869,243,79,164,550,38,328,78,209,41,118,68,43,7,58,35,23,8,8,76,16,60
"2021","Lewisham 013C","E01003284",757,202,52,150,476,23,230,63,133,34,125,90,34,1,93,60,33,5,5,79,32,47
"2021","Lewisham 013D","E01003286",770,267,95,172,461,24,200,41,131,28,70,40,28,2,150,98,52,17,17,42,19,23
"2021","Lewisham 014A","E01003272",791,198,36,162,441,20,196,51,118,27,123,89,31,3,93,48,45,9,9,152,22,130
"2021","Lewisham 014B","E01003274",662,182,43,139,410,19,177,55,95,27,104,68,33,3,103,63,40,7,7,70,19,51
"2021","Lewisham 014C","E01003275",621,169,62,107,366,24,159,38,77,44,61,32,27,2,114,55,59,8,8,86,41,45
"2021","Lewisham 014D","E01003276",663,124,30,94,450,31,228,44,146,38,85,45,37,3,98,51,47,8,8,89,35,54
"2021","Lewisham 015A","E01003225",586,115,48,67,410,29,239,54,158,27,78,37,36,5,61,25,36,3,3,61,21,40
"2021","Lewisham 015B","E01003231",647,197,53,144,343,15,140,38,85,17,102,65,36,1,77,47,30,9,9,107,19,88
"2021","Lewisham 015C","E01003232",622,130,58,72,404,31,221,50,137,34,92,48,39,5,54,23,31,6,6,88,30,58
"2021","Lewisham 015D","E01003233",666,140,49,91,433,22,210,64,125,21,90,55,31,4,105,65,40,6,6,93,34,59
"2021","Lewisham 016A","E01003280",625,166,58,108,394,29,188,36,125,27,54,33,16,5,117,75,42,6,6,65,35,30
"2021","Lewisham 016B","E01003281",584,150,59,91,386,34,222,49,139,34,57,23,27,7,69,38,31,4,4,48,18,30
"2021","Lewisham 016C","E01003285",752,242,85,157,432,28,207,55,129,23,92,67,25,0,97,61,36,8,8,78,28,50
"2021","Lewisham 016D","E01003287",762,168,62,106,539,37,308,71,205,32,115,72,40,3,73,44,29,6,6,55,20,35
"2021","Lewisham 017A","E01003292",734,213,45,168,433,16,182,62,94,26,121,87,33,1,100,69,31,14,14,88,32,56
"2021","Lewisham 017B","E01003293",637,202,40,162,339,10,116,45,55,16,112,83,26,3,92,61,31,9,9,96,36,60
"2021","Lewisham 017D","E01003295",726,211,26,185,454,31,167,50,98,19,121,90,25,6,106,72,34,29,29,61,19,42
"2021","Lewisham 017E","E01033320",637,180,45,135,378,20,170,55,90,25,101,73,25,3,78,53,25,9,9,79,25,54
"2021","Lewisham 017F","E01033322",574,200,17,183,317,5,123,43,65,15,112,87,22,3,71,52,19,6,6,57,14,43
"2021","Lewisham 018A","E01003319",750,258,81,177,373,20,135,43,65,27,64,34,26,4,144,93,51,10,10,119,38,81
"2021","Lewisham 018B","E01003320",620,203,42,161,330,6,123,34,65,24,62,39,19,4,129,78,51,10,10,87,34,53
"2021","Lewisham 018C","E01003323",622,182,50,132,324,8,126,40,64,22,79,55,19,5,98,64,34,13,13,116,31,85
"2021","Lewisham 018D","E01003325",787,261,77,184,427,11,133,47,65,21,88,53,32,3,188,144,44,7,7,99,41,58
"2021","Lewisham 019A","E01003226",705,164,38,126,418,27,197,49,119,29,119,71,46,2,68,40,28,7,7,123,30,93
"2021","Lewisham 019B","E01003227",658,181,63,118,418,26,228,53,137,38,104,57,40,7,50,24,26,10,10,59,13,46
"2021","Lewisham 019C","E01003228",667,162,44,118,428,21,199,63,129,7,130,92,32,6,72,38,34,6,6,77,12,65
"2021","Lewisham 019D","E01003229",781,287,75,212,429,22,141,53,71,17,98,65,29,4,155,101,54,13,13,65,21,44
"2021","Lewisham 019E","E01003230",870,290,55,235,500,20,184,55,107,22,128,71,51,6,153,98,55,15,15,80,25,55
"2021","Lewisham 020B","E01003318",775,301,31,270,383,10,139,41,85,13,71,46,25,0,148,112,36,15,15,91,42,49
"2021","Lewisham 020C","E01003321",760,265,53,212,393,11,138,35,71,32,113,76,35,2,120,79,41,11,11,102,29,73
"2021","Lewisham 020D","E01003322",608,177,46,131,303,15,124,37,71,16,73,41,27,5,82,44,38,9,9,128,59,69
"2021","Lewisham 020E","E01003324",723,245,58,187,420,13,162,49,93,20,67,38,25,4,168,118,50,10,10,58,25,33
"2021","Lewisham 020F","E01034390",690,254,15,239,380,2,149,61,73,15,125,100,22,3,95,82,13,9,9,56,16,40
"2021","Lewisham 020G","E01034391",636,164,33,131,408,28,211,44,134,33,86,48,33,5,76,45,31,7,7,64,19,45
"2021","Lewisham 021A","E01003254",604,175,69,106,367,41,184,63,95,26,85,58,26,1,54,41,13,3,3,62,20,42
"2021","Lewisham 021B","E01003255",984,362,51,311,530,14,181,84,86,11,214,164,45,5,110,77,33,11,11,92,13,79
"2021","Lewisham 021C","E01003260",635,153,41,112,410,34,228,51,139,38,74,43,28,3,71,38,33,3,3,72,21,51
"2021","Lewisham 021D","E01003261",607,149,52,97,389,25,186,50,110,26,87,64,21,2,85,43,42,6,6,69,12,57
"2021","Lewisham 021E","E01003262",661,193,46,147,400,11,157,48,88,21,134,98,32,4,85,54,31,13,13,68,14,54
"2021","Lewisham 022A","E01003217",655,154,55,99,407,31,219,48,126,45,63,31,28,4,86,44,42,8,8,94,51,43
"2021","Lewisham 022B","E01003218",549,115,47,68,375,35,192,41,118,33,54,22,26,6,87,43,44,7,7,59,27,32
"2021","Lewisham 022C","E01003220",598,181,46,135,337,12,147,35,87,25,62,41,19,2,87,46,41,29,29,80,36,44
"2021","Lewisham 022D","E01003222",618,174,50,124,353,28,173,36,100,37,45,25,13,7,100,52,48,7,7,91,29,62
"2021","Lewisham 022E","E01003224",640,153,47,106,412,27,207,44,122,41,71,29,34,8,96,52,44,11,11,75,36,39
"2021","Lewisham 023A","E01003263",741,228,71,157,440,19,182,47,106,29,75,41,31,3,156,96,60,8,8,73,36,37
"2021","Lewisham 023B","E01003268",766,245,74,171,450,27,205,59,113,33,90,60,28,2,114,83,31,14,14,71,17,54
"2021","Lewisham 023C","E01003269",639,153,54,99,425,35,196,55,88,53,78,43,30,5,103,59,44,13,13,61,23,38
"2021","Lewisham 023D","E01003270",655,197,54,143,395,37,184,53,87,44,81,42,31,8,85,38,47,8,8,63,27,36
"2021","Lewisham 023E","E01003271",621,138,73,65,421,63,221,65,114,42,57,31,20,6,72,32,40,8,8,62,31,31
"2021","Lewisham 024A","E01003307",650,164,56,108,433,25,203,58,117,28,96,60,30,6,98,46,52,11,11,53,15,38
"2021","Lewisham 024B","E01003308",708,204,56,148,433,18,188,44,116,28,108,71,32,5,107,68,39,12,12,71,25,46
"2021","Lewisham 024C","E01003314",660,174,41,133,431,16,199,48,137,14,105,67,37,1,105,70,35,6,6,55,24,31
"2021","Lewisham 024D","E01003315",592,186,40,146,343,8,132,57,61,14,114,86,23,5,81,55,26,8,8,63,13,50
"2021","Lewisham 024E","E01003316",575,129,43,86,387,23,190,55,100,35,100,59,36,5,68,33,35,6,6,59,17,42
"2021","Lewisham 025A","E01003216",617,158,25,133,364,24,178,48,92,38,65,37,23,5,89,52,37,8,8,95,31,64
"2021","Lewisham 025B","E01003219",661,200,112,88,398,33,223,49,112,62,42,17,18,7,94,47,47,6,6,63,26,37
"2021","Lewisham 025C","E01003221",764,232,50,182,425,29,175,34,104,37,94,39,53,2,114,68,46,13,13,107,54,53
"2021","Lewisham 025D","E01003223",596,132,51,81,369,59,186,40,84,62,46,24,12,10,68,31,37,10,10,95,30,65
"2021","Lewisham 026A","E01003346",649,182,61,121,396,21,182,61,72,49,40,17,12,11,141,75,66,12,12,71,37,34
"2021","Lewisham 026B","E01003349",544,119,37,82,374,5,156,27,98,31,52,19,29,4,155,94,61,6,6,51,22,29
"2021","Lewisham 026C","E01003351",598,162,68,94,353,22,138,22,81,35,49,20,23,6,136,83,53,8,8,83,52,31
"2021","Lewisham 026D","E01003354",825,275,58,217,438,21,184,61,86,37,81,48,31,2,141,108,33,11,11,112,61,51
"2021","Lewisham 027A","E01003309",654,207,78,129,366,14,133,32,76,25,86,54,27,5,125,93,32,8,8,81,24,57
"2021","Lewisham 027B","E01003310",732,263,50,213,371,10,132,40,68,24,121,86,32,3,98,58,40,10,10,98,13,85
"2021","Lewisham 027C","E01003311",593,140,47,93,392,49,214,56,122,36,59,30,23,6,64,29,35,6,6,61,30,31
"2021","Lewisham 027D","E01003312",774,295,116,179,413,27,191,49,110,32,92,56,32,4,95,58,37,8,8,66,28,38
"2021","Lewisham 027E","E01003313",624,173,33,140,389,9,119,25,79,15,93,50,36,7,159,103,56,9,9,62,31,31
"2021","Lewisham 028A","E01003256",934,318,73,245,535,29,196,42,127,27,135,98,31,6,164,97,67,11,11,81,22,59
"2021","Lewisham 028B","E01003257",632,174,53,121,383,33,165,39,98,28,75,44,29,2,106,59,47,4,4,75,20,55
"2021","Lewisham 028C","E01003258",591,147,29,118,378,9,127,30,63,34,58,32,20,6,176,115,61,8,8,66,27,39
"2021","Lewisham 028D","E01003259",757,244,53,191,437,22,191,57,120,14,115,74,38,3,97,65,32,12,12,76,28,48
"2021","Lewisham 029A","E01003193",684,178,72,106,444,32,205,36,128,41,67,31,32,4,129,67,62,11,11,62,28,34
"2021","Lewisham 029B","E01003194",725,241,87,154,395,22,160,52,79,29,59,40,15,4,144,88,56,10,10,89,44,45
"2021","Lewisham 029C","E01003195",623,179,66,113,399,25,171,50,90,31,81,43,34,4,114,58,56,8,8,45,18,27
"2021","Lewisham 029D","E01003196",672,221,74,147,373,17,162,45,81,36,51,24,17,10,136,81,55,7,7,78,49,29
"2021","Lewisham 029E","E01003197",652,220,66,154,359,15,145,42,58,45,47,19,21,7,143,90,53,9,9,73,39,34
"2021","Lewisham 030A","E01003347",654,164,42,122,447,11,115,14,75,26,55,11,38,6,255,178,77,11,11,43,19,24
"2021","Lewisham 030B","E01003348",619,158,69,89,372,23,170,31,99,40,50,20,18,12,120,73,47,9,9,89,44,45
"2021","Lewisham 030C","E01003350",475,130,39,91,282,10,126,32,54,40,33,15,13,5,102,62,40,11,11,63,43,20
"2021","Lewisham 030D","E01003352",843,234,85,149,527,34,213,35,125,53,49,21,21,7,216,141,75,15,15,82,39,43
"2021","Lewisham 030E","E01003353",627,151,71,80,395,35,215,36,121,58,56,21,29,6,83,41,42,6,6,81,44,37
"2021","Lewisham 031A","E01003264",720,267,135,132,376,25,165,48,78,39,71,38,27,6,110,62,48,5,5,77,35,42
"2021","Lewisham 031B","E01003265",665,180,44,136,396,9,149,43,79,27,84,50,29,5,143,98,45,11,11,89,34,55
"2021","Lewisham 031C","E01003266",732,257,96,161,412,27,156,41,82,33,70,33,29,8,148,80,68,11,11,63,34,29
"2021","Lewisham 031D","E01003267",609,152,70,82,391,19,190,28,105,57,57,31,21,5,118,69,49,7,7,66,33,33
"2021","Lewisham 033A","E01003329",657,178,57,121,415,11,198,48,117,33,83,50,30,3,120,70,50,3,3,64,23,41
"2021","Lewisham 033B","E01003330",667,203,74,129,421,26,154,28,101,25,62,34,24,4,171,117,54,8,8,43,19,24
"2021","Lewisham 033C","E01003331",587,183,91,92,352,36,151,42,78,31,56,23,26,7,102,54,48,7,7,52,19,33
"2021","Lewisham 033D","E01003332",708,260,81,179,384,17,149,38,94,17,104,74,23,7,109,59,50,5,5,64,25,39
"2021","Lewisham 033E","E01003334",792,296,73,223,407,15,145,59,62,24,111,83,23,5,123,80,43,13,13,89,38,51
"2021","Lewisham 034A","E01003189",652,195,57,138,378,12,153,26,84,43,63,34,20,9,139,80,59,11,11,79,53,26
"2021","Lewisham 034B","E01003190",950,273,58,215,602,8,177,46,103,28,82,38,34,10,286,198,88,49,49,75,47,28
"2021","Lewisham 034C","E01003191",701,239,69,170,403,10,158,46,83,29,59,24,26,9,164,99,65,12,12,59,28,31
"2021","Lewisham 034D","E01003192",743,301,63,238,370,9,122,31,69,22,63,23,36,4,165,104,61,11,11,72,45,27
"2021","Lewisham 035A","E01003326",697,216,86,130,395,28,175,57,94,24,75,46,22,7,109,73,36,8,8,86,45,41
"2021","Lewisham 035B","E01003327",690,200,66,134,418,30,200,64,101,35,100,65,32,3,81,48,33,7,7,72,17,55
"2021","Lewisham 035C","E01003328",827,313,103,210,443,25,162,64,76,22,127,91,29,7,113,79,34,16,16,71,23,48
"2021","Lewisham 035D","E01003333",632,170,48,122,404,15,157,32,95,30,96,64,28,4,128,60,68,8,8,58,26,32
"2021","Lewisham 035E","E01003335",619,163,49,114,412,24,133,30,70,33,99,73,23,3,147,99,48,9,9,44,24,20
"2021","Lewisham 037A","E01003236",651,151,52,99,429,21,165,43,94,28,68,33,27,8,166,91,75,9,9,71,38,33
"2021","Lewisham 037B","E01003237",614,148,48,100,409,13,184,35,109,40,66,26,28,12,141,76,65,5,5,57,28,29
"2021","Lewisham 037C","E01003238",566,148,39,109,374,19,138,24,96,18,56,21,26,9,157,99,58,4,4,44,24,20
"2021","Lewisham 037D","E01003239",576,133,42,91,374,17,164,30,95,39,41,14,25,2,142,89,53,10,10,69,39,30
"2021","Lewisham 037E","E01032564",490,105,33,72,347,11,97,27,54,16,65,28,24,13,167,94,73,7,7,38,17,21
"2021","Lewisham 038A","E01003235",524,123,42,81,346,31,164,42,80,42,51,23,22,6,90,45,45,10,10,55,32,23
"2021","Lewisham 038B","E01003240",715,176,61,115,456,25,173,35,104,34,80,33,36,11,169,99,70,9,9,83,54,29
"2021","Lewisham 038C","E01003241",696,274,165,109,349,34,153,37,74,42,42,17,17,8,111,42,69,9,9,73,34,39
"2021","Lewisham 038D","E01003243",589,173,70,103,359,20,148,34,75,39,56,31,22,3,121,76,45,14,14,57,30,27
"2021","Lewisham 038E","E01032565",605,223,87,136,342,18,137,26,81,30,41,17,20,4,125,74,51,21,21,40,24,16
"2021","Lewisham 039A","E01003298",472,121,28,93,275,5,79,20,38,21,35,19,13,3,141,85,56,15,15,76,28,48
"2021","Lewisham 039B","E01003300",600,207,35,172,297,5,100,30,43,27,52,27,21,4,125,75,50,15,15,96,43,53
"2021","Lewisham 039C","E01003303",646,189,41,148,336,18,103,35,49,19,79,61,15,3,113,72,41,23,23,121,33,88
"2021","Lewisham 039D","E01003304",1081,441,38,403,480,10,155,61,77,17,164,140,17,7,127,83,44,24,24,160,32,128
"2021","Lewisham 039E","E01032579",972,344,54,290,489,3,176,86,76,14,159,118,35,6,130,94,36,21,21,139,19,120
"2021","Lewisham 040A","E01034392",677,253,31,222,334,6,119,47,60,12,99,71,26,2,100,73,27,10,10,90,19,71
"2021","Lewisham 040B","E01034393",617,240,6,234,318,2,122,81,35,6,163,151,12,0,19,10,9,12,12,59,3,56
"2021","Lewisham 040C","E01034394",670,241,4,237,354,1,158,102,51,5,147,136,11,0,20,12,8,28,28,75,5,70
"2021","Lewisham 040D","E01034395",703,188,17,171,443,1,120,41,63,16,93,64,27,2,207,153,54,22,22,72,25,47
"2021","Lewisham 041A","E01003288",946,348,122,226,478,29,206,107,77,22,87,61,26,0,138,91,47,18,18,120,46,74
"2021","Lewisham 041E","E01003290",815,324,56,268,388,10,138,51,70,17,78,54,22,2,142,87,55,20,20,103,36,67
"2021","Lewisham 041D","E01003291",651,234,68,166,346,12,105,30,58,17,69,40,20,9,154,104,50,6,6,71,27,44
"2021","Lewisham 041B","E01033327",1006,372,44,328,488,15,210,78,84,48,150,127,23,0,82,57,25,31,31,146,44,102
"2021","Lewisham 041C","E01033341",568,171,32,139,309,13,96,37,48,11,82,59,19,4,108,73,35,10,10,88,25,63
"2021","Merton 001A","E01003472",473,70,39,31,372,32,262,51,184,27,48,26,20,2,27,15,12,3,3,31,13,18
"2021","Merton 001B","E01003473",563,117,43,74,364,33,228,51,145,32,66,55,10,1,35,23,12,2,2,82,14,68
"2021","Merton 001C","E01003474",470,73,32,41,357,37,271,69,159,43,25,21,4,0,22,15,7,2,2,40,18,22
"2021","Merton 001E","E01003478",666,120,38,82,464,22,314,59,215,40,73,53,19,1,44,28,16,11,11,82,28,54
"2021","Merton 001F","E01034578",443,106,32,74,293,18,133,32,80,21,47,33,13,1,88,69,19,7,7,44,14,30
"2021","Merton 001G","E01034579",895,278,30,248,543,13,210,95,100,15,188,156,31,1,110,86,24,22,22,74,20,54
"2021","Merton 002A","E01003460",647,235,127,108,363,76,194,72,88,34,52,39,12,1,40,23,17,1,1,49,13,36
"2021","Merton 002B","E01003462",575,150,83,67,392,90,233,58,134,41,38,22,15,1,28,19,9,3,3,33,15,18
"2021","Merton 002C","E01003464",540,127,80,47,361,81,219,63,125,31,22,14,8,0,35,12,23,4,4,52,18,34
"2021","Merton 002D","E01003465",465,83,50,33,338,69,218,68,109,41,25,15,9,1,24,15,9,2,2,44,15,29
"2021","Merton 003A","E01003400",629,194,50,144,362,26,206,63,124,19,90,82,8,0,28,19,9,12,12,73,17,56
"2021","Merton 003B","E01003454",575,174,74,100,358,34,198,64,107,27,81,59,19,3,35,20,15,10,10,43,8,35
"2021","Merton 003C","E01003456",666,181,45,136,401,26,209,72,116,21,125,107,15,3,34,21,13,7,7,84,14,70
"2021","Merton 003D","E01003476",490,107,37,70,307,14,189,32,122,35,37,25,11,1,60,32,28,7,7,76,21,55
"2021","Merton 003E","E01003477",592,116,50,66,406,21,253,59,160,34,74,49,22,3,54,30,24,4,4,70,10,60
"2021","Merton 004A","E01003401",625,211,104,107,355,22,209,65,123,21,78,67,11,0,39,21,18,7,7,59,13,46
"2021","Merton 004B","E01003402",680,256,98,158,372,42,236,75,136,25,47,34,13,0,39,23,16,8,8,52,15,37
"2021","Merton 004C","E01003403",676,233,99,134,395,55,221,91,106,24,90,77,12,1,24,10,14,5,5,48,12,36
"2021","Merton 004D","E01003404",914,384,160,224,461,45,231,89,122,20,128,104,21,3,40,30,10,17,17,69,11,58
"2021","Merton 004E","E01003461",675,225,71,154,398,58,200,90,87,23,92,71,18,3,45,22,23,3,3,52,10,42
"2021","Merton 005B","E01003369",745,211,48,163,429,9,175,79,79,17,163,127,32,4,70,31,39,12,12,105,28,77
"2021","Merton 005C","E01003370",878,258,45,213,487,20,194,62,101,31,172,142,28,2,76,51,25,25,25,133,31,102
"2021","Merton 005D","E01003371",630,163,51,112,352,24,173,61,80,32,102,84,14,4,43,14,29,10,10,115,21,94
"2021","Merton 005E","E01003455",747,238,38,200,441,10,210,69,116,25,152,119,28,5,59,34,25,10,10,68,15,53
"2021","Merton 005F","E01034580",596,151,21,130,346,20,158,56,69,33,108,93,15,0,51,19,32,9,9,99,19,80
"2021","Merton 005G","E01034581",683,208,22,186,397,6,184,80,93,11,145,129,16,0,49,35,14,13,13,78,11,67
"2021","Merton 006A","E01003359",797,289,108,181,432,20,220,75,128,17,119,96,17,6,61,34,27,12,12,76,15,61
"2021","Merton 006B","E01003360",746,181,44,137,470,12,254,93,145,16,150,120,29,1,46,24,22,8,8,95,20,75
"2021","Merton 006C","E01003457",614,137,46,91,422,18,305,54,219,32,62,44,17,1,34,22,12,3,3,55,12,43
"2021","Merton 006D","E01003458",719,168,47,121,469,26,260,73,161,26,123,98,25,0,49,32,17,11,11,82,9,73
"2021","Merton 006E","E01003459",959,278,69,209,569,26,254,99,125,30,149,121,25,3,130,90,40,10,10,112,24,88
"2021","Merton 007A","E01003394",674,125,49,76,372,34,196,42,91,63,56,27,24,5,70,34,36,16,16,177,78,99
"2021","Merton 007B","E01003395",539,99,40,59,321,30,187,48,95,44,33,22,10,1,62,19,43,9,9,119,57,62
"2021","Merton 007C","E01003396",527,111,53,58,303,26,159,36,85,38,45,24,20,1,58,17,41,15,15,113,42,71
"2021","Merton 007D","E01003397",544,121,47,74,306,28,153,35,78,40,47,28,17,2,61,31,30,17,17,117,37,80
"2021","Merton 007E","E01003398",656,153,51,102,371,25,202,43,99,60,63,37,22,4,71,29,42,10,10,132,59,73
"2021","Merton 008A","E01003368",582,124,42,82,342,34,171,36,95,40,61,41,13,7,61,24,37,15,15,116,48,68
"2021","Merton 008B","E01003372",642,167,43,124,361,13,146,34,85,27,75,50,18,7,111,60,51,16,16,114,44,70
"2021","Merton 008C","E01003393",689,205,35,170,367,13,171,53,102,16,100,78,22,0,73,40,33,10,10,117,32,85
"2021","Merton 008D","E01003406",569,110,19,91,342,11,170,46,88,36,54,25,22,7,96,44,52,11,11,117,44,73
"2021","Merton 008E","E01003407",786,232,41,191,450,8,241,84,123,34,106,76,27,3,82,59,23,13,13,104,38,66
"2021","Merton 009A","E01003355",821,266,56,210,475,15,228,93,116,19,180,156,21,3,34,21,13,18,18,80,21,59
"2021","Merton 009B","E01003356",704,165,63,102,444,20,290,72,184,34,79,58,18,3,46,28,18,9,9,95,23,72
"2021","Merton 009C","E01003358",793,243,64,179,461,20,260,90,153,17,129,116,13,0,43,28,15,9,9,89,15,74
"2021","Merton 009D","E01003383",667,154,40,114,432,14,244,70,150,24,123,97,25,1,45,24,21,6,6,81,17,64
"2021","Merton 009E","E01003384",680,152,41,111,463,29,260,84,153,23,120,100,18,2,45,34,11,9,9,65,10,55
"2021","Merton 010A","E01003442",676,201,97,104,426,56,258,69,164,25,56,48,8,0,51,25,26,5,5,49,22,27
"2021","Merton 010B","E01003443",634,161,82,79,443,60,290,54,207,29,36,25,8,3,52,29,23,5,5,30,10,20
"2021","Merton 010C","E01003444",673,187,74,113,446,51,267,80,156,31,74,53,21,0,52,27,25,2,2,40,11,29
"2021","Merton 010D","E01003445",652,136,57,79,459,47,283,57,168,58,59,31,24,4,59,35,24,11,11,57,22,35
"2021","Merton 010E","E01003463",547,106,59,47,386,66,251,61,152,38,20,10,9,1,48,30,18,1,1,55,25,30
"2021","Merton 011A","E01003380",666,159,71,88,440,33,273,50,193,30,85,61,23,1,41,15,26,8,8,67,18,49
"2021","Merton 011B","E01003382",726,175,70,105,485,35,275,77,180,18,111,82,26,3,58,31,27,6,6,66,17,49
"2021","Merton 011C","E01003385",583,104,33,71,435,49,302,53,222,27,54,39,13,2,26,12,14,4,4,44,15,29
"2021","Merton 011D","E01003399",630,190,66,124,382,33,197,71,103,23,97,83,14,0,46,29,17,9,9,58,7,51
"2021","Merton 011E","E01003423",650,168,71,97,412,43,257,71,162,24,71,47,23,1,38,16,22,3,3,70,26,44
"2021","Merton 012A","E01003357",724,197,59,138,440,18,176,33,105,38,72,35,30,7,161,103,58,13,13,87,25,62
"2021","Merton 012B","E01003376",589,159,57,102,347,20,174,57,80,37,44,23,15,6,99,47,52,10,10,83,46,37
"2021","Merton 012C","E01003377",548,112,28,84,352,10,140,36,69,35,53,20,27,6,142,83,59,7,7,84,47,37
"2021","Merton 012D","E01003408",869,271,63,208,507,19,235,84,123,28,156,114,40,2,76,46,30,21,21,91,21,70
"2021","Merton 012E","E01003410",626,161,29,132,370,21,173,39,102,32,69,44,22,3,87,53,34,20,20,95,38,57
"2021","Merton 013A","E01003386",759,148,57,91,475,26,274,39,175,60,51,28,23,0,104,68,36,20,20,136,66,70
"2021","Merton 013B","E01003388",618,156,87,69,347,32,173,34,97,42,46,26,16,4,86,45,41,10,10,115,58,57
"2021","Merton 013C","E01003389",642,162,59,103,361,25,191,47,96,48,51,25,23,3,80,42,38,14,14,119,55,64
"2021","Merton 013D","E01003392",513,126,43,83,302,24,156,39,84,33,51,22,28,1,61,30,31,10,10,85,40,45
"2021","Merton 013E","E01003409",580,119,57,62,338,18,168,35,90,43,41,19,18,4,95,41,54,16,16,123,69,54
"2021","Merton 014A","E01003387",784,217,72,145,457,20,203,44,118,41,75,38,32,5,142,80,62,17,17,110,55,55
"2021","Merton 014B","E01003391",481,149,36,113,279,7,107,21,64,22,33,12,18,3,124,90,34,8,8,53,27,26
"2021","Merton 014C","E01003411",742,163,45,118,483,25,244,46,162,36,94,55,36,3,103,66,37,17,17,96,58,38
"2021","Merton 014D","E01003412",621,163,44,119,360,13,163,25,97,41,44,29,11,4,134,81,53,6,6,98,54,44
"2021","Merton 014E","E01003435",738,170,49,121,468,33,227,42,134,51,68,33,30,5,130,77,53,10,10,100,49,51
"2021","Merton 015A","E01003361",616,127,58,69,396,41,222,60,129,33,54,28,23,3,68,38,30,11,11,93,31,62
"2021","Merton 015B","E01003424",574,110,84,26,419,85,263,58,158,47,34,17,15,2,35,14,21,2,2,45,15,30
"2021","Merton 015C","E01003425",517,78,55,23,377,69,253,53,146,54,24,14,10,0,31,13,18,0,0,62,29,33
"2021","Merton 015D","E01003426",602,95,61,34,406,59,240,43,125,72,47,27,15,5,53,23,30,7,7,101,32,69
"2021","Merton 015E","E01003428",632,198,97,101,399,42,238,55,151,32,69,52,15,2,43,25,18,7,7,35,9,26
"2021","Merton 016A","E01003366",647,167,58,109,375,23,198,48,122,28,73,48,17,8,70,31,39,11,11,105,40,65
"2021","Merton 016B","E01003381",708,234,96,138,401,18,229,83,131,15,123,94,27,2,27,18,9,4,4,73,17,56
"2021","Merton 016C","E01003446",901,312,63,249,509,24,264,87,146,31,131,109,17,5,82,48,34,8,8,80,19,61
"2021","Merton 016D","E01003447",681,206,59,147,411,15,172,62,90,20,87,61,23,3,125,86,39,12,12,64,18,46
"2021","Merton 016E","E01003471",635,135,71,64,422,55,245,60,150,35,59,39,18,2,56,28,28,7,7,78,30,48
"2021","Merton 017A","E01003413",732,160,54,106,453,24,205,48,120,37,92,53,33,6,111,63,48,21,21,119,61,58
"2021","Merton 017B","E01003414",565,113,61,52,361,37,179,43,86,50,46,20,19,7,84,36,48,15,15,91,42,49
"2021","Merton 017C","E01003415",791,168,57,111,473,36,264,41,162,61,63,34,22,7,100,52,48,10,10,150,80,70
"2021","Merton 017D","E01003416",534,106,58,48,327,38,168,32,78,58,40,15,20,5,70,18,52,11,11,101,50,51
"2021","Merton 017E","E01003434",500,93,40,53,312,40,162,29,84,49,43,13,19,11,63,24,39,4,4,95,52,43
"2021","Merton 018A","E01003373",545,122,30,92,329,11,118,24,65,29,38,17,17,4,157,101,56,5,5,94,45,49
"2021","Merton 018B","E01003378",769,152,47,105,500,20,260,53,156,51,93,45,36,12,118,65,53,9,9,117,66,51
"2021","Merton 018C","E01003379",742,211,78,133,423,18,197,39,123,35,66,30,28,8,134,86,48,8,8,108,60,48
"2021","Merton 018D","E01003390",638,168,36,132,390,8,180,36,110,34,40,13,26,1,148,105,43,14,14,80,37,43
"2021","Merton 018E","E01003405",840,199,59,140,504,26,262,62,152,48,77,27,41,9,125,66,59,14,14,137,71,66
"2021","Merton 019A","E01003429",526,97,49,48,337,26,189,37,97,55,35,11,17,7,79,36,43,8,8,92,52,40
"2021","Merton 019B","E01003430",577,157,29,128,305,11,119,14,74,31,32,12,16,4,127,97,30,16,16,115,56,59
"2021","Merton 019C","E01003431",570,121,40,81,355,15,154,29,87,38,39,10,17,12,139,81,58,8,8,94,51,43
"2021","Merton 019D","E01003432",527,90,39,51,356,8,162,32,87,43,37,7,25,5,142,86,56,7,7,81,51,30
"2021","Merton 019E","E01003433",576,151,63,88,333,28,147,23,79,45,41,16,20,5,105,58,47,12,12,92,47,45
"2021","Merton 020A","E01003466",626,132,71,61,413,44,277,56,161,60,44,20,18,6,45,18,27,3,3,81,23,58
"2021","Merton 020B","E01003467",667,155,80,75,464,65,282,62,172,48,50,29,17,4,63,35,28,4,4,48,19,29
"2021","Merton 020C","E01003468",638,134,69,65,448,61,299,52,189,58,48,29,16,3,34,18,16,6,6,56,23,33
"2021","Merton 020D","E01003469",576,93,33,60,404,29,230,52,129,49,52,25,24,3,80,41,39,13,13,79,33,46
"2021","Merton 020E","E01003470",749,198,55,143,464,29,301,61,173,67,64,41,20,3,58,31,27,12,12,87,34,53
"2021","Merton 021A","E01003362",503,102,60,42,350,51,219,43,118,58,24,10,11,3,51,24,27,5,5,51,14,37
"2021","Merton 021B","E01003363",595,105,74,31,436,51,280,59,159,62,41,16,23,2,58,22,36,6,6,54,26,28
"2021","Merton 021C","E01003364",662,142,99,43,457,67,290,66,157,67,48,19,27,2,49,11,38,3,3,63,31,32
"2021","Merton 021D","E01003365",501,85,60,25,342,55,216,56,113,47,38,14,20,4,29,7,22,4,4,74,31,43
"2021","Merton 021E","E01003421",612,158,67,91,385,44,219,52,121,46,53,36,16,1,62,31,31,7,7,69,33,36
"2021","Merton 022A","E01003374",667,200,70,130,400,19,185,50,106,29,62,39,21,2,120,74,46,14,14,67,34,33
"2021","Merton 022B","E01003375",721,254,139,115,404,41,237,48,141,48,49,21,24,4,71,31,40,6,6,63,28,35
"2021","Merton 022C","E01003437",769,207,96,111,451,63,238,65,120,53,62,38,21,3,76,36,40,12,12,111,58,53
"2021","Merton 022D","E01003440",630,163,56,107,389,34,173,48,92,33,61,34,23,4,113,66,47,8,8,78,42,36
"2021","Merton 022E","E01003441",646,145,47,98,405,30,200,45,110,45,61,28,27,6,105,59,46,9,9,96,54,42
"2021","Merton 023A","E01003427",729,178,62,116,419,27,250,64,150,36,57,35,20,2,68,40,28,17,17,132,53,79
"2021","Merton 023B","E01003436",606,133,57,76,397,22,223,53,118,52,49,22,24,3,94,46,48,9,9,76,41,35
"2021","Merton 023C","E01003439",573,127,37,90,356,12,183,50,89,44,48,25,18,5,107,64,43,6,6,90,37,53
"2021","Merton 023D","E01003448",885,236,57,179,547,14,263,68,155,40,130,87,33,10,119,61,58,21,21,102,55,47
"2021","Merton 023E","E01003453",662,166,63,103,399,21,208,45,124,39,73,47,19,7,87,50,37,10,10,97,44,53
"2021","Merton 024A","E01003438",657,163,76,87,418,21,221,50,108,63,63,28,31,4,107,59,48,6,6,76,42,34
"2021","Merton 024B","E01003449",663,177,75,102,370,39,184,35,119,30,50,19,20,11,79,39,40,18,18,116,52,64
"2021","Merton 024C","E01003450",610,131,61,70,402,21,200,33,132,35,71,33,28,10,104,54,50,6,6,77,44,33
"2021","Merton 024D","E01003451",664,133,59,74,456,59,275,61,134,80,51,19,25,7,65,33,32,6,6,75,36,39
"2021","Merton 024E","E01003452",815,222,104,118,496,37,264,62,143,59,61,26,28,7,126,64,62,8,8,97,50,47
"2021","Merton 025A","E01003417",603,140,83,57,407,44,220,48,113,59,61,27,30,4,74,35,39,8,8,56,22,34
"2021","Merton 025B","E01003418",528,95,65,30,393,64,230,58,101,71,49,19,27,3,49,25,24,1,1,40,17,23
"2021","Merton 025C","E01003419",666,127,60,67,473,39,269,75,137,57,75,27,39,9,79,42,37,11,11,66,36,30
"2021","Merton 025D","E01003420",505,73,35,38,380,42,218,40,128,50,54,23,27,4,55,19,36,11,11,52,31,21
"2021","Merton 025E","E01003422",532,121,70,51,354,56,203,42,106,55,39,26,12,1,56,26,30,0,0,57,32,25
"2021","Newham 001A","E01003543",839,215,42,173,497,20,247,59,145,43,107,67,34,6,107,61,46,16,16,127,62,65
"2021","Newham 001B","E01003544",623,133,32,101,367,9,171,37,105,29,72,38,30,4,99,43,56,16,16,123,45,78
"2021","Newham 001C","E01003546",572,116,31,85,347,4,158,31,96,31,46,30,16,0,126,67,59,13,13,109,61,48
"2021","Newham 001D","E01003550",609,152,39,113,356,12,187,40,117,30,49,32,15,2,98,46,52,10,10,101,59,42
"2021","Newham 002A","E01003576",633,201,57,144,368,8,202,24,142,36,29,8,19,2,115,68,47,14,14,64,44,20
"2021","Newham 002B","E01003581",475,60,19,41,308,7,193,23,120,50,22,14,8,0,78,44,34,8,8,107,72,35
"2021","Newham 002C","E01003582",452,77,29,48,287,13,155,21,107,27,20,4,9,7,94,55,39,5,5,88,56,32
"2021","Newham 002D","E01003583",532,71,23,48,358,9,219,20,159,40,25,6,13,6,95,65,30,10,10,103,73,30
"2021","Newham 003A","E01003578",592,112,24,88,379,5,236,22,185,29,36,18,18,0,85,63,22,17,17,101,58,43
"2021","Newham 003B","E01003584",606,131,47,84,363,22,198,41,109,48,44,33,8,3,88,41,47,11,11,112,58,54
"2021","Newham 003C","E01003586",530,85,20,65,325,14,190,33,110,47,36,17,17,2,59,37,22,26,26,120,73,47
"2021","Newham 003D","E01003590",572,169,52,117,334,2,151,26,96,29,34,19,12,3,140,108,32,7,7,69,38,31
"2021","Newham 004A","E01003579",491,82,31,51,287,17,176,12,133,31,19,10,8,1,67,38,29,8,8,122,95,27
"2021","Newham 004B","E01003585",409,59,14,45,214,12,133,15,81,37,19,11,7,1,44,25,19,6,6,136,89,47
"2021","Newham 004C","E01003587",806,165,65,100,512,11,284,47,203,34,56,33,19,4,149,99,50,12,12,129,75,54
"2021","Newham 004D","E01003591",682,152,51,101,401,7,241,41,161,39,28,17,11,0,111,66,45,14,14,129,80,49
"2021","Newham 005A","E01003528",409,86,27,59,256,7,142,23,95,24,10,3,5,2,93,56,37,4,4,67,44,23
"2021","Newham 005B","E01003575",470,80,28,52,281,11,177,18,128,31,19,7,10,2,66,32,34,8,8,109,64,45
"2021","Newham 005C","E01003577",759,187,63,124,484,4,276,19,222,35,46,17,29,0,152,99,53,6,6,88,47,41
"2021","Newham 005D","E01003580",612,136,41,95,384,13,217,22,168,27,27,11,13,3,119,74,45,8,8,92,50,42
"2021","Newham 006A","E01003545",634,180,40,140,338,9,134,34,81,19,63,34,16,13,115,62,53,17,17,116,44,72
"2021","Newham 006B","E01003548",809,240,87,153,390,19,199,62,103,34,62,37,20,5,93,48,45,17,17,179,68,111
"2021","Newham 006C","E01003549",780,203,42,161,435,12,198,39,131,28,69,40,25,4,134,70,64,22,22,142,54,88
"2021","Newham 006D","E01003557",652,172,25,147,364,7,172,40,103,29,62,43,15,4,104,59,45,19,19,116,65,51
"2021","Newham 007A","E01003547",675,163,50,113,388,23,201,50,110,41,76,47,25,4,79,36,43,9,9,124,47,77
"2021","Newham 007B","E01003555",485,109,32,77,223,21,121,23,72,26,24,11,11,2,46,18,28,11,11,153,101,52
"2021","Newham 007C","E01003561",467,67,29,38,278,13,182,28,107,47,19,15,4,0,51,25,26,13,13,122,74,48
"2021","Newham 007D","E01003567",507,71,20,51,299,9,185,24,131,30,19,8,10,1,74,44,30,12,12,137,86,51
"2021","Newham 008A","E01003556",651,201,34,167,359,5,190,24,144,22,42,22,19,1,107,69,38,15,15,91,59,32
"2021","Newham 008B","E01003558",543,127,28,99,303,10,162,19,117,26,51,33,14,4,66,47,19,14,14,113,59,54
"2021","Newham 008C","E01003570",546,112,22,90,317,9,216,31,133,52,17,7,8,2,63,28,35,12,12,117,72,45
"2021","Newham 008D","E01003571",579,89,31,58,316,10,208,36,114,58,21,11,8,2,66,35,31,11,11,174,107,67
"2021","Newham 008E","E01003572",447,74,20,54,250,9,149,15,89,45,25,15,6,4,53,24,29,14,14,123,84,39
"2021","Newham 009A","E01003551",620,171,52,119,324,7,153,31,88,34,52,29,18,5,91,57,34,21,21,125,46,79
"2021","Newham 009B","E01003553",734,224,48,176,407,5,195,36,130,29,63,29,28,6,122,68,54,22,22,103,38,65
"2021","Newham 009C","E01003554",690,200,51,149,328,17,139,39,64,36,80,57,19,4,65,29,36,27,27,162,58,104
"2021","Newham 009D","E01003559",898,256,46,210,459,7,192,60,104,28,105,66,32,7,112,61,51,43,43,183,59,124
"2021","Newham 010A","E01003529",627,79,21,58,357,23,225,33,133,59,19,5,10,4,63,26,37,27,27,191,122,69
"2021","Newham 010B","E01003530",482,65,29,36,266,12,172,21,105,46,20,7,12,1,52,21,31,10,10,151,83,68
"2021","Newham 010C","E01003531",561,86,31,55,309,20,179,25,115,39,14,6,5,3,75,42,33,21,21,166,109,57
"2021","Newham 010D","E01003532",564,91,38,53,273,12,181,34,89,58,18,8,6,4,49,20,29,13,13,200,129,71
"2021","Newham 010E","E01003534",630,96,33,63,380,11,241,31,154,56,26,9,12,5,90,50,40,12,12,154,95,59
"2021","Newham 011A","E01003533",566,87,34,53,339,10,227,31,134,62,25,11,14,0,65,34,31,12,12,140,103,37
"2021","Newham 011B","E01003560",445,62,29,33,264,13,163,22,93,48,22,8,13,1,52,29,23,14,14,119,78,41
"2021","Newham 011C","E01003563",587,78,21,57,338,12,213,18,150,45,23,8,15,0,78,41,37,12,12,171,127,44
"2021","Newham 011D","E01003588",427,63,23,40,250,15,156,18,99,39,21,9,12,0,49,21,28,9,9,114,72,42
"2021","Newham 011E","E01003589",510,93,30,63,286,8,201,25,135,41,20,13,7,0,47,29,18,10,10,131,87,44
"2021","Newham 012A","E01003616",679,189,47,142,375,11,185,39,102,44,62,34,22,6,100,45,55,17,17,115,42,73
"2021","Newham 012C","E01003618",828,214,62,152,397,12,169,49,96,24,94,67,23,4,86,54,32,36,36,217,62,155
"2021","Newham 012D","E01003619",1062,308,89,219,572,10,200,67,113,20,109,78,27,4,221,176,45,32,32,182,40,142
"2021","Newham 012E","E01034199",704,195,55,140,377,11,140,36,76,28,49,33,9,7,157,99,58,20,20,132,48,84
"2021","Newham 012F","E01034200",723,237,12,225,332,5,153,80,63,10,105,98,7,0,41,24,17,28,28,154,23,131
"2021","Newham 014A","E01003562",586,88,29,59,336,28,212,35,121,56,23,10,11,2,58,22,36,15,15,162,91,71
"2021","Newham 014B","E01003564",655,92,26,66,379,15,231,32,155,44,36,14,20,2,79,44,35,18,18,184,113,71
"2021","Newham 014C","E01003565",513,71,22,49,297,9,209,22,149,38,22,10,10,2,45,23,22,12,12,145,92,53
"2021","Newham 014D","E01003566",533,106,43,63,297,10,198,25,148,25,20,7,11,2,53,27,26,16,16,130,88,42
"2021","Newham 015A","E01003625",485,81,21,60,278,7,169,15,119,35,34,20,13,1,59,35,24,9,9,126,83,43
"2021","Newham 015B","E01003626",460,63,21,42,276,13,182,34,120,28,21,10,8,3,49,19,30,11,11,121,56,65
"2021","Newham 015C","E01003627",453,93,29,64,251,11,167,23,100,44,25,15,8,2,38,15,23,10,10,109,59,50
"2021","Newham 015D","E01003628",429,39,11,28,272,18,197,24,118,55,18,7,8,3,34,17,17,5,5,118,62,56
"2021","Newham 015E","E01003629",508,73,22,51,286,17,189,26,130,33,22,15,6,1,53,37,16,5,5,149,100,49
"2021","Newham 016A","E01003552",528,133,37,96,290,14,148,30,95,23,42,26,13,3,72,37,35,14,14,105,49,56
"2021","Newham 016B","E01003596",532,129,44,85,313,9,164,22,115,27,54,29,24,1,67,39,28,19,19,90,56,34
"2021","Newham 016C","E01003597",531,125,33,92,229,9,130,26,78,26,22,13,9,0,62,29,33,6,6,177,117,60
"2021","Newham 016D","E01003635",609,139,41,98,307,27,147,34,75,38,46,33,13,0,65,24,41,22,22,163,57,106
"2021","Newham 017A","E01003568",626,101,33,68,297,21,177,17,106,54,16,11,5,0,69,29,40,14,14,228,127,101
"2021","Newham 017B","E01003569",591,77,21,56,294,14,177,29,114,34,17,7,8,2,63,33,30,23,23,220,145,75
"2021","Newham 017C","E01003573",577,80,28,52,316,17,199,31,120,48,12,7,5,0,74,39,35,14,14,181,124,57
"2021","Newham 017D","E01003574",772,198,71,127,397,20,240,29,163,48,32,15,16,1,97,44,53,8,8,177,106,71
"2021","Newham 018A","E01003520",573,123,52,71,310,22,204,36,123,45,14,4,9,1,62,28,34,8,8,140,83,57
"2021","Newham 018B","E01003521",647,111,33,78,360,12,245,50,151,44,30,18,10,2,57,37,20,16,16,176,93,83
"2021","Newham 018C","E01003522",528,85,32,53,334,22,212,22,147,43,24,11,13,0,65,34,31,11,11,109,63,46
"2021","Newham 018D","E01003525",534,93,37,56,315,12,215,27,142,46,25,9,15,1,55,32,23,8,8,126,81,45
"2021","Newham 018E","E01003526",485,78,31,47,278,7,161,27,95,39,34,13,16,5,65,32,33,11,11,129,85,44
"2021","Newham 019A","E01003488",671,204,54,150,367,8,185,34,113,38,21,8,11,2,139,78,61,14,14,100,59,41
"2021","Newham 019B","E01003489",961,196,33,163,632,19,346,61,240,45,117,94,18,5,126,64,62,24,24,133,63,70
"2021","Newham 019C","E01003490",564,87,22,65,374,11,240,25,168,47,24,11,9,4,84,53,31,15,15,103,54,49
"2021","Newham 019D","E01003524",558,108,37,71,326,11,216,22,148,46,18,6,9,3,69,41,28,12,12,124,73,51
"2021","Newham 020A","E01003631",691,190,36,154,372,17,157,56,75,26,73,51,19,3,108,58,50,17,17,129,49,80
"2021","Newham 020B","E01003632",797,165,41,124,396,25,174,35,99,40,72,34,21,17,103,50,53,22,22,236,79,157
"2021","Newham 020C","E01003633",685,201,48,153,383,8,145,23,97,25,63,24,27,12,150,82,68,17,17,101,44,57
"2021","Newham 020D","E01003634",589,142,42,100,320,14,142,31,85,26,45,20,20,5,104,49,55,15,15,127,54,73
"2021","Newham 020E","E01003636",692,178,43,135,401,12,161,30,107,24,36,23,11,2,175,105,70,17,17,113,54,59
"2021","Newham 021A","E01003598",636,173,37,136,354,10,168,25,109,34,26,13,10,3,135,93,42,15,15,109,52,57
"2021","Newham 021B","E01003600",591,171,48,123,317,9,154,38,85,31,48,38,6,4,91,54,37,15,15,103,57,46
"2021","Newham 021C","E01003630",681,209,59,150,354,9,158,41,84,33,78,49,27,2,98,49,49,11,11,118,56,62
"2021","Newham 021D","E01003637",579,130,40,90,276,13,143,40,74,29,47,29,15,3,62,33,29,11,11,173,85,88
"2021","Newham 022A","E01003491",632,176,97,79,316,18,191,58,95,38,26,12,13,1,60,32,28,21,21,140,89,51
"2021","Newham 022B","E01003592",635,175,41,134,332,17,173,33,103,37,44,28,14,2,88,54,34,10,10,128,71,57
"2021","Newham 022C","E01003599",473,97,44,53,264,10,141,22,96,23,26,10,13,3,81,44,37,6,6,112,65,47
"2021","Newham 022E","E01034201",424,71,12,59,258,8,138,22,94,22,41,26,14,1,63,48,15,8,8,95,52,43
"2021","Newham 022F","E01034202",502,105,36,69,279,12,153,38,95,20,40,24,12,4,63,42,21,11,11,118,69,49
"2021","Newham 023A","E01003535",569,123,33,90,367,7,192,19,131,42,28,9,14,5,124,78,46,16,16,79,51,28
"2021","Newham 023B","E01003536",617,90,27,63,411,11,222,27,163,32,51,24,19,8,106,67,39,21,21,116,68,48
"2021","Newham 023C","E01003621",444,53,18,35,286,15,183,18,121,44,30,16,13,1,47,28,19,11,11,105,66,39
"2021","Newham 023D","E01003622",535,92,25,67,334,4,200,28,144,28,30,19,10,1,93,59,34,7,7,109,63,46
"2021","Newham 023E","E01003623",485,73,27,46,311,9,180,15,124,41,23,10,10,3,91,48,43,8,8,101,59,42
"2021","Newham 024A","E01003523",709,159,54,105,375,21,219,32,137,50,29,12,13,4,98,58,40,8,8,175,120,55
"2021","Newham 024B","E01003527",555,104,37,67,350,21,208,32,140,36,39,23,12,4,77,36,41,5,5,101,65,36
"2021","Newham 024C","E01003537",641,119,39,80,421,19,245,31,169,45,51,15,30,6,92,50,42,14,14,101,72,29
"2021","Newham 024D","E01003542",665,144,44,100,434,12,241,37,166,38,30,11,16,3,138,73,65,13,13,87,61,26
"2021","Newham 024E","E01003624",495,72,24,48,329,13,190,37,125,28,33,21,9,3,85,35,50,8,8,94,61,33
"2021","Newham 025A","E01003492",528,80,33,47,310,10,194,23,122,49,40,13,26,1,53,33,20,13,13,138,80,58
"2021","Newham 025C","E01003494",608,91,25,66,382,19,240,23,183,34,41,25,15,1,71,39,32,11,11,135,79,56
"2021","Newham 025D","E01003495",609,96,45,51,421,18,259,33,172,54,66,21,34,11,72,39,33,6,6,92,60,32
"2021","Newham 025E","E01034203",483,153,30,123,262,4,141,42,89,10,65,44,19,2,40,30,10,12,12,68,40,28
"2021","Newham 025F","E01034204",556,89,26,63,333,13,218,34,146,38,23,6,16,1,65,39,26,14,14,134,85,49
"2021","Newham 026A","E01003594",578,120,24,96,344,7,181,31,110,40,40,27,11,2,95,47,48,21,21,114,52,62
"2021","Newham 026B","E01003595",669,242,86,156,294,17,134,27,85,22,43,22,15,6,80,46,34,20,20,133,75,58
"2021","Newham 026C","E01003602",631,128,26,102,337,6,183,24,130,29,31,13,14,4,96,48,48,21,21,166,83,83
"2021","Newham 026D","E01003607",605,120,22,98,367,9,165,31,101,33,81,22,56,3,102,61,41,10,10,118,64,54
"2021","Newham 027A","E01003496",555,201,34,167,263,4,100,26,51,23,42,25,13,4,97,52,45,20,20,91,36,55
"2021","Newham 027B","E01003498",687,178,36,142,402,6,174,34,103,37,65,37,20,8,136,65,71,21,21,107,56,51
"2021","Newham 027C","E01003500",723,180,57,123,414,13,162,39,93,30,50,25,15,10,160,80,80,29,29,129,55,74
"2021","Newham 027D","E01003593",536,131,36,95,310,10,128,25,80,23,48,36,10,2,108,52,56,16,16,95,39,56
"2021","Newham 028A","E01003601",714,165,42,123,438,19,206,49,121,36,53,14,34,5,138,67,71,22,22,111,68,43
"2021","Newham 028B","E01003603",609,110,32,78,388,6,223,32,146,45,53,21,25,7,89,56,33,17,17,111,62,49
"2021","Newham 028C","E01003605",685,180,52,128,387,14,207,31,136,40,42,15,23,4,108,62,46,16,16,118,57,61
"2021","Newham 028D","E01003608",677,135,29,106,425,17,228,40,151,37,78,51,21,6,91,62,29,11,11,117,63,54
"2021","Newham 029A","E01003538",665,150,50,100,401,11,186,20,139,27,62,38,15,9,130,78,52,12,12,114,61,53
"2021","Newham 029B","E01003539",707,120,39,81,416,13,242,36,165,41,44,13,23,8,109,61,48,8,8,171,116,55
"2021","Newham 029C","E01003540",602,122,33,89,358,12,170,17,120,33,45,12,19,14,117,72,45,14,14,122,86,36
"2021","Newham 029D","E01003541",552,89,27,62,340,13,196,21,135,40,33,8,19,6,87,65,22,11,11,123,78,45
"2021","Newham 030A","E01003499",815,204,90,114,480,11,191,39,123,29,42,17,22,3,211,128,83,25,25,131,64,67
"2021","Newham 030B","E01003501",791,198,46,152,467,10,235,42,147,46,45,15,24,6,153,83,70,24,24,126,58,68
"2021","Newham 030C","E01003502",812,159,45,114,461,13,197,38,124,35,55,29,20,6,181,101,80,15,15,192,83,109
"2021","Newham 030D","E01003503",1155,357,42,315,600,10,245,99,116,30,163,139,21,3,142,88,54,40,40,198,61,137
"2021","Newham 031A","E01003507",832,260,67,193,428,14,214,57,120,37,50,27,20,3,132,66,66,18,18,144,66,78
"2021","Newham 031B","E01003508",963,254,38,216,547,13,211,68,108,35,124,90,27,7,177,113,64,22,22,162,76,86
"2021","Newham 031C","E01003509",777,209,63,146,453,14,157,45,83,29,62,19,38,5,203,154,49,17,17,115,50,65
"2021","Newham 031D","E01003604",752,160,46,114,465,14,224,33,154,37,66,26,32,8,148,91,57,13,13,127,58,69
"2021","Newham 032A","E01003483",600,160,58,102,342,10,161,39,80,42,51,31,15,5,113,60,53,7,7,98,51,47
"2021","Newham 032B","E01003484",555,109,21,88,306,7,148,22,102,24,53,24,26,3,84,56,28,14,14,140,79,61
"2021","Newham 032C","E01003516",651,164,46,118,386,5,143,28,85,30,50,18,22,10,177,108,69,11,11,101,58,43
"2021","Newham 032D","E01003518",571,106,24,82,366,16,179,42,109,28,58,31,25,2,100,56,44,13,13,99,57,42
"2021","Newham 032E","E01003519",494,107,29,78,246,16,111,24,57,30,36,23,13,0,72,39,33,11,11,141,69,72
"2021","Newham 033A","E01003480",585,151,48,103,338,16,163,27,91,45,51,25,23,3,101,54,47,7,7,96,44,52
"2021","Newham 033C","E01003486",442,140,65,75,247,13,81,18,38,25,19,4,10,5,124,55,69,10,10,55,40,15
"2021","Newham 033D","E01003487",412,90,18,72,247,10,115,19,72,24,32,11,14,7,79,41,38,11,11,75,51,24
"2021","Newham 033E","E01034205",559,125,24,101,352,1,185,48,113,24,53,23,27,3,96,61,35,17,17,82,44,38
"2021","Newham 033F","E01034206",677,176,3,173,417,19,176,48,110,18,110,89,19,2,97,71,26,15,15,84,26,58
"2021","Newham 033G","E01034207",715,217,5,212,417,3,214,80,123,11,133,114,18,1,46,39,7,21,21,81,14,67
"2021","Newham 034A","E01003497",588,138,49,89,358,27,137,29,73,35,44,15,20,9,124,63,61,26,26,92,40,52
"2021","Newham 034D","E01003506",480,119,40,79,271,3,117,14,68,35,27,10,12,5,108,55,53,16,16,90,31,59
"2021","Newham 034I","E01033584",562,111,32,79,377,15,152,29,89,34,38,17,17,4,159,72,87,13,13,74,38,36
"2021","Newham 034J","E01034208",665,194,63,131,365,9,160,42,94,24,44,13,26,5,143,80,63,9,9,106,51,55
"2021","Newham 034K","E01034209",683,191,4,187,366,1,182,95,75,12,117,110,7,0,35,22,13,31,31,126,13,113
"2021","Newham 034L","E01034210",708,237,41,196,345,7,164,72,83,9,96,79,16,1,52,24,28,26,26,126,21,105
"2021","Newham 034M","E01034211",748,231,3,228,378,0,164,109,48,7,153,139,14,0,18,7,11,43,43,139,5,134
"2021","Newham 034N","E01034212",1008,382,27,355,523,3,265,140,122,3,169,153,16,0,55,23,32,31,31,103,5,98
"2021","Newham 035A","E01003479",609,148,36,112,389,19,173,44,101,28,62,31,28,3,118,70,48,17,17,72,33,39
"2021","Newham 035B","E01003481",482,135,46,89,272,12,126,29,76,21,29,10,15,4,87,45,42,18,18,75,39,36
"2021","Newham 035C","E01003485",570,119,40,79,348,14,169,46,97,26,50,23,21,6,105,54,51,10,10,103,50,53
"2021","Newham 035D","E01003513",551,100,22,78,357,13,173,45,104,24,58,31,24,3,104,63,41,9,9,94,48,46
"2021","Newham 036A","E01003511",670,162,38,124,404,7,180,43,104,33,67,38,27,2,137,66,71,13,13,104,56,48
"2021","Newham 036B","E01003512",685,171,61,110,371,15,135,23,81,31,63,25,31,7,142,84,58,16,16,143,62,81
"2021","Newham 036C","E01003514",528,104,29,75,327,8,135,27,80,28,39,10,24,5,136,88,48,9,9,97,58,39
"2021","Newham 036D","E01003515",814,281,65,216,403,11,158,52,80,26,57,33,22,2,158,100,58,19,19,130,58,72
"2021","Newham 036E","E01003517",633,148,34,114,394,9,147,28,80,39,52,13,27,12,174,121,53,12,12,91,46,45
"2021","Newham 038A","E01034213",653,102,4,98,443,2,230,73,145,12,119,96,22,1,76,60,16,16,16,108,23,85
"2021","Newham 038B","E01034214",647,138,2,136,314,2,117,60,54,3,135,117,16,2,40,27,13,20,20,195,22,173
"2021","Newham 038C","E01034215",644,140,4,136,351,0,119,53,59,7,143,127,15,1,67,56,11,22,22,153,18,135
"2021","Newham 038D","E01034216",633,81,0,81,330,0,115,35,79,1,109,94,15,0,76,60,16,30,30,222,14,208
"2021","Newham 038E","E01034217",665,149,3,146,323,2,125,63,60,2,131,109,20,2,52,40,12,13,13,193,14,179
"2021","Newham 039A","E01003615",622,191,70,121,326,12,152,37,91,24,51,30,15,6,92,45,47,19,19,105,40,65
"2021","Newham 039B","E01034218",616,137,28,109,338,9,156,38,97,21,73,53,18,2,77,50,27,23,23,141,41,100
"2021","Newham 039C","E01034219",669,163,5,158,373,2,142,59,80,3,147,136,11,0,63,50,13,19,19,133,16,117
"2021","Newham 039D","E01034220",616,239,5,234,279,2,94,68,21,5,148,141,6,1,8,5,3,27,27,98,8,90
"2021","Newham 039E","E01034221",639,192,21,171,310,6,102,30,60,12,88,69,16,3,86,56,30,28,28,137,23,114
"2021","Newham 040C","E01033579",899,272,13,259,435,2,153,82,64,7,181,159,22,0,66,34,32,33,33,192,12,180
"2021","Newham 040D","E01033586",903,310,35,275,466,9,184,52,109,23,144,125,16,3,108,61,47,21,21,127,32,95
"2021","Newham 040A","E01034222",716,212,9,203,360,4,125,63,57,5,123,112,10,1,79,56,23,29,29,144,19,125
"2021","Newham 040B","E01034223",711,263,13,250,355,3,109,52,51,6,143,129,14,0,63,43,20,37,37,93,10,83
"2021","Newham 041C","E01003611",712,207,56,151,444,11,185,25,124,36,55,14,33,8,181,123,58,12,12,61,38,23
"2021","Newham 041A","E01033581",743,211,48,163,441,8,182,44,109,29,65,27,33,5,155,105,50,31,31,91,38,53
"2021","Newham 041B","E01033582",601,165,15,150,333,4,153,56,89,8,103,80,21,2,59,38,21,14,14,103,30,73
"2021","Newham 041D","E01034224",612,142,32,110,383,6,176,63,86,27,59,30,25,4,120,82,38,22,22,87,44,43
"2021","Newham 042A","E01033580",588,141,11,130,329,6,183,69,99,15,83,60,19,4,32,21,11,25,25,118,26,92
"2021","Newham 042B","E01034225",645,185,25,160,386,0,174,58,96,20,75,59,12,4,114,69,45,23,23,74,22,52
"2021","Newham 042C","E01034226",611,184,5,179,334,1,160,65,87,8,93,74,19,0,55,47,8,25,25,93,21,72
"2021","Newham 042D","E01034227",634,200,1,199,396,0,184,43,139,2,79,52,26,1,121,107,14,12,12,38,25,13
"2021","Newham 042E","E01034228",632,165,4,161,379,2,192,88,96,8,138,123,15,0,18,12,6,29,29,88,9,79
"2021","Newham 042F","E01034229",618,167,6,161,365,5,155,63,77,15,118,100,13,5,70,38,32,17,17,86,18,68
"2021","Newham 042G","E01034230",676,232,2,230,368,2,158,109,49,0,174,169,5,0,8,4,4,26,26,76,4,72
"2021","Newham 042H","E01034231",654,190,1,189,390,5,198,103,92,3,141,128,13,0,20,12,8,26,26,74,15,59
"2021","Redbridge 001A","E01003744",618,198,111,87,388,83,219,54,117,48,41,24,14,3,42,20,22,3,3,32,17,15
"2021","Redbridge 001B","E01003745",476,67,41,26,364,74,245,57,124,64,18,7,11,0,25,13,12,2,2,45,29,16
"2021","Redbridge 001C","E01003746",679,206,122,84,427,100,225,65,126,34,54,31,17,6,47,22,25,1,1,46,21,25
"2021","Redbridge 001D","E01003747",483,88,66,22,354,53,251,57,143,51,16,9,4,3,34,9,25,0,0,41,20,21
"2021","Redbridge 001E","E01003748",624,135,71,64,452,93,270,86,138,46,47,33,13,1,38,17,21,4,4,37,24,13
"2021","Redbridge 001F","E01003749",684,167,83,84,437,50,225,59,115,51,72,45,25,2,83,60,23,7,7,80,37,43
"2021","Redbridge 001G","E01003750",878,326,197,129,454,54,239,70,132,37,80,51,25,4,72,42,30,9,9,98,17,81
"2021","Redbridge 002A","E01003720",790,273,133,140,432,44,208,44,113,51,44,20,16,8,122,60,62,14,14,85,48,37
"2021","Redbridge 002B","E01003722",824,189,62,127,526,32,293,60,176,57,73,23,40,10,123,69,54,5,5,109,71,38
"2021","Redbridge 002C","E01003723",721,193,75,118,443,33,218,51,119,48,64,20,29,15,124,64,60,4,4,85,51,34
"2021","Redbridge 002D","E01003726",936,245,43,202,606,13,325,73,212,40,125,67,48,10,129,70,59,14,14,85,53,32
"2021","Redbridge 003A","E01003721",659,179,80,99,397,41,197,36,121,40,36,12,17,7,116,84,32,7,7,83,52,31
"2021","Redbridge 003B","E01003724",506,92,41,51,353,37,201,38,118,45,32,16,16,0,78,29,49,5,5,61,42,19
"2021","Redbridge 003C","E01003725",668,166,57,109,434,27,199,41,119,39,47,25,15,7,152,95,57,9,9,68,37,31
"2021","Redbridge 003D","E01003727",639,163,62,101,402,26,195,42,107,46,52,23,17,12,117,59,58,12,12,74,51,23
"2021","Redbridge 004A","E01003654",599,117,52,65,411,31,217,43,118,56,75,31,39,5,86,44,42,2,2,71,39,32
"2021","Redbridge 004B","E01003655",637,158,69,89,414,47,222,65,115,42,92,67,20,5,47,19,28,6,6,65,26,39
"2021","Redbridge 004C","E01003658",682,214,86,128,400,23,178,52,90,36,63,29,31,3,123,71,52,13,13,68,30,38
"2021","Redbridge 004D","E01003660",672,149,60,89,461,61,274,65,163,46,66,31,30,5,56,24,32,4,4,62,29,33
"2021","Redbridge 005A","E01003656",653,247,89,158,354,26,172,27,100,45,55,32,21,2,98,52,46,3,3,52,34,18
"2021","Redbridge 005B","E01003657",900,277,104,173,548,85,262,60,141,61,78,44,30,4,112,55,57,11,11,75,43,32
"2021","Redbridge 005C","E01003659",636,127,54,73,447,30,247,51,142,54,80,35,40,5,88,50,38,2,2,62,32,30
"2021","Redbridge 006A","E01003698",521,107,51,56,352,38,221,48,124,49,37,15,18,4,54,27,27,2,2,62,41,21
"2021","Redbridge 006B","E01003699",591,171,90,81,337,30,198,52,105,41,51,20,24,7,52,34,18,6,6,83,43,40
"2021","Redbridge 006C","E01003700",866,221,108,113,525,51,332,58,188,86,38,17,16,5,99,41,58,5,5,120,74,46
"2021","Redbridge 006D","E01003701",684,152,63,89,419,39,256,34,163,59,32,18,9,5,87,50,37,5,5,113,70,43
"2021","Redbridge 006E","E01003702",916,273,103,170,554,30,317,77,192,48,84,65,16,3,107,66,41,16,16,89,49,40
"2021","Redbridge 006F","E01003703",978,234,82,152,643,69,340,82,167,91,60,24,25,11,162,103,59,12,12,101,59,42
"2021","Redbridge 006G","E01003704",693,180,86,94,403,28,234,44,145,45,38,15,19,4,90,51,39,13,13,110,85,25
"2021","Redbridge 007A","E01003668",800,299,103,196,421,46,227,91,103,33,81,57,24,0,58,36,22,9,9,80,22,58
"2021","Redbridge 007B","E01003669",625,165,48,117,420,54,237,59,137,41,60,32,24,4,61,36,25,8,8,40,17,23
"2021","Redbridge 007C","E01003670",581,137,61,76,400,59,223,50,122,51,45,22,20,3,69,32,37,4,4,44,25,19
"2021","Redbridge 007D","E01003671",554,90,60,30,422,56,288,69,167,52,39,14,20,5,38,14,24,1,1,42,24,18
"2021","Redbridge 007E","E01003672",754,274,101,173,416,30,192,52,122,18,94,63,30,1,94,58,36,6,6,64,27,37
"2021","Redbridge 007F","E01003673",797,235,70,165,488,38,269,73,162,34,113,56,52,5,63,33,30,5,5,74,31,43
"2021","Redbridge 007G","E01003674",1063,355,99,256,604,26,329,84,198,47,134,101,30,3,99,75,24,16,16,104,29,75
"2021","Redbridge 008A","E01003707",488,87,44,43,331,40,219,33,113,73,17,5,8,4,52,27,25,3,3,70,37,33
"2021","Redbridge 008B","E01003708",754,228,56,172,436,14,242,40,161,41,35,19,15,1,138,83,55,7,7,90,60,30
"2021","Redbridge 008C","E01003709",571,105,63,42,391,58,248,42,143,63,27,9,13,5,56,25,31,2,2,75,48,27
"2021","Redbridge 008D","E01003710",505,128,83,45,276,36,181,31,82,68,16,7,7,2,41,13,28,2,2,101,61,40
"2021","Redbridge 009A","E01003759",556,104,62,42,400,54,271,53,158,60,44,20,18,6,26,12,14,5,5,52,28,24
"2021","Redbridge 009B","E01003760",672,131,45,86,454,40,251,59,137,55,62,39,21,2,94,53,41,7,7,87,48,39
"2021","Redbridge 009C","E01003761",683,192,47,145,443,5,213,42,131,40,38,13,19,6,182,128,54,5,5,48,29,19
"2021","Redbridge 009D","E01003762",652,157,64,93,445,35,261,66,155,40,71,38,29,4,73,39,34,5,5,50,23,27
"2021","Redbridge 009E","E01003763",661,122,73,49,440,56,268,42,163,63,41,11,23,7,69,34,35,6,6,99,56,43
"2021","Redbridge 009F","E01003764",857,238,82,156,539,28,279,79,168,32,122,71,47,4,99,60,39,11,11,80,28,52
"2021","Redbridge 009G","E01003765",740,179,43,136,491,34,275,61,171,43,87,61,23,3,83,55,28,12,12,70,27,43
"2021","Redbridge 010A","E01003705",822,170,67,103,536,47,348,66,210,72,35,18,14,3,97,59,38,9,9,116,63,53
"2021","Redbridge 010B","E01003706",622,158,72,86,404,47,228,42,132,54,29,15,14,0,98,64,34,2,2,60,39,21
"2021","Redbridge 010C","E01003711",636,148,76,72,419,51,250,38,158,54,20,5,11,4,93,43,50,5,5,69,39,30
"2021","Redbridge 010D","E01003712",543,160,88,72,319,20,140,18,80,42,33,15,14,4,122,49,73,4,4,64,47,17
"2021","Redbridge 012A","E01003646",602,143,70,73,347,34,234,40,129,65,24,16,8,0,46,21,25,9,9,112,58,54
"2021","Redbridge 012B","E01003648",517,115,88,27,330,54,209,44,99,66,21,8,8,5,43,20,23,3,3,72,48,24
"2021","Redbridge 012C","E01003649",513,79,50,29,352,43,241,41,128,72,11,6,2,3,50,29,21,7,7,82,49,33
"2021","Redbridge 012D","E01003651",476,99,72,27,288,47,201,33,101,67,4,2,2,0,32,13,19,4,4,89,44,45
"2021","Redbridge 013A","E01003639",788,206,103,103,479,42,297,43,202,52,43,19,22,2,90,50,40,7,7,103,70,33
"2021","Redbridge 013B","E01003640",623,126,51,75,407,40,280,47,172,61,22,13,6,3,58,37,21,7,7,90,59,31
"2021","Redbridge 013C","E01003641",610,77,39,38,440,26,314,45,123,146,23,7,13,3,72,31,41,5,5,93,62,31
"2021","Redbridge 013D","E01003642",556,97,43,54,375,24,224,27,125,72,36,14,14,8,81,36,45,10,10,84,51,33
"2021","Redbridge 014A","E01003774",853,288,108,180,518,38,261,54,178,29,132,92,35,5,83,42,41,4,4,47,15,32
"2021","Redbridge 014B","E01003775",640,173,75,98,383,60,196,50,106,40,55,40,15,0,61,33,28,11,11,84,42,42
"2021","Redbridge 014C","E01003776",900,442,247,195,401,38,169,71,79,19,97,76,16,5,83,48,35,14,14,57,25,32
"2021","Redbridge 014D","E01003777",846,312,103,209,469,25,229,96,107,26,144,114,27,3,51,25,26,20,20,65,21,44
"2021","Redbridge 014E","E01003778",899,316,133,183,511,41,262,89,142,31,146,118,25,3,50,32,18,12,12,72,17,55
"2021","Redbridge 014F","E01003779",719,253,142,111,432,43,257,106,119,32,73,48,20,5,54,38,16,5,5,34,8,26
"2021","Redbridge 014G","E01003780",508,63,44,19,379,70,255,53,128,74,15,7,6,2,39,14,25,0,0,66,29,37
"2021","Redbridge 015A","E01003647",633,97,37,60,427,29,283,56,160,67,16,10,6,0,87,44,43,12,12,109,61,48
"2021","Redbridge 015B","E01003650",590,129,71,58,382,42,245,32,141,72,15,5,7,3,75,36,39,5,5,79,47,32
"2021","Redbridge 015C","E01003652",478,75,40,35,317,26,236,43,128,65,13,3,6,4,36,19,17,6,6,86,57,29
"2021","Redbridge 015D","E01003653",723,189,40,149,415,20,244,37,149,58,26,14,10,2,119,95,24,6,6,119,82,37
"2021","Redbridge 017A","E01003638",662,186,109,77,392,41,267,47,157,63,22,11,8,3,55,19,36,7,7,84,52,32
"2021","Redbridge 017B","E01003643",704,156,104,52,435,39,306,42,195,69,21,10,6,5,64,29,35,5,5,113,70,43
"2021","Redbridge 017C","E01003644",501,80,43,37,342,44,223,32,129,62,13,6,6,1,59,23,36,3,3,79,51,28
"2021","Redbridge 017D","E01003645",906,166,41,125,641,28,435,68,305,62,65,43,20,2,104,59,45,9,9,99,62,37
"2021","Redbridge 018A","E01003789",588,169,72,97,371,49,189,46,103,40,85,73,10,2,43,25,18,5,5,48,21,27
"2021","Redbridge 018B","E01003794",580,150,98,52,380,42,237,40,158,39,37,18,18,1,62,28,34,2,2,50,24,26
"2021","Redbridge 018C","E01003795",433,74,42,32,322,57,206,45,123,38,29,16,13,0,29,12,17,1,1,37,19,18
"2021","Redbridge 018D","E01003796",605,141,65,76,413,50,243,51,141,51,48,30,15,3,67,28,39,5,5,51,19,32
"2021","Redbridge 020A","E01003751",673,128,44,84,397,31,262,36,155,71,25,11,11,3,73,45,28,6,6,148,101,47
"2021","Redbridge 020B","E01003753",626,124,49,75,415,24,294,39,185,70,26,7,18,1,62,37,25,9,9,87,53,34
"2021","Redbridge 020C","E01003754",556,128,75,53,327,38,200,31,100,69,12,8,4,0,67,25,42,10,10,101,62,39
"2021","Redbridge 020D","E01003757",640,146,41,105,369,20,236,32,144,60,23,7,15,1,81,49,32,9,9,125,86,39
"2021","Redbridge 022A","E01003769",584,126,26,100,355,17,220,35,151,34,29,17,12,0,75,51,24,14,14,103,56,47
"2021","Redbridge 022B","E01003770",877,208,37,171,522,23,358,42,243,73,30,10,17,3,102,65,37,9,9,147,104,43
"2021","Redbridge 022C","E01003771",525,94,35,59,331,17,204,28,121,55,24,8,12,4,76,43,33,10,10,100,61,39
"2021","Redbridge 022D","E01003773",557,98,46,52,366,28,251,48,162,41,24,10,11,3,54,29,25,9,9,93,61,32
"2021","Redbridge 023A","E01003752",823,139,43,96,535,44,382,86,221,75,22,13,6,3,74,32,42,13,13,149,96,53
"2021","Redbridge 023B","E01003755",661,79,30,49,468,28,339,33,205,101,21,8,10,3,76,43,33,4,4,114,80,34
"2021","Redbridge 023C","E01003756",755,149,51,98,474,29,300,35,189,76,24,9,10,5,112,71,41,9,9,132,83,49
"2021","Redbridge 023E","E01034480",410,56,9,47,309,11,194,21,151,22,19,7,11,1,80,60,20,5,5,45,15,30
"2021","Redbridge 023F","E01034481",466,63,20,43,330,7,187,18,131,38,20,9,11,0,103,50,53,13,13,73,35,38
"2021","Redbridge 024A","E01003766",624,103,41,62,395,19,275,28,183,64,35,9,24,2,56,27,29,10,10,126,72,54
"2021","Redbridge 024B","E01003767",662,119,54,65,411,12,226,28,161,37,40,12,25,3,117,79,38,16,16,132,81,51
"2021","Redbridge 024C","E01003768",653,186,47,139,359,18,208,33,124,51,44,18,26,0,79,57,22,10,10,108,70,38
"2021","Redbridge 024D","E01003772",524,79,31,48,349,29,228,30,140,58,18,5,10,3,69,29,40,5,5,96,57,39
"2021","Redbridge 026A","E01003781",653,150,28,122,417,16,268,69,164,35,34,19,9,6,86,53,33,13,13,86,50,36
"2021","Redbridge 026B","E01003782",482,79,27,52,312,13,218,22,148,48,19,8,9,2,55,39,16,7,7,91,62,29
"2021","Redbridge 026C","E01003786",455,62,22,40,309,23,215,23,135,57,20,6,11,3,48,19,29,3,3,84,48,36
"2021","Redbridge 026D","E01003787",491,112,39,73,291,23,200,28,124,48,17,10,5,2,41,24,17,10,10,88,58,30
"2021","Redbridge 027A","E01003790",546,136,65,71,372,41,216,52,125,39,54,21,31,2,57,24,33,4,4,38,26,12
"2021","Redbridge 027B","E01003791",540,102,59,43,390,67,217,54,112,51,51,21,26,4,48,18,30,7,7,48,29,19
"2021","Redbridge 027C","E01003792",503,102,43,59,353,32,237,57,126,54,44,16,20,8,39,17,22,1,1,48,20,28
"2021","Redbridge 027D","E01003793",734,291,120,171,408,21,189,57,99,33,93,52,36,5,97,64,33,8,8,35,15,20
"2021","Redbridge 029A","E01003783",885,244,83,161,531,19,301,56,207,38,49,21,27,1,132,94,38,30,30,110,64,46
"2021","Redbridge 029B","E01003784",593,100,25,75,361,30,236,49,133,54,21,11,7,3,64,37,27,10,10,132,76,56
"2021","Redbridge 029C","E01003785",670,166,32,134,373,14,241,60,148,33,36,20,15,1,75,55,20,7,7,131,74,57
"2021","Redbridge 029D","E01003788",633,159,32,127,400,13,244,49,166,29,44,24,20,0,92,63,29,7,7,74,44,30
"2021","Redbridge 031A","E01003737",668,113,63,50,374,53,241,38,135,68,13,5,7,1,62,41,21,5,5,181,134,47
"2021","Redbridge 031B","E01003738",654,95,53,42,412,34,277,30,170,77,14,0,12,2,78,33,45,9,9,147,91,56
"2021","Redbridge 031C","E01003739",673,131,62,69,413,22,287,27,184,76,25,10,8,7,74,43,31,5,5,129,85,44
"2021","Redbridge 031D","E01003740",616,102,49,53,368,24,246,41,143,62,22,7,8,7,59,27,32,17,17,146,87,59
"2021","Redbridge 031E","E01003741",667,164,96,68,419,40,240,49,139,52,27,13,10,4,107,72,35,5,5,84,61,23
"2021","Redbridge 031F","E01003742",643,95,35,60,386,15,272,33,184,55,18,6,11,1,68,36,32,13,13,162,104,58
"2021","Redbridge 031G","E01003743",517,76,36,40,321,30,194,18,126,50,11,3,8,0,72,39,33,14,14,120,78,42
"2021","Redbridge 032B","E01003729",496,99,40,59,291,11,193,26,130,37,18,9,8,1,61,33,28,8,8,106,63,43
"2021","Redbridge 032C","E01003730",457,49,13,36,299,11,206,25,130,51,15,5,9,1,55,33,22,12,12,109,73,36
"2021","Redbridge 032D","E01003732",632,146,14,132,434,5,208,27,155,26,53,24,24,5,150,113,37,18,18,52,31,21
"2021","Redbridge 032E","E01003733",492,67,24,43,321,6,207,28,128,51,24,9,9,6,66,40,26,18,18,104,69,35
"2021","Redbridge 032F","E01034482",429,104,2,102,286,0,188,40,140,8,41,28,13,0,51,44,7,6,6,39,14,25
"2021","Redbridge 032G","E01034483",542,136,6,130,372,1,185,33,143,9,45,30,14,1,134,113,21,7,7,34,10,24
"2021","Redbridge 032H","E01034484",533,128,50,78,306,16,198,27,128,43,20,8,11,1,65,46,19,7,7,99,61,38
"2021","Redbridge 033A","E01003731",418,92,29,63,250,6,155,20,98,37,14,5,9,0,64,37,27,11,11,76,46,30
"2021","Redbridge 033B","E01003734",500,93,32,61,287,19,179,18,117,44,16,3,9,4,62,38,24,11,11,120,85,35
"2021","Redbridge 033C","E01003735",705,179,86,93,435,3,193,30,130,33,29,10,15,4,176,104,72,34,34,91,64,27
"2021","Redbridge 033D","E01003736",492,52,15,37,299,5,186,19,128,39,23,7,15,1,76,43,33,9,9,141,110,31
"2021","Redbridge 034A","E01003713",492,74,32,42,279,25,186,32,109,45,13,5,6,2,47,20,27,8,8,139,91,48
"2021","Redbridge 034B","E01003714",684,116,47,69,416,11,303,32,202,69,26,9,14,3,67,32,35,9,9,152,103,49
"2021","Redbridge 034C","E01003715",627,102,33,69,339,12,227,29,134,64,26,11,12,3,66,33,33,8,8,186,91,95
"2021","Redbridge 034D","E01003716",593,178,65,113,310,29,198,36,110,52,19,10,6,3,55,24,31,9,9,105,62,43
"2021","Redbridge 034E","E01003718",659,129,26,103,450,12,302,53,210,39,35,20,14,1,90,66,24,11,11,80,47,33
"2021","Redbridge 034F","E01003719",720,142,44,98,429,16,275,42,177,56,44,10,16,18,85,63,22,9,9,149,91,58
"2021","Redbridge 034G","E01032581",743,237,65,172,432,12,227,47,145,35,61,27,29,5,122,86,36,10,10,74,42,32
"2021","Redbridge 035A","E01003690",748,188,61,127,463,26,295,67,180,48,55,33,21,1,73,44,29,14,14,97,46,51
"2021","Redbridge 035B","E01003691",459,70,32,38,292,17,173,18,106,49,10,5,3,2,83,27,56,9,9,97,58,39
"2021","Redbridge 035C","E01003692",474,78,35,43,295,25,199,30,126,43,20,11,7,2,49,23,26,2,2,101,58,43
"2021","Redbridge 035D","E01003693",444,54,22,32,268,32,178,24,96,58,11,6,4,1,41,12,29,6,6,122,85,37
"2021","Redbridge 035E","E01003694",446,91,58,33,264,35,172,24,84,64,4,1,2,1,46,24,22,7,7,91,52,39
"2021","Redbridge 035F","E01003695",494,117,34,83,293,20,185,42,101,42,25,18,5,2,50,27,23,13,13,84,50,34
"2021","Redbridge 035G","E01003696",522,109,54,55,292,36,197,24,111,62,8,3,2,3,47,22,25,4,4,121,53,68
"2021","Redbridge 035H","E01003697",508,96,35,61,296,26,203,31,127,45,21,9,7,5,40,19,21,6,6,116,65,51
"2021","Redbridge 036A","E01003675",502,76,33,43,305,39,200,37,101,62,15,11,4,0,44,24,20,7,7,121,71,50
"2021","Redbridge 036B","E01003676",520,77,36,41,306,34,210,22,124,64,13,6,4,3,46,29,17,3,3,137,81,56
"2021","Redbridge 036C","E01003677",525,87,46,41,351,54,236,22,124,90,15,7,3,5,42,15,27,4,4,87,52,35
"2021","Redbridge 036D","E01003678",474,45,21,24,348,51,225,29,115,81,16,3,10,3,53,24,29,3,3,81,51,30
"2021","Redbridge 036E","E01003679",494,56,33,23,344,34,250,31,136,83,13,5,5,3,45,15,30,2,2,94,61,33
"2021","Redbridge 036F","E01003680",484,54,36,18,344,44,234,32,123,79,10,3,6,1,50,19,31,6,6,86,60,26
"2021","Redbridge 036G","E01003681",678,167,107,60,411,46,237,30,127,80,17,6,8,3,102,76,26,9,9,100,52,48
"2021","Redbridge 036H","E01003682",510,53,31,22,356,32,272,48,140,84,9,2,4,3,40,15,25,3,3,101,63,38
"2021","Redbridge 037A","E01003663",640,168,123,45,392,47,256,42,165,49,20,4,12,4,65,30,35,4,4,80,54,26
"2021","Redbridge 037B","E01003664",562,93,41,52,393,33,258,26,178,54,34,11,17,6,60,34,26,8,8,76,49,27
"2021","Redbridge 037E","E01003665",513,80,46,34,345,32,231,24,144,63,19,5,10,4,54,22,32,9,9,88,53,35
"2021","Redbridge 037C","E01033590",417,76,11,65,297,5,143,22,109,12,24,7,15,2,120,102,18,5,5,44,24,20
"2021","Redbridge 037D","E01033592",626,109,44,65,432,28,273,52,165,56,20,6,12,2,100,54,46,11,11,85,60,25
"2021","Redbridge 038A","E01003661",696,149,60,89,455,29,287,39,188,60,34,10,20,4,92,57,35,13,13,92,56,36
"2021","Redbridge 038C","E01003662",761,216,50,166,447,13,282,60,177,45,54,27,22,5,85,51,34,13,13,98,53,45
"2021","Redbridge 038B","E01003666",1067,292,56,236,688,6,361,67,252,42,72,25,38,9,238,183,55,11,11,87,50,37
"2021","Redbridge 039C","E01003689",728,181,77,104,416,18,301,70,188,43,25,12,8,5,57,35,22,15,15,131,69,62
"2021","Redbridge 039B","E01033589",666,160,5,155,437,1,351,38,306,7,29,15,14,0,48,31,17,8,8,69,35,34
"2021","Redbridge 039A","E01033591",1014,274,76,198,612,8,423,79,297,47,67,30,34,3,104,72,32,10,10,128,77,51
"2021","Redbridge 040C","E01003683",572,69,34,35,365,22,229,17,161,51,31,8,19,4,71,42,29,12,12,138,88,50
"2021","Redbridge 040E","E01003684",503,84,30,54,324,12,215,18,131,66,20,3,15,2,65,33,32,12,12,95,65,30
"2021","Redbridge 040D","E01003685",546,102,27,75,307,17,214,19,128,67,11,5,4,2,59,27,32,6,6,137,75,62
"2021","Redbridge 040A","E01003686",577,122,40,82,326,24,205,26,117,62,18,7,8,3,71,37,34,8,8,129,95,34
"2021","Redbridge 040B","E01003688",525,85,21,64,312,23,169,28,105,36,14,6,8,0,97,66,31,9,9,128,89,39
"2021","Richmond upon Thames 001A","E01003797",515,105,82,23,387,80,256,57,155,44,19,8,10,1,31,19,12,1,1,23,11,12
"2021","Richmond upon Thames 001B","E01003798",649,242,112,130,372,65,209,77,106,26,44,31,13,0,50,33,17,4,4,35,15,20
"2021","Richmond upon Thames 001C","E01003799",641,169,70,99,422,62,252,65,146,41,68,44,20,4,35,19,16,5,5,50,11,39
"2021","Richmond upon Thames 001D","E01003800",604,166,81,85,388,40,207,49,116,42,46,22,20,4,91,42,49,4,4,50,19,31
"2021","Richmond upon Thames 001E","E01003801",541,174,74,100,324,46,195,60,116,19,52,43,8,1,27,17,10,4,4,43,10,33
"2021","Richmond upon Thames 001F","E01003802",627,209,96,113,388,51,236,70,134,32,46,33,12,1,45,29,16,10,10,30,7,23
"2021","Richmond upon Thames 001G","E01003803",607,175,72,103,373,24,182,36,106,40,53,22,15,16,108,58,50,6,6,59,17,42
"2021","Richmond upon Thames 002A","E01003846",615,114,67,47,451,69,308,70,181,57,37,16,13,8,35,16,19,2,2,50,24,26
"2021","Richmond upon Thames 002B","E01003847",831,323,132,191,456,43,259,111,121,27,111,90,17,4,39,20,19,4,4,52,10,42
"2021","Richmond upon Thames 002C","E01003849",641,208,87,121,398,55,248,66,139,43,53,35,18,0,40,20,20,2,2,35,13,22
"2021","Richmond upon Thames 002D","E01003851",656,175,92,83,444,76,281,78,155,48,56,42,13,1,30,14,16,1,1,37,17,20
"2021","Richmond upon Thames 002E","E01003860",778,230,64,166,495,53,267,101,139,27,131,112,18,1,35,19,16,9,9,53,16,37
"2021","Richmond upon Thames 002F","E01003864",644,198,91,107,415,54,243,74,144,25,73,56,16,1,41,22,19,4,4,31,13,18
"2021","Richmond upon Thames 003A","E01003852",657,265,112,153,335,40,190,63,104,23,57,45,12,0,40,20,20,8,8,57,7,50
"2021","Richmond upon Thames 003B","E01003853",594,178,100,78,375,68,214,61,123,30,32,18,12,2,57,32,25,4,4,41,17,24
"2021","Richmond upon Thames 003C","E01003854",637,218,78,140,375,39,194,71,111,12,80,55,20,5,58,33,25,4,4,44,12,32
"2021","Richmond upon Thames 003D","E01003855",895,328,105,223,496,37,208,63,118,27,102,74,25,3,142,89,53,7,7,71,18,53
"2021","Richmond upon Thames 003E","E01003856",738,232,71,161,454,20,241,72,157,12,108,79,29,0,80,56,24,5,5,52,18,34
"2021","Richmond upon Thames 003F","E01003857",750,193,89,104,508,29,323,79,224,20,93,60,32,1,60,38,22,3,3,49,18,31
"2021","Richmond upon Thames 003G","E01003858",665,174,78,96,465,45,300,73,203,24,85,58,27,0,34,25,9,1,1,26,13,13
"2021","Richmond upon Thames 004A","E01003848",816,231,70,161,537,27,294,88,178,28,126,95,27,4,82,40,42,8,8,48,22,26
"2021","Richmond upon Thames 004C","E01003861",889,284,91,193,551,19,317,114,178,25,146,124,21,1,57,34,23,12,12,54,13,41
"2021","Richmond upon Thames 004D","E01003862",809,240,87,153,514,29,263,68,154,41,93,62,28,3,121,82,39,8,8,55,24,31
"2021","Richmond upon Thames 004E","E01003863",623,231,138,93,355,41,209,43,138,28,52,34,15,3,47,31,16,6,6,37,15,22
"2021","Richmond upon Thames 004F","E01003865",590,164,60,104,381,33,199,48,121,30,64,42,19,3,78,46,32,7,7,45,17,28
"2021","Richmond upon Thames 004G","E01033570",835,251,46,205,542,29,308,112,178,18,105,77,24,4,92,73,19,8,8,42,19,23
"2021","Richmond upon Thames 004H","E01033571",605,174,67,107,385,48,229,42,130,57,38,26,8,4,65,33,32,5,5,46,17,29
"2021","Richmond upon Thames 005A","E01003804",753,207,83,124,504,46,314,64,215,35,75,44,26,5,65,40,25,4,4,42,18,24
"2021","Richmond upon Thames 005B","E01003807",839,290,96,194,474,41,276,71,183,22,91,63,25,3,61,36,25,5,5,75,24,51
"2021","Richmond upon Thames 005C","E01003808",783,230,117,113,518,37,326,76,225,25,90,62,25,3,59,34,25,6,6,35,14,21
"2021","Richmond upon Thames 005D","E01003809",637,135,74,61,458,93,308,66,189,53,20,9,9,2,36,20,16,1,1,44,20,24
"2021","Richmond upon Thames 005E","E01003859",607,138,72,66,439,52,291,65,191,35,43,20,23,0,48,29,19,5,5,30,15,15
"2021","Richmond upon Thames 006A","E01003873",795,332,122,210,427,37,243,97,128,18,98,83,14,1,42,28,14,7,7,36,13,23
"2021","Richmond upon Thames 006B","E01003874",768,304,93,211,438,30,239,96,131,12,137,114,23,0,28,21,7,4,4,26,6,20
"2021","Richmond upon Thames 006C","E01003875",647,167,86,81,439,58,288,59,184,45,36,16,16,4,51,32,19,6,6,41,20,21
"2021","Richmond upon Thames 006D","E01003878",628,229,103,126,331,42,183,60,92,31,47,30,15,2,53,30,23,6,6,68,20,48
"2021","Richmond upon Thames 007A","E01003866",670,167,60,107,483,38,316,75,211,30,84,54,28,2,41,19,22,4,4,20,8,12
"2021","Richmond upon Thames 007B","E01003868",656,189,60,129,421,40,247,67,157,23,95,66,26,3,35,22,13,4,4,46,11,35
"2021","Richmond upon Thames 007C","E01003871",696,172,59,113,490,45,298,82,181,35,72,41,26,5,73,49,24,2,2,34,16,18
"2021","Richmond upon Thames 007D","E01003872",683,211,57,154,421,28,228,68,134,26,99,76,21,2,53,31,22,13,13,51,14,37
"2021","Richmond upon Thames 008A","E01003821",765,266,92,174,462,39,284,100,169,15,82,57,22,3,52,33,19,5,5,37,11,26
"2021","Richmond upon Thames 008B","E01003876",941,368,122,246,516,64,245,111,107,27,160,132,24,4,42,24,18,5,5,57,13,44
"2021","Richmond upon Thames 008C","E01003877",684,258,120,138,396,45,238,74,146,18,78,60,18,0,26,15,11,9,9,30,10,20
"2021","Richmond upon Thames 008D","E01003879",577,164,63,101,389,36,241,64,151,26,74,61,12,1,35,26,9,3,3,24,8,16
"2021","Richmond upon Thames 009A","E01003892",890,287,134,153,562,77,334,95,209,30,92,65,26,1,56,36,20,3,3,41,14,27
"2021","Richmond upon Thames 009B","E01003893",752,293,104,189,416,45,229,74,128,27,100,80,14,6,35,19,16,7,7,43,7,36
"2021","Richmond upon Thames 009C","E01003894",737,243,84,159,455,40,270,82,156,32,105,88,15,2,36,19,17,4,4,39,12,27
"2021","Richmond upon Thames 009D","E01003895",720,217,76,141,459,51,260,65,160,35,70,44,25,1,76,54,22,2,2,44,16,28
"2021","Richmond upon Thames 010A","E01003905",532,152,72,80,336,35,178,57,94,27,59,38,19,2,59,29,30,5,5,44,14,30
"2021","Richmond upon Thames 010B","E01003906",652,179,83,96,406,37,219,48,132,39,67,37,28,2,72,37,35,11,11,67,22,45
"2021","Richmond upon Thames 010C","E01003907",646,177,77,100,413,44,205,48,113,44,58,24,25,9,97,52,45,9,9,56,24,32
"2021","Richmond upon Thames 010D","E01003908",663,150,93,57,445,62,287,75,147,65,37,19,18,0,53,18,35,6,6,68,27,41
"2021","Richmond upon Thames 010E","E01003909",636,156,85,71,424,61,243,52,130,61,55,31,20,4,56,33,23,9,9,56,22,34
"2021","Richmond upon Thames 011A","E01003867",596,139,53,86,409,38,258,57,150,51,53,32,17,4,52,27,25,8,8,48,16,32
"2021","Richmond upon Thames 011B","E01003869",687,182,79,103,458,36,268,77,157,34,101,81,15,5,47,39,8,6,6,47,12,35
"2021","Richmond upon Thames 011C","E01003870",817,186,62,124,579,39,377,96,231,50,109,69,36,4,45,31,14,9,9,52,16,36
"2021","Richmond upon Thames 011D","E01003910",661,164,111,53,455,69,282,65,166,51,56,30,23,3,46,21,25,2,2,42,16,26
"2021","Richmond upon Thames 012A","E01003805",599,90,64,26,475,108,313,49,216,48,28,5,17,6,25,12,13,1,1,34,15,19
"2021","Richmond upon Thames 012B","E01003806",511,91,52,39,397,75,282,60,166,56,18,8,9,1,22,15,7,0,0,23,12,11
"2021","Richmond upon Thames 012C","E01003816",617,126,83,43,443,62,285,50,198,37,34,16,12,6,60,31,29,2,2,48,22,26
"2021","Richmond upon Thames 012D","E01003817",859,320,168,152,479,71,265,64,174,27,66,43,19,4,75,45,30,2,2,60,27,33
"2021","Richmond upon Thames 013A","E01003840",586,106,50,56,385,36,245,39,145,61,41,17,21,3,60,26,34,3,3,95,56,39
"2021","Richmond upon Thames 013B","E01003841",820,245,84,161,501,25,239,59,144,36,79,24,45,10,153,100,53,5,5,74,41,33
"2021","Richmond upon Thames 013C","E01003842",607,111,57,54,428,40,233,41,137,55,52,19,27,6,97,52,45,6,6,68,31,37
"2021","Richmond upon Thames 013D","E01003843",798,199,99,100,508,70,271,47,144,80,29,11,17,1,130,73,57,8,8,91,50,41
"2021","Richmond upon Thames 013E","E01003844",547,127,71,56,380,73,239,58,126,55,20,11,7,2,46,24,22,2,2,40,16,24
"2021","Richmond upon Thames 013F","E01003845",623,137,95,42,426,71,266,56,129,81,51,17,27,7,37,15,22,1,1,60,31,29
"2021","Richmond upon Thames 014A","E01003882",849,262,101,161,537,46,327,97,198,32,120,80,39,1,36,25,11,8,8,50,13,37
"2021","Richmond upon Thames 014B","E01003883",877,264,93,171,584,31,317,82,216,19,154,106,45,3,74,54,20,8,8,29,7,22
"2021","Richmond upon Thames 014C","E01003896",880,329,93,236,475,38,251,91,136,24,120,107,13,0,57,38,19,9,9,76,15,61
"2021","Richmond upon Thames 014D","E01003897",873,309,93,216,517,19,272,82,166,24,149,119,29,1,65,36,29,12,12,47,14,33
"2021","Richmond upon Thames 015A","E01003898",732,231,69,162,472,29,243,79,145,19,123,90,32,1,73,50,23,4,4,29,8,21
"2021","Richmond upon Thames 015B","E01003899",621,176,66,110,416,36,229,60,151,18,84,52,30,2,65,48,17,2,2,29,13,16
"2021","Richmond upon Thames 015C","E01003900",621,137,76,61,411,33,222,43,135,44,55,26,23,6,91,41,50,10,10,73,29,44
"2021","Richmond upon Thames 015D","E01003901",611,88,54,34,473,27,316,61,214,41,74,28,41,5,54,31,23,2,2,50,19,31
"2021","Richmond upon Thames 015E","E01003902",499,103,66,37,363,40,232,41,161,30,36,11,23,2,50,24,26,5,5,33,15,18
"2021","Richmond upon Thames 015F","E01003903",585,94,46,48,437,54,247,51,155,41,47,20,23,4,88,50,38,1,1,54,21,33
"2021","Richmond upon Thames 015G","E01003904",653,183,74,109,435,26,245,58,171,16,84,40,42,2,72,42,30,8,8,35,10,25
"2021","Richmond upon Thames 016A","E01003880",581,122,45,77,413,54,261,59,165,37,58,35,19,4,37,22,15,3,3,46,25,21
"2021","Richmond upon Thames 016B","E01003881",476,154,70,84,297,48,170,43,101,26,44,33,8,3,31,14,17,4,4,25,10,15
"2021","Richmond upon Thames 016C","E01003884",739,237,119,118,460,71,254,66,153,35,71,48,20,3,58,32,26,6,6,42,11,31
"2021","Richmond upon Thames 016D","E01003885",644,169,73,96,420,48,232,64,132,36,84,56,22,6,55,36,19,1,1,55,10,45
"2021","Richmond upon Thames 017A","E01003818",665,204,111,93,422,57,224,51,148,25,51,19,29,3,86,52,34,4,4,39,15,24
"2021","Richmond upon Thames 017B","E01003819",728,243,98,145,425,28,203,48,120,35,57,25,26,6,133,75,58,4,4,60,27,33
"2021","Richmond upon Thames 017C","E01003820",757,190,92,98,516,43,293,64,181,48,62,21,36,5,113,76,37,5,5,51,27,24
"2021","Richmond upon Thames 018A","E01003811",718,181,65,116,514,34,323,71,220,32,81,41,36,4,73,51,22,3,3,23,8,15
"2021","Richmond upon Thames 018B","E01003812",749,191,60,131,516,33,296,67,189,40,114,80,30,4,64,38,26,9,9,42,15,27
"2021","Richmond upon Thames 018C","E01003890",690,204,79,125,453,55,271,63,171,37,79,52,26,1,42,26,16,6,6,33,12,21
"2021","Richmond upon Thames 018D","E01003891",857,326,150,176,510,97,268,99,132,37,84,66,18,0,53,32,21,8,8,21,4,17
"2021","Richmond upon Thames 019A","E01003810",620,146,52,94,441,48,292,62,175,55,49,32,14,3,50,35,15,2,2,33,13,20
"2021","Richmond upon Thames 019B","E01003813",621,141,83,58,453,84,288,65,162,61,39,19,18,2,41,25,16,1,1,27,9,18
"2021","Richmond upon Thames 019C","E01003814",797,287,102,185,464,50,255,91,125,39,104,77,25,2,51,29,22,4,4,46,12,34
"2021","Richmond upon Thames 019D","E01003815",934,341,165,176,543,57,261,82,150,29,125,87,34,4,89,67,22,11,11,50,15,35
"2021","Richmond upon Thames 020A","E01003828",617,149,86,63,434,104,244,64,136,44,32,12,16,4,52,32,20,2,2,34,14,20
"2021","Richmond upon Thames 020B","E01003829",698,246,113,133,388,32,203,35,112,56,50,19,21,10,97,65,32,6,6,64,33,31
"2021","Richmond upon Thames 020C","E01003830",751,203,87,116,496,65,293,78,165,50,63,32,27,4,73,43,30,2,2,52,21,31
"2021","Richmond upon Thames 020D","E01003831",687,188,95,93,458,57,244,65,133,46,71,29,35,7,81,55,26,5,5,41,19,22
"2021","Richmond upon Thames 020E","E01003832",680,282,105,177,358,30,131,38,66,27,83,47,27,9,112,61,51,2,2,40,21,19
"2021","Richmond upon Thames 020F","E01003833",666,237,91,146,385,40,189,63,88,38,74,44,26,4,77,49,28,5,5,44,13,31
"2021","Richmond upon Thames 021A","E01003886",671,175,59,116,453,48,276,77,156,43,80,53,25,2,46,31,15,3,3,43,15,28
"2021","Richmond upon Thames 021B","E01003887",804,262,107,155,503,44,299,110,160,29,115,86,28,1,41,26,15,4,4,39,4,35
"2021","Richmond upon Thames 021C","E01003888",937,382,158,224,491,38,253,77,145,31,100,63,32,5,97,57,40,3,3,64,16,48
"2021","Richmond upon Thames 021D","E01003889",752,249,107,142,475,84,263,91,135,37,81,59,21,1,42,22,20,5,5,28,13,15
"2021","Richmond upon Thames 022A","E01003834",783,289,82,207,456,59,214,88,93,33,110,87,22,1,66,43,23,7,7,38,11,27
"2021","Richmond upon Thames 022B","E01003835",595,110,40,70,456,60,311,67,199,45,42,22,19,1,42,24,18,1,1,29,8,21
"2021","Richmond upon Thames 022C","E01003836",578,194,121,73,351,48,196,41,117,38,37,18,16,3,67,39,28,3,3,33,10,23
"2021","Richmond upon Thames 022D","E01003837",886,271,118,153,576,94,315,95,180,40,90,61,26,3,75,52,23,2,2,39,13,26
"2021","Richmond upon Thames 022E","E01003838",749,223,79,144,487,48,285,70,176,39,83,61,20,2,67,36,31,4,4,39,18,21
"2021","Richmond upon Thames 022F","E01003839",1031,369,114,255,610,51,305,109,172,24,137,82,53,2,112,77,35,5,5,52,8,44
"2021","Richmond upon Thames 023A","E01003822",521,74,48,26,418,95,265,65,135,65,23,9,14,0,33,14,19,2,2,29,13,16
"2021","Richmond upon Thames 023B","E01003823",804,283,125,158,466,84,253,106,93,54,75,58,15,2,48,20,28,6,6,55,19,36
"2021","Richmond upon Thames 023C","E01003824",628,126,80,46,479,69,300,78,176,46,60,32,24,4,48,27,21,2,2,23,10,13
"2021","Richmond upon Thames 023D","E01003825",653,117,65,52,497,55,338,70,209,59,59,33,19,7,40,23,17,5,5,39,21,18
"2021","Richmond upon Thames 023E","E01003826",770,266,110,156,462,44,221,66,121,34,77,47,26,4,114,68,46,6,6,42,22,20
"2021","Richmond upon Thames 023F","E01003827",883,302,121,181,541,48,281,85,169,27,116,83,28,5,90,55,35,6,6,40,12,28
"2021","Southwark 001A","E01004029",930,309,26,283,449,10,183,78,94,11,149,113,28,8,83,61,22,24,24,172,16,156
"2021","Southwark 001B","E01004032",656,188,26,162,335,12,188,77,91,20,87,76,9,2,30,13,17,18,18,133,14,119
"2021","Southwark 001C","E01004053",890,282,43,239,476,24,226,104,105,17,163,140,20,3,44,25,19,19,19,132,14,118
"2021","Southwark 001D","E01004054",726,224,33,191,388,29,181,86,81,14,126,106,18,2,40,27,13,12,12,114,10,104
"2021","Southwark 001E","E01004055",531,159,69,90,307,21,117,34,48,35,52,22,24,6,110,53,57,7,7,65,28,37
"2021","Southwark 002B","E01003929",1072,467,64,403,459,17,160,92,51,17,177,160,13,4,81,49,32,24,24,146,16,130
"2021","Southwark 002C","E01003934",1117,545,116,429,486,39,206,140,47,19,143,135,7,1,71,33,38,27,27,86,4,82
"2021","Southwark 002D","E01003935",422,172,53,119,191,8,74,31,31,12,44,22,18,4,59,24,35,6,6,59,24,35
"2021","Southwark 002E","E01003939",881,325,25,300,387,5,120,65,44,11,111,93,11,7,84,50,34,67,67,169,11,158
"2021","Southwark 002F","E01033867",608,218,47,171,280,9,87,30,40,17,89,78,10,1,76,41,35,19,19,110,9,101
"2021","Southwark 002G","E01033868",601,274,16,258,240,4,72,42,25,5,121,116,5,0,28,22,6,15,15,87,3,84
"2021","Southwark 004A","E01003975",737,219,39,180,399,6,136,47,65,24,73,49,18,6,163,110,53,21,21,119,20,99
"2021","Southwark 004D","E01004023",711,231,75,156,381,14,117,53,50,14,82,49,26,7,100,57,43,68,68,99,24,75
"2021","Southwark 004E","E01004028",1100,397,58,339,552,9,188,56,111,21,149,120,25,4,181,115,66,25,25,151,27,124
"2021","Southwark 004F","E01033869",638,235,71,164,334,5,106,36,52,18,76,58,12,6,137,99,38,10,10,69,19,50
"2021","Southwark 004G","E01033870",859,298,25,273,423,8,138,79,52,7,151,140,10,1,100,69,31,26,26,138,25,113
"2021","Southwark 004H","E01033871",689,241,56,185,346,24,114,51,54,9,95,74,17,4,102,60,42,11,11,102,25,77
"2021","Southwark 004I","E01033872",657,284,38,246,300,3,110,47,52,11,104,87,14,3,68,44,24,15,15,73,13,60
"2021","Southwark 006A","E01003938",754,243,39,204,352,4,98,36,44,18,81,59,18,4,132,75,57,37,37,159,48,111
"2021","Southwark 006B","E01003940",631,199,49,150,280,8,77,16,44,17,51,32,12,7,127,85,42,17,17,152,33,119
"2021","Southwark 006C","E01003941",964,363,48,315,434,5,175,86,70,19,137,115,16,6,87,63,24,30,30,167,16,151
"2021","Southwark 006D","E01003942",637,186,50,136,339,12,125,27,72,26,43,22,15,6,133,87,46,26,26,112,34,78
"2021","Southwark 006E","E01003979",885,345,45,300,402,13,112,63,39,10,154,115,37,2,104,66,38,19,19,138,25,113
"2021","Southwark 006F","E01003981",658,304,69,235,246,3,83,32,39,12,64,54,9,1,83,49,34,13,13,108,15,93
"2021","Southwark 007A","E01004030",743,322,64,258,331,20,115,56,43,16,96,76,17,3,86,58,28,14,14,90,14,76
"2021","Southwark 007B","E01004031",1082,320,65,255,510,12,190,84,76,30,171,135,31,5,114,64,50,23,23,252,27,225
"2021","Southwark 007C","E01004033",1141,432,82,350,568,7,191,92,76,23,166,133,28,5,172,105,67,32,32,141,24,117
"2021","Southwark 007D","E01004034",653,162,39,123,382,12,117,39,49,29,75,44,25,6,164,101,63,14,14,109,17,92
"2021","Southwark 007E","E01004036",860,244,57,187,482,12,137,40,76,21,91,57,30,4,191,134,57,51,51,134,34,100
"2021","Southwark 008A","E01004056",1023,331,58,273,550,20,256,104,114,38,152,120,27,5,97,43,54,25,25,142,40,102
"2021","Southwark 008B","E01004057",949,282,48,234,566,18,273,94,149,30,140,99,33,8,105,65,40,30,30,101,28,73
"2021","Southwark 008C","E01004058",847,299,28,271,392,11,170,97,68,5,169,156,13,0,21,15,6,21,21,156,8,148
"2021","Southwark 008D","E01004059",897,233,19,214,454,10,180,91,81,8,182,154,27,1,56,46,10,26,26,210,13,197
"2021","Southwark 008E","E01004060",870,312,56,256,408,10,140,49,64,27,111,88,16,7,124,81,43,23,23,150,31,119
"2021","Southwark 009A","E01003936",582,191,39,152,256,12,122,47,66,9,80,71,9,0,25,11,14,17,17,135,4,131
"2021","Southwark 009B","E01003937",768,305,31,274,283,9,87,40,37,10,107,97,9,1,52,29,23,28,28,180,11,169
"2021","Southwark 009C","E01003943",586,165,41,124,306,8,93,19,58,16,49,28,18,3,135,61,74,21,21,115,19,96
"2021","Southwark 009G","E01033873",675,224,24,200,307,4,108,32,66,10,52,42,10,0,122,84,38,21,21,144,33,111
"2021","Southwark 009H","E01033874",625,207,1,206,213,0,53,37,15,1,105,103,2,0,27,22,5,28,28,205,3,202
"2021","Southwark 010A","E01003977",827,309,68,241,414,14,157,52,74,31,103,81,20,2,121,81,40,19,19,104,22,82
"2021","Southwark 010B","E01004037",876,305,38,267,454,9,165,62,81,22,131,69,55,7,125,95,30,24,24,117,28,89
"2021","Southwark 010C","E01004038",1032,347,25,322,543,9,200,73,100,27,108,79,25,4,195,121,74,31,31,142,35,107
"2021","Southwark 010D","E01004042",824,254,86,168,448,25,125,40,50,35,107,80,21,6,166,87,79,25,25,122,27,95
"2021","Southwark 010E","E01004043",579,187,52,135,302,26,118,45,49,24,73,51,20,2,77,31,46,8,8,90,20,70
"2021","Southwark 011A","E01003986",696,270,91,179,329,15,105,24,62,19,58,34,19,5,130,92,38,21,21,97,21,76
"2021","Southwark 011B","E01003987",823,329,93,236,389,27,135,41,63,31,67,39,16,12,148,100,48,12,12,105,38,67
"2021","Southwark 011C","E01004024",814,291,80,211,383,18,119,32,61,26,77,61,14,2,148,105,43,21,21,140,24,116
"2021","Southwark 011D","E01004035",591,210,78,132,262,18,88,17,57,14,59,41,12,6,79,46,33,18,18,119,28,91
"2021","Southwark 012A","E01003960",766,255,51,204,335,12,124,50,59,15,80,70,8,2,99,60,39,20,20,176,16,160
"2021","Southwark 012B","E01003961",885,325,120,205,430,11,135,34,74,27,71,42,23,6,183,119,64,30,30,130,29,101
"2021","Southwark 012E","E01003994",861,342,61,281,391,14,130,54,54,22,91,81,10,0,127,62,65,29,29,128,22,106
"2021","Southwark 012G","E01033875",640,249,61,188,315,4,101,45,41,15,87,77,7,3,108,72,36,15,15,76,13,63
"2021","Southwark 012H","E01033876",651,231,15,216,296,4,67,38,22,7,146,131,14,1,49,31,18,30,30,124,5,119
"2021","Southwark 012I","E01033877",680,216,42,174,331,13,107,44,46,17,102,88,11,3,90,57,33,19,19,133,20,113
"2021","Southwark 013A","E01003980",887,372,84,288,363,9,110,33,58,19,92,65,22,5,126,79,47,26,26,152,18,134
"2021","Southwark 013B","E01004039",636,199,18,181,320,7,115,35,64,16,85,57,24,4,91,53,38,22,22,117,17,100
"2021","Southwark 013C","E01004040",779,283,89,194,389,4,113,36,56,21,59,29,20,10,199,142,57,14,14,107,59,48
"2021","Southwark 013D","E01004041",694,263,54,209,342,10,138,39,76,23,75,35,37,3,102,59,43,17,17,89,27,62
"2021","Southwark 013E","E01004044",563,173,35,138,303,5,110,31,49,30,42,24,16,2,136,83,53,10,10,87,25,62
"2021","Southwark 014A","E01003992",648,238,105,133,300,6,97,14,67,16,37,19,16,2,145,95,50,15,15,110,21,89
"2021","Southwark 014B","E01003995",738,374,75,299,293,8,87,36,40,11,74,57,15,2,111,69,42,13,13,71,16,55
"2021","Southwark 014D","E01003998",657,234,55,179,307,18,104,55,38,11,91,63,23,5,80,48,32,14,14,116,16,100
"2021","Southwark 014E","E01003999",598,190,41,149,308,4,104,30,58,16,68,48,19,1,121,77,44,11,11,100,22,78
"2021","Southwark 014F","E01032639",783,274,45,229,308,8,83,35,37,11,124,106,17,1,73,52,21,20,20,201,13,188
"2021","Southwark 014G","E01032719",801,409,46,363,299,9,98,52,34,12,81,67,11,3,88,65,23,23,23,93,14,79
"2021","Southwark 015B","E01003966",825,247,74,173,413,21,127,34,62,31,81,39,26,16,148,82,66,36,36,165,42,123
"2021","Southwark 015D","E01003971",512,114,30,84,338,3,63,15,41,7,89,62,25,2,176,124,52,7,7,60,26,34
"2021","Southwark 015F","E01033878",421,106,29,77,245,10,72,14,43,15,52,32,18,2,97,69,28,14,14,70,19,51
"2021","Southwark 015G","E01033879",845,201,54,147,507,11,169,28,87,54,58,27,28,3,248,165,83,21,21,137,74,63
"2021","Southwark 015H","E01033880",533,135,18,117,231,4,85,25,50,10,81,61,17,3,48,26,22,13,13,167,94,73
"2021","Southwark 016A","E01003963",687,213,43,170,342,4,88,18,54,16,63,35,23,5,161,100,61,26,26,132,35,97
"2021","Southwark 016D","E01003972",615,176,36,140,337,4,89,35,44,10,87,60,23,4,139,106,33,18,18,102,26,76
"2021","Southwark 016E","E01003973",753,293,62,231,350,7,120,32,61,27,73,50,16,7,136,88,48,14,14,110,21,89
"2021","Southwark 016F","E01033881",708,208,67,141,383,18,122,32,70,20,50,24,17,9,167,95,72,26,26,117,39,78
"2021","Southwark 017A","E01003923",726,255,61,194,325,8,104,40,46,18,92,72,15,5,105,57,48,16,16,146,27,119
"2021","Southwark 017B","E01003969",1016,328,71,257,452,17,149,57,64,28,124,97,22,5,134,71,63,28,28,236,42,194
"2021","Southwark 017C","E01003991",584,216,104,112,281,16,78,25,42,11,43,28,11,4,126,48,78,18,18,87,18,69
"2021","Southwark 017D","E01003993",796,246,56,190,426,6,111,24,62,25,54,24,24,6,235,135,100,20,20,124,43,81
"2021","Southwark 017E","E01003997",505,141,36,105,254,3,70,24,38,8,58,45,6,7,110,60,50,13,13,110,27,83
"2021","Southwark 018A","E01003983",673,159,31,128,423,16,101,12,68,21,46,17,27,2,251,145,106,9,9,91,43,48
"2021","Southwark 018B","E01003988",870,349,118,231,383,21,119,48,52,19,44,28,14,2,177,112,65,22,22,138,39,99
"2021","Southwark 018C","E01003989",878,242,43,199,473,6,162,44,82,36,91,52,35,4,183,116,67,31,31,163,39,124
"2021","Southwark 018D","E01003990",823,218,60,158,462,13,130,30,67,33,85,32,45,8,217,123,94,17,17,143,41,102
"2021","Southwark 018E","E01004007",543,158,41,117,319,2,86,15,50,21,50,21,14,15,163,101,62,18,18,66,32,34
"2021","Southwark 019A","E01003912",668,185,30,155,399,20,110,15,75,20,43,15,26,2,211,160,51,15,15,84,37,47
"2021","Southwark 019B","E01004011",827,262,61,201,450,10,130,32,64,34,79,47,20,12,206,114,92,25,25,115,45,70
"2021","Southwark 019C","E01004012",919,283,37,246,468,3,143,37,71,35,112,74,32,6,183,102,81,27,27,168,61,107
"2021","Southwark 019D","E01004013",660,162,33,129,387,26,107,26,48,33,77,55,13,9,165,76,89,12,12,111,30,81
"2021","Southwark 019E","E01004014",813,287,59,228,427,2,153,41,93,19,70,39,23,8,181,125,56,21,21,99,50,49
"2021","Southwark 020A","E01003911",752,205,42,163,422,6,122,43,60,19,98,64,30,4,186,111,75,10,10,125,48,77
"2021","Southwark 020B","E01003916",912,279,50,229,444,6,148,48,79,21,139,103,25,11,125,74,51,26,26,189,46,143
"2021","Southwark 020C","E01003917",872,343,100,243,414,24,112,45,52,15,131,107,23,1,129,79,50,18,18,115,19,96
"2021","Southwark 020D","E01003918",647,244,105,139,298,7,95,37,42,16,68,53,10,5,113,75,38,15,15,105,19,86
"2021","Southwark 020E","E01003925",839,280,63,217,462,8,152,44,85,23,132,94,29,9,152,86,66,18,18,97,25,72
"2021","Southwark 021A","E01003919",681,249,56,193,301,13,99,41,48,10,100,72,23,5,74,38,36,15,15,131,25,106
"2021","Southwark 021B","E01003920",909,308,61,247,479,10,163,66,73,24,77,53,20,4,204,129,75,25,25,122,41,81
"2021","Southwark 021C","E01003921",992,430,55,375,439,12,128,54,58,16,144,122,21,1,131,90,41,24,24,123,10,113
"2021","Southwark 021D","E01003922",968,301,68,233,530,8,191,92,76,23,96,70,23,3,215,144,71,20,20,137,34,103
"2021","Southwark 021E","E01003924",905,340,104,236,440,11,120,31,71,18,78,48,27,3,201,136,65,30,30,125,54,71
"2021","Southwark 021F","E01003926",567,190,62,128,289,11,79,18,46,15,55,31,16,8,125,68,57,19,19,88,28,60
"2021","Southwark 022B","E01004008",803,239,53,186,437,8,128,29,67,32,74,40,32,2,208,114,94,19,19,127,32,95
"2021","Southwark 022D","E01004010",633,219,44,175,320,4,106,29,59,18,64,40,21,3,127,81,46,19,19,94,33,61
"2021","Southwark 022E","E01004067",932,319,48,271,463,13,161,40,75,46,93,59,33,1,172,108,64,24,24,150,35,115
"2021","Southwark 022G","E01033882",582,203,42,161,257,10,91,28,44,19,71,57,14,0,80,45,35,5,5,122,25,97
"2021","Southwark 022H","E01033883",648,204,33,171,340,8,105,32,48,25,93,61,30,2,120,78,42,14,14,104,22,82
"2021","Southwark 023A","E01003984",1004,352,106,246,482,16,158,56,81,21,160,127,26,7,135,83,52,13,13,170,36,134
"2021","Southwark 023B","E01004003",793,290,72,218,407,9,120,27,64,29,94,64,24,6,166,86,80,18,18,96,24,72
"2021","Southwark 023C","E01004004",1148,399,84,315,564,16,191,63,96,32,141,111,25,5,195,141,54,21,21,185,47,138
"2021","Southwark 023D","E01004005",1007,380,78,302,508,9,129,49,61,19,135,111,22,2,218,139,79,17,17,119,36,83
"2021","Southwark 023E","E01004006",789,260,58,202,411,14,155,45,87,23,122,75,42,5,108,63,45,12,12,118,19,99
"2021","Southwark 024A","E01003913",840,250,59,191,431,33,174,56,94,24,112,91,20,1,99,77,22,13,13,159,23,136
"2021","Southwark 024B","E01003914",717,197,62,135,377,20,140,50,75,15,124,90,30,4,81,40,41,12,12,143,20,123
"2021","Southwark 024C","E01003915",798,262,52,210,377,10,108,31,59,18,101,83,16,2,132,74,58,26,26,159,34,125
"2021","Southwark 024D","E01004050",630,191,37,154,344,28,129,48,65,16,136,116,18,2,44,26,18,7,7,95,15,80
"2021","Southwark 024E","E01004052",772,242,54,188,422,9,165,48,102,15,154,124,26,4,88,41,47,6,6,108,16,92
"2021","Southwark 025A","E01004061",737,227,53,174,407,17,171,52,91,28,133,108,24,1,71,40,31,15,15,103,12,91
"2021","Southwark 025B","E01004062",981,309,61,248,516,11,160,51,88,21,170,140,25,5,148,107,41,27,27,156,25,131
"2021","Southwark 025C","E01004063",856,291,94,197,417,11,180,50,109,21,131,106,25,0,84,44,40,11,11,148,14,134
"2021","Southwark 025D","E01004065",630,161,37,124,365,12,182,58,99,25,105,81,21,3,47,17,30,19,19,104,13,91
"2021","Southwark 025E","E01004066",852,238,48,190,492,29,175,49,101,25,113,80,28,5,158,101,57,17,17,122,33,89
"2021","Southwark 026A","E01004000",875,318,74,244,447,17,178,66,86,26,122,85,35,2,116,76,40,14,14,110,20,90
"2021","Southwark 026B","E01004001",755,248,96,152,425,19,125,30,68,27,82,50,30,2,193,73,120,6,6,82,26,56
"2021","Southwark 026C","E01004019",841,252,52,200,479,12,202,39,122,41,112,85,23,4,137,76,61,16,16,110,27,83
"2021","Southwark 026D","E01004064",816,250,77,173,438,8,143,41,74,28,134,103,28,3,142,88,54,11,11,128,37,91
"2021","Southwark 026E","E01004068",817,298,129,169,414,17,126,39,60,27,91,64,20,7,161,74,87,19,19,105,27,78
"2021","Southwark 027A","E01004045",638,193,35,158,375,4,106,18,70,18,68,38,29,1,186,114,72,11,11,70,23,47
"2021","Southwark 027B","E01004047",619,182,52,130,328,9,114,33,64,17,46,28,14,4,144,70,74,15,15,109,43,66
"2021","Southwark 027C","E01004048",691,229,40,189,385,4,176,49,111,16,82,46,33,3,114,65,49,9,9,77,21,56
"2021","Southwark 027D","E01004049",515,141,29,112,303,9,113,23,77,13,51,33,15,3,112,73,39,18,18,71,21,50
"2021","Southwark 027E","E01004051",584,195,66,129,316,21,137,48,72,17,96,71,23,2,57,31,26,5,5,73,8,65
"2021","Southwark 028A","E01003953",945,349,72,277,464,21,197,54,121,22,173,144,28,1,58,28,30,15,15,132,16,116
"2021","Southwark 028B","E01003955",815,239,76,163,495,15,252,76,137,39,149,107,39,3,69,33,36,10,10,81,16,65
"2021","Southwark 028C","E01004015",708,200,49,151,396,27,168,43,106,19,113,92,18,3,76,54,22,12,12,112,20,92
"2021","Southwark 028D","E01004021",999,321,60,261,570,20,197,66,113,18,246,201,44,1,89,52,37,18,18,108,16,92
"2021","Southwark 028E","E01004046",642,168,35,133,393,25,176,45,119,12,125,100,20,5,56,27,29,11,11,81,20,61
"2021","Southwark 029A","E01004002",656,152,55,97,411,12,227,48,150,29,92,54,31,7,77,42,35,3,3,93,19,74
"2021","Southwark 029B","E01004016",991,236,73,163,610,15,302,76,194,32,145,97,43,5,137,76,61,11,11,145,57,88
"2021","Southwark 029C","E01004017",650,157,40,117,413,28,205,42,134,29,98,73,22,3,77,50,27,5,5,80,25,55
"2021","Southwark 029D","E01004020",739,235,73,162,430,6,131,40,73,18,88,48,32,8,184,134,50,21,21,74,23,51
"2021","Southwark 030A","E01003952",686,176,48,128,418,14,205,66,123,16,119,97,21,1,66,41,25,14,14,92,19,73
"2021","Southwark 030B","E01003954",658,178,50,128,412,18,210,54,138,18,128,91,36,1,42,25,17,14,14,68,20,48
"2021","Southwark 030C","E01003956",726,193,50,143,461,20,239,51,167,21,142,109,30,3,51,30,21,9,9,72,24,48
"2021","Southwark 030D","E01004071",634,187,64,123,387,26,160,44,98,18,94,61,29,4,98,47,51,9,9,60,23,37
"2021","Southwark 030E","E01004072",622,118,50,68,450,44,275,74,163,38,73,48,21,4,54,30,24,4,4,54,14,40
"2021","Southwark 031A","E01004069",481,99,54,45,352,66,225,49,136,40,33,21,11,1,27,15,12,1,1,30,5,25
"2021","Southwark 031B","E01004070",730,161,67,94,505,40,279,64,186,29,88,50,27,11,93,51,42,5,5,64,22,42
"2021","Southwark 031C","E01004073",701,144,61,83,487,42,274,56,189,29,94,58,34,2,71,38,33,6,6,70,24,46
"2021","Southwark 031D","E01004074",616,116,73,43,420,51,276,74,155,47,47,22,23,2,43,30,13,3,3,80,15,65
"2021","Southwark 031E","E01004075",623,97,63,34,483,66,314,80,188,46,50,19,26,5,48,36,12,5,5,43,16,27
"2021","Southwark 032A","E01003949",863,318,63,255,462,31,209,65,123,21,122,93,27,2,84,57,27,16,16,83,20,63
"2021","Southwark 032B","E01003950",811,244,60,184,450,23,167,34,104,29,82,56,24,2,162,96,66,16,16,117,54,63
"2021","Southwark 032C","E01003957",699,151,42,109,479,24,241,54,158,29,140,99,36,5,69,30,39,5,5,69,12,57
"2021","Southwark 032D","E01003958",773,188,55,133,489,23,226,66,127,33,108,76,31,1,126,44,82,6,6,96,23,73
"2021","Southwark 032E","E01004018",781,211,57,154,493,21,261,71,162,28,134,94,38,2,69,46,23,8,8,77,16,61
"2021","Southwark 033A","E01003945",727,201,70,131,450,52,211,61,124,26,88,48,34,6,95,65,30,4,4,76,18,58
"2021","Southwark 033B","E01003946",753,226,99,127,462,55,214,47,141,26,84,51,30,3,104,60,44,5,5,65,37,28
"2021","Southwark 033C","E01003947",601,143,41,102,383,12,104,21,67,16,51,25,22,4,206,149,57,10,10,75,40,35
"2021","Southwark 033D","E01003948",800,260,71,189,485,20,187,63,105,19,154,120,33,1,107,83,24,17,17,55,14,41
"2021","Southwark 033E","E01003951",554,150,73,77,355,54,187,51,91,45,45,23,20,2,59,35,24,10,10,49,13,36
"2021","Southwark 034A","E01003930",746,289,47,242,373,8,121,57,54,10,111,87,21,3,117,84,33,16,16,84,12,72
"2021","Southwark 034B","E01003932",690,252,32,220,343,6,94,40,40,14,73,61,8,4,144,94,50,26,26,95,19,76
"2021","Southwark 034C","E01003933",1015,362,50,312,490,12,165,77,47,41,184,162,17,5,98,56,42,31,31,163,29,134
"2021","Southwark 034D","E01032583",919,341,44,297,444,6,153,73,60,20,104,85,19,0,147,98,49,34,34,134,16,118
"2021","Southwark 034E","E01032584",566,194,43,151,271,12,86,31,39,16,73,49,21,3,77,40,37,23,23,101,21,80
"2021","Southwark 035E","E01032637",567,259,8,251,245,3,83,61,19,3,143,138,5,0,7,3,4,9,9,63,3,60
"2021","Southwark 035D","E01032638",596,223,26,197,273,16,113,77,33,3,111,97,13,1,19,9,10,14,14,100,0,100
"2021","Southwark 035B","E01032640",611,266,18,248,287,10,134,95,31,8,118,112,6,0,10,6,4,15,15,58,0,58
"2021","Southwark 035C","E01032834",620,272,23,249,300,14,116,88,24,4,148,145,3,0,9,6,3,13,13,48,0,48
"2021","Southwark 035A","E01033884",593,259,17,242,234,2,79,45,29,5,87,78,9,0,48,25,23,18,18,100,6,94
"2021","Southwark 036D","E01003976",1145,395,63,332,582,8,178,82,77,19,181,154,24,3,180,123,57,35,35,168,19,149
"2021","Southwark 036B","E01032646",807,330,37,293,350,12,121,66,44,11,142,129,10,3,50,33,17,25,25,127,7,120
"2021","Southwark 036C","E01032803",788,286,21,265,363,8,114,60,47,7,154,146,8,0,57,40,17,30,30,139,9,130
"2021","Southwark 036A","E01033885",628,232,39,193,277,5,82,30,40,12,78,58,16,4,99,54,45,13,13,119,16,103
"2021","Sutton 001A","E01004125",617,184,82,102,370,27,181,41,101,39,59,23,28,8,99,66,33,4,4,63,36,27
"2021","Sutton 001B","E01004183",680,183,63,120,429,19,202,52,118,32,73,33,29,11,132,66,66,3,3,68,39,29
"2021","Sutton 001C","E01004184",605,131,49,82,427,16,207,41,138,28,65,24,36,5,130,89,41,9,9,47,29,18
"2021","Sutton 001D","E01004185",806,197,31,166,558,13,249,63,143,43,118,66,46,6,168,115,53,10,10,51,25,26
"2021","Sutton 001E","E01004189",772,178,82,96,523,21,258,68,128,62,83,23,42,18,149,87,62,12,12,71,42,29
"2021","Sutton 002A","E01004123",814,180,50,130,547,22,278,68,159,51,85,37,39,9,146,85,61,16,16,87,49,38
"2021","Sutton 002B","E01004124",669,115,50,65,471,25,248,50,142,56,66,22,33,11,123,67,56,9,9,83,51,32
"2021","Sutton 002C","E01004126",569,109,43,66,414,27,192,47,113,32,57,14,32,11,134,70,64,4,4,46,32,14
"2021","Sutton 002D","E01004128",525,122,44,78,355,15,173,41,79,53,53,15,24,14,107,59,48,7,7,48,28,20
"2021","Sutton 002E","E01004129",726,220,95,125,442,34,206,43,120,43,63,24,32,7,132,78,54,7,7,64,38,26
"2021","Sutton 003A","E01004130",655,148,94,54,446,60,258,51,131,76,57,27,26,4,65,30,35,6,6,61,28,33
"2021","Sutton 003B","E01004131",676,144,65,79,476,45,285,56,163,66,67,26,39,2,75,44,31,4,4,56,26,30
"2021","Sutton 003C","E01004134",560,108,53,55,388,48,223,48,116,59,45,22,17,6,65,33,32,7,7,64,34,30
"2021","Sutton 003D","E01004135",508,96,63,33,361,58,224,49,122,53,34,10,17,7,37,12,25,8,8,51,30,21
"2021","Sutton 003E","E01004136",556,97,57,40,413,60,249,62,115,72,47,17,22,8,53,23,30,4,4,46,20,26
"2021","Sutton 004A","E01004164",617,207,80,127,381,32,234,70,116,48,57,37,16,4,53,33,20,5,5,29,11,18
"2021","Sutton 004B","E01004166",674,194,87,107,456,48,254,84,130,40,90,56,29,5,61,36,25,3,3,24,6,18
"2021","Sutton 004C","E01004169",700,182,40,142,483,6,246,53,169,24,109,51,57,1,116,89,27,6,6,35,14,21
"2021","Sutton 004D","E01004186",770,270,51,219,472,16,241,81,136,24,107,62,42,3,101,62,39,7,7,28,16,12
"2021","Sutton 004F","E01034153",584,188,45,143,352,18,174,52,101,21,71,42,26,3,86,57,29,3,3,44,19,25
"2021","Sutton 004G","E01034154",635,160,15,145,435,8,225,78,134,13,137,81,53,3,59,44,15,6,6,40,19,21
"2021","Sutton 005A","E01004127",651,145,61,84,448,26,232,45,127,60,85,28,51,6,101,58,43,4,4,58,33,25
"2021","Sutton 005B","E01004163",631,112,65,47,472,53,260,70,132,58,72,29,34,9,83,42,41,4,4,47,24,23
"2021","Sutton 005C","E01004165",707,185,64,121,464,31,218,74,111,33,89,56,30,3,119,78,41,7,7,58,26,32
"2021","Sutton 005D","E01004167",583,156,79,77,375,19,184,33,110,41,46,16,24,6,118,85,33,8,8,52,34,18
"2021","Sutton 005E","E01004187",640,172,78,94,416,31,231,59,125,47,58,27,22,9,94,48,46,2,2,52,28,24
"2021","Sutton 006A","E01004117",513,82,47,35,390,43,253,70,126,57,51,24,21,6,40,13,27,3,3,41,21,20
"2021","Sutton 006B","E01004121",625,166,84,82,427,49,262,69,148,45,60,32,22,6,53,26,27,3,3,32,15,17
"2021","Sutton 006C","E01004192",729,161,60,101,523,34,290,74,176,40,85,47,30,8,107,52,55,7,7,45,13,32
"2021","Sutton 006D","E01004193",1055,223,80,143,766,34,428,105,277,46,157,76,71,10,141,96,45,6,6,66,34,32
"2021","Sutton 006E","E01004195",683,191,97,94,437,33,234,63,127,44,75,42,26,7,91,51,40,4,4,55,28,27
"2021","Sutton 007A","E01004144",652,130,69,61,461,73,276,52,147,77,49,23,21,5,58,22,36,5,5,61,34,27
"2021","Sutton 007B","E01004145",808,161,89,72,583,47,370,76,217,77,72,22,38,12,88,49,39,6,6,64,37,27
"2021","Sutton 007C","E01004146",732,190,92,98,466,36,282,64,174,44,74,41,28,5,66,43,23,8,8,76,43,33
"2021","Sutton 007D","E01004147",594,130,89,41,422,70,227,52,119,56,60,29,20,11,63,26,37,2,2,42,23,19
"2021","Sutton 008A","E01004116",639,190,146,44,405,74,243,62,120,61,45,22,20,3,40,20,20,3,3,44,20,24
"2021","Sutton 008B","E01004122",531,123,83,40,374,68,238,50,133,55,40,26,8,6,24,10,14,4,4,34,23,11
"2021","Sutton 008C","E01004190",505,81,53,28,386,66,246,65,121,60,39,20,10,9,33,8,25,2,2,38,19,19
"2021","Sutton 008D","E01004191",719,172,87,85,490,55,266,46,164,56,80,45,33,2,80,47,33,9,9,57,31,26
"2021","Sutton 008E","E01004194",694,245,91,154,402,34,199,49,115,35,77,44,31,2,85,53,32,7,7,47,21,26
"2021","Sutton 008F","E01004196",607,143,75,68,427,67,248,56,141,51,58,27,23,8,50,24,26,4,4,37,17,20
"2021","Sutton 009A","E01004115",671,161,83,78,450,48,270,49,169,52,70,30,35,5,60,29,31,2,2,60,29,31
"2021","Sutton 009B","E01004118",693,197,102,95,434,49,239,48,147,44,59,34,22,3,81,46,35,6,6,62,30,32
"2021","Sutton 009C","E01004119",499,75,40,35,380,49,221,43,126,52,58,21,27,10,50,23,27,2,2,44,28,16
"2021","Sutton 009D","E01004132",510,83,52,31,396,36,258,48,155,55,42,16,18,8,58,25,33,2,2,31,16,15
"2021","Sutton 009E","E01004133",538,88,55,33,414,59,273,53,161,59,37,14,18,5,41,19,22,4,4,36,20,16
"2021","Sutton 010A","E01004171",576,115,66,49,416,58,231,49,134,48,65,27,31,7,59,22,37,3,3,45,28,17
"2021","Sutton 010B","E01004172",845,298,87,211,511,25,248,48,164,36,73,41,30,2,161,113,48,4,4,36,16,20
"2021","Sutton 010C","E01004173",524,123,81,42,357,48,197,48,104,45,46,21,15,10,61,35,26,5,5,44,18,26
"2021","Sutton 010D","E01004175",694,179,72,107,462,42,246,69,129,48,87,44,36,7,77,47,30,10,10,53,27,26
"2021","Sutton 010E","E01004176",615,160,54,106,426,33,223,59,124,40,82,44,34,4,77,35,42,11,11,29,14,15
"2021","Sutton 011A","E01004076",622,173,86,87,389,35,214,51,110,53,55,20,29,6,79,44,35,6,6,60,36,24
"2021","Sutton 011B","E01004077",638,162,74,88,430,59,233,49,125,59,58,20,31,7,77,41,36,3,3,46,17,29
"2021","Sutton 011C","E01004078",698,171,48,123,481,30,237,67,134,36,85,43,41,1,123,77,46,6,6,46,26,20
"2021","Sutton 011D","E01004079",493,73,39,34,383,55,259,62,126,71,31,18,9,4,37,14,23,1,1,37,21,16
"2021","Sutton 011E","E01004080",511,109,76,33,353,61,206,40,100,66,41,20,14,7,40,12,28,5,5,49,32,17
"2021","Sutton 011F","E01004081",636,158,56,102,446,34,246,48,155,43,79,47,29,3,83,53,30,4,4,32,12,20
"2021","Sutton 011G","E01004082",500,95,51,44,359,47,226,52,116,58,32,11,19,2,50,20,30,4,4,46,27,19
"2021","Sutton 012A","E01004137",1161,403,81,322,687,27,365,113,223,29,183,144,33,6,98,72,26,14,14,71,31,40
"2021","Sutton 012B","E01004140",794,292,85,207,427,15,199,55,128,16,75,37,32,6,126,81,45,12,12,75,31,44
"2021","Sutton 012C","E01004141",756,259,115,144,429,22,184,38,122,24,85,46,38,1,128,102,26,10,10,68,35,33
"2021","Sutton 012E","E01004149",785,243,119,124,476,70,240,73,131,36,75,34,35,6,83,55,28,8,8,66,27,39
"2021","Sutton 012F","E01034155",860,248,89,159,551,27,256,73,158,25,97,57,38,2,157,121,36,14,14,61,21,40
"2021","Sutton 012G","E01034156",685,262,42,220,375,9,173,65,102,6,117,96,20,1,67,50,17,9,9,48,17,31
"2021","Sutton 013A","E01004101",538,116,80,36,384,58,234,58,126,50,35,20,14,1,54,24,30,3,3,38,15,23
"2021","Sutton 013B","E01004103",748,251,81,170,452,20,264,63,158,43,87,55,29,3,76,44,32,5,5,45,24,21
"2021","Sutton 013C","E01004138",751,221,61,160,480,30,239,53,153,33,106,61,38,7,94,70,24,11,11,50,25,25
"2021","Sutton 013D","E01004139",635,202,62,140,372,21,217,61,122,34,63,39,19,5,68,48,20,3,3,61,29,32
"2021","Sutton 013E","E01004168",582,107,74,33,429,56,258,63,128,67,62,24,31,7,48,30,18,5,5,46,24,22
"2021","Sutton 014A","E01004143",626,171,82,89,409,24,241,70,140,31,71,44,25,2,70,31,39,3,3,46,21,25
"2021","Sutton 014B","E01004148",676,170,98,72,463,22,247,43,164,40,61,21,37,3,124,90,34,9,9,43,22,21
"2021","Sutton 014C","E01004159",617,136,71,65,421,47,230,42,139,49,67,32,25,10,72,43,29,5,5,60,30,30
"2021","Sutton 014D","E01004160",680,196,53,143,426,35,250,69,147,34,58,36,18,4,79,45,34,4,4,58,31,27
"2021","Sutton 014E","E01004161",604,153,63,90,411,41,225,45,141,39,68,41,26,1,75,45,30,2,2,40,18,22
"2021","Sutton 015A","E01004097",623,127,72,55,456,51,278,69,148,61,67,31,32,4,54,29,25,6,6,40,18,22
"2021","Sutton 015B","E01004098",512,134,58,76,346,50,197,48,115,34,60,36,18,6,37,23,14,2,2,32,13,19
"2021","Sutton 015C","E01004099",770,280,111,169,467,26,191,71,105,15,129,92,33,4,116,77,39,5,5,23,9,14
"2021","Sutton 015D","E01004100",577,111,62,49,433,62,256,69,151,36,52,21,28,3,61,37,24,2,2,33,19,14
"2021","Sutton 015E","E01004102",597,162,69,93,397,36,248,57,144,47,63,34,29,0,46,25,21,4,4,38,18,20
"2021","Sutton 016A","E01004110",862,265,106,159,539,65,265,70,140,55,72,44,24,4,118,68,50,19,19,58,20,38
"2021","Sutton 016B","E01004111",683,240,151,89,401,48,254,55,145,54,51,21,29,1,46,27,19,2,2,42,23,19
"2021","Sutton 016C","E01004112",674,158,103,55,477,100,288,80,158,50,42,27,13,2,43,19,24,4,4,39,14,25
"2021","Sutton 016D","E01004120",544,104,72,32,396,74,255,61,125,69,35,10,20,5,29,9,20,3,3,44,24,20
"2021","Sutton 016E","E01004157",447,70,47,23,340,60,230,63,118,49,22,8,14,0,27,13,14,1,1,37,17,20
"2021","Sutton 017A","E01004087",538,80,56,24,401,88,255,50,124,81,13,8,5,0,41,16,25,4,4,57,26,31
"2021","Sutton 017B","E01004170",909,265,83,182,592,54,320,94,179,47,112,72,37,3,97,69,28,9,9,52,33,19
"2021","Sutton 017C","E01004174",682,236,76,160,398,36,204,46,127,31,78,46,26,6,75,48,27,5,5,48,20,28
"2021","Sutton 017D","E01004178",1060,413,144,269,593,42,296,76,189,31,110,60,46,4,138,98,40,7,7,54,26,28
"2021","Sutton 017E","E01004179",605,137,60,77,422,63,277,72,151,54,43,22,18,3,37,19,18,2,2,46,20,26
"2021","Sutton 018A","E01004152",838,353,160,193,433,32,204,61,130,13,101,67,32,2,88,55,33,8,8,52,17,35
"2021","Sutton 018B","E01004155",834,301,95,206,486,34,237,60,156,21,127,80,43,4,81,62,19,7,7,47,21,26
"2021","Sutton 018C","E01004156",944,364,119,245,536,28,296,87,191,18,117,89,25,3,86,57,29,9,9,44,14,30
"2021","Sutton 018D","E01004158",718,273,106,167,404,47,205,71,106,28,86,61,19,6,62,34,28,4,4,41,23,18
"2021","Sutton 018E","E01004162",747,254,90,164,434,25,236,62,145,29,84,57,25,2,79,56,23,10,10,59,23,36
"2021","Sutton 019A","E01004083",610,206,77,129,357,25,130,31,68,31,52,26,19,7,145,96,49,5,5,47,21,26
"2021","Sutton 019B","E01004086",726,171,53,118,485,48,277,53,173,51,64,33,29,2,93,61,32,3,3,70,48,22
"2021","Sutton 019C","E01004088",748,240,72,168,449,13,159,37,75,47,68,24,31,13,202,130,72,7,7,59,39,20
"2021","Sutton 019D","E01004089",552,185,52,133,333,15,137,34,78,25,47,22,20,5,131,100,31,3,3,34,19,15
"2021","Sutton 019E","E01004182",672,157,61,96,464,26,218,45,141,32,62,24,32,6,152,103,49,6,6,51,22,29
"2021","Sutton 020A","E01004104",553,95,59,36,420,77,267,56,157,54,35,14,19,2,41,19,22,0,0,38,20,18
"2021","Sutton 020B","E01004107",620,144,64,80,440,34,242,66,133,43,71,30,34,7,89,53,36,4,4,36,15,21
"2021","Sutton 020C","E01004177",910,450,286,164,421,56,174,48,103,23,72,38,30,4,110,75,35,9,9,39,15,24
"2021","Sutton 020D","E01004180",623,111,76,35,449,87,298,81,136,81,28,14,12,2,33,17,16,3,3,63,26,37
"2021","Sutton 020E","E01004181",781,319,144,175,424,53,208,47,127,34,57,32,21,4,98,66,32,8,8,38,19,19
"2021","Sutton 021A","E01004090",570,218,86,132,314,20,137,34,81,22,47,17,25,5,108,76,32,2,2,38,22,16
"2021","Sutton 021B","E01004096",751,328,79,249,389,21,178,64,97,17,110,75,33,2,75,53,22,5,5,34,12,22
"2021","Sutton 021C","E01004150",1057,528,238,290,472,23,226,86,131,9,130,92,37,1,81,58,23,12,12,57,23,34
"2021","Sutton 021D","E01004151",845,293,77,216,487,33,251,78,150,23,109,74,31,4,89,56,33,5,5,65,19,46
"2021","Sutton 021E","E01004153",891,354,118,236,500,25,283,73,188,22,109,63,45,1,74,43,31,9,9,37,12,25
"2021","Sutton 022A","E01004091",481,80,60,20,366,97,216,48,106,62,19,5,12,2,33,15,18,1,1,35,13,22
"2021","Sutton 022B","E01004092",581,136,68,68,405,81,249,69,129,51,33,18,13,2,38,18,20,4,4,40,16,24
"2021","Sutton 022C","E01004105",682,112,60,52,534,77,332,71,190,71,54,26,24,4,67,42,25,4,4,36,18,18
"2021","Sutton 022D","E01004106",552,48,40,8,478,96,327,89,156,82,25,16,8,1,28,12,16,2,2,26,13,13
"2021","Sutton 022E","E01004154",566,124,75,49,405,91,242,57,141,44,30,15,12,3,37,17,20,5,5,37,16,21
"2021","Sutton 024A","E01004084",514,75,59,16,374,86,227,63,100,64,31,13,10,8,29,8,21,1,1,65,35,30
"2021","Sutton 024B","E01004085",578,125,69,56,393,83,246,52,119,75,27,14,7,6,36,15,21,1,1,60,35,25
"2021","Sutton 024C","E01004108",695,132,66,66,507,70,320,66,196,58,56,25,23,8,56,34,22,5,5,56,24,32
"2021","Sutton 024D","E01004109",632,133,65,68,459,46,243,62,124,57,66,26,31,9,99,63,36,5,5,40,18,22
"2021","Sutton 025A","E01004093",617,134,68,66,439,63,283,58,182,43,43,21,21,1,49,33,16,1,1,44,20,24
"2021","Sutton 025B","E01004094",777,238,91,147,495,43,262,57,173,32,101,60,32,9,86,50,36,3,3,44,25,19
"2021","Sutton 025C","E01004095",625,167,77,90,415,76,244,61,138,45,48,33,14,1,43,22,21,4,4,43,21,22
"2021","Sutton 025D","E01004114",592,61,47,14,471,132,291,80,132,79,20,8,9,3,26,9,17,2,2,60,32,28
"2021","Sutton 025E","E01032623",607,84,68,16,461,140,287,62,149,76,14,3,7,4,19,7,12,1,1,62,31,31
"2021","Tower Hamlets 001A","E01004222",1120,401,129,272,587,21,221,56,121,44,135,91,40,4,189,88,101,21,21,132,30,102
"2021","Tower Hamlets 001B","E01004223",938,359,128,231,481,21,188,47,116,25,100,53,41,6,155,78,77,17,17,98,26,72
"2021","Tower Hamlets 001D","E01004226",910,272,39,233,487,6,206,45,142,19,133,94,35,4,124,89,35,18,18,151,40,111
"2021","Tower Hamlets 001E","E01035657",509,134,3,131,251,0,92,59,33,0,131,120,9,2,19,15,4,9,9,124,2,122
"2021","Tower Hamlets 001F","E01035658",593,187,0,187,357,0,140,65,71,4,176,160,16,0,32,28,4,9,9,49,9,40
"2021","Tower Hamlets 001G","E01035659",592,175,43,132,309,14,125,31,76,18,68,41,21,6,91,49,42,11,11,108,35,73
"2021","Tower Hamlets 002B","E01004198",578,227,73,154,244,10,99,13,65,21,38,21,13,4,89,48,41,8,8,107,35,72
"2021","Tower Hamlets 002C","E01004199",557,182,45,137,276,5,129,18,92,19,53,40,12,1,78,45,33,11,11,99,30,69
"2021","Tower Hamlets 002D","E01004201",677,217,53,164,340,9,115,30,66,19,87,56,27,4,91,46,45,38,38,120,30,90
"2021","Tower Hamlets 002E","E01035660",584,191,23,168,279,4,124,31,73,20,75,63,10,2,59,32,27,17,17,114,22,92
"2021","Tower Hamlets 002F","E01035661",497,170,23,147,210,1,88,15,64,9,69,46,19,4,43,33,10,9,9,117,55,62
"2021","Tower Hamlets 003A","E01004228",815,229,58,171,405,21,177,65,86,26,112,74,32,6,81,46,35,14,14,181,20,161
"2021","Tower Hamlets 003B","E01004230",830,218,71,147,456,10,188,40,127,21,142,106,18,18,99,54,45,17,17,156,26,130
"2021","Tower Hamlets 003C","E01004232",633,168,41,127,318,18,164,54,91,19,87,67,19,1,38,21,17,11,11,147,32,115
"2021","Tower Hamlets 003D","E01004233",931,364,107,257,410,12,165,47,96,22,97,76,19,2,102,62,40,34,34,157,40,117
"2021","Tower Hamlets 003E","E01004234",939,231,49,182,505,24,246,88,135,23,142,107,32,3,79,47,32,14,14,203,66,137
"2021","Tower Hamlets 004C","E01004229",537,153,29,124,264,12,128,29,77,22,50,42,8,0,59,27,32,15,15,120,24,96
"2021","Tower Hamlets 004D","E01004231",592,166,51,115,298,9,133,22,93,18,45,36,8,1,97,44,53,14,14,128,32,96
"2021","Tower Hamlets 004E","E01032764",1054,330,36,294,525,7,170,65,91,14,221,193,26,2,97,67,30,30,30,199,12,187
"2021","Tower Hamlets 004F","E01032765",739,237,35,202,379,11,140,51,58,31,105,81,20,4,106,73,33,17,17,123,24,99
"2021","Tower Hamlets 004G","E01032784",745,220,45,175,391,8,146,43,73,30,152,137,13,2,58,42,16,27,27,134,15,119
"2021","Tower Hamlets 004H","E01035662",639,252,10,242,325,2,93,71,20,2,206,198,8,0,15,10,5,9,9,62,1,61
"2021","Tower Hamlets 004I","E01035663",562,154,24,130,306,3,114,33,74,7,94,69,23,2,86,72,14,9,9,102,6,96
"2021","Tower Hamlets 005A","E01004200",575,181,15,166,274,11,87,29,51,7,132,115,17,0,29,15,14,15,15,120,13,107
"2021","Tower Hamlets 005B","E01004202",820,250,35,215,430,3,196,66,110,20,163,135,28,0,52,36,16,16,16,140,25,115
"2021","Tower Hamlets 005C","E01004203",676,175,42,133,316,12,132,30,82,20,80,72,8,0,71,32,39,21,21,185,27,158
"2021","Tower Hamlets 005D","E01004204",715,225,58,167,354,15,162,35,107,20,83,65,18,0,79,41,38,15,15,136,32,104
"2021","Tower Hamlets 006A","E01004311",756,298,74,224,348,10,158,42,100,16,89,69,18,2,81,54,27,10,10,110,26,84
"2021","Tower Hamlets 006C","E01004315",661,260,68,192,261,7,140,27,90,23,58,48,9,1,49,24,25,7,7,140,31,109
"2021","Tower Hamlets 006E","E01035664",1106,393,87,306,525,23,210,60,135,15,148,118,25,5,123,70,53,21,21,188,29,159
"2021","Tower Hamlets 007A","E01004259",783,298,44,254,357,5,132,47,79,6,140,111,26,3,63,40,23,17,17,128,14,114
"2021","Tower Hamlets 007B","E01004260",603,150,36,114,344,3,182,29,128,25,60,36,20,4,84,42,42,15,15,109,29,80
"2021","Tower Hamlets 007C","E01004263",483,117,45,72,278,16,129,17,85,27,33,24,5,4,88,44,44,12,12,88,27,61
"2021","Tower Hamlets 007D","E01004266",555,156,55,101,285,17,125,29,72,24,54,42,10,2,77,42,35,12,12,114,15,99
"2021","Tower Hamlets 008A","E01004235",485,152,34,118,276,8,148,25,108,15,33,15,14,4,80,52,28,7,7,57,25,32
"2021","Tower Hamlets 008B","E01004236",492,129,25,104,287,6,167,20,123,24,25,14,9,2,82,42,40,7,7,76,36,40
"2021","Tower Hamlets 008C","E01004237",619,210,33,177,321,5,144,33,105,6,77,57,20,0,82,65,17,13,13,88,23,65
"2021","Tower Hamlets 008E","E01004239",537,112,40,72,309,11,146,25,90,31,28,18,9,1,114,54,60,10,10,116,61,55
"2021","Tower Hamlets 008F","E01035665",673,246,1,245,305,2,118,53,59,6,117,100,17,0,49,40,9,19,19,122,11,111
"2021","Tower Hamlets 008G","E01035666",732,239,15,224,363,1,156,48,92,16,101,88,12,1,84,64,20,21,21,130,38,92
"2021","Tower Hamlets 008H","E01035667",687,158,12,146,407,1,185,39,133,13,73,56,17,0,124,70,54,24,24,122,53,69
"2021","Tower Hamlets 009A","E01004312",492,138,28,110,250,5,128,28,89,11,41,27,12,2,68,46,22,8,8,104,28,76
"2021","Tower Hamlets 009B","E01004313",804,205,40,165,445,2,205,44,145,16,88,74,12,2,129,84,45,21,21,154,24,130
"2021","Tower Hamlets 009C","E01004316",440,157,17,140,180,1,91,23,60,8,47,40,6,1,34,22,12,7,7,103,16,87
"2021","Tower Hamlets 009E","E01035668",823,247,15,232,358,5,138,45,73,20,123,109,14,0,62,36,26,30,30,218,31,187
"2021","Tower Hamlets 009F","E01035669",646,247,5,242,266,1,98,36,56,6,103,97,6,0,42,30,12,22,22,133,11,122
"2021","Tower Hamlets 010C","E01004264",446,107,31,76,245,6,138,9,111,18,12,7,4,1,76,37,39,13,13,94,29,65
"2021","Tower Hamlets 010E","E01032785",1027,286,9,277,607,4,249,81,158,10,215,176,39,0,122,94,28,17,17,134,20,114
"2021","Tower Hamlets 010F","E01032786",621,189,46,143,333,7,172,34,127,11,65,43,17,5,83,48,35,6,6,99,26,73
"2021","Tower Hamlets 010G","E01035670",832,197,52,145,438,16,243,37,131,75,55,33,22,0,103,54,49,21,21,197,66,131
"2021","Tower Hamlets 011A","E01004207",512,133,39,94,293,7,111,24,68,19,43,29,10,4,122,69,53,10,10,86,25,61
"2021","Tower Hamlets 011B","E01004209",455,116,19,97,262,2,137,15,111,11,32,18,14,0,75,41,34,16,16,77,31,46
"2021","Tower Hamlets 011D","E01004212",785,263,31,232,403,6,181,59,114,8,131,110,20,1,68,36,32,17,17,119,23,96
"2021","Tower Hamlets 011F","E01032787",774,171,34,137,427,13,243,38,179,26,57,38,14,5,100,55,45,14,14,176,49,127
"2021","Tower Hamlets 012A","E01004240",542,110,32,78,333,11,178,20,123,35,29,18,10,1,105,61,44,10,10,99,34,65
"2021","Tower Hamlets 012B","E01004241",543,127,34,93,345,18,167,22,126,19,34,19,15,0,117,69,48,9,9,71,33,38
"2021","Tower Hamlets 012D","E01004267",902,300,35,265,466,3,197,62,106,29,146,117,24,5,103,67,36,17,17,136,38,98
"2021","Tower Hamlets 012E","E01004268",733,269,40,229,362,8,166,33,107,26,68,57,9,2,104,62,42,16,16,102,35,67
"2021","Tower Hamlets 012F","E01035671",891,292,4,288,481,3,212,70,134,8,159,141,17,1,73,59,14,34,34,118,27,91
"2021","Tower Hamlets 012G","E01035672",1012,273,28,245,575,4,307,48,235,24,88,55,32,1,142,100,42,34,34,164,45,119
"2021","Tower Hamlets 012H","E01035673",453,135,6,129,245,2,120,40,74,6,70,59,11,0,37,26,11,16,16,73,12,61
"2021","Tower Hamlets 013A","E01004205",767,248,31,217,383,4,210,36,150,24,55,40,14,1,89,48,41,25,25,136,54,82
"2021","Tower Hamlets 013B","E01004206",548,213,23,190,230,8,127,20,83,24,35,25,9,1,51,33,18,9,9,105,38,67
"2021","Tower Hamlets 013C","E01004208",722,230,22,208,319,5,107,49,54,4,115,105,10,0,53,41,12,39,39,173,9,164
"2021","Tower Hamlets 013D","E01004211",741,277,32,245,314,2,113,51,51,11,130,116,14,0,49,34,15,20,20,150,23,127
"2021","Tower Hamlets 014B","E01004270",841,176,21,155,400,6,174,42,108,24,118,90,19,9,78,44,34,24,24,265,38,227
"2021","Tower Hamlets 014C","E01004271",905,229,36,193,527,10,248,50,186,12,142,113,29,0,115,73,42,12,12,149,42,107
"2021","Tower Hamlets 014D","E01004272",870,200,34,166,513,8,280,46,213,21,86,65,20,1,120,72,48,19,19,157,61,96
"2021","Tower Hamlets 014F","E01035674",572,173,22,151,311,6,147,53,78,16,84,69,15,0,67,51,16,7,7,88,19,69
"2021","Tower Hamlets 014G","E01035675",652,174,46,128,313,5,172,31,126,15,44,34,10,0,63,36,27,29,29,165,25,140
"2021","Tower Hamlets 014H","E01035676",481,115,24,91,273,7,147,18,104,25,38,31,5,2,74,44,30,7,7,93,50,43
"2021","Tower Hamlets 014I","E01035677",596,191,7,184,324,2,147,36,104,7,81,66,15,0,81,51,30,13,13,81,22,59
"2021","Tower Hamlets 015A","E01004306",687,216,35,181,265,8,120,34,67,19,77,64,12,1,46,21,25,14,14,206,63,143
"2021","Tower Hamlets 015B","E01004307",1027,492,29,463,363,4,163,106,47,10,137,126,8,3,35,23,12,24,24,172,8,164
"2021","Tower Hamlets 015C","E01004308",508,136,25,111,259,10,144,33,84,27,42,38,4,0,51,23,28,12,12,113,31,82
"2021","Tower Hamlets 015D","E01004309",943,313,37,276,434,5,205,48,134,23,108,89,19,0,90,40,50,26,26,196,44,152
"2021","Tower Hamlets 015E","E01004310",842,280,30,250,345,4,154,39,88,27,79,70,4,5,71,38,33,37,37,217,31,186
"2021","Tower Hamlets 016A","E01004283",734,192,47,145,410,10,221,57,126,38,63,42,14,7,101,46,55,15,15,132,45,87
"2021","Tower Hamlets 016B","E01004287",878,333,147,186,442,13,237,34,177,26,73,55,16,2,102,53,49,17,17,103,31,72
"2021","Tower Hamlets 016C","E01004289",662,200,61,139,323,15,159,19,112,28,52,38,10,4,79,31,48,18,18,139,48,91
"2021","Tower Hamlets 016D","E01004290",774,243,63,180,367,9,171,35,113,23,92,79,11,2,84,46,38,11,11,164,39,125
"2021","Tower Hamlets 017A","E01004322",525,212,44,168,216,5,110,17,85,8,40,35,4,1,48,25,23,13,13,97,22,75
"2021","Tower Hamlets 017B","E01004323",473,115,24,91,225,6,119,24,83,12,39,31,6,2,50,33,17,11,11,133,37,96
"2021","Tower Hamlets 017C","E01004324",517,136,31,105,262,5,140,17,101,22,31,22,4,5,61,31,30,25,25,119,46,73
"2021","Tower Hamlets 017D","E01004326",766,212,38,174,383,5,186,55,117,14,87,67,19,1,83,57,26,22,22,171,30,141
"2021","Tower Hamlets 018A","E01004245",1069,264,26,238,613,3,274,66,182,26,119,96,22,1,148,112,36,69,69,192,42,150
"2021","Tower Hamlets 018C","E01004248",620,142,36,106,383,3,163,13,129,21,71,48,19,4,138,97,41,8,8,95,43,52
"2021","Tower Hamlets 018D","E01004249",778,191,41,150,469,10,227,40,163,24,51,23,22,6,166,101,65,15,15,118,48,70
"2021","Tower Hamlets 018E","E01035678",757,237,29,208,415,12,189,49,126,14,98,79,18,1,100,73,27,16,16,105,25,80
"2021","Tower Hamlets 018F","E01035679",640,192,43,149,320,10,140,49,81,10,82,67,15,0,67,46,21,21,21,128,30,98
"2021","Tower Hamlets 019C","E01004286",851,255,53,202,448,15,203,39,129,35,72,51,20,1,143,68,75,15,15,148,68,80
"2021","Tower Hamlets 019D","E01004288",608,135,32,103,372,9,162,14,113,35,43,26,14,3,146,104,42,12,12,101,38,63
"2021","Tower Hamlets 019E","E01035680",735,206,7,199,425,3,210,54,141,15,123,96,26,1,70,53,17,19,19,104,27,77
"2021","Tower Hamlets 019F","E01035681",625,191,54,137,327,10,174,22,118,34,55,39,16,0,77,43,34,11,11,107,63,44
"2021","Tower Hamlets 019G","E01035682",500,133,10,123,279,1,136,24,103,9,65,52,13,0,65,51,14,12,12,88,24,64
"2021","Tower Hamlets 019H","E01035683",492,113,24,89,250,5,113,20,73,20,52,34,16,2,69,40,29,11,11,129,83,46
"2021","Tower Hamlets 020A","E01004243",462,110,25,85,261,5,153,29,100,24,40,29,9,2,53,34,19,10,10,91,50,41
"2021","Tower Hamlets 020B","E01004244",708,248,72,176,300,16,161,31,108,22,32,12,12,8,79,56,23,12,12,160,37,123
"2021","Tower Hamlets 020C","E01004247",863,199,45,154,488,11,265,62,166,37,67,42,21,4,131,84,47,14,14,176,66,110
"2021","Tower Hamlets 020E","E01035684",506,113,12,101,308,7,148,39,93,16,63,45,11,7,79,50,29,11,11,85,39,46
"2021","Tower Hamlets 020F","E01035685",496,136,53,83,299,10,157,29,114,14,33,9,13,11,96,55,41,3,3,61,29,32
"2021","Tower Hamlets 021A","E01004319",841,223,23,200,397,2,196,30,144,22,87,73,14,0,93,45,48,19,19,221,84,137
"2021","Tower Hamlets 021C","E01004321",845,325,56,269,371,2,173,34,116,23,60,49,11,0,78,47,31,58,58,149,46,103
"2021","Tower Hamlets 021F","E01032767",799,323,12,311,290,2,101,69,27,5,137,129,8,0,17,10,7,33,33,186,8,178
"2021","Tower Hamlets 021G","E01035686",573,158,7,151,212,1,106,28,65,13,49,44,4,1,33,22,11,23,23,203,29,174
"2021","Tower Hamlets 021H","E01035687",677,231,24,207,307,3,116,42,70,4,97,87,9,1,62,54,8,29,29,139,10,129
"2021","Tower Hamlets 021I","E01035688",694,290,3,287,318,2,130,48,79,3,98,96,2,0,38,35,3,50,50,86,3,83
"2021","Tower Hamlets 021J","E01035689",695,254,7,247,322,2,146,53,83,10,104,94,10,0,47,42,5,23,23,119,21,98
"2021","Tower Hamlets 022A","E01004298",566,209,44,165,259,5,122,32,69,21,47,40,6,1,69,41,28,16,16,98,45,53
"2021","Tower Hamlets 022B","E01004300",534,180,55,125,276,9,148,26,95,27,35,23,11,1,73,52,21,11,11,78,29,49
"2021","Tower Hamlets 022C","E01004304",624,166,47,119,318,5,168,30,116,22,51,35,16,0,75,37,38,19,19,140,49,91
"2021","Tower Hamlets 022D","E01004305",665,202,73,129,349,14,182,33,129,20,56,39,11,6,84,40,44,13,13,114,33,81
"2021","Tower Hamlets 023A","E01004251",931,279,51,228,494,9,261,49,190,22,82,59,20,3,125,81,44,17,17,158,48,110
"2021","Tower Hamlets 023C","E01004255",618,204,34,170,293,2,148,32,90,26,63,50,12,1,68,36,32,12,12,121,39,82
"2021","Tower Hamlets 023D","E01004258",691,252,57,195,355,18,193,101,77,15,89,72,17,0,46,21,25,9,9,84,14,70
"2021","Tower Hamlets 023E","E01035690",822,252,9,243,386,4,159,74,74,11,154,144,10,0,50,37,13,19,19,184,32,152
"2021","Tower Hamlets 023F","E01035691",759,229,13,216,367,13,158,68,83,7,127,110,17,0,51,43,8,18,18,163,12,151
"2021","Tower Hamlets 024C","E01004256",599,194,52,142,298,11,159,21,118,20,35,19,14,2,76,43,33,17,17,107,40,67
"2021","Tower Hamlets 024D","E01004257",752,206,32,174,451,11,240,28,172,40,43,27,12,4,139,95,44,18,18,95,38,57
"2021","Tower Hamlets 024E","E01035692",573,150,16,134,331,5,153,65,77,11,84,72,12,0,73,51,22,16,16,92,18,74
"2021","Tower Hamlets 024F","E01035693",618,157,19,138,354,6,160,63,85,12,83,72,9,2,85,67,18,20,20,107,17,90
"2021","Tower Hamlets 024G","E01035694",814,258,35,223,425,4,228,47,161,20,78,65,13,0,100,68,32,15,15,131,41,90
"2021","Tower Hamlets 024H","E01035695",588,177,46,131,329,7,173,22,125,26,20,13,6,1,111,64,47,18,18,82,19,63
"2021","Tower Hamlets 025B","E01004301",478,116,25,91,254,3,139,32,88,19,48,36,10,2,52,23,29,12,12,108,34,74
"2021","Tower Hamlets 025C","E01004302",554,149,7,142,307,1,175,22,134,19,44,34,10,0,72,49,23,15,15,98,38,60
"2021","Tower Hamlets 025D","E01004303",1007,313,67,246,530,18,274,59,193,22,110,83,26,1,111,79,32,17,17,164,53,111
"2021","Tower Hamlets 025E","E01032768",688,254,16,238,347,5,138,73,63,2,161,152,9,0,28,15,13,15,15,87,5,82
"2021","Tower Hamlets 025F","E01032769",632,246,18,228,293,9,153,66,77,10,80,75,5,0,34,17,17,17,17,93,16,77
"2021","Tower Hamlets 026A","E01004292",766,259,36,223,360,16,192,74,101,17,115,104,10,1,23,8,15,14,14,147,12,135
"2021","Tower Hamlets 026C","E01004295",664,165,38,127,373,12,204,29,160,15,63,45,17,1,79,58,21,15,15,126,32,94
"2021","Tower Hamlets 026D","E01004296",1102,416,59,357,554,14,246,89,131,26,190,171,19,0,87,57,30,17,17,132,28,104
"2021","Tower Hamlets 026E","E01035696",602,246,6,240,289,2,130,63,63,4,111,103,7,1,28,22,6,18,18,67,1,66
"2021","Tower Hamlets 026F","E01035697",670,279,23,256,306,3,141,96,36,9,123,117,6,0,23,12,11,16,16,85,13,72
"2021","Tower Hamlets 027A","E01004291",1008,429,66,363,503,26,228,130,91,7,187,162,22,3,38,27,11,24,24,76,7,69
"2021","Tower Hamlets 027B","E01004293",1007,373,74,299,507,29,228,124,81,23,188,156,24,8,45,18,27,17,17,127,20,107
"2021","Tower Hamlets 027C","E01004297",879,310,44,266,450,20,214,118,84,12,149,131,15,3,48,19,29,19,19,119,31,88
"2021","Tower Hamlets 030A","E01004214",635,216,58,158,348,10,149,31,102,16,63,34,20,9,117,70,47,9,9,71,32,39
"2021","Tower Hamlets 030B","E01004216",732,215,63,152,402,9,211,62,131,18,92,69,21,2,67,42,25,23,23,115,20,95
"2021","Tower Hamlets 030C","E01004217",834,243,68,175,465,15,236,82,126,28,96,73,23,0,99,55,44,19,19,126,33,93
"2021","Tower Hamlets 030D","E01004218",788,200,55,145,467,16,253,88,140,25,77,55,18,4,111,40,71,10,10,121,14,107
"2021","Tower Hamlets 031A","E01004274",666,143,25,118,377,11,182,56,97,29,81,63,18,0,90,44,46,13,13,146,52,94
"2021","Tower Hamlets 031B","E01004275",889,203,38,165,557,21,282,61,190,31,117,75,38,4,128,93,35,9,9,129,45,84
"2021","Tower Hamlets 031C","E01004276",959,296,25,271,546,15,303,136,153,14,176,142,31,3,38,29,9,14,14,117,8,109
"2021","Tower Hamlets 031D","E01004281",811,259,17,242,412,2,222,98,114,10,113,92,20,1,56,38,18,19,19,140,36,104
"2021","Tower Hamlets 031F","E01032775",564,178,15,163,336,6,205,81,118,6,91,87,4,0,25,13,12,9,9,50,3,47
"2021","Tower Hamlets 031G","E01032783",582,198,45,153,289,11,129,50,64,15,62,44,14,4,68,38,30,19,19,95,15,80
"2021","Tower Hamlets 032A","E01004280",750,218,46,172,428,14,241,83,131,27,70,57,9,4,89,61,28,14,14,104,36,68
"2021","Tower Hamlets 032B","E01032770",1084,453,34,419,471,7,223,114,94,15,140,129,9,2,60,43,17,41,41,160,24,136
"2021","Tower Hamlets 032C","E01032772",1179,554,29,525,507,13,237,102,118,17,132,113,14,5,97,72,25,28,28,118,38,80
"2021","Tower Hamlets 032E","E01032774",727,186,21,165,413,4,205,96,101,8,67,44,17,6,107,75,32,30,30,128,16,112
"2021","Tower Hamlets 032F","E01035698",479,191,4,187,245,2,123,57,65,1,68,61,6,1,40,30,10,12,12,43,6,37
"2021","Tower Hamlets 032G","E01035699",827,386,3,383,374,2,158,74,78,6,118,105,13,0,73,62,11,23,23,67,17,50
"2021","Tower Hamlets 033A","E01004277",854,330,14,316,420,16,229,147,78,4,122,114,7,1,32,21,11,21,21,104,8,96
"2021","Tower Hamlets 033B","E01032771",779,342,19,323,333,3,173,92,72,9,98,88,8,2,37,24,13,22,22,104,18,86
"2021","Tower Hamlets 033C","E01032781",764,243,13,230,419,9,232,119,100,13,106,88,17,1,46,29,17,26,26,102,19,83
"2021","Tower Hamlets 033D","E01032782",1133,539,14,525,515,1,232,106,95,31,179,165,12,2,73,61,12,30,30,79,14,65
"2021","Tower Hamlets 034D","E01032776",1050,469,4,465,464,3,228,128,93,7,159,143,16,0,46,34,12,28,28,117,20,97
"2021","Tower Hamlets 034A","E01035700",625,240,0,240,305,1,96,81,15,0,176,170,6,0,9,6,3,23,23,80,12,68
"2021","Tower Hamlets 034B","E01035701",665,307,0,307,262,1,98,73,25,0,131,130,1,0,10,7,3,22,22,96,5,91
"2021","Tower Hamlets 034C","E01035702",575,156,3,153,311,2,153,64,83,6,94,82,12,0,48,38,10,14,14,108,24,84
"2021","Tower Hamlets 035B","E01004219",1027,294,20,274,572,3,292,94,177,21,109,90,15,4,134,91,43,34,34,161,48,113
"2021","Tower Hamlets 035A","E01032777",577,206,7,199,297,2,155,73,71,11,65,56,9,0,60,38,22,15,15,74,17,57
"2021","Tower Hamlets 035C","E01032779",658,205,3,202,351,6,171,100,67,4,99,70,26,3,59,40,19,16,16,102,8,94
"2021","Tower Hamlets 035D","E01032780",1010,408,9,399,459,13,217,111,99,7,147,135,12,0,56,37,19,26,26,143,17,126
"2021","Tower Hamlets 036A","E01004221",820,273,47,226,401,10,205,68,117,20,76,60,16,0,88,56,32,22,22,146,24,122
"2021","Tower Hamlets 036B","E01035703",509,262,2,260,189,1,80,53,26,1,83,79,3,1,9,5,4,16,16,58,1,57
"2021","Tower Hamlets 036C","E01035704",594,212,2,210,293,2,138,62,73,3,76,66,10,0,64,55,9,13,13,89,27,62
"2021","Tower Hamlets 036D","E01035705",559,161,39,122,306,12,133,36,78,19,51,38,9,4,91,52,39,19,19,92,25,67
"2021","Tower Hamlets 036E","E01035706",562,161,8,153,320,6,166,73,81,12,90,72,16,2,33,29,4,25,25,81,12,69
"2021","Waltham Forest 001A","E01004349",552,119,58,61,380,39,192,43,109,40,42,11,21,10,103,48,55,4,4,53,30,23
"2021","Waltham Forest 001B","E01004350",920,432,309,123,432,83,177,39,94,44,64,31,27,6,103,55,48,5,5,56,28,28
"2021","Waltham Forest 001C","E01004351",637,149,85,64,451,74,232,55,119,58,70,36,24,10,69,28,41,6,6,37,21,16
"2021","Waltham Forest 001D","E01004356",594,121,65,56,400,53,214,36,110,68,36,13,16,7,91,46,45,6,6,73,42,31
"2021","Waltham Forest 001E","E01004357",576,141,72,69,377,62,176,35,89,52,56,20,27,9,76,39,37,7,7,58,32,26
"2021","Waltham Forest 002A","E01004352",794,266,130,136,473,83,250,86,109,55,72,39,26,7,64,24,40,4,4,55,21,34
"2021","Waltham Forest 002B","E01004353",792,252,125,127,495,88,246,68,117,61,80,45,26,9,77,37,40,4,4,45,15,30
"2021","Waltham Forest 002C","E01004354",775,205,70,135,517,50,270,69,151,50,97,51,40,6,92,53,39,8,8,53,26,27
"2021","Waltham Forest 002D","E01004358",881,351,139,212,463,47,230,61,127,42,76,42,34,0,101,64,37,9,9,67,31,36
"2021","Waltham Forest 002E","E01004359",599,121,65,56,427,48,255,52,132,71,55,26,22,7,66,30,36,3,3,51,33,18
"2021","Waltham Forest 003A","E01004384",747,206,85,121,477,25,198,40,113,45,69,24,37,8,179,101,78,6,6,64,35,29
"2021","Waltham Forest 003B","E01004385",654,237,96,141,373,33,156,30,90,36,72,31,37,4,102,66,36,10,10,44,22,22
"2021","Waltham Forest 003C","E01004386",648,152,92,60,438,66,251,74,122,55,64,30,27,7,52,16,36,5,5,58,28,30
"2021","Waltham Forest 003D","E01004389",691,205,83,122,428,46,187,46,95,46,74,36,29,9,114,54,60,7,7,58,31,27
"2021","Waltham Forest 003E","E01004390",628,182,84,98,396,25,198,46,108,44,46,22,19,5,120,59,61,7,7,50,26,24
"2021","Waltham Forest 004A","E01004355",681,190,79,111,432,37,202,48,106,48,60,20,33,7,124,87,37,9,9,59,30,29
"2021","Waltham Forest 004B","E01004360",479,91,59,32,338,73,179,42,84,53,38,13,22,3,43,21,22,5,5,50,27,23
"2021","Waltham Forest 004C","E01004413",703,285,154,131,368,34,137,36,64,37,67,29,27,11,128,56,72,2,2,50,29,21
"2021","Waltham Forest 004D","E01004415",621,190,106,84,355,40,188,45,92,51,32,18,11,3,89,35,54,6,6,76,47,29
"2021","Waltham Forest 004E","E01004416",718,189,69,120,475,52,249,62,138,49,84,49,26,9,86,43,43,4,4,54,26,28
"2021","Waltham Forest 005A","E01004361",495,102,61,41,351,50,207,52,100,55,45,19,20,6,48,18,30,1,1,42,25,17
"2021","Waltham Forest 005B","E01004414",636,141,75,66,403,33,217,44,115,58,47,21,24,2,89,51,38,17,17,92,54,38
"2021","Waltham Forest 005C","E01004417",700,192,98,94,442,57,246,52,130,64,47,22,20,5,85,41,44,7,7,66,31,35
"2021","Waltham Forest 005D","E01004451",632,131,66,65,427,58,241,60,108,73,38,11,20,7,86,49,37,4,4,74,44,30
"2021","Waltham Forest 005E","E01004452",767,255,123,132,440,36,218,53,125,40,84,40,33,11,94,58,36,8,8,72,37,35
"2021","Waltham Forest 006A","E01004450",606,123,75,48,420,56,234,41,136,57,44,14,20,10,78,31,47,8,8,63,36,27
"2021","Waltham Forest 006B","E01004453",658,175,52,123,380,43,195,46,106,43,44,19,21,4,93,58,35,5,5,103,60,43
"2021","Waltham Forest 006C","E01004454",687,169,83,86,433,29,213,46,132,35,51,20,28,3,130,80,50,10,10,85,55,30
"2021","Waltham Forest 006D","E01004455",604,142,58,84,370,27,178,33,107,38,50,25,23,2,103,56,47,12,12,92,41,51
"2021","Waltham Forest 006E","E01004456",561,123,47,76,353,16,135,25,60,50,35,7,16,12,159,83,76,8,8,85,56,29
"2021","Waltham Forest 007A","E01004379",727,154,45,109,514,31,272,65,143,64,118,66,49,3,84,35,49,9,9,59,24,35
"2021","Waltham Forest 007B","E01004380",625,137,54,83,426,46,214,45,124,45,72,30,34,8,86,55,31,8,8,62,38,24
"2021","Waltham Forest 007C","E01004381",741,138,41,97,538,45,282,85,144,53,104,60,37,7,104,57,47,3,3,65,31,34
"2021","Waltham Forest 007D","E01004383",582,103,51,52,426,45,253,51,145,57,51,19,30,2,71,35,36,6,6,53,29,24
"2021","Waltham Forest 007E","E01004387",523,80,49,31,414,67,259,64,121,74,47,15,25,7,39,17,22,2,2,29,15,14
"2021","Waltham Forest 007F","E01004388",660,190,60,130,410,42,197,58,105,34,75,35,33,7,83,59,24,13,13,60,27,33
"2021","Waltham Forest 008A","E01004343",650,123,50,73,453,39,264,61,135,68,66,36,23,7,78,43,35,6,6,74,37,37
"2021","Waltham Forest 008B","E01004344",662,146,44,102,436,16,208,40,128,40,79,36,41,2,129,79,50,4,4,80,51,29
"2021","Waltham Forest 008C","E01004382",628,157,38,119,417,14,183,31,117,35,54,28,21,5,156,102,54,10,10,54,36,18
"2021","Waltham Forest 008D","E01004418",650,141,55,86,426,41,204,51,113,40,63,20,36,7,108,67,41,10,10,83,39,44
"2021","Waltham Forest 008E","E01004419",925,232,48,184,573,30,308,55,193,60,101,53,39,9,126,93,33,8,8,120,67,53
"2021","Waltham Forest 009A","E01004398",666,144,69,75,403,15,170,28,91,51,51,20,26,5,154,76,78,13,13,119,64,55
"2021","Waltham Forest 009B","E01004399",595,108,39,69,380,11,157,32,90,35,53,14,31,8,147,82,65,12,12,107,67,40
"2021","Waltham Forest 009C","E01004400",655,133,42,91,427,11,221,49,131,41,89,47,35,7,98,50,48,8,8,95,45,50
"2021","Waltham Forest 009D","E01004402",655,136,60,76,430,20,195,33,121,41,88,46,32,10,114,63,51,13,13,89,38,51
"2021","Waltham Forest 009E","E01004403",898,186,45,141,594,20,289,72,182,35,130,71,53,6,141,93,48,14,14,118,62,56
"2021","Waltham Forest 010A","E01004345",615,127,45,82,384,16,203,37,131,35,72,45,23,4,80,41,39,13,13,104,43,61
"2021","Waltham Forest 010B","E01004348",1197,391,56,335,673,15,297,77,180,40,162,107,50,5,183,123,60,16,16,133,57,76
"2021","Waltham Forest 010C","E01004377",617,114,53,61,417,43,241,58,138,45,53,23,25,5,77,47,30,3,3,86,51,35
"2021","Waltham Forest 010D","E01004378",674,163,47,116,424,37,204,37,128,39,77,42,32,3,95,47,48,11,11,87,38,49
"2021","Waltham Forest 011A","E01004342",715,153,42,111,449,21,225,51,138,36,76,38,38,0,118,70,48,9,9,113,59,54
"2021","Waltham Forest 011B","E01004346",567,80,41,39,404,21,228,39,140,49,69,24,39,6,81,52,29,5,5,83,47,36
"2021","Waltham Forest 011C","E01004347",802,172,64,108,530,17,257,59,176,22,140,80,58,2,106,70,36,10,10,100,40,60
"2021","Waltham Forest 011D","E01004460",700,146,45,101,397,17,193,46,116,31,75,43,28,4,103,57,46,9,9,157,81,76
"2021","Waltham Forest 011E","E01004462",832,197,68,129,501,11,303,83,190,30,97,65,30,2,73,43,30,17,17,134,56,78
"2021","Waltham Forest 012A","E01004396",698,135,50,85,431,13,205,60,115,30,105,63,41,1,87,37,50,21,21,132,61,71
"2021","Waltham Forest 012B","E01004457",753,181,36,145,480,10,195,64,109,22,178,133,42,3,85,50,35,12,12,92,32,60
"2021","Waltham Forest 012C","E01004458",760,177,41,136,469,17,226,78,122,26,93,57,30,6,117,58,59,16,16,114,40,74
"2021","Waltham Forest 012D","E01004459",521,90,37,53,368,9,145,22,95,28,47,14,30,3,164,84,80,3,3,63,41,22
"2021","Waltham Forest 012E","E01004463",893,254,51,203,557,8,196,48,131,17,196,151,41,4,142,113,29,15,15,82,19,63
"2021","Waltham Forest 013A","E01004407",664,279,47,232,310,5,107,23,65,19,61,35,23,3,129,88,41,8,8,75,52,23
"2021","Waltham Forest 013B","E01004410",824,337,117,220,423,14,171,49,98,24,121,82,35,4,107,71,36,10,10,64,25,39
"2021","Waltham Forest 013C","E01004464",682,205,28,177,418,8,170,50,106,14,84,57,25,2,145,106,39,11,11,59,29,30
"2021","Waltham Forest 013D","E01004469",640,140,47,93,423,9,177,27,122,28,62,34,26,2,166,108,58,9,9,77,45,32
"2021","Waltham Forest 013E","E01004470",596,159,52,107,375,10,189,45,119,25,74,41,33,0,93,63,30,9,9,62,24,38
"2021","Waltham Forest 013F","E01004471",657,164,42,122,415,19,174,37,113,24,92,52,34,6,120,84,36,10,10,78,30,48
"2021","Waltham Forest 014A","E01004391",977,331,52,279,558,13,181,57,105,19,204,159,41,4,129,95,34,31,31,88,39,49
"2021","Waltham Forest 014B","E01004393",769,270,93,177,404,11,137,47,72,18,121,99,20,2,120,82,38,15,15,95,30,65
"2021","Waltham Forest 014C","E01004401",890,213,55,158,568,15,284,78,176,30,138,89,45,4,110,70,40,21,21,109,47,62
"2021","Waltham Forest 014D","E01004404",1105,346,59,287,658,8,274,64,174,36,138,83,53,2,227,173,54,11,11,101,54,47
"2021","Waltham Forest 014F","E01034485",768,173,51,122,450,21,241,88,116,37,102,69,29,4,71,36,35,15,15,145,34,111
"2021","Waltham Forest 014G","E01034486",737,240,3,237,407,0,125,83,41,1,233,215,18,0,30,24,6,19,19,90,8,82
"2021","Waltham Forest 015A","E01004412",751,204,50,154,482,22,187,63,102,22,193,132,60,1,74,41,33,6,6,65,21,44
"2021","Waltham Forest 015B","E01004465",570,129,39,90,368,21,215,49,126,40,63,23,34,6,65,34,31,4,4,73,35,38
"2021","Waltham Forest 015C","E01004466",672,165,56,109,434,16,234,69,140,25,112,72,37,3,66,35,31,6,6,73,24,49
"2021","Waltham Forest 015D","E01004467",910,270,60,210,539,9,245,74,140,31,117,70,42,5,154,116,38,14,14,101,47,54
"2021","Waltham Forest 015E","E01004468",667,163,48,115,416,30,236,63,135,38,81,50,30,1,59,36,23,10,10,88,44,44
"2021","Waltham Forest 016A","E01004406",735,219,40,179,405,13,184,54,106,24,96,77,17,2,98,48,50,14,14,111,43,68
"2021","Waltham Forest 016B","E01004408",708,184,50,134,441,16,200,65,106,29,112,82,29,1,103,61,42,10,10,83,19,64
"2021","Waltham Forest 016C","E01004409",752,242,81,161,428,20,167,61,83,23,119,92,25,2,110,88,22,12,12,82,24,58
"2021","Waltham Forest 016D","E01004411",767,175,31,144,464,11,208,54,127,27,171,102,68,1,59,35,24,15,15,128,40,88
"2021","Waltham Forest 016E","E01004443",783,193,31,162,447,17,197,45,115,37,134,101,28,5,81,56,25,18,18,143,52,91
"2021","Waltham Forest 016F","E01004447",651,145,39,106,401,20,220,53,124,43,95,63,31,1,55,27,28,11,11,105,35,70
"2021","Waltham Forest 017A","E01004392",985,250,41,209,594,11,268,68,159,41,167,131,33,3,118,74,44,30,30,141,61,80
"2021","Waltham Forest 017B","E01004394",789,227,53,174,443,17,174,53,89,32,106,74,31,1,128,75,53,18,18,119,50,69
"2021","Waltham Forest 017C","E01004397",1131,287,50,237,651,10,292,108,145,39,191,149,34,8,129,80,49,29,29,193,69,124
"2021","Waltham Forest 017D","E01004444",1150,332,51,281,630,15,241,84,122,35,192,156,36,0,156,104,52,26,26,188,67,121
"2021","Waltham Forest 017E","E01004446",798,147,49,98,489,19,243,53,159,31,121,79,38,4,88,55,33,18,18,162,89,73
"2021","Waltham Forest 018A","E01004395",595,112,40,72,387,28,200,46,122,32,97,55,39,3,58,24,34,4,4,96,40,56
"2021","Waltham Forest 018B","E01004421",597,94,38,56,342,24,192,24,114,54,53,39,13,1,60,14,46,13,13,161,88,73
"2021","Waltham Forest 018C","E01004445",679,144,44,100,408,23,186,47,115,24,102,71,28,3,85,39,46,12,12,127,78,49
"2021","Waltham Forest 018D","E01004448",765,196,33,163,476,12,214,77,112,25,129,82,44,3,111,74,37,10,10,93,36,57
"2021","Waltham Forest 018E","E01004449",637,170,54,116,374,20,142,18,85,39,44,19,19,6,160,82,78,8,8,93,50,43
"2021","Waltham Forest 019A","E01004363",519,92,44,48,342,31,184,38,105,41,53,20,29,4,62,33,29,12,12,85,49,36
"2021","Waltham Forest 019B","E01004364",620,112,37,75,394,19,200,33,117,50,59,26,26,7,108,63,45,8,8,114,55,59
"2021","Waltham Forest 019C","E01004366",667,154,63,91,407,42,217,44,110,63,77,42,34,1,59,19,40,12,12,106,52,54
"2021","Waltham Forest 019D","E01004367",533,123,39,84,316,11,185,46,107,32,53,30,21,2,53,28,25,14,14,94,46,48
"2021","Waltham Forest 019E","E01004368",779,234,48,186,407,24,196,49,106,41,94,54,37,3,72,40,32,21,21,138,87,51
"2021","Waltham Forest 020A","E01004365",795,190,40,150,434,16,201,70,104,27,60,33,26,1,136,81,55,21,21,171,105,66
"2021","Waltham Forest 020B","E01004405",608,142,32,110,370,15,203,47,126,30,63,41,20,2,79,44,35,10,10,96,33,63
"2021","Waltham Forest 020C","E01004420",736,186,43,143,404,15,203,53,101,49,51,31,14,6,119,55,64,16,16,146,63,83
"2021","Waltham Forest 020D","E01004423",717,203,64,139,394,12,169,36,97,36,77,38,37,2,125,79,46,11,11,120,68,52
"2021","Waltham Forest 020H","E01034487",458,118,22,96,282,8,116,25,75,16,60,41,16,3,88,51,37,10,10,58,34,24
"2021","Waltham Forest 020I","E01034488",663,196,41,155,402,12,159,25,98,36,48,25,19,4,172,117,55,11,11,65,47,18
"2021","Waltham Forest 021A","E01004362",677,210,57,153,390,26,187,43,115,29,100,69,30,1,62,39,23,15,15,77,26,51
"2021","Waltham Forest 021B","E01004436",576,169,37,132,320,16,153,38,82,33,80,55,21,4,66,32,34,5,5,87,32,55
"2021","Waltham Forest 021C","E01004437",748,266,68,198,373,10,152,52,80,20,114,66,46,2,83,56,27,14,14,109,38,71
"2021","Waltham Forest 021D","E01004439",662,207,46,161,368,19,145,45,75,25,96,60,32,4,85,45,40,23,23,87,32,55
"2021","Waltham Forest 021E","E01004442",617,153,37,116,393,25,176,52,84,40,122,87,32,3,58,30,28,12,12,71,23,48
"2021","Waltham Forest 022A","E01004422",984,254,37,217,579,27,258,63,144,51,145,98,43,4,125,81,44,24,24,151,67,84
"2021","Waltham Forest 022B","E01004424",735,215,33,182,382,9,168,37,91,40,72,43,25,4,117,64,53,16,16,138,74,64
"2021","Waltham Forest 022C","E01004425",835,232,39,193,511,7,196,58,113,25,152,97,51,4,137,99,38,19,19,92,28,64
"2021","Waltham Forest 022D","E01004426",602,134,41,93,336,18,177,30,96,51,46,27,17,2,80,34,46,15,15,132,56,76
"2021","Waltham Forest 022E","E01004427",828,242,45,197,468,9,209,61,123,25,132,93,37,2,109,73,36,9,9,118,36,82
"2021","Waltham Forest 023A","E01004369",636,127,23,104,393,16,179,46,107,26,115,81,32,2,73,40,33,10,10,116,47,69
"2021","Waltham Forest 023B","E01004370",805,179,42,137,497,12,248,71,134,43,147,103,40,4,71,48,23,19,19,129,51,78
"2021","Waltham Forest 023C","E01004372",690,170,41,129,419,5,186,75,95,16,150,115,33,2,61,30,31,17,17,101,31,70
"2021","Waltham Forest 023D","E01004432",708,165,53,112,428,22,228,56,141,31,80,58,19,3,84,47,37,14,14,115,52,63
"2021","Waltham Forest 023E","E01004435",818,248,56,192,454,13,191,56,117,18,106,67,37,2,129,70,59,15,15,116,49,67
"2021","Waltham Forest 024A","E01004333",583,155,38,117,343,15,170,23,130,17,58,29,26,3,91,69,22,9,9,85,42,43
"2021","Waltham Forest 024B","E01004334",616,196,70,126,322,10,113,23,74,16,41,21,19,1,147,93,54,11,11,98,78,20
"2021","Waltham Forest 024C","E01004438",794,181,37,144,481,14,226,90,93,43,141,106,30,5,73,39,34,27,27,132,46,86
"2021","Waltham Forest 024D","E01004440",806,217,45,172,455,15,203,71,102,30,98,64,30,4,109,75,34,30,30,134,34,100
"2021","Waltham Forest 024E","E01004441",608,168,54,114,345,24,186,55,99,32,80,57,16,7,49,33,16,6,6,95,30,65
"2021","Waltham Forest 025A","E01004371",608,143,36,107,349,21,145,43,82,20,85,52,32,1,84,44,40,14,14,116,44,72
"2021","Waltham Forest 025B","E01004373",677,180,39,141,380,17,169,44,105,20,92,62,29,1,79,41,38,23,23,117,42,75
"2021","Waltham Forest 025C","E01004374",703,155,41,114,399,25,204,59,115,30,91,58,30,3,73,30,43,6,6,149,48,101
"2021","Waltham Forest 025D","E01004375",709,158,35,123,433,13,233,90,107,36,98,72,24,2,73,37,36,16,16,118,46,72
"2021","Waltham Forest 025E","E01004376",659,164,39,125,334,13,148,43,67,38,72,51,19,2,79,34,45,22,22,161,61,100
"2021","Waltham Forest 026A","E01004336",583,182,77,105,247,5,103,29,51,23,67,42,23,2,59,30,29,13,13,154,39,115
"2021","Waltham Forest 026B","E01004428",710,181,48,133,440,9,195,32,115,48,43,16,15,12,182,102,80,11,11,89,48,41
"2021","Waltham Forest 026C","E01004429",699,204,37,167,400,17,156,42,83,31,67,46,20,1,147,83,64,13,13,95,43,52
"2021","Waltham Forest 026D","E01004430",1076,324,61,263,543,17,239,84,116,39,154,130,23,1,105,60,45,28,28,209,54,155
"2021","Waltham Forest 026E","E01004434",748,211,75,136,421,13,201,30,129,42,70,40,28,2,123,88,35,14,14,116,50,66
"2021","Waltham Forest 027A","E01004335",608,159,33,126,361,7,135,23,73,39,45,21,20,4,166,95,71,8,8,88,50,38
"2021","Waltham Forest 027B","E01004337",646,171,63,108,370,21,147,27,93,27,56,33,21,2,131,53,78,15,15,105,35,70
"2021","Waltham Forest 027C","E01004338",644,128,33,95,337,19,139,37,75,27,77,58,18,1,80,36,44,22,22,179,67,112
"2021","Waltham Forest 027D","E01004339",697,159,35,124,431,9,188,54,106,28,150,82,61,7,72,41,31,12,12,107,32,75
"2021","Waltham Forest 027E","E01004340",715,204,58,146,410,13,156,39,84,33,53,41,11,1,173,97,76,15,15,101,46,55
"2021","Waltham Forest 027F","E01004341",742,246,66,180,394,18,129,31,67,31,107,50,13,44,124,76,48,16,16,102,52,50
"2021","Waltham Forest 028A","E01004327",475,138,62,76,238,14,110,27,62,21,46,26,14,6,62,31,31,6,6,99,72,27
"2021","Waltham Forest 028B","E01004328",659,142,35,107,396,14,178,43,106,29,84,50,30,4,107,59,48,13,13,121,47,74
"2021","Waltham Forest 028C","E01004329",642,155,41,114,368,10,159,37,100,22,88,58,28,2,98,54,44,13,13,119,58,61
"2021","Waltham Forest 028D","E01004330",611,130,52,78,372,20,197,56,113,28,74,40,29,5,72,32,40,9,9,109,46,63
"2021","Waltham Forest 028E","E01004331",604,130,39,91,378,17,150,33,97,20,89,58,27,4,109,62,47,13,13,96,46,50
"2021","Waltham Forest 028F","E01004332",650,166,28,138,333,13,168,40,98,30,62,36,23,3,84,54,30,6,6,151,57,94
"2021","Wandsworth 001A","E01004560",880,291,67,224,446,16,203,82,96,25,120,102,17,1,94,72,22,13,13,143,19,124
"2021","Wandsworth 001B","E01004566",785,298,96,202,356,18,147,61,71,15,124,110,11,3,47,26,21,20,20,131,30,101
"2021","Wandsworth 001C","E01004582",986,334,157,177,460,77,200,63,111,26,98,79,16,3,66,34,32,19,19,192,18,174
"2021","Wandsworth 001D","E01004583",815,331,136,195,373,46,149,64,64,21,87,76,10,1,73,48,25,18,18,111,8,103
"2021","Wandsworth 003A","E01004539",780,212,50,162,457,9,171,20,116,35,57,33,17,7,209,135,74,11,11,111,28,83
"2021","Wandsworth 003B","E01004540",1046,359,89,270,530,22,203,89,96,18,151,119,24,8,134,78,56,20,20,157,14,143
"2021","Wandsworth 003C","E01004577",819,298,105,193,375,23,196,59,118,19,85,69,15,1,52,34,18,19,19,146,15,131
"2021","Wandsworth 003D","E01004584",717,193,28,165,424,12,112,26,63,23,49,33,13,3,229,131,98,22,22,100,25,75
"2021","Wandsworth 004B","E01004579",826,284,81,203,431,33,191,64,103,24,100,85,13,2,95,50,45,12,12,111,12,99
"2021","Wandsworth 004C","E01004580",893,293,51,242,403,9,170,52,96,22,107,87,18,2,87,50,37,30,30,197,19,178
"2021","Wandsworth 004D","E01004581",837,313,99,214,372,27,157,63,74,20,105,84,21,0,68,31,37,15,15,152,13,139
"2021","Wandsworth 004E","E01033099",911,314,39,275,459,9,165,86,65,14,132,121,10,1,128,83,45,25,25,138,14,124
"2021","Wandsworth 004G","E01033133",648,266,29,237,315,7,114,61,41,12,127,115,11,1,48,31,17,19,19,67,3,64
"2021","Wandsworth 004H","E01035488",745,244,48,196,404,20,170,89,65,16,160,140,17,3,39,19,20,15,15,97,2,95
"2021","Wandsworth 004I","E01035489",693,300,20,280,325,5,124,47,69,8,137,119,17,1,45,31,14,14,14,68,10,58
"2021","Wandsworth 005A","E01004565",780,217,59,158,401,10,147,72,65,10,139,130,8,1,78,41,37,27,27,162,16,146
"2021","Wandsworth 005B","E01004590",814,262,96,166,435,35,184,60,90,34,81,59,15,7,118,60,58,17,17,117,14,103
"2021","Wandsworth 005C","E01004591",859,264,66,198,404,20,143,49,82,12,128,105,20,3,95,52,43,18,18,191,17,174
"2021","Wandsworth 005D","E01004592",778,266,90,176,414,22,159,52,76,31,102,82,19,1,121,65,56,10,10,98,15,83
"2021","Wandsworth 006A","E01004604",592,114,51,63,417,57,276,65,172,39,41,31,9,1,42,18,24,1,1,61,15,46
"2021","Wandsworth 006B","E01004605",806,282,121,161,439,45,224,54,142,28,79,61,16,2,85,46,39,6,6,85,17,68
"2021","Wandsworth 006C","E01004606",753,215,47,168,446,27,222,86,124,12,152,134,16,2,33,21,12,12,12,92,6,86
"2021","Wandsworth 006D","E01004607",691,193,62,131,407,51,229,58,134,37,91,82,9,0,32,19,13,4,4,91,16,75
"2021","Wandsworth 006E","E01004608",789,275,103,172,377,27,164,58,85,21,106,94,8,4,70,31,39,10,10,137,14,123
"2021","Wandsworth 007A","E01004535",707,204,39,165,443,3,158,57,78,23,37,20,13,4,229,171,58,16,16,60,30,30
"2021","Wandsworth 007B","E01004537",931,343,78,265,438,4,138,40,72,26,97,84,12,1,173,112,61,26,26,150,26,124
"2021","Wandsworth 007C","E01004538",1084,331,103,228,592,14,187,75,94,18,169,132,29,8,199,91,108,23,23,161,24,137
"2021","Wandsworth 007D","E01004541",769,293,112,181,385,15,127,40,65,22,55,46,7,2,163,85,78,25,25,91,25,66
"2021","Wandsworth 008A","E01004534",789,223,68,155,369,25,183,52,120,11,89,78,10,1,57,31,26,15,15,197,15,182
"2021","Wandsworth 008B","E01004536",881,287,60,227,429,6,138,33,84,21,108,91,14,3,143,102,41,34,34,165,14,151
"2021","Wandsworth 008C","E01004552",887,240,29,211,385,8,152,60,83,9,163,152,10,1,29,14,15,33,33,262,6,256
"2021","Wandsworth 008D","E01004585",824,226,68,158,412,16,160,64,79,17,154,137,15,2,58,35,23,24,24,186,13,173
"2021","Wandsworth 008E","E01004588",882,235,47,188,439,12,224,109,103,12,148,132,16,0,28,14,14,27,27,208,13,195
"2021","Wandsworth 009A","E01004554",620,128,33,95,383,20,229,50,161,18,95,82,13,0,30,21,9,9,9,109,16,93
"2021","Wandsworth 009B","E01004556",586,110,36,74,411,20,284,54,215,15,59,36,19,4,42,26,16,6,6,65,12,53
"2021","Wandsworth 009C","E01004586",854,255,44,211,393,16,162,61,82,19,142,123,18,1,46,21,25,27,27,206,12,194
"2021","Wandsworth 009D","E01004587",699,155,48,107,387,18,221,64,137,20,97,78,17,2,35,18,17,16,16,157,27,130
"2021","Wandsworth 009E","E01004589",735,157,28,129,415,10,211,62,137,12,126,105,18,3,49,26,23,19,19,163,14,149
"2021","Wandsworth 010B","E01004511",651,144,36,108,369,11,175,57,104,14,111,92,18,1,54,29,25,18,18,138,9,129
"2021","Wandsworth 010C","E01004602",712,179,41,138,421,57,179,58,105,16,141,125,14,2,36,23,13,8,8,112,20,92
"2021","Wandsworth 010E","E01004609",1013,344,82,262,496,19,213,80,108,25,199,181,18,0,44,21,23,21,21,173,14,159
"2021","Wandsworth 010G","E01033135",464,98,25,73,289,15,157,39,106,12,72,61,11,0,34,12,22,11,11,77,6,71
"2021","Wandsworth 010H","E01035490",779,230,47,183,473,39,252,101,98,53,119,96,20,3,48,37,11,15,15,76,6,70
"2021","Wandsworth 010I","E01035491",620,204,27,177,290,6,109,51,54,4,114,101,13,0,35,17,18,26,26,126,4,122
"2021","Wandsworth 010J","E01035492",852,294,17,277,478,8,198,87,106,5,200,171,29,0,47,30,17,25,25,80,5,75
"2021","Wandsworth 010K","E01035493",831,306,54,252,412,17,126,50,67,9,170,157,12,1,78,55,23,21,21,113,7,106
"2021","Wandsworth 011A","E01004506",1104,401,109,292,550,37,247,113,115,19,204,188,14,2,43,22,21,19,19,153,10,143
"2021","Wandsworth 011B","E01004638",501,84,51,33,375,64,241,64,124,53,33,19,14,0,34,15,19,3,3,42,20,22
"2021","Wandsworth 011C","E01004639",771,264,86,178,428,30,229,74,124,31,95,82,12,1,55,28,27,19,19,79,15,64
"2021","Wandsworth 011D","E01004640",770,261,77,184,430,41,217,70,124,23,127,110,15,2,34,11,23,11,11,79,14,65
"2021","Wandsworth 011E","E01004641",790,251,124,127,444,38,240,65,122,53,67,50,17,0,90,55,35,9,9,95,21,74
"2021","Wandsworth 012A","E01004508",978,314,57,257,493,23,171,81,72,18,201,191,10,0,67,23,44,31,31,171,7,164
"2021","Wandsworth 012B","E01004510",862,286,45,241,452,23,179,75,92,12,172,156,13,3,55,25,30,23,23,124,14,110
"2021","Wandsworth 012C","E01004514",799,240,56,184,428,24,221,79,128,14,120,103,16,1,49,26,23,14,14,131,14,117
"2021","Wandsworth 012D","E01004515",768,259,48,211,354,13,127,47,53,27,136,123,10,3,60,30,30,18,18,155,16,139
"2021","Wandsworth 012E","E01004551",787,311,45,266,342,8,112,60,45,7,143,130,9,4,64,30,34,15,15,134,11,123
"2021","Wandsworth 013A","E01004568",456,134,40,94,297,4,133,36,80,17,26,9,17,0,130,97,33,4,4,25,12,13
"2021","Wandsworth 013B","E01004574",702,206,42,164,420,5,143,21,95,27,46,6,32,8,219,167,52,7,7,76,23,53
"2021","Wandsworth 013C","E01004575",681,273,141,132,325,36,117,29,72,16,38,26,9,3,126,73,53,8,8,83,22,61
"2021","Wandsworth 013D","E01004576",595,182,65,117,322,19,160,32,101,27,27,8,14,5,111,79,32,5,5,91,36,55
"2021","Wandsworth 014A","E01004500",984,412,124,288,413,21,166,67,84,15,151,138,12,1,56,28,28,19,19,159,9,150
"2021","Wandsworth 014B","E01004501",664,228,84,144,333,23,166,47,79,40,66,56,9,1,65,39,26,13,13,103,15,88
"2021","Wandsworth 014C","E01004503",718,224,60,164,391,19,191,73,92,26,109,95,9,5,58,30,28,14,14,103,13,90
"2021","Wandsworth 014D","E01004505",783,275,102,173,404,38,191,80,99,12,99,79,19,1,43,28,15,33,33,104,17,87
"2021","Wandsworth 014E","E01004507",1239,425,88,337,651,21,300,117,159,24,231,205,24,2,80,53,27,19,19,163,16,147
"2021","Wandsworth 015A","E01004553",776,232,55,177,392,9,184,54,116,14,132,120,10,2,50,28,22,17,17,152,13,139
"2021","Wandsworth 015B","E01004557",661,155,45,110,425,20,217,48,151,18,127,66,60,1,49,27,22,12,12,81,15,66
"2021","Wandsworth 015C","E01004558",671,126,36,90,461,17,281,53,201,27,99,69,25,5,57,38,19,7,7,84,17,67
"2021","Wandsworth 015D","E01004559",519,89,32,57,354,18,254,60,167,27,47,39,8,0,31,19,12,4,4,76,15,61
"2021","Wandsworth 015E","E01004619",504,109,25,84,335,18,220,50,131,39,52,43,7,2,42,22,20,3,3,60,22,38
"2021","Wandsworth 016A","E01004572",667,196,69,127,382,40,187,66,102,19,55,31,23,1,94,56,38,6,6,89,32,57
"2021","Wandsworth 016B","E01004642",828,236,102,134,488,31,239,61,146,32,102,72,25,5,112,52,60,4,4,104,27,77
"2021","Wandsworth 016C","E01004643",972,298,100,198,552,39,254,65,158,31,104,68,32,4,133,90,43,22,22,122,36,86
"2021","Wandsworth 016D","E01004644",1062,351,131,220,609,53,340,103,195,42,94,67,23,4,114,47,67,8,8,102,33,69
"2021","Wandsworth 016E","E01004645",814,262,95,167,450,36,170,28,114,28,64,38,25,1,164,99,65,16,16,102,29,73
"2021","Wandsworth 017A","E01004477",610,127,64,63,394,46,244,57,158,29,57,38,18,1,39,17,22,8,8,89,32,57
"2021","Wandsworth 017B","E01004478",521,87,32,55,353,24,259,38,191,30,37,21,16,0,29,14,15,4,4,81,21,60
"2021","Wandsworth 017C","E01004479",609,156,46,110,365,28,230,59,131,40,67,57,10,0,32,18,14,8,8,88,10,78
"2021","Wandsworth 017D","E01004550",519,151,61,90,316,19,155,47,89,19,57,48,7,2,81,67,14,4,4,52,7,45
"2021","Wandsworth 017E","E01004555",580,95,39,56,409,23,282,46,209,27,64,38,23,3,28,18,10,12,12,76,22,54
"2021","Wandsworth 018A","E01004494",802,243,44,199,441,18,183,65,97,21,123,100,21,2,87,55,32,30,30,118,19,99
"2021","Wandsworth 018B","E01004513",845,234,63,171,478,18,156,54,82,20,179,152,27,0,108,73,35,17,17,133,22,111
"2021","Wandsworth 018D","E01004601",1095,381,96,285,563,21,267,91,148,28,176,148,24,4,80,45,35,19,19,151,26,125
"2021","Wandsworth 018E","E01035494",957,361,15,346,475,4,152,83,59,10,237,224,13,0,56,25,31,26,26,121,8,113
"2021","Wandsworth 018F","E01035495",510,147,26,121,314,10,100,18,44,38,30,14,11,5,168,112,56,6,6,49,22,27
"2021","Wandsworth 019A","E01004493",846,259,54,205,460,16,224,71,129,24,146,128,16,2,61,39,22,13,13,127,21,106
"2021","Wandsworth 019B","E01004512",608,173,39,134,368,23,204,64,125,15,86,75,9,2,40,20,20,15,15,67,18,49
"2021","Wandsworth 019C","E01004620",681,177,50,127,405,23,212,51,139,22,111,94,17,0,48,23,25,11,11,99,39,60
"2021","Wandsworth 019D","E01004621",696,185,52,133,397,27,204,59,118,27,106,82,20,4,51,26,25,9,9,114,26,88
"2021","Wandsworth 019E","E01004623",705,163,48,115,434,20,235,60,154,21,108,88,18,2,60,33,27,11,11,108,18,90
"2021","Wandsworth 019F","E01004627",603,130,36,94,372,31,233,49,158,26,59,46,12,1,44,22,22,5,5,101,15,86
"2021","Wandsworth 020A","E01004499",705,205,53,152,367,22,156,52,86,18,124,106,18,0,48,29,19,17,17,133,17,116
"2021","Wandsworth 020B","E01004502",684,183,50,133,418,36,237,71,133,33,103,88,13,2,34,17,17,8,8,83,17,66
"2021","Wandsworth 020C","E01004504",554,106,51,55,382,33,263,72,152,39,48,35,13,0,29,18,11,9,9,66,16,50
"2021","Wandsworth 020D","E01004594",631,120,55,65,414,34,277,70,171,36,45,33,11,1,51,31,20,7,7,97,20,77
"2021","Wandsworth 020E","E01004596",640,156,66,90,420,28,273,65,177,31,72,48,21,3,36,15,21,11,11,64,17,47
"2021","Wandsworth 020F","E01004629",605,134,66,68,373,50,221,58,125,38,47,33,11,3,44,26,18,11,11,98,28,70
"2021","Wandsworth 021A","E01004472",756,217,64,153,392,29,210,58,118,34,91,80,11,0,50,23,27,12,12,147,16,131
"2021","Wandsworth 021B","E01004474",984,335,42,293,432,6,150,77,66,7,201,182,18,1,61,46,15,14,14,217,16,201
"2021","Wandsworth 021C","E01004476",882,311,65,246,394,17,152,62,72,18,143,132,10,1,60,31,29,22,22,177,9,168
"2021","Wandsworth 021D","E01004542",595,128,46,82,379,24,212,44,137,31,96,76,20,0,38,21,17,9,9,88,9,79
"2021","Wandsworth 021E","E01004544",590,148,30,118,336,15,203,50,132,21,70,58,10,2,44,13,31,4,4,106,16,90
"2021","Wandsworth 022A","E01004628",888,275,62,213,520,21,258,98,138,22,123,93,25,5,104,66,38,14,14,93,23,70
"2021","Wandsworth 022B","E01004630",657,180,82,98,383,16,158,33,106,19,49,28,16,5,147,102,45,13,13,94,29,65
"2021","Wandsworth 022C","E01004631",742,215,54,161,435,17,208,55,122,31,88,62,23,3,101,62,39,21,21,92,17,75
"2021","Wandsworth 022D","E01004633",599,150,61,89,367,10,129,27,79,23,69,33,32,4,145,87,58,14,14,82,24,58
"2021","Wandsworth 023A","E01004569",723,175,69,106,423,27,203,57,105,41,51,30,17,4,134,84,50,8,8,125,39,86
"2021","Wandsworth 023B","E01004570",718,230,117,113,368,10,173,25,126,22,30,14,13,3,142,99,43,13,13,120,24,96
"2021","Wandsworth 023C","E01004571",687,209,72,137,354,11,141,41,80,20,59,40,17,2,131,76,55,12,12,124,34,90
"2021","Wandsworth 023D","E01004573",632,155,56,99,361,15,173,49,103,21,49,34,12,3,106,63,43,18,18,116,35,81
"2021","Wandsworth 024A","E01004495",522,100,33,67,315,4,120,24,71,25,87,68,16,3,88,50,38,16,16,107,31,76
"2021","Wandsworth 024B","E01004496",933,295,63,232,453,9,169,60,96,13,209,187,21,1,52,26,26,14,14,185,8,177
"2021","Wandsworth 024C","E01004497",520,99,47,52,362,10,231,35,165,31,60,41,18,1,51,25,26,10,10,59,11,48
"2021","Wandsworth 024D","E01004622",519,191,42,149,258,17,92,27,51,14,76,66,9,1,65,41,24,8,8,70,10,60
"2021","Wandsworth 024E","E01004624",608,118,41,77,394,22,207,51,120,36,85,61,20,4,69,39,30,11,11,96,9,87
"2021","Wandsworth 025A","E01004593",835,264,75,189,473,24,247,72,154,21,131,99,31,1,59,37,22,12,12,98,19,79
"2021","Wandsworth 025B","E01004595",794,220,69,151,490,24,246,91,137,18,155,124,28,3,50,30,20,15,15,84,6,78
"2021","Wandsworth 025C","E01004597",767,188,78,110,492,27,286,88,170,28,94,66,24,4,74,45,29,11,11,87,21,66
"2021","Wandsworth 025D","E01004598",953,239,36,203,590,15,286,96,176,14,236,206,28,2,41,25,16,12,12,124,13,111
"2021","Wandsworth 025E","E01004599",566,91,45,46,429,30,287,67,195,25,80,55,22,3,27,12,15,5,5,46,13,33
"2021","Wandsworth 026A","E01004473",756,217,56,161,374,12,189,52,118,19,123,109,14,0,36,15,21,14,14,165,16,149
"2021","Wandsworth 026B","E01004475",634,181,40,141,342,16,152,53,88,11,104,89,15,0,65,31,34,5,5,111,15,96
"2021","Wandsworth 026C","E01004480",669,142,31,111,312,14,133,43,81,9,107,97,9,1,37,19,18,21,21,215,28,187
"2021","Wandsworth 026D","E01004483",963,320,62,258,476,7,215,84,111,20,160,137,22,1,69,54,15,25,25,167,19,148
"2021","Wandsworth 026E","E01004484",625,167,36,131,307,13,130,35,78,17,106,98,6,2,45,26,19,13,13,151,13,138
"2021","Wandsworth 026F","E01004486",737,297,75,222,345,17,143,66,59,18,134,129,4,1,36,21,15,15,15,95,7,88
"2021","Wandsworth 027A","E01004543",722,179,43,136,421,20,252,105,120,27,99,84,10,5,45,23,22,5,5,122,15,107
"2021","Wandsworth 027B","E01004545",1020,415,72,343,408,9,140,82,53,5,209,181,27,1,32,15,17,18,18,197,6,191
"2021","Wandsworth 027C","E01004546",613,154,31,123,332,33,159,40,98,21,94,75,17,2,35,16,19,11,11,127,10,117
"2021","Wandsworth 027D","E01004549",666,197,48,149,363,16,193,53,105,35,101,87,10,4,42,18,24,11,11,106,17,89
"2021","Wandsworth 027E","E01004625",475,90,58,32,351,53,255,57,148,50,22,15,6,1,20,10,10,1,1,34,10,24
"2021","Wandsworth 027F","E01004626",768,218,69,149,481,29,251,76,144,31,141,85,54,2,49,31,18,11,11,69,8,61
"2021","Wandsworth 028A","E01004632",574,131,51,80,341,24,205,54,111,40,55,25,25,5,47,25,22,10,10,102,16,86
"2021","Wandsworth 028B","E01004634",678,240,74,166,385,26,165,52,92,21,89,70,17,2,91,46,45,14,14,53,11,42
"2021","Wandsworth 028C","E01004635",666,197,77,120,383,20,184,51,109,24,98,72,24,2,64,36,28,17,17,86,21,65
"2021","Wandsworth 028D","E01004636",620,194,55,139,366,31,198,64,111,23,51,41,7,3,80,45,35,6,6,60,12,48
"2021","Wandsworth 028E","E01004637",569,151,47,104,322,28,150,41,85,24,61,35,20,6,65,34,31,18,18,96,20,76
"2021","Wandsworth 029A","E01004481",688,175,50,125,315,8,115,46,58,11,129,115,13,1,46,24,22,17,17,198,15,183
"2021","Wandsworth 029B","E01004488",559,178,41,137,301,12,170,53,98,19,67,50,16,1,46,16,30,6,6,80,19,61
"2021","Wandsworth 029C","E01004547",554,154,48,106,325,19,167,36,83,48,70,60,8,2,60,29,31,9,9,75,16,59
"2021","Wandsworth 029D","E01004548",1029,404,94,310,458,15,156,63,73,20,173,153,18,2,90,69,21,24,24,167,16,151
"2021","Wandsworth 030A","E01004482",607,162,45,117,304,21,132,40,68,24,86,71,11,4,55,28,27,10,10,141,22,119
"2021","Wandsworth 030B","E01004485",748,230,88,142,344,23,151,55,80,16,99,88,9,2,58,36,22,13,13,174,23,151
"2021","Wandsworth 030C","E01004487",701,269,36,233,333,13,147,47,75,25,117,104,13,0,44,22,22,12,12,99,18,81
"2021","Wandsworth 030D","E01004489",597,220,35,185,319,12,162,36,98,28,70,59,8,3,64,41,23,11,11,58,13,45
"2021","Wandsworth 031A","E01004490",597,120,39,81,381,15,233,56,155,22,97,75,22,0,33,19,14,3,3,96,13,83
"2021","Wandsworth 031B","E01004491",1127,580,46,534,448,20,205,67,119,19,126,113,9,4,84,56,28,13,13,99,23,76
"2021","Wandsworth 031C","E01004492",743,212,43,169,418,17,206,52,133,21,109,92,16,1,72,40,32,14,14,113,18,95
"2021","Wandsworth 031D","E01004498",744,199,39,160,443,11,216,77,133,6,158,140,16,2,45,29,16,13,13,102,13,89
"2021","Wandsworth 032A","E01004532",621,171,57,114,355,15,147,38,92,17,111,90,20,1,78,44,34,4,4,95,11,84
"2021","Wandsworth 032B","E01004611",552,96,37,59,318,19,163,44,85,34,55,39,13,3,65,26,39,16,16,138,22,116
"2021","Wandsworth 032C","E01004612",541,100,35,65,282,14,141,32,70,39,56,47,7,2,50,22,28,21,21,159,40,119
"2021","Wandsworth 032D","E01004618",532,108,49,59,278,29,161,33,98,30,42,28,14,0,37,15,22,9,9,146,22,124
"2021","Wandsworth 033A","E01004531",651,140,49,91,384,14,139,29,81,29,96,59,35,2,126,82,44,9,9,127,25,102
"2021","Wandsworth 033B","E01004533",611,127,38,89,362,20,140,54,63,23,63,44,15,4,129,78,51,10,10,122,13,109
"2021","Wandsworth 033C","E01004610",716,142,44,98,363,34,181,48,88,45,75,66,7,2,54,26,28,19,19,211,35,176
"2021","Wandsworth 033D","E01004613",698,226,88,138,352,8,164,40,105,19,60,54,6,0,109,71,38,11,11,120,24,96
"2021","Wandsworth 034A","E01004614",834,241,65,176,420,13,177,62,90,25,139,112,25,2,80,45,35,11,11,173,14,159
"2021","Wandsworth 034B","E01004615",707,245,67,178,378,13,120,38,65,17,64,44,14,6,167,100,67,14,14,84,24,60
"2021","Wandsworth 034C","E01004616",764,182,32,150,348,10,137,38,73,26,107,94,11,2,78,33,45,16,16,234,27,207
"2021","Wandsworth 034D","E01004617",727,174,43,131,304,11,114,42,56,16,76,64,10,2,84,53,31,19,19,249,21,228
"2021","Wandsworth 035A","E01004525",725,166,42,124,365,10,138,28,86,24,72,59,12,1,85,63,22,60,60,194,27,167
"2021","Wandsworth 035B","E01004526",753,216,47,169,408,12,155,48,83,24,128,101,23,4,72,50,22,41,41,129,16,113
"2021","Wandsworth 035C","E01004527",601,145,66,79,310,24,154,28,100,26,66,50,13,3,57,25,32,9,9,146,22,124
"2021","Wandsworth 035D","E01004528",713,246,67,179,375,15,155,38,89,28,79,62,12,5,115,64,51,11,11,92,21,71
"2021","Wandsworth 035E","E01004529",887,236,52,184,470,14,215,65,116,34,143,118,24,1,83,61,22,15,15,181,30,151
"2021","Wandsworth 035F","E01004530",737,230,58,172,382,22,177,59,87,31,116,98,17,1,53,25,28,14,14,125,10,115
"2021","Wandsworth 036A","E01004516",502,78,40,38,355,33,211,33,124,54,50,18,25,7,55,24,31,6,6,69,24,45
"2021","Wandsworth 036B","E01004518",650,147,55,92,439,28,232,58,121,53,84,44,37,3,91,48,43,4,4,64,18,46
"2021","Wandsworth 036C","E01004519",614,122,51,71,384,26,206,42,124,40,65,43,16,6,80,35,45,7,7,108,31,77
"2021","Wandsworth 036D","E01004520",440,79,42,37,270,13,130,25,82,23,36,15,15,6,82,41,41,9,9,91,37,54
"2021","Wandsworth 036E","E01004523",706,285,126,159,340,36,173,43,92,38,57,43,10,4,66,42,24,8,8,81,22,59
"2021","Wandsworth 037A","E01004517",887,235,37,198,489,8,227,59,135,33,149,108,35,6,89,57,32,16,16,163,51,112
"2021","Wandsworth 037B","E01004521",765,167,47,120,492,21,243,59,135,49,107,70,33,4,105,64,41,16,16,106,35,71
"2021","Wandsworth 037C","E01004522",639,151,40,111,381,15,176,50,98,28,72,53,17,2,95,58,37,23,23,107,44,63
"2021","Wandsworth 037D","E01004524",817,343,125,218,361,9,128,43,68,17,46,29,16,1,161,110,51,17,17,113,33,80
"2021","Wandsworth 038C","E01033098",946,424,21,403,436,8,201,93,96,12,156,144,12,0,44,31,13,27,27,86,6,80
"2021","Wandsworth 038D","E01033132",1149,529,29,500,524,7,221,124,89,8,185,171,14,0,80,49,31,31,31,96,17,79
"2021","Wandsworth 038A","E01035496",706,277,25,252,367,15,127,83,31,13,162,155,6,1,31,23,8,32,32,62,6,56
"2021","Wandsworth 038B","E01035497",654,183,5,178,382,1,110,48,58,4,108,97,11,0,141,120,21,22,22,89,8,81
"2021","Wandsworth 038E","E01035498",651,267,2,265,297,4,138,63,73,2,110,101,9,0,11,6,5,34,34,87,4,83
"2021","Wandsworth 039E","E01004563",869,250,46,204,472,8,142,44,64,34,106,81,21,4,190,135,55,26,26,147,31,116
"2021","Wandsworth 039D","E01004564",833,230,49,181,391,16,150,67,64,19,131,115,11,5,75,41,34,19,19,212,24,188
"2021","Wandsworth 039A","E01004567",980,328,52,276,528,12,167,40,96,31,103,75,21,7,223,139,84,23,23,124,36,88
"2021","Wandsworth 039B","E01033100",849,286,73,213,385,10,131,66,42,23,136,113,21,2,81,46,35,27,27,178,21,157
"2021","Wandsworth 039C","E01035499",612,192,63,129,303,11,98,27,46,25,35,20,11,4,144,75,69,15,15,117,35,82
"2021","Westminster 001A","E01004647",619,228,81,147,327,34,182,48,103,31,57,35,15,7,45,16,29,9,9,64,18,46
"2021","Westminster 001B","E01004649",594,201,64,137,327,45,204,48,135,21,26,23,3,0,39,22,17,13,13,66,21,45
"2021","Westminster 001C","E01004724",868,363,72,291,394,34,204,84,89,31,68,54,13,1,73,34,39,15,15,111,19,92
"2021","Westminster 001D","E01004730",697,250,108,142,374,47,202,76,93,33,51,44,5,2,48,25,23,26,26,73,14,59
"2021","Westminster 002A","E01004646",640,140,64,76,423,23,237,70,143,24,35,25,8,2,118,32,86,10,10,77,38,39
"2021","Westminster 002B","E01004648",1037,352,97,255,543,30,291,106,161,24,118,108,10,0,71,40,31,33,33,142,35,107
"2021","Westminster 002C","E01004650",858,343,108,235,432,39,246,78,148,20,93,78,11,4,37,24,13,17,17,83,18,65
"2021","Westminster 002D","E01004710",721,207,72,135,399,12,181,39,112,30,66,40,21,5,125,72,53,15,15,115,40,75
"2021","Westminster 002E","E01004711",817,235,74,161,469,16,194,47,119,28,65,46,17,2,179,105,74,15,15,113,17,96
"2021","Westminster 003A","E01004651",1012,548,109,439,400,40,225,97,116,12,85,76,9,0,24,13,11,26,26,64,8,56
"2021","Westminster 003B","E01004725",583,227,51,176,296,26,130,44,65,21,31,27,2,2,89,47,42,20,20,60,6,54
"2021","Westminster 003C","E01004726",792,331,80,251,369,35,220,88,111,21,54,45,7,2,44,18,26,16,16,92,29,63
"2021","Westminster 003D","E01004728",729,311,122,189,340,27,160,63,64,33,69,56,9,4,66,32,34,18,18,78,12,66
"2021","Westminster 003E","E01004729",738,374,182,192,288,26,153,51,78,24,26,19,5,2,71,31,40,12,12,76,11,65
"2021","Westminster 004A","E01004718",793,289,57,232,413,15,152,46,84,22,73,56,11,6,150,56,94,23,23,91,36,55
"2021","Westminster 004B","E01004719",783,245,72,173,464,22,174,48,84,42,78,53,20,5,170,78,92,20,20,74,19,55
"2021","Westminster 004C","E01004720",857,212,66,146,544,12,213,57,113,43,109,78,23,8,186,73,113,24,24,101,47,54
"2021","Westminster 004D","E01004721",840,326,101,225,435,27,153,48,77,28,52,33,14,5,184,114,70,19,19,79,32,47
"2021","Westminster 004E","E01004722",869,214,52,162,508,9,226,33,141,52,58,37,15,6,201,111,90,14,14,147,72,75
"2021","Westminster 005A","E01004674",773,286,95,191,391,12,153,39,83,31,83,41,13,29,127,68,59,16,16,96,24,72
"2021","Westminster 005B","E01004675",1070,456,139,317,489,9,196,60,101,35,79,57,16,6,170,97,73,35,35,125,33,92
"2021","Westminster 005C","E01004677",805,286,62,224,395,11,136,54,58,24,93,75,13,5,128,78,50,27,27,124,24,100
"2021","Westminster 005D","E01004678",834,325,76,249,405,12,148,36,87,25,78,56,13,9,156,92,64,11,11,104,28,76
"2021","Westminster 005E","E01004679",921,368,69,299,464,12,165,41,80,44,79,61,16,2,181,97,84,27,27,89,15,74
"2021","Westminster 005F","E01004723",963,327,68,259,486,17,179,48,102,29,105,84,18,3,165,98,67,20,20,150,26,124
"2021","Westminster 006A","E01004676",714,270,44,226,343,4,150,53,71,26,91,74,12,5,82,51,31,16,16,101,18,83
"2021","Westminster 006B","E01004706",684,207,61,146,343,21,188,81,94,13,87,68,15,4,41,25,16,6,6,134,8,126
"2021","Westminster 006C","E01004707",752,203,52,151,409,16,261,86,142,33,71,60,10,1,42,26,16,19,19,140,12,128
"2021","Westminster 006D","E01004708",724,278,67,211,349,5,169,60,84,25,86,72,12,2,69,34,35,20,20,97,11,86
"2021","Westminster 006E","E01004756",754,319,53,266,358,7,138,56,66,16,98,85,11,2,97,57,40,18,18,77,7,70
"2021","Westminster 007A","E01004701",771,306,100,206,418,18,245,124,113,8,96,88,7,1,44,22,22,15,15,47,11,36
"2021","Westminster 007B","E01004703",864,276,87,189,511,40,318,106,189,23,76,55,16,5,62,30,32,15,15,77,16,61
"2021","Westminster 007D","E01004705",587,211,52,159,322,28,183,61,104,18,71,58,12,1,30,16,14,10,10,54,8,46
"2021","Westminster 007E","E01004709",721,248,63,185,385,21,202,69,104,29,65,49,9,7,81,34,47,16,16,88,18,70
"2021","Westminster 007H","E01035715",1171,511,102,409,524,35,281,123,135,23,137,120,14,3,53,27,26,18,18,136,13,123
"2021","Westminster 008A","E01004659",844,387,68,319,304,27,142,77,49,16,75,68,6,1,36,29,7,24,24,153,13,140
"2021","Westminster 008B","E01004660",667,231,54,177,336,41,169,65,90,14,49,31,18,0,45,25,20,32,32,100,13,87
"2021","Westminster 008C","E01004712",733,340,73,267,332,32,164,74,71,19,75,63,9,3,35,12,23,26,26,61,9,52
"2021","Westminster 008D","E01004727",764,340,62,278,327,36,181,69,90,22,57,51,5,1,30,15,15,23,23,97,12,85
"2021","Westminster 009A","E01004670",927,288,129,159,473,28,182,39,90,53,21,11,8,2,226,117,109,16,16,166,78,88
"2021","Westminster 009E","E01004702",1071,351,116,235,577,43,223,29,132,62,56,35,11,10,231,103,128,24,24,143,66,77
"2021","Westminster 009F","E01033598",547,184,78,106,286,15,102,31,42,29,26,16,5,5,127,60,67,16,16,77,26,51
"2021","Westminster 009G","E01033601",609,185,88,97,291,16,135,26,82,27,21,15,4,2,105,54,51,14,14,133,86,47
"2021","Westminster 009H","E01033602",632,256,84,172,313,14,116,24,66,26,36,13,20,3,135,76,59,12,12,63,34,29
"2021","Westminster 009I","E01033603",593,261,37,224,250,10,72,30,26,16,76,36,36,4,77,36,41,15,15,82,8,74
"2021","Westminster 009J","E01033604",542,223,39,184,244,7,91,34,47,10,43,25,18,0,85,51,34,18,18,75,9,66
"2021","Westminster 009K","E01033605",699,280,93,187,314,12,122,21,71,30,40,30,9,1,129,72,57,11,11,105,38,67
"2021","Westminster 010A","E01004754",679,223,78,145,388,12,162,23,105,34,49,29,15,5,142,77,65,23,23,68,16,52
"2021","Westminster 010B","E01004755",990,361,50,311,488,16,213,53,116,44,101,75,18,8,141,70,71,17,17,141,38,103
"2021","Westminster 010C","E01004757",624,165,52,113,360,14,147,27,86,34,34,19,14,1,150,72,78,15,15,99,26,73
"2021","Westminster 010F","E01032512",894,314,64,250,513,10,195,32,120,43,50,30,15,5,251,161,90,7,7,67,27,40
"2021","Westminster 010G","E01032513",532,212,62,150,268,11,102,22,59,21,36,18,15,3,112,68,44,7,7,52,13,39
"2021","Westminster 011A","E01004713",695,333,95,238,307,28,158,72,71,15,75,67,8,0,28,16,12,18,18,55,11,44
"2021","Westminster 011B","E01004714",817,358,54,304,387,16,207,83,96,28,109,101,7,1,30,16,14,25,25,72,6,66
"2021","Westminster 011C","E01004716",532,223,60,163,252,36,124,56,56,12,48,35,12,1,24,16,8,20,20,57,11,46
"2021","Westminster 011D","E01004717",745,379,66,313,313,19,118,58,47,13,74,65,9,0,33,10,23,69,69,53,5,48
"2021","Westminster 011E","E01004762",762,385,93,292,288,24,144,53,47,44,51,44,7,0,55,30,25,14,14,89,19,70
"2021","Westminster 012A","E01004657",600,264,59,205,270,21,162,71,66,25,59,58,1,0,19,9,10,9,9,66,7,59
"2021","Westminster 012B","E01004658",773,398,46,352,281,13,142,88,41,13,69,53,16,0,26,13,13,31,31,94,8,86
"2021","Westminster 012C","E01004661",844,336,46,290,340,24,151,60,64,27,98,90,7,1,35,22,13,32,32,168,53,115
"2021","Westminster 012D","E01004662",781,420,80,340,256,19,129,69,52,8,59,55,4,0,23,18,5,26,26,105,10,95
"2021","Westminster 012E","E01004663",719,304,79,225,349,36,148,61,66,21,81,71,10,0,44,17,27,40,40,66,10,56
"2021","Westminster 013A","E01004715",834,435,92,343,267,16,116,45,43,28,43,31,8,4,71,43,28,21,21,132,12,120
"2021","Westminster 013B","E01004763",1117,598,57,541,389,5,121,75,37,9,160,149,10,1,54,22,32,49,49,130,9,121
"2021","Westminster 013D","E01004765",1045,524,80,444,410,29,147,74,58,15,97,87,6,4,76,24,52,61,61,111,21,90
"2021","Westminster 013G","E01035716",1262,702,137,565,448,17,167,90,60,17,115,98,15,2,72,36,36,77,77,112,41,71
"2021","Westminster 014A","E01004653",797,340,94,246,357,23,187,63,105,19,87,77,9,1,51,30,21,9,9,100,20,80
"2021","Westminster 014B","E01004654",1198,582,98,484,497,31,294,138,110,46,102,91,9,2,46,24,22,24,24,119,55,64
"2021","Westminster 014D","E01004656",1102,568,109,459,454,21,197,98,80,19,136,121,14,1,69,49,20,31,31,80,13,67
"2021","Westminster 014E","E01004760",698,262,75,187,360,12,165,57,87,21,68,59,4,5,99,45,54,16,16,76,24,52
"2021","Westminster 014H","E01035717",999,500,72,428,384,19,165,68,75,22,114,97,15,2,67,30,37,19,19,115,18,97
"2021","Westminster 015A","E01004680",565,217,71,146,272,32,142,61,60,21,51,46,4,1,27,9,18,20,20,76,9,67
"2021","Westminster 015B","E01004683",626,219,55,164,306,37,177,75,82,20,44,36,6,2,33,11,22,15,15,101,40,61
"2021","Westminster 015C","E01004684",472,199,39,160,220,17,110,32,64,14,25,24,0,1,53,26,27,15,15,53,9,44
"2021","Westminster 015E","E01004686",746,413,89,324,245,14,116,49,58,9,47,45,0,2,38,25,13,30,30,88,12,76
"2021","Westminster 015F","E01033593",870,365,22,343,437,3,168,59,93,16,111,107,3,1,114,79,35,41,41,68,11,57
"2021","Westminster 015G","E01033594",702,360,114,246,255,20,105,57,39,9,58,46,11,1,55,27,28,17,17,87,10,77
"2021","Westminster 016A","E01004681",919,392,63,329,414,19,189,93,69,27,118,110,7,1,61,33,28,27,27,113,38,75
"2021","Westminster 016B","E01004682",673,353,48,305,225,11,91,44,40,7,66,63,3,0,29,18,11,28,28,95,4,91
"2021","Westminster 016C","E01004694",774,355,47,308,325,58,134,81,43,10,80,73,7,0,26,20,6,27,27,94,11,83
"2021","Westminster 016D","E01004697",666,281,56,225,294,19,133,59,62,12,77,61,16,0,40,21,19,25,25,91,6,85
"2021","Westminster 016E","E01004700",768,346,49,297,327,17,169,87,67,15,92,84,8,0,29,20,9,20,20,95,12,83
"2021","Westminster 017A","E01004652",851,386,68,318,332,17,152,68,64,20,84,78,6,0,45,21,24,34,34,133,12,121
"2021","Westminster 017B","E01004693",589,285,58,227,256,22,146,58,79,9,46,38,6,2,34,21,13,8,8,48,6,42
"2021","Westminster 017C","E01004695",548,259,58,201,171,6,75,42,27,6,41,36,5,0,29,9,20,20,20,118,9,109
"2021","Westminster 017D","E01004696",692,292,92,200,315,19,124,45,56,23,52,43,6,3,104,54,50,16,16,85,18,67
"2021","Westminster 017E","E01004698",635,291,46,245,278,14,124,44,69,11,82,76,5,1,41,12,29,17,17,66,16,50
"2021","Westminster 017F","E01004699",895,415,61,354,359,14,166,74,82,10,101,96,5,0,47,28,19,31,31,121,15,106
"2021","Westminster 018A","E01004734",1007,558,121,437,327,24,110,68,26,16,97,87,9,1,64,19,45,32,32,122,11,111
"2021","Westminster 018B","E01004735",1157,697,115,582,378,12,130,59,55,16,139,106,30,3,71,32,39,26,26,82,16,66
"2021","Westminster 018C","E01004736",582,301,52,249,222,32,104,60,33,11,53,48,4,1,22,5,17,11,11,59,6,53
"2021","Westminster 018D","E01004761",697,384,70,314,241,35,104,55,35,14,43,40,2,1,41,23,18,18,18,72,13,59
"2021","Westminster 019A","E01004687",672,291,76,215,322,44,173,73,67,33,32,24,7,1,48,20,28,25,25,59,17,42
"2021","Westminster 019D","E01004690",438,135,36,99,234,35,127,60,52,15,33,23,9,1,30,14,16,9,9,69,22,47
"2021","Westminster 019E","E01004691",475,203,64,139,199,24,94,46,37,11,28,23,4,1,41,19,22,12,12,73,23,50
"2021","Westminster 019F","E01004692",450,161,54,107,224,27,107,42,50,15,34,25,7,2,38,15,23,18,18,65,22,43
"2021","Westminster 019G","E01035718",731,274,75,199,384,59,221,102,86,33,36,27,7,2,52,23,29,16,16,73,41,32
"2021","Westminster 020A","E01004731",1042,470,54,416,440,23,231,116,98,17,107,95,12,0,58,32,26,21,21,132,18,114
"2021","Westminster 020B","E01004732",689,371,95,276,272,18,96,33,41,22,39,25,10,4,106,60,46,13,13,46,11,35
"2021","Westminster 020C","E01004733",946,405,71,334,431,40,175,85,68,22,110,100,10,0,72,31,41,34,34,110,8,102
"2021","Westminster 020D","E01004744",732,360,117,243,311,19,181,83,80,18,43,35,7,1,58,35,23,10,10,61,7,54
"2021","Westminster 020E","E01004748",519,211,63,148,250,40,131,57,58,16,32,30,1,1,34,14,20,13,13,58,11,47
"2021","Westminster 021A","E01004740",653,331,159,172,262,21,116,39,58,19,45,35,9,1,74,34,40,6,6,60,9,51
"2021","Westminster 021B","E01004743",726,298,47,251,355,13,167,59,68,40,63,47,12,4,92,44,48,20,20,73,13,60
"2021","Westminster 021D","E01004746",672,350,101,249,273,18,94,34,43,17,57,41,12,4,86,50,36,18,18,49,6,43
"2021","Westminster 021E","E01004747",1048,444,129,315,467,29,202,94,78,30,101,84,15,2,98,53,45,37,37,137,30,107
"2021","Westminster 021F","E01035719",631,268,50,218,305,22,139,52,68,19,65,50,13,2,61,36,25,18,18,58,10,48
"2021","Westminster 021G","E01035720",589,236,52,184,289,20,97,36,52,9,73,50,22,1,84,30,54,15,15,64,6,58
"2021","Westminster 022A","E01004742",711,331,43,288,293,15,113,58,45,10,84,78,5,1,63,14,49,18,18,87,9,78
"2021","Westminster 022B","E01004749",1052,430,88,342,494,32,219,106,87,26,120,107,12,1,97,58,39,26,26,128,14,114
"2021","Westminster 022C","E01004751",770,339,64,275,337,23,165,89,62,14,96,90,4,2,40,18,22,13,13,94,17,77
"2021","Westminster 022D","E01004752",707,350,75,275,290,13,104,43,51,10,85,71,14,0,66,22,44,22,22,67,11,56
"2021","Westminster 022E","E01004753",923,457,107,350,341,15,156,97,42,17,106,84,21,1,48,26,22,16,16,125,8,117
"2021","Westminster 023D","E01004668",590,186,65,121,319,29,150,47,88,15,52,38,9,5,74,35,39,14,14,85,18,67
"2021","Westminster 023E","E01004750",839,429,153,276,331,32,110,39,50,21,60,54,5,1,80,51,29,49,49,79,22,57
"2021","Westminster 023F","E01033597",585,344,65,279,198,14,96,38,49,9,37,31,6,0,43,28,15,8,8,43,6,37
"2021","Westminster 023G","E01033599",525,167,20,147,321,6,112,21,60,31,29,17,9,3,165,91,74,9,9,37,12,25
"2021","Westminster 023H","E01035721",1307,748,134,614,470,42,219,98,90,31,62,49,9,4,123,64,59,24,24,89,29,60
"2021","Westminster 024A","E01004665",576,199,68,131,315,16,132,18,76,38,43,25,12,6,114,62,52,10,10,62,20,42
"2021","Westminster 024B","E01004669",729,269,85,184,347,19,146,37,76,33,44,35,8,1,117,63,54,21,21,113,16,97
"2021","Westminster 024C","E01004737",600,261,88,173,305,30,120,33,71,16,57,41,15,1,89,50,39,9,9,34,10,24
"2021","Westminster 024F","E01004741",671,322,87,235,287,13,111,44,50,17,87,72,12,3,58,31,27,18,18,62,16,46
"2021","Westminster 024G","E01035722",1183,645,179,466,409,33,185,107,64,14,120,114,5,1,56,20,36,15,15,129,18,111
"2021","Medway 001A","E01016070",702,193,105,88,458,104,224,86,84,54,69,37,28,4,55,25,30,6,6,51,33,18
"2021","Medway 001B","E01016071",655,149,81,68,448,56,222,92,83,47,86,28,50,8,81,36,45,3,3,58,39,19
"2021","Medway 001C","E01016072",524,123,66,57,356,44,188,75,74,39,71,33,33,5,50,28,22,3,3,45,25,20
"2021","Medway 001D","E01016074",982,369,206,163,568,125,246,116,80,50,130,80,41,9,63,28,35,4,4,45,24,21
"2021","Medway 002A","E01016142",534,106,54,52,403,67,223,80,89,54,67,35,28,4,45,25,20,1,1,25,10,15
"2021","Medway 002B","E01016144",585,119,73,46,430,100,233,79,97,57,55,24,21,10,38,12,26,4,4,36,19,17
"2021","Medway 002C","E01016145",504,90,46,44,390,61,227,71,112,44,60,16,37,7,40,26,14,2,2,24,16,8
"2021","Medway 002D","E01016149",599,140,65,75,424,58,208,68,85,55,81,34,34,13,71,48,23,6,6,35,24,11
"2021","Medway 003A","E01016073",856,160,99,61,635,121,355,122,160,73,91,50,32,9,65,32,33,3,3,61,32,29
"2021","Medway 003B","E01016075",656,125,75,50,483,78,228,67,105,56,103,50,45,8,73,39,34,1,1,48,24,24
"2021","Medway 003D","E01016077",671,210,130,80,425,62,185,54,88,43,90,40,40,10,84,51,33,4,4,36,20,16
"2021","Medway 003E","E01016143",1134,230,94,136,831,69,406,133,192,81,194,88,91,15,158,121,37,4,4,73,36,37
"2021","Medway 003F","E01035286",633,129,42,87,456,42,240,60,152,28,102,42,57,3,72,57,15,0,0,48,30,18
"2021","Medway 003G","E01035287",716,154,79,75,517,69,262,76,134,52,114,55,53,6,69,39,30,3,3,45,25,20
"2021","Medway 004B","E01016147",742,167,98,69,527,78,283,78,136,69,94,39,48,7,71,47,24,1,1,48,15,33
"2021","Medway 004C","E01016148",810,151,80,71,605,102,319,80,161,78,100,52,42,6,82,57,25,2,2,54,31,23
"2021","Medway 004D","E01035288",551,137,58,79,379,54,181,44,108,29,80,34,43,3,60,38,22,4,4,35,21,14
"2021","Medway 004E","E01035289",653,204,106,98,408,40,184,65,87,32,97,47,42,8,80,48,32,7,7,41,17,24
"2021","Medway 005A","E01016133",551,118,93,25,400,102,221,74,87,60,51,17,20,14,24,7,17,2,2,33,15,18
"2021","Medway 005B","E01016134",531,99,46,53,397,63,232,80,98,54,54,27,24,3,47,26,21,1,1,35,22,13
"2021","Medway 005C","E01016138",588,138,97,41,403,92,215,61,88,66,47,27,19,1,48,24,24,1,1,47,23,24
"2021","Medway 005D","E01016139",612,108,63,45,458,61,261,76,131,54,72,31,33,8,58,24,34,6,6,46,20,26
"2021","Medway 006A","E01016135",624,151,71,80,432,43,221,68,107,46,90,36,45,9,72,43,29,6,6,41,21,20
"2021","Medway 006B","E01016136",671,192,60,132,433,41,201,61,100,40,79,38,37,4,109,78,31,3,3,46,33,13
"2021","Medway 006C","E01016137",633,153,45,108,436,25,179,50,97,32,107,48,55,4,121,84,37,4,4,44,21,23
"2021","Medway 006D","E01016140",630,211,54,157,369,27,163,61,67,35,72,40,25,7,101,75,26,6,6,50,28,22
"2021","Medway 006E","E01016141",742,250,74,176,420,18,183,56,97,30,106,52,48,6,106,66,40,7,7,72,38,34
"2021","Medway 007A","E01016035",744,205,54,151,443,19,169,47,90,32,103,41,52,10,142,112,30,10,10,96,37,59
"2021","Medway 007F","E01035290",767,212,61,151,514,52,275,98,140,37,107,60,38,9,75,53,22,5,5,41,17,24
"2021","Medway 007G","E01035291",778,194,58,136,552,76,281,100,142,39,102,68,29,5,88,50,38,5,5,32,14,18
"2021","Medway 007H","E01035292",768,342,40,302,376,17,140,43,86,11,108,75,32,1,103,73,30,8,8,50,13,37
"2021","Medway 007I","E01035293",730,279,98,181,404,26,204,76,102,26,83,33,47,3,82,58,24,9,9,47,20,27
"2021","Medway 008A","E01016151",633,136,61,75,448,57,231,52,122,57,80,33,39,8,77,38,39,3,3,49,24,25
"2021","Medway 008B","E01016152",648,202,101,101,403,66,188,61,80,47,66,21,38,7,77,48,29,6,6,43,22,21
"2021","Medway 008C","E01016153",607,182,84,98,384,27,123,35,68,20,84,25,51,8,145,100,45,5,5,41,23,18
"2021","Medway 008D","E01016155",613,117,72,45,440,68,194,52,94,48,78,25,42,11,95,51,44,5,5,56,28,28
"2021","Medway 009A","E01016033",487,156,58,98,289,17,101,29,51,21,70,25,40,5,96,60,36,5,5,42,23,19
"2021","Medway 009C","E01016037",656,185,53,132,376,24,169,45,86,38,76,25,46,5,93,59,34,14,14,95,25,70
"2021","Medway 009D","E01016039",661,174,51,123,396,17,165,49,87,29,89,47,37,5,111,76,35,14,14,91,31,60
"2021","Medway 009E","E01035294",710,434,47,387,257,22,80,45,29,6,116,103,10,3,33,26,7,6,6,19,3,16
"2021","Medway 009F","E01035295",615,163,33,130,361,24,145,47,73,25,79,35,40,4,95,66,29,18,18,91,24,67
"2021","Medway 010A","E01016030",696,163,60,103,490,37,232,65,122,45,85,30,47,8,133,98,35,3,3,43,27,16
"2021","Medway 010B","E01016032",466,95,40,55,320,10,128,31,62,35,59,15,37,7,123,75,48,0,0,51,28,23
"2021","Medway 010C","E01016034",1028,273,94,179,679,48,324,117,148,59,174,82,83,9,126,83,43,7,7,76,40,36
"2021","Medway 010D","E01016038",631,163,65,98,405,40,190,56,105,29,77,39,29,9,92,58,34,6,6,63,25,38
"2021","Medway 011A","E01016150",624,127,54,73,453,28,199,50,102,47,87,30,50,7,136,108,28,3,3,44,26,18
"2021","Medway 011B","E01016154",694,218,67,151,419,33,204,55,97,52,96,47,42,7,82,50,32,4,4,57,29,28
"2021","Medway 011C","E01016156",661,145,49,96,473,33,216,73,110,33,125,53,63,9,98,60,38,1,1,43,26,17
"2021","Medway 011D","E01016157",899,187,63,124,653,47,310,87,172,51,175,82,83,10,115,70,45,6,6,59,35,24
"2021","Medway 011E","E01016158",979,277,86,191,636,65,285,88,149,48,156,88,60,8,117,76,41,13,13,66,35,31
"2021","Medway 012A","E01016031",808,336,106,230,415,19,124,38,61,25,96,44,50,2,167,137,30,9,9,57,20,37
"2021","Medway 012B","E01016041",706,237,56,181,384,18,164,50,87,27,93,27,53,13,103,64,39,6,6,85,37,48
"2021","Medway 012C","E01016045",614,149,46,103,394,25,201,53,112,36,74,28,38,8,87,51,36,7,7,71,37,34
"2021","Medway 012D","E01016049",881,322,88,234,482,14,182,40,103,39,102,43,49,10,176,135,41,8,8,77,38,39
"2021","Medway 013A","E01016040",706,196,66,130,442,28,197,43,104,50,86,41,38,7,122,73,49,9,9,68,30,38
"2021","Medway 013B","E01016042",545,130,46,84,353,19,156,43,86,27,64,23,32,9,105,73,32,9,9,62,29,33
"2021","Medway 013C","E01016043",551,121,67,54,390,40,189,68,85,36,95,35,42,18,63,27,36,3,3,40,22,18
"2021","Medway 013D","E01016177",615,154,59,95,411,36,193,63,84,46,77,32,38,7,101,54,47,4,4,50,23,27
"2021","Medway 013E","E01016178",546,142,51,91,354,41,177,38,94,45,67,29,34,4,63,35,28,6,6,50,19,31
"2021","Medway 014A","E01016117",950,413,107,306,469,22,151,61,73,17,147,95,48,4,135,105,30,14,14,68,23,45
"2021","Medway 014B","E01016129",946,336,81,255,571,42,192,86,78,28,157,91,58,8,172,135,37,8,8,39,15,24
"2021","Medway 014C","E01016130",956,437,137,300,457,64,207,90,93,24,120,98,18,4,61,34,27,5,5,62,8,54
"2021","Medway 014D","E01016131",817,319,182,137,462,72,243,96,115,32,93,61,25,7,54,28,26,0,0,36,17,19
"2021","Medway 015A","E01016016",640,237,58,179,342,19,155,45,82,28,61,27,27,7,99,57,42,8,8,61,29,32
"2021","Medway 015B","E01016017",820,370,59,311,369,20,132,55,64,13,98,59,38,1,106,75,31,13,13,81,22,59
"2021","Medway 015C","E01016019",650,140,35,105,437,17,181,34,118,29,96,23,61,12,134,106,28,9,9,73,39,34
"2021","Medway 015E","E01016111",763,292,96,196,391,13,180,53,116,11,83,41,38,4,107,83,24,8,8,80,21,59
"2021","Medway 015F","E01035296",736,342,102,240,353,23,130,79,45,6,123,95,26,2,70,55,15,7,7,41,14,27
"2021","Medway 015G","E01035297",730,325,52,273,359,12,144,47,84,13,106,73,31,2,89,69,20,8,8,46,16,30
"2021","Medway 016A","E01016044",684,186,59,127,424,23,191,63,97,31,91,40,46,5,114,63,51,5,5,74,33,41
"2021","Medway 016B","E01016046",630,175,52,123,394,29,182,48,95,39,98,42,45,11,79,58,21,6,6,61,23,38
"2021","Medway 016C","E01016047",656,175,52,123,409,24,193,53,114,26,81,32,43,6,105,66,39,6,6,72,32,40
"2021","Medway 016D","E01016048",672,199,66,133,398,21,208,56,117,35,65,25,38,2,99,70,29,5,5,75,33,42
"2021","Medway 017A","E01016113",597,150,77,73,393,60,198,58,105,35,76,46,27,3,53,28,25,6,6,54,30,24
"2021","Medway 017B","E01016114",614,171,42,129,387,15,160,61,73,26,86,49,34,3,116,82,34,10,10,56,25,31
"2021","Medway 017C","E01016115",773,169,74,95,562,58,238,71,113,54,115,50,53,12,145,99,46,6,6,42,24,18
"2021","Medway 017D","E01016118",756,216,71,145,477,35,197,69,89,39,130,68,52,10,106,65,41,9,9,63,15,48
"2021","Medway 018A","E01016160",615,172,88,84,394,45,170,60,71,39,74,27,41,6,103,60,43,2,2,49,24,25
"2021","Medway 018B","E01016161",744,296,162,134,413,41,136,49,57,30,93,34,49,10,139,88,51,4,4,35,18,17
"2021","Medway 018C","E01016162",637,148,80,68,437,68,205,61,103,41,89,37,41,11,74,42,32,1,1,52,28,24
"2021","Medway 018D","E01016163",507,113,57,56,351,43,166,52,80,34,61,22,31,8,79,37,42,2,2,43,23,20
"2021","Medway 018E","E01016164",644,217,116,101,388,53,163,45,77,41,82,38,34,10,87,48,39,3,3,39,16,23
"2021","Medway 018F","E01016165",525,146,83,63,345,51,192,68,82,42,39,14,18,7,58,24,34,5,5,34,15,19
"2021","Medway 019A","E01016159",557,119,48,71,384,32,143,39,75,29,79,23,48,8,124,88,36,6,6,54,26,28
"2021","Medway 019B","E01016174",510,120,51,69,333,36,180,53,81,46,52,22,20,10,55,31,24,10,10,57,20,37
"2021","Medway 019C","E01016175",745,155,87,68,543,101,304,96,124,84,73,33,34,6,64,31,33,1,1,47,23,24
"2021","Medway 019D","E01016179",502,94,51,43,370,59,202,67,73,62,51,29,16,6,55,25,30,3,3,38,23,15
"2021","Medway 020A","E01016061",661,184,39,145,415,15,162,40,87,35,97,35,57,5,134,105,29,7,7,62,30,32
"2021","Medway 020B","E01016063",680,257,73,184,358,13,150,48,89,13,85,33,43,9,102,72,30,8,8,65,32,33
"2021","Medway 020C","E01016064",740,282,92,190,401,29,154,57,62,35,98,51,42,5,112,83,29,8,8,57,30,27
"2021","Medway 020D","E01016069",705,229,41,188,392,12,150,54,76,20,99,49,44,6,121,97,24,10,10,84,37,47
"2021","Medway 021A","E01016020",513,168,47,121,311,17,167,41,100,26,50,27,20,3,76,51,25,1,1,34,15,19
"2021","Medway 021B","E01016021",609,156,65,91,396,37,175,46,105,24,77,28,42,7,97,54,43,10,10,57,29,28
"2021","Medway 021C","E01016022",536,134,34,100,337,20,161,35,91,35,56,24,28,4,94,59,35,6,6,65,42,23
"2021","Medway 021D","E01016125",652,148,65,83,446,53,230,48,127,55,83,41,34,8,76,50,26,4,4,58,30,28
"2021","Medway 022A","E01016018",729,185,53,132,491,8,215,57,123,35,114,47,62,5,149,109,40,5,5,53,32,21
"2021","Medway 022B","E01016023",615,133,57,76,437,14,171,37,102,32,85,28,48,9,163,112,51,4,4,45,34,11
"2021","Medway 022C","E01016024",754,184,42,142,502,20,197,54,122,21,113,34,71,8,165,123,42,7,7,68,40,28
"2021","Medway 022D","E01016062",604,160,54,106,389,27,173,45,93,35,74,25,41,8,107,66,41,8,8,55,22,33
"2021","Medway 023A","E01016093",770,192,133,59,545,131,288,94,138,56,78,39,34,5,45,23,22,3,3,33,9,24
"2021","Medway 023B","E01016096",669,184,126,58,458,102,206,81,86,39,90,43,38,9,57,34,23,3,3,27,10,17
"2021","Medway 023C","E01016166",616,137,86,51,445,70,212,60,107,45,84,36,36,12,76,31,45,3,3,34,19,15
"2021","Medway 023D","E01016167",586,151,91,60,397,60,217,74,83,60,54,19,29,6,62,32,30,4,4,38,17,21
"2021","Medway 024A","E01016116",750,189,98,91,531,40,269,71,152,46,103,47,47,9,111,60,51,8,8,30,19,11
"2021","Medway 024B","E01016127",681,231,108,123,413,67,179,52,93,34,83,47,33,3,78,46,32,6,6,37,12,25
"2021","Medway 024C","E01016128",564,124,72,52,396,48,181,55,97,29,79,42,34,3,86,40,46,2,2,44,23,21
"2021","Medway 024D","E01016132",676,131,58,73,508,73,280,90,140,50,81,37,33,11,73,41,32,1,1,37,14,23
"2021","Medway 025A","E01016094",670,174,102,72,466,81,220,80,97,43,91,44,37,10,72,36,36,2,2,30,14,16
"2021","Medway 025B","E01016095",539,128,58,70,382,49,184,58,90,36,91,48,38,5,56,30,26,2,2,29,17,12
"2021","Medway 025C","E01016097",625,200,90,110,394,43,179,60,86,33,81,42,37,2,90,60,30,1,1,31,19,12
"2021","Medway 025D","E01016098",711,316,153,163,370,42,117,46,46,25,108,46,57,5,95,67,28,8,8,25,11,14
"2021","Medway 025E","E01016102",619,204,102,102,367,41,142,46,57,39,79,33,37,9,102,50,52,3,3,48,27,21
"2021","Medway 026A","E01016119",550,115,72,43,398,72,221,62,83,76,48,17,27,4,56,33,23,1,1,37,19,18
"2021","Medway 026B","E01016120",581,174,83,91,377,34,178,53,93,32,76,27,41,8,88,41,47,1,1,30,12,18
"2021","Medway 026C","E01016124",685,191,103,88,448,64,254,76,117,61,80,34,37,9,50,29,21,0,0,46,25,21
"2021","Medway 026D","E01016126",611,107,65,42,457,70,260,82,113,65,71,28,34,9,54,23,31,2,2,47,25,22
"2021","Medway 027A","E01016025",624,199,106,93,382,54,196,59,96,41,56,23,29,4,70,41,29,6,6,43,30,13
"2021","Medway 027B","E01016065",631,213,102,111,398,76,208,83,72,53,72,40,28,4,41,27,14,1,1,20,11,9
"2021","Medway 027C","E01016066",661,171,76,95,455,48,220,66,114,40,91,41,47,3,95,58,37,1,1,35,22,13
"2021","Medway 027D","E01016067",641,177,80,97,420,26,214,68,100,46,86,35,41,10,88,42,46,6,6,44,26,18
"2021","Medway 027E","E01016068",667,185,80,105,432,23,189,52,98,39,91,31,51,9,125,88,37,4,4,50,35,15
"2021","Medway 028A","E01016026",538,127,62,65,387,53,208,78,93,37,85,43,35,7,40,20,20,1,1,24,12,12
"2021","Medway 028B","E01016027",583,101,75,26,452,104,238,75,117,46,56,26,26,4,53,23,30,1,1,30,13,17
"2021","Medway 028C","E01016028",665,193,127,66,438,99,217,80,86,51,71,33,31,7,48,18,30,3,3,34,20,14
"2021","Medway 028D","E01016029",878,211,68,143,613,42,321,110,157,54,144,62,72,10,105,70,35,1,1,54,33,21
"2021","Medway 029A","E01016087",703,173,99,74,495,92,253,77,120,56,96,39,48,9,54,31,23,0,0,35,20,15
"2021","Medway 029B","E01016088",591,128,77,51,432,65,208,52,109,47,69,32,35,2,88,52,36,2,2,31,16,15
"2021","Medway 029C","E01016089",668,206,138,68,428,89,202,61,97,44,75,33,33,9,59,27,32,3,3,34,15,19
"2021","Medway 029D","E01016090",612,135,100,35,444,99,236,74,116,46,63,24,31,8,46,14,32,0,0,33,13,20
"2021","Medway 030A","E01016085",667,154,122,32,473,157,242,68,107,67,40,14,23,3,33,11,22,1,1,40,20,20
"2021","Medway 030B","E01016086",512,112,89,23,380,85,240,70,107,63,35,17,15,3,20,9,11,0,0,20,11,9
"2021","Medway 030C","E01016091",617,138,105,33,452,132,239,70,101,68,49,27,18,4,30,11,19,2,2,27,13,14
"2021","Medway 030D","E01016176",574,100,56,44,431,74,262,93,101,68,62,33,24,5,33,13,20,0,0,43,19,24
"2021","Medway 031A","E01016058",620,180,82,98,415,70,210,74,94,42,90,51,33,6,44,21,23,1,1,25,16,9
"2021","Medway 031B","E01016059",534,154,80,74,340,34,144,39,73,32,69,28,37,4,88,48,40,5,5,40,18,22
"2021","Medway 031C","E01016079",484,86,38,48,355,46,205,69,86,50,49,21,25,3,54,30,24,1,1,43,27,16
"2021","Medway 031D","E01016083",562,219,94,125,313,26,121,44,55,22,70,29,32,9,96,57,39,0,0,30,20,10
"2021","Medway 031E","E01016084",506,81,37,44,383,27,174,37,91,46,75,24,40,11,103,64,39,4,4,42,24,18
"2021","Medway 032A","E01016101",564,131,74,57,411,34,220,64,100,56,87,41,44,2,68,41,27,2,2,22,9,13
"2021","Medway 032B","E01016103",726,149,66,83,533,74,309,97,158,54,85,39,37,9,62,43,19,3,3,44,21,23
"2021","Medway 032C","E01016104",562,121,48,73,413,48,196,62,100,34,107,55,45,7,61,42,19,1,1,28,15,13
"2021","Medway 032D","E01016107",602,143,68,75,438,73,239,67,115,57,78,42,31,5,47,36,11,1,1,21,14,7
"2021","Medway 033A","E01016121",631,168,108,60,436,105,214,79,86,49,55,27,25,3,58,27,31,4,4,27,15,12
"2021","Medway 033B","E01016122",953,285,146,139,609,88,342,97,176,69,112,60,42,10,63,39,24,4,4,59,41,18
"2021","Medway 033C","E01016123",637,168,97,71,432,76,217,67,102,48,74,28,37,9,64,28,36,1,1,37,18,19
"2021","Medway 033D","E01016173",657,178,75,103,431,56,208,54,103,51,69,26,41,2,91,58,33,7,7,48,24,24
"2021","Medway 034A","E01016078",667,212,26,186,430,14,199,67,97,35,139,83,53,3,77,58,19,1,1,25,10,15
"2021","Medway 034B","E01016080",610,176,86,90,412,40,200,70,98,32,113,55,48,10,59,36,23,0,0,22,10,12
"2021","Medway 034C","E01016081",584,101,25,76,439,42,260,92,123,45,86,28,52,6,48,35,13,3,3,44,20,24
"2021","Medway 034D","E01016082",576,111,48,63,429,51,225,68,114,43,93,48,42,3,56,32,24,4,4,36,17,19
"2021","Medway 035A","E01016050",668,147,91,56,502,116,272,76,128,68,66,29,30,7,44,15,29,4,4,19,5,14
"2021","Medway 035B","E01016051",595,119,68,51,440,63,258,89,121,48,67,34,26,7,50,26,24,2,2,36,15,21
"2021","Medway 035C","E01016052",650,130,101,29,477,128,275,93,126,56,43,13,25,5,31,9,22,0,0,43,20,23
"2021","Medway 035D","E01016053",640,151,111,40,462,140,250,86,110,54,39,22,12,5,31,12,19,2,2,27,11,16
"2021","Medway 035E","E01016054",639,131,75,56,480,112,265,100,116,49,71,33,33,5,32,17,15,0,0,28,16,12
"2021","Medway 036A","E01016092",621,173,112,61,418,80,217,71,99,47,72,33,35,4,49,19,30,0,0,30,13,17
"2021","Medway 036B","E01016099",628,149,68,81,462,60,197,59,103,35,106,49,45,12,98,59,39,1,1,17,7,10
"2021","Medway 036C","E01016100",650,181,104,77,434,68,185,69,80,36,98,48,43,7,80,47,33,3,3,35,21,14
"2021","Medway 036D","E01016105",586,173,109,64,389,96,196,54,93,49,50,27,20,3,44,19,25,3,3,24,11,13
"2021","Medway 036E","E01016106",589,157,99,58,399,90,170,57,84,29,79,30,39,10,58,27,31,2,2,33,16,17
"2021","Medway 037A","E01016168",664,175,98,77,452,65,223,65,105,53,85,38,46,1,76,39,37,3,3,37,20,17
"2021","Medway 037B","E01016169",622,128,75,53,456,79,256,73,122,61,68,25,33,10,52,29,23,1,1,38,17,21
"2021","Medway 037C","E01016171",647,162,90,72,452,48,186,55,89,42,96,29,56,11,118,71,47,4,4,33,18,15
"2021","Medway 037D","E01016172",580,132,80,52,406,88,218,62,117,39,55,30,22,3,42,22,20,3,3,42,18,24
"2021","Medway 038A","E01016055",617,165,104,61,423,63,204,58,96,50,79,24,50,5,73,46,27,4,4,29,16,13
"2021","Medway 038B","E01016056",644,209,85,124,403,23,177,60,87,30,122,63,53,6,80,52,28,1,1,32,16,16
"2021","Medway 038C","E01016057",652,132,65,67,497,61,250,79,115,56,98,32,57,9,86,43,43,2,2,23,12,11
"2021","Medway 038D","E01016060",628,130,87,43,467,113,247,76,112,59,64,22,38,4,43,18,25,0,0,31,15,16
"2021","Medway 038E","E01016170",627,145,68,77,438,59,189,45,92,52,102,41,55,6,85,41,44,3,3,44,21,23
"2021","Bracknell Forest 001C","E01016252",700,228,114,114,431,100,217,94,92,31,66,45,15,6,46,24,22,2,2,41,9,32
"2021","Bracknell Forest 001D","E01016253",537,106,43,63,408,47,283,78,150,55,40,29,10,1,34,20,14,4,4,23,11,12
"2021","Bracknell Forest 001F","E01035234",433,114,67,47,296,50,179,64,77,38,31,22,8,1,33,14,19,3,3,23,10,13
"2021","Bracknell Forest 001G","E01035235",835,268,192,76,536,171,281,111,128,42,41,23,18,0,43,17,26,0,0,31,19,12
"2021","Bracknell Forest 002B","E01016185",624,219,77,142,372,35,197,87,90,20,80,62,14,4,57,29,28,3,3,33,10,23
"2021","Bracknell Forest 002D","E01016187",675,160,88,72,492,100,283,93,142,48,68,35,32,1,41,30,11,0,0,23,13,10
"2021","Bracknell Forest 002E","E01016188",775,151,57,94,600,41,354,121,190,43,133,85,41,7,71,48,23,1,1,24,8,16
"2021","Bracknell Forest 002F","E01035236",716,154,64,90,510,77,270,94,125,51,102,54,44,4,59,36,23,2,2,52,22,30
"2021","Bracknell Forest 002G","E01035237",584,151,58,93,407,27,230,80,141,9,110,81,28,1,39,27,12,1,1,26,9,17
"2021","Bracknell Forest 002H","E01035238",501,97,33,64,373,21,222,62,142,18,96,58,37,1,33,27,6,1,1,31,15,16
"2021","Bracknell Forest 002I","E01035239",448,88,40,48,342,45,214,77,100,37,55,43,9,3,27,9,18,1,1,18,7,11
"2021","Bracknell Forest 002J","E01035240",609,170,16,154,403,9,197,59,123,15,138,90,45,3,55,45,10,4,4,36,18,18
"2021","Bracknell Forest 003A","E01016190",615,139,87,52,427,72,220,63,111,46,55,29,20,6,74,48,26,6,6,49,22,27
"2021","Bracknell Forest 003B","E01016238",709,225,106,119,430,72,204,78,93,33,101,72,28,1,47,23,24,6,6,54,11,43
"2021","Bracknell Forest 003C","E01016243",582,161,44,117,406,35,246,70,136,40,83,54,25,4,38,19,19,4,4,15,4,11
"2021","Bracknell Forest 003D","E01016245",878,157,49,108,682,70,456,144,230,82,106,61,39,6,48,31,17,2,2,39,18,21
"2021","Bracknell Forest 003E","E01016246",612,130,42,88,456,37,297,75,166,56,72,44,21,7,46,31,15,4,4,26,10,16
"2021","Bracknell Forest 003F","E01016247",733,172,44,128,528,33,303,105,154,44,117,68,41,8,70,45,25,5,5,33,17,16
"2021","Bracknell Forest 004A","E01016239",617,144,65,79,437,51,225,75,101,49,77,24,46,7,80,42,38,4,4,36,20,16
"2021","Bracknell Forest 004B","E01016240",644,162,64,98,438,32,211,62,107,42,92,45,38,9,96,61,35,7,7,44,24,20
"2021","Bracknell Forest 004C","E01016241",629,161,66,95,421,29,210,57,126,27,77,30,40,7,98,60,38,7,7,47,21,26
"2021","Bracknell Forest 004D","E01016242",987,384,72,312,543,25,207,68,108,31,183,124,54,5,119,89,30,9,9,60,20,40
"2021","Bracknell Forest 005A","E01016180",544,161,101,60,355,48,186,49,105,32,57,34,20,3,60,36,24,4,4,28,7,21
"2021","Bracknell Forest 005B","E01016181",657,167,82,85,441,84,248,87,126,35,61,36,19,6,48,29,19,0,0,49,21,28
"2021","Bracknell Forest 005C","E01016182",627,159,72,87,430,66,238,83,111,44,65,40,21,4,56,31,25,5,5,38,11,27
"2021","Bracknell Forest 005D","E01016183",526,122,56,66,366,41,220,58,129,33,57,24,31,2,48,33,15,0,0,38,19,19
"2021","Bracknell Forest 005E","E01016222",495,96,34,62,379,52,248,93,104,51,61,37,19,5,18,6,12,0,0,20,7,13
"2021","Bracknell Forest 006B","E01016191",638,148,87,61,441,61,238,66,129,43,68,21,36,11,70,34,36,4,4,49,18,31
"2021","Bracknell Forest 006C","E01016223",544,190,55,135,327,25,180,62,93,25,74,47,22,5,45,30,15,3,3,27,11,16
"2021","Bracknell Forest 006D","E01016224",874,239,71,168,567,34,275,73,163,39,114,59,50,5,137,96,41,7,7,68,24,44
"2021","Bracknell Forest 006E","E01016226",635,199,78,121,396,37,194,68,93,33,89,47,33,9,73,45,28,3,3,40,12,28
"2021","Bracknell Forest 006F","E01032724",769,279,93,186,428,26,198,66,117,15,104,53,50,1,92,74,18,8,8,62,28,34
"2021","Bracknell Forest 006G","E01032728",858,335,82,253,439,27,189,65,102,22,131,87,41,3,83,59,24,9,9,84,33,51
"2021","Bracknell Forest 007B","E01016233",1053,331,74,257,628,31,288,80,166,42,147,71,67,9,154,104,50,8,8,94,38,56
"2021","Bracknell Forest 007C","E01016248",567,135,73,62,373,44,191,51,83,57,49,12,34,3,84,53,31,5,5,59,27,32
"2021","Bracknell Forest 007E","E01016250",763,255,102,153,460,60,219,71,104,44,100,52,43,5,75,46,29,6,6,48,21,27
"2021","Bracknell Forest 007F","E01035241",756,395,50,345,325,7,138,68,66,4,112,93,18,1,59,48,11,9,9,36,4,32
"2021","Bracknell Forest 007G","E01035242",708,244,54,190,405,31,184,84,76,24,124,101,20,3,58,39,19,8,8,59,9,50
"2021","Bracknell Forest 007H","E01035243",647,109,18,91,503,16,305,80,198,27,87,45,39,3,91,72,19,4,4,35,17,18
"2021","Bracknell Forest 007I","E01035244",540,152,46,106,364,44,191,49,105,37,83,44,36,3,43,31,12,3,3,24,14,10
"2021","Bracknell Forest 008A","E01016200",560,141,20,121,388,26,209,75,108,26,110,73,34,3,42,18,24,1,1,31,11,20
"2021","Bracknell Forest 008B","E01016201",558,158,28,130,372,19,205,83,91,31,93,65,26,2,52,30,22,3,3,28,10,18
"2021","Bracknell Forest 008C","E01016202",614,229,34,195,365,9,163,76,70,17,144,105,37,2,45,27,18,4,4,20,2,18
"2021","Bracknell Forest 008D","E01016203",589,205,96,109,349,24,165,74,65,26,84,44,35,5,70,43,27,6,6,35,14,21
"2021","Bracknell Forest 008E","E01016204",472,113,44,69,326,29,172,50,86,36,66,41,20,5,56,35,21,3,3,33,14,19
"2021","Bracknell Forest 009A","E01016209",557,107,67,40,399,55,201,60,91,50,66,29,30,7,71,41,30,6,6,51,24,27
"2021","Bracknell Forest 009B","E01016210",519,153,46,107,326,24,129,38,66,25,75,23,49,3,96,66,30,2,2,40,18,22
"2021","Bracknell Forest 009D","E01016213",422,85,52,33,312,40,192,66,78,48,45,22,23,0,33,20,13,2,2,25,8,17
"2021","Bracknell Forest 009E","E01016214",499,70,44,26,396,106,239,75,112,52,25,11,10,4,25,13,12,1,1,33,18,15
"2021","Bracknell Forest 009F","E01016215",476,115,50,65,323,24,145,42,78,25,61,23,33,5,90,60,30,3,3,38,17,21
"2021","Bracknell Forest 009H","E01032726",628,136,67,69,441,31,224,58,118,48,84,30,46,8,99,61,38,3,3,51,21,30
"2021","Bracknell Forest 009I","E01035245",584,91,11,80,461,14,269,76,169,24,107,60,47,0,68,41,27,3,3,32,7,25
"2021","Bracknell Forest 009J","E01035246",651,121,22,99,488,14,280,67,196,17,121,62,53,6,70,59,11,3,3,42,23,19
"2021","Bracknell Forest 010A","E01016205",540,157,63,94,355,35,179,52,88,39,70,37,29,4,64,38,26,7,7,28,13,15
"2021","Bracknell Forest 010B","E01016217",573,141,53,88,393,35,206,81,95,30,74,49,20,5,75,46,29,3,3,39,14,25
"2021","Bracknell Forest 010C","E01016218",633,243,102,141,360,39,184,68,87,29,76,41,31,4,59,22,37,2,2,30,14,16
"2021","Bracknell Forest 010D","E01016231",734,169,55,114,485,39,258,78,135,45,94,44,47,3,91,57,34,3,3,80,31,49
"2021","Bracknell Forest 010E","E01016232",593,165,66,99,383,54,197,70,89,38,72,41,27,4,57,32,25,3,3,45,14,31
"2021","Bracknell Forest 011A","E01016212",492,91,51,40,348,38,172,44,99,29,50,17,29,4,87,53,34,1,1,53,18,35
"2021","Bracknell Forest 011B","E01016216",552,155,59,96,366,39,196,62,101,33,67,35,29,3,61,34,27,3,3,31,13,18
"2021","Bracknell Forest 011C","E01016219",542,143,90,53,363,77,184,55,79,50,47,23,20,4,50,26,24,5,5,36,12,24
"2021","Bracknell Forest 011D","E01016220",574,181,47,134,346,23,163,47,96,20,77,42,33,2,77,51,26,6,6,47,19,28
"2021","Bracknell Forest 011E","E01016221",571,192,71,121,348,32,193,69,93,31,65,40,22,3,55,32,23,3,3,31,14,17
"2021","Bracknell Forest 012A","E01016206",854,243,135,108,571,168,270,77,143,50,64,40,23,1,65,35,30,4,4,40,16,24
"2021","Bracknell Forest 012B","E01016208",908,283,126,157,583,87,312,97,165,50,111,63,43,5,71,45,26,2,2,42,15,27
"2021","Bracknell Forest 012C","E01016229",488,143,99,44,320,63,173,63,75,35,51,26,23,2,33,13,20,0,0,25,11,14
"2021","Bracknell Forest 012D","E01016230",423,134,67,67,272,51,151,60,75,16,41,26,13,2,27,16,11,2,2,17,5,12
"2021","Bracknell Forest 013A","E01016207",727,166,57,109,525,37,305,81,173,51,102,74,23,5,77,40,37,4,4,36,16,20
"2021","Bracknell Forest 013B","E01016234",452,99,47,52,327,59,181,68,80,33,55,29,23,3,31,22,9,1,1,26,12,14
"2021","Bracknell Forest 013C","E01016235",485,95,46,49,371,54,225,72,91,62,49,27,19,3,41,25,16,2,2,19,6,13
"2021","Bracknell Forest 013D","E01016236",575,140,44,96,378,32,199,57,100,42,71,31,38,2,71,46,25,5,5,57,29,28
"2021","Bracknell Forest 013E","E01016237",475,122,44,78,334,49,176,47,89,40,57,33,18,6,51,29,22,1,1,19,10,9
"2021","Bracknell Forest 014A","E01016192",606,214,91,123,359,51,189,59,97,33,76,42,27,7,42,28,14,1,1,33,15,18
"2021","Bracknell Forest 014B","E01016194",501,111,73,38,356,106,191,62,94,35,30,19,7,4,28,14,14,1,1,34,8,26
"2021","Bracknell Forest 014C","E01016195",484,125,40,85,330,20,170,55,88,27,85,54,27,4,53,33,20,2,2,29,12,17
"2021","Bracknell Forest 014D","E01016227",479,70,34,36,385,62,224,59,126,39,57,23,33,1,42,29,13,0,0,24,8,16
"2021","Bracknell Forest 014E","E01016228",679,121,63,58,510,89,282,79,146,57,78,36,35,7,59,38,21,2,2,48,21,27
"2021","Bracknell Forest 015A","E01016193",530,162,59,103,327,23,181,66,75,40,72,43,27,2,47,32,15,4,4,41,18,23
"2021","Bracknell Forest 015B","E01016196",499,68,35,33,397,42,272,76,158,38,44,16,27,1,36,15,21,3,3,34,12,22
"2021","Bracknell Forest 015C","E01016197",504,90,48,42,360,50,196,52,103,41,51,20,30,1,59,30,29,4,4,54,29,25
"2021","Bracknell Forest 015D","E01016198",518,163,95,68,335,50,189,64,84,41,61,44,14,3,33,17,16,2,2,20,7,13
"2021","Bracknell Forest 015E","E01016199",468,101,45,56,337,51,219,86,86,47,38,27,8,3,28,11,17,1,1,30,16,14
"2021","West Berkshire 001A","E01016277",535,118,72,46,398,92,239,80,126,33,33,15,15,3,34,19,15,0,0,19,4,15
"2021","West Berkshire 001B","E01016286",652,121,59,62,491,56,288,81,154,53,65,31,31,3,79,59,20,3,3,40,17,23
"2021","West Berkshire 001C","E01016287",588,122,57,65,439,74,256,92,112,52,67,42,21,4,41,20,21,1,1,27,6,21
"2021","West Berkshire 001D","E01016288",694,148,68,80,511,90,313,130,146,37,61,38,21,2,45,23,22,2,2,35,10,25
"2021","West Berkshire 002A","E01016303",633,150,85,65,458,102,252,114,97,41,68,39,24,5,33,18,15,3,3,25,5,20
"2021","West Berkshire 002B","E01016304",711,192,88,104,477,97,239,106,100,33,88,54,31,3,52,30,22,1,1,42,15,27
"2021","West Berkshire 002C","E01016305",615,230,94,136,345,73,172,81,65,26,70,50,19,1,27,12,15,3,3,40,8,32
"2021","West Berkshire 002D","E01016306",553,147,69,78,367,63,162,53,72,37,73,32,36,5,63,37,26,6,6,39,11,28
"2021","West Berkshire 003A","E01016256",699,115,55,60,557,107,347,120,157,70,60,38,17,5,39,18,21,4,4,27,10,17
"2021","West Berkshire 003B","E01016257",516,100,57,43,395,68,265,90,145,30,39,24,11,4,21,10,11,2,2,21,6,15
"2021","West Berkshire 003C","E01016313",750,231,119,112,484,82,239,95,101,43,75,40,30,5,85,48,37,3,3,35,12,23
"2021","West Berkshire 003D","E01016314",601,141,78,63,432,97,242,103,102,37,48,32,14,2,42,27,15,3,3,28,6,22
"2021","West Berkshire 004A","E01016315",724,201,80,121,494,129,249,89,115,45,71,51,16,4,41,13,28,4,4,29,11,18
"2021","West Berkshire 004B","E01016316",799,163,78,85,583,90,359,118,174,67,74,38,32,4,55,28,27,5,5,53,26,27
"2021","West Berkshire 004C","E01016317",567,104,55,49,429,93,247,74,126,47,36,16,17,3,52,30,22,1,1,34,11,23
"2021","West Berkshire 004D","E01016318",631,162,98,64,443,94,231,77,101,53,62,29,30,3,51,30,21,5,5,26,13,13
"2021","West Berkshire 005A","E01016258",685,232,151,81,436,93,238,75,103,60,55,22,30,3,49,30,19,1,1,17,4,13
"2021","West Berkshire 005B","E01016261",586,68,34,34,493,53,324,99,151,74,70,37,30,3,45,24,21,1,1,25,9,16
"2021","West Berkshire 005C","E01016349",485,95,60,35,359,71,204,57,99,48,49,22,27,0,34,14,20,1,1,31,19,12
"2021","West Berkshire 005D","E01016350",586,135,93,42,409,84,212,60,100,52,63,31,28,4,46,23,23,4,4,42,18,24
"2021","West Berkshire 006A","E01016259",608,120,60,60,452,71,243,68,114,61,73,41,27,5,62,31,31,3,3,36,16,20
"2021","West Berkshire 006B","E01016260",643,111,78,33,489,97,280,90,128,62,49,21,21,7,60,28,32,3,3,43,18,25
"2021","West Berkshire 006C","E01016262",535,121,95,26,390,82,228,65,104,59,45,12,33,0,33,20,13,2,2,24,12,12
"2021","West Berkshire 006D","E01016272",614,140,77,63,441,82,274,86,127,61,49,23,20,6,36,23,13,0,0,33,15,18
"2021","West Berkshire 006E","E01016273",700,203,123,80,451,49,206,55,107,44,91,34,49,8,99,65,34,6,6,46,20,26
"2021","West Berkshire 007A","E01016263",894,153,70,83,702,117,404,102,233,69,103,44,55,4,77,59,18,1,1,39,18,21
"2021","West Berkshire 007D","E01016284",528,93,47,46,402,75,242,85,112,45,51,32,15,4,34,21,13,0,0,33,10,23
"2021","West Berkshire 007E","E01016285",637,155,72,83,455,69,276,90,141,45,62,38,19,5,47,32,15,1,1,27,12,15
"2021","West Berkshire 007F","E01033851",978,162,87,75,761,133,501,152,271,78,73,35,28,10,53,34,19,1,1,55,20,35
"2021","West Berkshire 008A","E01016271",645,214,87,127,399,64,194,66,74,54,66,42,22,2,71,41,30,4,4,32,16,16
"2021","West Berkshire 008B","E01016274",570,112,49,63,430,80,225,78,91,56,65,39,22,4,57,36,21,3,3,28,12,16
"2021","West Berkshire 008C","E01016275",656,210,50,160,430,47,208,73,100,35,105,68,36,1,66,39,27,4,4,16,5,11
"2021","West Berkshire 008D","E01016276",585,129,38,91,422,42,229,65,103,61,94,45,41,8,52,31,21,5,5,34,9,25
"2021","West Berkshire 009A","E01016327",497,105,42,63,365,60,205,81,88,36,58,33,22,3,40,27,13,2,2,27,10,17
"2021","West Berkshire 009B","E01016328",790,192,80,112,562,64,277,87,137,53,109,68,35,6,111,70,41,1,1,36,18,18
"2021","West Berkshire 009C","E01016344",781,353,146,207,398,39,197,68,89,40,96,62,32,2,60,40,20,6,6,30,7,23
"2021","West Berkshire 009D","E01016345",617,169,66,103,402,55,202,62,102,38,87,55,29,3,56,35,21,2,2,46,18,28
"2021","West Berkshire 010A","E01016296",748,281,133,148,445,67,196,91,72,33,93,58,32,3,89,61,28,0,0,22,8,14
"2021","West Berkshire 010B","E01016297",717,242,143,99,451,85,229,77,100,52,68,29,32,7,67,37,30,2,2,24,12,12
"2021","West Berkshire 010C","E01016298",565,220,100,120,320,59,160,75,62,23,65,43,21,1,32,23,9,4,4,25,7,18
"2021","West Berkshire 010D","E01016299",665,194,91,103,445,93,214,89,92,33,76,44,29,3,52,33,19,10,10,26,10,16
"2021","West Berkshire 011A","E01016254",691,248,138,110,419,83,232,100,99,33,66,47,14,5,38,18,20,0,0,24,6,18
"2021","West Berkshire 011B","E01016255",582,150,78,72,397,89,220,73,102,45,49,30,16,3,37,19,18,2,2,35,16,19
"2021","West Berkshire 011C","E01016264",415,105,50,55,294,46,194,52,106,36,33,20,11,2,20,12,8,1,1,16,4,12
"2021","West Berkshire 011D","E01016265",601,131,88,43,444,102,252,88,121,43,55,25,30,0,32,15,17,3,3,26,13,13
"2021","West Berkshire 011E","E01016266",541,112,71,41,405,87,232,89,94,49,51,26,21,4,33,19,14,2,2,24,10,14
"2021","West Berkshire 011F","E01016339",1135,284,112,172,794,108,431,137,229,65,147,78,59,10,105,73,32,3,3,57,24,33
"2021","West Berkshire 012A","E01016310",884,319,142,177,505,82,260,99,112,49,78,45,28,5,80,40,40,5,5,60,22,38
"2021","West Berkshire 012B","E01016311",870,378,168,210,455,78,229,94,113,22,87,65,19,3,51,30,21,10,10,37,6,31
"2021","West Berkshire 012C","E01016323",602,187,108,79,390,90,211,78,95,38,51,28,19,4,33,22,11,5,5,25,9,16
"2021","West Berkshire 012D","E01016324",590,171,93,78,382,71,212,71,96,45,51,30,19,2,45,28,17,3,3,37,15,22
"2021","West Berkshire 012E","E01016325",659,198,102,96,416,61,183,67,94,22,57,28,28,1,109,70,39,6,6,45,19,26
"2021","West Berkshire 013A","E01016279",946,307,97,210,566,33,292,88,163,41,133,85,45,3,99,70,29,9,9,73,23,50
"2021","West Berkshire 013B","E01016280",688,168,64,104,446,47,197,64,101,32,95,53,35,7,100,65,35,7,7,74,40,34
"2021","West Berkshire 013C","E01016281",579,133,79,54,410,60,227,78,101,48,76,40,32,4,44,24,20,3,3,36,12,24
"2021","West Berkshire 013D","E01016282",614,141,53,88,433,56,225,83,109,33,93,62,29,2,56,30,26,3,3,40,12,28
"2021","West Berkshire 014A","E01016329",622,181,57,124,415,54,224,81,94,49,90,60,26,4,43,22,21,4,4,26,7,19
"2021","West Berkshire 014B","E01016340",789,191,84,107,544,70,273,104,125,44,108,54,45,9,85,60,25,8,8,54,24,30
"2021","West Berkshire 014C","E01016341",519,115,43,72,365,42,207,70,94,43,52,24,26,2,64,30,34,0,0,39,16,23
"2021","West Berkshire 014D","E01016342",850,209,57,152,586,56,298,101,140,57,147,75,63,9,79,42,37,6,6,55,13,42
"2021","West Berkshire 014E","E01016343",580,131,81,50,415,93,229,92,81,56,54,32,19,3,36,13,23,3,3,34,11,23
"2021","West Berkshire 015A","E01016267",583,117,62,55,443,93,268,89,144,35,50,25,22,3,28,13,15,4,4,23,5,18
"2021","West Berkshire 015B","E01016268",681,154,83,71,499,62,249,78,127,44,73,29,35,9,113,84,29,2,2,28,10,18
"2021","West Berkshire 015C","E01016269",576,144,69,75,393,64,242,87,115,40,47,29,17,1,35,18,17,5,5,39,14,25
"2021","West Berkshire 015D","E01016270",534,103,47,56,422,38,291,84,176,31,54,28,26,0,37,26,11,2,2,9,1,8
"2021","West Berkshire 016A","E01016330",670,239,101,138,411,53,199,83,81,35,93,63,28,2,61,45,16,5,5,20,7,13
"2021","West Berkshire 016B","E01016331",596,130,59,71,438,47,215,64,113,38,89,42,44,3,85,47,38,2,2,28,17,11
"2021","West Berkshire 016C","E01016332",752,302,177,125,406,92,178,64,82,32,73,37,32,4,57,30,27,6,6,44,18,26
"2021","West Berkshire 016D","E01016334",660,166,45,121,456,30,255,78,132,45,83,41,39,3,83,55,28,5,5,38,16,22
"2021","West Berkshire 016E","E01016336",534,149,89,60,347,37,140,55,48,37,67,19,42,6,102,70,32,1,1,38,17,21
"2021","West Berkshire 017A","E01016333",505,111,38,73,374,34,235,81,111,43,68,46,19,3,34,23,11,3,3,20,9,11
"2021","West Berkshire 017B","E01016335",602,133,72,61,445,55,257,89,122,46,83,45,32,6,45,21,24,5,5,24,8,16
"2021","West Berkshire 017C","E01016337",918,234,101,133,639,55,350,89,218,43,114,56,56,2,115,83,32,5,5,45,19,26
"2021","West Berkshire 017D","E01016338",741,172,91,81,547,66,335,128,135,72,77,38,33,6,67,40,27,2,2,22,7,15
"2021","West Berkshire 018A","E01016300",637,180,102,78,437,76,229,96,105,28,59,38,18,3,71,45,26,2,2,20,5,15
"2021","West Berkshire 018B","E01016301",869,212,130,82,618,134,376,164,149,63,63,39,19,5,43,15,28,2,2,39,12,27
"2021","West Berkshire 018C","E01016302",641,122,74,48,486,85,285,119,111,55,60,40,19,1,55,28,27,1,1,33,12,21
"2021","West Berkshire 018D","E01016326",563,129,64,65,401,79,242,104,103,35,56,37,16,3,24,15,9,0,0,33,12,21
"2021","West Berkshire 019B","E01016346",784,361,86,275,381,27,164,68,82,14,116,83,29,4,66,51,15,8,8,42,5,37
"2021","West Berkshire 019D","E01016348",1111,376,95,281,660,38,313,114,166,33,205,148,54,3,96,70,26,8,8,75,19,56
"2021","West Berkshire 019E","E01033852",655,169,49,120,439,59,223,84,95,44,80,48,29,3,75,40,35,2,2,47,13,34
"2021","West Berkshire 019F","E01033853",681,139,69,70,510,70,300,83,170,47,85,47,33,5,54,35,19,1,1,32,12,20
"2021","West Berkshire 019G","E01033854",795,266,34,232,496,27,208,79,119,10,180,136,42,2,74,62,12,7,7,33,6,27
"2021","West Berkshire 019H","E01033855",712,414,180,234,262,32,116,47,62,7,70,57,12,1,39,25,14,5,5,36,8,28
"2021","West Berkshire 019I","E01033856",616,286,74,212,298,13,131,58,70,3,94,76,17,1,51,39,12,9,9,32,4,28
"2021","West Berkshire 020A","E01016294",652,167,67,100,450,65,256,93,124,39,71,42,28,1,57,29,28,1,1,35,8,27
"2021","West Berkshire 020B","E01016295",623,208,57,151,378,32,146,52,68,26,94,44,41,9,104,80,24,2,2,37,18,19
"2021","West Berkshire 020C","E01016312",878,265,74,191,561,49,304,98,171,35,103,66,31,6,91,53,38,14,14,52,21,31
"2021","West Berkshire 020D","E01016319",847,323,198,125,498,94,258,80,135,43,81,50,26,5,62,42,20,3,3,26,8,18
"2021","West Berkshire 020E","E01016320",660,229,88,141,408,55,231,87,115,29,75,49,24,2,40,23,17,7,7,23,8,15
"2021","West Berkshire 021A","E01016289",581,126,99,27,433,152,237,74,124,39,28,11,17,0,16,10,6,0,0,22,7,15
"2021","West Berkshire 021B","E01016290",627,135,71,64,475,97,255,68,132,55,66,32,33,1,56,35,21,1,1,17,4,13
"2021","West Berkshire 021C","E01016291",736,158,76,82,542,98,314,80,184,50,69,34,34,1,59,40,19,2,2,36,19,17
"2021","West Berkshire 021D","E01016292",607,119,69,50,448,67,242,70,115,57,77,33,35,9,61,36,25,1,1,40,23,17
"2021","West Berkshire 021E","E01016321",685,209,94,115,437,60,232,59,135,38,76,48,26,2,60,32,28,9,9,39,9,30
"2021","West Berkshire 021F","E01016322",510,97,63,34,388,76,247,66,145,36,34,18,15,1,30,15,15,1,1,25,12,13
"2021","West Berkshire 022A","E01016307",727,229,113,116,461,82,240,71,130,39,67,35,30,2,69,41,28,3,3,37,6,31
"2021","West Berkshire 022B","E01016308",804,192,112,80,586,136,333,114,167,52,64,39,21,4,50,31,19,3,3,26,13,13
"2021","West Berkshire 022C","E01016309",962,241,104,137,678,103,391,138,192,61,103,54,43,6,80,53,27,1,1,43,18,25
"2021","Reading 001A","E01016407",656,194,133,61,426,78,233,56,136,41,51,20,23,8,63,39,24,1,1,36,9,27
"2021","Reading 001B","E01016408",577,158,88,70,362,56,196,57,97,42,45,24,19,2,59,26,33,6,6,57,24,33
"2021","Reading 001C","E01016410",711,158,64,94,498,79,288,82,155,51,66,45,20,1,57,36,21,8,8,55,20,35
"2021","Reading 001D","E01016411",670,153,110,43,488,136,278,90,142,46,39,20,18,1,35,14,21,0,0,29,6,23
"2021","Reading 001E","E01016412",578,124,66,58,416,55,255,56,150,49,52,27,18,7,51,29,22,3,3,38,17,21
"2021","Reading 002A","E01016386",609,137,104,33,449,107,268,83,135,50,46,23,21,2,27,13,14,1,1,23,7,16
"2021","Reading 002B","E01016387",591,98,71,27,465,102,293,77,158,58,37,20,16,1,32,11,21,1,1,28,17,11
"2021","Reading 002C","E01016425",668,131,82,49,508,68,335,99,192,44,51,27,22,2,53,31,22,1,1,29,12,17
"2021","Reading 002D","E01016426",512,63,42,21,414,74,285,77,163,45,27,15,9,3,25,17,8,3,3,35,11,24
"2021","Reading 002E","E01016430",513,72,41,31,421,52,275,63,160,52,50,25,21,4,42,25,17,2,2,20,7,13
"2021","Reading 003A","E01016364",600,175,84,91,372,43,230,66,137,27,57,44,12,1,38,20,18,4,4,53,15,38
"2021","Reading 003B","E01016409",747,228,140,88,470,61,243,57,146,40,67,34,26,7,98,57,41,1,1,49,22,27
"2021","Reading 003C","E01016427",666,193,104,89,452,69,273,69,159,45,63,44,17,2,45,22,23,2,2,21,5,16
"2021","Reading 003D","E01016428",758,197,98,99,516,72,295,74,186,35,76,47,25,4,71,44,27,2,2,45,24,21
"2021","Reading 003E","E01016429",633,128,80,48,473,67,290,76,175,39,69,36,29,4,46,22,24,1,1,32,9,23
"2021","Reading 004A","E01016362",905,353,144,209,495,35,206,90,101,15,172,134,32,6,75,55,20,7,7,57,10,47
"2021","Reading 004B","E01016363",709,137,36,101,506,19,200,43,125,32,109,51,48,10,172,115,57,6,6,66,20,46
"2021","Reading 004C","E01016365",782,240,66,174,467,36,210,84,107,19,150,104,39,7,63,28,35,8,8,75,9,66
"2021","Reading 004D","E01016366",679,195,77,118,428,45,204,63,106,35,95,57,31,7,79,49,30,5,5,56,16,40
"2021","Reading 004E","E01016367",696,195,60,135,452,33,203,64,109,30,125,85,37,3,86,53,33,5,5,49,13,36
"2021","Reading 005A","E01016380",705,180,70,110,466,70,230,61,131,38,91,51,34,6,71,42,29,4,4,59,23,36
"2021","Reading 005B","E01016383",663,177,77,100,450,29,216,88,83,45,113,58,48,7,89,61,28,3,3,36,11,25
"2021","Reading 005C","E01016384",629,104,45,59,478,107,274,97,112,65,48,17,26,5,40,21,19,9,9,47,15,32
"2021","Reading 005D","E01016431",647,147,79,68,465,71,255,59,133,63,69,35,31,3,68,42,26,2,2,35,15,20
"2021","Reading 005E","E01016432",630,192,138,54,410,78,209,64,91,54,62,26,30,6,58,41,17,3,3,28,13,15
"2021","Reading 006A","E01016381",529,101,42,59,366,25,202,57,104,41,51,21,25,5,80,45,35,8,8,62,29,33
"2021","Reading 006B","E01016382",721,159,61,98,466,28,196,53,104,39,96,56,29,11,135,89,46,11,11,96,34,62
"2021","Reading 006C","E01016385",606,115,39,76,441,37,224,68,124,32,89,50,32,7,87,52,35,4,4,50,24,26
"2021","Reading 006D","E01016396",668,189,86,103,420,26,205,51,115,39,84,45,31,8,98,63,35,7,7,59,30,29
"2021","Reading 006E","E01016397",683,189,79,110,436,18,198,51,115,32,74,23,45,6,137,95,42,9,9,58,39,19
"2021","Reading 007A","E01016355",820,245,45,200,446,13,233,86,111,36,129,110,17,2,53,28,25,18,18,129,21,108
"2021","Reading 007B","E01016358",764,231,29,202,381,17,165,55,96,14,93,70,21,2,88,52,36,18,18,152,39,113
"2021","Reading 007C","E01016359",1038,244,45,199,637,24,309,80,195,34,126,80,40,6,158,121,37,20,20,157,74,83
"2021","Reading 007D","E01016360",886,221,33,188,477,18,268,81,153,34,91,54,30,7,84,52,32,16,16,188,79,109
"2021","Reading 007E","E01016361",786,191,43,148,454,7,220,60,119,41,117,71,44,2,90,69,21,20,20,141,48,93
"2021","Reading 008A","E01016356",673,230,34,196,357,5,158,43,96,19,102,63,35,4,86,57,29,6,6,86,24,62
"2021","Reading 008B","E01016357",758,251,45,206,397,14,193,66,100,27,124,80,40,4,55,34,21,11,11,110,39,71
"2021","Reading 008C","E01016395",618,211,120,91,368,61,186,64,89,33,46,25,19,2,68,36,32,7,7,39,19,20
"2021","Reading 008D","E01016398",757,237,32,205,457,23,212,62,117,33,104,60,41,3,103,72,31,15,15,63,19,44
"2021","Reading 008E","E01016399",585,140,44,96,390,44,204,60,102,42,72,35,32,5,64,39,25,6,6,55,19,36
"2021","Reading 008F","E01016400",686,214,57,157,367,24,166,52,97,17,94,56,37,1,74,50,24,9,9,105,37,68
"2021","Reading 009A","E01016394",591,154,90,64,400,27,140,41,73,26,67,28,35,4,159,112,47,7,7,37,20,17
"2021","Reading 009B","E01016433",644,204,114,90,403,62,202,64,91,47,62,37,23,2,76,50,26,1,1,37,12,25
"2021","Reading 009C","E01016434",762,168,88,80,526,75,249,64,136,49,80,29,45,6,118,77,41,4,4,68,36,32
"2021","Reading 009D","E01016435",623,179,94,85,399,61,193,60,93,40,54,24,26,4,88,55,33,3,3,45,21,24
"2021","Reading 009E","E01016436",634,157,69,88,440,59,205,59,101,45,86,39,37,10,88,54,34,2,2,37,18,19
"2021","Reading 010B","E01016402",633,132,30,102,308,8,151,23,108,20,58,30,25,3,73,52,21,18,18,193,32,161
"2021","Reading 010C","E01016404",814,221,49,172,446,13,228,57,135,36,97,67,26,4,98,74,24,10,10,147,57,90
"2021","Reading 010D","E01016405",667,134,23,111,357,6,199,40,130,29,70,48,21,1,68,39,29,14,14,176,86,90
"2021","Reading 010E","E01016406",470,97,28,69,223,20,112,26,62,24,54,36,17,1,30,16,14,7,7,150,31,119
"2021","Reading 010F","E01033417",624,229,47,182,327,19,132,65,58,9,129,116,12,1,32,15,17,15,15,68,8,60
"2021","Reading 010G","E01033421",1069,392,71,321,554,23,261,78,149,34,153,119,30,4,105,73,32,12,12,123,32,91
"2021","Reading 012A","E01016401",567,181,58,123,289,47,162,45,86,31,50,37,10,3,27,14,13,3,3,97,19,78
"2021","Reading 012B","E01016403",675,128,50,78,429,43,265,60,166,39,71,49,18,4,44,28,16,6,6,118,31,87
"2021","Reading 012C","E01016416",730,269,29,240,264,11,115,42,64,9,92,78,14,0,40,23,17,6,6,197,21,176
"2021","Reading 012D","E01016417",555,129,35,94,212,20,97,37,47,13,60,39,17,4,25,11,14,10,10,214,18,196
"2021","Reading 012E","E01016418",571,123,28,95,228,19,107,31,65,11,60,46,14,0,36,23,13,6,6,220,17,203
"2021","Reading 013A","E01016388",622,175,76,99,378,58,191,62,81,48,60,41,18,1,57,34,23,12,12,69,23,46
"2021","Reading 013B","E01016389",696,198,52,146,433,18,174,33,118,23,63,20,32,11,169,121,48,9,9,65,29,36
"2021","Reading 013C","E01016390",714,278,78,200,371,28,187,65,100,22,107,82,24,1,37,18,19,12,12,65,15,50
"2021","Reading 013D","E01016392",1058,414,87,327,562,29,240,89,132,19,163,125,37,1,114,78,36,16,16,82,19,63
"2021","Reading 013E","E01016393",767,214,83,131,476,51,276,78,171,27,80,50,29,1,62,42,20,7,7,77,27,50
"2021","Reading 014A","E01016374",706,191,37,154,388,11,168,53,96,19,143,111,31,1,50,32,18,16,16,127,38,89
"2021","Reading 014B","E01016375",501,155,35,120,245,8,102,33,55,14,61,43,15,3,66,34,32,8,8,101,39,62
"2021","Reading 014C","E01016376",785,304,74,230,320,31,169,52,101,16,67,50,15,2,41,23,18,12,12,161,37,124
"2021","Reading 014D","E01016379",803,201,34,167,401,13,186,61,109,16,142,114,27,1,43,25,18,17,17,201,69,132
"2021","Reading 014E","E01016413",502,127,40,87,299,41,171,48,105,18,43,35,8,0,33,18,15,11,11,76,15,61
"2021","Reading 014F","E01016414",766,281,30,251,382,23,178,73,85,20,120,104,15,1,49,27,22,12,12,103,14,89
"2021","Reading 015A","E01016419",927,318,94,224,526,44,259,80,143,36,108,82,22,4,104,70,34,11,11,83,26,57
"2021","Reading 015B","E01016420",624,202,48,154,375,15,158,27,96,35,53,21,25,7,146,107,39,3,3,47,25,22
"2021","Reading 015C","E01016421",526,146,103,43,344,64,168,55,77,36,51,25,20,6,60,29,31,1,1,36,14,22
"2021","Reading 015D","E01016422",618,224,126,98,348,60,159,52,71,36,40,18,22,0,86,47,39,3,3,46,23,23
"2021","Reading 015E","E01016423",597,156,90,66,392,29,168,37,83,48,85,37,38,10,104,59,45,6,6,49,28,21
"2021","Reading 015F","E01016424",532,103,51,52,388,57,230,67,122,41,53,34,16,3,41,20,21,7,7,41,18,23
"2021","Reading 016A","E01016370",470,122,62,60,255,25,137,39,80,18,48,28,19,1,39,31,8,6,6,93,18,75
"2021","Reading 016B","E01016371",615,159,85,74,385,70,190,52,101,37,47,29,16,2,66,32,34,12,12,71,30,41
"2021","Reading 016C","E01016373",547,112,38,74,349,7,163,33,97,33,66,29,29,8,106,65,41,7,7,86,47,39
"2021","Reading 016D","E01016415",649,236,102,134,327,24,154,34,97,23,46,26,16,4,95,63,32,8,8,86,38,48
"2021","Reading 017A","E01016368",546,134,54,80,338,16,153,28,82,43,46,18,24,4,122,67,55,1,1,74,44,30
"2021","Reading 017B","E01016372",486,88,40,48,345,20,135,25,72,38,72,31,28,13,110,76,34,8,8,53,26,27
"2021","Reading 017C","E01016377",664,192,43,149,356,14,165,44,89,32,71,43,17,11,95,60,35,11,11,116,49,67
"2021","Reading 017D","E01016438",523,138,73,65,337,26,144,31,82,31,47,8,32,7,115,69,46,5,5,48,22,26
"2021","Reading 017F","E01016443",562,94,32,62,407,21,177,44,94,39,63,20,35,8,139,89,50,7,7,61,35,26
"2021","Reading 017G","E01033857",712,152,61,91,446,26,202,54,102,46,72,30,27,15,138,95,43,8,8,114,73,41
"2021","Reading 017H","E01033858",710,219,25,194,432,8,249,64,169,16,115,83,31,1,52,46,6,8,8,59,15,44
"2021","Reading 017I","E01033859",699,261,6,255,388,3,175,82,88,5,165,143,19,3,32,20,12,13,13,50,12,38
"2021","Reading 018A","E01016369",641,147,99,48,402,55,210,65,99,46,62,19,32,11,69,26,43,6,6,92,41,51
"2021","Reading 018B","E01016437",511,116,52,64,327,22,164,45,82,37,57,21,30,6,74,42,32,10,10,68,38,30
"2021","Reading 018C","E01016439",743,182,69,113,481,35,256,82,131,43,80,42,32,6,99,57,42,11,11,80,38,42
"2021","Reading 018D","E01016440",565,132,66,66,360,34,176,54,79,43,46,17,21,8,98,51,47,6,6,73,28,45
"2021","Reading 018E","E01016441",582,162,58,104,362,23,152,40,72,40,63,37,17,9,121,80,41,3,3,58,33,25
"2021","Reading 019C","E01016353",884,281,40,241,470,12,217,81,115,21,132,95,32,5,84,60,24,25,25,133,34,99
"2021","Reading 019B","E01033415",1091,475,29,446,508,21,259,125,123,11,165,155,10,0,39,19,20,24,24,108,14,94
"2021","Reading 019A","E01033418",713,253,15,238,374,6,193,70,116,7,115,108,7,0,49,34,15,11,11,86,5,81
"2021","Reading 019D","E01033422",689,284,42,242,333,13,138,72,61,5,117,96,20,1,50,40,10,15,15,72,15,57
"2021","Reading 020E","E01016391",943,315,49,266,519,24,218,71,124,23,164,128,31,5,103,76,27,10,10,109,34,75
"2021","Reading 020B","E01033420",688,334,64,270,300,11,163,68,89,6,103,98,5,0,6,4,2,17,17,54,7,47
"2021","Reading 020A","E01033423",794,318,17,301,375,7,193,86,103,4,118,108,9,1,39,24,15,18,18,101,14,87
"2021","Reading 020C","E01033838",556,195,19,176,291,1,138,49,74,15,106,92,13,1,29,18,11,17,17,70,10,60
"2021","Reading 020D","E01033839",627,278,19,259,287,3,131,39,86,6,103,89,12,2,35,19,16,15,15,62,2,60
"2021","Slough 001A","E01016450",535,102,26,76,370,8,181,34,109,38,47,13,28,6,128,81,47,6,6,63,39,24
"2021","Slough 001B","E01016451",618,163,54,109,389,14,200,27,148,25,46,11,24,11,125,92,33,4,4,66,41,25
"2021","Slough 001C","E01016452",645,156,54,102,419,27,247,37,164,46,51,15,33,3,85,50,35,9,9,70,47,23
"2021","Slough 001D","E01016453",633,166,88,78,420,30,233,54,138,41,51,14,34,3,100,64,36,6,6,47,27,20
"2021","Slough 001E","E01016454",596,150,45,105,397,14,198,35,131,32,65,21,37,7,115,73,42,5,5,49,26,23
"2021","Slough 001F","E01016455",687,110,33,77,511,15,282,56,200,26,72,25,42,5,133,85,48,9,9,66,42,24
"2021","Slough 002A","E01016483",603,85,27,58,390,24,229,30,153,46,36,13,23,0,91,72,19,10,10,128,74,54
"2021","Slough 002B","E01016484",621,160,51,109,377,31,200,30,108,62,52,21,30,1,82,43,39,12,12,84,59,25
"2021","Slough 002C","E01016485",542,80,29,51,369,24,241,40,147,54,31,13,13,5,66,44,22,7,7,93,53,40
"2021","Slough 002D","E01016486",591,164,55,109,355,15,197,31,129,37,49,20,19,10,87,53,34,7,7,72,40,32
"2021","Slough 002E","E01016487",505,80,39,41,291,23,182,32,97,53,21,7,10,4,49,21,28,16,16,134,89,45
"2021","Slough 002F","E01016488",669,144,44,100,440,21,265,52,166,47,49,28,19,2,87,63,24,18,18,85,50,35
"2021","Slough 003A","E01016493",464,117,49,68,297,30,175,51,89,35,43,21,17,5,48,34,14,1,1,50,23,27
"2021","Slough 003B","E01016494",747,182,37,145,502,19,270,65,173,32,79,38,38,3,125,87,38,9,9,63,26,37
"2021","Slough 003C","E01016495",619,221,60,161,360,31,212,57,125,30,52,36,16,0,64,38,26,1,1,38,22,16
"2021","Slough 003D","E01016496",571,173,74,99,370,20,157,27,106,24,69,31,32,6,117,74,43,7,7,28,9,19
"2021","Slough 003E","E01016497",460,84,45,39,319,45,216,46,116,54,18,7,8,3,37,16,21,3,3,57,30,27
"2021","Slough 003F","E01016498",621,161,46,115,405,19,208,42,125,41,63,31,25,7,97,55,42,18,18,55,31,24
"2021","Slough 003G","E01016499",496,129,30,99,313,7,143,29,76,38,39,19,16,4,118,77,41,6,6,54,30,24
"2021","Slough 004A","E01016444",475,53,25,28,334,11,203,25,135,43,25,6,13,6,88,49,39,7,7,88,57,31
"2021","Slough 004B","E01016445",525,84,28,56,324,14,193,23,118,52,26,3,21,2,87,47,40,4,4,117,84,33
"2021","Slough 004C","E01016446",459,64,24,40,289,13,175,24,113,38,26,7,17,2,67,34,33,8,8,106,74,32
"2021","Slough 004D","E01016447",520,77,24,53,325,21,208,32,137,39,24,10,10,4,64,36,28,8,8,118,66,52
"2021","Slough 004E","E01016448",763,178,84,94,424,21,271,55,163,53,47,17,27,3,76,42,34,9,9,161,101,60
"2021","Slough 004F","E01016449",657,100,45,55,430,18,278,34,182,62,32,9,17,6,95,49,46,7,7,127,91,36
"2021","Slough 005A","E01016516",479,65,34,31,288,14,181,14,118,49,17,7,7,3,66,37,29,10,10,126,90,36
"2021","Slough 005B","E01016517",480,101,36,65,272,21,160,17,108,35,17,8,9,0,64,34,30,10,10,107,75,32
"2021","Slough 005C","E01016518",605,106,32,74,397,25,230,58,129,43,39,12,25,2,94,63,31,9,9,102,66,36
"2021","Slough 005D","E01016519",957,250,118,132,575,28,380,65,273,42,41,14,22,5,117,63,54,9,9,132,82,50
"2021","Slough 005E","E01016520",569,125,47,78,372,24,212,32,136,44,24,6,14,4,110,59,51,2,2,72,34,38
"2021","Slough 005F","E01016521",646,147,86,61,388,21,245,37,146,62,26,7,17,2,86,43,43,10,10,111,80,31
"2021","Slough 006A","E01016467",536,117,38,79,359,17,208,45,134,29,41,17,19,5,88,49,39,5,5,60,35,25
"2021","Slough 006B","E01016468",651,117,47,70,468,27,295,53,187,55,60,24,25,11,79,47,32,7,7,66,38,28
"2021","Slough 006C","E01016469",667,152,62,90,454,38,268,69,159,40,54,27,21,6,84,46,38,10,10,61,39,22
"2021","Slough 006D","E01016470",679,204,62,142,419,26,258,65,154,39,59,41,18,0,72,45,27,4,4,56,36,20
"2021","Slough 006E","E01016471",496,111,51,60,333,23,211,52,124,35,40,15,21,4,55,25,30,4,4,52,25,27
"2021","Slough 006F","E01016472",586,135,87,48,382,30,229,35,142,52,46,14,25,7,75,36,39,2,2,69,48,21
"2021","Slough 008A","E01016473",914,167,29,138,671,18,416,95,270,51,98,54,40,4,131,83,48,8,8,76,45,31
"2021","Slough 008B","E01016474",831,250,97,153,524,44,265,58,174,33,80,37,37,6,127,89,38,8,8,57,38,19
"2021","Slough 008C","E01016475",632,101,41,60,389,27,225,31,135,59,32,8,21,3,94,60,34,11,11,142,92,50
"2021","Slough 008D","E01016476",652,165,31,134,446,6,260,50,182,28,69,29,33,7,99,72,27,12,12,41,22,19
"2021","Slough 008E","E01016477",1034,292,51,241,671,8,447,90,325,32,104,50,49,5,103,75,28,9,9,71,44,27
"2021","Slough 008F","E01016478",672,149,38,111,454,26,273,61,169,43,58,23,31,4,88,55,33,9,9,69,47,22
"2021","Slough 009A","E01016462",763,137,17,120,471,13,271,42,192,37,74,35,35,4,99,69,30,14,14,155,86,69
"2021","Slough 009B","E01016463",594,140,60,80,341,18,213,26,135,52,33,8,19,6,72,44,28,5,5,113,75,38
"2021","Slough 009C","E01016464",606,138,45,93,323,10,195,51,109,35,33,11,22,0,72,42,30,13,13,145,101,44
"2021","Slough 009D","E01016465",927,204,42,162,566,28,327,47,233,47,56,26,28,2,144,94,50,11,11,157,87,70
"2021","Slough 009F","E01032729",620,148,27,121,391,8,196,44,140,12,74,31,42,1,102,77,25,11,11,81,42,39
"2021","Slough 009G","E01032730",756,204,19,185,476,7,265,82,168,15,80,39,37,4,111,90,21,13,13,76,38,38
"2021","Slough 010A","E01016506",736,212,30,182,466,13,250,60,159,31,95,60,33,2,100,77,23,8,8,58,28,30
"2021","Slough 010B","E01016507",622,149,88,61,404,33,256,40,173,43,33,17,10,6,78,52,26,4,4,69,46,23
"2021","Slough 010C","E01016508",718,112,52,60,520,41,361,50,259,52,41,18,20,3,70,43,27,7,7,86,60,26
"2021","Slough 010D","E01016509",591,142,39,103,391,30,252,59,147,46,38,16,17,5,63,37,26,8,8,58,33,25
"2021","Slough 010E","E01016510",644,79,34,45,456,43,325,60,180,85,21,9,11,1,62,31,31,5,5,109,70,39
"2021","Slough 011A","E01016511",963,381,94,287,483,30,249,78,138,33,85,54,31,0,109,72,37,10,10,99,56,43
"2021","Slough 011D","E01016514",872,303,64,239,494,20,285,94,170,21,83,62,21,0,94,53,41,12,12,75,30,45
"2021","Slough 011E","E01016515",609,78,46,32,401,55,288,40,175,73,12,5,6,1,44,19,25,2,2,130,77,53
"2021","Slough 011F","E01035247",616,185,25,160,373,6,216,62,144,10,81,59,20,2,58,48,10,12,12,58,24,34
"2021","Slough 011G","E01035248",643,200,47,153,375,13,203,49,140,14,69,42,23,4,79,60,19,11,11,68,19,49
"2021","Slough 011H","E01035249",398,62,34,28,257,35,179,23,101,55,12,7,4,1,31,19,12,0,0,79,44,35
"2021","Slough 011I","E01035250",475,29,10,19,391,12,307,22,253,32,20,3,17,0,52,38,14,0,0,55,45,10
"2021","Slough 012A","E01016500",599,100,35,65,390,34,258,37,174,47,21,9,8,4,75,46,29,2,2,109,61,48
"2021","Slough 012B","E01016501",613,151,49,102,395,16,211,37,140,34,41,7,27,7,120,64,56,7,7,67,47,20
"2021","Slough 012C","E01016502",492,89,46,43,342,17,226,29,161,36,33,7,23,3,59,31,28,7,7,61,41,20
"2021","Slough 012D","E01016503",582,144,41,103,366,19,233,35,155,43,34,17,14,3,73,39,34,7,7,72,44,28
"2021","Slough 012E","E01016504",468,92,40,52,290,32,187,37,90,60,19,8,5,6,49,27,22,3,3,86,51,35
"2021","Slough 012F","E01016505",617,145,46,99,411,24,246,34,179,33,42,14,21,7,95,51,44,4,4,61,35,26
"2021","Slough 013B","E01016490",791,238,93,145,484,31,220,39,140,41,62,18,34,10,160,109,51,11,11,69,36,33
"2021","Slough 013C","E01016491",622,143,76,67,402,46,255,47,152,56,31,16,12,3,67,39,28,3,3,77,47,30
"2021","Slough 013D","E01016492",605,147,68,79,381,19,263,48,159,56,27,8,15,4,67,39,28,5,5,77,42,35
"2021","Slough 013E","E01032731",480,74,14,60,332,9,217,33,145,39,31,13,17,1,72,40,32,3,3,74,44,30
"2021","Slough 013F","E01032732",644,187,74,113,384,24,212,40,141,31,59,26,29,4,85,52,33,4,4,73,42,31
"2021","Slough 014A","E01016479",537,90,25,65,365,14,217,37,137,43,33,10,18,5,97,70,27,4,4,82,52,30
"2021","Slough 014B","E01016480",516,125,34,91,326,16,156,33,94,29,47,22,21,4,100,57,43,7,7,65,39,26
"2021","Slough 014C","E01016481",670,246,46,200,375,14,197,77,94,26,90,44,43,3,67,45,22,7,7,49,22,27
"2021","Slough 014D","E01016482",667,184,53,131,402,25,236,57,125,54,58,28,27,3,75,45,30,8,8,81,40,41
"2021","Slough 015A","E01016458",556,124,46,78,336,21,175,27,100,48,29,11,16,2,104,58,46,7,7,96,59,37
"2021","Slough 015B","E01035251",649,108,31,77,390,12,249,39,163,47,28,15,13,0,91,54,37,10,10,151,94,57
"2021","Slough 015C","E01035252",485,120,18,102,296,7,183,49,114,20,42,33,6,3,60,40,20,4,4,69,30,39
"2021","Slough 015D","E01035253",651,198,6,192,406,2,270,83,183,4,71,50,21,0,48,42,6,15,15,47,24,23
"2021","Slough 016D","E01016456",622,139,51,88,320,9,172,26,101,45,25,11,12,2,98,47,51,16,16,163,93,70
"2021","Slough 016C","E01016457",566,70,24,46,362,26,237,24,161,52,28,8,17,3,65,36,29,6,6,134,92,42
"2021","Slough 016A","E01016460",566,81,46,35,337,43,219,36,134,49,13,5,7,1,58,23,35,4,4,148,88,60
"2021","Slough 016B","E01035254",544,119,15,104,336,6,211,52,136,23,53,40,12,1,62,43,19,4,4,89,50,39
"2021","Windsor and Maidenhead 001A","E01016570",635,141,99,42,474,88,279,77,153,49,43,24,17,2,62,27,35,2,2,20,9,11
"2021","Windsor and Maidenhead 001B","E01016572",553,124,78,46,397,91,206,60,112,34,48,26,20,2,48,19,29,4,4,32,11,21
"2021","Windsor and Maidenhead 001C","E01016582",513,116,50,66,301,25,168,44,96,28,53,29,22,2,52,27,25,3,3,96,60,36
"2021","Windsor and Maidenhead 001D","E01016600",448,91,55,36,327,81,189,61,96,32,31,22,6,3,26,12,14,0,0,30,6,24
"2021","Windsor and Maidenhead 002A","E01016530",657,190,104,86,434,58,216,59,120,37,65,32,28,5,84,50,34,11,11,33,17,16
"2021","Windsor and Maidenhead 002B","E01016531",594,150,93,57,410,110,234,84,103,47,42,31,9,2,23,6,17,1,1,34,6,28
"2021","Windsor and Maidenhead 002C","E01016532",840,259,132,127,542,101,307,98,156,53,78,56,18,4,51,26,25,5,5,39,10,29
"2021","Windsor and Maidenhead 002D","E01016533",763,166,99,67,572,107,347,103,188,56,67,47,17,3,47,26,21,4,4,25,8,17
"2021","Windsor and Maidenhead 002E","E01016578",671,150,80,70,472,86,298,89,164,45,44,34,6,4,41,22,19,3,3,49,21,28
"2021","Windsor and Maidenhead 002F","E01016579",739,175,92,83,511,106,271,111,118,42,77,43,31,3,53,35,18,4,4,53,20,33
"2021","Windsor and Maidenhead 002G","E01016581",601,144,68,76,426,82,250,86,118,46,49,24,20,5,42,20,22,3,3,31,12,19
"2021","Windsor and Maidenhead 003A","E01016571",677,115,56,59,524,82,311,79,193,39,59,28,26,5,67,40,27,5,5,38,15,23
"2021","Windsor and Maidenhead 003B","E01016573",538,115,61,54,381,29,216,43,114,59,43,22,16,5,89,46,43,4,4,42,21,21
"2021","Windsor and Maidenhead 003C","E01016574",561,130,65,65,383,57,211,40,131,40,64,36,24,4,46,30,16,5,5,48,25,23
"2021","Windsor and Maidenhead 003D","E01016599",604,157,69,88,395,21,197,33,107,57,69,25,33,11,105,60,45,3,3,52,23,29
"2021","Windsor and Maidenhead 004A","E01016583",801,213,108,105,535,93,297,80,166,51,94,58,33,3,47,24,23,4,4,53,15,38
"2021","Windsor and Maidenhead 004B","E01016585",821,321,115,206,448,69,232,95,99,38,88,67,17,4,57,32,25,2,2,52,16,36
"2021","Windsor and Maidenhead 004C","E01016586",541,120,63,57,392,97,222,87,90,45,40,27,12,1,30,16,14,3,3,29,11,18
"2021","Windsor and Maidenhead 004D","E01016591",879,169,57,112,649,80,420,111,249,60,92,62,26,4,52,33,19,5,5,61,28,33
"2021","Windsor and Maidenhead 004E","E01016592",851,244,102,142,533,106,265,98,134,33,94,70,22,2,57,41,16,11,11,74,25,49
"2021","Windsor and Maidenhead 005A","E01016525",724,195,91,104,486,54,314,92,177,45,77,46,30,1,41,29,12,0,0,43,21,22
"2021","Windsor and Maidenhead 005B","E01016528",665,168,65,103,446,56,234,65,137,32,99,61,34,4,50,24,26,7,7,51,26,25
"2021","Windsor and Maidenhead 005C","E01016529",896,334,107,227,484,31,230,75,125,30,110,76,21,13,107,63,44,6,6,78,39,39
"2021","Windsor and Maidenhead 005D","E01016536",862,325,94,231,457,43,256,83,145,28,101,78,22,1,54,36,18,3,3,80,26,54
"2021","Windsor and Maidenhead 005E","E01016584",934,283,88,195,560,30,307,95,184,28,131,91,32,8,86,62,24,6,6,91,35,56
"2021","Windsor and Maidenhead 005G","E01032733",733,380,150,230,327,18,145,44,97,4,93,68,24,1,66,55,11,5,5,26,5,21
"2021","Windsor and Maidenhead 005H","E01032734",800,283,43,240,459,18,239,66,151,22,108,91,16,1,84,62,22,10,10,58,17,41
"2021","Windsor and Maidenhead 006A","E01016526",704,166,70,96,493,33,304,81,185,38,89,48,37,4,58,35,23,9,9,45,21,24
"2021","Windsor and Maidenhead 006B","E01016527",651,178,40,138,433,29,245,72,137,36,90,57,33,0,61,33,28,8,8,40,17,23
"2021","Windsor and Maidenhead 006C","E01016534",602,106,75,31,450,92,300,81,162,57,25,10,10,5,32,15,17,1,1,46,23,23
"2021","Windsor and Maidenhead 006D","E01016598",538,110,68,42,406,77,256,76,131,49,37,20,14,3,33,13,20,3,3,22,4,18
"2021","Windsor and Maidenhead 006E","E01016601",638,146,69,77,466,59,279,68,166,45,68,40,25,3,57,34,23,3,3,26,12,14
"2021","Windsor and Maidenhead 006F","E01016602",633,128,90,38,470,102,271,80,137,54,47,24,20,3,47,21,26,3,3,35,22,13
"2021","Windsor and Maidenhead 007A","E01016535",511,135,72,63,314,39,186,40,107,39,40,20,19,1,49,25,24,0,0,62,28,34
"2021","Windsor and Maidenhead 007B","E01016537",573,84,33,51,385,26,221,51,137,33,70,41,25,4,62,31,31,6,6,104,45,59
"2021","Windsor and Maidenhead 007C","E01016538",627,167,66,101,413,39,235,55,152,28,77,51,23,3,57,33,24,5,5,47,24,23
"2021","Windsor and Maidenhead 007D","E01016593",705,186,64,122,466,34,250,70,129,51,71,36,31,4,104,63,41,7,7,53,31,22
"2021","Windsor and Maidenhead 007E","E01016594",626,162,64,98,424,34,216,52,127,37,76,49,20,7,94,58,36,4,4,40,12,28
"2021","Windsor and Maidenhead 008A","E01016559",566,106,78,28,430,84,264,64,151,49,41,18,18,5,39,18,21,2,2,30,16,14
"2021","Windsor and Maidenhead 008B","E01016560",607,165,60,105,401,38,201,44,118,39,62,18,39,5,98,63,35,2,2,41,14,27
"2021","Windsor and Maidenhead 008C","E01016561",684,122,68,54,514,78,300,72,175,53,61,30,24,7,74,44,30,1,1,48,20,28
"2021","Windsor and Maidenhead 008D","E01016562",521,85,63,22,406,88,236,78,112,46,36,15,18,3,42,19,23,4,4,30,20,10
"2021","Windsor and Maidenhead 008E","E01016563",531,110,61,49,395,72,221,48,131,42,47,21,23,3,54,37,17,1,1,26,12,14
"2021","Windsor and Maidenhead 008F","E01016580",657,213,98,115,400,43,202,72,97,33,66,28,32,6,85,44,41,4,4,44,18,26
"2021","Windsor and Maidenhead 009A","E01016539",643,179,105,74,419,81,251,87,123,41,48,28,17,3,35,14,21,4,4,45,16,29
"2021","Windsor and Maidenhead 009B","E01016540",640,162,101,61,427,81,250,75,126,49,51,28,15,8,43,23,20,2,2,51,24,27
"2021","Windsor and Maidenhead 009C","E01016541",511,94,50,44,385,85,219,59,115,45,30,13,14,3,45,20,25,6,6,32,14,18
"2021","Windsor and Maidenhead 009D","E01016542",480,129,61,68,323,42,187,49,107,31,35,11,20,4,55,29,26,4,4,28,15,13
"2021","Windsor and Maidenhead 009E","E01016543",677,152,78,74,486,95,291,84,153,54,54,34,17,3,46,21,25,0,0,39,13,26
"2021","Windsor and Maidenhead 010A","E01016544",884,372,100,272,444,35,221,93,103,25,129,103,22,4,51,30,21,8,8,68,17,51
"2021","Windsor and Maidenhead 010B","E01016567",691,257,75,182,395,38,232,99,96,37,77,58,11,8,44,24,20,4,4,39,9,30
"2021","Windsor and Maidenhead 010C","E01016568",513,130,72,58,342,48,199,54,99,46,45,14,24,7,48,26,22,2,2,41,14,27
"2021","Windsor and Maidenhead 010D","E01016569",503,184,94,90,298,29,147,61,52,34,66,44,21,1,54,32,22,2,2,21,14,7
"2021","Windsor and Maidenhead 011A","E01016564",657,160,80,80,443,57,248,73,119,56,62,33,24,5,71,42,29,5,5,54,34,20
"2021","Windsor and Maidenhead 011B","E01016565",669,165,73,92,446,74,258,77,117,64,58,39,19,0,52,26,26,4,4,58,24,34
"2021","Windsor and Maidenhead 011C","E01016566",743,260,77,183,441,46,222,75,105,42,96,56,31,9,74,41,33,3,3,42,20,22
"2021","Windsor and Maidenhead 011D","E01016577",725,206,84,122,437,57,227,61,107,59,65,32,25,8,86,45,41,2,2,82,45,37
"2021","Windsor and Maidenhead 012A","E01016545",1138,541,223,318,547,44,256,110,120,26,162,126,33,3,75,51,24,10,10,50,10,40
"2021","Windsor and Maidenhead 012B","E01016547",772,241,63,178,494,24,263,88,155,20,135,97,38,0,68,44,24,4,4,37,8,29
"2021","Windsor and Maidenhead 012C","E01016550",511,113,51,62,352,25,204,59,117,28,63,31,31,1,60,34,26,0,0,46,19,27
"2021","Windsor and Maidenhead 012D","E01016552",713,208,94,114,455,64,261,64,153,44,66,45,16,5,61,38,23,3,3,50,16,34
"2021","Windsor and Maidenhead 013A","E01016551",631,171,98,73,404,82,243,67,111,65,46,18,21,7,30,12,18,3,3,56,18,38
"2021","Windsor and Maidenhead 013B","E01016553",678,234,149,85,412,96,213,54,114,45,49,32,14,3,51,21,30,3,3,32,13,19
"2021","Windsor and Maidenhead 013C","E01016557",829,268,156,112,504,84,251,78,115,58,88,34,50,4,76,42,34,5,5,57,25,32
"2021","Windsor and Maidenhead 013D","E01016558",529,112,38,74,392,28,234,56,161,17,67,43,18,6,61,39,22,2,2,25,12,13
"2021","Windsor and Maidenhead 014A","E01016548",820,255,90,165,517,63,297,85,162,50,88,56,29,3,63,40,23,6,6,48,25,23
"2021","Windsor and Maidenhead 014B","E01016549",852,273,130,143,531,59,261,77,139,45,87,41,41,5,113,59,54,11,11,48,19,29
"2021","Windsor and Maidenhead 014C","E01016554",686,203,67,136,433,47,195,45,119,31,70,34,31,5,115,82,33,6,6,50,28,22
"2021","Windsor and Maidenhead 014D","E01016555",639,186,64,122,401,26,196,56,100,40,71,28,34,9,103,60,43,5,5,52,23,29
"2021","Windsor and Maidenhead 014E","E01016556",768,240,121,119,469,61,263,79,135,49,56,30,23,3,82,47,35,7,7,59,27,32
"2021","Windsor and Maidenhead 015A","E01016546",752,247,86,161,471,53,274,105,139,30,88,63,25,0,45,28,17,11,11,34,8,26
"2021","Windsor and Maidenhead 015B","E01016595",709,159,60,99,509,47,299,75,174,50,80,54,22,4,82,54,28,1,1,41,16,25
"2021","Windsor and Maidenhead 015C","E01016596",857,251,103,148,560,89,318,115,169,34,97,66,25,6,51,33,18,5,5,46,15,31
"2021","Windsor and Maidenhead 015D","E01016597",611,90,65,25,480,96,312,78,173,61,32,14,15,3,37,19,18,3,3,41,18,23
"2021","Windsor and Maidenhead 016A","E01016575",661,125,84,41,431,104,259,91,102,66,34,14,13,7,30,6,24,4,4,105,57,48
"2021","Windsor and Maidenhead 016B","E01016576",688,165,85,80,443,62,265,87,114,64,63,28,26,9,50,27,23,3,3,80,34,46
"2021","Windsor and Maidenhead 016C","E01016587",676,161,89,72,454,85,266,71,148,47,53,29,19,5,47,23,24,3,3,61,18,43
"2021","Windsor and Maidenhead 016D","E01016588",807,280,151,129,488,86,260,84,116,60,71,40,24,7,67,40,27,4,4,39,15,24
"2021","Windsor and Maidenhead 016E","E01016589",672,151,88,63,482,85,298,91,144,63,54,30,18,6,42,18,24,3,3,39,15,24
"2021","Windsor and Maidenhead 017A","E01016522",716,144,75,69,535,116,348,91,188,69,35,18,14,3,36,20,16,0,0,37,19,18
"2021","Windsor and Maidenhead 017B","E01016523",588,157,78,79,399,71,217,64,104,49,56,30,20,6,51,33,18,4,4,32,15,17
"2021","Windsor and Maidenhead 017C","E01016524",888,293,100,193,569,96,339,104,181,54,67,37,27,3,67,33,34,0,0,26,6,20
"2021","Windsor and Maidenhead 017D","E01016609",770,214,92,122,513,42,274,92,142,40,87,48,31,8,105,65,40,5,5,43,18,25
"2021","Windsor and Maidenhead 018A","E01016603",729,214,126,88,464,89,265,83,143,39,47,33,11,3,61,31,30,2,2,51,22,29
"2021","Windsor and Maidenhead 018B","E01016604",962,320,213,107,591,152,316,94,162,60,54,30,18,6,67,36,31,2,2,51,19,32
"2021","Windsor and Maidenhead 018C","E01016605",628,156,72,84,448,73,244,60,158,26,52,23,27,2,73,50,23,6,6,24,12,12
"2021","Windsor and Maidenhead 018D","E01016606",650,155,77,78,465,78,296,76,164,56,41,26,13,2,45,28,17,5,5,30,10,20
"2021","Windsor and Maidenhead 018E","E01016607",576,81,43,38,466,83,313,73,153,87,29,14,15,0,39,22,17,2,2,29,11,18
"2021","Windsor and Maidenhead 018F","E01016608",809,236,108,128,534,59,298,110,146,42,87,48,33,6,83,48,35,7,7,39,14,25
"2021","Wokingham 001B","E01016676",627,133,97,36,484,110,290,96,151,43,48,32,16,0,35,18,17,1,1,10,4,6
"2021","Wokingham 001D","E01016678",606,165,84,81,414,83,243,87,119,37,52,29,19,4,33,22,11,3,3,27,5,22
"2021","Wokingham 001E","E01035256",1084,321,188,133,721,155,395,140,192,63,92,54,33,5,76,41,35,3,3,42,16,26
"2021","Wokingham 002A","E01016619",606,104,60,44,462,74,303,76,179,48,44,27,15,2,40,25,15,1,1,40,17,23
"2021","Wokingham 002B","E01016620",544,79,51,28,435,59,275,71,160,44,49,18,26,5,52,31,21,0,0,30,12,18
"2021","Wokingham 002C","E01016692",676,196,124,72,464,79,242,70,137,35,81,53,23,5,61,37,24,1,1,16,6,10
"2021","Wokingham 002D","E01016693",618,190,58,132,409,46,210,69,119,22,106,74,28,4,47,31,16,0,0,19,8,11
"2021","Wokingham 002E","E01016694",728,280,138,142,417,69,212,57,138,17,81,60,21,0,48,30,18,7,7,31,11,20
"2021","Wokingham 002F","E01016695",611,124,95,29,477,85,311,88,176,47,49,25,23,1,30,20,10,2,2,10,6,4
"2021","Wokingham 003A","E01016621",597,139,72,67,427,64,228,59,115,54,63,16,39,8,72,47,25,0,0,31,15,16
"2021","Wokingham 003B","E01016623",618,164,117,47,420,83,230,68,125,37,61,26,28,7,44,30,14,2,2,34,17,17
"2021","Wokingham 003C","E01016624",540,108,81,27,399,87,244,63,120,61,25,13,11,1,41,23,18,2,2,33,15,18
"2021","Wokingham 003D","E01016684",629,131,60,71,465,105,266,92,123,51,51,29,16,6,42,18,24,1,1,33,14,19
"2021","Wokingham 003E","E01016685",629,162,87,75,424,82,277,95,130,52,29,14,14,1,36,17,19,0,0,43,14,29
"2021","Wokingham 004A","E01016622",457,96,62,34,336,89,198,50,98,50,24,9,14,1,24,7,17,1,1,25,9,16
"2021","Wokingham 004B","E01016657",561,100,49,51,444,58,294,79,174,41,54,34,18,2,35,20,15,3,3,17,6,11
"2021","Wokingham 004C","E01016658",1024,178,36,142,787,39,468,114,293,61,167,115,47,5,112,83,29,1,1,59,25,34
"2021","Wokingham 004D","E01016659",643,219,83,136,404,32,214,80,102,32,90,56,31,3,66,39,27,2,2,20,9,11
"2021","Wokingham 004E","E01016660",649,118,52,66,493,62,300,99,150,51,73,35,34,4,54,38,16,4,4,38,16,22
"2021","Wokingham 005A","E01016615",599,203,134,69,343,46,178,29,107,42,52,21,24,7,63,31,32,4,4,53,25,28
"2021","Wokingham 005B","E01016616",675,196,119,77,418,96,208,63,106,39,60,35,20,5,46,19,27,8,8,61,28,33
"2021","Wokingham 005C","E01016617",777,184,121,63,563,80,342,69,222,51,73,35,37,1,63,38,25,5,5,30,17,13
"2021","Wokingham 005D","E01016662",736,255,123,132,434,40,204,47,116,41,68,24,39,5,114,76,38,8,8,47,23,24
"2021","Wokingham 006A","E01016613",491,90,34,56,305,30,182,34,99,49,41,21,16,4,50,23,27,2,2,96,45,51
"2021","Wokingham 006B","E01016614",499,80,43,37,340,56,233,66,113,54,22,9,11,2,25,11,14,4,4,79,43,36
"2021","Wokingham 006C","E01016618",466,85,44,41,330,50,200,58,109,33,34,22,10,2,44,17,27,2,2,51,23,28
"2021","Wokingham 006D","E01016664",462,80,59,21,362,50,272,49,174,49,15,6,9,0,24,13,11,1,1,20,11,9
"2021","Wokingham 006E","E01016668",626,126,54,72,455,56,308,72,187,49,39,16,20,3,47,25,22,5,5,45,18,27
"2021","Wokingham 006F","E01016669",727,174,105,69,500,63,327,68,214,45,45,29,12,4,63,30,33,2,2,53,18,35
"2021","Wokingham 007A","E01016661",497,89,50,39,376,57,226,70,105,51,48,28,18,2,45,21,24,0,0,32,12,20
"2021","Wokingham 007B","E01016663",602,134,75,59,423,67,245,64,132,49,49,24,21,4,58,35,23,4,4,45,21,24
"2021","Wokingham 007C","E01016686",480,132,55,77,318,35,167,48,95,24,54,37,16,1,58,34,24,4,4,30,10,20
"2021","Wokingham 007D","E01016687",493,120,83,37,349,67,214,60,100,54,37,16,19,2,29,16,13,2,2,24,11,13
"2021","Wokingham 007E","E01016688",774,155,90,65,569,60,367,75,234,58,73,42,29,2,67,43,24,2,2,50,27,23
"2021","Wokingham 007F","E01016689",577,146,110,36,412,104,238,73,116,49,36,19,14,3,33,19,14,1,1,19,11,8
"2021","Wokingham 008B","E01016652",469,98,47,51,345,70,227,50,122,55,26,13,7,6,21,11,10,1,1,26,10,16
"2021","Wokingham 008C","E01016653",522,108,60,48,379,72,254,54,149,51,34,23,8,3,17,8,9,2,2,35,17,18
"2021","Wokingham 008D","E01016665",632,155,70,85,441,56,259,66,156,37,73,49,21,3,49,28,21,4,4,36,15,21
"2021","Wokingham 008E","E01016666",512,93,56,37,393,47,275,71,174,30,40,17,20,3,29,19,10,2,2,26,8,18
"2021","Wokingham 008H","E01035257",476,108,57,51,343,80,219,64,101,54,23,10,9,4,21,9,12,0,0,25,13,12
"2021","Wokingham 008I","E01035258",525,98,74,24,394,79,273,66,160,47,18,9,7,2,21,12,9,3,3,33,18,15
"2021","Wokingham 009A","E01016647",620,85,26,59,494,46,333,76,206,51,56,30,18,8,52,24,28,7,7,41,20,21
"2021","Wokingham 009B","E01016701",742,150,68,82,548,78,376,91,212,73,48,28,17,3,43,23,20,3,3,44,23,21
"2021","Wokingham 009C","E01016702",721,164,87,77,504,67,290,79,156,55,77,45,29,3,64,43,21,6,6,53,18,35
"2021","Wokingham 009D","E01016703",958,164,44,120,725,57,445,111,277,57,132,75,51,6,82,51,31,9,9,69,31,38
"2021","Wokingham 009E","E01016704",908,237,101,136,607,45,358,95,216,47,98,58,34,6,101,58,43,5,5,64,32,32
"2021","Wokingham 010A","E01016627",835,185,76,109,608,121,337,91,200,46,83,57,23,3,65,42,23,2,2,42,16,26
"2021","Wokingham 010B","E01016628",987,197,95,102,757,97,428,113,270,45,119,53,61,5,108,70,38,5,5,33,16,17
"2021","Wokingham 010C","E01016656",588,145,63,82,404,82,234,74,122,38,51,35,15,1,37,22,15,0,0,39,18,21
"2021","Wokingham 010D","E01016700",733,131,61,70,558,75,361,102,195,64,63,38,22,3,51,30,21,8,8,44,20,24
"2021","Wokingham 011A","E01016644",533,113,48,65,394,26,266,57,172,37,55,25,25,5,46,27,19,1,1,26,13,13
"2021","Wokingham 011B","E01016645",738,301,66,235,411,30,240,82,125,33,102,86,14,2,39,21,18,0,0,26,13,13
"2021","Wokingham 011C","E01016646",626,141,38,103,455,36,297,80,159,58,69,49,19,1,50,29,21,3,3,30,16,14
"2021","Wokingham 011D","E01016648",630,200,42,158,408,18,241,76,142,23,97,63,27,7,48,30,18,4,4,22,9,13
"2021","Wokingham 011E","E01016649",622,202,62,140,385,28,242,76,125,41,62,43,17,2,51,38,13,2,2,35,10,25
"2021","Wokingham 012A","E01016651",585,130,55,75,404,61,243,70,134,39,54,41,10,3,41,15,26,5,5,51,15,36
"2021","Wokingham 012B","E01016654",589,169,92,77,385,64,239,81,118,40,49,31,14,4,30,16,14,3,3,35,14,21
"2021","Wokingham 012C","E01016655",501,103,23,80,369,49,249,82,133,34,41,32,8,1,26,16,10,4,4,29,17,12
"2021","Wokingham 012D","E01016679",844,192,65,127,549,46,301,74,183,44,84,47,32,5,108,63,45,10,10,103,41,62
"2021","Wokingham 012E","E01016680",513,138,46,92,332,22,177,43,97,37,52,18,28,6,77,53,24,4,4,43,16,27
"2021","Wokingham 012H","E01032759",735,113,67,46,580,69,351,92,226,33,89,52,33,4,64,39,25,7,7,42,15,27
"2021","Wokingham 012I","E01035259",649,133,34,99,487,28,263,86,153,24,118,67,45,6,75,54,21,3,3,29,11,18
"2021","Wokingham 012J","E01035260",599,76,6,70,493,4,280,59,207,14,150,91,56,3,56,49,7,3,3,30,12,18
"2021","Wokingham 013A","E01016626",1031,429,183,246,569,59,275,85,161,29,138,92,38,8,90,62,28,7,7,33,9,24
"2021","Wokingham 013B","E01016671",1078,473,325,148,577,162,255,98,122,35,116,91,18,7,42,24,18,2,2,28,5,23
"2021","Wokingham 013C","E01016673",795,279,125,154,474,45,200,61,99,40,90,53,30,7,134,79,55,5,5,42,15,27
"2021","Wokingham 013D","E01016674",730,160,59,101,548,66,267,75,153,39,116,60,48,8,99,74,25,0,0,22,12,10
"2021","Wokingham 013E","E01016696",899,349,108,241,490,42,205,86,99,20,151,119,29,3,77,46,31,15,15,60,7,53
"2021","Wokingham 014A","E01016670",1116,266,72,194,805,66,479,138,282,59,154,94,55,5,100,67,33,6,6,45,12,33
"2021","Wokingham 014B","E01016672",1080,228,109,119,806,117,462,129,282,51,121,75,43,3,99,64,35,7,7,46,18,28
"2021","Wokingham 014F","E01035261",703,131,16,115,537,29,318,60,234,24,109,76,31,2,78,61,17,3,3,35,13,22
"2021","Wokingham 014G","E01035262",794,173,101,72,588,134,349,102,186,61,59,30,26,3,44,26,18,2,2,33,9,24
"2021","Wokingham 015A","E01016612",996,156,72,84,797,119,530,165,281,84,85,52,31,2,63,34,29,0,0,43,19,24
"2021","Wokingham 015B","E01016629",544,97,80,17,430,121,261,71,129,61,25,10,13,2,22,13,9,1,1,17,9,8
"2021","Wokingham 015C","E01016630",581,104,52,52,460,56,301,102,159,40,57,34,19,4,45,24,21,1,1,17,8,9
"2021","Wokingham 015D","E01016635",535,101,35,66,414,38,276,88,152,36,51,30,18,3,49,26,23,0,0,20,15,5
"2021","Wokingham 016A","E01016625",695,157,77,80,510,109,298,86,179,33,59,43,13,3,40,26,14,4,4,28,8,20
"2021","Wokingham 016B","E01016631",551,156,82,74,369,38,206,50,125,31,65,40,23,2,55,32,23,5,5,26,12,14
"2021","Wokingham 016C","E01016632",712,140,77,63,542,74,365,97,229,39,53,31,20,2,47,31,16,3,3,30,11,19
"2021","Wokingham 016D","E01016634",882,306,92,214,533,74,278,94,147,37,113,80,29,4,62,43,19,6,6,43,8,35
"2021","Wokingham 016E","E01016699",728,206,78,128,477,80,240,65,141,34,98,65,25,8,53,36,17,6,6,45,18,27
"2021","Wokingham 017C","E01016690",913,250,105,145,624,95,325,87,183,55,109,54,52,3,92,66,26,3,3,39,13,26
"2021","Wokingham 017D","E01016691",506,113,65,48,362,66,218,84,99,35,44,24,20,0,34,21,13,0,0,31,16,15
"2021","Wokingham 017E","E01035263",651,158,31,127,470,14,256,75,162,19,148,92,53,3,49,39,10,3,3,23,11,12
"2021","Wokingham 017F","E01035264",723,163,77,86,520,68,310,93,164,53,81,47,27,7,54,31,23,7,7,40,16,24
"2021","Wokingham 017G","E01035265",764,115,20,95,607,26,361,106,236,19,167,120,43,4,52,45,7,1,1,42,21,21
"2021","Wokingham 017H","E01035266",657,158,68,90,474,71,280,83,152,45,77,41,29,7,45,25,20,1,1,25,9,16
"2021","Wokingham 018B","E01016611",795,174,43,131,580,29,272,83,175,14,181,120,56,5,92,76,16,6,6,41,16,25
"2021","Wokingham 018E","E01035267",595,119,56,63,435,69,236,79,125,32,67,38,27,2,58,33,25,5,5,41,18,23
"2021","Wokingham 018F","E01035268",531,106,20,86,393,8,206,53,134,19,99,55,38,6,80,54,26,0,0,32,19,13
"2021","Wokingham 018G","E01035269",1257,284,138,146,910,146,517,143,304,70,124,70,51,3,119,86,33,4,4,63,30,33
"2021","Wokingham 019A","E01016633",507,73,38,35,414,82,272,62,154,56,39,21,13,5,20,14,6,1,1,20,3,17
"2021","Wokingham 019B","E01016636",579,98,64,34,461,125,263,72,148,43,41,20,17,4,30,12,18,2,2,20,10,10
"2021","Wokingham 019C","E01016637",427,64,36,28,336,76,224,74,110,40,18,8,6,4,15,4,11,3,3,27,9,18
"2021","Wokingham 019D","E01016638",498,103,46,57,382,49,233,72,120,41,52,23,24,5,45,30,15,3,3,13,4,9
"2021","Wokingham 019E","E01016639",630,136,62,74,461,73,293,85,156,52,56,34,21,1,38,16,22,1,1,33,7,26
"2021","Wokingham 019F","E01016640",648,127,77,50,499,120,285,106,116,63,51,35,12,4,39,16,23,4,4,22,12,10
"2021","Wokingham 019G","E01016643",502,72,36,36,415,73,282,73,153,56,34,16,13,5,25,10,15,1,1,15,4,11
"2021","Wokingham 020A","E01016705",554,149,67,82,360,40,193,67,93,33,59,31,20,8,58,31,27,10,10,45,13,32
"2021","Wokingham 020B","E01016706",677,122,71,51,526,101,327,110,166,51,53,31,20,2,42,20,22,3,3,29,14,15
"2021","Wokingham 020C","E01016707",709,147,90,57,538,106,302,70,171,61,68,40,21,7,60,37,23,2,2,24,12,12
"2021","Wokingham 020D","E01016708",649,137,92,45,485,136,278,86,139,53,39,21,14,4,28,14,14,4,4,27,15,12
"2021","Wokingham 020E","E01016709",622,114,85,29,469,106,284,60,179,45,45,21,22,2,34,14,20,0,0,39,19,20
"2021","Milton Keynes 001A","E01016796",733,212,105,107,498,100,250,86,127,37,88,52,33,3,57,37,20,3,3,23,9,14
"2021","Milton Keynes 001B","E01016797",842,324,173,151,492,107,238,86,107,45,85,56,27,2,60,37,23,2,2,26,10,16
"2021","Milton Keynes 001C","E01016798",762,164,83,81,577,101,327,113,152,62,94,48,41,5,52,34,18,3,3,21,10,11
"2021","Milton Keynes 001D","E01016799",800,220,135,85,549,110,279,93,144,42,92,42,42,8,66,38,28,2,2,31,16,15
"2021","Milton Keynes 001E","E01016800",751,177,95,82,549,102,301,111,150,40,73,45,25,3,73,44,29,0,0,25,9,16
"2021","Milton Keynes 002A","E01016759",696,187,101,86,486,76,253,107,99,47,72,38,28,6,83,59,24,2,2,23,7,16
"2021","Milton Keynes 002C","E01016761",651,163,84,79,463,108,240,101,100,39,78,54,21,3,35,20,15,2,2,25,13,12
"2021","Milton Keynes 002D","E01016801",572,137,92,45,408,103,200,84,72,44,59,36,21,2,45,23,22,1,1,27,11,16
"2021","Milton Keynes 002E","E01016802",604,151,94,57,422,102,225,91,99,35,58,38,17,3,34,18,16,3,3,31,13,18
"2021","Milton Keynes 002F","E01016803",572,129,74,55,414,88,217,91,90,36,67,40,23,4,41,26,15,1,1,29,11,18
"2021","Milton Keynes 002G","E01034446",637,178,23,155,411,22,196,61,117,18,101,62,39,0,83,63,20,9,9,48,17,31
"2021","Milton Keynes 002H","E01034447",527,113,67,46,389,83,200,71,102,27,68,32,33,3,37,20,17,1,1,25,8,17
"2021","Milton Keynes 002I","E01034448",582,101,11,90,443,20,250,66,159,25,101,51,47,3,67,51,16,5,5,38,15,23
"2021","Milton Keynes 003A","E01016786",628,173,115,58,427,122,179,70,88,21,66,25,33,8,58,35,23,2,2,28,13,15
"2021","Milton Keynes 003B","E01016787",684,208,120,88,430,82,180,55,90,35,73,34,34,5,88,57,31,7,7,46,21,25
"2021","Milton Keynes 003C","E01016788",611,120,62,58,464,87,262,87,119,56,61,28,29,4,50,37,13,4,4,27,10,17
"2021","Milton Keynes 003D","E01016789",514,97,29,68,396,38,209,61,99,49,69,37,23,9,79,57,22,1,1,21,14,7
"2021","Milton Keynes 003E","E01016790",578,143,108,35,404,104,207,60,102,45,46,18,25,3,47,22,25,0,0,31,16,15
"2021","Milton Keynes 004A","E01016791",595,149,93,56,424,90,223,69,107,47,69,28,37,4,41,24,17,1,1,22,5,17
"2021","Milton Keynes 004B","E01016792",534,149,52,97,357,37,191,63,91,37,72,43,23,6,54,30,24,3,3,28,16,12
"2021","Milton Keynes 004C","E01016793",871,235,105,130,603,66,324,91,174,59,119,64,45,10,91,53,38,3,3,33,16,17
"2021","Milton Keynes 004D","E01016794",812,289,105,184,493,72,219,74,115,30,103,66,31,6,88,56,32,11,11,30,11,19
"2021","Milton Keynes 004E","E01016795",693,201,79,122,459,45,209,88,95,26,106,68,35,3,90,60,30,9,9,33,11,22
"2021","Milton Keynes 005A","E01016762",537,126,54,72,362,83,153,61,67,25,60,28,27,5,61,37,24,5,5,49,28,21
"2021","Milton Keynes 005B","E01016764",633,186,86,100,395,83,178,76,72,30,79,37,36,6,48,27,21,7,7,52,17,35
"2021","Milton Keynes 005C","E01016766",541,128,78,50,354,52,177,60,85,32,56,29,18,9,66,37,29,3,3,59,23,36
"2021","Milton Keynes 005D","E01016767",540,104,51,53,407,72,220,99,78,43,67,44,17,6,44,23,21,4,4,29,14,15
"2021","Milton Keynes 005E","E01016771",496,143,63,80,292,32,154,39,73,42,40,10,25,5,64,37,27,2,2,61,35,26
"2021","Milton Keynes 006A","E01016806",724,187,56,131,458,21,204,48,109,47,75,28,39,8,148,106,42,10,10,79,45,34
"2021","Milton Keynes 006B","E01016807",686,158,76,82,471,55,220,78,106,36,84,37,38,9,107,63,44,5,5,57,27,30
"2021","Milton Keynes 006C","E01016809",534,126,57,69,350,43,178,54,83,41,51,23,24,4,68,36,32,10,10,58,25,33
"2021","Milton Keynes 006D","E01016835",728,207,73,134,462,32,181,47,102,32,93,38,44,11,150,107,43,6,6,59,30,29
"2021","Milton Keynes 007A","E01016763",630,225,123,102,372,72,182,86,59,37,61,33,18,10,56,29,27,1,1,33,12,21
"2021","Milton Keynes 007B","E01016769",578,171,87,84,373,57,220,86,86,48,54,32,17,5,37,13,24,5,5,34,13,21
"2021","Milton Keynes 007C","E01016770",664,165,65,100,452,67,245,96,98,51,75,47,22,6,62,41,21,3,3,47,23,24
"2021","Milton Keynes 007D","E01016773",859,296,216,80,505,119,272,116,109,47,61,40,14,7,49,24,25,4,4,58,24,34
"2021","Milton Keynes 008A","E01016836",635,150,51,99,415,32,205,62,112,31,85,49,33,3,83,46,37,10,10,70,31,39
"2021","Milton Keynes 008B","E01016837",749,196,54,142,467,27,266,82,133,51,99,57,36,6,65,34,31,10,10,86,33,53
"2021","Milton Keynes 008C","E01016838",601,122,69,53,426,56,216,69,106,41,67,39,27,1,82,47,35,5,5,53,31,22
"2021","Milton Keynes 008D","E01016841",1112,356,73,283,663,37,248,90,126,32,203,130,67,6,159,120,39,16,16,93,26,67
"2021","Milton Keynes 009A","E01016721",642,186,74,112,347,45,158,46,77,35,49,32,15,2,82,52,30,13,13,109,41,68
"2021","Milton Keynes 009B","E01016765",645,195,125,70,406,83,204,80,80,44,50,27,21,2,64,38,26,5,5,44,20,24
"2021","Milton Keynes 009C","E01016772",506,137,51,86,303,14,151,49,70,32,55,20,27,8,75,41,34,8,8,66,36,30
"2021","Milton Keynes 009D","E01016804",771,255,108,147,442,30,174,56,90,28,94,50,39,5,128,94,34,16,16,74,36,38
"2021","Milton Keynes 010A","E01016812",646,182,111,71,429,85,215,81,95,39,71,37,30,4,55,32,23,3,3,35,12,23
"2021","Milton Keynes 010B","E01016817",672,211,89,122,434,73,190,68,88,34,74,40,30,4,95,53,42,2,2,27,11,16
"2021","Milton Keynes 010C","E01016818",938,404,220,184,502,97,198,91,83,24,132,89,37,6,72,43,29,3,3,32,8,24
"2021","Milton Keynes 010E","E01034449",832,236,102,134,530,77,261,73,141,47,108,61,41,6,79,53,26,5,5,66,27,39
"2021","Milton Keynes 010F","E01034450",683,166,28,138,462,28,214,71,127,16,121,65,56,0,90,56,34,9,9,55,19,36
"2021","Milton Keynes 011A","E01016719",643,211,96,115,399,58,204,70,94,40,65,35,23,7,67,38,29,5,5,33,16,17
"2021","Milton Keynes 011B","E01016722",621,144,61,83,427,66,223,82,88,53,73,31,37,5,60,35,25,5,5,50,28,22
"2021","Milton Keynes 011C","E01016805",608,181,77,104,405,85,203,93,73,37,73,57,14,2,42,17,25,2,2,22,6,16
"2021","Milton Keynes 011D","E01016808",543,112,40,72,380,50,206,77,89,40,70,36,27,7,50,39,11,4,4,51,26,25
"2021","Milton Keynes 012A","E01016810",646,258,78,180,338,17,152,50,77,25,47,21,22,4,116,83,33,6,6,50,30,20
"2021","Milton Keynes 012B","E01016811",498,85,21,64,365,15,140,25,95,20,60,16,37,7,145,102,43,5,5,48,24,24
"2021","Milton Keynes 012C","E01016819",459,138,69,69,272,35,112,27,62,23,33,10,15,8,86,56,30,6,6,49,32,17
"2021","Milton Keynes 012D","E01016839",636,144,50,94,431,10,182,52,107,23,78,28,41,9,152,115,37,9,9,61,26,35
"2021","Milton Keynes 013A","E01016717",677,189,77,112,418,35,204,74,88,42,79,46,28,5,87,42,45,13,13,70,33,37
"2021","Milton Keynes 013B","E01016720",637,221,134,87,355,34,160,49,78,33,48,14,26,8,110,70,40,3,3,61,28,33
"2021","Milton Keynes 013C","E01016723",614,143,63,80,417,68,247,85,107,55,47,31,14,2,51,22,29,4,4,54,30,24
"2021","Milton Keynes 013D","E01016724",649,182,48,134,347,28,165,47,91,27,57,35,17,5,88,53,35,9,9,120,45,75
"2021","Milton Keynes 014A","E01016718",676,188,22,166,357,10,146,33,90,23,63,33,25,5,117,86,31,21,21,131,36,95
"2021","Milton Keynes 014B","E01016729",804,250,81,169,418,25,174,32,118,24,59,25,34,0,144,94,50,16,16,136,69,67
"2021","Milton Keynes 014D","E01016768",1079,347,60,287,601,38,274,107,125,42,152,104,42,6,113,78,35,24,24,131,45,86
"2021","Milton Keynes 014E","E01033499",1059,501,41,460,440,14,214,110,94,10,130,102,22,6,59,44,15,23,23,118,11,107
"2021","Milton Keynes 014F","E01033500",843,414,13,401,358,5,167,99,62,6,124,108,15,1,46,37,9,16,16,71,9,62
"2021","Milton Keynes 015A","E01016776",539,107,45,62,396,42,246,91,110,45,56,24,25,7,50,25,25,2,2,36,14,22
"2021","Milton Keynes 015B","E01016813",665,268,37,231,369,20,185,63,91,31,83,59,23,1,78,59,19,3,3,28,11,17
"2021","Milton Keynes 015C","E01016815",537,152,61,91,345,34,201,59,112,30,47,27,16,4,60,39,21,3,3,40,15,25
"2021","Milton Keynes 015D","E01016816",597,118,67,51,442,100,277,82,146,49,39,22,16,1,26,11,15,0,0,37,15,22
"2021","Milton Keynes 016A","E01016731",651,187,89,98,394,56,210,78,94,38,53,28,21,4,72,41,31,3,3,70,35,35
"2021","Milton Keynes 016B","E01016732",535,125,47,78,349,56,188,63,82,43,44,24,17,3,56,29,27,5,5,61,29,32
"2021","Milton Keynes 016D","E01016784",767,257,87,170,428,61,179,71,60,48,74,46,23,5,104,76,28,10,10,82,28,54
"2021","Milton Keynes 016E","E01033501",743,114,16,98,559,7,310,69,202,39,101,44,55,2,129,107,22,12,12,70,29,41
"2021","Milton Keynes 016F","E01033506",721,113,37,76,551,36,346,73,218,55,96,48,43,5,66,47,19,7,7,57,37,20
"2021","Milton Keynes 018A","E01016726",616,150,30,120,359,9,136,40,72,24,59,23,33,3,147,102,45,8,8,107,49,58
"2021","Milton Keynes 018B","E01016733",630,173,38,135,334,14,138,29,77,32,65,31,29,5,105,79,26,12,12,123,56,67
"2021","Milton Keynes 018C","E01016845",661,163,46,117,423,9,146,39,78,29,84,21,57,6,176,127,49,8,8,75,36,39
"2021","Milton Keynes 018D","E01016846",637,183,83,100,388,34,187,59,90,38,63,29,31,3,96,66,30,8,8,66,26,40
"2021","Milton Keynes 018E","E01016848",631,210,91,119,345,46,174,66,86,22,50,23,25,2,70,43,27,5,5,76,30,46
"2021","Milton Keynes 020A","E01016774",671,152,79,73,469,68,298,92,165,41,60,35,21,4,43,24,19,0,0,50,24,26
"2021","Milton Keynes 020B","E01016775",709,214,77,137,458,40,260,73,148,39,74,50,21,3,82,57,25,2,2,37,15,22
"2021","Milton Keynes 020C","E01016777",635,171,77,94,426,38,252,95,129,28,68,36,29,3,67,39,28,1,1,38,18,20
"2021","Milton Keynes 020D","E01016778",704,192,61,131,466,28,281,87,151,43,69,42,25,2,83,45,38,5,5,46,24,22
"2021","Milton Keynes 021A","E01016725",592,139,20,119,369,17,165,50,87,28,64,35,27,2,116,78,38,7,7,84,36,48
"2021","Milton Keynes 021B","E01016727",682,191,73,118,419,43,209,61,115,33,64,32,27,5,93,51,42,10,10,72,32,40
"2021","Milton Keynes 021C","E01016728",726,130,30,100,481,18,268,67,170,31,88,46,37,5,94,62,32,13,13,115,57,58
"2021","Milton Keynes 021D","E01016847",871,270,102,168,508,32,205,58,107,40,78,28,39,11,178,113,65,15,15,93,41,52
"2021","Milton Keynes 022A","E01016822",666,189,47,142,433,23,177,62,85,30,100,54,40,6,132,102,30,1,1,44,20,24
"2021","Milton Keynes 022B","E01016824",674,183,48,135,457,26,257,82,126,49,58,26,32,0,113,72,41,3,3,34,16,18
"2021","Milton Keynes 022C","E01016825",633,175,44,131,422,28,194,62,95,37,95,58,30,7,100,70,30,5,5,36,19,17
"2021","Milton Keynes 022D","E01016827",723,186,44,142,492,16,257,93,116,48,119,72,41,6,97,64,33,3,3,45,14,31
"2021","Milton Keynes 022E","E01016828",742,199,56,143,510,58,290,101,130,59,94,56,36,2,66,41,25,2,2,33,11,22
"2021","Milton Keynes 023B","E01016842",585,172,33,139,364,11,118,28,65,25,58,17,35,6,173,124,49,4,4,49,26,23
"2021","Milton Keynes 023C","E01016843",546,138,28,110,331,17,126,22,85,19,46,17,25,4,137,104,33,5,5,77,37,40
"2021","Milton Keynes 023D","E01016844",632,195,80,115,351,34,137,34,72,31,48,16,25,7,121,80,41,11,11,86,47,39
"2021","Milton Keynes 023E","E01033497",761,303,108,195,411,47,156,69,66,21,106,78,25,3,87,69,18,15,15,47,14,33
"2021","Milton Keynes 023F","E01033498",835,292,74,218,471,27,204,62,114,28,96,46,47,3,133,101,32,11,11,72,28,44
"2021","Milton Keynes 024A","E01016734",706,177,94,83,498,80,256,89,121,46,89,49,34,6,71,52,19,2,2,31,19,12
"2021","Milton Keynes 024C","E01016736",642,220,142,78,403,96,200,79,83,38,63,36,23,4,42,24,18,2,2,19,7,12
"2021","Milton Keynes 024D","E01016826",532,87,28,59,422,33,295,101,117,77,44,19,19,6,44,32,12,6,6,23,9,14
"2021","Milton Keynes 024E","E01034451",783,167,28,139,573,37,293,102,167,24,159,112,43,4,79,69,10,5,5,43,20,23
"2021","Milton Keynes 024F","E01034452",946,271,74,197,639,73,321,94,192,35,121,78,41,2,116,83,33,8,8,36,18,18
"2021","Milton Keynes 025B","E01016752",622,119,33,86,474,28,304,88,148,68,69,21,39,9,67,47,20,6,6,29,20,9
"2021","Milton Keynes 025C","E01016753",890,230,43,187,603,16,348,93,193,62,113,65,37,11,119,76,43,7,7,57,27,30
"2021","Milton Keynes 025D","E01016755",716,180,72,108,491,32,295,84,167,44,72,37,29,6,88,63,25,4,4,45,23,22
"2021","Milton Keynes 025E","E01033514",582,88,19,69,445,8,298,60,210,28,59,25,29,5,79,60,19,1,1,49,27,22
"2021","Milton Keynes 025F","E01033515",665,71,24,47,538,21,393,85,246,62,50,16,27,7,71,51,20,3,3,56,26,30
"2021","Milton Keynes 025G","E01033517",550,90,12,78,420,10,293,71,185,37,70,33,33,4,41,27,14,6,6,40,18,22
"2021","Milton Keynes 026A","E01016754",725,233,98,135,449,53,232,80,104,48,75,40,29,6,81,50,31,8,8,43,22,21
"2021","Milton Keynes 026B","E01016756",921,300,117,183,572,35,311,71,193,47,86,41,41,4,137,92,45,3,3,49,20,29
"2021","Milton Keynes 026C","E01016757",603,139,60,79,404,67,231,79,109,43,39,22,15,2,65,40,25,2,2,60,24,36
"2021","Milton Keynes 026D","E01016758",670,148,43,105,478,31,285,87,144,54,75,43,31,1,79,43,36,8,8,44,18,26
"2021","Milton Keynes 027A","E01016737",638,116,62,54,459,67,240,79,100,61,64,30,27,7,85,51,34,3,3,63,34,29
"2021","Milton Keynes 027B","E01016738",763,202,95,107,501,54,189,43,98,48,72,27,39,6,179,126,53,7,7,60,36,24
"2021","Milton Keynes 027C","E01016739",594,121,45,76,440,65,241,87,102,52,63,36,25,2,69,48,21,2,2,33,11,22
"2021","Milton Keynes 027D","E01016740",577,133,84,49,407,91,196,71,80,45,59,24,29,6,59,30,29,2,2,37,23,14
"2021","Milton Keynes 027E","E01016741",650,167,75,92,425,51,180,54,88,38,70,28,34,8,119,80,39,5,5,58,31,27
"2021","Milton Keynes 028A","E01016748",858,212,47,165,611,32,348,99,195,54,116,68,47,1,114,89,25,1,1,35,15,20
"2021","Milton Keynes 028C","E01016750",621,160,73,87,414,58,254,80,129,45,59,32,22,5,39,25,14,4,4,47,31,16
"2021","Milton Keynes 028D","E01016751",631,148,42,106,455,22,269,71,156,42,82,45,33,4,81,51,30,1,1,28,20,8
"2021","Milton Keynes 028E","E01033519",1020,191,38,153,756,15,465,91,333,41,123,59,58,6,146,114,32,7,7,73,40,33
"2021","Milton Keynes 028F","E01033520",658,114,32,82,502,45,342,90,197,55,57,24,27,6,55,36,19,3,3,42,22,20
"2021","Milton Keynes 029A","E01016829",679,162,91,71,478,71,179,47,88,44,81,32,38,11,145,102,43,2,2,39,16,23
"2021","Milton Keynes 029B","E01016831",626,148,89,59,439,80,223,79,90,54,64,25,34,5,70,47,23,2,2,39,22,17
"2021","Milton Keynes 029C","E01016832",505,129,72,57,337,62,162,57,65,40,44,16,20,8,66,35,31,3,3,39,20,19
"2021","Milton Keynes 029D","E01016833",499,119,87,32,344,100,209,71,78,60,20,6,9,5,15,6,9,0,0,36,20,16
"2021","Milton Keynes 029E","E01016834",641,159,94,65,440,44,190,60,83,47,67,22,38,7,138,84,54,1,1,42,16,26
"2021","Milton Keynes 030A","E01016710",792,241,152,89,481,74,231,68,103,60,84,42,33,9,85,50,35,7,7,70,35,35
"2021","Milton Keynes 030B","E01016714",846,238,111,127,494,52,212,55,117,40,87,43,39,5,131,96,35,12,12,114,67,47
"2021","Milton Keynes 030C","E01016716",1080,333,123,210,656,80,303,99,151,53,148,96,47,5,101,62,39,24,24,91,39,52
"2021","Milton Keynes 030D","E01016745",622,140,76,64,435,78,215,71,83,61,64,26,32,6,73,40,33,5,5,47,31,16
"2021","Milton Keynes 031A","E01016711",1195,329,157,172,785,125,388,128,191,69,140,83,47,10,118,74,44,14,14,81,41,40
"2021","Milton Keynes 031B","E01016713",734,176,98,78,509,115,252,98,101,53,77,38,29,10,59,29,30,6,6,49,20,29
"2021","Milton Keynes 031C","E01016715",671,142,79,63,459,51,205,71,88,46,95,49,41,5,104,70,34,4,4,70,40,30
"2021","Milton Keynes 031D","E01016830",523,162,76,86,333,35,177,63,75,39,73,33,37,3,47,31,16,1,1,28,10,18
"2021","Milton Keynes 032A","E01016742",640,132,43,89,440,21,148,25,92,31,67,15,42,10,198,154,44,6,6,68,39,29
"2021","Milton Keynes 032C","E01016744",566,105,37,68,401,25,159,31,96,32,61,17,36,8,152,104,48,4,4,60,37,23
"2021","Milton Keynes 032D","E01016746",704,164,88,76,473,70,210,66,107,37,69,38,31,0,118,62,56,6,6,67,30,37
"2021","Milton Keynes 032E","E01034453",729,177,10,167,504,2,249,69,165,15,155,86,68,1,90,76,14,8,8,48,29,19
"2021","Milton Keynes 032F","E01034454",662,146,59,87,462,18,176,34,107,35,88,28,53,7,174,117,57,6,6,54,28,26
"2021","Milton Keynes 032G","E01034455",689,139,12,127,509,7,250,82,155,13,167,111,53,3,78,65,13,7,7,41,21,20
"2021","Milton Keynes 033A","E01033503",904,152,39,113,689,41,444,90,312,42,99,45,48,6,103,81,22,2,2,63,38,25
"2021","Milton Keynes 033B","E01033511",686,176,35,141,441,22,199,53,130,16,99,56,42,1,109,89,20,12,12,69,24,45
"2021","Milton Keynes 033C","E01034456",604,83,30,53,471,48,308,52,213,43,51,19,26,6,60,39,21,4,4,50,18,32
"2021","Milton Keynes 033D","E01034457",804,231,8,223,538,7,290,69,208,13,105,65,40,0,128,119,9,8,8,35,15,20
"2021","Milton Keynes 034C","E01033508",914,152,13,139,657,9,418,67,322,29,104,42,56,6,114,87,27,12,12,105,48,57
"2021","Milton Keynes 034A","E01034458",644,109,6,103,491,2,300,51,236,13,126,77,49,0,57,51,6,6,6,44,28,16
"2021","Milton Keynes 034B","E01034459",655,143,11,132,447,6,236,34,189,13,109,48,53,8,93,75,18,3,3,65,27,38
"2021","Milton Keynes 034D","E01034460",627,124,5,119,455,1,276,58,209,9,116,64,50,2,59,52,7,3,3,48,34,14
"2021","Milton Keynes 034E","E01034461",643,153,15,138,395,8,204,40,149,15,76,48,24,4,94,74,20,13,13,95,37,58
"2021","Milton Keynes 035A","E01016783",734,195,34,161,476,8,252,54,170,28,88,44,39,5,123,91,32,5,5,63,34,29
"2021","Milton Keynes 035D","E01016820",767,201,45,156,516,51,312,102,160,50,73,39,31,3,78,60,18,2,2,50,30,20
"2021","Milton Keynes 035B","E01016821",526,113,30,83,380,20,233,65,134,34,65,31,30,4,59,47,12,3,3,33,14,19
"2021","Milton Keynes 035C","E01016823",787,300,44,256,441,9,212,79,107,26,127,83,43,1,86,68,18,7,7,46,12,34
"2021","Milton Keynes 036E","E01033522",677,175,18,157,450,8,239,47,169,23,111,55,52,4,82,66,16,10,10,52,20,32
"2021","Milton Keynes 036D","E01033523",548,132,13,119,354,5,175,39,127,9,72,41,26,5,96,65,31,6,6,62,27,35
"2021","Milton Keynes 036A","E01034462",654,192,114,78,435,132,186,71,77,38,61,35,22,4,54,28,26,2,2,27,7,20
"2021","Milton Keynes 036B","E01034463",624,157,0,157,425,6,256,62,186,8,121,76,41,4,38,27,11,4,4,42,22,20
"2021","Milton Keynes 036C","E01034464",605,166,17,149,409,20,220,61,151,8,125,89,32,4,37,34,3,7,7,30,16,14
"2021","Milton Keynes 036F","E01034465",632,101,11,90,490,8,307,46,237,24,87,40,41,6,86,72,14,2,2,41,18,23
"2021","Milton Keynes 037C","E01016780",657,160,55,105,459,34,271,82,141,48,91,42,46,3,59,33,26,4,4,38,21,17
"2021","Milton Keynes 037D","E01016781",557,108,54,54,413,47,308,105,138,65,34,20,11,3,23,12,11,1,1,36,17,19
"2021","Milton Keynes 037A","E01034466",859,111,4,107,687,2,447,49,393,5,156,80,75,1,74,59,15,8,8,61,40,21
"2021","Milton Keynes 037B","E01034467",717,129,27,102,529,17,322,61,223,38,81,35,38,8,106,76,30,3,3,59,35,24
"2021","Milton Keynes 037E","E01034468",462,246,183,63,195,79,76,24,45,7,25,15,8,2,13,10,3,2,2,21,9,12
"2021","Brighton and Hove 001A","E01016924",576,150,99,51,386,61,219,62,110,47,60,29,26,5,46,24,22,0,0,40,12,28
"2021","Brighton and Hove 001B","E01016926",605,139,60,79,406,22,194,52,112,30,72,26,39,7,114,73,41,4,4,60,26,34
"2021","Brighton and Hove 001C","E01016927",618,144,75,69,422,50,211,58,109,44,80,39,35,6,78,45,33,3,3,52,22,30
"2021","Brighton and Hove 001D","E01016929",623,160,89,71,419,56,220,67,110,43,76,36,32,8,64,38,26,3,3,44,15,29
"2021","Brighton and Hove 001E","E01016931",635,149,102,47,446,70,227,61,125,41,91,41,47,3,56,27,29,2,2,40,16,24
"2021","Brighton and Hove 002A","E01016898",733,218,134,84,411,58,197,63,79,55,79,42,32,5,74,33,41,3,3,104,17,87
"2021","Brighton and Hove 002B","E01016899",407,105,44,61,210,26,106,27,50,29,38,17,19,2,40,16,24,0,0,92,11,81
"2021","Brighton and Hove 002C","E01016914",471,97,23,74,264,15,91,18,43,30,64,22,28,14,85,52,33,9,9,110,24,86
"2021","Brighton and Hove 002D","E01016915",467,87,42,45,279,12,124,29,52,43,43,11,23,9,97,62,35,3,3,101,19,82
"2021","Brighton and Hove 003A","E01016923",666,222,131,91,395,65,207,68,105,34,58,27,29,2,63,42,21,2,2,49,13,36
"2021","Brighton and Hove 003B","E01016928",671,151,98,53,485,99,252,76,122,54,64,38,19,7,67,43,24,3,3,35,12,23
"2021","Brighton and Hove 003C","E01016998",583,119,74,45,422,61,243,67,133,43,57,21,32,4,59,37,22,2,2,42,16,26
"2021","Brighton and Hove 003D","E01016999",598,118,71,47,437,83,255,89,128,38,54,30,19,5,43,24,19,2,2,43,13,30
"2021","Brighton and Hove 003E","E01017000",852,314,188,126,468,64,223,69,115,39,103,67,31,5,72,52,20,6,6,70,15,55
"2021","Brighton and Hove 004A","E01016925",596,144,68,76,397,37,198,48,111,39,65,24,38,3,92,52,40,5,5,55,19,36
"2021","Brighton and Hove 004B","E01016930",755,157,91,66,524,97,265,96,124,45,96,45,47,4,65,30,35,1,1,74,31,43
"2021","Brighton and Hove 004C","E01017001",594,122,88,34,444,94,267,72,152,43,41,13,22,6,41,21,20,1,1,28,13,15
"2021","Brighton and Hove 004D","E01017003",690,194,101,93,460,41,273,109,133,31,82,43,35,4,62,33,29,2,2,36,13,23
"2021","Brighton and Hove 005A","E01016916",603,155,105,50,418,64,215,78,101,36,72,33,34,5,65,33,32,2,2,30,12,18
"2021","Brighton and Hove 005B","E01016917",574,127,79,48,418,61,192,51,103,38,85,37,42,6,77,43,34,3,3,29,14,15
"2021","Brighton and Hove 005C","E01016918",599,186,102,84,376,42,156,49,71,36,74,37,31,6,98,62,36,6,6,37,12,25
"2021","Brighton and Hove 005D","E01016919",542,132,56,76,379,42,151,38,73,40,77,30,39,8,107,63,44,2,2,31,12,19
"2021","Brighton and Hove 005E","E01016920",631,145,70,75,443,32,230,77,110,43,100,48,43,9,77,44,33,4,4,43,9,34
"2021","Brighton and Hove 006A","E01016882",625,160,93,67,417,63,165,44,87,34,74,25,44,5,112,68,44,3,3,48,26,22
"2021","Brighton and Hove 006B","E01016883",656,163,118,45,466,149,205,69,87,49,64,25,32,7,45,27,18,3,3,27,14,13
"2021","Brighton and Hove 006C","E01016884",623,161,85,76,410,41,243,56,133,54,40,23,17,0,83,55,28,3,3,52,26,26
"2021","Brighton and Hove 006D","E01016885",611,218,83,135,348,13,129,33,70,26,84,36,42,6,120,78,42,2,2,45,19,26
"2021","Brighton and Hove 006E","E01016886",622,169,99,70,405,59,214,56,106,52,64,18,41,5,61,30,31,7,7,48,24,24
"2021","Brighton and Hove 007A","E01016980",645,149,76,73,449,63,271,69,157,45,59,28,29,2,53,34,19,3,3,47,13,34
"2021","Brighton and Hove 007B","E01016982",507,87,63,24,398,72,243,70,134,39,45,15,26,4,38,25,13,0,0,22,13,9
"2021","Brighton and Hove 007C","E01016983",541,100,52,48,401,57,270,84,133,53,36,15,17,4,37,14,23,1,1,40,15,25
"2021","Brighton and Hove 007D","E01016984",578,107,84,23,436,93,264,90,124,50,40,19,18,3,35,20,15,4,4,35,16,19
"2021","Brighton and Hove 007E","E01016985",613,144,60,84,429,45,238,58,140,40,80,48,29,3,65,35,30,1,1,40,9,31
"2021","Brighton and Hove 008A","E01016900",743,322,89,233,335,29,113,44,47,22,64,28,32,4,122,94,28,7,7,86,18,68
"2021","Brighton and Hove 008B","E01016902",593,124,46,78,407,49,160,28,100,32,81,31,41,9,113,72,41,4,4,62,16,46
"2021","Brighton and Hove 008C","E01016904",685,223,56,167,370,18,124,39,46,39,64,23,33,8,159,107,52,5,5,92,18,74
"2021","Brighton and Hove 008D","E01016905",797,344,140,204,370,23,144,45,76,23,100,49,48,3,97,65,32,6,6,83,13,70
"2021","Brighton and Hove 008E","E01016909",620,147,62,85,275,26,95,29,36,30,78,39,35,4,65,34,31,11,11,198,17,181
"2021","Brighton and Hove 009A","E01016906",588,152,60,92,351,20,148,36,67,45,86,30,45,11,91,51,40,6,6,85,32,53
"2021","Brighton and Hove 009B","E01016907",580,112,56,56,249,22,99,39,32,28,50,24,25,1,70,38,32,8,8,219,32,187
"2021","Brighton and Hove 009C","E01016908",565,147,59,88,343,20,146,41,73,32,61,16,38,7,108,69,39,8,8,75,20,55
"2021","Brighton and Hove 009D","E01016910",501,94,24,70,318,21,122,56,38,28,63,17,34,12,109,60,49,3,3,89,15,74
"2021","Brighton and Hove 009E","E01016911",529,100,43,57,321,39,133,34,46,53,66,28,30,8,73,41,32,10,10,108,14,94
"2021","Brighton and Hove 010A","E01016901",603,114,47,67,404,20,203,42,130,31,106,44,57,5,73,51,22,2,2,85,17,68
"2021","Brighton and Hove 010B","E01016903",654,130,35,95,399,25,205,44,128,33,92,48,41,3,70,48,22,7,7,125,18,107
"2021","Brighton and Hove 010C","E01016934",510,112,49,63,363,39,226,67,122,37,68,29,33,6,30,17,13,0,0,35,11,24
"2021","Brighton and Hove 010D","E01016939",591,100,46,54,430,31,245,69,146,30,88,42,41,5,65,39,26,1,1,61,14,47
"2021","Brighton and Hove 010E","E01016940",603,130,29,101,430,28,253,61,160,32,104,56,41,7,42,27,15,3,3,43,8,35
"2021","Brighton and Hove 011A","E01016981",668,173,91,82,460,85,284,89,158,37,43,21,17,5,47,25,22,1,1,35,9,26
"2021","Brighton and Hove 011B","E01017002",745,208,103,105,467,63,230,70,129,31,102,72,26,4,69,49,20,3,3,70,11,59
"2021","Brighton and Hove 011C","E01017004",774,286,77,209,419,24,179,60,93,26,136,101,29,6,74,47,27,6,6,69,15,54
"2021","Brighton and Hove 011D","E01017005",708,178,50,128,464,34,244,72,143,29,127,87,35,5,51,37,14,8,8,66,19,47
"2021","Brighton and Hove 011E","E01017006",767,250,76,174,458,27,223,85,96,42,139,104,33,2,67,46,21,2,2,59,5,54
"2021","Brighton and Hove 012A","E01016921",663,179,66,113,436,32,204,57,106,41,90,38,47,5,105,64,41,5,5,48,18,30
"2021","Brighton and Hove 012B","E01016922",519,112,65,47,365,40,170,49,85,36,76,34,37,5,77,52,25,2,2,42,18,24
"2021","Brighton and Hove 012C","E01016973",640,175,95,80,414,59,200,71,86,43,79,45,28,6,73,50,23,3,3,51,22,29
"2021","Brighton and Hove 012D","E01016977",624,150,76,74,426,39,210,63,104,43,89,39,36,14,85,56,29,3,3,48,19,29
"2021","Brighton and Hove 012E","E01016978",785,307,110,197,419,31,177,64,84,29,99,54,41,4,109,68,41,3,3,59,21,38
"2021","Brighton and Hove 013A","E01016879",560,116,70,46,396,39,205,46,118,41,62,21,33,8,87,55,32,3,3,48,20,28
"2021","Brighton and Hove 013B","E01016880",492,106,50,56,322,12,138,31,64,43,49,17,25,7,119,74,45,4,4,64,30,34
"2021","Brighton and Hove 013C","E01016881",615,185,94,91,381,30,205,49,115,41,69,28,37,4,73,29,44,4,4,49,13,36
"2021","Brighton and Hove 013D","E01016887",609,168,92,76,387,42,195,46,97,52,81,31,41,9,63,30,33,6,6,54,17,37
"2021","Brighton and Hove 013E","E01016888",577,143,107,36,389,46,229,51,134,44,55,22,29,4,55,29,26,4,4,45,18,27
"2021","Brighton and Hove 013F","E01016976",605,116,80,36,446,71,234,66,112,56,82,28,43,11,57,32,25,2,2,43,16,27
"2021","Brighton and Hove 014A","E01016932",694,227,59,168,406,39,215,62,122,31,103,71,28,4,44,29,15,5,5,61,14,47
"2021","Brighton and Hove 014B","E01016933",623,214,53,161,362,24,179,54,92,33,97,65,29,3,58,40,18,4,4,47,8,39
"2021","Brighton and Hove 014C","E01016935",801,318,147,171,422,42,179,68,96,15,126,90,34,2,67,47,20,8,8,61,11,50
"2021","Brighton and Hove 014D","E01016936",760,221,43,178,440,24,208,79,122,7,154,113,41,0,45,31,14,9,9,99,7,92
"2021","Brighton and Hove 014E","E01016937",1025,365,57,308,479,6,161,99,57,5,232,203,27,2,72,53,19,8,8,181,16,165
"2021","Brighton and Hove 015A","E01016890",835,300,38,262,295,6,80,31,35,14,144,112,30,2,49,34,15,16,16,240,11,229
"2021","Brighton and Hove 015B","E01016966",751,270,54,216,274,12,94,43,47,4,110,88,18,4,46,27,19,12,12,207,9,198
"2021","Brighton and Hove 015C","E01016970",718,218,53,165,397,27,184,71,95,18,105,76,28,1,71,46,25,10,10,103,6,97
"2021","Brighton and Hove 015D","E01016971",736,200,31,169,270,5,97,38,41,18,117,93,23,1,40,23,17,11,11,266,9,257
"2021","Brighton and Hove 015E","E01016972",791,255,51,204,418,19,176,81,74,21,156,131,24,1,60,41,19,7,7,118,11,107
"2021","Brighton and Hove 016A","E01016979",683,124,38,86,506,33,274,67,174,33,132,66,58,8,59,32,27,8,8,53,20,33
"2021","Brighton and Hove 016B","E01016990",759,250,72,178,460,22,214,62,133,19,123,83,37,3,97,59,38,4,4,49,8,41
"2021","Brighton and Hove 016C","E01016991",769,255,61,194,426,15,170,65,94,11,152,101,45,6,87,63,24,2,2,88,14,74
"2021","Brighton and Hove 016D","E01016996",748,172,68,104,516,18,271,71,181,19,133,71,57,5,89,70,19,5,5,60,17,43
"2021","Brighton and Hove 017A","E01017007",655,179,104,75,424,50,184,55,97,32,76,34,36,6,105,53,52,9,9,52,19,33
"2021","Brighton and Hove 017B","E01017008",699,168,115,53,472,94,250,114,89,47,68,40,23,5,57,32,25,3,3,59,18,41
"2021","Brighton and Hove 017C","E01017009",618,150,85,65,428,72,203,70,83,50,70,32,25,13,81,46,35,2,2,40,14,26
"2021","Brighton and Hove 017D","E01017010",708,150,88,62,496,96,237,94,95,48,97,52,35,10,61,36,25,5,5,62,23,39
"2021","Brighton and Hove 017E","E01017011",526,115,66,49,368,31,157,56,67,34,69,25,35,9,104,68,36,7,7,43,17,26
"2021","Brighton and Hove 017F","E01017012",713,170,89,81,490,70,242,81,122,39,94,39,45,10,82,39,43,2,2,53,20,33
"2021","Brighton and Hove 018A","E01016892",623,121,31,90,378,25,159,44,90,25,111,68,40,3,73,46,27,10,10,124,9,115
"2021","Brighton and Hove 018B","E01016893",762,206,69,137,428,24,181,70,97,14,151,92,53,6,66,47,19,6,6,128,11,117
"2021","Brighton and Hove 018C","E01016912",767,204,42,162,313,8,81,38,32,11,131,90,34,7,81,55,26,12,12,250,10,240
"2021","Brighton and Hove 018D","E01016913",645,132,42,90,276,14,128,46,57,25,81,54,25,2,45,25,20,8,8,237,7,230
"2021","Brighton and Hove 018E","E01016946",613,171,51,120,382,35,197,52,122,23,98,54,41,3,49,32,17,3,3,60,8,52
"2021","Brighton and Hove 019A","E01016860",863,370,72,298,387,15,122,48,68,6,165,128,34,3,72,48,24,13,13,106,6,100
"2021","Brighton and Hove 019B","E01016871",981,463,157,306,414,41,150,70,69,11,134,110,23,1,69,47,22,20,20,104,6,98
"2021","Brighton and Hove 019C","E01016872",901,331,46,285,480,8,164,71,82,11,224,182,39,3,78,51,27,6,6,90,4,86
"2021","Brighton and Hove 019D","E01016873",978,441,97,344,431,22,137,60,66,11,168,137,30,1,98,58,40,6,6,106,12,94
"2021","Brighton and Hove 019E","E01016878",876,362,130,232,465,41,225,71,128,26,131,106,24,1,66,46,20,2,2,49,6,43
"2021","Brighton and Hove 020A","E01016870",694,203,38,165,411,23,209,67,110,32,116,89,24,3,56,37,19,7,7,80,12,68
"2021","Brighton and Hove 020B","E01016874",1034,458,188,270,484,49,166,73,77,16,163,121,39,3,89,70,19,17,17,92,7,85
"2021","Brighton and Hove 020C","E01016875",619,158,35,123,395,20,222,58,133,31,93,63,27,3,55,38,17,5,5,66,16,50
"2021","Brighton and Hove 020D","E01016876",863,343,111,232,426,19,178,59,99,20,172,142,28,2,47,32,15,10,10,94,12,82
"2021","Brighton and Hove 020E","E01016877",929,406,134,272,424,51,162,75,74,13,122,82,39,1,73,46,27,16,16,99,13,86
"2021","Brighton and Hove 021A","E01016974",784,241,77,164,469,18,229,56,132,41,121,70,48,3,96,66,30,5,5,74,15,59
"2021","Brighton and Hove 021B","E01016975",633,156,71,85,414,24,196,49,103,44,95,45,45,5,94,44,50,5,5,63,30,33
"2021","Brighton and Hove 021C","E01016992",700,195,118,77,465,56,283,65,175,43,79,44,34,1,44,29,15,3,3,40,12,28
"2021","Brighton and Hove 021D","E01016994",752,234,67,167,457,27,233,67,139,27,115,76,38,1,76,49,27,6,6,61,10,51
"2021","Brighton and Hove 021E","E01016997",666,194,75,119,418,43,224,56,144,24,94,52,39,3,53,34,19,4,4,54,19,35
"2021","Brighton and Hove 022A","E01016889",735,232,58,174,329,12,131,45,67,19,131,93,36,2,49,39,10,6,6,174,7,167
"2021","Brighton and Hove 022B","E01016891",832,333,65,268,306,10,118,41,68,9,103,65,36,2,64,37,27,11,11,193,14,179
"2021","Brighton and Hove 022C","E01016894",717,229,67,162,362,15,127,57,51,19,119,84,32,3,78,41,37,23,23,126,10,116
"2021","Brighton and Hove 022D","E01016896",695,186,42,144,364,11,150,50,84,16,142,90,43,9,53,42,11,8,8,145,6,139
"2021","Brighton and Hove 022E","E01016897",749,239,65,174,403,16,169,68,92,9,139,89,47,3,74,53,21,5,5,107,8,99
"2021","Brighton and Hove 023A","E01016987",744,270,111,159,406,41,211,73,109,29,94,58,35,1,55,34,21,5,5,68,13,55
"2021","Brighton and Hove 023B","E01016989",699,286,94,192,365,49,196,72,95,29,68,55,13,0,44,26,18,8,8,48,6,42
"2021","Brighton and Hove 023C","E01016993",748,309,122,187,399,33,162,49,93,20,85,32,51,2,110,75,35,9,9,40,9,31
"2021","Brighton and Hove 023D","E01016995",633,138,65,73,449,63,278,68,170,40,58,24,34,0,44,25,19,6,6,46,10,36
"2021","Brighton and Hove 024A","E01016938",927,331,60,271,477,15,201,61,126,14,188,154,32,2,58,43,15,15,15,119,6,113
"2021","Brighton and Hove 024B","E01016950",1025,482,134,348,447,26,127,66,50,11,250,223,27,0,36,26,10,8,8,96,3,93
"2021","Brighton and Hove 024C","E01016951",901,460,82,378,348,23,113,65,38,10,152,135,15,2,49,37,12,11,11,93,10,83
"2021","Brighton and Hove 024D","E01016967",1034,514,57,457,413,14,126,70,50,6,216,184,32,0,48,36,12,9,9,107,4,103
"2021","Brighton and Hove 024E","E01016968",844,438,42,396,328,2,103,61,35,7,183,162,17,4,30,19,11,10,10,78,6,72
"2021","Brighton and Hove 025A","E01016864",568,148,84,64,338,43,119,38,49,32,70,28,31,11,103,67,36,3,3,82,16,66
"2021","Brighton and Hove 025B","E01016865",572,132,44,88,388,13,131,27,68,36,70,25,39,6,170,108,62,4,4,52,18,34
"2021","Brighton and Hove 025C","E01016866",565,165,42,123,329,24,109,25,46,38,72,24,33,15,121,72,49,3,3,71,28,43
"2021","Brighton and Hove 025D","E01016867",646,268,71,197,305,22,102,30,51,21,60,31,19,10,111,59,52,10,10,73,15,58
"2021","Brighton and Hove 025E","E01016868",731,325,129,196,349,13,134,47,57,30,65,26,33,6,132,94,38,5,5,57,26,31
"2021","Brighton and Hove 025F","E01016895",622,151,53,98,399,20,159,37,88,34,83,35,40,8,130,78,52,7,7,72,18,54
"2021","Brighton and Hove 026A","E01016849",826,361,68,293,370,31,138,77,50,11,145,119,24,2,53,35,18,3,3,95,12,83
"2021","Brighton and Hove 026B","E01016852",924,447,56,391,368,4,110,61,44,5,188,170,18,0,50,33,17,16,16,109,3,106
"2021","Brighton and Hove 026C","E01016853",1063,495,109,386,457,15,151,70,70,11,207,176,30,1,69,50,19,15,15,111,4,107
"2021","Brighton and Hove 026D","E01016855",964,512,71,441,385,8,100,64,34,2,184,158,21,5,79,49,30,14,14,67,5,62
"2021","Brighton and Hove 026E","E01016856",929,464,160,304,348,37,125,71,50,4,130,107,20,3,44,30,14,12,12,117,7,110
"2021","Brighton and Hove 027A","E01016952",904,432,50,382,314,7,82,49,31,2,159,121,37,1,32,23,9,34,34,158,4,154
"2021","Brighton and Hove 027B","E01016953",797,328,73,255,377,40,163,80,67,16,119,99,16,4,40,29,11,15,15,92,9,83
"2021","Brighton and Hove 027C","E01016964",1200,562,93,469,397,17,135,82,45,8,139,121,16,2,87,49,38,19,19,241,20,221
"2021","Brighton and Hove 027E","E01016969",967,406,125,281,385,21,116,66,40,10,146,126,19,1,73,54,19,29,29,176,6,170
"2021","Brighton and Hove 027F","E01033328",677,303,74,229,267,16,83,54,25,4,101,93,6,2,50,28,22,17,17,107,12,95
"2021","Brighton and Hove 027G","E01033329",851,298,32,266,381,6,146,77,54,15,132,104,25,3,62,40,22,35,35,172,6,166
"2021","Brighton and Hove 028A","E01016857",836,407,84,323,370,35,132,65,58,9,125,110,14,1,68,40,28,10,10,59,5,54
"2021","Brighton and Hove 028B","E01016858",869,449,81,368,352,16,121,70,41,10,150,127,21,2,59,46,13,6,6,68,3,65
"2021","Brighton and Hove 028C","E01016859",843,442,171,271,350,62,117,65,38,14,119,105,13,1,45,29,16,7,7,51,4,47
"2021","Brighton and Hove 028D","E01016986",838,406,134,272,375,45,168,77,71,20,106,73,30,3,54,32,22,2,2,57,11,46
"2021","Brighton and Hove 028E","E01016988",748,347,114,233,351,33,146,54,75,17,119,86,31,2,46,29,17,7,7,50,9,41
"2021","Brighton and Hove 029A","E01016850",867,387,62,325,381,18,121,71,41,9,179,138,39,2,50,33,17,13,13,99,8,91
"2021","Brighton and Hove 029B","E01016851",1032,531,76,455,395,12,144,81,54,9,183,160,20,3,46,32,14,10,10,106,9,97
"2021","Brighton and Hove 029C","E01016854",994,522,98,424,390,8,111,76,30,5,211,190,20,1,52,33,19,8,8,82,3,79
"2021","Brighton and Hove 029D","E01016954",974,492,63,429,365,17,104,62,36,6,181,169,10,2,44,26,18,19,19,117,7,110
"2021","Brighton and Hove 029E","E01016955",936,496,58,438,326,18,87,58,23,6,153,134,19,0,43,23,20,25,25,114,9,105
"2021","Brighton and Hove 030A","E01016941",1102,569,122,447,365,23,106,65,30,11,144,124,19,1,64,35,29,28,28,168,11,157
"2021","Brighton and Hove 030B","E01016945",933,479,70,409,348,4,83,52,28,3,220,209,10,1,22,13,9,19,19,106,3,103
"2021","Brighton and Hove 030C","E01016947",975,475,109,366,410,16,111,40,55,16,100,70,29,1,169,81,88,14,14,90,13,77
"2021","Brighton and Hove 030D","E01016948",769,239,60,179,408,27,154,50,83,21,129,82,42,5,90,60,30,8,8,122,22,100
"2021","Brighton and Hove 030E","E01016949",909,450,113,337,330,22,125,61,49,15,93,82,9,2,77,45,32,13,13,129,8,121
"2021","Brighton and Hove 031A","E01016861",912,455,91,364,333,30,119,80,31,8,140,129,10,1,38,26,12,6,6,124,5,119
"2021","Brighton and Hove 031B","E01016862",825,404,119,285,326,23,125,72,51,2,134,112,19,3,35,23,12,9,9,95,10,85
"2021","Brighton and Hove 031C","E01016942",1042,685,395,290,305,67,90,50,31,9,60,41,15,4,81,48,33,7,7,52,9,43
"2021","Brighton and Hove 031D","E01016943",677,217,60,157,380,20,158,58,85,15,136,94,37,5,58,40,18,8,8,80,11,69
"2021","Brighton and Hove 031E","E01016944",885,406,43,363,371,18,117,75,31,11,170,156,13,1,25,15,10,41,41,108,6,102
"2021","Brighton and Hove 032A","E01016863",889,408,149,259,403,29,166,58,100,8,94,72,21,1,104,74,30,10,10,78,8,70
"2021","Brighton and Hove 032B","E01016869",864,305,129,176,443,35,186,66,98,22,102,64,31,7,104,63,41,16,16,116,21,95
"2021","Brighton and Hove 032C","E01016957",1065,510,137,373,485,59,213,118,67,28,143,99,15,29,53,26,27,17,17,70,8,62
"2021","Brighton and Hove 032D","E01016963",1000,413,138,275,477,54,186,94,75,17,141,113,27,1,82,50,32,14,14,110,17,93
"2021","Brighton and Hove 033A","E01016956",716,218,130,88,464,87,218,98,77,43,81,47,32,2,75,37,38,3,3,34,9,25
"2021","Brighton and Hove 033B","E01016958",847,284,169,115,515,121,217,91,84,42,91,49,40,2,82,55,27,4,4,48,14,34
"2021","Brighton and Hove 033C","E01016959",653,178,118,60,433,111,237,114,70,53,42,22,18,2,41,21,20,2,2,42,8,34
"2021","Brighton and Hove 033D","E01016960",815,281,163,118,492,109,233,105,84,44,75,52,16,7,68,36,32,7,7,42,11,31
"2021","Brighton and Hove 033E","E01016961",891,295,125,170,544,97,249,110,106,33,121,82,34,5,69,41,28,8,8,52,14,38
"2021","Brighton and Hove 033F","E01016962",736,194,129,65,493,111,249,122,88,39,77,41,29,7,54,26,28,2,2,49,8,41
"2021","Portsmouth 001A","E01017112",659,151,51,100,432,35,174,47,78,49,86,34,46,6,127,75,52,10,10,76,37,39
"2021","Portsmouth 001B","E01017115",488,90,52,38,336,21,150,56,54,40,66,24,32,10,94,48,46,5,5,62,27,35
"2021","Portsmouth 001C","E01017117",590,152,66,86,395,39,162,49,77,36,92,30,53,9,101,65,36,1,1,43,14,29
"2021","Portsmouth 001D","E01017119",634,145,67,78,439,43,202,67,87,48,96,40,42,14,90,54,36,8,8,50,24,26
"2021","Portsmouth 001E","E01017120",688,231,117,114,407,37,167,55,78,34,79,26,45,8,117,73,44,7,7,50,28,22
"2021","Portsmouth 002A","E01017051",895,265,84,181,549,38,204,67,113,24,103,45,51,7,185,147,38,19,19,81,21,60
"2021","Portsmouth 002B","E01017052",595,136,61,75,421,49,169,70,64,35,94,37,46,11,104,58,46,5,5,38,13,25
"2021","Portsmouth 002C","E01017053",530,165,69,96,323,33,122,41,50,31,62,32,25,5,99,70,29,7,7,42,14,28
"2021","Portsmouth 002D","E01017118",566,132,51,81,365,30,144,47,57,40,74,28,35,11,109,69,40,8,8,69,29,40
"2021","Portsmouth 003A","E01017050",744,237,159,78,460,114,223,80,99,44,62,28,30,4,54,41,13,7,7,47,19,28
"2021","Portsmouth 003B","E01017061",667,142,104,38,484,117,286,94,117,75,54,29,20,5,24,11,13,3,3,41,16,25
"2021","Portsmouth 003C","E01017063",611,141,107,34,434,79,258,89,112,57,64,26,32,6,32,16,16,1,1,36,13,23
"2021","Portsmouth 003D","E01017064",779,234,174,60,513,137,264,84,135,45,59,31,26,2,50,32,18,3,3,32,11,21
"2021","Portsmouth 004A","E01017054",613,199,106,93,374,52,190,57,89,44,61,31,28,2,67,38,29,4,4,40,19,21
"2021","Portsmouth 004B","E01017113",668,142,83,59,474,63,229,97,92,40,97,52,37,8,80,47,33,5,5,52,25,27
"2021","Portsmouth 004C","E01017114",758,265,122,143,452,99,189,112,47,30,121,96,24,1,39,24,15,4,4,41,9,32
"2021","Portsmouth 004D","E01017116",688,149,50,99,499,36,229,57,140,32,106,37,60,9,124,95,29,4,4,40,20,20
"2021","Portsmouth 006A","E01017055",675,221,122,99,393,55,201,52,104,45,58,30,24,4,71,35,36,8,8,61,25,36
"2021","Portsmouth 006B","E01017056",496,88,52,36,372,45,225,47,124,54,49,21,24,4,50,23,27,3,3,36,13,23
"2021","Portsmouth 006C","E01017057",570,116,73,43,406,53,230,68,118,44,67,31,30,6,56,23,33,0,0,48,19,29
"2021","Portsmouth 006D","E01017058",743,186,49,137,498,43,235,72,116,47,103,44,56,3,110,70,40,7,7,59,23,36
"2021","Portsmouth 006E","E01017060",766,169,88,81,561,62,315,78,189,48,109,53,42,14,74,43,31,1,1,36,15,21
"2021","Portsmouth 007A","E01017086",503,95,55,40,371,48,219,82,87,50,68,33,33,2,35,21,14,1,1,37,13,24
"2021","Portsmouth 007B","E01017089",641,152,59,93,438,36,214,76,107,31,73,46,23,4,110,81,29,5,5,51,22,29
"2021","Portsmouth 007C","E01017090",739,210,65,145,493,50,249,81,122,46,87,55,30,2,102,71,31,5,5,36,15,21
"2021","Portsmouth 007D","E01017091",786,316,176,140,437,68,212,95,95,22,65,31,33,1,86,69,17,6,6,33,15,18
"2021","Portsmouth 007E","E01017092",652,192,89,103,426,65,214,75,106,33,92,50,33,9,53,25,28,2,2,34,10,24
"2021","Portsmouth 008A","E01017014",640,161,69,92,445,58,221,65,101,55,86,40,41,5,76,47,29,4,4,34,15,19
"2021","Portsmouth 008B","E01017046",781,278,107,171,469,92,242,113,81,48,86,57,24,5,46,17,29,3,3,34,10,24
"2021","Portsmouth 008C","E01017047",628,130,61,69,451,58,243,71,120,52,89,33,48,8,58,32,26,3,3,47,22,25
"2021","Portsmouth 008D","E01017048",592,141,76,65,417,48,225,72,98,55,81,27,47,7,62,37,25,1,1,34,10,24
"2021","Portsmouth 008E","E01017085",667,239,112,127,407,79,181,77,72,32,75,43,25,7,70,38,32,2,2,21,8,13
"2021","Portsmouth 009A","E01017084",567,155,52,103,359,44,193,64,94,35,63,35,24,4,54,28,26,5,5,53,17,36
"2021","Portsmouth 009B","E01017087",575,163,41,122,362,33,190,58,92,40,82,38,40,4,52,31,21,5,5,50,17,33
"2021","Portsmouth 009C","E01017088",721,210,65,145,440,46,243,77,128,38,100,61,30,9,50,27,23,1,1,71,32,39
"2021","Portsmouth 009D","E01017105",710,270,112,158,379,39,173,60,87,26,91,53,33,5,72,46,26,4,4,61,25,36
"2021","Portsmouth 009E","E01017107",682,230,58,172,380,28,162,62,77,23,91,42,44,5,95,70,25,4,4,72,19,53
"2021","Portsmouth 010A","E01017104",499,130,52,78,323,31,143,49,66,28,67,33,30,4,79,46,33,3,3,46,16,30
"2021","Portsmouth 010B","E01017106",634,188,74,114,397,30,152,45,80,27,105,52,47,6,105,71,34,5,5,49,11,38
"2021","Portsmouth 010C","E01017108",719,257,126,131,408,36,161,72,62,27,94,55,31,8,108,63,45,9,9,54,12,42
"2021","Portsmouth 010D","E01017109",637,205,66,139,376,22,151,59,71,21,106,50,52,4,94,57,37,3,3,56,18,38
"2021","Portsmouth 011A","E01017041",505,96,43,53,349,43,201,53,105,43,60,15,36,9,42,24,18,3,3,60,25,35
"2021","Portsmouth 011B","E01017043",509,115,41,74,349,27,174,55,84,35,76,33,42,1,68,42,26,4,4,45,17,28
"2021","Portsmouth 011C","E01017044",599,161,44,117,369,29,185,64,80,41,77,40,31,6,76,52,24,2,2,69,25,44
"2021","Portsmouth 011D","E01017049",587,115,60,55,430,72,243,79,104,60,79,38,34,7,36,18,18,0,0,42,21,21
"2021","Portsmouth 011E","E01017110",586,146,36,110,387,30,162,53,76,33,103,48,48,7,85,54,31,7,7,53,13,40
"2021","Portsmouth 011F","E01017111",704,224,55,169,405,20,159,53,78,28,124,73,43,8,89,61,28,13,13,75,30,45
"2021","Portsmouth 012A","E01017013",699,165,63,102,479,20,219,61,119,39,123,61,61,1,110,81,29,7,7,55,20,35
"2021","Portsmouth 012B","E01017042",513,91,33,58,367,20,177,44,90,43,73,33,33,7,92,61,31,5,5,55,26,29
"2021","Portsmouth 012C","E01017045",507,126,52,74,340,32,162,46,88,28,67,35,29,3,75,51,24,4,4,41,20,21
"2021","Portsmouth 012D","E01017075",677,202,55,147,418,19,151,43,77,31,111,58,47,6,123,83,40,14,14,57,20,37
"2021","Portsmouth 012E","E01017082",729,205,34,171,439,20,176,56,89,31,127,71,51,5,109,81,28,7,7,85,35,50
"2021","Portsmouth 012F","E01017083",700,192,54,138,438,28,187,60,91,36,106,49,51,6,112,68,44,5,5,70,25,45
"2021","Portsmouth 013A","E01017036",596,150,53,97,396,20,126,44,58,24,80,22,44,14,159,105,54,11,11,50,19,31
"2021","Portsmouth 013B","E01017037",656,216,90,126,397,21,126,29,77,20,53,13,36,4,186,134,52,11,11,43,21,22
"2021","Portsmouth 013C","E01017038",780,350,178,172,363,39,106,37,60,9,66,23,35,8,144,103,41,8,8,67,18,49
"2021","Portsmouth 013D","E01017102",772,327,119,208,360,21,151,51,64,36,67,36,27,4,115,72,43,6,6,85,33,52
"2021","Portsmouth 013E","E01017103",524,169,54,115,313,14,111,29,61,21,46,13,26,7,137,93,44,5,5,42,20,22
"2021","Portsmouth 014A","E01017015",621,175,68,107,408,53,190,63,85,42,88,42,38,8,69,38,31,8,8,38,17,21
"2021","Portsmouth 014B","E01017016",643,164,74,90,425,43,192,65,82,45,111,53,55,3,76,47,29,3,3,54,19,35
"2021","Portsmouth 014C","E01017017",592,150,71,79,405,65,220,70,99,51,83,44,32,7,35,18,17,2,2,37,17,20
"2021","Portsmouth 014D","E01017018",621,138,79,59,441,63,238,72,105,61,84,41,38,5,55,29,26,1,1,42,11,31
"2021","Portsmouth 014E","E01017019",727,214,80,134,443,45,184,58,96,30,113,64,45,4,98,64,34,3,3,70,30,40
"2021","Portsmouth 014F","E01017020",965,260,115,145,647,67,313,90,154,69,124,56,53,15,133,87,46,10,10,58,25,33
"2021","Portsmouth 015A","E01017076",748,253,59,194,434,24,164,64,75,25,121,58,60,3,112,75,37,13,13,61,13,48
"2021","Portsmouth 015B","E01017077",897,436,171,265,401,19,158,59,81,18,102,56,43,3,113,78,35,9,9,60,17,43
"2021","Portsmouth 015C","E01017078",625,152,53,99,416,18,183,59,95,29,117,61,52,4,85,58,27,13,13,57,15,42
"2021","Portsmouth 015D","E01017079",625,140,53,87,398,23,168,60,80,28,113,59,42,12,81,49,32,13,13,87,26,61
"2021","Portsmouth 015E","E01017080",798,215,60,155,451,15,198,52,121,25,127,71,50,6,103,68,35,8,8,132,24,108
"2021","Portsmouth 015F","E01017081",656,157,37,120,402,14,178,63,84,31,110,62,39,9,87,64,23,13,13,97,21,76
"2021","Portsmouth 017A","E01017021",647,214,147,67,413,107,192,81,69,42,58,24,30,4,53,26,27,3,3,20,5,15
"2021","Portsmouth 017B","E01017093",498,175,87,88,288,55,141,58,57,26,36,22,11,3,55,31,24,1,1,35,19,16
"2021","Portsmouth 017C","E01017096",653,239,126,113,371,48,168,67,70,31,95,47,40,8,58,43,15,2,2,43,14,29
"2021","Portsmouth 017D","E01017099",1124,396,170,226,619,65,288,92,163,33,139,73,57,9,119,88,31,8,8,109,33,76
"2021","Portsmouth 017E","E01017100",531,104,52,52,394,47,222,77,106,39,70,29,35,6,54,26,28,1,1,33,17,16
"2021","Portsmouth 017F","E01017101",645,199,83,116,403,34,188,55,99,34,105,49,52,4,72,46,26,4,4,43,8,35
"2021","Portsmouth 018A","E01017035",774,357,164,193,357,25,136,33,93,10,53,14,33,6,135,105,30,8,8,60,29,31
"2021","Portsmouth 018B","E01017128",620,194,27,167,227,11,77,36,31,10,95,83,11,1,33,22,11,11,11,199,12,187
"2021","Portsmouth 018C","E01017129",638,175,41,134,225,18,87,26,47,14,68,54,10,4,36,23,13,16,16,238,22,216
"2021","Portsmouth 018D","E01017130",811,274,112,162,437,7,178,33,117,28,61,15,36,10,186,136,50,5,5,100,38,62
"2021","Portsmouth 018E","E01017132",554,207,100,107,264,19,97,25,63,9,40,22,17,1,102,76,26,6,6,83,19,64
"2021","Portsmouth 018F","E01017133",825,416,209,207,299,40,106,36,58,12,67,42,20,5,71,54,17,15,15,110,14,96
"2021","Portsmouth 019A","E01017023",660,177,68,109,413,33,195,53,109,33,102,58,38,6,72,37,35,11,11,70,9,61
"2021","Portsmouth 019B","E01017025",776,188,65,123,432,16,168,54,95,19,142,95,44,3,90,58,32,16,16,156,29,127
"2021","Portsmouth 019C","E01017026",759,256,124,132,391,40,183,73,87,23,94,62,30,2,62,35,27,12,12,112,14,98
"2021","Portsmouth 019D","E01017029",685,192,63,129,403,30,204,65,103,36,90,49,35,6,72,49,23,7,7,90,15,75
"2021","Portsmouth 019E","E01017030",689,157,49,108,340,26,131,39,68,24,98,61,33,4,73,48,25,12,12,192,16,176
"2021","Portsmouth 020A","E01017022",642,266,81,185,261,30,120,49,56,15,67,56,9,2,38,23,15,6,6,115,9,106
"2021","Portsmouth 020B","E01017024",756,210,44,166,367,26,145,55,66,24,114,73,38,3,67,47,20,15,15,179,10,169
"2021","Portsmouth 020C","E01017027",624,151,53,98,283,27,120,44,63,13,75,54,18,3,53,31,22,8,8,190,25,165
"2021","Portsmouth 020D","E01017028",755,186,31,155,289,17,111,35,62,14,69,41,28,0,80,62,18,12,12,280,31,249
"2021","Portsmouth 020E","E01017124",746,272,57,215,377,28,166,66,77,23,119,79,36,4,54,37,17,10,10,97,16,81
"2021","Portsmouth 021A","E01017094",611,149,49,100,421,44,205,66,109,30,102,49,49,4,69,46,23,1,1,41,12,29
"2021","Portsmouth 021B","E01017095",857,298,99,199,496,33,215,101,92,22,131,87,42,2,116,77,39,1,1,63,14,49
"2021","Portsmouth 021C","E01017097",709,236,72,164,416,14,177,70,80,27,132,75,51,6,82,52,30,11,11,57,14,43
"2021","Portsmouth 021D","E01017098",671,231,56,175,389,17,156,69,71,16,118,73,40,5,92,60,32,6,6,51,13,38
"2021","Portsmouth 022A","E01017122",855,378,81,297,393,41,151,73,53,25,144,117,25,2,46,28,18,11,11,84,13,71
"2021","Portsmouth 022B","E01017125",860,440,212,228,346,43,138,57,62,19,103,82,16,5,58,36,22,4,4,74,3,71
"2021","Portsmouth 022C","E01017127",974,464,79,385,399,21,143,74,54,15,171,151,17,3,51,31,20,13,13,111,5,106
"2021","Portsmouth 022D","E01017135",804,326,110,216,388,55,164,86,59,19,103,75,26,2,60,34,26,6,6,90,15,75
"2021","Portsmouth 023A","E01017067",646,187,93,94,420,69,213,86,81,46,71,43,26,2,64,35,29,3,3,39,11,28
"2021","Portsmouth 023B","E01017068",890,359,128,231,477,73,172,92,66,14,139,106,25,8,88,52,36,5,5,54,9,45
"2021","Portsmouth 023C","E01017069",663,197,84,113,429,55,209,88,90,31,104,58,43,3,58,34,24,3,3,37,9,28
"2021","Portsmouth 023D","E01017070",732,323,120,203,351,72,161,72,65,24,81,59,20,2,30,14,16,7,7,58,17,41
"2021","Portsmouth 023E","E01017074",789,249,93,156,474,49,224,84,116,24,92,45,42,5,95,71,24,14,14,66,21,45
"2021","Portsmouth 024A","E01017073",1034,535,209,326,408,66,159,74,65,20,131,107,21,3,44,21,23,8,8,91,19,72
"2021","Portsmouth 024B","E01017123",1133,596,189,407,439,66,163,98,53,12,151,137,14,0,40,23,17,19,19,98,20,78
"2021","Portsmouth 024C","E01017131",754,262,108,154,393,64,172,82,73,17,80,59,21,0,66,46,20,11,11,99,8,91
"2021","Portsmouth 024E","E01033380",696,357,81,276,296,72,127,87,31,9,59,52,7,0,23,13,10,15,15,43,6,37
"2021","Portsmouth 024F","E01033384",768,374,195,179,356,91,153,81,51,21,71,61,8,2,37,19,18,4,4,38,2,36
"2021","Portsmouth 025A","E01017071",638,239,41,198,322,19,162,69,68,25,91,62,24,5,38,29,9,12,12,77,13,64
"2021","Portsmouth 025B","E01017072",582,182,78,104,341,63,180,67,80,33,63,45,14,4,27,15,12,8,8,59,13,46
"2021","Portsmouth 025C","E01017121",732,301,67,234,360,40,174,67,86,21,98,72,24,2,38,22,16,10,10,71,13,58
"2021","Portsmouth 025D","E01017126",829,316,96,220,401,31,161,66,78,17,134,100,31,3,67,39,28,8,8,112,16,96
"2021","Portsmouth 026A","E01017059",631,137,103,34,462,113,223,61,112,50,65,30,27,8,59,35,24,2,2,32,13,19
"2021","Portsmouth 026B","E01017062",618,104,53,51,490,76,316,81,192,43,60,30,23,7,37,23,14,1,1,24,13,11
"2021","Portsmouth 026C","E01017066",766,197,99,98,521,81,262,75,139,48,96,54,35,7,80,56,24,2,2,48,18,30
"2021","Portsmouth 026D","E01032604",604,149,81,68,417,71,236,75,113,48,60,26,24,10,48,27,21,2,2,38,14,24
"2021","Portsmouth 027C","E01017032",667,326,68,258,272,12,80,32,41,7,75,55,20,0,85,64,21,20,20,69,10,59
"2021","Portsmouth 027A","E01017034",637,261,67,194,305,15,96,31,55,10,71,39,29,3,111,84,27,12,12,71,10,61
"2021","Portsmouth 027D","E01033381",754,335,50,285,321,13,108,54,35,19,100,79,20,1,69,50,19,31,31,98,16,82
"2021","Portsmouth 027B","E01033383",589,231,86,145,285,26,97,37,34,26,62,32,24,6,87,56,31,13,13,73,9,64
"2021","Portsmouth 028A","E01017031",934,419,183,236,444,23,152,50,80,22,79,33,39,7,175,122,53,15,15,71,23,48
"2021","Portsmouth 028C","E01017039",722,240,105,135,383,24,155,35,91,29,52,22,26,4,141,101,40,11,11,99,37,62
"2021","Portsmouth 028B","E01017040",630,223,80,143,353,14,100,27,51,22,70,25,33,12,157,111,46,12,12,54,29,25
"2021","Southampton 001A","E01017144",419,109,49,60,252,33,134,41,70,23,44,26,12,6,37,20,17,4,4,58,16,42
"2021","Southampton 001B","E01017145",666,201,115,86,413,67,224,90,90,44,81,59,20,2,39,18,21,2,2,52,21,31
"2021","Southampton 001C","E01017146",692,197,92,105,434,75,244,106,95,43,79,55,19,5,27,15,12,9,9,61,16,45
"2021","Southampton 001D","E01017148",425,85,37,48,295,48,183,69,78,36,35,20,14,1,27,7,20,2,2,45,12,33
"2021","Southampton 001E","E01017149",458,84,30,54,246,16,123,21,75,27,28,11,11,6,64,32,32,15,15,128,26,102
"2021","Southampton 002A","E01017180",583,132,66,66,422,68,218,76,93,49,83,45,35,3,48,33,15,5,5,29,12,17
"2021","Southampton 002B","E01017181",595,193,90,103,358,62,163,53,79,31,52,21,30,1,77,35,42,4,4,44,17,27
"2021","Southampton 002C","E01017183",663,139,76,63,489,79,246,89,115,42,91,40,44,7,68,44,24,5,5,35,14,21
"2021","Southampton 002D","E01017185",718,213,90,123,454,46,202,53,113,36,97,51,41,5,103,64,39,6,6,51,20,31
"2021","Southampton 002E","E01017187",729,211,71,140,465,65,198,73,92,33,101,65,33,3,91,60,31,10,10,53,17,36
"2021","Southampton 003A","E01017264",521,250,49,201,241,20,86,19,52,15,65,37,26,2,62,45,17,8,8,30,11,19
"2021","Southampton 003B","E01017265",740,288,120,168,410,40,167,58,74,35,87,48,33,6,110,75,35,6,6,42,24,18
"2021","Southampton 003C","E01017270",566,239,132,107,289,32,128,51,60,17,62,37,23,2,62,32,30,5,5,38,17,21
"2021","Southampton 003D","E01017271",477,141,62,79,285,50,130,49,58,23,68,37,23,8,32,16,16,5,5,51,20,31
"2021","Southampton 004A","E01017182",710,361,253,108,311,67,154,58,59,37,45,22,17,6,45,26,19,0,0,38,17,21
"2021","Southampton 004B","E01017184",601,171,110,61,391,79,183,66,83,34,70,28,34,8,57,24,33,2,2,39,13,26
"2021","Southampton 004C","E01017186",711,210,61,149,455,27,212,70,92,50,102,59,35,8,106,66,40,8,8,46,18,28
"2021","Southampton 004D","E01017188",623,147,60,87,412,33,192,56,101,35,77,35,33,9,106,65,41,4,4,64,27,37
"2021","Southampton 005A","E01017266",487,107,45,62,269,10,144,39,74,31,34,13,16,5,78,46,32,3,3,111,20,91
"2021","Southampton 005B","E01017267",459,114,31,83,229,16,124,35,67,22,41,32,8,1,42,30,12,6,6,116,27,89
"2021","Southampton 005E","E01017272",501,89,42,47,357,31,180,51,103,26,63,30,28,5,81,47,34,2,2,55,26,29
"2021","Southampton 005G","E01035442",540,93,38,55,230,22,122,22,84,16,32,22,8,2,45,19,26,9,9,217,19,198
"2021","Southampton 005H","E01035443",401,134,44,90,160,10,67,20,39,8,35,22,12,1,40,27,13,8,8,107,11,96
"2021","Southampton 006A","E01017147",624,200,91,109,373,73,176,78,77,21,73,51,21,1,43,21,22,8,8,51,18,33
"2021","Southampton 006B","E01017150",603,173,106,67,365,82,196,64,91,41,58,37,19,2,26,10,16,3,3,65,20,45
"2021","Southampton 006C","E01017151",725,248,120,128,428,71,182,64,86,32,94,53,35,6,76,34,42,5,5,49,18,31
"2021","Southampton 006D","E01017152",688,233,74,159,395,44,177,61,86,30,111,83,28,0,60,33,27,3,3,60,17,43
"2021","Southampton 007A","E01017238",820,220,85,135,532,46,227,76,116,35,118,60,55,3,135,95,40,6,6,68,32,36
"2021","Southampton 007B","E01017241",669,272,168,104,357,38,142,47,69,26,71,25,43,3,104,71,33,2,2,40,16,24
"2021","Southampton 007C","E01017242",921,330,82,248,539,41,231,73,126,32,152,101,47,4,109,75,34,6,6,52,22,30
"2021","Southampton 007D","E01017243",652,124,65,59,475,73,255,89,115,51,68,32,30,6,69,40,29,10,10,53,22,31
"2021","Southampton 007E","E01017244",549,122,53,69,379,32,182,51,95,36,77,30,39,8,79,58,21,9,9,48,17,31
"2021","Southampton 008A","E01017174",571,127,79,48,411,91,212,76,99,37,70,31,33,6,35,17,18,3,3,33,12,21
"2021","Southampton 008B","E01017175",601,149,60,89,413,57,222,62,119,41,74,35,36,3,59,37,22,1,1,39,11,28
"2021","Southampton 008C","E01017176",673,192,76,116,445,65,218,76,93,49,93,43,45,5,66,43,23,3,3,36,16,20
"2021","Southampton 008D","E01017179",534,156,67,89,340,40,143,49,69,25,81,38,38,5,76,51,25,0,0,38,13,25
"2021","Southampton 009A","E01017226",846,380,180,200,402,90,182,74,82,26,90,79,10,1,33,17,16,7,7,64,10,54
"2021","Southampton 009D","E01017231",630,168,55,113,249,32,125,51,57,17,54,44,10,0,34,23,11,4,4,213,12,201
"2021","Southampton 009E","E01017232",503,159,60,99,256,26,142,46,81,15,50,33,16,1,33,18,15,5,5,88,10,78
"2021","Southampton 009F","E01032753",778,208,91,117,403,88,218,70,123,25,60,41,15,4,31,21,10,6,6,167,21,146
"2021","Southampton 010A","E01017246",967,331,68,263,546,36,234,83,136,15,130,86,38,6,131,105,26,15,15,90,24,66
"2021","Southampton 010B","E01017250",760,321,154,167,406,41,151,50,90,11,89,43,40,6,121,94,27,4,4,33,13,20
"2021","Southampton 010C","E01017251",665,194,59,135,403,29,176,57,93,26,78,37,36,5,104,70,34,16,16,68,29,39
"2021","Southampton 010D","E01017253",669,160,74,86,424,44,202,56,112,34,69,32,33,4,103,62,41,6,6,85,36,49
"2021","Southampton 011A","E01017247",623,126,66,60,438,64,263,80,129,54,58,35,22,1,45,24,21,8,8,59,25,34
"2021","Southampton 011B","E01017248",593,152,66,86,400,65,251,54,153,44,50,21,26,3,33,23,10,1,1,41,15,26
"2021","Southampton 011C","E01017249",496,93,61,32,359,75,234,78,123,33,26,13,12,1,21,7,14,3,3,44,16,28
"2021","Southampton 011D","E01017252",646,168,90,78,434,66,253,78,133,42,71,49,17,5,42,22,20,2,2,44,13,31
"2021","Southampton 011E","E01017254",685,167,76,91,452,39,230,60,144,26,95,49,35,11,84,56,28,4,4,66,18,48
"2021","Southampton 012A","E01017236",593,192,101,91,366,24,173,56,81,36,62,23,27,12,104,66,38,3,3,35,14,21
"2021","Southampton 012B","E01017237",596,149,59,90,407,25,179,51,89,39,84,31,46,7,113,81,32,6,6,40,20,20
"2021","Southampton 012C","E01017239",640,205,63,142,393,29,177,60,84,33,91,55,32,4,86,58,28,10,10,42,19,23
"2021","Southampton 012D","E01017240",612,224,51,173,351,32,116,46,48,22,93,39,47,7,107,77,30,3,3,37,12,25
"2021","Southampton 012E","E01017245",624,177,68,109,417,18,127,37,66,24,96,25,62,9,172,137,35,4,4,30,13,17
"2021","Southampton 013A","E01017227",428,174,21,153,127,2,53,17,29,7,43,32,9,2,25,12,13,4,4,127,11,116
"2021","Southampton 013B","E01017228",699,286,70,216,357,30,157,61,73,23,103,68,29,6,63,36,27,4,4,56,18,38
"2021","Southampton 013C","E01017233",738,258,109,149,420,37,163,49,84,30,106,71,30,5,107,59,48,7,7,60,16,44
"2021","Southampton 013D","E01017234",735,309,100,209,264,33,119,44,61,14,66,40,22,4,42,23,19,4,4,162,22,140
"2021","Southampton 013E","E01017235",600,229,31,198,226,10,88,36,40,12,80,67,9,4,34,26,8,14,14,145,17,128
"2021","Southampton 014A","E01017171",882,353,81,272,474,34,206,75,104,27,147,99,41,7,76,62,14,11,11,55,20,35
"2021","Southampton 014B","E01017172",825,291,74,217,468,37,214,74,106,34,135,87,44,4,71,48,23,11,11,66,12,54
"2021","Southampton 014C","E01017173",640,170,77,93,443,59,228,73,121,34,77,41,31,5,72,49,23,7,7,27,11,16
"2021","Southampton 014D","E01017177",784,326,138,188,414,69,189,62,98,29,89,67,20,2,64,40,24,3,3,44,10,34
"2021","Southampton 014E","E01017178",586,121,40,81,431,49,252,76,138,38,72,40,31,1,52,40,12,6,6,34,16,18
"2021","Southampton 015A","E01017207",667,210,80,130,421,15,148,34,91,23,84,31,52,1,165,132,33,9,9,36,17,19
"2021","Southampton 015B","E01017209",580,146,47,99,384,36,192,64,88,40,89,49,36,4,61,39,22,6,6,50,13,37
"2021","Southampton 015C","E01017211",932,487,277,210,394,63,174,84,72,18,101,70,29,2,49,29,20,7,7,51,13,38
"2021","Southampton 015D","E01017212",573,147,69,78,376,48,214,67,115,32,57,31,20,6,51,34,17,6,6,50,16,34
"2021","Southampton 015E","E01017213",814,289,61,228,466,29,228,78,125,25,139,94,41,4,63,40,23,7,7,59,17,42
"2021","Southampton 016A","E01017200",872,320,194,126,501,88,248,102,97,49,96,57,35,4,64,41,23,5,5,51,20,31
"2021","Southampton 016B","E01017201",551,179,87,92,338,43,125,51,60,14,78,28,42,8,87,58,29,5,5,34,14,20
"2021","Southampton 016C","E01017202",748,242,57,185,456,35,138,43,70,25,110,50,56,4,168,135,33,5,5,50,21,29
"2021","Southampton 016D","E01017203",627,142,64,78,454,51,223,65,111,47,92,38,47,7,83,57,26,5,5,31,16,15
"2021","Southampton 016E","E01017204",632,170,96,74,430,73,220,69,110,41,74,34,33,7,62,37,25,1,1,32,12,20
"2021","Southampton 017A","E01017157",599,233,33,200,194,13,81,33,43,5,55,37,17,1,36,20,16,9,9,172,10,162
"2021","Southampton 017B","E01017158",933,367,76,291,382,14,168,84,73,11,127,105,17,5,60,37,23,13,13,184,13,171
"2021","Southampton 017C","E01017159",521,134,17,117,199,8,83,23,49,11,55,39,15,1,37,27,10,16,16,188,23,165
"2021","Southampton 017D","E01017160",662,201,41,160,319,7,121,48,60,13,137,114,20,3,44,26,18,10,10,142,22,120
"2021","Southampton 018A","E01017198",681,226,136,90,416,82,180,76,70,34,72,45,26,1,81,37,44,1,1,39,18,21
"2021","Southampton 018B","E01017199",751,270,155,115,450,76,198,83,82,33,83,49,34,0,90,57,33,3,3,31,10,21
"2021","Southampton 018C","E01017205",618,172,76,96,403,24,170,34,94,42,90,33,47,10,111,70,41,8,8,43,26,17
"2021","Southampton 018D","E01017206",671,167,80,87,443,61,211,76,88,47,86,51,28,7,81,38,43,4,4,61,27,34
"2021","Southampton 019A","E01017208",585,150,57,93,389,33,149,37,80,32,81,27,42,12,123,80,43,3,3,46,22,24
"2021","Southampton 019B","E01017210",671,164,71,93,450,28,177,52,90,35,90,25,51,14,148,107,41,7,7,57,29,28
"2021","Southampton 019C","E01017214",550,126,45,81,362,47,186,51,101,34,83,50,28,5,45,26,19,1,1,62,31,31
"2021","Southampton 019D","E01017215",700,162,71,91,493,65,272,89,129,54,81,35,39,7,71,44,27,4,4,45,28,17
"2021","Southampton 019E","E01017216",562,168,57,111,319,24,158,55,73,30,74,46,22,6,58,34,24,5,5,75,29,46
"2021","Southampton 020A","E01017189",705,325,38,287,298,15,151,73,62,16,103,85,17,1,25,18,7,4,4,82,15,67
"2021","Southampton 020B","E01017190",671,256,52,204,328,30,154,65,76,13,101,80,20,1,31,17,14,12,12,87,10,77
"2021","Southampton 020C","E01017191",800,353,33,320,361,13,150,46,85,19,125,94,26,5,61,40,21,12,12,86,24,62
"2021","Southampton 020D","E01017196",1058,444,83,361,518,43,214,87,115,12,188,166,18,4,55,28,27,18,18,96,14,82
"2021","Southampton 020E","E01017197",530,129,47,82,348,39,213,59,120,34,59,38,20,1,34,18,16,3,3,53,12,41
"2021","Southampton 021A","E01017192",907,311,82,229,511,29,234,86,127,21,138,87,46,5,96,61,35,14,14,85,24,61
"2021","Southampton 021B","E01017193",880,386,119,267,428,24,171,67,81,23,137,88,42,7,86,51,35,10,10,66,17,49
"2021","Southampton 021C","E01017194",965,369,64,305,498,21,211,83,103,25,149,113,33,3,96,58,38,21,21,98,28,70
"2021","Southampton 021D","E01017195",978,406,78,328,502,28,191,74,98,19,182,141,40,1,86,65,21,15,15,70,14,56
"2021","Southampton 022A","E01017153",474,109,19,90,253,3,141,13,100,28,41,22,19,0,56,32,24,12,12,112,59,53
"2021","Southampton 022B","E01017154",1019,389,53,336,541,5,240,51,167,22,122,72,44,6,151,102,49,23,23,89,39,50
"2021","Southampton 022C","E01017155",601,158,26,132,296,5,177,33,120,24,44,32,10,2,53,36,17,17,17,147,55,92
"2021","Southampton 022D","E01017156",509,108,29,79,282,4,180,30,121,29,22,11,10,1,60,39,21,16,16,119,65,54
"2021","Southampton 022F","E01032738",890,389,14,375,346,5,97,42,49,6,160,139,19,2,62,45,17,22,22,155,4,151
"2021","Southampton 022G","E01032750",583,324,30,294,199,7,81,26,49,6,56,41,15,0,42,34,8,13,13,60,18,42
"2021","Southampton 023A","E01017136",642,223,65,158,199,17,80,34,37,9,71,63,7,1,22,10,12,9,9,220,12,208
"2021","Southampton 023B","E01017137",476,95,10,85,123,2,54,23,23,8,40,28,12,0,16,6,10,11,11,258,9,249
"2021","Southampton 023C","E01017138",870,318,91,227,359,23,134,51,72,11,133,111,21,1,54,35,19,15,15,193,10,183
"2021","Southampton 023E","E01035444",623,347,84,263,230,15,78,38,35,5,87,75,12,0,37,22,15,13,13,46,12,34
"2021","Southampton 023F","E01035445",604,297,62,235,265,13,106,44,56,6,64,46,17,1,71,56,15,11,11,42,7,35
"2021","Southampton 024A","E01017217",688,213,95,118,428,67,208,75,97,36,85,52,31,2,63,39,24,5,5,47,19,28
"2021","Southampton 024B","E01017223",649,154,59,95,448,60,264,73,145,46,75,33,38,4,46,25,21,3,3,47,28,19
"2021","Southampton 024C","E01017224",555,131,63,68,394,54,228,78,118,32,54,34,16,4,49,31,18,9,9,30,8,22
"2021","Southampton 024D","E01017225",609,159,70,89,413,42,208,67,95,46,82,39,40,3,75,46,29,6,6,37,13,24
"2021","Southampton 025A","E01017162",626,196,122,74,396,94,183,75,67,41,70,42,19,9,44,23,21,5,5,34,10,24
"2021","Southampton 025B","E01017163",651,215,46,169,401,31,140,38,77,25,68,27,37,4,160,129,31,2,2,35,21,14
"2021","Southampton 025C","E01017164",686,195,87,108,449,81,216,89,81,46,71,36,31,4,76,41,35,5,5,42,18,24
"2021","Southampton 025D","E01017165",620,178,104,74,405,49,202,76,85,41,67,33,27,7,84,53,31,3,3,37,17,20
"2021","Southampton 025E","E01017166",737,245,104,141,449,20,144,44,78,22,96,34,53,9,179,131,48,10,10,43,16,27
"2021","Southampton 026A","E01017256",870,226,109,117,588,106,312,109,145,58,105,60,37,8,64,33,31,1,1,56,15,41
"2021","Southampton 026B","E01017257",775,339,98,241,409,44,176,68,75,33,114,63,41,10,70,47,23,5,5,27,7,20
"2021","Southampton 026C","E01017259",596,166,87,79,400,70,203,90,86,27,75,40,33,2,49,27,22,3,3,30,9,21
"2021","Southampton 026D","E01017260",641,235,143,92,385,86,194,88,71,35,60,34,22,4,42,22,20,3,3,21,10,11
"2021","Southampton 026E","E01017262",538,142,73,69,368,38,190,74,76,40,72,33,28,11,65,30,35,3,3,28,11,17
"2021","Southampton 027A","E01017167",705,230,47,183,446,22,129,44,66,19,85,34,50,1,209,162,47,1,1,29,12,17
"2021","Southampton 027B","E01017168",794,305,84,221,450,47,160,64,69,27,96,55,37,4,144,105,39,3,3,39,12,27
"2021","Southampton 027C","E01017169",667,211,103,108,423,48,153,60,64,29,81,22,52,7,138,104,34,3,3,33,18,15
"2021","Southampton 027D","E01017170",678,212,99,113,433,51,174,54,85,35,103,52,50,1,103,71,32,2,2,33,15,18
"2021","Southampton 028A","E01017218",494,103,49,54,342,25,162,50,78,34,61,31,21,9,88,58,30,6,6,49,22,27
"2021","Southampton 028B","E01017219",870,362,120,242,440,44,153,51,82,20,117,58,50,9,121,93,28,5,5,68,21,47
"2021","Southampton 028C","E01017220",799,288,114,174,464,46,198,67,96,35,99,56,34,9,113,73,40,8,8,47,21,26
"2021","Southampton 028D","E01017221",672,165,52,113,470,43,248,82,117,49,93,44,43,6,81,57,24,5,5,37,16,21
"2021","Southampton 028E","E01017222",622,172,55,117,409,39,212,72,109,31,86,54,24,8,68,42,26,4,4,41,9,32
"2021","Southampton 030A","E01017255",701,218,79,139,447,60,229,71,106,52,94,55,33,6,57,32,25,7,7,36,10,26
"2021","Southampton 030B","E01017258",652,204,84,120,409,47,202,67,89,46,80,37,39,4,78,50,28,2,2,39,9,30
"2021","Southampton 030C","E01017261",728,201,89,112,488,69,235,96,98,41,106,72,26,8,76,42,34,2,2,39,17,22
"2021","Southampton 030D","E01017263",665,218,99,119,401,41,180,77,79,24,108,49,51,8,68,39,29,4,4,46,16,30
"2021","Southampton 031A","E01017273",653,224,88,136,388,49,191,64,96,31,89,44,39,6,56,30,26,3,3,41,11,30
"2021","Southampton 031B","E01017275",684,204,72,132,422,61,182,66,80,36,103,58,44,1,74,38,36,2,2,58,25,33
"2021","Southampton 031C","E01017276",865,324,61,263,497,28,208,71,104,33,141,82,53,6,113,81,32,7,7,44,18,26
"2021","Southampton 031E","E01017279",724,226,81,145,448,68,188,85,72,31,116,63,47,6,72,49,23,4,4,50,18,32
"2021","Southampton 031F","E01035446",671,279,22,257,361,11,112,51,52,9,174,141,32,1,58,47,11,6,6,31,3,28
"2021","Southampton 031G","E01035447",680,177,38,139,460,42,203,78,101,24,122,76,41,5,88,61,27,5,5,43,14,29
"2021","Southampton 032A","E01017274",617,202,107,95,379,40,151,57,68,26,77,23,50,4,105,69,36,6,6,36,14,22
"2021","Southampton 032B","E01017277",582,128,63,65,417,56,190,56,100,34,86,36,42,8,84,49,35,1,1,37,13,24
"2021","Southampton 032C","E01017280",731,259,91,168,419,36,163,51,83,29,104,50,44,10,113,69,44,3,3,53,23,30
"2021","Southampton 032D","E01017281",690,261,46,215,416,15,120,37,61,22,90,28,60,2,187,158,29,4,4,13,3,10
"2021","Southampton 033B","E01017139",1033,411,125,286,500,15,211,54,142,15,118,85,28,5,131,91,40,25,25,122,33,89
"2021","Southampton 033C","E01032745",716,254,36,218,368,5,137,43,85,9,115,85,29,1,96,66,30,15,15,94,21,73
"2021","Southampton 033D","E01032751",775,302,37,265,386,12,150,52,80,18,131,112,19,0,65,55,10,28,28,87,13,74
"2021","Southampton 033A","E01032755",488,216,28,188,248,2,118,20,92,6,49,24,24,1,74,52,22,5,5,24,9,15
"2021","Southampton 034C","E01032746",728,319,21,298,324,10,126,55,65,6,143,134,7,2,22,14,8,23,23,85,6,79
"2021","Southampton 034D","E01032748",1086,502,67,435,472,30,192,114,64,14,198,176,17,5,31,18,13,21,21,112,5,107
"2021","Southampton 034A","E01035448",633,336,13,323,258,4,64,33,25,6,136,121,15,0,41,26,15,13,13,39,6,33
"2021","Southampton 034B","E01035449",603,250,26,224,310,42,119,78,27,14,109,97,12,0,31,17,14,9,9,43,5,38
"2021","Isle of Wight 001A","E01017300",1151,528,272,256,562,150,232,128,62,42,93,65,23,5,80,51,29,7,7,61,19,42
"2021","Isle of Wight 001B","E01017303",563,203,62,141,329,32,159,69,61,29,77,47,25,5,57,35,22,4,4,31,8,23
"2021","Isle of Wight 001C","E01017305",707,287,108,179,368,34,141,53,65,23,101,53,39,9,90,66,24,2,2,52,15,37
"2021","Isle of Wight 001D","E01017306",558,165,63,102,350,39,146,41,76,29,87,38,45,4,78,49,29,0,0,43,17,26
"2021","Isle of Wight 001E","E01017309",702,212,87,125,456,51,176,72,77,27,122,61,54,7,103,71,32,4,4,34,13,21
"2021","Isle of Wight 002A","E01017301",486,141,102,39,328,106,154,70,58,26,42,19,22,1,25,8,17,1,1,17,6,11
"2021","Isle of Wight 002B","E01017302",687,168,88,80,482,77,246,80,137,29,78,29,43,6,80,50,30,1,1,37,16,21
"2021","Isle of Wight 002C","E01017304",582,167,88,79,384,48,183,54,100,29,79,41,30,8,73,50,23,1,1,31,10,21
"2021","Isle of Wight 002D","E01017316",978,328,173,155,624,137,308,138,121,49,103,55,41,7,72,47,25,4,4,26,14,12
"2021","Isle of Wight 002E","E01017329",1008,268,184,84,683,175,357,157,125,75,81,42,27,12,68,24,44,2,2,57,22,35
"2021","Isle of Wight 003A","E01017307",1130,389,243,146,695,205,294,149,100,45,108,53,47,8,83,55,28,5,5,46,20,26
"2021","Isle of Wight 003B","E01017308",735,243,123,120,456,84,203,69,101,33,99,45,44,10,68,42,26,2,2,36,21,15
"2021","Isle of Wight 003D","E01033229",877,263,142,121,576,158,259,151,72,36,104,56,43,5,54,37,17,1,1,38,10,28
"2021","Isle of Wight 003E","E01033237",778,271,109,162,471,46,174,68,80,26,120,56,56,8,128,90,38,3,3,36,16,20
"2021","Isle of Wight 004A","E01017335",813,413,153,260,357,46,154,78,48,28,73,44,21,8,84,57,27,0,0,43,16,27
"2021","Isle of Wight 004B","E01017336",895,498,144,354,355,45,113,54,41,18,107,75,31,1,86,58,28,4,4,42,17,25
"2021","Isle of Wight 004C","E01017337",852,439,160,279,366,51,145,71,49,25,90,66,18,6,74,45,29,6,6,47,21,26
"2021","Isle of Wight 004D","E01017346",721,356,141,215,328,60,136,70,39,27,72,43,25,4,59,40,19,1,1,37,13,24
"2021","Isle of Wight 005A","E01017286",727,213,149,64,489,168,234,106,82,46,58,37,17,4,27,16,11,2,2,25,12,13
"2021","Isle of Wight 005B","E01017287",742,207,129,78,513,139,251,123,88,40,77,38,32,7,44,27,17,2,2,22,8,14
"2021","Isle of Wight 005C","E01017367",898,295,196,99,563,205,241,119,76,46,64,30,28,6,53,28,25,0,0,40,12,28
"2021","Isle of Wight 005D","E01017368",733,271,161,110,425,104,180,81,72,27,79,46,29,4,59,39,20,3,3,37,14,23
"2021","Isle of Wight 006A","E01017282",590,171,82,89,392,56,186,67,86,33,69,34,29,6,81,57,24,0,0,27,11,16
"2021","Isle of Wight 006B","E01017283",738,227,127,100,482,95,238,107,80,51,83,45,31,7,64,34,30,2,2,29,8,21
"2021","Isle of Wight 006C","E01017338",656,246,154,92,375,107,157,66,59,32,52,34,15,3,59,32,27,0,0,35,14,21
"2021","Isle of Wight 006D","E01017341",683,199,116,83,462,78,192,69,88,35,83,27,46,10,106,69,37,3,3,22,8,14
"2021","Isle of Wight 006E","E01017342",741,262,122,140,449,71,196,75,95,26,69,41,24,4,109,76,33,4,4,30,15,15
"2021","Isle of Wight 007A","E01017339",780,250,103,147,483,60,211,80,94,37,110,40,59,11,94,62,32,8,8,47,18,29
"2021","Isle of Wight 007B","E01017340",869,345,129,216,470,60,191,75,76,40,111,63,44,4,105,70,35,3,3,54,21,33
"2021","Isle of Wight 007C","E01017343",574,190,86,104,351,57,149,58,59,32,76,32,43,1,66,43,23,3,3,33,12,21
"2021","Isle of Wight 007D","E01017344",782,242,133,109,517,140,237,108,84,45,72,43,22,7,67,37,30,1,1,23,10,13
"2021","Isle of Wight 007E","E01017345",825,287,86,201,493,34,155,56,74,25,122,47,68,7,179,137,42,3,3,45,20,25
"2021","Isle of Wight 008A","E01017310",587,161,104,57,386,86,196,74,75,47,66,45,19,2,37,22,15,1,1,40,16,24
"2021","Isle of Wight 008B","E01017311",708,230,98,132,445,93,182,79,66,37,95,41,50,4,72,45,27,3,3,33,12,21
"2021","Isle of Wight 008C","E01017331",997,331,117,214,619,58,231,83,111,37,174,76,91,7,153,105,48,3,3,47,18,29
"2021","Isle of Wight 008D","E01017332",839,266,102,164,537,48,211,63,100,48,124,52,64,8,148,105,43,6,6,36,12,24
"2021","Isle of Wight 008E","E01017334",495,119,56,63,339,51,179,72,67,40,59,32,22,5,48,28,20,2,2,37,16,21
"2021","Isle of Wight 009A","E01017295",591,170,66,104,398,49,154,60,64,30,89,42,39,8,105,82,23,1,1,23,14,9
"2021","Isle of Wight 009B","E01017325",623,252,114,138,349,50,135,61,50,24,92,49,36,7,66,42,24,6,6,22,11,11
"2021","Isle of Wight 009C","E01017326",879,460,196,264,375,41,105,43,44,18,115,70,40,5,106,80,26,8,8,44,10,34
"2021","Isle of Wight 009D","E01017328",706,308,97,211,354,33,123,57,50,16,85,46,35,4,106,65,41,7,7,44,17,27
"2021","Isle of Wight 009E","E01017333",666,143,59,84,466,41,230,80,102,48,114,46,56,12,79,49,30,2,2,57,20,37
"2021","Isle of Wight 010A","E01017284",805,312,234,78,465,188,176,93,49,34,55,36,15,4,44,25,19,2,2,28,11,17
"2021","Isle of Wight 010B","E01017285",951,308,227,81,605,212,273,132,82,59,53,27,21,5,65,37,28,2,2,38,12,26
"2021","Isle of Wight 010C","E01017288",593,202,120,82,366,102,160,73,58,29,46,25,20,1,57,30,27,1,1,25,9,16
"2021","Isle of Wight 010D","E01017351",666,208,125,83,427,126,208,98,66,44,52,28,21,3,40,22,18,1,1,31,10,21
"2021","Isle of Wight 010E","E01017352",541,143,108,35,378,155,172,98,44,30,23,16,6,1,27,13,14,1,1,20,2,18
"2021","Isle of Wight 011A","E01017292",779,251,132,119,499,76,221,72,110,39,121,58,60,3,80,52,28,1,1,29,10,19
"2021","Isle of Wight 011B","E01017293",787,203,108,95,547,98,286,91,143,52,91,41,48,2,71,55,16,1,1,37,23,14
"2021","Isle of Wight 011C","E01017296",555,147,85,62,359,98,175,94,41,40,47,30,16,1,36,19,17,3,3,49,17,32
"2021","Isle of Wight 011D","E01017321",604,175,100,75,398,108,182,76,72,34,65,29,31,5,39,23,16,4,4,31,16,15
"2021","Isle of Wight 011E","E01017322",603,201,77,124,367,37,153,49,69,35,83,34,41,8,91,58,33,3,3,35,20,15
"2021","Isle of Wight 011F","E01017327",693,220,108,112,440,83,177,74,65,38,95,54,37,4,85,56,29,0,0,33,10,23
"2021","Isle of Wight 012A","E01017312",887,320,191,129,534,140,205,94,70,41,79,46,28,5,109,74,35,1,1,33,8,25
"2021","Isle of Wight 012D","E01017315",722,263,157,106,439,110,168,82,51,35,71,30,32,9,88,52,36,2,2,20,9,11
"2021","Isle of Wight 012E","E01017354",577,247,173,74,310,107,113,56,34,23,40,28,9,3,47,24,23,3,3,20,8,12
"2021","Isle of Wight 012F","E01017361",674,228,145,83,414,166,164,101,45,18,42,27,14,1,40,23,17,2,2,32,15,17
"2021","Isle of Wight 012G","E01017362",724,261,127,134,429,113,180,110,41,29,66,40,23,3,66,37,29,4,4,34,18,16
"2021","Isle of Wight 012H","E01033239",1190,410,283,127,730,302,298,182,56,60,69,48,18,3,60,22,38,1,1,50,15,35
"2021","Isle of Wight 013A","E01017290",548,153,76,77,359,96,186,98,46,42,54,43,9,2,20,9,11,3,3,36,15,21
"2021","Isle of Wight 013B","E01017291",578,160,107,53,395,149,179,112,42,25,34,21,11,2,33,18,15,0,0,23,6,17
"2021","Isle of Wight 013C","E01017294",693,204,103,101,455,94,237,94,85,58,62,32,25,5,59,27,32,3,3,34,19,15
"2021","Isle of Wight 013D","E01017353",579,155,99,56,388,121,181,106,42,33,55,37,16,2,29,15,14,2,2,36,20,16
"2021","Isle of Wight 014A","E01017289",979,260,146,114,653,162,286,150,78,58,82,42,33,7,123,80,43,0,0,66,19,47
"2021","Isle of Wight 014B","E01017347",809,283,166,117,486,113,202,92,68,42,86,35,42,9,82,55,27,3,3,40,12,28
"2021","Isle of Wight 014C","E01017348",601,209,93,116,333,65,148,63,53,32,66,38,25,3,53,31,22,1,1,59,20,39
"2021","Isle of Wight 014D","E01017349",1025,447,211,236,509,95,204,95,68,41,110,63,38,9,98,70,28,2,2,69,25,44
"2021","Isle of Wight 014E","E01017350",817,267,112,155,508,93,211,90,82,39,78,36,38,4,123,71,52,3,3,42,20,22
"2021","Isle of Wight 015A","E01017317",667,203,119,84,432,98,200,96,62,42,63,33,29,1,70,37,33,1,1,32,15,17
"2021","Isle of Wight 015B","E01017320",568,206,153,53,348,139,136,75,30,31,44,32,9,3,27,11,16,2,2,14,6,8
"2021","Isle of Wight 015C","E01017323",524,118,79,39,379,116,192,98,48,46,44,28,12,4,27,13,14,0,0,27,13,14
"2021","Isle of Wight 015D","E01017324",649,180,105,75,435,115,219,101,66,52,51,27,22,2,50,29,21,0,0,34,17,17
"2021","Isle of Wight 015E","E01017355",711,213,110,103,465,124,218,93,79,46,71,41,26,4,52,33,19,0,0,33,13,20
"2021","Isle of Wight 015F","E01017358",601,184,131,53,382,138,159,77,35,47,36,18,16,2,45,18,27,4,4,35,14,21
"2021","Isle of Wight 016A","E01017318",526,171,78,93,328,51,146,60,51,35,60,25,29,6,70,46,24,1,1,27,13,14
"2021","Isle of Wight 016B","E01017319",676,338,232,106,308,97,132,63,44,25,40,22,17,1,39,23,16,0,0,30,10,20
"2021","Isle of Wight 016C","E01017356",741,337,146,191,353,75,142,70,40,32,51,31,16,4,82,50,32,3,3,51,23,28
"2021","Isle of Wight 016D","E01017357",655,227,128,99,387,94,185,87,66,32,48,22,22,4,57,35,22,3,3,41,12,29
"2021","Isle of Wight 016E","E01017359",729,258,147,111,434,141,193,113,48,32,66,45,17,4,34,21,13,0,0,37,10,27
"2021","Isle of Wight 016F","E01017360",891,428,187,241,426,81,154,80,44,30,84,55,27,2,105,73,32,2,2,37,10,27
"2021","Isle of Wight 017A","E01017297",639,159,98,61,452,115,234,118,75,41,67,29,26,12,36,22,14,0,0,28,13,15
"2021","Isle of Wight 017B","E01017298",703,222,146,76,443,123,240,132,63,45,46,29,14,3,33,12,21,1,1,38,20,18
"2021","Isle of Wight 017C","E01017299",577,198,105,93,338,102,150,81,44,25,46,22,22,2,38,23,15,2,2,41,17,24
"2021","Isle of Wight 017D","E01017369",671,204,132,72,430,116,195,90,66,39,63,31,28,4,54,26,28,2,2,37,19,18
"2021","Isle of Wight 018A","E01017363",789,408,167,241,351,70,127,74,29,24,73,43,27,3,80,52,28,1,1,30,3,27
"2021","Isle of Wight 018B","E01017364",697,310,143,167,352,107,141,82,34,25,56,32,19,5,47,22,25,1,1,35,9,26
"2021","Isle of Wight 018C","E01017365",698,261,166,95,413,154,172,104,37,31,54,28,19,7,31,16,15,2,2,24,10,14
"2021","Isle of Wight 018D","E01017366",641,197,96,101,413,74,158,73,56,29,64,27,34,3,117,72,45,0,0,31,12,19
"2021","Isle of Wight 018E","E01017370",794,245,170,75,520,128,252,122,75,55,61,29,22,10,77,36,41,2,2,29,12,17
"2021","Buckinghamshire 001A","E01017648",676,153,75,78,499,105,308,109,132,67,58,34,24,0,27,18,9,1,1,24,7,17
"2021","Buckinghamshire 001B","E01017649",1039,287,144,143,699,96,336,112,175,49,129,78,46,5,133,81,52,5,5,53,17,36
"2021","Buckinghamshire 001C","E01033951",413,102,41,61,290,56,170,75,72,23,44,26,16,2,18,10,8,2,2,21,8,13
"2021","Buckinghamshire 001D","E01033952",550,143,67,76,378,74,222,90,88,44,44,21,19,4,36,22,14,2,2,29,16,13
"2021","Buckinghamshire 001E","E01033953",592,104,11,93,476,15,266,48,201,17,91,34,51,6,100,84,16,4,4,12,7,5
"2021","Buckinghamshire 001F","E01033954",656,131,79,52,495,63,308,90,158,60,71,34,32,5,50,36,14,3,3,30,15,15
"2021","Buckinghamshire 002A","E01017644",650,193,79,114,443,49,221,81,106,34,108,66,32,10,60,41,19,5,5,14,9,5
"2021","Buckinghamshire 002B","E01017645",682,313,73,240,324,27,113,43,51,19,80,53,24,3,89,59,30,15,15,45,7,38
"2021","Buckinghamshire 002C","E01017646",993,296,149,147,659,111,285,89,157,39,122,54,60,8,135,86,49,6,6,38,10,28
"2021","Buckinghamshire 002D","E01017647",622,120,94,26,476,135,259,68,121,70,34,18,14,2,46,19,27,2,2,26,12,14
"2021","Buckinghamshire 003A","E01017671",640,141,71,70,468,77,301,109,144,48,58,30,22,6,32,18,14,0,0,31,15,16
"2021","Buckinghamshire 003B","E01017672",647,121,63,58,492,99,279,106,119,54,78,57,19,2,36,22,14,0,0,34,9,25
"2021","Buckinghamshire 003C","E01017695",526,132,100,32,371,92,195,88,69,38,42,20,20,2,41,18,23,1,1,23,7,16
"2021","Buckinghamshire 003D","E01017696",555,114,63,51,417,78,236,82,117,37,67,37,25,5,35,15,20,1,1,24,7,17
"2021","Buckinghamshire 004A","E01017693",468,112,55,57,333,55,187,75,79,33,53,28,22,3,36,26,10,2,2,23,10,13
"2021","Buckinghamshire 004B","E01017694",944,186,84,102,705,100,419,148,215,56,112,57,49,6,73,48,25,1,1,53,21,32
"2021","Buckinghamshire 004C","E01017713",607,155,71,84,425,66,214,90,83,41,84,45,32,7,56,35,21,5,5,27,13,14
"2021","Buckinghamshire 004D","E01017714",653,113,62,51,508,101,290,105,148,37,68,36,28,4,48,33,15,1,1,32,11,21
"2021","Buckinghamshire 004E","E01017717",751,207,95,112,515,87,293,112,124,57,70,44,24,2,62,36,26,3,3,29,9,20
"2021","Buckinghamshire 004F","E01017718",754,170,76,94,539,91,302,109,149,44,84,42,37,5,62,33,29,0,0,45,24,21
"2021","Buckinghamshire 005A","E01017735",590,138,71,67,424,73,242,91,95,56,68,43,22,3,37,14,23,4,4,28,10,18
"2021","Buckinghamshire 005B","E01017736",683,225,129,96,429,80,213,90,84,39,63,31,29,3,69,46,23,4,4,29,10,19
"2021","Buckinghamshire 005C","E01017737",591,163,104,59,405,122,201,90,71,40,49,30,17,2,31,17,14,2,2,23,9,14
"2021","Buckinghamshire 005D","E01017738",1059,311,126,185,719,82,347,142,161,44,168,96,65,7,120,92,28,2,2,29,13,16
"2021","Buckinghamshire 006A","E01017669",948,167,71,96,725,98,395,143,196,56,118,61,47,10,111,63,48,3,3,56,29,27
"2021","Buckinghamshire 006B","E01017670",756,155,77,78,560,95,328,137,135,56,95,59,31,5,40,20,20,2,2,41,16,25
"2021","Buckinghamshire 006C","E01017715",504,114,58,56,373,84,207,79,85,43,51,35,14,2,29,10,19,2,2,17,7,10
"2021","Buckinghamshire 006D","E01017716",749,158,104,54,554,109,315,114,150,51,77,36,37,4,52,27,25,1,1,37,11,26
"2021","Buckinghamshire 007A","E01017731",591,190,115,75,386,61,181,55,83,43,71,30,38,3,72,41,31,1,1,15,1,14
"2021","Buckinghamshire 007B","E01017732",659,152,66,86,484,78,258,86,123,49,86,47,33,6,61,38,23,1,1,23,9,14
"2021","Buckinghamshire 007C","E01017733",546,128,76,52,398,76,220,87,93,40,59,31,23,5,42,24,18,1,1,20,10,10
"2021","Buckinghamshire 007D","E01017734",645,138,67,71,483,98,272,105,120,47,74,48,23,3,38,23,15,1,1,24,7,17
"2021","Buckinghamshire 007E","E01033955",552,102,49,53,423,52,215,71,109,35,120,78,37,5,35,29,6,1,1,27,11,16
"2021","Buckinghamshire 007F","E01033956",619,113,64,49,478,44,269,80,156,33,91,43,45,3,70,54,16,4,4,28,11,17
"2021","Buckinghamshire 007G","E01033957",402,61,8,53,314,14,171,49,110,12,81,39,38,4,46,38,8,2,2,27,14,13
"2021","Buckinghamshire 009A","E01017703",543,138,82,56,381,81,215,79,96,40,46,24,21,1,39,25,14,0,0,24,7,17
"2021","Buckinghamshire 009B","E01017704",507,83,50,33,400,84,244,96,105,43,48,26,19,3,22,8,14,2,2,24,13,11
"2021","Buckinghamshire 009C","E01017719",510,143,78,65,341,50,177,48,94,35,52,23,25,4,58,37,21,4,4,26,14,12
"2021","Buckinghamshire 009D","E01017720",525,124,55,69,362,48,201,68,103,30,64,38,23,3,48,29,19,1,1,39,11,28
"2021","Buckinghamshire 009E","E01032958",650,152,81,71,476,96,249,109,91,49,87,51,31,5,41,22,19,3,3,22,9,13
"2021","Buckinghamshire 009F","E01033958",529,89,21,68,397,14,238,48,170,20,72,39,27,6,64,56,8,9,9,43,20,23
"2021","Buckinghamshire 009G","E01033959",548,107,16,91,395,8,187,51,124,12,63,35,25,3,117,104,13,20,20,46,23,23
"2021","Buckinghamshire 008A","E01017651",639,128,78,50,487,103,281,102,135,44,65,35,24,6,37,21,16,1,1,24,11,13
"2021","Buckinghamshire 008B","E01017652",703,161,76,85,515,77,285,111,126,48,95,67,25,3,56,27,29,2,2,27,9,18
"2021","Buckinghamshire 008C","E01017657",663,160,112,48,480,114,250,90,108,52,65,35,25,5,50,28,22,1,1,23,12,11
"2021","Buckinghamshire 008D","E01017658",670,147,71,76,489,75,291,112,132,47,77,48,25,4,45,25,20,1,1,34,15,19
"2021","Buckinghamshire 008E","E01017701",1037,177,80,97,828,113,504,129,315,60,108,46,53,9,102,71,31,1,1,32,15,17
"2021","Buckinghamshire 008F","E01017702",660,185,106,79,452,83,235,91,99,45,78,41,31,6,50,28,22,6,6,23,10,13
"2021","Buckinghamshire 010A","E01017642",554,153,84,69,376,85,205,65,107,33,47,33,11,3,39,23,16,0,0,25,10,15
"2021","Buckinghamshire 010B","E01017643",592,137,69,68,429,81,251,107,119,25,68,36,31,1,28,16,12,1,1,26,9,17
"2021","Buckinghamshire 010C","E01017673",537,109,60,49,400,65,243,80,117,46,54,29,22,3,37,16,21,1,1,28,13,15
"2021","Buckinghamshire 010D","E01017674",562,140,43,97,390,46,230,83,97,50,75,35,33,7,38,19,19,1,1,32,15,17
"2021","Buckinghamshire 012A","E01017659",621,180,86,94,375,43,193,42,103,48,58,23,26,9,70,38,32,11,11,66,36,30
"2021","Buckinghamshire 012B","E01017660",757,289,66,223,447,28,223,96,96,31,121,77,41,3,73,47,26,2,2,21,7,14
"2021","Buckinghamshire 012C","E01017661",632,213,76,137,373,26,200,54,101,45,69,40,24,5,73,45,28,5,5,46,26,20
"2021","Buckinghamshire 012D","E01017664",622,196,51,145,399,43,231,104,91,36,79,51,26,2,43,21,22,3,3,27,13,14
"2021","Buckinghamshire 011A","E01017706",504,96,42,54,367,15,218,71,106,41,50,22,22,6,80,44,36,4,4,41,21,20
"2021","Buckinghamshire 011B","E01017707",466,112,27,85,311,10,172,42,100,30,43,23,14,6,78,43,35,8,8,43,20,23
"2021","Buckinghamshire 011C","E01017708",589,174,55,119,353,27,165,37,91,37,68,27,35,6,85,54,31,8,8,62,34,28
"2021","Buckinghamshire 011D","E01033960",596,58,7,51,503,3,311,73,223,15,134,87,46,1,52,46,6,3,3,35,23,12
"2021","Buckinghamshire 011E","E01033961",591,71,4,67,485,5,295,56,224,15,119,66,49,4,65,56,9,1,1,35,20,15
"2021","Buckinghamshire 011F","E01033962",568,87,7,80,439,10,235,46,174,15,75,26,47,2,113,91,22,6,6,42,25,17
"2021","Buckinghamshire 011G","E01033963",560,91,4,87,442,8,239,55,171,13,111,51,57,3,81,72,9,3,3,27,18,9
"2021","Buckinghamshire 011H","E01033964",566,103,13,90,429,6,208,41,147,20,105,63,42,0,106,86,20,4,4,34,16,18
"2021","Buckinghamshire 011I","E01033967",584,122,44,78,431,42,240,94,110,36,97,61,32,4,49,31,18,3,3,31,8,23
"2021","Buckinghamshire 013A","E01017665",1057,312,60,252,658,25,294,60,198,36,157,88,63,6,173,116,57,9,9,87,39,48
"2021","Buckinghamshire 013B","E01017666",959,356,132,224,533,33,283,80,171,32,117,76,38,3,92,68,24,8,8,70,30,40
"2021","Buckinghamshire 013C","E01017667",531,120,59,61,380,22,186,44,118,24,52,19,27,6,110,74,36,10,10,31,14,17
"2021","Buckinghamshire 013D","E01017668",639,149,69,80,444,35,226,66,114,46,87,53,27,7,81,51,30,15,15,46,28,18
"2021","Buckinghamshire 014A","E01017697",613,202,61,141,391,47,189,61,99,29,93,66,24,3,55,35,20,7,7,20,10,10
"2021","Buckinghamshire 014B","E01017698",531,144,57,87,350,28,191,46,112,33,57,26,27,4,69,38,31,5,5,37,15,22
"2021","Buckinghamshire 014C","E01017699",635,206,46,160,394,9,164,44,100,20,111,56,52,3,104,84,20,6,6,35,13,22
"2021","Buckinghamshire 014D","E01017700",645,137,96,41,486,111,268,72,136,60,66,35,29,2,34,14,20,7,7,22,9,13
"2021","Buckinghamshire 015A","E01017634",734,272,42,230,405,9,200,71,108,21,110,82,23,5,70,40,30,16,16,57,23,34
"2021","Buckinghamshire 015B","E01017662",574,163,58,105,346,29,159,54,75,30,64,35,26,3,91,64,27,3,3,65,31,34
"2021","Buckinghamshire 015C","E01017663",617,205,84,121,322,23,165,37,93,35,57,36,21,0,64,39,25,13,13,90,50,40
"2021","Buckinghamshire 015D","E01032955",791,439,176,263,318,47,138,56,65,17,82,55,27,0,44,35,9,7,7,34,8,26
"2021","Buckinghamshire 015E","E01032961",788,387,73,314,367,24,166,66,89,11,107,80,24,3,58,39,19,12,12,34,7,27
"2021","Buckinghamshire 016A","E01017653",603,161,64,97,401,44,207,72,104,31,93,60,32,1,54,22,32,3,3,41,18,23
"2021","Buckinghamshire 016B","E01017654",651,214,35,179,367,16,201,47,123,31,70,40,25,5,65,35,30,15,15,70,28,42
"2021","Buckinghamshire 016C","E01017655",815,258,78,180,528,49,278,93,145,40,124,88,32,4,74,47,27,3,3,29,12,17
"2021","Buckinghamshire 016D","E01032956",678,171,40,131,491,31,278,96,164,18,125,80,40,5,53,41,12,4,4,16,8,8
"2021","Buckinghamshire 016E","E01032957",590,192,34,158,372,23,169,53,107,9,116,86,29,1,56,35,21,8,8,26,9,17
"2021","Buckinghamshire 016F","E01032962",654,194,59,135,433,39,240,74,140,26,102,64,37,1,46,33,13,6,6,27,8,19
"2021","Buckinghamshire 018A","E01017635",624,201,112,89,395,83,200,53,114,33,63,25,34,4,46,28,18,3,3,28,14,14
"2021","Buckinghamshire 018B","E01017636",629,158,108,50,444,87,247,60,138,49,54,17,31,6,55,20,35,1,1,27,8,19
"2021","Buckinghamshire 018C","E01017637",486,108,48,60,344,34,211,59,101,51,55,35,17,3,43,25,18,1,1,34,17,17
"2021","Buckinghamshire 018D","E01017638",507,124,94,30,354,80,215,64,104,47,31,14,14,3,27,15,12,1,1,29,17,12
"2021","Buckinghamshire 018E","E01017639",606,120,85,35,467,120,272,82,131,59,44,27,14,3,27,15,12,4,4,19,4,15
"2021","Buckinghamshire 018F","E01017640",640,148,107,41,459,97,262,71,134,57,53,18,32,3,46,25,21,1,1,33,15,18
"2021","Buckinghamshire 017A","E01017709",572,146,84,62,363,23,186,44,106,36,59,17,31,11,86,52,34,9,9,63,29,34
"2021","Buckinghamshire 017B","E01017710",547,106,42,64,381,26,213,40,132,41,56,29,18,9,82,36,46,4,4,60,30,30
"2021","Buckinghamshire 017C","E01017711",653,208,82,126,390,25,196,46,119,31,77,34,36,7,82,47,35,10,10,55,23,32
"2021","Buckinghamshire 017D","E01017712",919,292,64,228,535,29,264,66,156,42,115,66,43,6,109,70,39,18,18,92,44,48
"2021","Buckinghamshire 019A","E01017687",1054,336,71,265,645,34,331,72,219,40,124,55,60,9,149,100,49,7,7,73,27,46
"2021","Buckinghamshire 019B","E01017688",511,168,50,118,311,24,156,65,76,15,78,49,28,1,51,32,19,2,2,32,15,17
"2021","Buckinghamshire 019C","E01017689",552,145,70,75,383,58,219,75,106,38,64,36,26,2,40,20,20,2,2,24,8,16
"2021","Buckinghamshire 019D","E01017690",483,131,60,71,320,61,170,66,80,24,41,20,16,5,46,23,23,2,2,32,8,24
"2021","Buckinghamshire 019E","E01017691",533,108,45,63,408,61,252,96,108,48,55,30,19,6,38,23,15,2,2,17,7,10
"2021","Buckinghamshire 019F","E01017692",679,232,69,163,396,56,199,61,88,50,85,57,22,6,53,34,19,3,3,51,19,32
"2021","Buckinghamshire 020A","E01017721",803,313,76,237,463,29,228,93,109,26,124,72,48,4,74,47,27,8,8,27,13,14
"2021","Buckinghamshire 020B","E01017722",636,192,63,129,419,37,215,86,84,45,97,49,41,7,64,36,28,6,6,25,8,17
"2021","Buckinghamshire 020C","E01017723",500,141,47,94,314,13,168,44,97,27,41,12,21,8,88,44,44,4,4,45,23,22
"2021","Buckinghamshire 020D","E01017724",519,127,40,87,344,23,184,32,113,39,47,17,25,5,87,52,35,3,3,48,27,21
"2021","Buckinghamshire 021A","E01017627",756,219,95,124,515,80,275,88,152,35,83,46,34,3,72,41,31,5,5,22,9,13
"2021","Buckinghamshire 021B","E01017628",665,119,65,54,518,105,301,91,145,65,70,35,30,5,39,23,16,3,3,28,10,18
"2021","Buckinghamshire 021C","E01017629",719,171,82,89,512,128,305,107,137,61,38,21,13,4,40,24,16,1,1,36,13,23
"2021","Buckinghamshire 021D","E01017630",649,145,93,52,470,125,247,89,117,41,57,32,19,6,38,19,19,3,3,34,13,21
"2021","Buckinghamshire 021E","E01017631",921,191,94,97,682,93,353,106,187,60,149,77,65,7,84,56,28,3,3,48,28,20
"2021","Buckinghamshire 021F","E01033965",610,111,47,64,489,85,256,84,134,38,89,54,30,5,59,46,13,0,0,10,2,8
"2021","Buckinghamshire 021G","E01033966",597,104,38,66,464,38,266,73,157,36,95,40,47,8,63,48,15,2,2,29,9,20
"2021","Buckinghamshire 022A","E01017675",766,197,98,99,549,112,299,90,176,33,82,55,26,1,54,41,13,2,2,20,3,17
"2021","Buckinghamshire 022B","E01017676",603,117,79,38,454,133,250,89,117,44,37,25,9,3,33,15,18,1,1,32,9,23
"2021","Buckinghamshire 022C","E01017677",837,208,124,84,606,123,320,134,160,26,94,53,40,1,65,48,17,4,4,23,12,11
"2021","Buckinghamshire 022D","E01017678",576,141,79,62,399,73,236,96,102,38,62,34,22,6,27,12,15,1,1,36,14,22
"2021","Buckinghamshire 022E","E01017679",624,141,70,71,453,70,269,89,139,41,56,33,21,2,57,31,26,1,1,30,9,21
"2021","Buckinghamshire 022F","E01017680",544,183,104,79,342,56,171,47,93,31,58,32,22,4,54,35,19,3,3,19,5,14
"2021","Buckinghamshire 023A","E01017681",582,159,104,55,404,80,215,87,103,25,60,32,21,7,47,27,20,2,2,19,8,11
"2021","Buckinghamshire 023B","E01017682",505,122,71,51,369,72,235,70,132,33,36,21,11,4,25,20,5,1,1,14,6,8
"2021","Buckinghamshire 023C","E01017683",714,123,65,58,559,110,342,117,151,74,60,33,24,3,47,28,19,0,0,32,11,21
"2021","Buckinghamshire 023D","E01017684",481,112,75,37,346,90,181,63,89,29,40,25,14,1,35,14,21,0,0,23,9,14
"2021","Buckinghamshire 024A","E01017726",571,229,151,78,314,97,156,63,70,23,35,25,9,1,24,13,11,2,2,28,10,18
"2021","Buckinghamshire 024B","E01017727",716,165,110,55,476,110,289,69,170,50,45,21,17,7,31,15,16,1,1,75,10,65
"2021","Buckinghamshire 024C","E01017729",673,174,100,74,485,90,281,85,145,51,68,36,26,6,44,25,19,2,2,14,6,8
"2021","Buckinghamshire 024D","E01017730",739,302,162,140,416,76,212,67,117,28,68,30,31,7,58,33,25,2,2,21,10,11
"2021","Buckinghamshire 024E","E01033968",475,93,39,54,369,29,250,61,159,30,57,42,15,0,32,25,7,1,1,13,12,1
"2021","Buckinghamshire 024F","E01033969",591,132,18,114,444,18,240,53,172,15,94,62,31,1,87,72,15,5,5,15,8,7
"2021","Buckinghamshire 029A","E01017750",906,205,117,88,650,126,394,128,186,80,69,42,21,6,59,30,29,2,2,51,25,26
"2021","Buckinghamshire 029B","E01017752",905,206,114,92,653,125,418,136,204,78,55,27,23,5,49,23,26,6,6,46,14,32
"2021","Buckinghamshire 029C","E01017766",933,189,113,76,698,161,415,154,174,87,76,47,27,2,46,18,28,0,0,46,22,24
"2021","Buckinghamshire 029D","E01017778",506,105,69,36,386,90,223,65,114,44,33,16,15,2,37,23,14,3,3,15,9,6
"2021","Buckinghamshire 027A","E01017747",539,121,58,63,367,46,221,60,124,37,59,28,27,4,38,24,14,3,3,51,33,18
"2021","Buckinghamshire 027B","E01017748",800,281,103,178,483,48,238,70,118,50,83,44,36,3,110,65,45,4,4,36,19,17
"2021","Buckinghamshire 027C","E01017749",735,160,89,71,548,116,309,88,170,51,74,38,29,7,46,24,22,3,3,27,14,13
"2021","Buckinghamshire 027D","E01017789",535,143,79,64,344,38,172,56,85,31,49,26,18,5,82,51,31,3,3,48,15,33
"2021","Buckinghamshire 027E","E01017790",522,96,57,39,383,37,198,52,110,36,61,22,30,9,84,56,28,3,3,43,27,16
"2021","Buckinghamshire 027F","E01017795",862,217,86,131,586,73,306,82,174,50,97,41,48,8,101,67,34,9,9,59,38,21
"2021","Buckinghamshire 028A","E01017769",643,151,62,89,462,77,281,88,142,51,65,41,19,5,36,17,19,3,3,30,14,16
"2021","Buckinghamshire 028B","E01017771",633,190,121,69,416,99,228,63,120,45,48,20,22,6,41,15,26,0,0,27,8,19
"2021","Buckinghamshire 028C","E01017780",554,116,59,57,408,53,244,65,136,43,67,34,30,3,41,25,16,3,3,30,7,23
"2021","Buckinghamshire 028D","E01017781",476,142,31,111,284,16,145,40,95,10,56,32,24,0,63,43,20,4,4,50,32,18
"2021","Buckinghamshire 030A","E01017770",751,267,129,138,438,29,203,63,113,27,127,87,32,8,71,47,24,8,8,46,24,22
"2021","Buckinghamshire 030B","E01017791",624,194,79,115,401,26,218,63,116,39,73,42,26,5,82,47,35,2,2,29,14,15
"2021","Buckinghamshire 030C","E01017792",1132,494,179,315,595,69,257,101,130,26,150,102,46,2,105,80,25,14,14,43,16,27
"2021","Buckinghamshire 030D","E01017793",605,163,79,84,407,68,189,70,85,34,64,30,27,7,82,40,42,4,4,35,15,20
"2021","Buckinghamshire 031A","E01017768",1013,337,182,155,637,128,351,111,184,56,81,43,36,2,74,47,27,3,3,39,14,25
"2021","Buckinghamshire 031B","E01017779",416,70,45,25,333,68,220,58,123,39,19,8,7,4,26,17,9,0,0,13,6,7
"2021","Buckinghamshire 031C","E01017785",658,140,84,56,495,121,292,98,125,69,44,24,16,4,35,12,23,3,3,23,4,19
"2021","Buckinghamshire 031D","E01017786",628,150,93,57,461,95,257,72,134,51,58,32,25,1,46,28,18,5,5,17,10,7
"2021","Buckinghamshire 031E","E01017787",634,129,92,37,480,142,268,70,142,56,36,21,13,2,33,22,11,1,1,25,6,19
"2021","Buckinghamshire 031F","E01017788",761,275,154,121,457,75,184,53,104,27,89,40,42,7,107,66,41,2,2,29,13,16
"2021","Buckinghamshire 032A","E01017741",666,193,106,87,441,61,265,60,176,29,58,27,28,3,47,30,17,10,10,32,13,19
"2021","Buckinghamshire 032B","E01017742",789,253,135,118,512,101,297,92,167,38,60,46,12,2,52,29,23,2,2,24,7,17
"2021","Buckinghamshire 032C","E01017743",735,152,73,79,552,32,291,70,182,39,85,40,42,3,131,76,55,13,13,31,12,19
"2021","Buckinghamshire 032D","E01017763",802,266,165,101,512,84,279,75,165,39,74,55,18,1,52,29,23,23,23,24,8,16
"2021","Buckinghamshire 032E","E01017764",611,108,74,34,473,105,321,85,179,57,20,8,7,5,23,15,8,4,4,30,13,17
"2021","Buckinghamshire 032F","E01017765",621,95,74,21,501,128,328,80,187,61,26,11,13,2,19,11,8,0,0,25,11,14
"2021","Buckinghamshire 034A","E01017739",493,90,61,29,388,83,240,57,139,44,30,16,10,4,31,15,16,4,4,15,8,7
"2021","Buckinghamshire 034B","E01017740",561,126,51,75,411,52,266,55,176,35,54,28,24,2,38,21,17,1,1,24,10,14
"2021","Buckinghamshire 034C","E01017744",615,166,99,67,420,71,255,69,130,56,49,24,21,4,43,27,16,2,2,29,12,17
"2021","Buckinghamshire 034D","E01017745",818,316,157,159,479,94,248,75,132,41,75,56,15,4,58,34,24,4,4,23,7,16
"2021","Buckinghamshire 034E","E01017746",606,129,60,69,458,62,288,57,189,42,59,34,25,0,47,22,25,2,2,19,8,11
"2021","Buckinghamshire 035A","E01017762",512,72,48,24,410,98,275,84,132,59,19,6,11,2,18,5,13,0,0,30,18,12
"2021","Buckinghamshire 035B","E01017775",730,228,119,109,481,75,270,75,148,47,71,44,23,4,60,43,17,5,5,21,6,15
"2021","Buckinghamshire 035C","E01017776",890,209,75,134,636,66,346,77,225,44,79,49,27,3,137,109,28,8,8,45,25,20
"2021","Buckinghamshire 035D","E01017777",670,120,91,29,532,108,356,74,233,49,23,14,8,1,40,22,18,5,5,18,10,8
"2021","Buckinghamshire 047A","E01017759",779,242,133,109,510,87,290,89,155,46,69,38,26,5,61,34,27,3,3,27,17,10
"2021","Buckinghamshire 047B","E01017760",651,117,96,21,498,134,305,104,143,58,33,18,10,5,24,16,8,2,2,36,24,12
"2021","Buckinghamshire 047C","E01017761",856,205,138,67,614,100,367,108,201,58,71,37,30,4,75,51,24,1,1,37,18,19
"2021","Buckinghamshire 047D","E01017794",892,187,123,64,672,106,435,124,239,72,74,30,35,9,55,37,18,2,2,33,14,19
"2021","Buckinghamshire 050A","E01017754",545,102,72,30,414,77,252,73,130,49,31,14,15,2,50,21,29,4,4,29,11,18
"2021","Buckinghamshire 050B","E01017755",887,305,141,164,544,75,257,77,143,37,101,69,29,3,108,78,30,3,3,38,18,20
"2021","Buckinghamshire 050C","E01017756",582,100,74,26,457,120,259,83,125,51,34,16,15,3,41,16,25,3,3,25,12,13
"2021","Buckinghamshire 050D","E01017757",480,108,70,38,357,63,221,76,104,41,35,14,19,2,38,20,18,0,0,15,7,8
"2021","Buckinghamshire 050E","E01017758",500,133,110,23,324,80,197,50,101,46,19,9,10,0,28,16,12,0,0,43,13,30
"2021","Buckinghamshire 054A","E01017751",792,149,116,33,612,122,422,104,226,92,28,13,14,1,40,19,21,0,0,31,13,18
"2021","Buckinghamshire 054B","E01017753",513,137,85,52,354,41,202,57,112,33,52,18,30,4,57,29,28,2,2,22,14,8
"2021","Buckinghamshire 054C","E01017767",912,225,117,108,646,88,374,86,205,83,74,34,36,4,106,62,44,4,4,41,24,17
"2021","Buckinghamshire 053A","E01017796",808,293,148,145,459,66,235,61,136,38,78,58,15,5,72,43,29,8,8,56,14,42
"2021","Buckinghamshire 053B","E01017797",525,106,62,44,388,92,249,65,140,44,22,12,10,0,25,14,11,0,0,31,17,14
"2021","Buckinghamshire 053C","E01017798",728,172,125,47,515,149,307,77,179,51,19,13,5,1,40,20,20,0,0,41,13,28
"2021","Buckinghamshire 053D","E01017799",880,258,129,129,597,77,356,80,223,53,88,55,25,8,70,42,28,6,6,25,10,15
"2021","Buckinghamshire 053E","E01017800",683,206,90,116,424,40,234,64,149,21,75,40,31,4,73,56,17,2,2,53,16,37
"2021","Buckinghamshire 053F","E01017801",612,107,67,40,475,74,313,74,180,59,48,27,17,4,40,25,15,0,0,30,15,15
"2021","Buckinghamshire 053G","E01017802",650,160,84,76,453,71,229,56,133,40,58,27,22,9,88,54,34,7,7,37,15,22
"2021","Buckinghamshire 058A","E01017818",731,149,71,78,515,65,322,80,182,60,60,27,25,8,64,46,18,4,4,67,32,35
"2021","Buckinghamshire 058B","E01017819",585,107,71,36,429,96,283,72,152,59,26,13,12,1,21,11,10,3,3,49,33,16
"2021","Buckinghamshire 058C","E01017820",818,313,152,161,466,118,223,70,115,38,62,52,10,0,52,38,14,11,11,39,12,27
"2021","Buckinghamshire 058D","E01017821",582,131,64,67,395,83,258,64,131,63,22,13,9,0,31,22,9,1,1,56,24,32
"2021","Buckinghamshire 058E","E01017822",647,75,52,23,487,95,345,64,199,82,24,11,11,2,22,12,10,1,1,85,61,24
"2021","Buckinghamshire 059A","E01017810",1156,491,275,216,600,104,233,85,110,38,116,53,54,9,140,97,43,7,7,65,25,40
"2021","Buckinghamshire 059B","E01017811",504,162,101,61,303,66,160,55,60,45,44,22,18,4,31,10,21,2,2,39,22,17
"2021","Buckinghamshire 059C","E01017812",739,175,65,110,491,50,261,77,141,43,75,42,27,6,94,46,48,11,11,73,40,33
"2021","Buckinghamshire 059D","E01017813",820,225,104,121,522,84,322,110,117,95,72,39,27,6,43,17,26,1,1,73,34,39
"2021","Buckinghamshire 063A","E01017815",714,145,73,72,520,108,314,106,153,55,46,16,24,6,50,25,25,2,2,49,24,25
"2021","Buckinghamshire 063B","E01017816",771,274,151,123,456,82,244,77,130,37,58,27,26,5,64,39,25,8,8,41,14,27
"2021","Buckinghamshire 063C","E01017817",757,164,91,73,532,93,320,76,177,67,57,27,21,9,58,35,23,4,4,61,29,32
"2021","Buckinghamshire 063D","E01017823",574,139,78,61,387,53,232,80,107,45,48,20,25,3,54,39,15,0,0,48,19,29
"2021","Buckinghamshire 064A","E01017830",798,209,98,111,528,82,277,80,150,47,59,25,29,5,105,60,45,5,5,61,28,33
"2021","Buckinghamshire 064B","E01017831",651,154,81,73,446,83,263,82,119,62,48,20,20,8,50,22,28,2,2,51,26,25
"2021","Buckinghamshire 064C","E01017832",649,136,59,77,422,63,275,82,125,68,41,27,10,4,42,18,24,1,1,91,46,45
"2021","Buckinghamshire 064D","E01017834",585,154,57,97,352,61,211,65,103,43,32,12,14,6,46,22,24,2,2,79,43,36
"2021","Buckinghamshire 064E","E01017835",746,267,150,117,438,89,228,95,85,48,63,34,26,3,54,28,26,4,4,41,14,27
"2021","Buckinghamshire 065A","E01017803",534,108,61,47,361,77,213,83,94,36,37,25,7,5,31,13,18,3,3,65,11,54
"2021","Buckinghamshire 065B","E01017806",663,116,70,46,508,111,308,81,153,74,44,24,15,5,44,17,27,1,1,39,18,21
"2021","Buckinghamshire 065C","E01017814",624,129,83,46,424,71,254,66,138,50,50,31,18,1,49,24,25,0,0,71,30,41
"2021","Buckinghamshire 065D","E01017833",1138,371,165,206,718,149,337,148,146,43,154,114,37,3,74,47,27,4,4,49,13,36
"2021","Buckinghamshire 066A","E01017804",741,259,148,111,443,69,242,65,106,71,66,44,17,5,63,35,28,3,3,39,16,23
"2021","Buckinghamshire 066B","E01017805",818,248,88,160,530,47,242,71,121,50,93,46,36,11,141,80,61,7,7,40,14,26
"2021","Buckinghamshire 066C","E01017807",616,156,68,88,423,56,280,67,161,52,47,26,18,3,39,22,17,1,1,37,21,16
"2021","Buckinghamshire 066D","E01017808",689,204,91,113,459,95,229,58,131,40,64,32,27,5,65,36,29,6,6,26,14,12
"2021","Buckinghamshire 066E","E01017809",601,145,53,92,421,34,245,50,155,40,70,34,30,6,69,37,32,3,3,35,11,24
"2021","Buckinghamshire 067A","E01017824",675,184,99,85,437,65,248,73,118,57,49,27,15,7,73,39,34,2,2,54,27,27
"2021","Buckinghamshire 067B","E01017825",658,153,67,86,458,48,288,82,145,61,66,30,31,5,55,21,34,1,1,47,20,27
"2021","Buckinghamshire 067C","E01017826",625,188,85,103,386,49,208,42,89,77,51,18,20,13,75,44,31,3,3,51,21,30
"2021","Buckinghamshire 067D","E01017827",820,242,79,163,521,56,286,85,152,49,97,57,35,5,74,43,31,8,8,57,24,33
"2021","Buckinghamshire 067E","E01017828",639,199,101,98,401,59,203,60,99,44,73,35,32,6,65,34,31,1,1,39,15,24
"2021","Buckinghamshire 067F","E01017829",702,88,44,44,478,60,317,84,132,101,38,30,7,1,57,26,31,6,6,136,88,48
"2021","Buckinghamshire 026A","E01017929",816,362,238,124,417,69,161,48,88,25,95,61,28,6,87,59,28,5,5,37,17,20
"2021","Buckinghamshire 026B","E01017930",805,217,125,92,564,141,296,99,151,46,81,52,24,5,42,15,27,4,4,24,12,12
"2021","Buckinghamshire 026C","E01017931",647,187,91,96,430,71,241,85,116,40,58,34,21,3,56,28,28,4,4,30,10,20
"2021","Buckinghamshire 026D","E01017932",692,169,116,53,494,142,259,96,115,48,55,28,22,5,38,17,21,0,0,29,14,15
"2021","Buckinghamshire 026E","E01017933",859,286,217,69,534,128,260,100,109,51,73,34,34,5,69,29,40,4,4,39,12,27
"2021","Buckinghamshire 025A","E01017885",871,175,96,79,676,110,355,131,161,63,122,77,42,3,89,61,28,0,0,20,7,13
"2021","Buckinghamshire 025B","E01017886",617,135,76,59,451,109,255,102,111,42,63,39,20,4,24,11,13,0,0,31,13,18
"2021","Buckinghamshire 025C","E01017887",471,119,85,34,329,60,210,75,86,49,38,25,10,3,21,13,8,0,0,23,9,14
"2021","Buckinghamshire 025D","E01017888",599,108,53,55,462,99,284,92,154,38,41,30,9,2,38,27,11,0,0,29,16,13
"2021","Buckinghamshire 033A","E01017869",506,79,50,29,404,115,227,72,115,40,34,24,8,2,28,10,18,0,0,23,9,14
"2021","Buckinghamshire 033B","E01017870",465,67,53,14,375,94,222,85,82,55,36,16,14,6,21,10,11,2,2,23,11,12
"2021","Buckinghamshire 033C","E01017871",612,124,87,37,471,123,272,95,130,47,42,22,17,3,33,16,17,1,1,17,8,9
"2021","Buckinghamshire 033D","E01017872",654,143,97,46,476,135,262,92,110,60,47,30,12,5,29,10,19,3,3,35,10,25
"2021","Buckinghamshire 033E","E01017873",523,85,48,37,418,84,243,73,103,67,54,30,19,5,37,19,18,0,0,20,11,9
"2021","Buckinghamshire 033F","E01017874",560,148,79,69,387,44,227,61,141,25,76,57,18,1,36,25,11,4,4,25,13,12
"2021","Buckinghamshire 037A","E01017915",568,132,71,61,394,61,214,76,96,42,62,24,32,6,46,23,23,11,11,42,19,23
"2021","Buckinghamshire 037B","E01017916",481,95,57,38,361,87,200,78,83,39,50,36,14,0,22,5,17,2,2,25,5,20
"2021","Buckinghamshire 037C","E01017917",632,147,52,95,454,57,253,83,128,42,87,47,34,6,57,33,24,0,0,31,14,17
"2021","Buckinghamshire 037D","E01017918",705,254,125,129,431,69,201,70,88,43,91,46,41,4,67,38,29,3,3,20,9,11
"2021","Buckinghamshire 038A","E01017857",599,229,78,151,313,14,143,43,75,25,55,24,28,3,97,57,40,4,4,57,34,23
"2021","Buckinghamshire 038B","E01017858",963,413,203,210,485,48,248,62,167,19,90,63,26,1,90,60,30,9,9,65,21,44
"2021","Buckinghamshire 038C","E01017859",614,99,37,62,452,80,250,72,132,46,61,31,25,5,55,32,23,6,6,63,41,22
"2021","Buckinghamshire 038D","E01017860",490,74,33,41,363,36,190,26,113,51,56,28,21,7,75,42,33,6,6,53,27,26
"2021","Buckinghamshire 038E","E01017861",599,139,87,52,426,67,260,76,136,48,54,29,22,3,43,24,19,2,2,34,16,18
"2021","Buckinghamshire 038F","E01017862",714,159,83,76,527,79,319,72,196,51,58,32,19,7,67,42,25,4,4,28,12,16
"2021","Buckinghamshire 038G","E01017863",641,121,73,48,476,77,296,67,171,58,60,27,30,3,40,24,16,3,3,44,20,24
"2021","Buckinghamshire 040A","E01017853",569,161,60,101,370,35,191,79,76,36,92,60,28,4,51,28,23,1,1,38,20,18
"2021","Buckinghamshire 040B","E01017854",507,132,57,75,355,62,196,75,70,51,54,30,17,7,43,14,29,0,0,20,8,12
"2021","Buckinghamshire 040C","E01017878",1016,226,120,106,729,151,424,190,179,55,94,58,36,0,60,32,28,0,0,61,16,45
"2021","Buckinghamshire 040D","E01033970",600,107,58,49,445,86,272,101,120,51,50,29,17,4,34,15,19,3,3,48,14,34
"2021","Buckinghamshire 040E","E01033971",563,91,45,46,442,70,279,103,137,39,59,35,21,3,31,22,9,3,3,30,10,20
"2021","Buckinghamshire 041A","E01017920",567,117,59,58,411,54,234,59,137,38,77,42,30,5,45,21,24,1,1,39,14,25
"2021","Buckinghamshire 041B","E01017921",700,178,51,127,445,46,241,86,117,38,96,62,32,2,57,33,24,5,5,77,29,48
"2021","Buckinghamshire 041C","E01017922",885,237,71,166,571,46,297,71,174,52,101,63,36,2,118,84,34,9,9,77,49,28
"2021","Buckinghamshire 041D","E01017923",760,333,41,292,336,11,167,53,97,17,98,79,19,0,54,31,23,6,6,91,41,50
"2021","Buckinghamshire 041E","E01017924",589,111,39,72,435,80,244,82,123,39,75,43,27,5,32,14,18,4,4,43,22,21
"2021","Buckinghamshire 045A","E01017937",561,116,70,46,424,85,271,75,152,44,42,20,18,4,25,12,13,1,1,21,8,13
"2021","Buckinghamshire 045B","E01017938",501,91,50,41,388,89,236,69,124,43,31,20,6,5,32,18,14,0,0,22,10,12
"2021","Buckinghamshire 045C","E01017940",693,210,62,148,448,48,219,73,116,30,119,69,46,4,57,34,23,5,5,35,17,18
"2021","Buckinghamshire 045D","E01017942",581,121,93,28,443,108,251,58,151,42,40,16,19,5,43,18,25,1,1,17,5,12
"2021","Buckinghamshire 042A","E01017850",481,94,14,80,332,7,181,43,105,33,55,24,25,6,85,47,38,4,4,55,33,22
"2021","Buckinghamshire 042B","E01017851",668,191,58,133,409,14,223,66,118,39,91,55,32,4,73,39,34,8,8,68,28,40
"2021","Buckinghamshire 042C","E01017852",709,104,32,72,471,40,316,46,197,73,37,19,18,0,73,44,29,5,5,134,82,52
"2021","Buckinghamshire 042D","E01017919",635,228,96,132,364,22,152,43,96,13,120,84,32,4,66,48,18,4,4,43,10,33
"2021","Buckinghamshire 043A","E01017925",780,174,36,138,547,33,281,58,172,51,114,70,38,6,110,55,55,9,9,59,26,33
"2021","Buckinghamshire 043B","E01017926",652,241,74,167,381,15,182,64,100,18,74,32,41,1,105,82,23,5,5,30,9,21
"2021","Buckinghamshire 043C","E01017927",643,146,84,62,434,72,240,78,117,45,63,31,22,10,58,31,27,1,1,63,31,32
"2021","Buckinghamshire 043D","E01017928",595,187,106,81,357,38,209,66,109,34,54,27,19,8,53,27,26,3,3,51,21,30
"2021","Buckinghamshire 044A","E01017911",627,158,61,97,414,30,224,60,125,39,69,35,28,6,91,51,40,0,0,55,30,25
"2021","Buckinghamshire 044B","E01017912",547,138,48,90,346,31,213,60,115,38,53,30,19,4,43,23,20,6,6,63,26,37
"2021","Buckinghamshire 044C","E01017913",864,295,35,260,474,6,224,57,136,31,111,74,32,5,128,90,38,5,5,95,47,48
"2021","Buckinghamshire 044D","E01017914",516,97,37,60,380,38,220,64,116,40,63,36,21,6,56,31,25,3,3,39,20,19
"2021","Buckinghamshire 046A","E01017903",520,131,21,110,275,8,157,20,111,26,41,18,19,4,58,32,26,11,11,114,53,61
"2021","Buckinghamshire 046B","E01017904",660,162,20,142,377,10,217,58,136,23,64,38,26,0,71,45,26,15,15,121,63,58
"2021","Buckinghamshire 046C","E01017905",942,381,53,328,423,8,207,60,123,24,104,76,28,0,86,54,32,18,18,138,65,73
"2021","Buckinghamshire 046D","E01017906",490,60,22,38,328,7,199,22,140,37,27,5,17,5,88,50,38,7,7,102,70,32
"2021","Buckinghamshire 046E","E01017907",603,166,86,80,324,31,196,44,111,41,37,14,19,4,53,27,26,7,7,113,60,53
"2021","Buckinghamshire 048A","E01017899",678,196,106,90,431,42,226,49,146,31,90,43,46,1,69,36,33,4,4,51,29,22
"2021","Buckinghamshire 048B","E01017900",490,140,38,102,318,30,125,36,66,23,59,31,26,2,101,74,27,3,3,32,14,18
"2021","Buckinghamshire 048C","E01017901",461,106,27,79,324,14,157,55,75,27,57,26,26,5,91,52,39,5,5,31,16,15
"2021","Buckinghamshire 048D","E01017902",636,188,59,129,390,21,189,48,119,22,61,30,27,4,110,71,39,9,9,58,23,35
"2021","Buckinghamshire 049A","E01017836",557,113,35,78,352,23,203,56,114,33,62,28,33,1,58,38,20,6,6,92,48,44
"2021","Buckinghamshire 049B","E01017837",1012,396,57,339,512,19,239,94,119,26,137,114,22,1,99,68,31,18,18,104,37,67
"2021","Buckinghamshire 049C","E01017838",509,89,40,49,315,35,190,49,104,37,39,16,20,3,44,22,22,7,7,105,61,44
"2021","Buckinghamshire 049D","E01017839",795,291,52,239,421,40,212,72,114,26,108,95,12,1,41,21,20,20,20,83,26,57
"2021","Buckinghamshire 049E","E01017840",675,150,75,75,436,55,293,62,158,73,31,17,11,3,50,26,24,7,7,89,52,37
"2021","Buckinghamshire 049F","E01017841",880,114,43,71,693,53,425,99,268,58,98,44,53,1,111,96,15,6,6,73,48,25
"2021","Buckinghamshire 051A","E01017910",1097,386,106,280,646,63,326,110,184,32,164,124,35,5,81,53,28,12,12,65,23,42
"2021","Buckinghamshire 051B","E01017941",636,217,64,153,394,50,193,62,107,24,86,54,26,6,59,36,23,6,6,25,9,16
"2021","Buckinghamshire 051C","E01033972",721,212,30,182,466,13,204,51,135,18,128,66,56,6,111,85,26,10,10,43,18,25
"2021","Buckinghamshire 051D","E01033973",565,221,29,192,309,7,106,31,58,17,103,70,28,5,88,55,33,5,5,35,19,16
"2021","Buckinghamshire 051E","E01033974",606,185,43,142,391,30,227,75,121,31,86,61,23,2,45,25,20,3,3,30,9,21
"2021","Buckinghamshire 051F","E01033975",643,254,97,157,349,33,142,39,83,20,96,59,34,3,69,44,25,9,9,40,14,26
"2021","Buckinghamshire 052A","E01017843",665,177,112,65,451,107,244,79,111,54,44,23,13,8,55,27,28,1,1,37,14,23
"2021","Buckinghamshire 052B","E01017844",699,257,147,110,380,44,222,54,128,40,41,19,19,3,68,32,36,5,5,62,25,37
"2021","Buckinghamshire 052C","E01017845",684,237,111,126,388,48,195,53,107,35,65,30,29,6,74,40,34,6,6,59,30,29
"2021","Buckinghamshire 052D","E01017855",664,170,88,82,453,84,234,78,109,47,75,38,35,2,58,30,28,2,2,41,22,19
"2021","Buckinghamshire 052E","E01017856",571,126,70,56,414,45,183,52,96,35,88,28,52,8,95,50,45,3,3,31,15,16
"2021","Buckinghamshire 055A","E01017864",526,115,76,39,390,96,219,61,115,43,44,23,20,1,29,11,18,2,2,21,8,13
"2021","Buckinghamshire 055B","E01017865",607,127,103,24,469,109,270,83,130,57,47,19,26,2,42,19,23,1,1,11,4,7
"2021","Buckinghamshire 055C","E01017867",594,155,96,59,393,54,173,49,87,37,76,23,44,9,87,57,30,3,3,46,22,24
"2021","Buckinghamshire 055D","E01017868",650,164,109,55,445,107,245,78,118,49,55,21,30,4,35,15,20,3,3,41,13,28
"2021","Buckinghamshire 056A","E01017934",786,251,86,165,484,46,207,62,104,41,98,55,36,7,126,73,53,7,7,51,16,35
"2021","Buckinghamshire 056B","E01017935",868,280,114,166,560,52,286,84,171,31,127,81,38,8,90,57,33,5,5,28,15,13
"2021","Buckinghamshire 056C","E01017936",643,184,95,89,433,96,229,68,124,37,60,37,21,2,48,24,24,0,0,26,8,18
"2021","Buckinghamshire 056D","E01017939",588,169,61,108,390,51,199,42,113,44,87,56,30,1,50,26,24,3,3,29,9,20
"2021","Buckinghamshire 057A","E01017866",614,150,96,54,435,108,242,88,105,49,56,39,16,1,28,9,19,1,1,29,11,18
"2021","Buckinghamshire 057B","E01017875",546,90,40,50,437,72,314,93,184,37,25,18,5,2,23,10,13,3,3,19,11,8
"2021","Buckinghamshire 057C","E01017876",775,136,92,44,616,134,399,107,228,64,42,11,25,6,39,18,21,2,2,23,7,16
"2021","Buckinghamshire 057D","E01017877",647,165,103,62,461,115,264,67,153,44,35,14,16,5,45,26,19,2,2,21,9,12
"2021","Buckinghamshire 060A","E01017846",664,224,119,105,408,45,181,51,82,48,101,39,58,4,76,31,45,5,5,32,12,20
"2021","Buckinghamshire 060B","E01017847",761,262,138,124,465,96,246,81,124,41,75,53,21,1,46,22,24,2,2,34,8,26
"2021","Buckinghamshire 060C","E01017848",490,101,79,22,366,83,209,58,120,31,45,20,22,3,25,13,12,4,4,23,15,8
"2021","Buckinghamshire 060D","E01017849",699,236,111,125,444,81,213,93,87,33,114,63,48,3,35,22,13,1,1,19,8,11
"2021","Buckinghamshire 062A","E01017889",575,136,70,66,402,42,205,43,129,33,59,29,27,3,92,58,34,4,4,37,14,23
"2021","Buckinghamshire 062B","E01017890",493,80,58,22,394,84,245,57,145,43,30,13,12,5,32,19,13,3,3,19,8,11
"2021","Buckinghamshire 062C","E01017891",628,194,117,77,419,79,244,74,129,41,50,32,18,0,45,28,17,1,1,15,7,8
"2021","Buckinghamshire 062D","E01017892",601,116,86,30,460,135,264,71,153,40,25,17,6,2,35,21,14,1,1,25,12,13
"2021","Buckinghamshire 062E","E01017893",906,413,239,174,452,89,172,53,101,18,91,64,26,1,100,67,33,0,0,41,13,28
"2021","Buckinghamshire 062F","E01017894",666,194,121,73,454,89,256,70,150,36,52,25,21,6,55,35,20,2,2,18,5,13
"2021","Buckinghamshire 061A","E01017895",614,232,117,115,354,53,180,57,98,25,60,40,17,3,58,31,27,3,3,28,7,21
"2021","Buckinghamshire 061B","E01017896",613,178,104,74,417,112,214,63,119,32,47,29,18,0,40,21,19,4,4,18,6,12
"2021","Buckinghamshire 061C","E01017897",667,173,80,93,465,38,252,62,160,30,94,61,30,3,78,48,30,3,3,29,8,21
"2021","Buckinghamshire 061D","E01017898",487,115,54,61,348,29,167,48,94,25,63,35,22,6,86,52,34,3,3,24,11,13
"2021","Buckinghamshire 039A","E01017773",649,168,103,65,459,116,246,77,119,50,45,26,17,2,48,21,27,4,4,22,8,14
"2021","Buckinghamshire 039B","E01017774",531,127,98,29,382,104,228,67,106,55,27,15,10,2,22,14,8,1,1,22,7,15
"2021","Buckinghamshire 039C","E01017782",552,76,51,25,455,108,294,71,179,44,22,10,11,1,31,17,14,0,0,21,9,12
"2021","Buckinghamshire 039D","E01017783",609,128,68,60,452,90,268,83,143,42,45,28,15,2,48,25,23,1,1,29,12,17
"2021","Buckinghamshire 039E","E01017784",655,157,90,67,475,106,296,93,158,45,34,20,13,1,35,11,24,4,4,23,9,14
"2021","Buckinghamshire 039F","E01032609",539,157,86,71,357,73,190,51,99,40,50,24,23,3,40,17,23,4,4,25,12,13
"2021","Buckinghamshire 036A","E01017880",515,84,70,14,413,83,244,61,138,45,41,18,21,2,41,18,23,4,4,18,7,11
"2021","Buckinghamshire 036B","E01017881",743,183,120,63,530,128,284,76,154,54,63,28,32,3,50,27,23,5,5,30,17,13
"2021","Buckinghamshire 036C","E01017882",638,152,95,57,453,74,253,73,123,57,56,21,31,4,67,34,33,3,3,33,12,21
"2021","Buckinghamshire 036D","E01017883",634,132,70,62,467,99,278,90,130,58,40,19,16,5,45,28,17,5,5,35,19,16
"2021","Buckinghamshire 036E","E01017884",621,243,158,85,356,60,200,49,112,39,49,21,25,3,44,19,25,3,3,22,10,12
"2021","Buckinghamshire 036F","E01032610",652,163,95,68,469,95,252,68,127,57,55,19,30,6,64,37,27,3,3,20,10,10
"2021","Eastbourne 001A","E01020924",548,136,66,70,368,54,178,65,73,40,68,31,32,5,64,34,30,4,4,44,16,28
"2021","Eastbourne 001B","E01020925",585,140,63,77,407,41,170,57,83,30,84,27,40,17,104,57,47,8,8,38,17,21
"2021","Eastbourne 001C","E01020927",561,123,50,73,404,46,186,68,76,42,75,37,31,7,95,54,41,2,2,34,22,12
"2021","Eastbourne 001D","E01020928",786,298,185,113,455,125,154,58,77,19,81,41,33,7,85,51,34,10,10,33,10,23
"2021","Eastbourne 001E","E01020930",494,81,29,52,366,15,181,49,76,56,63,20,36,7,107,66,41,0,0,47,22,25
"2021","Eastbourne 002A","E01020917",578,155,52,103,386,26,151,49,69,33,85,33,42,10,124,83,41,0,0,37,23,14
"2021","Eastbourne 002B","E01020918",618,126,61,65,451,62,195,51,104,40,88,34,47,7,103,63,40,3,3,41,23,18
"2021","Eastbourne 002C","E01020919",593,114,56,58,437,60,186,56,91,39,92,41,43,8,99,69,30,0,0,42,21,21
"2021","Eastbourne 002D","E01020923",547,162,67,95,346,28,134,42,67,25,80,33,38,9,99,62,37,5,5,39,24,15
"2021","Eastbourne 002E","E01020949",680,168,114,54,470,112,199,77,82,40,79,32,40,7,76,40,36,4,4,42,15,27
"2021","Eastbourne 003A","E01020926",606,135,81,54,433,90,223,82,90,51,56,30,20,6,61,34,27,3,3,38,10,28
"2021","Eastbourne 003B","E01020929",790,299,159,140,452,65,157,46,83,28,95,36,55,4,128,91,37,7,7,39,16,23
"2021","Eastbourne 003C","E01020955",687,219,104,115,439,56,164,51,87,26,94,31,54,9,122,80,42,3,3,29,9,20
"2021","Eastbourne 003D","E01020956",810,312,234,78,477,187,165,66,67,32,64,34,29,1,59,24,35,2,2,21,11,10
"2021","Eastbourne 003E","E01020957",635,177,111,66,419,73,187,69,85,33,74,25,40,9,84,58,26,1,1,39,17,22
"2021","Eastbourne 004A","E01020920",727,302,131,171,401,46,133,47,57,29,94,44,45,5,119,80,39,9,9,24,11,13
"2021","Eastbourne 004B","E01020921",587,163,78,85,402,68,185,56,85,44,72,36,31,5,76,43,33,1,1,22,9,13
"2021","Eastbourne 004C","E01020922",603,188,77,111,376,38,157,51,59,47,74,30,40,4,105,66,39,2,2,39,11,28
"2021","Eastbourne 004D","E01020945",789,201,139,62,552,187,272,103,94,75,58,21,31,6,35,17,18,0,0,36,14,22
"2021","Eastbourne 004E","E01020950",728,229,169,60,471,137,197,95,66,36,61,32,25,4,71,30,41,5,5,28,8,20
"2021","Eastbourne 006A","E01020940",616,147,110,37,428,102,261,74,147,40,33,12,18,3,30,21,9,2,2,41,22,19
"2021","Eastbourne 006B","E01020941",638,156,68,88,433,37,191,47,101,43,88,23,53,12,113,69,44,4,4,49,32,17
"2021","Eastbourne 006C","E01020942",628,153,87,66,446,65,237,72,115,50,69,33,27,9,74,50,24,1,1,29,13,16
"2021","Eastbourne 006D","E01020946",735,204,135,69,500,154,265,105,106,54,51,31,15,5,29,17,12,1,1,31,10,21
"2021","Eastbourne 006E","E01020947",699,244,121,123,416,75,197,73,91,33,62,28,31,3,78,51,27,4,4,39,21,18
"2021","Eastbourne 007A","E01020914",807,226,92,134,491,38,203,64,109,30,120,62,56,2,123,91,32,7,7,90,22,68
"2021","Eastbourne 007B","E01020915",820,349,190,159,428,63,153,64,68,21,104,60,39,5,97,65,32,11,11,43,20,23
"2021","Eastbourne 007C","E01020952",783,270,138,132,459,53,229,61,130,38,79,30,43,6,91,55,36,7,7,54,21,33
"2021","Eastbourne 007D","E01020953",579,99,52,47,445,50,248,81,121,46,81,38,40,3,64,36,28,2,2,35,11,24
"2021","Eastbourne 007E","E01020954",620,116,59,57,453,61,282,70,149,63,62,22,34,6,46,27,19,2,2,51,25,26
"2021","Eastbourne 008A","E01020948",682,257,177,80,371,121,168,59,75,34,37,21,14,2,39,21,18,6,6,54,13,41
"2021","Eastbourne 008B","E01020963",745,174,73,101,521,57,296,111,133,52,84,43,37,4,78,56,22,6,6,50,22,28
"2021","Eastbourne 008C","E01020965",963,494,147,347,407,44,151,66,66,19,132,91,37,4,68,48,20,12,12,62,13,49
"2021","Eastbourne 008D","E01020966",880,458,193,265,374,64,146,69,61,16,97,71,25,1,58,39,19,9,9,48,6,42
"2021","Eastbourne 009A","E01020938",623,167,85,82,408,39,220,66,123,31,65,24,30,11,80,45,35,4,4,48,21,27
"2021","Eastbourne 009B","E01020939",641,175,99,76,422,65,213,61,116,36,80,43,35,2,64,39,25,0,0,44,17,27
"2021","Eastbourne 009C","E01020943",747,285,136,149,422,63,176,62,84,30,93,41,44,8,86,61,25,4,4,40,12,28
"2021","Eastbourne 009D","E01020964",858,423,243,180,405,87,167,75,80,12,86,57,24,5,62,43,19,3,3,30,8,22
"2021","Eastbourne 009E","E01020967",1000,500,301,199,446,128,175,82,62,31,76,59,15,2,61,28,33,6,6,54,7,47
"2021","Eastbourne 010A","E01020910",997,482,137,345,403,34,139,61,61,17,131,85,39,7,90,58,32,9,9,112,25,87
"2021","Eastbourne 010B","E01020911",1091,434,80,354,527,13,173,70,86,17,184,125,54,5,129,100,29,28,28,130,21,109
"2021","Eastbourne 010C","E01020912",1149,581,102,479,459,15,143,62,67,14,136,85,47,4,149,120,29,16,16,109,16,93
"2021","Eastbourne 010D","E01020916",778,234,81,153,473,19,186,55,100,31,124,61,56,7,137,92,45,7,7,71,28,43
"2021","Eastbourne 011A","E01020935",1147,563,171,392,497,48,179,89,77,13,147,109,34,4,109,65,44,14,14,87,18,69
"2021","Eastbourne 011B","E01020936",1005,584,352,232,377,158,104,60,36,8,51,47,4,0,55,30,25,9,9,44,9,35
"2021","Eastbourne 011C","E01020937",848,428,217,211,374,73,148,65,69,14,88,66,21,1,59,37,22,6,6,46,4,42
"2021","Eastbourne 011D","E01020968",1045,543,244,299,439,67,155,70,77,8,138,109,26,3,72,41,31,7,7,63,15,48
"2021","Eastbourne 012A","E01020931",781,378,251,127,372,152,123,68,36,19,61,39,17,5,34,16,18,2,2,31,6,25
"2021","Eastbourne 012B","E01020932",790,420,327,93,344,198,85,61,13,11,43,28,15,0,16,7,9,2,2,26,4,22
"2021","Eastbourne 012E","E01020944",600,136,88,48,433,111,235,88,113,34,37,23,10,4,44,35,9,6,6,31,13,18
"2021","Eastbourne 012F","E01034298",1161,467,315,152,634,241,240,113,77,50,81,50,26,5,65,44,21,7,7,60,10,50
"2021","Eastbourne 013A","E01020913",1059,339,169,170,664,90,265,103,120,42,141,63,68,10,162,98,64,6,6,56,20,36
"2021","Eastbourne 013B","E01020951",659,218,87,131,386,35,195,70,97,28,88,46,36,6,65,44,21,3,3,55,25,30
"2021","Eastbourne 013C","E01020959",609,168,121,47,406,77,202,59,100,43,67,25,36,6,58,33,25,2,2,35,15,20
"2021","Eastbourne 013D","E01020961",641,188,140,48,430,146,196,66,84,46,46,24,17,5,42,23,19,0,0,23,7,16
"2021","Eastbourne 013E","E01020962",970,325,182,143,600,150,257,106,102,49,102,51,40,11,88,49,39,3,3,45,12,33
"2021","Eastbourne 014A","E01020960",1185,417,204,213,709,170,259,115,83,61,129,81,42,6,145,100,45,6,6,59,16,43
"2021","Eastbourne 014B","E01032831",755,210,109,101,509,167,205,94,66,45,77,54,20,3,59,30,29,1,1,36,13,23
"2021","Eastbourne 014C","E01032832",663,203,90,113,419,96,163,74,53,36,62,29,28,5,96,58,38,2,2,41,19,22
"2021","Eastbourne 014D","E01032833",673,265,128,137,377,94,145,75,44,26,75,53,19,3,59,37,22,4,4,31,9,22
"2021","Hastings 001A","E01020969",642,189,120,69,415,103,203,70,84,49,59,18,34,7,48,29,19,2,2,38,18,20
"2021","Hastings 001B","E01020970",1062,227,116,111,748,107,452,155,194,103,119,65,44,10,66,36,30,4,4,87,35,52
"2021","Hastings 001C","E01020971",861,230,106,124,579,76,278,87,125,66,105,39,56,10,114,69,45,6,6,52,24,28
"2021","Hastings 001D","E01020987",789,252,76,176,490,32,256,89,120,47,115,47,59,9,86,61,25,1,1,47,28,19
"2021","Hastings 002A","E01020974",710,195,116,79,467,113,218,97,70,51,63,27,35,1,71,43,28,2,2,48,20,28
"2021","Hastings 002B","E01020986",637,138,90,48,470,121,241,98,94,49,61,33,26,2,44,25,19,3,3,29,13,16
"2021","Hastings 002C","E01020988",737,206,152,54,494,157,233,96,88,49,59,33,21,5,45,14,31,0,0,37,16,21
"2021","Hastings 002D","E01021007",678,168,121,47,468,146,226,105,72,49,60,26,27,7,34,11,23,2,2,42,17,25
"2021","Hastings 002E","E01021008",767,322,226,96,390,101,152,68,58,26,82,40,30,12,51,30,21,4,4,55,27,28
"2021","Hastings 002F","E01021009",806,186,124,62,582,152,273,98,116,59,95,47,43,5,61,32,29,1,1,38,17,21
"2021","Hastings 003A","E01020993",588,186,65,121,353,32,120,42,48,30,73,28,39,6,127,70,57,1,1,49,31,18
"2021","Hastings 003B","E01020994",592,141,71,70,396,34,141,44,65,32,76,20,49,7,144,99,45,1,1,55,28,27
"2021","Hastings 003C","E01020995",578,165,65,100,371,33,151,60,60,31,82,32,45,5,99,62,37,6,6,42,18,24
"2021","Hastings 003D","E01020996",709,121,52,69,530,57,246,91,113,42,105,33,66,6,118,73,45,4,4,58,34,24
"2021","Hastings 003E","E01021019",799,342,192,150,407,45,146,56,61,29,95,36,50,9,117,75,42,4,4,50,25,25
"2021","Hastings 004A","E01021004",808,246,126,120,512,113,201,85,78,38,102,46,49,7,93,60,33,3,3,50,26,24
"2021","Hastings 004B","E01021005",627,140,75,65,436,38,144,39,85,20,99,24,60,15,148,110,38,7,7,51,27,24
"2021","Hastings 004C","E01021006",802,260,103,157,499,74,178,80,73,25,113,52,56,5,128,88,40,6,6,43,12,31
"2021","Hastings 004D","E01021013",735,184,92,92,496,44,224,79,103,42,113,45,59,9,111,70,41,4,4,55,23,32
"2021","Hastings 005A","E01020972",751,239,88,151,453,28,143,50,65,28,106,30,64,12,174,127,47,2,2,59,35,24
"2021","Hastings 005B","E01020973",742,179,93,86,505,78,226,68,113,45,100,41,45,14,98,59,39,3,3,58,32,26
"2021","Hastings 005C","E01020977",707,261,84,177,383,29,150,62,62,26,92,53,37,2,104,73,31,8,8,63,27,36
"2021","Hastings 005D","E01021015",715,219,86,133,453,18,132,53,59,20,93,25,64,4,209,165,44,1,1,43,23,20
"2021","Hastings 006A","E01021010",630,161,105,56,418,76,197,68,87,42,81,39,34,8,61,29,32,3,3,51,24,27
"2021","Hastings 006B","E01021011",669,181,77,104,436,38,201,74,87,40,102,43,50,9,93,66,27,2,2,52,17,35
"2021","Hastings 006C","E01021012",769,313,153,160,383,59,156,53,79,24,75,38,33,4,88,57,31,5,5,73,34,39
"2021","Hastings 006D","E01021020",761,192,109,83,497,67,214,68,99,47,87,24,55,8,124,65,59,5,5,72,33,39
"2021","Hastings 006E","E01021021",833,263,101,162,532,86,234,82,100,52,117,63,47,7,90,59,31,5,5,38,12,26
"2021","Hastings 007A","E01021000",611,181,87,94,386,44,171,65,74,32,109,51,51,7,62,34,28,0,0,44,18,26
"2021","Hastings 007B","E01021001",497,132,58,74,317,43,158,52,70,36,68,32,27,9,47,30,17,1,1,48,18,30
"2021","Hastings 007C","E01021002",621,192,80,112,383,68,159,75,53,31,82,48,25,9,69,39,30,5,5,46,15,31
"2021","Hastings 007D","E01021003",810,429,205,224,332,59,122,74,26,22,88,62,19,7,59,31,28,4,4,49,10,39
"2021","Hastings 007E","E01021014",789,264,81,183,468,30,176,61,80,35,122,65,45,12,138,101,37,2,2,57,27,30
"2021","Hastings 008A","E01020975",775,324,147,177,396,54,165,68,79,18,114,67,41,6,60,39,21,3,3,55,19,36
"2021","Hastings 008B","E01020976",870,324,146,178,480,86,226,97,86,43,92,55,32,5,71,39,32,5,5,66,24,42
"2021","Hastings 008C","E01020990",692,229,69,160,407,23,148,55,66,27,111,62,33,16,116,79,37,9,9,56,17,39
"2021","Hastings 008D","E01020991",655,275,87,188,342,45,158,89,41,28,88,51,32,5,48,30,18,3,3,38,15,23
"2021","Hastings 008E","E01020992",920,419,114,305,444,25,177,72,85,20,110,67,38,5,126,86,40,6,6,57,23,34
"2021","Hastings 009A","E01020978",1038,494,154,340,460,26,137,66,57,14,169,116,48,5,116,75,41,12,12,84,21,63
"2021","Hastings 009B","E01020979",1079,608,163,445,392,29,127,54,57,16,119,77,39,3,105,71,34,12,12,79,16,63
"2021","Hastings 009C","E01020980",780,380,122,258,344,19,118,57,44,17,120,69,44,7,83,61,22,4,4,56,17,39
"2021","Hastings 009D","E01020981",677,269,86,183,359,49,147,70,58,19,88,52,32,4,72,38,34,3,3,49,14,35
"2021","Hastings 010A","E01020997",673,177,78,99,453,75,199,74,91,34,94,52,38,4,82,46,36,3,3,43,13,30
"2021","Hastings 010B","E01020998",924,450,163,287,427,59,163,73,62,28,113,78,34,1,86,57,29,6,6,47,12,35
"2021","Hastings 010C","E01020999",755,230,141,89,480,129,220,99,85,36,75,38,34,3,51,30,21,5,5,45,15,30
"2021","Hastings 010D","E01021016",751,249,119,130,457,62,189,73,78,38,93,42,45,6,102,76,26,11,11,45,22,23
"2021","Hastings 010E","E01021017",652,176,80,96,428,45,228,86,96,46,90,41,46,3,62,35,27,3,3,48,23,25
"2021","Hastings 010F","E01021018",736,157,72,85,518,83,275,94,122,59,100,57,36,7,60,39,21,0,0,61,29,32
"2021","Hastings 011A","E01020982",985,576,137,439,366,18,132,64,56,12,102,74,26,2,109,79,30,5,5,43,10,33
"2021","Hastings 011B","E01020983",913,561,246,315,312,30,94,51,32,11,86,67,19,0,93,66,27,9,9,40,2,38
"2021","Hastings 011C","E01020984",1032,540,154,386,429,27,132,76,45,11,137,97,37,3,119,76,43,14,14,63,18,45
"2021","Hastings 011D","E01020985",912,495,163,332,365,26,136,67,56,13,119,86,30,3,80,53,27,4,4,52,9,43
"2021","Hastings 011E","E01020989",812,405,92,313,359,18,133,65,56,12,109,67,41,1,97,61,36,2,2,48,18,30
"2021","Lewes 001A","E01021022",892,202,110,92,640,120,352,117,173,62,97,44,50,3,70,48,22,1,1,50,17,33
"2021","Lewes 001B","E01021024",475,152,75,77,297,46,145,54,66,25,49,26,23,0,55,31,24,2,2,26,15,11
"2021","Lewes 001C","E01021025",715,116,50,66,567,122,327,118,154,55,70,42,24,4,46,27,19,2,2,32,13,19
"2021","Lewes 001D","E01021052",519,125,82,43,379,100,189,68,95,26,48,24,21,3,42,23,19,0,0,15,6,9
"2021","Lewes 001E","E01021053",526,140,92,48,361,89,174,62,72,40,50,22,25,3,47,28,19,1,1,25,6,19
"2021","Lewes 002A","E01021023",1169,236,105,131,887,104,526,181,271,74,162,91,63,8,92,59,33,3,3,46,18,28
"2021","Lewes 002B","E01021026",1053,352,280,72,653,233,303,109,155,39,67,33,31,3,48,20,28,2,2,48,16,32
"2021","Lewes 002C","E01021032",837,231,147,84,550,142,280,109,115,56,63,30,28,5,58,30,28,7,7,56,15,41
"2021","Lewes 002D","E01021067",453,108,70,38,320,65,186,82,71,33,39,23,11,5,30,11,19,0,0,25,5,20
"2021","Lewes 002E","E01021068",427,93,48,45,299,53,171,74,63,34,47,29,13,5,26,14,12,2,2,35,16,19
"2021","Lewes 003A","E01021033",838,301,149,152,483,64,246,97,115,34,91,44,40,7,82,49,33,0,0,54,18,36
"2021","Lewes 003B","E01021034",540,162,86,76,363,45,162,48,92,22,79,41,30,8,77,54,23,0,0,15,5,10
"2021","Lewes 003C","E01021035",1006,487,229,258,468,80,167,78,63,26,117,87,25,5,97,61,36,7,7,51,8,43
"2021","Lewes 003D","E01021036",604,174,99,75,408,86,222,72,103,47,52,27,19,6,47,24,23,1,1,22,6,16
"2021","Lewes 003E","E01021037",606,196,70,126,353,28,153,48,73,32,68,20,43,5,100,64,36,4,4,57,23,34
"2021","Lewes 003F","E01021038",799,324,149,175,436,65,184,78,89,17,96,68,24,4,87,63,24,4,4,39,9,30
"2021","Lewes 004A","E01021054",617,160,99,61,428,98,208,77,92,39,78,44,26,8,41,22,19,3,3,29,14,15
"2021","Lewes 004B","E01021055",764,239,178,61,501,113,259,74,144,41,62,24,29,9,66,40,26,1,1,24,7,17
"2021","Lewes 004C","E01021056",722,190,133,57,497,148,248,102,107,39,65,34,29,2,35,23,12,1,1,35,11,24
"2021","Lewes 004D","E01021057",669,192,96,96,443,62,201,80,79,42,78,34,38,6,98,65,33,4,4,34,7,27
"2021","Lewes 005A","E01021039",634,240,126,114,355,64,178,72,77,29,58,35,22,1,53,30,23,2,2,39,10,29
"2021","Lewes 005B","E01021040",654,249,134,115,367,62,167,56,89,22,78,47,29,2,57,38,19,3,3,38,6,32
"2021","Lewes 005C","E01021041",628,188,137,51,406,84,228,72,124,32,56,16,30,10,37,24,13,1,1,34,11,23
"2021","Lewes 005D","E01021042",486,97,54,43,367,51,200,56,113,31,51,24,22,5,63,34,29,2,2,22,9,13
"2021","Lewes 005E","E01021043",605,133,69,64,442,52,199,55,109,35,72,30,39,3,118,83,35,1,1,30,12,18
"2021","Lewes 006A","E01021027",659,190,117,73,434,69,234,95,95,44,66,36,25,5,62,29,33,3,3,35,12,23
"2021","Lewes 006B","E01021028",598,132,67,65,431,66,220,65,104,51,69,27,36,6,76,43,33,0,0,35,12,23
"2021","Lewes 006C","E01021029",612,144,94,50,425,78,201,63,95,43,72,28,35,9,74,36,38,0,0,43,17,26
"2021","Lewes 006D","E01021030",569,202,135,67,330,73,160,62,72,26,61,37,21,3,33,17,16,3,3,37,15,22
"2021","Lewes 006E","E01021031",728,293,147,146,382,58,175,57,77,41,77,49,26,2,69,43,26,3,3,53,17,36
"2021","Lewes 007A","E01021061",598,117,61,56,433,74,234,85,85,64,71,29,39,3,53,34,19,1,1,48,23,25
"2021","Lewes 007B","E01021063",704,182,105,77,478,104,244,96,91,57,64,29,28,7,65,34,31,1,1,44,17,27
"2021","Lewes 007C","E01021064",865,336,201,135,476,105,200,94,77,29,88,51,31,6,80,49,31,3,3,53,20,33
"2021","Lewes 007D","E01021065",619,292,155,137,297,55,106,45,46,15,60,36,22,2,71,48,23,5,5,30,9,21
"2021","Lewes 007E","E01021066",637,162,119,43,436,87,209,79,92,38,71,37,30,4,63,42,21,6,6,39,15,24
"2021","Lewes 008A","E01021045",917,328,203,125,542,134,208,89,81,38,87,43,38,6,110,77,33,3,3,47,16,31
"2021","Lewes 008B","E01021046",611,128,87,41,445,76,218,69,94,55,84,38,41,5,64,42,22,3,3,38,9,29
"2021","Lewes 008C","E01021047",666,218,113,105,411,65,196,86,67,43,82,42,34,6,67,39,28,1,1,37,14,23
"2021","Lewes 008D","E01021048",788,280,113,167,468,53,163,66,79,18,106,61,43,2,139,97,42,7,7,40,9,31
"2021","Lewes 009A","E01021044",735,127,56,71,533,35,234,66,133,35,111,38,65,8,147,100,47,6,6,75,44,31
"2021","Lewes 009B","E01021049",671,264,100,164,371,29,136,56,64,16,84,39,41,4,120,98,22,2,2,36,13,23
"2021","Lewes 009C","E01021050",512,132,78,54,345,36,173,64,72,37,68,33,29,6,68,41,27,0,0,35,20,15
"2021","Lewes 009D","E01021051",495,155,68,87,309,47,136,57,57,22,69,28,34,7,53,41,12,4,4,31,14,17
"2021","Lewes 010A","E01021058",860,251,128,123,544,80,246,99,99,48,86,41,33,12,128,76,52,4,4,65,27,38
"2021","Lewes 010B","E01021059",812,276,168,108,474,112,207,99,67,41,77,44,27,6,75,40,35,3,3,62,21,41
"2021","Lewes 010C","E01021060",979,276,160,116,640,100,282,96,136,50,109,44,54,11,145,83,62,4,4,63,21,42
"2021","Lewes 010D","E01021062",724,216,82,134,462,41,208,75,88,45,100,46,49,5,108,77,31,5,5,46,23,23
"2021","Lewes 011A","E01021069",671,205,129,76,428,136,179,71,65,43,63,35,23,5,47,25,22,3,3,38,14,24
"2021","Lewes 011B","E01021075",749,177,142,35,549,145,247,83,117,47,94,45,45,4,63,42,21,0,0,23,13,10
"2021","Lewes 011C","E01021077",675,206,148,58,433,127,201,92,74,35,63,32,21,10,42,19,23,0,0,36,13,23
"2021","Lewes 011D","E01021081",733,250,163,87,445,147,166,79,52,35,74,42,26,6,57,34,23,1,1,38,14,24
"2021","Lewes 011E","E01021082",788,240,171,69,501,186,204,116,54,34,71,49,17,5,38,17,21,2,2,47,8,39
"2021","Lewes 011F","E01021083",559,128,97,31,407,131,213,101,70,42,35,18,14,3,27,13,14,1,1,24,14,10
"2021","Lewes 012A","E01021072",739,206,175,31,503,235,201,91,71,39,42,21,19,2,23,11,12,2,2,30,13,17
"2021","Lewes 012B","E01021073",632,161,126,35,439,140,207,80,77,50,49,29,19,1,42,21,21,1,1,32,12,20
"2021","Lewes 012C","E01021074",767,236,169,67,481,104,200,80,83,37,100,44,49,7,77,43,34,0,0,50,21,29
"2021","Lewes 012D","E01021076",787,246,134,112,495,66,230,73,106,51,86,36,45,5,109,73,36,4,4,46,13,33
"2021","Lewes 012E","E01021078",620,163,116,47,428,180,170,75,71,24,45,18,22,5,29,16,13,4,4,29,14,15
"2021","Lewes 013A","E01021070",830,361,184,177,439,76,180,75,78,27,100,68,28,4,81,51,30,2,2,30,5,25
"2021","Lewes 013B","E01021071",1098,603,290,313,458,86,135,76,41,18,124,81,41,2,108,76,32,5,5,37,7,30
"2021","Lewes 013C","E01021079",788,349,218,131,392,99,165,76,55,34,77,54,21,2,51,22,29,0,0,47,10,37
"2021","Lewes 013D","E01021080",672,225,144,81,419,108,187,70,69,48,69,35,28,6,52,32,20,3,3,28,6,22
"2021","Rother 001A","E01021132",503,125,91,34,343,74,192,62,92,38,43,19,17,7,33,17,16,1,1,35,19,16
"2021","Rother 001B","E01021133",699,199,97,102,467,80,234,90,104,40,74,38,31,5,78,44,34,1,1,33,11,22
"2021","Rother 001C","E01021134",623,148,79,69,440,73,224,90,91,43,72,42,27,3,68,48,20,3,3,35,15,20
"2021","Rother 001D","E01021139",619,199,139,60,405,84,181,60,92,29,62,28,31,3,76,62,14,2,2,15,10,5
"2021","Rother 001E","E01021140",734,189,100,89,510,101,283,116,114,53,78,43,30,5,48,22,26,0,0,35,21,14
"2021","Rother 001F","E01021141",605,139,79,60,439,82,259,91,117,51,50,34,11,5,47,27,20,1,1,27,5,22
"2021","Rother 002A","E01021103",656,201,117,84,408,116,172,88,43,41,63,29,28,6,56,31,25,1,1,47,18,29
"2021","Rother 002B","E01021114",773,204,129,75,529,134,234,112,86,36,83,38,39,6,75,40,35,3,3,40,11,29
"2021","Rother 002C","E01021115",756,226,145,81,499,181,240,130,71,39,44,23,17,4,32,16,16,2,2,31,11,20
"2021","Rother 002D","E01021116",707,221,156,65,448,107,210,96,77,37,69,33,29,7,54,32,22,8,8,38,12,26
"2021","Rother 003A","E01021098",765,213,140,73,516,133,243,107,91,45,74,40,25,9,63,42,21,3,3,36,15,21
"2021","Rother 003B","E01021099",687,148,76,72,494,139,263,113,98,52,66,44,17,5,25,10,15,1,1,45,26,19
"2021","Rother 003C","E01021100",663,156,85,71,463,81,257,101,91,65,65,28,30,7,59,34,25,1,1,44,10,34
"2021","Rother 003D","E01021104",635,154,86,68,436,106,222,110,71,41,70,33,32,5,38,23,15,0,0,45,22,23
"2021","Rother 003E","E01021105",555,158,93,65,364,97,171,71,65,35,42,25,15,2,53,22,31,1,1,33,10,23
"2021","Rother 004A","E01021101",807,288,207,81,468,150,185,86,57,42,76,41,26,9,53,15,38,4,4,51,22,29
"2021","Rother 004B","E01021102",685,246,138,108,393,87,180,86,49,45,66,31,26,9,59,34,25,1,1,46,23,23
"2021","Rother 004C","E01021117",769,289,162,127,445,115,178,96,54,28,90,58,26,6,62,34,28,0,0,35,10,25
"2021","Rother 004D","E01021118",874,306,168,138,525,117,229,121,70,38,98,54,42,2,80,55,25,1,1,43,13,30
"2021","Rother 004E","E01021119",496,188,115,73,284,56,105,34,58,13,38,15,17,6,85,57,28,0,0,24,9,15
"2021","Rother 005A","E01021087",793,194,113,81,541,149,286,128,106,52,65,33,29,3,40,21,19,1,1,58,23,35
"2021","Rother 005B","E01021088",702,170,120,50,495,166,226,92,86,48,62,29,25,8,40,17,23,1,1,37,11,26
"2021","Rother 005C","E01021089",671,183,122,61,451,103,193,73,80,40,68,24,36,8,84,53,31,3,3,37,18,19
"2021","Rother 005D","E01021109",740,192,109,83,491,155,212,99,68,45,76,33,36,7,46,15,31,2,2,57,29,28
"2021","Rother 005E","E01021110",1109,304,234,70,752,275,336,201,66,69,85,56,20,9,55,17,38,1,1,53,20,33
"2021","Rother 006A","E01021084",909,382,231,151,487,87,174,65,88,21,95,50,44,1,128,88,40,3,3,40,14,26
"2021","Rother 006B","E01021085",706,156,83,73,517,117,252,100,112,40,83,43,32,8,61,38,23,4,4,33,14,19
"2021","Rother 006C","E01021086",733,183,125,58,508,117,257,89,123,45,55,22,30,3,75,52,23,4,4,42,23,19
"2021","Rother 006D","E01021096",513,114,63,51,367,79,184,79,73,32,53,27,20,6,47,25,22,4,4,32,12,20
"2021","Rother 006E","E01021097",543,108,67,41,397,93,200,75,81,44,58,30,20,8,41,20,21,5,5,38,16,22
"2021","Rother 007A","E01021111",518,225,157,68,278,72,116,51,42,23,42,28,10,4,46,27,19,2,2,15,5,10
"2021","Rother 007B","E01021113",734,223,120,103,470,65,205,81,94,30,120,56,56,8,79,43,36,1,1,41,17,24
"2021","Rother 007C","E01021131",613,150,69,81,425,32,192,63,88,41,87,43,37,7,113,76,37,1,1,38,21,17
"2021","Rother 007D","E01021135",805,257,99,158,489,43,165,55,78,32,98,34,59,5,178,109,69,5,5,59,39,20
"2021","Rother 007E","E01021136",587,212,103,109,346,32,115,43,43,29,74,25,43,6,121,95,26,4,4,29,17,12
"2021","Rother 007F","E01021137",677,194,95,99,444,68,174,51,82,41,91,32,49,10,108,68,40,3,3,39,15,24
"2021","Rother 008A","E01021112",641,224,146,78,391,105,182,80,66,36,57,32,21,4,44,19,25,3,3,26,8,18
"2021","Rother 008B","E01021120",800,380,316,64,401,155,156,63,64,29,37,20,12,5,52,26,26,1,1,19,6,13
"2021","Rother 008C","E01021126",682,237,104,133,411,90,175,80,65,30,74,44,26,4,66,43,23,6,6,34,15,19
"2021","Rother 008D","E01021127",682,181,111,70,441,108,174,72,60,42,70,32,34,4,86,47,39,3,3,60,28,32
"2021","Rother 008E","E01021128",879,272,170,102,553,157,249,108,95,46,78,44,31,3,67,29,38,2,2,54,22,32
"2021","Rother 009A","E01021093",676,183,141,42,456,198,187,105,49,33,36,28,7,1,33,16,17,2,2,37,10,27
"2021","Rother 009B","E01021095",629,193,147,46,413,216,154,73,44,37,28,13,10,5,13,7,6,2,2,23,7,16
"2021","Rother 009C","E01021123",698,183,129,54,471,194,201,96,64,41,38,24,10,4,36,19,17,2,2,44,18,26
"2021","Rother 009D","E01021124",1026,310,206,104,669,221,287,141,89,57,100,61,34,5,60,37,23,1,1,47,20,27
"2021","Rother 009E","E01021125",558,173,138,35,357,148,143,80,35,28,36,25,8,3,30,11,19,0,0,28,12,16
"2021","Rother 009F","E01021129",799,227,162,65,524,177,247,133,64,50,47,27,16,4,52,22,30,1,1,48,16,32
"2021","Rother 009G","E01021138",482,125,90,35,320,98,129,64,35,30,51,30,15,6,40,16,24,2,2,37,17,20
"2021","Rother 010A","E01021094",815,383,289,94,408,161,160,95,34,31,45,35,8,2,40,20,20,2,2,24,8,16
"2021","Rother 010B","E01021106",936,388,301,87,523,254,170,85,45,40,42,27,14,1,54,27,27,3,3,25,8,17
"2021","Rother 010C","E01021107",733,217,178,39,484,218,205,102,57,46,37,20,12,5,23,12,11,1,1,32,7,25
"2021","Rother 010D","E01021108",630,175,97,78,422,80,189,72,70,47,79,41,32,6,72,43,29,2,2,33,13,20
"2021","Rother 010E","E01021130",681,218,131,87,426,113,193,80,60,53,63,45,17,1,53,23,30,4,4,37,17,20
"2021","Rother 011A","E01021090",800,340,125,215,404,40,124,49,58,17,122,69,49,4,115,85,30,3,3,56,20,36
"2021","Rother 011B","E01021091",1098,536,260,276,512,67,167,93,53,21,132,79,44,9,138,96,42,8,8,50,20,30
"2021","Rother 011C","E01021092",1197,661,337,324,496,125,145,76,55,14,93,51,38,4,126,80,46,7,7,40,17,23
"2021","Rother 011D","E01021121",812,361,222,139,407,101,159,83,51,25,72,48,15,9,68,39,29,7,7,44,16,28
"2021","Rother 011E","E01021122",866,493,268,225,337,71,106,70,19,17,66,41,19,6,87,55,32,7,7,36,7,29
"2021","Wealden 001A","E01021167",991,325,185,140,606,95,296,92,139,65,79,36,36,7,134,86,48,2,2,60,26,34
"2021","Wealden 001B","E01021168",663,154,96,58,465,103,246,59,128,59,47,27,18,2,66,39,27,3,3,44,22,22
"2021","Wealden 001C","E01021169",509,123,65,58,337,69,185,73,70,42,43,26,14,3,38,22,16,2,2,49,20,29
"2021","Wealden 001D","E01021186",518,124,68,56,362,84,191,69,86,36,46,21,19,6,40,17,23,1,1,32,15,17
"2021","Wealden 002A","E01021171",832,196,114,82,597,121,342,124,172,46,83,47,30,6,48,25,23,3,3,39,12,27
"2021","Wealden 002B","E01021172",724,188,107,81,500,89,281,95,144,42,75,46,24,5,52,24,28,3,3,36,14,22
"2021","Wealden 002C","E01021173",578,124,60,64,418,77,254,100,98,56,57,28,19,10,26,12,14,4,4,36,17,19
"2021","Wealden 002D","E01021218",492,108,65,43,360,95,194,83,80,31,40,18,21,1,29,14,15,2,2,24,10,14
"2021","Wealden 003A","E01021156",864,293,195,98,536,121,256,82,125,49,71,43,25,3,86,62,24,2,2,35,16,19
"2021","Wealden 003B","E01021157",733,154,106,48,539,152,270,104,111,55,46,13,23,10,64,32,32,7,7,40,15,25
"2021","Wealden 003C","E01021158",895,187,110,77,665,138,353,102,181,70,95,46,44,5,75,49,26,4,4,43,23,20
"2021","Wealden 004A","E01021159",994,233,180,53,722,232,390,177,129,84,58,29,27,2,39,24,15,3,3,39,8,31
"2021","Wealden 004B","E01021160",766,281,165,116,444,138,196,68,90,38,65,42,18,5,42,28,14,3,3,41,16,25
"2021","Wealden 004C","E01021161",707,178,84,94,504,90,246,95,117,34,94,52,36,6,72,39,33,2,2,25,9,16
"2021","Wealden 004D","E01021162",634,117,76,41,484,167,247,101,96,50,34,19,11,4,35,11,24,1,1,33,17,16
"2021","Wealden 005A","E01021202",544,207,145,62,323,86,161,63,73,25,41,27,10,4,35,17,18,0,0,14,4,10
"2021","Wealden 005B","E01021203",650,147,90,57,464,109,278,122,114,42,36,12,22,2,39,22,17,2,2,39,16,23
"2021","Wealden 005C","E01021229",754,192,103,89,529,124,285,119,122,44,61,35,23,3,56,26,30,3,3,33,13,20
"2021","Wealden 005D","E01021230",707,138,79,59,541,109,328,124,151,53,63,46,10,7,41,19,22,0,0,28,12,16
"2021","Wealden 005E","E01021231",808,289,176,113,506,104,257,103,109,45,68,35,31,2,75,44,31,2,2,13,2,11
"2021","Wealden 006A","E01021151",740,158,85,73,538,93,324,106,157,61,66,35,21,10,52,17,35,3,3,44,17,27
"2021","Wealden 006B","E01021152",582,144,75,69,407,49,194,61,102,31,82,36,35,11,79,47,32,3,3,31,11,20
"2021","Wealden 006C","E01021153",894,296,149,147,565,81,293,90,150,53,104,64,38,2,83,49,34,4,4,33,11,22
"2021","Wealden 006D","E01021154",621,180,88,92,415,61,195,61,93,41,86,44,37,5,72,42,30,1,1,26,7,19
"2021","Wealden 006E","E01021155",513,119,35,84,368,45,188,74,83,31,75,51,19,5,54,30,24,6,6,26,8,18
"2021","Wealden 007A","E01021163",810,171,117,54,583,149,338,145,129,64,58,36,18,4,36,13,23,2,2,56,23,33
"2021","Wealden 007B","E01021164",756,200,101,99,505,103,280,107,127,46,67,33,30,4,50,26,24,5,5,51,14,37
"2021","Wealden 007C","E01021187",584,133,72,61,411,103,232,94,88,50,47,31,8,8,28,12,16,1,1,40,13,27
"2021","Wealden 008A","E01021144",705,147,91,56,510,121,293,131,115,47,65,38,17,10,29,14,15,2,2,48,21,27
"2021","Wealden 008B","E01021145",901,232,131,101,627,146,330,123,151,56,90,43,43,4,56,33,23,5,5,42,15,27
"2021","Wealden 008C","E01021170",1148,244,146,98,854,209,476,207,173,96,105,58,41,6,61,27,34,3,3,50,20,30
"2021","Wealden 008D","E01021217",563,153,101,52,378,88,210,94,67,49,39,24,13,2,41,24,17,0,0,32,11,21
"2021","Wealden 009A","E01021219",543,113,83,30,405,104,223,92,100,31,34,20,12,2,44,16,28,0,0,25,13,12
"2021","Wealden 009B","E01021220",818,372,247,125,413,99,188,75,83,30,66,40,22,4,53,32,21,7,7,33,12,21
"2021","Wealden 009C","E01021223",480,146,70,76,306,42,177,72,71,34,50,32,16,2,37,22,15,0,0,28,13,15
"2021","Wealden 009D","E01021224",657,210,118,92,415,51,189,52,92,45,74,35,31,8,96,61,35,5,5,32,13,19
"2021","Wealden 009E","E01021225",681,165,97,68,489,87,227,82,110,35,95,49,38,8,76,41,35,4,4,27,13,14
"2021","Wealden 009F","E01021226",525,123,51,72,372,33,198,72,98,28,82,41,36,5,59,40,19,0,0,30,12,18
"2021","Wealden 010A","E01021150",573,120,67,53,412,92,226,90,98,38,51,25,25,1,42,30,12,1,1,41,15,26
"2021","Wealden 010B","E01021191",869,386,225,161,461,130,192,87,66,39,81,57,21,3,55,28,27,3,3,22,6,16
"2021","Wealden 010C","E01021192",665,178,90,88,461,96,242,88,101,53,66,36,24,6,56,31,25,1,1,26,14,12
"2021","Wealden 010D","E01021193",794,272,137,135,490,82,232,78,114,40,100,58,35,7,73,40,33,3,3,32,12,20
"2021","Wealden 010E","E01021194",669,161,98,63,480,77,289,87,148,54,63,31,27,5,49,28,21,2,2,28,12,16
"2021","Wealden 011A","E01021149",589,168,105,63,390,82,205,89,75,41,58,32,24,2,43,25,18,2,2,31,11,20
"2021","Wealden 011B","E01021189",550,111,63,48,403,97,218,96,78,44,55,33,18,4,31,14,17,2,2,36,16,20
"2021","Wealden 011C","E01021190",655,176,96,80,460,118,222,97,83,42,73,47,24,2,44,23,21,3,3,19,12,7
"2021","Wealden 011D","E01021200",634,211,112,99,398,65,198,70,92,36,75,36,36,3,60,30,30,0,0,25,8,17
"2021","Wealden 011E","E01021201",662,149,94,55,484,102,278,96,127,55,64,34,25,5,38,21,17,2,2,29,11,18
"2021","Wealden 012A","E01021221",573,187,67,120,361,46,171,63,78,30,72,50,20,2,67,39,28,5,5,25,8,17
"2021","Wealden 012B","E01021222",704,265,120,145,402,45,187,64,88,35,99,60,37,2,70,42,28,1,1,37,9,28
"2021","Wealden 012C","E01021227",779,143,62,81,606,94,325,107,162,56,95,49,40,6,89,55,34,3,3,30,12,18
"2021","Wealden 012D","E01021228",693,153,76,77,516,75,296,104,122,70,76,40,31,5,69,40,29,0,0,24,5,19
"2021","Wealden 013A","E01021146",924,203,123,80,685,159,347,150,137,60,95,39,50,6,81,55,26,3,3,36,15,21
"2021","Wealden 013B","E01021147",687,173,86,87,464,100,264,121,78,65,67,41,22,4,33,17,16,0,0,50,17,33
"2021","Wealden 013C","E01021148",611,147,79,68,432,86,219,91,89,39,79,39,34,6,47,29,18,1,1,32,12,20
"2021","Wealden 013D","E01021165",524,104,56,48,388,84,220,96,88,36,45,30,13,2,39,24,15,0,0,32,12,20
"2021","Wealden 014A","E01021188",477,114,66,48,331,84,191,91,64,36,32,23,8,1,23,10,13,1,1,32,18,14
"2021","Wealden 014B","E01021198",694,194,113,81,463,80,211,79,86,46,98,51,42,5,71,56,15,3,3,37,12,25
"2021","Wealden 014C","E01021199",591,158,100,58,396,118,200,101,56,43,47,26,18,3,29,15,14,2,2,37,15,22
"2021","Wealden 014D","E01021204",494,115,69,46,358,84,174,61,73,40,47,22,21,4,51,33,18,2,2,21,6,15
"2021","Wealden 014E","E01021205",506,100,65,35,376,102,195,80,69,46,47,27,16,4,30,15,15,2,2,30,12,18
"2021","Wealden 015A","E01021174",855,189,109,80,624,116,319,106,153,60,114,63,44,7,72,41,31,3,3,42,15,27
"2021","Wealden 015B","E01021175",627,167,105,62,442,113,218,79,97,42,65,37,22,6,46,24,22,0,0,18,8,10
"2021","Wealden 015C","E01021176",677,242,193,49,405,100,179,68,70,41,75,43,28,4,51,28,23,0,0,30,13,17
"2021","Wealden 015D","E01021177",745,312,157,155,403,76,166,80,62,24,87,55,32,0,68,42,26,6,6,30,9,21
"2021","Wealden 016A","E01021180",608,155,96,59,419,101,185,78,69,38,77,50,20,7,55,33,22,1,1,34,9,25
"2021","Wealden 016B","E01021181",601,152,89,63,425,73,222,79,96,47,72,36,33,3,56,38,18,2,2,24,11,13
"2021","Wealden 016C","E01021182",722,270,200,70,417,111,214,75,92,47,48,24,21,3,42,17,25,2,2,35,18,17
"2021","Wealden 016D","E01021183",538,154,74,80,351,39,137,48,61,28,66,25,32,9,108,81,27,1,1,33,10,23
"2021","Wealden 017A","E01021178",694,182,95,87,478,78,184,69,82,33,99,47,48,4,115,85,30,2,2,34,13,21
"2021","Wealden 017B","E01021179",702,229,108,121,433,50,175,54,81,40,88,33,49,6,113,78,35,7,7,40,18,22
"2021","Wealden 017C","E01021184",697,226,125,101,437,103,211,93,70,48,72,40,28,4,44,17,27,7,7,34,13,21
"2021","Wealden 017D","E01021185",634,210,114,96,398,47,172,76,69,27,81,34,43,4,90,51,39,8,8,26,11,15
"2021","Wealden 018A","E01021142",617,240,199,41,357,184,127,77,33,17,31,23,6,2,15,6,9,0,0,20,6,14
"2021","Wealden 018B","E01021143",555,182,113,69,349,106,155,71,62,22,63,39,21,3,25,14,11,0,0,24,9,15
"2021","Wealden 018C","E01021166",1038,286,180,106,699,265,327,170,96,61,62,38,17,7,43,23,20,2,2,53,22,31
"2021","Wealden 018E","E01021196",873,227,138,89,610,127,300,115,140,45,89,43,39,7,92,45,47,2,2,36,18,18
"2021","Wealden 018G","E01034299",656,182,123,59,435,121,198,94,62,42,70,41,26,3,42,15,27,4,4,39,14,25
"2021","Wealden 018H","E01034300",571,109,18,91,423,24,199,61,119,19,107,57,46,4,91,73,18,2,2,39,17,22
"2021","Wealden 018I","E01034301",453,73,16,57,363,44,149,48,88,13,97,55,41,1,73,61,12,0,0,17,10,7
"2021","Wealden 018J","E01034302",712,146,61,85,517,54,290,101,145,44,93,48,39,6,76,45,31,4,4,49,19,30
"2021","Wealden 018K","E01034303",413,91,48,43,292,60,153,63,54,36,42,27,14,1,35,21,14,2,2,30,9,21
"2021","Wealden 019B","E01021213",862,310,126,184,518,75,226,92,95,39,113,64,44,5,98,73,25,6,6,34,16,18
"2021","Wealden 019C","E01021214",819,298,201,97,492,127,205,86,73,46,85,51,32,2,73,43,30,2,2,29,13,16
"2021","Wealden 019D","E01021215",634,227,163,64,387,110,177,69,76,32,48,37,10,1,46,28,18,6,6,20,7,13
"2021","Wealden 019E","E01021216",500,134,86,48,340,67,158,83,48,27,56,25,25,6,56,27,29,3,3,26,12,14
"2021","Wealden 019F","E01034304",663,218,140,78,421,113,201,94,67,40,58,36,20,2,46,19,27,3,3,24,7,17
"2021","Wealden 019G","E01034305",736,160,58,102,538,54,249,65,159,25,126,54,67,5,104,68,36,5,5,38,20,18
"2021","Wealden 020A","E01021206",716,231,171,60,449,113,225,106,82,37,56,35,17,4,54,21,33,1,1,36,13,23
"2021","Wealden 020B","E01021207",652,201,120,81,415,99,197,106,51,40,71,43,23,5,47,25,22,1,1,36,13,23
"2021","Wealden 020C","E01021208",1006,175,84,91,783,103,398,122,205,71,161,64,90,7,115,84,31,6,6,48,24,24
"2021","Wealden 020D","E01021209",996,219,125,94,723,173,337,124,155,58,126,70,50,6,81,44,37,6,6,54,24,30
"2021","Wealden 020E","E01021210",605,92,50,42,479,60,283,91,132,60,75,33,37,5,60,34,26,1,1,34,16,18
"2021","Wealden 020F","E01021211",798,322,216,106,442,163,169,87,46,36,54,39,10,5,53,27,26,3,3,34,4,30
"2021","Wealden 021A","E01021232",819,286,195,91,503,142,219,94,88,37,81,42,35,4,58,32,26,3,3,30,8,22
"2021","Wealden 021B","E01021233",649,176,127,49,439,116,214,80,87,47,60,27,29,4,46,21,25,3,3,34,18,16
"2021","Wealden 021C","E01021234",662,181,132,49,462,153,220,91,89,40,57,41,10,6,32,14,18,0,0,19,8,11
"2021","Wealden 021D","E01021235",638,194,136,58,422,157,203,103,62,38,46,29,12,5,15,4,11,1,1,22,11,11
"2021","Wealden 021E","E01021236",731,243,161,82,459,108,223,92,69,62,64,36,22,6,62,32,30,2,2,29,10,19
"2021","Basingstoke and Deane 001A","E01022553",612,169,98,71,420,97,209,76,87,46,80,54,24,2,31,16,15,3,3,23,11,12
"2021","Basingstoke and Deane 001B","E01022554",720,165,92,73,521,77,273,81,136,56,77,43,30,4,94,48,46,0,0,34,14,20
"2021","Basingstoke and Deane 001C","E01022555",623,190,103,87,395,70,201,72,88,41,72,29,38,5,48,25,23,4,4,38,13,25
"2021","Basingstoke and Deane 001D","E01022556",769,228,101,127,513,45,253,76,128,49,91,43,45,3,122,81,41,2,2,28,9,19
"2021","Basingstoke and Deane 001E","E01022560",489,125,56,69,341,59,180,64,88,28,70,29,34,7,31,15,16,1,1,23,12,11
"2021","Basingstoke and Deane 002A","E01022493",545,121,69,52,393,81,231,83,109,39,59,35,20,4,19,9,10,3,3,31,16,15
"2021","Basingstoke and Deane 002B","E01022536",569,130,86,44,408,117,221,93,86,42,38,20,12,6,29,11,18,3,3,31,13,18
"2021","Basingstoke and Deane 002C","E01022537",552,133,90,43,398,121,214,71,95,48,41,28,12,1,22,11,11,0,0,21,7,14
"2021","Basingstoke and Deane 002D","E01022557",623,166,79,87,427,76,212,66,109,37,75,37,36,2,56,33,23,8,8,30,11,19
"2021","Basingstoke and Deane 002E","E01022558",587,223,66,157,333,29,170,65,77,28,84,59,24,1,48,27,21,2,2,31,11,20
"2021","Basingstoke and Deane 002F","E01022559",521,125,73,52,369,79,215,95,70,50,52,28,18,6,21,12,9,2,2,27,14,13
"2021","Basingstoke and Deane 003A","E01022488",544,104,40,64,406,53,210,79,96,35,78,39,32,7,63,38,25,2,2,34,9,25
"2021","Basingstoke and Deane 003B","E01022489",595,123,67,56,435,98,242,99,97,46,55,33,16,6,37,13,24,3,3,37,15,22
"2021","Basingstoke and Deane 003C","E01022499",620,117,80,37,486,100,317,97,177,43,40,21,16,3,29,18,11,0,0,17,7,10
"2021","Basingstoke and Deane 003D","E01022500",547,104,51,53,416,87,235,107,93,35,56,32,21,3,38,23,15,0,0,27,10,17
"2021","Basingstoke and Deane 003E","E01022513",613,90,59,31,472,104,270,94,120,56,50,29,20,1,47,26,21,1,1,51,20,31
"2021","Basingstoke and Deane 004A","E01022472",509,112,59,53,369,84,215,79,89,47,46,31,10,5,23,13,10,1,1,28,12,16
"2021","Basingstoke and Deane 004B","E01022473",509,126,63,63,355,56,200,74,86,40,46,21,21,4,49,24,25,4,4,28,9,19
"2021","Basingstoke and Deane 004C","E01022520",790,262,129,133,485,65,249,109,99,41,92,57,30,5,74,49,25,5,5,43,14,29
"2021","Basingstoke and Deane 004D","E01022521",728,219,135,84,480,118,249,110,105,34,72,53,13,6,41,16,25,0,0,29,11,18
"2021","Basingstoke and Deane 004E","E01022522",686,126,60,66,521,87,332,139,148,45,67,27,34,6,33,23,10,2,2,39,8,31
"2021","Basingstoke and Deane 005A","E01022490",747,193,94,99,514,67,316,122,154,40,72,45,24,3,54,28,26,5,5,40,19,21
"2021","Basingstoke and Deane 005B","E01022491",794,157,48,109,601,49,335,107,177,51,120,63,52,5,93,72,21,4,4,36,16,20
"2021","Basingstoke and Deane 005C","E01022492",631,159,81,78,442,89,253,107,104,42,70,50,18,2,27,14,13,3,3,30,11,19
"2021","Basingstoke and Deane 005E","E01022547",760,168,96,72,570,137,320,135,135,50,67,39,22,6,44,17,27,2,2,22,8,14
"2021","Basingstoke and Deane 005F","E01034708",514,75,30,45,425,44,229,80,119,30,102,63,36,3,48,31,17,2,2,14,4,10
"2021","Basingstoke and Deane 005G","E01034709",528,131,25,106,385,18,175,71,94,10,135,86,45,4,53,44,9,4,4,12,7,5
"2021","Basingstoke and Deane 005H","E01034710",505,67,15,52,421,15,214,67,135,12,121,77,42,2,67,57,10,4,4,17,9,8
"2021","Basingstoke and Deane 006A","E01022495",651,176,41,135,456,32,231,90,109,32,132,94,34,4,57,41,16,4,4,19,8,11
"2021","Basingstoke and Deane 006C","E01022497",595,175,60,115,409,46,228,78,115,35,96,71,20,5,36,24,12,3,3,11,4,7
"2021","Basingstoke and Deane 006D","E01022498",657,185,56,129,441,62,248,81,125,42,88,59,26,3,43,34,9,0,0,31,12,19
"2021","Basingstoke and Deane 006E","E01034711",689,178,42,136,479,33,260,89,153,18,107,76,31,0,76,56,20,3,3,32,10,22
"2021","Basingstoke and Deane 006F","E01034712",724,119,37,82,576,38,391,124,206,61,87,50,36,1,58,41,17,2,2,29,14,15
"2021","Basingstoke and Deane 007B","E01022539",484,115,42,73,330,49,150,41,79,30,66,31,29,6,63,34,29,2,2,39,16,23
"2021","Basingstoke and Deane 007C","E01022540",952,219,59,160,644,39,298,77,173,48,154,89,57,8,142,96,46,11,11,89,42,47
"2021","Basingstoke and Deane 007E","E01022542",448,105,53,52,295,32,134,39,68,27,42,12,26,4,79,45,34,8,8,48,21,27
"2021","Basingstoke and Deane 007F","E01022543",633,175,52,123,385,32,186,40,100,46,82,37,37,8,77,48,29,8,8,73,29,44
"2021","Basingstoke and Deane 007H","E01032843",770,190,20,170,536,12,273,99,157,17,150,89,55,6,93,66,27,8,8,44,14,30
"2021","Basingstoke and Deane 007I","E01032844",1156,319,108,211,746,38,367,95,241,31,191,105,84,2,138,99,39,12,12,91,45,46
"2021","Basingstoke and Deane 007K","E01034713",622,156,33,123,431,31,199,59,109,31,136,86,44,6,60,40,20,5,5,35,11,24
"2021","Basingstoke and Deane 007L","E01034714",709,213,58,155,441,21,188,47,111,30,96,42,50,4,132,109,23,4,4,55,24,31
"2021","Basingstoke and Deane 008A","E01022470",805,230,96,134,554,80,347,130,158,59,90,53,32,5,34,23,11,3,3,21,8,13
"2021","Basingstoke and Deane 008B","E01022471",617,138,52,86,472,73,296,107,126,63,61,44,16,1,41,20,21,1,1,7,3,4
"2021","Basingstoke and Deane 008C","E01022494",1043,301,96,205,687,67,364,122,191,51,159,95,56,8,93,55,38,4,4,55,19,36
"2021","Basingstoke and Deane 008D","E01022523",925,217,63,154,596,27,248,66,134,48,139,50,76,13,169,107,62,13,13,112,40,72
"2021","Basingstoke and Deane 009A","E01022524",743,216,83,133,438,35,190,65,86,39,92,42,39,11,118,71,47,3,3,89,33,56
"2021","Basingstoke and Deane 009B","E01022525",646,166,86,80,425,63,240,71,118,51,72,47,21,4,46,20,26,4,4,55,24,31
"2021","Basingstoke and Deane 009D","E01022527",755,293,134,159,417,45,182,68,79,35,86,49,30,7,97,64,33,7,7,45,15,30
"2021","Basingstoke and Deane 009E","E01034715",655,157,63,94,445,33,232,64,109,59,74,36,34,4,99,58,41,7,7,53,21,32
"2021","Basingstoke and Deane 009F","E01034716",626,232,14,218,369,8,172,56,103,13,133,94,36,3,49,33,16,7,7,25,11,14
"2021","Basingstoke and Deane 010B","E01022566",477,82,46,36,366,72,202,73,85,44,43,12,30,1,48,23,25,1,1,29,11,18
"2021","Basingstoke and Deane 010C","E01022567",505,137,64,73,318,33,149,31,74,44,54,15,35,4,78,47,31,4,4,50,16,34
"2021","Basingstoke and Deane 010D","E01022568",614,204,84,120,370,48,160,59,67,34,65,36,24,5,95,48,47,2,2,40,18,22
"2021","Basingstoke and Deane 010E","E01022570",629,147,77,70,447,95,239,92,102,45,66,31,27,8,44,14,30,3,3,35,11,24
"2021","Basingstoke and Deane 010G","E01032841",1108,288,42,246,743,30,379,114,226,39,232,165,64,3,91,73,18,11,11,77,26,51
"2021","Basingstoke and Deane 010H","E01034717",473,194,11,183,252,4,131,34,84,13,70,28,39,3,44,39,5,3,3,27,7,20
"2021","Basingstoke and Deane 010I","E01034718",787,149,9,140,560,3,291,74,193,24,151,86,56,9,106,81,25,9,9,78,30,48
"2021","Basingstoke and Deane 011B","E01022502",688,208,88,120,430,51,220,68,101,51,98,72,23,3,48,21,27,13,13,50,15,35
"2021","Basingstoke and Deane 011C","E01022506",594,197,70,127,370,54,181,67,85,29,84,58,21,5,50,23,27,1,1,27,9,18
"2021","Basingstoke and Deane 011D","E01022507",679,228,66,162,407,45,219,74,109,36,73,50,18,5,61,33,28,9,9,44,16,28
"2021","Basingstoke and Deane 011E","E01032842",723,330,14,316,336,7,200,66,130,4,99,92,7,0,21,16,5,9,9,57,14,43
"2021","Basingstoke and Deane 011F","E01032847",1102,554,157,397,496,40,202,91,81,30,174,148,26,0,73,39,34,7,7,52,8,44
"2021","Basingstoke and Deane 012A","E01022481",769,194,103,91,483,74,236,68,114,54,79,54,21,4,83,47,36,11,11,92,43,49
"2021","Basingstoke and Deane 012B","E01022482",707,288,133,155,353,41,158,42,81,35,74,43,27,4,76,53,23,4,4,66,32,34
"2021","Basingstoke and Deane 012D","E01022503",830,299,85,214,464,44,216,91,98,27,137,105,30,2,56,32,24,11,11,67,7,60
"2021","Basingstoke and Deane 012E","E01032845",751,227,51,176,456,30,227,70,121,36,117,74,38,5,77,48,29,5,5,68,20,48
"2021","Basingstoke and Deane 012F","E01032846",799,283,27,256,452,11,239,72,153,14,131,104,24,3,59,42,17,12,12,64,14,50
"2021","Basingstoke and Deane 013A","E01022484",520,120,53,67,356,21,130,26,69,35,89,29,53,7,113,82,31,3,3,44,20,24
"2021","Basingstoke and Deane 013B","E01022485",459,118,36,82,301,29,116,29,67,20,80,29,41,10,71,47,24,5,5,40,16,24
"2021","Basingstoke and Deane 013C","E01022486",812,165,40,125,584,48,320,102,167,51,122,63,49,10,90,65,25,4,4,63,30,33
"2021","Basingstoke and Deane 013D","E01022487",484,113,51,62,316,28,121,43,57,21,83,31,43,9,80,54,26,4,4,55,20,35
"2021","Basingstoke and Deane 013E","E01022569",600,133,71,62,426,88,206,75,97,34,79,44,31,4,51,26,25,2,2,41,16,25
"2021","Basingstoke and Deane 014A","E01022548",612,185,107,78,392,80,166,60,73,33,76,30,37,9,60,29,31,10,10,35,14,21
"2021","Basingstoke and Deane 014B","E01022549",760,302,114,188,417,32,176,62,74,40,88,42,42,4,115,80,35,6,6,41,16,25
"2021","Basingstoke and Deane 014C","E01022550",764,251,101,150,467,62,189,66,92,31,104,43,51,10,103,63,40,9,9,46,16,30
"2021","Basingstoke and Deane 014D","E01022551",658,206,94,112,404,60,186,77,74,35,91,49,31,11,65,32,33,2,2,48,20,28
"2021","Basingstoke and Deane 014E","E01022552",616,147,51,96,413,28,199,62,94,43,75,30,42,3,101,63,38,10,10,56,27,29
"2021","Basingstoke and Deane 015A","E01022528",513,90,62,28,403,100,227,86,98,43,43,25,14,4,30,15,15,3,3,20,8,12
"2021","Basingstoke and Deane 015B","E01022529",679,210,113,97,441,97,235,99,98,38,63,38,22,3,43,23,20,3,3,28,13,15
"2021","Basingstoke and Deane 015C","E01022530",589,116,87,29,440,136,230,75,118,37,44,29,15,0,29,15,14,1,1,33,17,16
"2021","Basingstoke and Deane 015D","E01022531",601,120,80,40,459,140,229,84,84,61,51,25,23,3,39,19,20,0,0,22,12,10
"2021","Basingstoke and Deane 016A","E01022475",728,230,59,171,470,39,251,99,111,41,110,68,41,1,66,40,26,4,4,28,5,23
"2021","Basingstoke and Deane 016B","E01022476",694,161,63,98,477,50,269,89,125,55,80,46,29,5,72,39,33,6,6,56,15,41
"2021","Basingstoke and Deane 016C","E01022480",498,108,51,57,356,29,185,52,91,42,70,29,34,7,65,40,25,7,7,34,18,16
"2021","Basingstoke and Deane 016D","E01022504",673,169,88,81,466,118,221,74,100,47,84,47,31,6,39,18,21,4,4,38,8,30
"2021","Basingstoke and Deane 016E","E01022505",741,225,83,142,469,78,257,85,123,49,81,48,25,8,47,26,21,6,6,47,20,27
"2021","Basingstoke and Deane 017A","E01022467",682,164,100,64,496,122,291,110,132,49,51,28,21,2,32,17,15,0,0,22,4,18
"2021","Basingstoke and Deane 017B","E01022468",786,239,122,117,520,128,266,103,106,57,75,49,25,1,43,23,20,8,8,27,13,14
"2021","Basingstoke and Deane 017C","E01022469",667,193,127,66,449,89,270,104,116,50,45,25,20,0,45,19,26,0,0,25,9,16
"2021","Basingstoke and Deane 017D","E01022561",618,144,81,63,451,79,282,120,112,50,54,33,14,7,35,21,14,1,1,23,10,13
"2021","Basingstoke and Deane 017E","E01022562",583,114,60,54,443,107,260,121,105,34,37,24,11,2,38,19,19,1,1,26,11,15
"2021","Basingstoke and Deane 018A","E01022515",651,216,172,44,410,164,193,98,47,48,31,14,14,3,22,8,14,0,0,25,9,16
"2021","Basingstoke and Deane 018B","E01022516",619,151,115,36,443,124,246,75,114,57,48,16,26,6,23,8,15,2,2,25,14,11
"2021","Basingstoke and Deane 018C","E01022517",487,78,66,12,385,103,231,94,100,37,31,14,16,1,20,10,10,0,0,24,10,14
"2021","Basingstoke and Deane 018D","E01022518",748,144,75,69,575,113,363,108,178,77,58,31,21,6,39,23,16,2,2,29,8,21
"2021","Basingstoke and Deane 018E","E01022519",509,93,73,20,395,113,223,77,87,59,30,15,12,3,28,10,18,1,1,21,11,10
"2021","Basingstoke and Deane 019A","E01022474",732,233,107,126,452,47,192,51,91,50,82,32,43,7,125,86,39,6,6,47,17,30
"2021","Basingstoke and Deane 019B","E01022477",639,232,71,161,378,37,182,58,92,32,95,61,26,8,57,41,16,7,7,29,10,19
"2021","Basingstoke and Deane 019C","E01022478",631,198,71,127,398,27,181,68,77,36,83,32,43,8,104,64,40,3,3,35,10,25
"2021","Basingstoke and Deane 019D","E01022479",601,175,98,77,365,29,168,51,81,36,72,32,38,2,93,53,40,3,3,61,26,35
"2021","Basingstoke and Deane 019E","E01022509",585,133,49,84,435,48,239,83,121,35,106,72,29,5,40,15,25,2,2,17,6,11
"2021","Basingstoke and Deane 020A","E01022514",700,182,96,86,471,97,271,115,109,47,69,39,29,1,31,17,14,3,3,47,15,32
"2021","Basingstoke and Deane 020B","E01022563",744,172,94,78,539,103,311,120,143,48,73,40,29,4,51,20,31,1,1,33,10,23
"2021","Basingstoke and Deane 020C","E01022564",911,277,130,147,604,84,338,107,184,47,112,63,46,3,68,42,26,2,2,30,8,22
"2021","Basingstoke and Deane 020D","E01022565",832,263,109,154,542,78,268,86,145,37,125,71,51,3,69,49,20,2,2,27,11,16
"2021","Basingstoke and Deane 021B","E01022510",599,96,29,67,474,41,319,108,143,68,73,39,32,2,40,19,21,1,1,29,13,16
"2021","Basingstoke and Deane 021C","E01022511",448,66,24,42,365,42,258,77,124,57,46,25,18,3,17,9,8,2,2,17,7,10
"2021","Basingstoke and Deane 021D","E01022512",473,58,15,43,395,33,298,101,135,62,43,22,19,2,21,13,8,0,0,20,12,8
"2021","Basingstoke and Deane 021E","E01032848",632,128,22,106,477,12,267,67,184,16,92,51,38,3,100,74,26,6,6,27,15,12
"2021","Basingstoke and Deane 021F","E01032849",578,117,24,93,432,14,243,75,130,38,102,46,52,4,70,49,21,3,3,29,12,17
"2021","Basingstoke and Deane 021G","E01032850",599,176,44,132,404,40,240,80,134,26,78,58,19,1,46,29,17,0,0,19,8,11
"2021","Basingstoke and Deane 022A","E01022532",903,165,61,104,706,85,393,131,205,57,163,95,58,10,60,44,16,5,5,32,6,26
"2021","Basingstoke and Deane 022B","E01022533",704,156,78,78,512,95,303,116,143,44,62,39,19,4,51,33,18,1,1,36,15,21
"2021","Basingstoke and Deane 022C","E01022534",846,248,133,115,570,115,287,88,153,46,103,55,42,6,65,33,32,0,0,28,9,19
"2021","Basingstoke and Deane 022D","E01022535",739,246,134,112,475,107,232,82,112,38,78,50,25,3,57,28,29,1,1,18,5,13
"2021","East Hampshire 001A","E01022581",673,133,58,75,508,88,282,96,154,32,76,40,34,2,60,37,23,2,2,32,11,21
"2021","East Hampshire 001B","E01022582",592,115,75,40,453,97,274,108,130,36,45,20,20,5,37,19,18,0,0,24,10,14
"2021","East Hampshire 001C","E01022604",568,118,72,46,421,88,249,105,102,42,45,25,18,2,36,15,21,3,3,29,15,14
"2021","East Hampshire 001D","E01022605",830,210,96,114,585,102,321,110,161,50,84,64,19,1,73,45,28,5,5,35,11,24
"2021","East Hampshire 002A","E01022574",737,300,154,146,403,61,188,63,88,37,85,64,17,4,66,46,20,3,3,34,12,22
"2021","East Hampshire 002B","E01022575",587,142,59,83,410,29,186,56,91,39,75,31,34,10,117,72,45,3,3,35,14,21
"2021","East Hampshire 002C","E01022576",891,492,240,252,364,58,133,51,53,29,97,77,16,4,73,48,25,3,3,35,8,27
"2021","East Hampshire 002D","E01022579",761,183,76,107,544,49,257,72,148,37,115,60,51,4,112,78,34,11,11,34,14,20
"2021","East Hampshire 003A","E01022571",462,98,56,42,342,75,178,72,76,30,60,34,26,0,26,13,13,3,3,22,10,12
"2021","East Hampshire 003B","E01022572",507,122,62,60,361,71,188,75,76,37,47,26,19,2,54,21,33,1,1,24,8,16
"2021","East Hampshire 003C","E01022573",1079,347,134,213,694,168,378,142,160,76,93,64,24,5,49,25,24,6,6,38,10,28
"2021","East Hampshire 003D","E01022577",756,324,193,131,422,80,198,81,86,31,82,62,17,3,57,31,26,5,5,10,4,6
"2021","East Hampshire 003F","E01022580",494,120,61,59,350,71,190,62,83,45,52,36,13,3,36,18,18,1,1,24,8,16
"2021","East Hampshire 003G","E01034719",717,164,92,72,528,132,262,85,125,52,74,39,32,3,59,34,25,1,1,25,12,13
"2021","East Hampshire 003H","E01034720",684,194,96,98,457,59,241,63,141,37,61,26,31,4,92,51,41,4,4,33,13,20
"2021","East Hampshire 004A","E01022603",537,110,45,65,391,39,214,87,91,36,71,31,33,7,64,36,28,3,3,36,11,25
"2021","East Hampshire 004B","E01022634",516,200,92,108,291,36,155,58,71,26,65,40,24,1,34,16,18,1,1,25,11,14
"2021","East Hampshire 004C","E01022639",641,134,25,109,461,19,206,57,120,29,144,89,51,4,82,59,23,10,10,46,17,29
"2021","East Hampshire 004D","E01022640",1059,198,40,158,817,28,426,140,246,40,228,127,93,8,125,85,40,10,10,44,16,28
"2021","East Hampshire 006A","E01022615",1143,288,133,155,793,124,422,166,172,84,148,73,68,7,93,57,36,6,6,62,19,43
"2021","East Hampshire 006B","E01022633",604,226,83,143,357,35,182,76,82,24,92,66,24,2,45,25,20,3,3,21,7,14
"2021","East Hampshire 006C","E01022635",525,99,42,57,388,41,187,60,82,45,77,24,49,4,82,46,36,1,1,38,16,22
"2021","East Hampshire 006D","E01022636",524,116,56,60,363,37,204,69,97,38,78,38,27,13,41,17,24,3,3,45,14,31
"2021","East Hampshire 006E","E01022641",533,166,57,109,331,34,177,78,74,25,64,32,28,4,51,28,23,5,5,36,15,21
"2021","East Hampshire 007A","E01022591",1043,195,111,84,786,186,471,211,172,88,86,52,27,7,39,19,20,4,4,62,23,39
"2021","East Hampshire 007B","E01022593",525,83,51,32,398,118,242,83,102,57,22,9,11,2,15,8,7,1,1,44,14,30
"2021","East Hampshire 007C","E01022594",800,163,82,81,605,126,293,106,142,45,97,62,30,5,83,59,24,6,6,32,14,18
"2021","East Hampshire 007D","E01022595",942,168,84,84,738,138,445,149,222,74,81,34,42,5,72,50,22,2,2,36,19,17
"2021","East Hampshire 007E","E01022596",767,131,68,63,604,148,348,151,141,56,62,38,19,5,46,29,17,0,0,32,13,19
"2021","East Hampshire 007F","E01022627",946,204,106,98,668,146,376,145,161,70,83,42,36,5,63,36,27,0,0,74,23,51
"2021","East Hampshire 008A","E01022630",960,238,137,101,668,148,375,165,144,66,84,49,27,8,57,35,22,4,4,54,17,37
"2021","East Hampshire 008D","E01022642",423,102,67,35,292,54,168,63,73,32,35,16,12,7,34,19,15,1,1,29,9,20
"2021","East Hampshire 008F","E01034721",481,110,50,60,346,48,181,61,85,35,74,47,17,10,41,19,22,2,2,25,10,15
"2021","East Hampshire 008G","E01034722",726,170,85,85,512,63,280,98,126,56,112,70,38,4,53,33,20,4,4,44,21,23
"2021","East Hampshire 009A","E01022583",750,195,100,95,521,106,276,77,154,45,76,47,24,5,59,31,28,4,4,34,12,22
"2021","East Hampshire 009B","E01022584",846,339,175,164,472,78,249,86,125,38,76,41,31,4,66,45,21,3,3,35,12,23
"2021","East Hampshire 009C","E01022585",785,207,165,42,544,149,302,95,161,46,37,15,19,3,53,25,28,3,3,34,8,26
"2021","East Hampshire 009D","E01022586",778,138,65,73,597,106,363,122,180,61,73,40,29,4,54,33,21,1,1,43,22,21
"2021","East Hampshire 009E","E01022587",896,255,120,135,604,91,301,88,171,42,106,56,47,3,102,72,30,4,4,37,15,22
"2021","East Hampshire 010A","E01022616",754,271,123,148,451,66,199,81,86,32,88,45,31,12,92,58,34,6,6,32,11,21
"2021","East Hampshire 010B","E01022617",693,185,106,79,473,79,283,99,132,52,60,41,19,0,49,34,15,2,2,35,9,26
"2021","East Hampshire 010C","E01022618",686,136,98,38,521,150,292,102,151,39,44,33,11,0,32,14,18,3,3,29,11,18
"2021","East Hampshire 010D","E01022631",517,105,61,44,391,68,234,92,99,43,49,25,13,11,38,19,19,2,2,21,9,12
"2021","East Hampshire 010E","E01022632",459,112,55,57,337,68,183,64,92,27,60,37,23,0,26,13,13,0,0,10,5,5
"2021","East Hampshire 011A","E01022592",971,230,120,110,701,153,380,165,151,64,95,48,38,9,70,28,42,3,3,40,13,27
"2021","East Hampshire 011B","E01022597",1032,222,104,118,753,127,466,155,238,73,89,61,24,4,67,38,29,4,4,57,21,36
"2021","East Hampshire 011C","E01022619",520,157,67,90,343,81,185,60,98,27,35,18,15,2,40,16,24,2,2,20,8,12
"2021","East Hampshire 011D","E01022624",1007,290,192,98,699,208,366,142,156,68,69,34,28,7,55,30,25,1,1,18,5,13
"2021","East Hampshire 011E","E01022625",1129,303,180,123,796,176,434,156,197,81,100,64,31,5,81,50,31,5,5,30,14,16
"2021","East Hampshire 012A","E01022620",499,139,57,82,341,39,187,54,103,30,71,41,29,1,42,19,23,2,2,19,2,17
"2021","East Hampshire 012B","E01022621",620,234,125,109,357,39,187,53,97,37,50,21,27,2,78,45,33,3,3,29,11,18
"2021","East Hampshire 012C","E01022622",947,221,144,77,702,129,360,114,197,49,106,49,53,4,103,71,32,4,4,24,11,13
"2021","East Hampshire 012D","E01022623",938,252,135,117,650,100,344,105,173,66,84,38,40,6,119,81,38,3,3,36,12,24
"2021","East Hampshire 012F","E01032664",674,378,209,169,275,65,100,41,48,11,72,63,8,1,35,19,16,3,3,21,6,15
"2021","East Hampshire 012G","E01032665",679,295,116,179,354,43,150,62,68,20,81,57,21,3,75,44,31,5,5,30,7,23
"2021","East Hampshire 013A","E01022588",1040,195,100,95,796,144,432,147,211,74,118,61,53,4,101,66,35,1,1,49,20,29
"2021","East Hampshire 013B","E01022589",859,220,122,98,612,91,346,138,166,42,109,64,41,4,63,40,23,3,3,27,10,17
"2021","East Hampshire 013C","E01022590",632,122,82,40,495,122,279,119,102,58,55,18,30,7,39,24,15,0,0,15,3,12
"2021","East Hampshire 013D","E01022607",517,144,75,69,344,85,171,71,67,33,49,21,24,4,38,19,19,1,1,29,10,19
"2021","East Hampshire 013E","E01022608",532,101,62,39,406,76,238,90,101,47,58,34,22,2,31,12,19,3,3,25,8,17
"2021","East Hampshire 014A","E01022606",1010,210,100,110,735,153,418,177,173,68,105,58,38,9,54,19,35,5,5,65,20,45
"2021","East Hampshire 014B","E01022611",654,171,106,65,459,103,245,85,110,50,62,39,17,6,46,28,18,3,3,24,10,14
"2021","East Hampshire 014C","E01022613",556,102,53,49,425,92,249,72,117,60,47,23,18,6,36,21,15,1,1,29,14,15
"2021","East Hampshire 014D","E01022614",485,150,92,58,312,52,162,64,69,29,47,23,19,5,50,29,21,1,1,23,9,14
"2021","East Hampshire 016A","E01022610",742,207,108,99,495,64,284,107,132,45,90,51,35,4,56,39,17,1,1,40,13,27
"2021","East Hampshire 016B","E01022628",644,205,75,130,425,71,227,100,91,36,73,43,25,5,50,32,18,4,4,14,8,6
"2021","East Hampshire 016C","E01022629",711,199,132,67,500,153,256,125,82,49,44,30,11,3,42,25,17,5,5,12,2,10
"2021","East Hampshire 016D","E01032615",478,141,100,41,317,108,164,66,65,33,23,12,10,1,21,8,13,1,1,20,10,10
"2021","East Hampshire 016E","E01032616",638,145,82,63,480,100,272,101,118,53,61,31,26,4,42,24,18,5,5,13,7,6
"2021","East Hampshire 017A","E01022599",635,235,139,96,372,68,180,72,78,30,72,44,26,2,49,22,27,3,3,28,10,18
"2021","East Hampshire 017B","E01022600",649,162,107,55,462,126,254,112,95,47,47,34,8,5,34,15,19,1,1,25,8,17
"2021","East Hampshire 017C","E01022601",607,159,95,64,424,108,223,84,87,52,53,35,16,2,39,21,18,1,1,24,6,18
"2021","East Hampshire 017D","E01022602",550,93,69,24,429,120,248,109,90,49,34,21,11,2,25,15,10,2,2,28,8,20
"2021","East Hampshire 017E","E01032625",555,124,91,33,404,113,209,62,114,33,50,29,19,2,30,17,13,2,2,27,14,13
"2021","Eastleigh 001A","E01022705",655,166,131,35,462,156,252,70,142,40,26,18,8,0,28,14,14,0,0,27,12,15
"2021","Eastleigh 001B","E01022706",637,101,76,25,509,141,303,84,168,51,33,15,15,3,30,18,12,2,2,27,8,19
"2021","Eastleigh 001C","E01022707",734,128,89,39,585,121,378,98,221,59,38,15,23,0,44,27,17,4,4,21,7,14
"2021","Eastleigh 001D","E01022708",714,161,90,71,510,97,268,66,170,32,68,41,26,1,73,53,20,4,4,43,7,36
"2021","Eastleigh 001E","E01022709",677,136,92,44,514,145,288,73,173,42,35,21,10,4,46,34,12,0,0,27,12,15
"2021","Eastleigh 002A","E01022659",611,130,57,73,457,67,248,63,145,40,71,37,30,4,64,31,33,7,7,24,9,15
"2021","Eastleigh 002B","E01022660",626,195,122,73,405,75,205,70,109,26,64,24,33,7,59,28,31,2,2,26,12,14
"2021","Eastleigh 002C","E01022675",564,117,73,44,425,111,224,91,86,47,58,31,23,4,29,15,14,3,3,22,7,15
"2021","Eastleigh 002D","E01022676",731,144,83,61,555,110,322,117,147,58,67,35,28,4,55,33,22,1,1,32,13,19
"2021","Eastleigh 002E","E01022704",736,182,131,51,523,116,303,68,161,74,41,18,20,3,61,40,21,2,2,31,20,11
"2021","Eastleigh 003A","E01022661",793,255,172,83,507,139,225,97,90,38,94,58,32,4,44,20,24,5,5,31,11,20
"2021","Eastleigh 003B","E01022662",547,113,66,47,414,95,242,93,107,42,41,21,18,2,33,16,17,3,3,20,4,16
"2021","Eastleigh 003C","E01022663",645,136,51,85,478,89,275,92,134,49,70,45,24,1,43,22,21,1,1,31,8,23
"2021","Eastleigh 003D","E01022664",648,163,96,67,459,100,254,96,122,36,49,29,17,3,56,35,21,0,0,26,8,18
"2021","Eastleigh 003E","E01022665",702,303,172,131,378,67,185,74,78,33,65,42,22,1,56,32,24,5,5,21,4,17
"2021","Eastleigh 004A","E01022648",793,310,186,124,454,97,227,95,97,35,82,53,25,4,44,34,10,4,4,29,11,18
"2021","Eastleigh 004B","E01022667",820,186,56,130,579,45,299,102,154,43,134,66,63,5,95,66,29,6,6,55,17,38
"2021","Eastleigh 004C","E01022672",623,173,85,88,408,71,211,73,92,46,67,31,36,0,55,33,22,4,4,42,15,27
"2021","Eastleigh 004D","E01022673",931,233,72,161,633,38,302,97,153,52,156,100,48,8,129,85,44,8,8,65,18,47
"2021","Eastleigh 004E","E01022674",702,235,118,117,437,69,206,75,96,35,89,58,28,3,71,45,26,2,2,30,8,22
"2021","Eastleigh 005A","E01022643",655,182,79,103,445,82,229,81,99,49,80,36,38,6,50,29,21,4,4,28,8,20
"2021","Eastleigh 005B","E01022644",499,125,83,42,345,47,200,84,81,35,59,23,29,7,38,25,13,1,1,29,13,16
"2021","Eastleigh 005C","E01022646",633,177,84,93,426,68,205,72,88,45,91,53,33,5,59,29,30,3,3,30,11,19
"2021","Eastleigh 005D","E01022647",697,129,79,50,547,93,309,112,150,47,98,58,36,4,45,25,20,2,2,21,11,10
"2021","Eastleigh 005E","E01022649",631,177,83,94,429,46,183,61,86,36,78,31,38,9,120,75,45,2,2,25,9,16
"2021","Eastleigh 005F","E01022650",481,113,56,57,346,60,177,53,85,39,62,34,23,5,47,25,22,0,0,22,8,14
"2021","Eastleigh 006C","E01022678",739,144,58,86,541,58,290,87,155,48,108,51,47,10,78,39,39,7,7,54,17,37
"2021","Eastleigh 006D","E01022680",807,309,126,183,461,62,183,68,83,32,121,58,54,9,93,62,31,2,2,37,14,23
"2021","Eastleigh 006E","E01022681",697,187,89,98,448,54,207,67,101,39,89,39,44,6,91,67,24,7,7,62,32,30
"2021","Eastleigh 006F","E01035433",625,231,65,166,355,15,140,43,79,18,101,64,36,1,93,71,22,6,6,39,15,24
"2021","Eastleigh 006G","E01035434",702,136,49,87,497,31,260,81,135,44,98,42,46,10,103,68,35,5,5,69,29,40
"2021","Eastleigh 006H","E01035435",499,154,103,51,311,44,173,67,70,36,48,20,19,9,44,19,25,2,2,34,15,19
"2021","Eastleigh 006I","E01035436",518,124,4,120,368,4,118,36,77,5,145,88,57,0,99,84,15,2,2,26,11,15
"2021","Eastleigh 006J","E01035437",635,113,17,96,481,2,216,62,127,27,128,59,63,6,130,99,31,5,5,41,8,33
"2021","Eastleigh 007A","E01022666",978,380,125,255,528,61,219,85,100,34,154,106,43,5,86,58,28,8,8,70,13,57
"2021","Eastleigh 007B","E01022669",730,202,62,140,461,24,226,72,113,41,123,76,41,6,79,51,28,9,9,67,21,46
"2021","Eastleigh 007C","E01022670",631,189,48,141,382,18,156,65,72,19,83,33,45,5,113,70,43,12,12,60,16,44
"2021","Eastleigh 007D","E01022671",700,303,83,220,340,23,158,62,69,27,85,62,21,2,71,44,27,3,3,57,18,39
"2021","Eastleigh 007E","E01022679",799,200,53,147,538,36,238,90,109,39,142,79,58,5,116,68,48,6,6,61,18,43
"2021","Eastleigh 008A","E01022645",489,106,76,30,360,121,174,77,63,34,44,28,15,1,21,5,16,0,0,23,9,14
"2021","Eastleigh 008B","E01022682",710,103,45,58,577,84,311,106,146,59,123,71,49,3,57,35,22,2,2,30,15,15
"2021","Eastleigh 008C","E01022683",874,176,82,94,672,70,362,96,218,48,159,84,67,8,79,59,20,2,2,26,6,20
"2021","Eastleigh 008D","E01022684",582,105,71,34,455,106,227,100,80,47,64,27,32,5,56,34,22,2,2,22,10,12
"2021","Eastleigh 008E","E01022685",522,219,109,110,284,48,144,61,51,32,53,29,23,1,39,23,16,0,0,19,7,12
"2021","Eastleigh 008F","E01022686",762,131,75,56,590,58,336,91,167,78,128,79,43,6,68,40,28,0,0,41,18,23
"2021","Eastleigh 008G","E01022687",672,155,53,102,477,63,290,98,141,51,75,38,32,5,46,25,21,3,3,40,21,19
"2021","Eastleigh 009A","E01022713",842,224,111,113,583,108,254,113,103,38,128,82,42,4,87,55,32,6,6,35,14,21
"2021","Eastleigh 009B","E01022714",709,194,137,57,488,131,271,111,105,55,48,27,17,4,36,11,25,2,2,27,12,15
"2021","Eastleigh 009C","E01022715",874,289,115,174,541,69,260,100,120,40,120,72,40,8,86,57,29,6,6,44,21,23
"2021","Eastleigh 009D","E01022716",734,293,108,185,418,52,174,76,76,22,127,95,27,5,65,35,30,0,0,23,8,15
"2021","Eastleigh 009E","E01022717",514,158,51,107,339,56,187,66,75,46,71,50,18,3,24,11,13,1,1,17,5,12
"2021","Eastleigh 009F","E01022718",647,168,69,99,451,86,241,90,105,46,76,45,29,2,46,30,16,2,2,28,13,15
"2021","Eastleigh 009G","E01022719",726,243,155,88,457,124,253,96,99,58,55,33,17,5,21,7,14,4,4,26,10,16
"2021","Eastleigh 010B","E01022691",611,155,47,108,441,29,278,86,147,45,84,51,27,6,47,37,10,3,3,15,6,9
"2021","Eastleigh 010D","E01022693",529,88,45,43,410,28,277,76,161,40,63,39,22,2,42,26,16,0,0,31,13,18
"2021","Eastleigh 010E","E01022694",656,118,38,80,518,37,303,87,167,49,99,55,40,4,79,59,20,0,0,20,15,5
"2021","Eastleigh 010F","E01035438",748,100,20,80,614,21,334,82,223,29,152,85,67,0,104,94,10,3,3,34,15,19
"2021","Eastleigh 010G","E01035439",723,120,29,91,570,29,329,74,221,34,111,62,44,5,99,65,34,2,2,33,13,20
"2021","Eastleigh 010H","E01035440",592,157,8,149,403,4,194,44,139,11,110,67,41,2,93,75,18,2,2,32,10,22
"2021","Eastleigh 010I","E01035441",598,139,88,51,426,99,212,79,103,30,70,38,32,0,45,30,15,0,0,33,13,20
"2021","Eastleigh 011A","E01022652",756,224,135,89,503,105,242,87,108,47,84,37,41,6,70,35,35,2,2,29,17,12
"2021","Eastleigh 011B","E01022695",580,215,132,83,344,56,182,72,66,44,54,25,25,4,49,27,22,3,3,21,13,8
"2021","Eastleigh 011C","E01022700",663,220,110,110,414,51,205,58,104,43,78,45,33,0,80,58,22,0,0,29,9,20
"2021","Eastleigh 011D","E01022701",416,109,77,32,291,55,169,54,85,30,33,16,15,2,34,17,17,0,0,16,7,9
"2021","Eastleigh 011E","E01022703",648,219,104,115,412,81,201,65,101,35,88,53,30,5,42,25,17,0,0,17,6,11
"2021","Eastleigh 012A","E01022651",793,224,90,134,545,88,258,98,121,39,130,81,45,4,63,37,26,6,6,24,7,17
"2021","Eastleigh 012B","E01022696",632,144,108,36,462,136,228,83,109,36,50,23,17,10,48,18,30,0,0,26,12,14
"2021","Eastleigh 012C","E01022697",620,136,93,43,450,112,255,85,126,44,47,28,17,2,36,15,21,0,0,34,15,19
"2021","Eastleigh 012D","E01022698",790,203,121,82,541,107,287,95,142,50,88,36,48,4,58,39,19,1,1,46,18,28
"2021","Eastleigh 012E","E01022699",716,175,88,87,520,96,277,92,142,43,73,41,28,4,73,51,22,1,1,21,8,13
"2021","Eastleigh 012F","E01022702",522,101,39,62,407,47,224,83,107,34,94,55,30,9,42,24,18,0,0,14,4,10
"2021","Eastleigh 013A","E01022654",568,159,50,109,374,41,203,83,90,30,87,51,33,3,41,25,16,2,2,35,11,24
"2021","Eastleigh 013B","E01022655",555,128,59,69,398,19,164,38,81,45,77,19,44,14,135,87,48,3,3,29,8,21
"2021","Eastleigh 013C","E01022656",965,205,88,117,690,85,324,118,157,49,168,83,79,6,113,80,33,0,0,70,27,43
"2021","Eastleigh 013D","E01022657",1158,298,99,199,802,82,391,144,207,40,222,145,68,9,102,77,25,5,5,58,23,35
"2021","Eastleigh 013E","E01022658",732,171,90,81,524,119,280,118,116,46,72,43,24,5,49,26,23,4,4,37,14,23
"2021","Eastleigh 014A","E01022710",962,369,205,164,557,127,254,105,110,39,105,60,42,3,66,36,30,5,5,36,13,23
"2021","Eastleigh 014B","E01022711",776,260,150,110,485,72,215,66,106,43,90,45,36,9,102,56,46,6,6,31,13,18
"2021","Eastleigh 014C","E01022712",704,212,70,142,461,64,239,96,97,46,85,50,31,4,70,48,22,3,3,31,14,17
"2021","Eastleigh 015A","E01022688",1048,323,145,178,682,138,329,161,123,45,122,81,31,10,83,50,33,10,10,43,9,34
"2021","Eastleigh 015B","E01022689",848,214,107,107,609,119,311,134,139,38,110,66,36,8,64,42,22,5,5,25,10,15
"2021","Eastleigh 015C","E01022690",803,220,112,108,537,83,243,93,107,43,106,54,47,5,101,68,33,4,4,46,16,30
"2021","Fareham 001A","E01022758",826,155,49,106,629,78,353,109,189,55,89,44,39,6,106,70,36,3,3,42,18,24
"2021","Fareham 001B","E01022771",615,93,26,67,498,24,313,86,188,39,98,57,38,3,63,45,18,0,0,24,8,16
"2021","Fareham 001C","E01022772",919,121,31,90,753,70,473,131,273,69,118,69,44,5,89,62,27,3,3,45,17,28
"2021","Fareham 001D","E01022773",695,143,66,77,515,98,289,108,148,33,75,40,33,2,53,27,26,0,0,37,17,20
"2021","Fareham 001E","E01022774",810,150,88,62,621,115,368,126,184,58,99,51,43,5,35,18,17,4,4,39,15,24
"2021","Fareham 002A","E01022749",537,114,86,28,400,93,233,85,98,50,41,18,15,8,31,12,19,2,2,23,6,17
"2021","Fareham 002B","E01022753",490,124,81,43,346,52,174,62,75,37,74,43,26,5,46,27,19,0,0,20,11,9
"2021","Fareham 002C","E01022754",1004,351,155,196,603,79,298,104,156,38,107,66,33,8,114,79,35,5,5,50,18,32
"2021","Fareham 002D","E01022780",679,143,40,103,499,57,307,106,153,48,72,42,25,5,63,47,16,0,0,37,12,25
"2021","Fareham 002E","E01022787",558,135,85,50,386,67,196,60,97,39,65,45,20,0,57,38,19,1,1,37,11,26
"2021","Fareham 002F","E01022788",523,146,69,77,354,59,178,52,98,28,76,41,30,5,41,25,16,0,0,23,5,18
"2021","Fareham 003A","E01022730",645,186,121,65,419,92,205,73,81,51,67,37,25,5,52,24,28,3,3,40,17,23
"2021","Fareham 003B","E01022731",503,101,53,48,378,47,211,75,92,44,66,32,30,4,54,16,38,0,0,24,10,14
"2021","Fareham 003C","E01022732",648,202,72,130,421,29,162,63,67,32,95,42,41,12,131,84,47,4,4,25,5,20
"2021","Fareham 003D","E01022733",732,201,117,84,498,136,234,101,94,39,70,48,19,3,55,38,17,3,3,33,4,29
"2021","Fareham 003E","E01022734",541,137,66,71,364,52,164,46,73,45,79,30,44,5,66,35,31,3,3,40,17,23
"2021","Fareham 004A","E01022720",609,146,57,89,439,93,249,94,100,55,64,49,13,2,32,21,11,1,1,24,13,11
"2021","Fareham 004B","E01022725",485,91,70,21,377,101,220,84,96,40,38,19,15,4,18,4,14,0,0,17,7,10
"2021","Fareham 004C","E01022726",597,152,115,37,423,128,224,94,88,42,47,19,25,3,23,10,13,1,1,22,7,15
"2021","Fareham 004D","E01022727",652,177,126,51,436,103,228,93,96,39,60,31,21,8,43,19,24,2,2,39,14,25
"2021","Fareham 004E","E01022729",454,86,40,46,339,54,194,74,87,33,65,44,19,2,24,12,12,2,2,29,13,16
"2021","Fareham 004F","E01022743",794,230,139,91,519,133,268,114,96,58,73,46,22,5,44,20,24,1,1,45,19,26
"2021","Fareham 005A","E01022750",649,228,184,44,404,82,239,90,92,57,49,29,17,3,32,7,25,2,2,17,5,12
"2021","Fareham 005B","E01022751",668,190,138,52,441,118,249,89,112,48,40,24,12,4,31,14,17,3,3,37,16,21
"2021","Fareham 005C","E01022752",549,100,71,29,423,101,253,103,107,43,37,18,15,4,31,15,16,1,1,26,8,18
"2021","Fareham 005D","E01022757",697,202,45,157,476,37,240,81,123,36,124,69,47,8,71,45,26,4,4,19,7,12
"2021","Fareham 005E","E01022790",712,175,88,87,495,105,290,123,118,49,62,34,25,3,37,25,12,1,1,42,12,30
"2021","Fareham 006A","E01022755",671,135,85,50,498,99,238,74,123,41,79,39,38,2,81,48,33,1,1,38,12,26
"2021","Fareham 006B","E01022756",723,166,54,112,533,61,310,109,148,53,96,53,40,3,62,33,29,4,4,24,6,18
"2021","Fareham 006C","E01022791",856,281,187,94,546,119,291,107,130,54,77,48,25,4,59,37,22,0,0,29,7,22
"2021","Fareham 006D","E01022792",688,183,108,75,461,99,254,105,103,46,56,31,24,1,50,28,22,2,2,44,14,30
"2021","Fareham 006E","E01022793",780,165,78,87,586,123,332,106,163,63,81,44,34,3,49,34,15,1,1,29,11,18
"2021","Fareham 007A","E01022781",579,175,89,86,377,63,198,61,100,37,61,33,25,3,53,33,20,2,2,27,11,16
"2021","Fareham 007B","E01022782",676,186,115,71,457,108,234,112,72,50,67,43,19,5,42,20,22,6,6,33,12,21
"2021","Fareham 007C","E01022785",606,152,84,68,427,79,251,97,95,59,59,34,24,1,37,24,13,1,1,27,11,16
"2021","Fareham 007D","E01022786",897,210,83,127,653,105,340,124,161,55,117,61,52,4,87,53,34,4,4,34,14,20
"2021","Fareham 007E","E01022789",681,193,65,128,476,70,244,96,120,28,97,73,21,3,59,35,24,6,6,12,3,9
"2021","Fareham 008A","E01022721",698,198,92,106,466,86,227,97,92,38,87,51,32,4,61,41,20,5,5,34,11,23
"2021","Fareham 008B","E01022722",719,272,161,111,424,81,224,63,112,49,60,38,15,7,55,31,24,4,4,23,8,15
"2021","Fareham 008C","E01022723",768,335,138,197,385,53,164,71,69,24,109,74,26,9,53,38,15,6,6,48,15,33
"2021","Fareham 008D","E01022724",575,129,57,72,412,58,204,80,87,37,81,50,28,3,65,41,24,4,4,34,15,19
"2021","Fareham 008E","E01022737",644,174,85,89,430,90,208,72,96,40,77,43,30,4,55,22,33,0,0,40,10,30
"2021","Fareham 008F","E01022766",524,105,71,34,395,112,220,92,84,44,43,28,12,3,17,6,11,3,3,24,8,16
"2021","Fareham 008G","E01022769",561,188,68,120,349,51,183,62,89,32,75,47,24,4,40,24,16,0,0,24,11,13
"2021","Fareham 009A","E01022740",720,199,114,85,506,150,236,96,96,44,71,42,26,3,46,21,25,3,3,15,4,11
"2021","Fareham 009B","E01022741",558,102,61,41,437,77,289,100,153,36,45,24,19,2,25,17,8,1,1,19,10,9
"2021","Fareham 009C","E01022742",853,280,200,80,549,182,262,152,59,51,65,48,11,6,37,11,26,3,3,24,7,17
"2021","Fareham 009D","E01022783",634,167,100,67,435,127,223,95,82,46,48,27,16,5,35,19,16,2,2,32,8,24
"2021","Fareham 009E","E01022784",497,77,46,31,401,76,262,90,116,56,37,11,21,5,25,13,12,1,1,19,9,10
"2021","Fareham 010A","E01022759",684,173,119,54,478,102,236,98,90,48,85,46,30,9,54,33,21,1,1,33,7,26
"2021","Fareham 010B","E01022763",680,169,108,61,475,141,242,112,77,53,52,28,19,5,40,19,21,0,0,36,12,24
"2021","Fareham 010C","E01022765",759,219,165,54,493,110,272,106,118,48,74,39,33,2,35,14,21,2,2,47,21,26
"2021","Fareham 010D","E01022768",602,166,85,81,417,95,193,84,76,33,78,47,26,5,48,28,20,3,3,19,6,13
"2021","Fareham 010E","E01022770",797,170,106,64,600,136,312,107,141,64,89,56,30,3,61,44,17,2,2,27,10,17
"2021","Fareham 011A","E01022728",825,348,175,173,432,46,168,63,78,27,117,73,38,6,98,65,33,3,3,45,14,31
"2021","Fareham 011B","E01022735",757,216,76,140,494,50,251,74,131,46,112,70,29,13,80,50,30,1,1,47,11,36
"2021","Fareham 011C","E01022736",662,189,86,103,437,63,227,91,103,33,91,48,33,10,53,28,25,3,3,36,16,20
"2021","Fareham 011D","E01022738",461,183,76,107,259,27,100,31,48,21,62,36,24,2,69,41,28,1,1,19,7,12
"2021","Fareham 011E","E01022739",667,219,114,105,416,36,155,47,76,32,89,41,41,7,135,93,42,1,1,32,11,21
"2021","Fareham 012A","E01022760",646,158,93,65,459,75,226,89,91,46,78,36,35,7,78,45,33,2,2,29,9,20
"2021","Fareham 012B","E01022761",653,189,130,59,434,89,191,84,65,42,74,40,29,5,77,29,48,3,3,30,12,18
"2021","Fareham 012C","E01022762",626,186,111,75,402,59,230,87,100,43,65,38,26,1,48,20,28,0,0,38,14,24
"2021","Fareham 012D","E01022764",732,262,176,86,432,119,226,108,71,47,47,30,11,6,39,19,20,1,1,38,17,21
"2021","Fareham 012E","E01022767",507,100,55,45,386,66,221,71,99,51,54,30,22,2,45,22,23,0,0,21,11,10
"2021","Fareham 013B","E01022776",634,145,94,51,462,121,271,109,105,57,37,23,9,5,32,13,19,1,1,27,11,16
"2021","Fareham 013C","E01022777",776,304,248,56,437,151,195,90,71,34,38,15,17,6,53,26,27,0,0,35,15,20
"2021","Fareham 013D","E01022778",588,154,117,37,405,95,202,99,64,39,54,30,23,1,52,32,20,2,2,29,15,14
"2021","Fareham 013F","E01032877",934,263,194,69,631,199,303,126,107,70,64,24,33,7,63,32,31,2,2,40,19,21
"2021","Fareham 014A","E01022744",557,119,91,28,421,157,215,81,84,50,25,16,8,1,22,10,12,2,2,17,6,11
"2021","Fareham 014B","E01022745",637,134,105,29,476,144,250,103,96,51,42,21,16,5,38,22,16,2,2,27,12,15
"2021","Fareham 014C","E01022746",730,185,141,44,527,143,305,113,148,44,38,20,15,3,40,20,20,1,1,18,6,12
"2021","Fareham 014D","E01022747",590,214,148,66,363,108,163,73,61,29,46,28,17,1,45,26,19,1,1,13,8,5
"2021","Fareham 014E","E01022748",623,176,98,78,431,91,221,89,92,40,62,39,22,1,56,34,22,1,1,16,5,11
"2021","Gosport 001A","E01022800",628,159,108,51,425,66,205,76,93,36,78,31,41,6,69,34,35,7,7,44,16,28
"2021","Gosport 001B","E01022801",630,218,118,100,370,53,171,68,75,28,61,33,24,4,85,45,40,0,0,42,23,19
"2021","Gosport 001C","E01022802",609,126,87,39,442,97,222,92,87,43,60,26,30,4,62,37,25,1,1,41,13,28
"2021","Gosport 001D","E01022803",653,208,100,108,384,41,177,59,71,47,86,35,45,6,76,36,40,4,4,61,23,38
"2021","Gosport 001E","E01022836",638,174,137,37,438,140,217,105,69,43,53,22,27,4,26,11,15,2,2,26,13,13
"2021","Gosport 002A","E01022804",674,207,93,114,418,82,209,86,73,50,60,32,22,6,61,34,27,6,6,49,21,28
"2021","Gosport 002B","E01022805",631,206,137,69,382,54,176,77,79,20,72,31,33,8,78,43,35,2,2,43,14,29
"2021","Gosport 002C","E01022834",600,226,139,87,347,87,177,77,56,44,47,23,23,1,35,14,21,1,1,27,11,16
"2021","Gosport 002D","E01022835",615,202,85,117,383,67,169,79,56,34,85,40,40,5,58,32,26,4,4,30,8,22
"2021","Gosport 002E","E01022840",629,217,86,131,374,52,198,66,94,38,48,19,25,4,73,43,30,3,3,38,14,24
"2021","Gosport 003A","E01022813",537,123,72,51,376,43,200,78,78,44,83,37,39,7,46,26,20,4,4,38,19,19
"2021","Gosport 003B","E01022814",741,244,133,111,462,60,245,103,103,39,85,46,32,7,70,39,31,2,2,35,14,21
"2021","Gosport 003C","E01022815",610,130,74,56,441,58,237,94,89,54,75,41,30,4,69,41,28,2,2,39,20,19
"2021","Gosport 003D","E01022823",631,158,89,69,435,85,205,79,87,39,89,46,39,4,51,26,25,5,5,38,21,17
"2021","Gosport 003E","E01022825",582,161,79,82,392,58,194,77,74,43,66,33,27,6,72,50,22,2,2,29,7,22
"2021","Gosport 004A","E01022819",664,188,64,124,420,19,166,61,73,32,99,49,43,7,125,100,25,11,11,56,21,35
"2021","Gosport 004B","E01022820",602,115,27,88,453,6,215,59,126,30,88,34,48,6,139,101,38,5,5,34,19,15
"2021","Gosport 004E","E01022841",656,214,69,145,398,40,179,70,83,26,99,54,42,3,74,50,24,6,6,44,22,22
"2021","Gosport 004F","E01022842",588,109,43,66,436,43,239,61,159,19,73,27,41,5,77,58,19,4,4,43,26,17
"2021","Gosport 004H","E01034060",848,197,37,160,594,22,227,74,128,25,150,67,73,10,190,155,35,5,5,57,32,25
"2021","Gosport 004I","E01034061",441,111,15,96,289,6,113,37,67,9,64,22,37,5,104,78,26,2,2,41,22,19
"2021","Gosport 005A","E01022807",714,302,125,177,377,34,113,54,37,22,117,63,49,5,109,78,31,4,4,35,8,27
"2021","Gosport 005B","E01022816",588,175,83,92,389,42,211,93,77,41,80,36,36,8,53,31,22,3,3,24,11,13
"2021","Gosport 005C","E01022817",710,220,80,140,438,37,222,79,101,42,99,50,40,9,75,44,31,5,5,52,27,25
"2021","Gosport 005D","E01022818",584,175,73,102,371,39,148,51,56,41,83,38,37,8,96,55,41,5,5,38,19,19
"2021","Gosport 005F","E01034062",638,207,65,142,399,56,162,79,64,19,97,55,37,5,78,61,17,6,6,32,9,23
"2021","Gosport 005G","E01034063",576,198,45,153,360,50,156,86,44,26,84,55,28,1,69,49,20,1,1,18,6,12
"2021","Gosport 006A","E01022826",678,198,99,99,464,103,253,126,77,50,64,36,25,3,42,27,15,2,2,16,8,8
"2021","Gosport 006C","E01022828",730,361,282,79,346,153,120,63,30,27,31,18,9,4,39,26,13,3,3,23,7,16
"2021","Gosport 006D","E01022829",1049,264,156,108,746,201,378,152,186,40,88,58,25,5,78,47,31,1,1,39,15,24
"2021","Gosport 006E","E01022830",642,189,122,67,437,137,195,99,59,37,60,35,23,2,43,22,21,2,2,16,7,9
"2021","Gosport 006F","E01032880",503,59,24,35,419,68,259,76,132,51,54,20,30,4,38,22,16,0,0,25,13,12
"2021","Gosport 006G","E01032881",608,109,40,69,474,34,297,73,186,38,62,24,38,0,81,63,18,0,0,25,11,14
"2021","Gosport 006H","E01032883",647,260,173,87,364,73,168,69,57,42,49,20,27,2,70,45,25,4,4,23,9,14
"2021","Gosport 007A","E01022806",582,174,80,94,379,57,170,72,71,27,77,44,28,5,68,39,29,7,7,29,8,21
"2021","Gosport 007D","E01022832",681,170,66,104,472,45,217,72,100,45,117,67,43,7,84,56,28,9,9,39,7,32
"2021","Gosport 007E","E01022839",635,279,94,185,328,39,133,56,51,26,87,64,21,2,69,33,36,0,0,28,12,16
"2021","Gosport 007F","E01032884",957,344,176,168,580,125,269,130,99,40,98,58,36,4,79,49,30,9,9,33,14,19
"2021","Gosport 008A","E01022810",749,323,161,162,385,71,158,87,47,24,90,47,37,6,61,36,25,5,5,41,13,28
"2021","Gosport 008C","E01022833",810,343,114,229,423,26,140,57,64,19,98,40,50,8,153,102,51,6,6,44,21,23
"2021","Gosport 008D","E01022843",702,258,112,146,416,44,149,57,70,22,82,47,32,3,134,97,37,7,7,28,12,16
"2021","Gosport 008F","E01032878",570,279,68,211,260,21,68,34,28,6,87,59,27,1,82,57,25,2,2,31,9,22
"2021","Gosport 008G","E01032879",750,412,187,225,326,67,107,74,21,12,62,45,15,2,85,62,23,5,5,12,1,11
"2021","Gosport 008H","E01034064",647,222,51,171,383,33,150,68,54,28,101,65,31,5,92,64,28,7,7,42,11,31
"2021","Gosport 008I","E01034065",588,281,64,217,288,32,97,46,32,19,81,52,29,0,74,56,18,4,4,19,5,14
"2021","Gosport 009A","E01022794",627,175,107,68,420,123,225,96,87,42,40,19,13,8,31,17,14,1,1,32,15,17
"2021","Gosport 009B","E01022795",759,281,145,136,458,108,228,104,93,31,62,33,28,1,60,37,23,0,0,20,6,14
"2021","Gosport 009C","E01022796",503,112,98,14,374,117,202,74,82,46,28,14,12,2,24,15,9,3,3,17,7,10
"2021","Gosport 009D","E01022837",635,174,139,35,423,100,226,68,111,47,57,17,38,2,38,19,19,2,2,38,15,23
"2021","Gosport 009E","E01022838",526,118,93,25,394,98,208,73,95,40,53,26,21,6,34,16,18,1,1,14,5,9
"2021","Gosport 010A","E01022797",443,125,59,66,284,79,137,56,53,28,35,13,20,2,32,18,14,1,1,34,14,20
"2021","Gosport 010B","E01022798",513,178,112,66,318,73,167,89,53,25,43,26,14,3,35,21,14,0,0,17,6,11
"2021","Gosport 010C","E01022799",581,151,87,64,409,125,192,75,80,37,53,31,21,1,36,22,14,3,3,21,9,12
"2021","Gosport 010D","E01022812",518,151,63,88,332,40,165,66,71,28,69,34,32,3,56,33,23,2,2,35,10,25
"2021","Gosport 010E","E01022831",619,210,113,97,382,61,176,77,64,35,84,50,29,5,58,29,29,3,3,27,10,17
"2021","Gosport 010F","E01022845",677,276,116,160,376,48,182,73,73,36,66,39,22,5,76,39,37,4,4,25,6,19
"2021","Hart 001A","E01022890",622,161,107,54,430,76,211,76,90,45,58,29,23,6,83,43,40,2,2,31,10,21
"2021","Hart 001B","E01022891",732,176,120,56,521,107,303,84,152,67,60,24,28,8,49,33,16,2,2,35,18,17
"2021","Hart 001C","E01022892",804,202,132,70,561,154,291,92,130,69,72,42,27,3,40,12,28,4,4,41,12,29
"2021","Hart 001D","E01022893",752,167,92,75,556,108,242,82,122,38,115,59,49,7,89,40,49,2,2,29,13,16
"2021","Hart 001E","E01022894",619,184,98,86,410,74,206,74,98,34,71,40,27,4,58,32,26,1,1,25,13,12
"2021","Hart 002A","E01022859",654,143,73,70,479,67,308,100,160,48,57,30,18,9,47,28,19,0,0,32,12,20
"2021","Hart 002B","E01022895",736,215,102,113,494,99,245,83,116,46,90,59,27,4,58,26,32,2,2,27,13,14
"2021","Hart 002C","E01022896",595,114,76,38,451,105,250,73,116,61,45,14,26,5,51,24,27,0,0,30,16,14
"2021","Hart 002D","E01022897",639,122,52,70,492,82,288,98,137,53,69,25,34,10,50,22,28,3,3,25,6,19
"2021","Hart 002E","E01022898",571,112,64,48,435,107,246,76,119,51,38,15,20,3,43,23,20,1,1,24,10,14
"2021","Hart 003A","E01022846",796,205,71,134,563,82,256,98,118,40,152,102,44,6,70,56,14,3,3,28,11,17
"2021","Hart 003B","E01022847",778,237,102,135,485,73,245,83,116,46,101,63,31,7,63,32,31,3,3,56,16,40
"2021","Hart 003C","E01022848",624,156,97,59,421,106,201,71,96,34,56,25,27,4,55,23,32,3,3,47,20,27
"2021","Hart 003D","E01022874",496,100,68,32,358,58,195,51,98,46,62,31,28,3,40,20,20,3,3,38,12,26
"2021","Hart 003E","E01022875",483,75,39,36,354,39,182,42,88,52,44,20,19,5,88,44,44,1,1,54,28,26
"2021","Hart 003F","E01022876",580,104,73,31,440,81,232,58,107,67,64,28,28,8,60,30,30,3,3,36,15,21
"2021","Hart 003G","E01022877",547,91,62,29,420,90,219,62,95,62,69,32,30,7,39,21,18,3,3,36,16,20
"2021","Hart 004A","E01022858",485,93,40,53,368,54,225,80,111,34,58,37,17,4,30,16,14,1,1,24,7,17
"2021","Hart 004B","E01022878",713,161,118,43,526,169,296,114,133,49,36,21,11,4,23,12,11,2,2,26,12,14
"2021","Hart 004C","E01022879",1010,377,228,149,606,123,292,104,135,53,109,59,46,4,76,48,28,6,6,27,8,19
"2021","Hart 004D","E01022880",879,228,104,124,623,61,362,115,201,46,90,51,29,10,110,70,40,0,0,28,9,19
"2021","Hart 005A","E01022860",935,360,242,118,541,150,268,78,132,58,70,43,24,3,50,22,28,3,3,34,10,24
"2021","Hart 005B","E01022862",1140,511,210,301,580,68,291,94,154,43,150,112,35,3,60,38,22,11,11,49,6,43
"2021","Hart 005D","E01022867",735,234,55,179,476,44,281,115,136,30,111,88,21,2,37,25,12,3,3,25,9,16
"2021","Hart 005E","E01032852",626,109,21,88,483,17,285,68,185,32,81,37,40,4,97,71,26,3,3,34,12,22
"2021","Hart 005F","E01032853",661,104,22,82,523,30,336,69,227,40,93,50,40,3,58,39,19,6,6,34,19,15
"2021","Hart 005G","E01032854",604,113,22,91,456,17,296,70,206,20,89,49,36,4,48,37,11,6,6,35,12,23
"2021","Hart 005H","E01032857",452,133,20,113,297,28,179,57,89,33,70,55,14,1,17,12,5,3,3,22,5,17
"2021","Hart 006A","E01022881",1155,316,108,208,786,73,420,137,219,64,163,106,49,8,124,76,48,6,6,53,24,29
"2021","Hart 006B","E01022882",952,158,53,105,753,79,398,122,225,51,180,107,71,2,94,67,27,2,2,41,17,24
"2021","Hart 006C","E01022883",544,101,49,52,432,68,273,74,140,59,51,32,15,4,39,22,17,1,1,11,6,5
"2021","Hart 006D","E01022884",676,198,103,95,451,89,253,87,131,35,58,33,23,2,48,28,20,3,3,27,7,20
"2021","Hart 006E","E01022885",554,110,46,64,427,50,282,85,155,42,53,35,16,2,38,23,15,4,4,17,8,9
"2021","Hart 007A","E01022861",633,127,89,38,483,108,295,76,158,61,45,23,17,5,34,18,16,1,1,23,6,17
"2021","Hart 007B","E01022863",635,148,108,40,468,134,269,69,150,50,29,17,11,1,35,17,18,1,1,19,7,12
"2021","Hart 007C","E01022865",634,108,77,31,497,117,316,102,165,49,27,16,10,1,36,15,21,1,1,29,11,18
"2021","Hart 007D","E01022868",681,140,98,42,527,134,308,89,162,57,46,29,12,5,38,18,20,1,1,14,5,9
"2021","Hart 007E","E01022870",580,165,90,75,390,92,238,67,118,53,24,10,12,2,35,16,19,1,1,25,13,12
"2021","Hart 008A","E01022864",641,203,107,96,417,117,222,69,112,41,23,14,9,0,54,33,21,1,1,21,10,11
"2021","Hart 008B","E01022871",556,157,49,108,373,41,214,53,125,36,58,25,27,6,60,30,30,0,0,26,8,18
"2021","Hart 008C","E01022872",734,194,104,90,498,104,263,71,147,45,67,36,25,6,60,38,22,4,4,42,16,26
"2021","Hart 008E","E01022887",605,115,58,57,456,87,281,123,104,54,50,35,14,1,36,9,27,2,2,34,12,22
"2021","Hart 008F","E01034723",548,132,99,33,401,104,250,77,124,49,14,6,6,2,31,20,11,2,2,15,0,15
"2021","Hart 008G","E01034724",643,115,26,89,502,41,315,84,201,30,78,40,36,2,67,51,16,1,1,26,10,16
"2021","Hart 009A","E01022849",663,149,96,53,480,86,281,73,164,44,66,38,25,3,44,22,22,3,3,34,13,21
"2021","Hart 009B","E01022850",615,180,80,100,413,69,225,66,118,41,65,35,28,2,52,35,17,2,2,22,10,12
"2021","Hart 009C","E01022851",654,157,96,61,478,81,286,76,162,48,63,39,21,3,47,25,22,1,1,19,8,11
"2021","Hart 009D","E01022853",756,198,125,73,524,98,321,84,187,50,54,31,21,2,48,21,27,3,3,34,13,21
"2021","Hart 009E","E01022869",625,150,88,62,443,89,239,71,133,35,70,46,21,3,41,24,17,4,4,32,14,18
"2021","Hart 010A","E01022852",771,216,58,158,525,49,287,97,141,49,114,75,36,3,72,55,17,3,3,30,10,20
"2021","Hart 010B","E01022854",647,128,59,69,502,74,309,108,150,51,60,34,23,3,58,33,25,1,1,17,6,11
"2021","Hart 010C","E01022855",503,122,72,50,365,74,210,69,107,34,31,17,11,3,50,30,20,0,0,16,7,9
"2021","Hart 010D","E01022856",648,127,77,50,483,99,276,96,131,49,65,36,24,5,39,21,18,4,4,38,22,16
"2021","Hart 010F","E01034725",725,129,59,70,556,23,309,67,225,17,123,61,60,2,97,91,6,4,4,40,22,18
"2021","Hart 010G","E01034726",760,116,17,99,601,23,369,79,255,35,110,55,51,4,93,75,18,6,6,43,24,19
"2021","Hart 011B","E01022888",952,274,160,114,645,159,332,126,148,58,88,52,28,8,64,46,18,2,2,33,9,24
"2021","Hart 011C","E01022889",696,230,128,102,439,70,223,88,105,30,52,25,22,5,90,57,33,4,4,27,13,14
"2021","Hart 011D","E01032855",420,93,41,52,309,68,174,73,69,32,42,25,13,4,23,16,7,2,2,18,7,11
"2021","Hart 011E","E01032856",482,87,15,72,386,23,281,83,185,13,59,39,19,1,23,20,3,0,0,9,1,8
"2021","Havant 003A","E01022930",811,240,184,56,538,144,272,142,64,66,70,40,23,7,51,23,28,1,1,33,10,23
"2021","Havant 003B","E01022931",665,141,84,57,483,136,244,102,102,40,60,38,17,5,43,15,28,0,0,41,16,25
"2021","Havant 003C","E01022935",656,191,148,43,427,117,207,95,62,50,59,27,27,5,42,22,20,2,2,38,12,26
"2021","Havant 003D","E01022975",844,221,141,80,573,139,258,104,100,54,103,53,37,13,69,40,29,4,4,50,18,32
"2021","Havant 003E","E01022976",680,268,105,163,376,80,178,76,59,43,59,38,17,4,57,39,18,2,2,36,9,27
"2021","Havant 004A","E01022922",653,211,76,135,422,44,203,81,93,29,108,66,36,6,66,42,24,1,1,20,6,14
"2021","Havant 004B","E01022971",718,281,135,146,417,103,186,74,73,39,85,53,26,6,40,22,18,3,3,20,9,11
"2021","Havant 004C","E01022972",747,178,111,67,528,122,278,94,124,60,80,40,32,8,48,22,26,0,0,41,18,23
"2021","Havant 004D","E01022974",591,138,75,63,429,117,218,101,65,52,65,33,27,5,29,18,11,0,0,24,9,15
"2021","Havant 005A","E01022959",542,137,77,60,352,40,154,43,80,31,59,20,34,5,94,61,33,5,5,53,29,24
"2021","Havant 005B","E01022962",851,197,107,90,607,64,326,114,142,70,129,61,64,4,82,55,27,6,6,47,22,25
"2021","Havant 005C","E01022965",607,204,80,124,355,43,166,65,62,39,56,25,26,5,86,56,30,4,4,48,22,26
"2021","Havant 005D","E01022973",979,432,240,192,483,90,194,84,70,40,98,52,41,5,91,54,37,10,10,64,18,46
"2021","Havant 006A","E01022901",713,193,83,110,487,53,198,70,90,38,122,55,55,12,111,65,46,3,3,33,14,19
"2021","Havant 006B","E01022902",565,120,59,61,406,32,182,63,72,47,91,37,44,10,95,56,39,6,6,39,22,17
"2021","Havant 006C","E01022966",509,127,50,77,343,27,160,47,77,36,61,15,41,5,91,61,30,4,4,39,21,18
"2021","Havant 006D","E01022967",477,191,98,93,272,21,99,35,49,15,73,28,37,8,77,55,22,2,2,14,5,9
"2021","Havant 007A","E01022960",502,120,42,78,350,29,181,69,85,27,73,40,27,6,66,41,25,1,1,32,21,11
"2021","Havant 007B","E01022961",491,92,46,46,370,34,197,66,87,44,65,34,28,3,71,41,30,3,3,29,14,15
"2021","Havant 007C","E01022963",625,189,102,87,395,99,204,88,75,41,54,27,23,4,35,14,21,3,3,41,14,27
"2021","Havant 007D","E01022964",641,270,130,140,338,33,138,50,65,23,81,45,34,2,85,53,32,1,1,33,18,15
"2021","Havant 008A","E01022903",737,229,87,142,453,29,168,70,63,35,110,40,62,8,138,104,34,8,8,55,27,28
"2021","Havant 008B","E01022906",573,127,54,73,417,34,158,56,58,44,110,49,49,12,113,79,34,2,2,29,17,12
"2021","Havant 008C","E01022968",512,121,61,60,349,27,145,46,72,27,69,21,38,10,102,61,41,6,6,42,19,23
"2021","Havant 008D","E01022969",667,141,61,80,476,29,184,53,92,39,104,57,41,6,153,102,51,6,6,50,26,24
"2021","Havant 009A","E01022913",536,153,72,81,360,34,132,48,56,28,73,21,47,5,115,78,37,6,6,23,6,17
"2021","Havant 009B","E01022914",526,162,65,97,319,41,144,52,58,34,56,23,30,3,78,53,25,0,0,45,17,28
"2021","Havant 009C","E01022915",618,210,85,125,360,35,126,38,57,31,94,38,47,9,101,70,31,4,4,48,20,28
"2021","Havant 009D","E01022916",636,155,70,85,455,32,203,75,84,44,114,46,53,15,103,68,35,3,3,26,11,15
"2021","Havant 009E","E01022917",504,184,110,74,289,26,117,44,44,29,81,34,39,8,62,34,28,3,3,31,14,17
"2021","Havant 010A","E01022900",709,198,86,112,462,44,216,83,92,41,99,41,50,8,100,59,41,3,3,49,22,27
"2021","Havant 010B","E01022904",831,212,116,96,561,63,248,84,114,50,131,52,61,18,115,64,51,4,4,58,25,33
"2021","Havant 010C","E01022905",811,316,119,197,451,29,144,55,60,29,98,49,43,6,169,124,45,11,11,44,15,29
"2021","Havant 010D","E01022908",627,151,69,82,438,48,198,91,74,33,87,50,30,7,99,60,39,6,6,38,11,27
"2021","Havant 010E","E01022970",679,153,67,86,463,30,185,54,84,47,86,27,52,7,157,109,48,5,5,63,38,25
"2021","Havant 011A","E01022947",650,131,74,57,482,85,279,108,100,71,72,36,32,4,46,22,24,0,0,37,14,23
"2021","Havant 011B","E01022948",712,210,112,98,464,95,236,94,100,42,84,44,38,2,47,21,26,2,2,38,13,25
"2021","Havant 011C","E01022949",741,342,185,157,369,34,170,63,63,44,68,33,30,5,95,56,39,2,2,30,17,13
"2021","Havant 011D","E01022950",683,129,77,52,505,117,275,113,109,53,67,31,28,8,46,29,17,0,0,49,20,29
"2021","Havant 011E","E01022951",572,124,90,34,424,85,249,116,85,48,60,32,25,3,28,12,16,2,2,24,14,10
"2021","Havant 011F","E01022952",627,168,87,81,422,76,233,100,89,44,66,39,24,3,45,26,19,2,2,37,17,20
"2021","Havant 013A","E01022924",705,268,180,88,402,104,193,75,82,36,51,33,16,2,51,29,22,3,3,35,12,23
"2021","Havant 013B","E01022925",884,192,103,89,651,134,318,116,158,44,99,52,40,7,98,55,43,2,2,41,19,22
"2021","Havant 013C","E01022926",734,174,120,54,539,125,293,98,158,37,62,33,26,3,54,30,24,5,5,21,9,12
"2021","Havant 013D","E01022927",737,257,164,93,455,109,207,94,65,48,71,38,28,5,66,33,33,2,2,25,12,13
"2021","Havant 013E","E01022928",803,262,201,61,520,173,248,128,74,46,66,37,23,6,32,18,14,1,1,21,3,18
"2021","Havant 013F","E01022929",813,362,208,154,413,140,154,91,40,23,63,49,11,3,55,30,25,1,1,38,7,31
"2021","Havant 014B","E01022954",702,202,130,72,462,139,230,103,79,48,60,35,18,7,32,14,18,1,1,38,18,20
"2021","Havant 014C","E01022955",696,205,151,54,461,101,238,93,91,54,75,40,31,4,42,26,16,5,5,30,10,20
"2021","Havant 014D","E01022956",489,152,66,86,315,28,166,53,87,26,63,37,21,5,57,33,24,1,1,22,7,15
"2021","Havant 014E","E01022957",552,173,95,78,334,56,174,68,82,24,55,31,18,6,48,27,21,1,1,45,17,28
"2021","Havant 014F","E01022958",928,185,104,81,715,149,366,142,166,58,118,64,50,4,80,53,27,2,2,28,19,9
"2021","Havant 014G","E01034066",469,156,65,91,289,31,129,66,49,14,88,50,33,5,40,27,13,1,1,24,8,16
"2021","Havant 014H","E01034067",777,419,158,261,324,45,121,43,54,24,75,51,23,1,79,46,33,4,4,34,9,25
"2021","Havant 015A","E01022937",570,173,99,74,358,89,166,70,57,39,55,25,25,5,47,21,26,1,1,39,27,12
"2021","Havant 015B","E01022943",644,160,131,29,455,205,194,113,44,37,39,29,7,3,16,6,10,1,1,29,6,23
"2021","Havant 015C","E01022944",542,113,75,38,398,126,201,105,54,42,43,27,14,2,25,16,9,3,3,31,13,18
"2021","Havant 015D","E01022946",877,261,166,95,569,154,253,115,96,42,75,40,30,5,84,44,40,3,3,47,24,23
"2021","Havant 016A","E01022940",736,248,146,102,448,144,184,84,56,44,68,43,17,8,51,22,29,1,1,40,15,25
"2021","Havant 016B","E01022942",780,366,215,151,394,115,143,73,46,24,55,30,24,1,77,60,17,4,4,20,5,15
"2021","Havant 016C","E01022945",1083,390,265,125,649,210,262,125,83,54,88,41,41,6,87,52,35,2,2,44,16,28
"2021","Havant 017A","E01022936",796,322,183,139,438,122,164,101,39,24,90,55,29,6,58,33,25,4,4,36,9,27
"2021","Havant 017B","E01022938",762,255,149,106,480,124,229,98,95,36,60,31,27,2,65,43,22,2,2,27,11,16
"2021","Havant 017C","E01022939",701,217,146,71,449,122,191,89,59,43,70,43,22,5,64,38,26,2,2,35,10,25
"2021","Havant 017D","E01022941",695,217,133,84,437,141,194,104,45,45,57,32,20,5,40,19,21,5,5,41,11,30
"2021","Havant 018A","E01022899",496,94,43,51,360,39,189,54,90,45,63,24,34,5,66,32,34,3,3,42,23,19
"2021","Havant 018B","E01022907",638,162,107,55,437,108,205,88,70,47,67,36,25,6,53,27,26,4,4,39,16,23
"2021","Havant 018C","E01022909",719,173,95,78,512,94,299,116,124,59,79,47,23,9,39,19,20,1,1,34,16,18
"2021","Havant 018D","E01022910",657,222,103,119,388,48,163,69,59,35,97,58,37,2,73,47,26,7,7,47,25,22
"2021","Havant 018E","E01022911",644,160,99,61,441,92,203,78,68,57,88,55,30,3,58,28,30,0,0,43,15,28
"2021","Havant 018F","E01032605",672,127,77,50,515,90,267,119,112,36,98,46,43,9,59,31,28,1,1,30,9,21
"2021","Havant 019A","E01022919",638,171,92,79,431,95,220,81,93,46,69,25,35,9,45,23,22,2,2,36,13,23
"2021","Havant 019B","E01022933",676,271,99,172,363,38,141,42,72,27,60,19,34,7,122,92,30,2,2,42,26,16
"2021","Havant 019C","E01022934",769,244,91,153,478,40,169,59,78,32,119,50,61,8,146,105,41,4,4,47,15,32
"2021","Havant 019D","E01032618",703,159,84,75,506,90,239,83,107,49,97,57,38,2,77,49,28,3,3,38,19,19
"2021","Havant 020A","E01022918",684,206,150,56,457,127,203,78,79,46,66,35,22,9,58,41,17,3,3,21,8,13
"2021","Havant 020B","E01022920",688,184,112,72,471,109,233,87,97,49,84,45,28,11,43,24,19,2,2,33,14,19
"2021","Havant 020C","E01022921",649,159,106,53,459,103,248,96,101,51,64,37,24,3,42,20,22,2,2,31,14,17
"2021","Havant 020D","E01032617",670,156,119,37,479,119,248,101,90,57,65,28,32,5,45,28,17,2,2,35,17,18
"2021","New Forest 001A","E01023011",632,143,79,64,436,107,221,94,94,33,71,47,21,3,35,18,17,2,2,53,14,39
"2021","New Forest 001B","E01023012",594,137,89,48,423,124,212,101,58,53,59,39,19,1,25,12,13,3,3,34,11,23
"2021","New Forest 001C","E01023021",625,138,94,44,466,110,261,109,111,41,55,34,17,4,37,24,13,3,3,21,10,11
"2021","New Forest 001D","E01023022",948,431,220,211,499,103,198,79,89,30,105,73,27,5,89,55,34,4,4,18,4,14
"2021","New Forest 001E","E01023023",757,245,137,108,483,114,235,97,95,43,73,32,37,4,59,35,24,2,2,29,14,15
"2021","New Forest 001F","E01023024",720,183,123,60,509,117,254,90,116,48,98,60,36,2,37,23,14,3,3,28,14,14
"2021","New Forest 001G","E01023025",586,135,81,54,412,128,222,120,67,35,38,26,8,4,23,10,13,1,1,39,12,27
"2021","New Forest 002A","E01023076",627,167,124,43,434,120,213,88,79,46,71,39,25,7,27,10,17,3,3,26,8,18
"2021","New Forest 002B","E01023082",604,172,68,104,404,54,189,66,84,39,84,41,41,2,75,43,32,2,2,28,10,18
"2021","New Forest 002C","E01023083",665,221,94,127,413,53,188,74,74,40,74,36,33,5,93,54,39,5,5,31,10,21
"2021","New Forest 002D","E01023088",608,157,94,63,404,42,207,66,92,49,74,27,35,12,76,40,36,5,5,47,21,26
"2021","New Forest 003A","E01023073",509,119,37,82,367,51,220,72,89,59,63,33,28,2,31,18,13,2,2,23,9,14
"2021","New Forest 003B","E01023080",555,121,63,58,408,76,194,63,81,50,74,38,34,2,64,46,18,0,0,26,15,11
"2021","New Forest 003C","E01023081",762,157,73,84,551,57,309,92,158,59,101,48,48,5,79,36,43,5,5,54,28,26
"2021","New Forest 003D","E01023089",701,236,104,132,449,83,229,91,96,42,85,57,25,3,52,31,21,0,0,16,9,7
"2021","New Forest 003E","E01023090",810,254,83,171,533,44,275,106,114,55,116,71,42,3,96,58,38,2,2,23,8,15
"2021","New Forest 004A","E01023074",635,244,174,70,363,82,179,77,63,39,55,29,22,4,42,30,12,5,5,28,13,15
"2021","New Forest 004B","E01023077",826,337,116,221,459,45,174,67,81,26,125,68,49,8,108,81,27,7,7,30,11,19
"2021","New Forest 004C","E01023078",658,190,142,48,442,118,221,92,85,44,58,37,17,4,45,23,22,0,0,26,13,13
"2021","New Forest 004D","E01023079",713,166,71,95,506,73,242,73,109,60,107,54,46,7,80,46,34,4,4,41,12,29
"2021","New Forest 004E","E01023085",622,167,83,84,421,58,189,77,80,32,77,38,34,5,93,60,33,4,4,34,16,18
"2021","New Forest 005A","E01023072",545,142,51,91,383,40,208,78,94,36,76,47,28,1,54,31,23,5,5,20,7,13
"2021","New Forest 005B","E01023075",570,151,82,69,389,61,199,68,92,39,67,34,31,2,61,39,22,1,1,30,9,21
"2021","New Forest 005C","E01023084",618,151,98,53,443,73,255,88,122,45,61,36,20,5,54,24,30,0,0,24,9,15
"2021","New Forest 005D","E01023086",640,169,108,61,436,80,215,86,87,42,75,24,44,7,62,37,25,4,4,35,12,23
"2021","New Forest 005E","E01023087",614,168,34,134,429,33,230,85,113,32,106,67,33,6,59,37,22,1,1,17,4,13
"2021","New Forest 006A","E01022977",596,124,87,37,447,112,262,112,101,49,44,24,16,4,28,15,13,1,1,25,10,15
"2021","New Forest 006B","E01022978",638,138,85,53,449,129,247,100,97,50,49,27,15,7,24,10,14,0,0,51,21,30
"2021","New Forest 006C","E01022979",475,126,84,42,324,94,163,70,50,43,38,23,11,4,28,14,14,1,1,25,10,15
"2021","New Forest 006D","E01022980",571,135,91,44,405,108,221,81,91,49,44,23,15,6,30,17,13,2,2,31,13,18
"2021","New Forest 007A","E01022992",484,96,62,34,352,101,185,70,73,42,52,33,11,8,14,3,11,0,0,36,15,21
"2021","New Forest 007B","E01022993",551,137,78,59,376,102,196,92,57,47,52,34,10,8,25,10,15,1,1,38,12,26
"2021","New Forest 007C","E01023045",709,206,129,77,473,127,238,100,100,38,59,43,15,1,48,31,17,1,1,30,13,17
"2021","New Forest 007D","E01023046",662,214,112,102,402,106,181,82,74,25,68,46,21,1,44,20,24,3,3,46,12,34
"2021","New Forest 008A","E01023007",491,169,116,53,299,67,148,59,56,33,46,20,23,3,37,15,22,1,1,23,8,15
"2021","New Forest 008B","E01023010",628,213,70,143,392,36,171,72,75,24,91,40,42,9,90,55,35,4,4,23,10,13
"2021","New Forest 008C","E01023047",533,138,51,87,380,57,213,74,100,39,60,39,20,1,50,31,19,0,0,15,5,10
"2021","New Forest 008D","E01023048",510,82,54,28,398,94,216,81,88,47,55,30,21,4,31,14,17,2,2,30,11,19
"2021","New Forest 008E","E01023049",669,210,52,158,439,47,232,96,107,29,87,65,21,1,69,49,20,4,4,20,9,11
"2021","New Forest 008F","E01023050",683,153,44,109,505,62,303,107,157,39,77,47,30,0,59,43,16,4,4,25,16,9
"2021","New Forest 009A","E01023008",884,414,279,135,444,180,178,100,54,24,53,36,16,1,30,15,15,3,3,26,8,18
"2021","New Forest 009B","E01023009",639,182,70,112,434,74,234,94,102,38,76,46,26,4,49,29,20,1,1,23,8,15
"2021","New Forest 009C","E01023038",627,153,112,41,454,125,220,101,83,36,63,34,24,5,45,26,19,1,1,20,9,11
"2021","New Forest 009D","E01023039",644,200,123,77,414,105,180,65,74,41,73,42,30,1,54,32,22,2,2,30,10,20
"2021","New Forest 009E","E01023040",656,162,125,37,477,161,220,95,79,46,50,31,18,1,43,23,20,3,3,17,7,10
"2021","New Forest 010A","E01023026",471,108,58,50,336,87,193,102,54,37,26,17,7,2,26,12,14,4,4,27,9,18
"2021","New Forest 010B","E01023062",567,98,53,45,437,98,251,89,111,51,47,31,13,3,40,21,19,1,1,32,15,17
"2021","New Forest 010C","E01023064",538,106,60,46,407,67,207,74,91,42,61,32,23,6,71,44,27,1,1,25,10,15
"2021","New Forest 010D","E01023066",713,182,129,53,500,131,274,102,124,48,54,27,24,3,41,24,17,0,0,31,16,15
"2021","New Forest 010E","E01023067",606,140,93,47,426,98,232,69,126,37,56,28,25,3,39,23,16,1,1,40,12,28
"2021","New Forest 011A","E01023003",769,205,152,53,527,151,267,127,92,48,59,36,19,4,49,25,24,1,1,37,20,17
"2021","New Forest 011B","E01023004",706,131,86,45,534,103,299,110,133,56,66,29,35,2,63,29,34,3,3,41,10,31
"2021","New Forest 011C","E01023005",633,163,115,48,438,128,219,98,85,36,56,27,26,3,35,13,22,0,0,32,15,17
"2021","New Forest 011D","E01023006",497,105,51,54,338,21,158,42,76,40,55,22,30,3,97,64,33,7,7,54,23,31
"2021","New Forest 011E","E01023028",855,213,102,111,611,98,317,105,150,62,93,40,43,10,98,72,26,5,5,31,10,21
"2021","New Forest 011F","E01023037",925,335,190,145,542,100,218,87,97,34,107,52,45,10,109,74,35,8,8,48,12,36
"2021","New Forest 012A","E01023065",656,167,105,62,455,93,219,68,105,46,62,30,30,2,76,30,46,5,5,34,14,20
"2021","New Forest 012B","E01023068",526,135,69,66,358,55,167,52,75,40,52,24,20,8,82,41,41,2,2,33,16,17
"2021","New Forest 012C","E01023069",834,254,157,97,538,105,232,71,126,35,117,66,46,5,82,50,32,2,2,42,18,24
"2021","New Forest 012D","E01023070",997,509,299,210,448,94,140,60,60,20,113,71,34,8,96,58,38,5,5,40,15,25
"2021","New Forest 012E","E01023071",683,233,83,150,420,68,170,77,68,25,112,64,47,1,66,44,22,4,4,30,13,17
"2021","New Forest 013A","E01023029",634,146,91,55,447,30,182,66,79,37,70,14,49,7,158,119,39,7,7,41,29,12
"2021","New Forest 013B","E01023030",508,122,53,69,364,52,174,60,79,35,75,26,44,5,61,39,22,2,2,22,6,16
"2021","New Forest 013C","E01023032",559,136,93,43,387,98,196,91,69,36,54,22,24,8,37,16,21,2,2,36,21,15
"2021","New Forest 013D","E01023033",528,107,57,50,391,70,166,75,59,32,67,34,29,4,86,54,32,2,2,30,7,23
"2021","New Forest 014A","E01023013",629,170,114,56,436,98,225,105,93,27,68,32,31,5,44,21,23,1,1,23,6,17
"2021","New Forest 014B","E01023014",753,219,148,71,489,139,221,105,75,41,77,45,29,3,50,30,20,2,2,45,15,30
"2021","New Forest 014C","E01023015",598,156,81,75,395,86,204,90,75,39,50,28,20,2,53,28,25,2,2,47,25,22
"2021","New Forest 014D","E01023016",623,174,125,49,428,129,233,117,66,50,41,24,14,3,24,11,13,1,1,21,11,10
"2021","New Forest 014E","E01023027",606,176,86,90,393,87,198,74,82,42,59,29,27,3,49,27,22,0,0,37,18,19
"2021","New Forest 014F","E01023031",549,159,84,75,355,80,151,73,48,30,67,35,27,5,54,27,27,3,3,35,14,21
"2021","New Forest 015A","E01022989",725,194,142,52,507,125,267,101,104,62,52,18,25,9,62,32,30,1,1,24,7,17
"2021","New Forest 015B","E01022991",901,222,142,80,631,194,341,137,131,73,58,38,16,4,34,17,17,4,4,48,21,27
"2021","New Forest 015C","E01022998",675,113,85,28,530,170,296,127,113,56,33,20,11,2,31,11,20,0,0,32,20,12
"2021","New Forest 015D","E01023000",793,291,211,80,462,115,212,81,97,34,67,35,29,3,64,34,30,4,4,40,19,21
"2021","New Forest 016A","E01022994",676,174,132,42,473,143,240,109,85,46,38,17,18,3,50,28,22,2,2,29,10,19
"2021","New Forest 016B","E01022995",581,134,92,42,429,106,240,82,121,37,42,20,22,0,40,18,22,1,1,18,6,12
"2021","New Forest 016C","E01022996",512,125,76,49,353,84,186,88,59,39,43,24,17,2,39,19,20,1,1,34,11,23
"2021","New Forest 016D","E01022997",566,156,90,66,379,93,227,106,73,48,27,13,9,5,32,22,10,0,0,31,11,20
"2021","New Forest 016E","E01023063",549,96,51,45,421,74,230,80,110,40,75,41,32,2,42,28,14,0,0,32,9,23
"2021","New Forest 017A","E01022990",620,162,96,66,430,104,231,91,98,42,55,28,18,9,39,17,22,1,1,28,9,19
"2021","New Forest 017B","E01022999",903,251,130,121,599,129,321,144,115,62,87,48,34,5,58,32,26,4,4,53,25,28
"2021","New Forest 017C","E01023041",770,234,153,81,518,196,222,105,92,25,52,33,13,6,46,18,28,2,2,18,11,7
"2021","New Forest 017D","E01023042",953,526,296,230,405,118,128,78,32,18,88,74,12,2,66,42,24,5,5,22,7,15
"2021","New Forest 017E","E01023043",826,326,203,123,468,127,214,93,90,31,66,38,22,6,57,35,22,4,4,32,13,19
"2021","New Forest 018A","E01022984",657,165,125,40,447,178,193,92,58,43,49,27,12,10,27,9,18,0,0,45,17,28
"2021","New Forest 018B","E01022985",526,128,81,47,380,91,186,89,65,32,53,29,21,3,46,22,24,4,4,18,8,10
"2021","New Forest 018C","E01023020",633,139,108,31,464,148,218,104,62,52,58,25,27,6,39,18,21,1,1,30,9,21
"2021","New Forest 018D","E01023034",811,250,163,87,530,168,235,85,108,42,79,41,34,4,45,25,20,3,3,31,9,22
"2021","New Forest 018E","E01023035",757,190,125,65,520,130,251,93,106,52,75,34,33,8,60,29,31,4,4,47,15,32
"2021","New Forest 018F","E01023036",931,257,208,49,631,258,265,122,91,52,59,33,22,4,47,24,23,2,2,43,14,29
"2021","New Forest 019A","E01023001",950,318,152,166,599,99,266,129,105,32,137,78,55,4,93,62,31,4,4,33,17,16
"2021","New Forest 019B","E01023002",778,279,150,129,453,93,197,77,91,29,80,46,27,7,82,51,31,1,1,46,13,33
"2021","New Forest 019C","E01023058",623,189,102,87,404,44,169,63,68,38,84,44,27,13,105,61,44,2,2,30,13,17
"2021","New Forest 019D","E01023060",654,146,99,47,473,121,267,110,112,45,41,24,14,3,41,21,20,3,3,35,13,22
"2021","New Forest 019E","E01023061",664,232,122,110,395,70,179,69,80,30,74,44,22,8,70,42,28,2,2,37,10,27
"2021","New Forest 020A","E01023017",803,203,123,80,575,147,268,89,111,68,75,31,34,10,82,46,36,3,3,25,13,12
"2021","New Forest 020B","E01023018",688,253,145,108,398,117,142,57,55,30,52,34,17,1,80,49,31,7,7,37,14,23
"2021","New Forest 020C","E01023019",669,255,96,159,395,33,171,60,70,41,103,59,33,11,83,51,32,5,5,19,6,13
"2021","New Forest 020D","E01023055",511,133,62,71,345,37,155,48,71,36,58,17,37,4,90,50,40,5,5,33,17,16
"2021","New Forest 021A","E01022986",645,189,134,55,421,125,206,83,80,43,48,26,19,3,41,25,16,1,1,35,13,22
"2021","New Forest 021B","E01022988",635,218,101,117,383,63,164,64,72,28,64,37,19,8,90,50,40,2,2,34,13,21
"2021","New Forest 021C","E01023054",859,316,204,112,499,163,196,72,78,46,74,40,29,5,63,31,32,3,3,44,10,34
"2021","New Forest 021D","E01023056",795,346,246,100,420,138,153,74,59,20,72,43,26,3,54,36,18,3,3,29,8,21
"2021","New Forest 021E","E01023057",893,384,233,151,469,128,164,68,62,34,90,56,27,7,83,52,31,4,4,40,13,27
"2021","New Forest 022A","E01022981",907,256,190,66,615,288,263,145,53,65,37,29,5,3,23,9,14,4,4,36,7,29
"2021","New Forest 022B","E01022982",947,335,229,106,576,244,217,120,60,37,61,36,19,6,50,25,25,4,4,36,10,26
"2021","New Forest 022C","E01022983",791,256,166,90,512,196,241,132,60,49,32,21,5,6,40,15,25,3,3,23,6,17
"2021","New Forest 022D","E01022987",896,250,194,56,604,280,234,114,74,46,54,28,22,4,34,12,22,2,2,42,11,31
"2021","New Forest 023A","E01023044",538,180,143,37,346,165,140,64,59,17,19,17,2,0,22,8,14,0,0,12,4,8
"2021","New Forest 023B","E01023051",663,193,129,64,440,144,199,79,79,41,53,25,25,3,43,25,18,1,1,30,6,24
"2021","New Forest 023C","E01023052",928,347,261,86,544,256,200,119,47,34,54,36,14,4,32,17,15,2,2,37,8,29
"2021","New Forest 023D","E01023053",837,278,218,60,533,232,223,119,67,37,46,27,15,4,28,13,15,4,4,26,7,19
"2021","New Forest 023E","E01023059",786,247,166,81,497,161,226,107,83,36,53,30,18,5,54,24,30,3,3,42,14,28
"2021","Rushmoor 001A","E01023099",608,130,59,71,436,55,202,64,97,41,76,31,38,7,101,61,40,2,2,42,14,28
"2021","Rushmoor 001B","E01023104",596,143,72,71,367,55,184,48,84,52,59,24,32,3,64,35,29,5,5,86,44,42
"2021","Rushmoor 001C","E01023106",572,164,66,98,331,28,148,52,55,41,65,30,22,13,89,51,38,1,1,77,33,44
"2021","Rushmoor 001D","E01023121",767,167,95,72,538,63,267,90,101,76,94,39,49,6,111,56,55,3,3,62,31,31
"2021","Rushmoor 002A","E01023105",611,181,94,87,348,31,174,47,72,55,62,29,25,8,76,51,25,5,5,82,37,45
"2021","Rushmoor 002B","E01023119",464,128,44,84,280,20,113,26,51,36,38,11,22,5,107,71,36,2,2,56,20,36
"2021","Rushmoor 002C","E01023120",606,146,60,86,365,30,185,38,90,57,57,22,31,4,92,49,43,1,1,95,48,47
"2021","Rushmoor 002D","E01023122",504,88,41,47,330,20,173,44,88,41,59,21,33,5,71,44,27,7,7,86,38,48
"2021","Rushmoor 002E","E01023146",474,79,32,47,332,22,160,42,74,44,57,17,34,6,92,48,44,1,1,63,28,35
"2021","Rushmoor 003A","E01023100",488,123,40,83,327,23,163,51,90,22,72,37,29,6,64,32,32,5,5,38,16,22
"2021","Rushmoor 003B","E01023101",487,109,67,42,347,62,205,72,77,56,41,23,18,0,38,16,22,1,1,31,9,22
"2021","Rushmoor 003C","E01023102",570,130,68,62,404,86,210,64,96,50,66,30,29,7,42,24,18,0,0,36,15,21
"2021","Rushmoor 003D","E01023134",695,175,53,122,478,54,255,73,133,49,104,64,34,6,64,31,33,1,1,42,18,24
"2021","Rushmoor 003E","E01023147",568,99,63,36,397,79,206,69,81,56,48,25,21,2,57,26,31,7,7,72,34,38
"2021","Rushmoor 004A","E01023096",1014,312,109,203,638,81,374,114,204,56,94,73,18,3,82,51,31,7,7,64,20,44
"2021","Rushmoor 004B","E01023097",619,122,57,65,445,89,254,105,112,37,64,44,16,4,35,15,20,3,3,52,23,29
"2021","Rushmoor 004C","E01023103",625,139,76,63,441,58,274,101,120,53,66,45,20,1,40,19,21,3,3,45,12,33
"2021","Rushmoor 004D","E01023111",777,239,115,124,494,110,254,79,132,43,79,50,22,7,47,27,20,4,4,44,16,28
"2021","Rushmoor 004E","E01023112",469,87,47,40,351,29,216,59,126,31,54,25,28,1,51,22,29,1,1,31,13,18
"2021","Rushmoor 005A","E01023092",568,121,43,78,429,41,267,97,128,42,75,44,27,4,43,24,19,3,3,18,5,13
"2021","Rushmoor 005B","E01023093",524,96,38,58,404,62,250,103,97,50,53,33,18,2,39,18,21,0,0,24,11,13
"2021","Rushmoor 005C","E01023132",616,161,78,83,406,51,235,67,107,61,65,34,24,7,51,23,28,4,4,49,22,27
"2021","Rushmoor 005D","E01023133",517,122,32,90,364,45,216,61,121,34,75,46,25,4,27,18,9,1,1,31,17,14
"2021","Rushmoor 005E","E01023135",953,223,88,135,672,80,359,86,217,56,139,75,56,8,94,61,33,0,0,58,24,34
"2021","Rushmoor 006A","E01023091",699,185,74,111,461,18,200,58,93,49,87,32,51,4,151,110,41,5,5,53,25,28
"2021","Rushmoor 006B","E01023094",554,156,64,92,369,62,208,65,109,34,57,33,21,3,41,24,17,1,1,29,16,13
"2021","Rushmoor 006C","E01023095",816,273,104,169,485,45,248,71,135,42,109,65,40,4,80,48,32,3,3,58,19,39
"2021","Rushmoor 006D","E01023098",742,227,98,129,455,59,234,78,111,45,82,53,27,2,79,50,29,1,1,60,21,39
"2021","Rushmoor 006E","E01023148",581,192,83,109,348,58,173,61,70,42,65,42,21,2,49,22,27,3,3,41,22,19
"2021","Rushmoor 006F","E01023149",528,125,73,52,357,74,201,56,88,57,52,30,22,0,27,10,17,3,3,46,24,22
"2021","Rushmoor 007A","E01023113",849,305,98,207,489,53,253,91,125,37,109,77,29,3,65,43,22,9,9,55,12,43
"2021","Rushmoor 007B","E01023114",545,100,39,61,415,44,258,60,151,47,67,34,29,4,46,32,14,0,0,30,8,22
"2021","Rushmoor 007C","E01023136",1073,323,63,260,685,20,383,104,233,46,168,115,51,2,107,73,34,7,7,65,20,45
"2021","Rushmoor 007D","E01023137",555,137,38,99,385,37,184,42,108,34,89,53,30,6,71,47,24,4,4,33,10,23
"2021","Rushmoor 007E","E01023138",716,316,97,219,368,40,172,67,78,27,79,53,21,5,70,42,28,7,7,32,5,27
"2021","Rushmoor 007F","E01023139",529,191,76,115,307,34,160,53,79,28,62,34,23,5,48,28,20,3,3,31,14,17
"2021","Rushmoor 007G","E01023140",654,205,49,156,418,7,267,76,171,20,79,45,33,1,57,49,8,8,8,31,17,14
"2021","Rushmoor 008A","E01023141",630,106,3,103,481,5,340,86,237,17,79,38,40,1,53,43,10,4,4,43,21,22
"2021","Rushmoor 008D","E01023144",769,220,77,143,431,48,215,69,91,55,82,59,19,4,80,46,34,6,6,118,42,76
"2021","Rushmoor 008E","E01034727",796,139,8,131,579,14,342,99,216,27,141,95,43,3,81,70,11,1,1,78,45,33
"2021","Rushmoor 008F","E01034728",526,69,2,67,410,1,264,45,196,23,80,43,37,0,58,51,7,7,7,47,36,11
"2021","Rushmoor 008G","E01034729",563,158,41,117,367,13,211,42,152,17,77,50,23,4,58,43,15,8,8,38,23,15
"2021","Rushmoor 008H","E01034730",700,273,44,229,378,59,158,67,50,41,85,62,22,1,66,46,20,10,10,49,12,37
"2021","Rushmoor 009A","E01023118",735,225,81,144,398,32,196,58,91,47,90,51,34,5,71,43,28,9,9,112,56,56
"2021","Rushmoor 009B","E01023124",501,123,44,79,322,21,183,62,84,37,66,32,33,1,50,25,25,2,2,56,27,29
"2021","Rushmoor 009C","E01023125",943,219,77,142,650,64,343,107,174,62,128,68,57,3,104,53,51,11,11,74,27,47
"2021","Rushmoor 009F","E01032858",1031,299,79,220,658,32,259,70,129,60,163,83,72,8,197,140,57,7,7,74,31,43
"2021","Rushmoor 010A","E01023128",601,223,103,120,324,37,175,66,75,34,58,33,24,1,52,29,23,2,2,54,31,23
"2021","Rushmoor 010B","E01023129",571,178,53,125,319,24,152,38,71,43,75,45,27,3,63,37,26,5,5,74,26,48
"2021","Rushmoor 010C","E01023130",555,127,72,55,389,60,230,80,105,45,50,19,30,1,48,19,29,1,1,39,17,22
"2021","Rushmoor 010D","E01023131",599,194,127,67,357,64,211,79,86,46,40,23,13,4,37,17,20,5,5,48,15,33
"2021","Rushmoor 010E","E01023145",1098,452,123,329,563,58,261,98,115,48,123,80,39,4,108,66,42,13,13,83,26,57
"2021","Rushmoor 011A","E01023109",598,125,50,75,411,54,214,61,96,57,76,50,24,2,62,39,23,5,5,62,34,28
"2021","Rushmoor 011B","E01023115",529,99,33,66,386,63,231,77,109,45,40,22,17,1,48,24,24,4,4,44,23,21
"2021","Rushmoor 011C","E01023116",759,199,42,157,478,34,279,87,126,66,88,60,24,4,68,43,25,9,9,82,32,50
"2021","Rushmoor 011D","E01023117",683,134,65,69,512,89,287,83,138,66,83,39,32,12,50,21,29,3,3,37,16,21
"2021","Rushmoor 012A","E01023107",637,208,128,80,387,40,182,60,81,41,62,32,25,5,97,51,46,6,6,42,21,21
"2021","Rushmoor 012B","E01023108",626,204,92,112,379,34,170,53,80,37,79,41,31,7,94,47,47,2,2,43,22,21
"2021","Rushmoor 012C","E01023110",714,175,61,114,464,47,212,64,96,52,98,46,47,5,104,58,46,3,3,75,30,45
"2021","Rushmoor 012D","E01023123",589,134,57,77,388,38,223,54,111,58,66,23,35,8,59,30,29,2,2,67,29,38
"2021","Test Valley 001A","E01023165",877,205,99,106,621,121,392,167,167,58,69,48,16,5,38,24,14,1,1,51,16,35
"2021","Test Valley 001B","E01023169",923,265,165,100,624,136,331,115,149,67,89,55,33,1,64,26,38,4,4,34,16,18
"2021","Test Valley 001C","E01023181",509,75,28,47,403,47,250,96,102,52,57,33,21,3,45,20,25,4,4,31,15,16
"2021","Test Valley 001D","E01023182",637,152,53,99,459,57,255,99,111,45,85,52,30,3,57,32,25,5,5,26,9,17
"2021","Test Valley 002A","E01023153",779,277,79,198,439,30,174,86,62,26,127,65,58,4,102,66,36,6,6,63,22,41
"2021","Test Valley 002B","E01023154",628,149,64,85,424,32,168,62,78,28,97,43,47,7,123,83,40,4,4,55,21,34
"2021","Test Valley 002C","E01023156",467,89,32,57,331,13,134,37,70,27,78,26,45,7,99,66,33,7,7,47,15,32
"2021","Test Valley 002D","E01023157",521,124,45,79,352,30,162,49,80,33,69,25,36,8,90,60,30,1,1,45,13,32
"2021","Test Valley 002E","E01023205",467,106,31,75,307,19,138,36,70,32,61,25,27,9,88,58,30,1,1,54,27,27
"2021","Test Valley 004A","E01023179",747,188,82,106,517,52,244,87,113,44,107,63,40,4,110,68,42,4,4,42,10,32
"2021","Test Valley 004B","E01023183",576,162,81,81,387,42,200,70,101,29,71,35,29,7,72,44,28,2,2,27,14,13
"2021","Test Valley 004C","E01023190",577,236,130,106,312,66,164,64,73,27,49,34,14,1,32,18,14,1,1,29,9,20
"2021","Test Valley 004D","E01023203",658,214,115,99,407,74,204,92,70,42,78,46,27,5,51,36,15,0,0,37,19,18
"2021","Test Valley 004E","E01023204",752,265,100,165,443,38,167,64,77,26,134,83,43,8,94,55,39,10,10,44,10,34
"2021","Test Valley 005B","E01023180",717,200,129,71,478,120,245,82,122,41,61,38,19,4,48,26,22,4,4,39,18,21
"2021","Test Valley 005C","E01023186",725,229,101,128,459,74,237,82,109,46,83,47,30,6,62,41,21,3,3,37,15,22
"2021","Test Valley 005D","E01023189",625,132,71,61,447,74,267,93,133,41,52,28,19,5,51,30,21,3,3,46,15,31
"2021","Test Valley 005E","E01023196",710,190,94,96,489,112,281,115,100,66,58,35,18,5,34,20,14,4,4,31,10,21
"2021","Test Valley 005F","E01032870",736,163,85,78,522,105,300,85,142,73,67,36,24,7,46,28,18,4,4,51,15,36
"2021","Test Valley 005G","E01032871",639,196,107,89,408,76,216,76,92,48,77,46,26,5,38,22,16,1,1,35,12,23
"2021","Test Valley 006A","E01023187",650,188,74,114,427,71,239,95,105,39,71,49,18,4,42,26,16,4,4,35,8,27
"2021","Test Valley 006B","E01023188",505,107,55,52,379,55,228,95,91,42,65,34,26,5,31,19,12,0,0,19,5,14
"2021","Test Valley 006C","E01023216",867,322,133,189,502,66,214,83,96,35,117,74,37,6,93,60,33,12,12,43,17,26
"2021","Test Valley 006D","E01023217",716,224,111,113,444,93,233,89,98,46,79,52,26,1,37,24,13,2,2,48,18,30
"2021","Test Valley 006E","E01023218",636,159,95,64,449,114,227,87,94,46,60,31,24,5,46,25,21,2,2,28,12,16
"2021","Test Valley 007A","E01023159",971,236,142,94,694,139,387,176,156,55,102,59,33,10,64,38,26,2,2,41,19,22
"2021","Test Valley 007B","E01023195",760,127,55,72,604,85,396,137,221,38,67,41,25,1,56,37,19,0,0,29,14,15
"2021","Test Valley 007C","E01023197",598,124,60,64,443,68,243,100,98,45,66,37,26,3,61,40,21,5,5,31,9,22
"2021","Test Valley 007D","E01023198",619,133,77,56,452,101,259,122,98,39,59,40,18,1,32,14,18,1,1,34,7,27
"2021","Test Valley 008A","E01023160",588,126,87,39,443,123,248,100,102,46,45,32,11,2,25,11,14,2,2,19,4,15
"2021","Test Valley 008B","E01023168",653,173,113,60,451,134,233,114,82,37,54,33,20,1,26,12,14,4,4,29,5,24
"2021","Test Valley 008C","E01023178",957,214,118,96,707,143,423,161,201,61,85,59,22,4,53,29,24,3,3,36,10,26
"2021","Test Valley 009A","E01023166",691,173,85,88,484,107,283,131,116,36,60,40,17,3,30,19,11,4,4,34,14,20
"2021","Test Valley 009B","E01023167",696,199,125,74,458,118,251,117,90,44,52,32,18,2,37,17,20,0,0,39,12,27
"2021","Test Valley 009C","E01023177",910,185,101,84,673,145,373,148,157,68,95,50,39,6,59,31,28,1,1,52,21,31
"2021","Test Valley 009D","E01023184",559,81,38,43,458,82,271,110,106,55,71,40,27,4,33,14,19,1,1,20,8,12
"2021","Test Valley 009E","E01023185",532,145,85,60,367,79,194,85,81,28,55,37,18,0,39,19,20,0,0,20,11,9
"2021","Test Valley 010A","E01023174",724,211,91,120,480,90,265,86,129,50,64,40,21,3,59,32,27,2,2,33,17,16
"2021","Test Valley 010B","E01023175",698,193,123,70,487,165,239,85,103,51,45,33,11,1,36,16,20,2,2,18,5,13
"2021","Test Valley 010C","E01023176",728,260,137,123,440,103,197,81,81,35,81,48,27,6,56,29,27,3,3,28,8,20
"2021","Test Valley 010D","E01023207",694,191,111,80,483,134,233,70,128,35,65,38,24,3,51,33,18,0,0,20,9,11
"2021","Test Valley 010E","E01023208",469,135,77,58,319,47,160,53,70,37,64,31,27,6,48,32,16,0,0,15,3,12
"2021","Test Valley 010F","E01023209",546,139,85,54,392,94,210,69,108,33,49,30,17,2,39,28,11,0,0,15,7,8
"2021","Test Valley 011A","E01023150",850,361,197,164,453,110,205,75,83,47,73,51,21,1,65,35,30,0,0,36,11,25
"2021","Test Valley 011B","E01023151",736,360,217,143,347,79,115,58,42,15,89,60,23,6,61,39,22,3,3,29,5,24
"2021","Test Valley 011C","E01023152",924,450,307,143,448,145,177,92,58,27,67,48,17,2,55,29,26,4,4,26,5,21
"2021","Test Valley 011D","E01023206",527,202,142,60,308,73,135,54,48,33,45,22,21,2,51,24,27,4,4,17,7,10
"2021","Test Valley 012A","E01023158",1002,223,135,88,735,188,430,163,183,84,72,40,29,3,42,21,21,3,3,44,14,30
"2021","Test Valley 012B","E01023191",766,208,95,113,540,98,288,107,147,34,99,59,35,5,52,28,24,3,3,18,6,12
"2021","Test Valley 012C","E01023192",826,271,151,120,518,93,239,63,134,42,70,33,32,5,110,77,33,6,6,37,19,18
"2021","Test Valley 012D","E01023193",779,180,114,66,571,129,311,111,139,61,69,33,33,3,59,40,19,3,3,28,9,19
"2021","Test Valley 012E","E01023194",639,163,128,35,451,134,233,88,95,50,51,23,23,5,32,14,18,1,1,25,10,15
"2021","Test Valley 012F","E01023200",617,147,80,67,452,85,271,110,115,46,62,38,24,0,31,20,11,3,3,18,6,12
"2021","Test Valley 013A","E01023162",717,157,92,65,509,107,312,115,131,66,50,27,18,5,39,15,24,1,1,51,21,30
"2021","Test Valley 013B","E01023163",675,133,82,51,503,142,277,109,115,53,51,33,15,3,31,9,22,2,2,39,15,24
"2021","Test Valley 013C","E01023164",666,180,109,71,451,137,236,88,104,44,43,20,21,2,35,13,22,0,0,35,14,21
"2021","Test Valley 013E","E01035450",635,139,44,95,473,34,232,79,133,20,124,76,41,7,81,57,24,2,2,23,9,14
"2021","Test Valley 013F","E01035451",647,147,36,111,484,30,246,78,156,12,117,70,43,4,90,69,21,1,1,16,5,11
"2021","Test Valley 013G","E01035452",590,106,62,44,445,98,251,86,126,39,48,25,16,7,46,23,23,2,2,39,14,25
"2021","Test Valley 014A","E01023210",534,74,32,42,438,54,308,89,157,62,40,16,19,5,35,22,13,1,1,22,17,5
"2021","Test Valley 014B","E01023211",675,97,31,66,552,23,348,75,224,49,83,45,35,3,95,65,30,3,3,26,7,19
"2021","Test Valley 014C","E01023212",592,142,74,68,433,89,271,93,118,60,46,35,11,0,26,13,13,1,1,17,5,12
"2021","Test Valley 014D","E01023213",498,93,39,54,386,55,251,88,121,42,52,31,20,1,26,12,14,2,2,19,10,9
"2021","Test Valley 014E","E01023214",521,107,50,57,395,58,235,82,113,40,63,41,18,4,37,18,19,2,2,19,9,10
"2021","Test Valley 015A","E01023170",1087,295,148,147,743,107,354,123,177,54,169,98,68,3,108,78,30,5,5,49,15,34
"2021","Test Valley 015B","E01023171",644,119,65,54,454,116,269,95,130,44,44,16,24,4,22,8,14,3,3,71,44,27
"2021","Test Valley 015C","E01023172",613,116,76,40,480,115,279,121,99,59,57,36,14,7,27,13,14,2,2,17,9,8
"2021","Test Valley 015D","E01023173",587,117,78,39,453,121,247,99,100,48,46,22,19,5,36,18,18,3,3,17,7,10
"2021","Test Valley 016A","E01035453",545,111,24,87,409,18,225,66,136,23,130,69,60,1,32,23,9,4,4,25,11,14
"2021","Test Valley 016B","E01035454",583,172,65,107,372,62,219,86,93,40,48,25,19,4,40,18,22,3,3,39,15,24
"2021","Test Valley 016C","E01035455",636,119,14,105,472,5,268,93,158,17,112,58,50,4,83,62,21,4,4,45,25,20
"2021","Test Valley 016D","E01035456",627,124,12,112,466,17,235,69,145,21,107,56,48,3,104,81,23,3,3,37,13,24
"2021","Test Valley 016E","E01035457",594,155,7,148,397,4,191,55,127,9,146,92,51,3,52,44,8,4,4,42,21,21
"2021","Test Valley 017A","E01035458",591,78,12,66,478,7,225,69,133,23,138,60,73,5,106,91,15,2,2,35,21,14
"2021","Test Valley 017B","E01035459",622,102,15,87,487,36,239,71,150,18,154,103,49,2,53,43,10,5,5,33,8,25
"2021","Test Valley 017C","E01035460",525,142,71,71,356,46,172,43,97,32,62,16,40,6,72,39,33,4,4,27,7,20
"2021","Test Valley 017D","E01035461",512,126,12,114,369,9,173,49,115,9,115,61,52,2,69,54,15,3,3,17,7,10
"2021","Test Valley 017E","E01035462",603,151,16,135,412,6,222,62,144,16,119,58,59,2,62,53,9,3,3,40,22,18
"2021","Test Valley 018A","E01023202",1103,576,262,314,473,74,157,69,65,23,143,103,39,1,86,62,24,13,13,54,12,42
"2021","Test Valley 018C","E01023215",725,175,90,85,515,82,282,122,120,40,87,43,39,5,62,31,31,2,2,35,14,21
"2021","Test Valley 018B","E01023219",631,194,92,102,402,68,186,80,63,43,65,39,26,0,78,48,30,5,5,35,14,21
"2021","Winchester 001A","E01023286",652,190,109,81,447,82,243,87,119,37,73,39,31,3,49,32,17,0,0,15,9,6
"2021","Winchester 001B","E01023287",1129,188,102,86,892,172,587,189,308,90,71,42,25,4,62,41,21,0,0,49,23,26
"2021","Winchester 001C","E01023288",618,156,62,94,438,71,248,93,119,36,76,53,23,0,42,27,15,1,1,24,7,17
"2021","Winchester 002A","E01023236",817,174,101,73,607,140,375,133,191,51,61,41,19,1,30,21,9,1,1,36,11,25
"2021","Winchester 002B","E01023237",647,191,85,106,430,49,215,83,113,19,91,52,36,3,73,48,25,2,2,26,10,16
"2021","Winchester 002C","E01023238",640,159,82,77,454,76,272,107,127,38,63,35,25,3,43,23,20,0,0,27,10,17
"2021","Winchester 002D","E01023239",689,163,99,64,498,92,290,95,140,55,71,45,21,5,43,21,22,2,2,28,7,21
"2021","Winchester 003A","E01023240",869,198,139,59,621,142,353,87,208,58,56,33,16,7,67,35,32,3,3,50,21,29
"2021","Winchester 003B","E01023241",547,126,74,52,398,108,233,82,111,40,31,22,9,0,25,14,11,1,1,23,8,15
"2021","Winchester 003C","E01023248",688,132,105,27,539,139,318,102,172,44,41,21,20,0,38,23,15,3,3,17,4,13
"2021","Winchester 003D","E01023253",822,244,141,103,549,85,310,74,202,34,95,60,34,1,56,38,18,3,3,29,10,19
"2021","Winchester 003E","E01023274",972,203,116,87,718,103,405,139,220,46,119,65,52,2,88,68,20,3,3,51,12,39
"2021","Winchester 004A","E01023225",889,176,110,66,684,157,391,165,153,73,82,58,18,6,52,27,25,2,2,29,9,20
"2021","Winchester 004B","E01023278",727,252,164,88,452,127,218,86,100,32,44,25,16,3,62,29,33,1,1,23,11,12
"2021","Winchester 004C","E01023279",618,164,95,69,435,105,226,72,106,48,64,36,24,4,39,21,18,1,1,19,4,15
"2021","Winchester 004D","E01023280",602,118,66,52,454,96,269,102,125,42,51,26,20,5,38,20,18,0,0,30,9,21
"2021","Winchester 004E","E01023281",911,403,287,116,476,137,197,76,87,34,65,41,20,4,75,44,31,2,2,32,7,25
"2021","Winchester 005A","E01023247",678,196,123,73,453,104,272,92,143,37,44,32,12,0,28,16,12,5,5,29,8,21
"2021","Winchester 005B","E01023249",565,170,97,73,368,71,208,67,111,30,47,23,21,3,42,22,20,0,0,27,7,20
"2021","Winchester 005C","E01023250",698,187,88,99,451,56,238,53,143,42,65,28,33,4,87,58,29,5,5,60,26,34
"2021","Winchester 005D","E01023268",477,106,41,65,345,47,210,58,129,23,50,34,16,0,34,23,11,4,4,26,7,19
"2021","Winchester 005E","E01023269",726,167,61,106,477,81,278,89,153,36,67,49,13,5,47,29,18,4,4,82,8,74
"2021","Winchester 005F","E01023270",458,102,53,49,327,31,205,61,122,22,59,32,24,3,28,21,7,4,4,29,6,23
"2021","Winchester 006A","E01023251",655,330,193,137,274,34,127,53,63,11,69,55,11,3,41,24,17,3,3,51,4,47
"2021","Winchester 006B","E01023255",739,279,75,204,403,35,189,81,70,38,101,69,29,3,71,46,25,7,7,57,2,55
"2021","Winchester 006C","E01023256",642,201,66,135,340,26,124,35,63,26,78,35,36,7,104,68,36,8,8,101,12,89
"2021","Winchester 006D","E01023257",747,263,124,139,434,68,201,77,94,30,96,55,38,3,57,32,25,12,12,50,9,41
"2021","Winchester 006E","E01023258",564,167,78,89,343,46,163,65,72,26,66,32,25,9,63,37,26,5,5,54,13,41
"2021","Winchester 007A","E01023252",1043,548,165,383,406,39,173,83,76,14,135,116,17,2,49,27,22,10,10,89,1,88
"2021","Winchester 007B","E01023254",855,318,132,186,504,49,264,89,146,29,132,102,24,6,55,33,22,4,4,33,4,29
"2021","Winchester 007C","E01023263",686,236,94,142,394,94,179,75,84,20,66,56,10,0,52,30,22,3,3,56,7,49
"2021","Winchester 007D","E01023264",698,350,148,202,316,42,161,83,65,13,76,66,8,2,31,19,12,6,6,32,1,31
"2021","Winchester 007E","E01023265",823,334,170,164,445,77,255,77,154,24,75,55,15,5,36,21,15,2,2,44,6,38
"2021","Winchester 007F","E01023267",547,193,60,133,327,21,193,65,119,9,76,53,22,1,31,21,10,6,6,27,1,26
"2021","Winchester 008A","E01023260",498,126,47,79,267,19,109,34,52,23,57,18,38,1,78,54,24,4,4,105,8,97
"2021","Winchester 008B","E01023261",645,201,93,108,322,28,152,50,69,33,51,17,27,7,88,54,34,3,3,122,12,110
"2021","Winchester 008C","E01023262",502,88,45,43,259,28,107,30,51,26,48,12,34,2,68,37,31,8,8,155,14,141
"2021","Winchester 008D","E01023266",591,154,86,68,345,65,198,55,100,43,38,22,13,3,41,30,11,3,3,92,8,84
"2021","Winchester 009A","E01023229",822,173,119,54,613,121,359,122,178,59,78,39,32,7,53,23,30,2,2,36,13,23
"2021","Winchester 009B","E01023242",489,116,56,60,346,58,212,66,116,30,45,33,11,1,29,16,13,2,2,27,11,16
"2021","Winchester 009C","E01023243",600,206,76,130,353,29,165,69,80,16,96,80,16,0,61,36,25,2,2,41,10,31
"2021","Winchester 009D","E01023244",663,149,121,28,490,157,264,97,118,49,40,20,18,2,27,15,12,2,2,24,6,18
"2021","Winchester 009E","E01023259",764,144,70,74,538,76,315,90,185,40,50,32,18,0,93,68,25,4,4,82,12,70
"2021","Winchester 010A","E01023226",684,184,102,82,482,94,281,70,174,37,58,37,15,6,49,31,18,0,0,18,4,14
"2021","Winchester 010B","E01023227",870,265,144,121,572,90,304,103,153,48,96,55,35,6,77,44,33,5,5,33,13,20
"2021","Winchester 010C","E01023228",969,247,160,87,692,142,401,136,213,52,85,55,24,6,63,43,20,1,1,30,10,20
"2021","Winchester 010D","E01023230",826,183,91,92,604,130,377,111,208,58,50,25,23,2,42,26,16,5,5,39,17,22
"2021","Winchester 010E","E01023246",620,117,66,51,453,97,275,101,128,46,58,35,19,4,22,11,11,1,1,50,17,33
"2021","Winchester 011A","E01023235",898,205,125,80,657,163,354,155,139,60,86,54,27,5,51,31,20,3,3,36,14,22
"2021","Winchester 011B","E01023275",671,147,99,48,497,84,295,110,139,46,67,36,28,3,51,37,14,0,0,27,7,20
"2021","Winchester 011C","E01023276",690,129,72,57,538,111,324,117,151,56,63,21,38,4,40,24,16,0,0,23,11,12
"2021","Winchester 011D","E01023277",504,80,47,33,392,91,231,103,84,44,41,23,15,3,28,14,14,1,1,32,13,19
"2021","Winchester 011E","E01023282",903,221,117,104,631,142,354,150,152,52,68,42,20,6,62,40,22,5,5,51,17,34
"2021","Winchester 012A","E01023220",877,265,104,161,573,105,298,97,155,46,112,69,40,3,57,31,26,1,1,39,10,29
"2021","Winchester 012B","E01023221",920,366,227,139,517,141,233,88,106,39,79,49,29,1,62,41,21,2,2,37,14,23
"2021","Winchester 012C","E01023222",679,205,133,72,446,120,247,95,108,44,50,36,12,2,27,14,13,2,2,28,11,17
"2021","Winchester 012D","E01023223",669,199,111,88,453,94,224,78,109,37,70,32,30,8,63,34,29,2,2,17,7,10
"2021","Winchester 012E","E01023272",672,166,79,87,480,78,259,100,126,33,90,49,36,5,51,29,22,2,2,26,13,13
"2021","Winchester 012F","E01023273",671,133,74,59,505,97,305,114,142,49,62,40,20,2,38,24,14,3,3,33,12,21
"2021","Winchester 013A","E01023245",1080,254,141,113,782,138,461,168,210,83,118,70,38,10,62,42,20,3,3,44,13,31
"2021","Winchester 013B","E01023271",500,115,68,47,354,65,195,75,78,42,56,26,25,5,37,20,17,1,1,31,11,20
"2021","Winchester 013E","E01023285",731,256,160,96,438,83,220,92,96,32,58,19,34,5,76,54,22,1,1,37,12,25
"2021","Winchester 013F","E01032859",664,112,31,81,514,33,335,114,173,48,90,54,31,5,53,44,9,3,3,38,15,23
"2021","Winchester 013G","E01032860",687,185,35,150,468,22,241,87,135,19,119,86,31,2,68,51,17,18,18,34,7,27
"2021","Winchester 013H","E01034731",671,234,32,202,419,18,194,81,91,22,132,87,43,2,71,51,20,4,4,18,6,12
"2021","Winchester 013I","E01034732",596,188,91,97,373,82,182,78,65,39,61,40,20,1,44,21,23,4,4,35,17,18
"2021","Winchester 014B","E01023231",764,153,90,63,565,130,317,137,117,63,74,42,29,3,42,25,17,2,2,46,14,32
"2021","Winchester 014C","E01023232",1097,220,88,132,823,116,451,169,203,79,155,81,68,6,94,64,30,7,7,54,21,33
"2021","Winchester 014D","E01023233",774,240,158,82,507,83,307,99,138,70,71,48,18,5,46,31,15,0,0,27,8,19
"2021","Winchester 014E","E01023234",689,225,126,99,439,70,225,94,89,42,73,36,35,2,69,31,38,2,2,25,13,12
"2021","Winchester 014F","E01034733",692,168,84,84,495,122,283,125,126,32,52,29,21,2,38,19,19,0,0,29,15,14
"2021","Winchester 014G","E01034734",637,129,11,118,485,11,208,63,133,12,161,89,68,4,101,86,15,4,4,23,10,13
"2021","Ashford 001B","E01023987",445,123,76,47,304,65,150,66,58,26,43,20,22,1,46,21,25,0,0,18,7,11
"2021","Ashford 001C","E01023988",623,132,69,63,448,91,247,90,117,40,63,42,21,0,45,30,15,2,2,43,23,20
"2021","Ashford 001D","E01024040",600,217,137,80,364,60,173,69,85,19,56,29,25,2,71,46,25,4,4,19,8,11
"2021","Ashford 001E","E01024041",525,186,125,61,316,71,175,65,89,21,42,22,17,3,26,14,12,2,2,23,7,16
"2021","Ashford 001F","E01032810",621,151,55,96,434,37,182,51,99,32,96,41,51,4,116,77,39,3,3,36,13,23
"2021","Ashford 001G","E01032812",680,131,62,69,512,84,304,101,153,50,77,38,34,5,47,27,20,0,0,37,12,25
"2021","Ashford 002A","E01023985",548,180,118,62,334,118,151,76,52,23,36,24,9,3,25,18,7,4,4,34,14,20
"2021","Ashford 002B","E01023986",652,185,95,90,440,89,191,73,84,34,89,41,44,4,67,41,26,4,4,27,11,16
"2021","Ashford 002C","E01023989",502,84,57,27,395,78,241,82,114,45,52,28,16,8,23,10,13,1,1,23,13,10
"2021","Ashford 002D","E01023990",543,157,89,68,365,68,182,77,65,40,60,37,19,4,52,26,26,3,3,21,7,14
"2021","Ashford 002E","E01024033",734,156,81,75,542,114,297,114,118,65,77,46,25,6,52,29,23,2,2,36,14,22
"2021","Ashford 002F","E01024035",456,117,67,50,316,84,160,67,56,37,46,26,13,7,26,12,14,0,0,23,10,13
"2021","Ashford 003A","E01023983",620,175,123,52,416,102,211,64,99,48,58,25,28,5,43,21,22,2,2,29,19,10
"2021","Ashford 003B","E01023999",933,218,147,71,680,174,371,139,157,75,70,34,31,5,63,35,28,2,2,35,16,19
"2021","Ashford 003D","E01032811",588,111,37,74,439,30,228,51,127,50,83,47,34,2,94,56,38,4,4,38,17,21
"2021","Ashford 003E","E01032822",568,133,78,55,398,62,220,72,97,51,59,28,29,2,56,31,25,1,1,37,17,20
"2021","Ashford 005A","E01023973",1104,334,83,251,682,45,266,63,162,41,164,73,87,4,197,151,46,10,10,88,42,46
"2021","Ashford 005B","E01024002",596,169,47,122,374,26,157,49,79,29,101,57,44,0,83,58,25,7,7,53,17,36
"2021","Ashford 005C","E01024023",985,219,79,140,665,56,344,98,172,74,132,66,57,9,126,78,48,7,7,101,44,57
"2021","Ashford 005E","E01024029",987,264,104,160,625,73,304,100,136,68,126,58,55,13,115,72,43,7,7,98,35,63
"2021","Ashford 005F","E01034985",598,222,40,182,313,29,138,40,74,24,70,37,30,3,71,53,18,5,5,63,17,46
"2021","Ashford 005G","E01034986",691,343,51,292,294,9,104,58,38,8,124,104,18,2,43,36,7,14,14,54,6,48
"2021","Ashford 006A","E01023972",532,112,43,69,375,45,163,46,81,36,75,29,42,4,90,51,39,2,2,45,25,20
"2021","Ashford 006B","E01023995",471,114,60,54,338,62,199,64,88,47,42,18,18,6,35,19,16,0,0,19,11,8
"2021","Ashford 006C","E01023996",475,81,42,39,372,39,228,67,112,49,66,27,32,7,37,13,24,2,2,22,10,12
"2021","Ashford 006D","E01024003",781,212,121,91,528,136,255,109,103,43,60,22,32,6,74,46,28,3,3,41,10,31
"2021","Ashford 006E","E01024004",890,200,101,99,629,102,341,129,161,51,125,70,48,7,59,38,21,2,2,61,19,42
"2021","Ashford 006F","E01024005",643,178,88,90,428,48,224,77,105,42,87,38,45,4,65,40,25,4,4,37,19,18
"2021","Ashford 007A","E01023974",553,135,56,79,355,36,146,40,66,40,71,26,34,11,99,71,28,3,3,63,29,34
"2021","Ashford 007B","E01023975",769,154,71,83,529,36,241,73,105,63,96,33,58,5,151,107,44,5,5,86,43,43
"2021","Ashford 007C","E01023977",597,182,85,97,380,42,170,58,87,25,95,47,46,2,70,47,23,3,3,35,13,22
"2021","Ashford 007D","E01024016",642,244,79,165,369,43,157,57,70,30,100,60,36,4,64,45,19,5,5,29,15,14
"2021","Ashford 007E","E01024017",814,248,136,112,536,65,261,84,139,38,133,79,50,4,74,50,24,3,3,30,16,14
"2021","Ashford 007F","E01024028",714,207,79,128,452,34,140,41,69,30,94,30,55,9,175,129,46,9,9,55,22,33
"2021","Ashford 008A","E01023976",719,268,135,133,374,42,195,47,86,62,66,19,39,8,68,39,29,3,3,77,37,40
"2021","Ashford 008B","E01024019",556,107,29,78,383,20,166,39,98,29,85,26,52,7,107,76,31,5,5,66,31,35
"2021","Ashford 008C","E01024020",643,105,38,67,458,17,182,34,107,41,88,22,56,10,164,119,45,7,7,80,50,30
"2021","Ashford 008E","E01032816",767,153,40,113,575,44,307,79,174,54,153,73,67,13,67,51,16,4,4,39,19,20
"2021","Ashford 008F","E01032823",607,126,50,76,447,39,222,83,97,42,96,33,54,9,83,59,24,7,7,34,18,16
"2021","Ashford 009A","E01024001",669,212,116,96,402,48,177,64,75,38,90,40,39,11,77,52,25,10,10,55,22,33
"2021","Ashford 009B","E01024006",443,59,29,30,344,41,222,74,100,48,45,19,21,5,33,22,11,3,3,40,18,22
"2021","Ashford 009D","E01024008",711,103,39,64,566,42,352,97,177,78,108,49,47,12,62,39,23,2,2,42,24,18
"2021","Ashford 009F","E01032815",424,132,40,92,257,17,112,32,65,15,59,30,26,3,65,40,25,4,4,35,10,25
"2021","Ashford 009G","E01032817",450,104,22,82,308,10,160,42,90,28,70,34,33,3,62,43,19,6,6,38,13,25
"2021","Ashford 009H","E01032818",554,102,30,72,429,29,238,51,147,40,99,45,50,4,61,47,14,2,2,23,7,16
"2021","Ashford 009I","E01032819",632,111,33,78,479,36,259,66,152,41,99,49,44,6,85,69,16,0,0,42,22,20
"2021","Ashford 009J","E01032824",595,154,59,95,414,40,212,73,96,43,95,49,37,9,66,48,18,1,1,27,8,19
"2021","Ashford 010A","E01024013",810,210,122,88,575,126,292,120,137,35,87,43,38,6,69,44,25,1,1,25,12,13
"2021","Ashford 010B","E01024014",748,152,86,66,534,119,314,127,127,60,54,29,20,5,44,19,25,3,3,62,25,37
"2021","Ashford 010C","E01024015",662,145,83,62,469,120,271,119,107,45,57,33,22,2,21,11,10,0,0,48,26,22
"2021","Ashford 010E","E01034987",608,118,12,106,467,6,237,67,158,12,139,71,66,2,83,69,14,2,2,23,11,12
"2021","Ashford 010F","E01034988",635,115,62,53,482,71,289,101,151,37,84,55,24,5,37,22,15,1,1,38,20,18
"2021","Ashford 010G","E01034989",658,132,51,81,495,56,278,91,145,42,91,46,38,7,70,45,25,0,0,31,14,17
"2021","Ashford 011A","E01023978",558,120,59,61,398,121,204,85,84,35,38,26,9,3,35,16,19,0,0,40,15,25
"2021","Ashford 011B","E01023979",556,139,85,54,395,71,190,57,99,34,66,36,26,4,67,42,25,1,1,22,8,14
"2021","Ashford 011C","E01024032",824,195,105,90,581,146,277,118,99,60,81,38,35,8,73,43,30,4,4,48,24,24
"2021","Ashford 011D","E01024036",571,114,54,60,424,93,238,85,110,43,56,28,22,6,36,19,17,1,1,33,12,21
"2021","Ashford 012B","E01024031",710,191,104,87,474,120,241,104,89,48,59,30,28,1,53,30,23,1,1,45,12,33
"2021","Ashford 012C","E01024038",909,265,187,78,599,192,272,125,96,51,72,40,25,7,60,30,30,3,3,45,19,26
"2021","Ashford 012D","E01024039",650,143,87,56,463,103,258,93,114,51,60,31,20,9,42,25,17,0,0,44,18,26
"2021","Ashford 012E","E01032813",735,173,46,127,519,18,262,66,163,33,147,81,62,4,89,73,16,3,3,43,19,24
"2021","Ashford 012F","E01032814",812,170,76,94,592,85,323,113,161,49,102,45,46,11,78,45,33,4,4,50,29,21
"2021","Ashford 013A","E01024009",631,149,97,52,453,132,217,113,67,37,56,35,17,4,45,27,18,3,3,29,8,21
"2021","Ashford 013B","E01024010",629,197,121,76,397,98,173,65,70,38,61,30,29,2,62,41,21,3,3,35,9,26
"2021","Ashford 013C","E01024011",512,118,71,47,368,102,184,63,78,43,38,15,14,9,40,18,22,4,4,26,13,13
"2021","Ashford 013D","E01024012",490,141,97,44,326,67,155,70,55,30,51,17,30,4,52,29,23,1,1,23,10,13
"2021","Ashford 013E","E01024024",1129,421,269,152,674,239,254,120,95,39,88,51,27,10,87,47,40,6,6,34,9,25
"2021","Ashford 013F","E01024025",714,312,206,106,386,130,122,56,41,25,61,34,25,2,71,41,30,2,2,16,7,9
"2021","Ashford 014A","E01023997",659,174,102,72,449,92,236,99,83,54,65,34,23,8,54,33,21,2,2,36,16,20
"2021","Ashford 014B","E01023998",516,137,82,55,354,98,176,87,52,37,45,17,23,5,34,26,8,1,1,25,10,15
"2021","Ashford 014C","E01024026",519,123,89,34,366,95,176,65,72,39,51,23,21,7,40,24,16,4,4,30,14,16
"2021","Ashford 014D","E01024037",816,216,121,95,561,115,292,98,144,50,88,44,40,4,63,35,28,3,3,39,24,15
"2021","Ashford 015A","E01023980",504,159,100,59,328,70,149,55,61,33,53,23,26,4,55,35,20,1,1,17,10,7
"2021","Ashford 015B","E01023981",637,208,116,92,383,67,169,50,83,36,64,32,25,7,81,54,27,2,2,46,21,25
"2021","Ashford 015C","E01023984",472,116,41,75,317,35,103,19,63,21,63,21,37,5,116,82,34,0,0,39,22,17
"2021","Ashford 015E","E01024021",664,252,75,177,356,40,155,49,83,23,83,59,23,1,72,51,21,6,6,56,15,41
"2021","Ashford 015D","E01024022",645,181,121,60,422,98,219,62,90,67,49,20,25,4,51,27,24,5,5,42,19,23
"2021","Ashford 016C","E01023992",717,189,77,112,449,42,208,64,108,36,99,46,45,8,96,62,34,4,4,79,33,46
"2021","Ashford 016D","E01023993",552,122,56,66,381,45,200,56,99,45,76,34,38,4,58,39,19,2,2,49,23,26
"2021","Ashford 016B","E01032820",997,229,47,182,696,40,360,103,211,46,175,103,66,6,112,77,35,9,9,72,33,39
"2021","Ashford 016A","E01032821",1101,229,72,157,806,59,461,95,293,73,178,93,79,6,101,83,18,7,7,66,35,31
"2021","Canterbury 001A","E01024078",969,507,195,312,423,36,138,53,65,20,119,68,50,1,123,108,15,7,7,39,13,26
"2021","Canterbury 001B","E01024080",606,272,87,185,296,33,109,39,48,22,55,37,16,2,98,66,32,1,1,38,9,29
"2021","Canterbury 001C","E01024081",825,464,193,271,321,51,110,50,39,21,75,50,24,1,80,61,19,5,5,40,14,26
"2021","Canterbury 001D","E01024082",627,212,97,115,382,66,166,65,72,29,68,34,30,4,78,57,21,4,4,33,15,18
"2021","Canterbury 001E","E01024095",638,206,90,116,397,74,194,76,83,35,51,27,20,4,77,46,31,1,1,35,18,17
"2021","Canterbury 002A","E01024094",1148,302,179,123,784,207,380,168,133,79,118,50,59,9,75,47,28,4,4,62,23,39
"2021","Canterbury 002B","E01024096",766,220,167,53,506,176,221,92,74,55,59,26,30,3,48,24,24,2,2,40,17,23
"2021","Canterbury 002C","E01024097",762,276,210,66,443,166,194,89,66,39,46,21,20,5,37,18,19,0,0,43,17,26
"2021","Canterbury 002D","E01024098",658,171,124,47,445,149,202,86,69,47,54,33,16,5,40,17,23,0,0,42,21,21
"2021","Canterbury 003A","E01024064",997,209,139,70,730,149,387,127,182,78,112,52,50,10,79,50,29,3,3,58,26,32
"2021","Canterbury 003B","E01024066",662,204,105,99,420,74,178,52,75,51,59,16,37,6,104,57,47,5,5,38,17,21
"2021","Canterbury 003C","E01024079",695,223,143,80,435,111,193,66,72,55,60,37,19,4,70,46,24,1,1,37,12,25
"2021","Canterbury 003D","E01024083",666,268,162,106,368,81,142,46,59,37,53,22,29,2,91,55,36,1,1,30,12,18
"2021","Canterbury 003E","E01024118",775,248,137,111,484,93,211,77,81,53,96,57,32,7,80,41,39,4,4,43,13,30
"2021","Canterbury 004A","E01024059",744,342,204,138,364,96,150,68,54,28,51,27,21,3,64,29,35,3,3,38,13,25
"2021","Canterbury 004B","E01024065",824,198,121,77,576,123,267,94,105,68,102,32,61,9,81,47,34,3,3,50,24,26
"2021","Canterbury 004C","E01024117",667,186,132,54,447,130,197,82,73,42,66,29,26,11,52,23,29,2,2,34,16,18
"2021","Canterbury 004D","E01024119",619,170,71,99,407,48,167,52,80,35,92,38,45,9,98,62,36,2,2,42,23,19
"2021","Canterbury 004E","E01024120",815,291,178,113,479,137,206,113,47,46,54,30,18,6,79,36,43,3,3,45,14,31
"2021","Canterbury 005A","E01024056",793,145,120,25,602,220,310,138,111,61,36,18,16,2,36,11,25,0,0,46,22,24
"2021","Canterbury 005B","E01024057",820,232,170,62,545,202,230,105,71,54,69,38,26,5,40,15,25,4,4,43,17,26
"2021","Canterbury 005C","E01024058",673,174,92,82,470,94,228,81,103,44,82,40,32,10,66,38,28,0,0,29,11,18
"2021","Canterbury 005D","E01024114",797,254,168,86,510,125,268,101,117,50,62,41,21,0,51,31,20,4,4,33,10,23
"2021","Canterbury 005E","E01024115",649,173,135,38,452,152,221,106,77,38,44,23,13,8,34,13,21,1,1,24,13,11
"2021","Canterbury 006A","E01024073",1005,236,118,118,721,107,352,107,195,50,125,53,62,10,132,88,44,5,5,48,23,25
"2021","Canterbury 006B","E01024074",551,99,63,36,427,94,235,70,102,63,51,22,25,4,46,25,21,1,1,25,7,18
"2021","Canterbury 006C","E01024075",688,217,133,84,429,112,182,71,74,37,69,31,35,3,64,34,30,2,2,42,16,26
"2021","Canterbury 006D","E01024076",748,201,103,98,501,76,275,118,107,50,82,36,41,5,66,43,23,2,2,46,24,22
"2021","Canterbury 006E","E01024077",834,149,64,85,636,82,337,102,181,54,134,71,58,5,81,55,26,2,2,49,24,25
"2021","Canterbury 007A","E01024055",717,202,136,66,489,132,232,88,93,51,74,41,28,5,48,20,28,3,3,26,10,16
"2021","Canterbury 007B","E01024061",640,234,138,96,368,48,130,40,67,23,70,31,37,2,115,75,40,5,5,38,18,20
"2021","Canterbury 007C","E01024063",658,165,89,76,461,94,241,79,111,51,76,36,35,5,49,29,20,1,1,32,13,19
"2021","Canterbury 007D","E01024071",741,241,122,119,459,58,224,77,98,49,84,43,33,8,92,57,35,1,1,41,16,25
"2021","Canterbury 007E","E01024116",665,214,139,75,424,107,216,95,90,31,58,32,24,2,39,16,23,4,4,27,8,19
"2021","Canterbury 008A","E01024060",684,217,97,120,430,87,180,74,83,23,83,48,31,4,77,46,31,3,3,37,16,21
"2021","Canterbury 008B","E01024069",552,170,65,105,360,35,168,62,81,25,77,37,35,5,77,50,27,3,3,22,8,14
"2021","Canterbury 008C","E01024070",655,306,123,183,317,41,142,61,56,25,76,54,17,5,57,39,18,1,1,32,8,24
"2021","Canterbury 008D","E01024072",564,257,87,170,277,31,109,49,45,15,87,67,18,2,48,27,21,2,2,30,9,21
"2021","Canterbury 008E","E01024106",715,225,143,82,459,120,200,85,83,32,85,49,29,7,52,30,22,2,2,31,10,21
"2021","Canterbury 009A","E01024062",882,226,83,143,598,109,272,107,125,40,112,59,48,5,104,85,19,1,1,58,19,39
"2021","Canterbury 009B","E01024105",698,193,134,59,473,125,244,116,83,45,53,32,18,3,50,20,30,1,1,32,18,14
"2021","Canterbury 009C","E01024107",600,132,82,50,440,87,243,85,101,57,63,26,31,6,45,25,20,2,2,28,12,16
"2021","Canterbury 009D","E01024108",539,171,97,74,328,84,124,55,42,27,39,17,16,6,78,52,26,3,3,40,17,23
"2021","Canterbury 009E","E01024109",989,256,192,64,674,175,354,136,152,66,86,44,36,6,58,30,28,1,1,59,26,33
"2021","Canterbury 010A","E01024084",522,132,67,65,356,65,180,72,69,39,61,27,27,7,48,28,20,2,2,34,15,19
"2021","Canterbury 010B","E01024085",654,148,83,65,469,113,236,86,110,40,51,27,22,2,65,35,30,4,4,37,14,23
"2021","Canterbury 010C","E01024086",851,201,81,120,586,73,263,80,125,58,136,61,60,15,111,71,40,3,3,64,29,35
"2021","Canterbury 010D","E01024087",516,106,51,55,368,83,192,86,65,41,57,34,19,4,34,23,11,2,2,42,15,27
"2021","Canterbury 011A","E01024091",502,109,47,62,322,28,138,37,71,30,60,21,31,8,90,55,35,6,6,71,26,45
"2021","Canterbury 011B","E01024110",674,185,122,63,455,96,204,69,90,45,90,54,31,5,62,39,23,3,3,34,14,20
"2021","Canterbury 011C","E01024111",626,169,92,77,414,60,191,53,93,45,68,31,33,4,90,59,31,5,5,43,28,15
"2021","Canterbury 011D","E01024112",659,164,112,52,455,89,242,74,109,59,60,33,22,5,60,33,27,4,4,40,20,20
"2021","Canterbury 011E","E01024113",623,195,107,88,391,84,172,63,69,40,75,52,20,3,56,30,26,4,4,37,10,27
"2021","Canterbury 012C","E01024067",485,114,65,49,331,75,175,76,67,32,53,34,15,4,25,15,10,3,3,40,18,22
"2021","Canterbury 012D","E01024068",586,151,100,51,388,113,183,55,93,35,47,24,17,6,43,21,22,2,2,47,20,27
"2021","Canterbury 012E","E01024123",620,146,80,66,387,78,204,69,107,28,62,41,17,4,39,20,19,4,4,87,8,79
"2021","Canterbury 012G","E01035308",514,148,101,47,337,98,179,68,72,39,34,25,7,2,25,11,14,1,1,29,12,17
"2021","Canterbury 012H","E01035309",465,106,67,39,312,61,165,57,80,28,46,31,11,4,36,27,9,4,4,47,11,36
"2021","Canterbury 013A","E01024099",532,122,40,82,260,15,87,21,43,23,56,29,27,0,88,59,29,14,14,150,15,135
"2021","Canterbury 013B","E01024100",492,78,44,34,235,39,129,41,65,23,22,12,8,2,41,25,16,4,4,179,12,167
"2021","Canterbury 013C","E01024101",632,137,52,85,296,37,135,43,61,31,60,27,24,9,56,35,21,8,8,199,17,182
"2021","Canterbury 013D","E01024102",683,147,60,87,354,86,176,60,79,37,51,35,15,1,37,24,13,4,4,182,6,176
"2021","Canterbury 013E","E01024103",623,188,94,94,283,35,122,37,59,26,43,16,20,7,80,51,29,3,3,152,16,136
"2021","Canterbury 014A","E01024047",679,96,31,65,527,11,221,45,155,21,92,39,46,7,193,157,36,10,10,56,22,34
"2021","Canterbury 014B","E01024049",555,180,69,111,310,22,137,46,56,35,46,23,19,4,95,53,42,10,10,65,19,46
"2021","Canterbury 014C","E01024090",840,280,65,215,399,32,140,42,76,22,110,72,32,6,103,81,22,14,14,161,33,128
"2021","Canterbury 014D","E01024092",643,250,90,160,216,25,74,34,29,11,53,33,19,1,53,32,21,11,11,177,18,159
"2021","Canterbury 014E","E01024093",849,400,139,261,335,23,109,35,59,15,90,63,23,4,100,72,28,13,13,114,11,103
"2021","Canterbury 016A","E01024044",874,309,106,203,433,59,187,57,96,34,107,84,21,2,70,44,26,10,10,132,6,126
"2021","Canterbury 016B","E01024045",667,175,108,67,426,94,214,66,109,39,50,35,15,0,60,30,30,8,8,66,20,46
"2021","Canterbury 016C","E01024046",854,310,168,142,497,127,266,89,131,46,60,44,12,4,42,23,19,2,2,47,15,32
"2021","Canterbury 016D","E01024048",551,146,51,95,229,19,86,28,45,13,49,28,20,1,69,42,27,6,6,176,14,162
"2021","Canterbury 016E","E01024131",685,203,84,119,380,72,181,72,92,17,84,58,23,3,39,25,14,4,4,102,17,85
"2021","Canterbury 017A","E01024052",967,230,77,153,672,61,327,107,182,38,150,80,65,5,125,84,41,9,9,65,33,32
"2021","Canterbury 017B","E01024053",817,164,88,76,588,82,325,114,162,49,107,62,40,5,71,50,21,3,3,65,33,32
"2021","Canterbury 017C","E01024054",745,161,90,71,537,119,299,119,121,59,67,37,24,6,50,25,25,2,2,47,23,24
"2021","Canterbury 017D","E01024127",677,144,97,47,475,91,264,93,121,50,63,31,27,5,54,29,25,3,3,58,29,29
"2021","Canterbury 018A","E01024042",576,146,82,64,383,57,209,84,79,46,65,45,16,4,48,33,15,4,4,47,18,29
"2021","Canterbury 018B","E01024043",562,145,109,36,390,102,211,79,89,43,47,30,15,2,30,16,14,0,0,27,8,19
"2021","Canterbury 018C","E01024088",654,187,119,68,440,93,230,78,123,29,67,40,24,3,48,28,20,2,2,27,9,18
"2021","Canterbury 018D","E01024089",481,124,93,31,338,88,190,84,78,28,31,14,15,2,27,14,13,2,2,19,8,11
"2021","Canterbury 019A","E01024128",680,216,64,152,379,19,143,51,77,15,103,59,39,5,107,69,38,7,7,85,24,61
"2021","Canterbury 019B","E01024129",639,156,30,126,315,15,117,39,60,18,112,71,38,3,54,31,23,17,17,168,19,149
"2021","Canterbury 019D","E01035310",660,191,81,110,384,39,188,68,96,24,82,60,18,4,67,44,23,8,8,85,22,63
"2021","Canterbury 019E","E01035311",574,179,50,129,303,19,132,33,81,18,84,53,28,3,56,42,14,12,12,92,23,69
"2021","Canterbury 020A","E01024104",987,363,129,234,438,54,164,60,86,18,139,110,26,3,58,29,29,23,23,186,7,179
"2021","Canterbury 020B","E01024121",671,209,110,99,329,51,147,60,69,18,90,68,21,1,36,17,19,5,5,133,11,122
"2021","Canterbury 020C","E01024122",651,240,143,97,320,32,123,43,55,25,80,46,26,8,78,50,28,7,7,91,10,81
"2021","Canterbury 020D","E01024124",547,271,124,147,221,39,79,33,41,5,74,59,15,0,20,11,9,9,9,55,4,51
"2021","Canterbury 020E","E01024126",544,139,70,69,325,28,138,33,76,29,65,26,29,10,89,55,34,5,5,80,24,56
"2021","Canterbury 020F","E01032807",760,299,93,206,332,33,107,52,40,15,125,113,12,0,53,34,19,14,14,129,8,121
"2021","Canterbury 020G","E01032808",824,324,43,281,353,20,122,47,62,13,117,95,19,3,78,59,19,16,16,147,15,132
"2021","Dartford 001C","E01024154",502,125,61,64,335,34,152,39,83,30,55,20,29,6,89,56,33,5,5,42,21,21
"2021","Dartford 001D","E01024155",905,225,64,161,618,33,327,64,224,39,117,45,64,8,129,95,34,12,12,62,39,23
"2021","Dartford 001E","E01035270",585,134,4,130,407,3,239,48,184,7,112,61,51,0,48,36,12,5,5,44,27,17
"2021","Dartford 001F","E01035271",564,97,8,89,423,2,270,46,217,7,94,43,50,1,53,39,14,4,4,44,28,16
"2021","Dartford 001G","E01035272",601,152,33,119,411,18,187,44,110,33,82,30,43,9,119,77,42,5,5,38,20,18
"2021","Dartford 001H","E01035273",456,97,40,57,330,15,164,39,100,25,57,15,37,5,91,62,29,3,3,29,14,15
"2021","Dartford 001I","E01035274",580,264,104,160,287,24,101,25,66,10,50,22,24,4,109,88,21,3,3,29,13,16
"2021","Dartford 001J","E01035275",581,156,25,131,374,13,204,42,151,11,93,56,35,2,59,45,14,5,5,51,21,30
"2021","Dartford 001K","E01035276",527,72,4,68,417,2,269,45,215,9,63,22,40,1,75,62,13,8,8,38,21,17
"2021","Dartford 002C","E01024143",1089,270,55,215,762,53,395,132,218,45,178,107,63,8,121,84,37,15,15,57,22,35
"2021","Dartford 002D","E01024179",1133,316,57,259,729,26,322,97,183,42,191,92,85,14,175,140,35,15,15,88,48,40
"2021","Dartford 002E","E01035277",699,182,32,150,484,16,266,73,152,41,131,62,59,10,67,48,19,4,4,33,14,19
"2021","Dartford 002F","E01035278",666,170,67,103,463,39,243,69,135,39,114,61,49,4,62,37,25,5,5,33,14,19
"2021","Dartford 002G","E01035279",828,232,16,216,540,6,262,70,176,16,169,106,61,2,99,79,20,4,4,56,32,24
"2021","Dartford 002H","E01035280",760,163,4,159,563,3,301,58,229,14,195,117,75,3,58,48,10,6,6,34,19,15
"2021","Dartford 002I","E01035281",756,155,10,145,564,5,281,87,182,12,204,115,88,1,68,55,13,6,6,37,22,15
"2021","Dartford 003A","E01024180",1015,302,44,258,643,14,297,89,188,20,180,103,68,9,130,94,36,22,22,70,30,40
"2021","Dartford 003B","E01024181",835,226,33,193,535,30,264,66,169,29,139,98,35,6,90,57,33,12,12,74,32,42
"2021","Dartford 003C","E01024182",810,306,62,244,443,13,196,68,98,30,119,74,41,4,101,71,30,14,14,61,29,32
"2021","Dartford 003D","E01024183",517,114,70,44,359,55,212,49,108,55,45,14,25,6,44,28,16,3,3,44,29,15
"2021","Dartford 003E","E01024184",826,195,98,97,571,54,331,73,214,44,70,33,33,4,107,69,38,9,9,60,29,31
"2021","Dartford 003F","E01024185",916,259,106,153,604,63,308,66,192,50,115,50,57,8,108,64,44,10,10,53,33,20
"2021","Dartford 004B","E01024176",796,259,115,144,494,39,199,71,102,26,116,50,55,11,134,96,38,6,6,43,23,20
"2021","Dartford 004C","E01024177",566,153,69,84,352,37,140,38,72,30,67,18,39,10,105,71,34,3,3,61,37,24
"2021","Dartford 004D","E01024178",601,124,51,73,427,35,235,81,106,48,81,32,39,10,76,48,28,0,0,50,29,21
"2021","Dartford 004E","E01035282",713,252,23,229,421,10,190,71,102,17,143,89,46,8,72,49,23,6,6,40,17,23
"2021","Dartford 004F","E01035283",649,220,59,161,393,21,166,45,93,28,120,64,47,9,84,57,27,2,2,36,20,16
"2021","Dartford 005A","E01024156",736,282,83,199,402,11,208,67,104,37,88,45,35,8,88,54,34,7,7,52,35,17
"2021","Dartford 005B","E01024161",771,149,28,121,556,23,273,82,143,48,137,66,60,11,113,67,46,10,10,66,27,39
"2021","Dartford 005C","E01024162",903,316,56,260,532,21,242,70,146,26,129,71,50,8,127,86,41,13,13,55,27,28
"2021","Dartford 005D","E01024163",727,177,84,93,489,44,258,64,131,63,95,41,44,10,88,48,40,4,4,61,33,28
"2021","Dartford 005E","E01024164",826,264,66,198,493,33,224,74,114,36,113,54,58,1,119,87,32,4,4,69,23,46
"2021","Dartford 006A","E01024169",900,258,107,151,583,46,267,63,157,47,124,52,61,11,142,89,53,4,4,59,35,24
"2021","Dartford 006B","E01024170",644,205,85,120,399,23,175,38,97,40,84,38,37,9,110,73,37,7,7,40,22,18
"2021","Dartford 006C","E01024171",596,144,56,88,409,38,203,55,98,50,89,47,33,9,77,41,36,2,2,43,18,25
"2021","Dartford 006D","E01024172",1017,386,69,317,575,34,258,87,138,33,161,94,62,5,112,86,26,10,10,56,22,34
"2021","Dartford 007A","E01024144",545,96,63,33,415,64,246,58,124,64,59,25,23,11,43,21,22,3,3,34,22,12
"2021","Dartford 007B","E01024145",583,100,65,35,429,68,258,66,118,74,52,18,25,9,47,27,20,4,4,54,29,25
"2021","Dartford 007C","E01024146",528,95,65,30,399,81,226,56,109,61,48,18,26,4,42,23,19,2,2,34,19,15
"2021","Dartford 007D","E01024147",662,118,68,50,506,78,285,75,143,67,89,32,45,12,50,23,27,4,4,38,22,16
"2021","Dartford 007E","E01024186",515,99,49,50,388,46,218,59,110,49,68,31,30,7,56,28,28,0,0,28,15,13
"2021","Dartford 008A","E01024133",473,77,39,38,379,42,246,71,135,40,56,25,27,4,35,18,17,0,0,17,10,7
"2021","Dartford 008B","E01024136",630,196,67,129,402,43,238,64,128,46,61,39,16,6,58,39,19,2,2,32,22,10
"2021","Dartford 008C","E01024137",658,114,64,50,486,54,301,50,186,65,72,29,36,7,56,32,24,3,3,58,38,20
"2021","Dartford 008D","E01024138",681,162,76,86,479,50,247,55,143,49,70,29,35,6,109,65,44,3,3,40,28,12
"2021","Dartford 008E","E01024139",687,148,106,42,500,109,268,60,146,62,58,18,29,11,59,28,31,6,6,39,22,17
"2021","Dartford 009A","E01024165",671,210,90,120,414,25,170,46,94,30,77,26,47,4,136,92,44,6,6,47,26,21
"2021","Dartford 009B","E01024166",601,112,46,66,432,27,188,40,102,46,89,27,51,11,123,61,62,5,5,57,29,28
"2021","Dartford 009C","E01024167",849,277,120,157,513,36,255,64,149,42,103,47,48,8,114,74,40,5,5,59,28,31
"2021","Dartford 009D","E01024168",472,139,80,59,293,43,151,28,84,39,51,19,23,9,45,19,26,3,3,40,29,11
"2021","Dartford 010A","E01024150",636,159,116,43,449,126,231,83,86,62,50,19,25,6,41,19,22,1,1,28,12,16
"2021","Dartford 010B","E01024151",643,188,150,38,431,152,207,68,88,51,40,13,25,2,32,14,18,0,0,24,13,11
"2021","Dartford 010C","E01024152",955,171,61,110,717,61,377,79,217,81,112,48,57,7,157,91,66,10,10,67,38,29
"2021","Dartford 010D","E01024153",539,124,90,34,376,83,223,69,107,47,41,19,19,3,27,10,17,2,2,39,18,21
"2021","Dartford 011A","E01024173",693,148,85,63,499,88,246,78,113,55,96,34,52,10,65,25,40,4,4,46,26,20
"2021","Dartford 011B","E01024187",440,110,62,48,304,60,163,36,84,43,44,13,26,5,35,16,19,2,2,26,9,17
"2021","Dartford 011C","E01024188",533,103,69,34,399,66,224,50,127,47,62,28,29,5,47,26,21,0,0,31,11,20
"2021","Dartford 011D","E01024189",693,239,144,95,436,86,208,72,88,48,78,37,34,7,61,32,29,3,3,18,9,9
"2021","Dartford 012A","E01024132",487,88,46,42,369,49,175,47,90,38,78,34,34,10,64,34,30,3,3,30,17,13
"2021","Dartford 012B","E01024134",644,135,63,72,471,84,221,71,97,53,70,31,34,5,91,45,46,5,5,38,22,16
"2021","Dartford 012C","E01024135",550,132,60,72,388,51,169,45,84,40,73,41,25,7,89,45,44,6,6,30,16,14
"2021","Dartford 012D","E01024174",492,149,71,78,326,40,172,48,79,45,67,40,26,1,44,29,15,3,3,17,7,10
"2021","Dartford 012E","E01024175",500,108,54,54,374,68,194,58,103,33,62,25,35,2,50,34,16,0,0,18,8,10
"2021","Dartford 013A","E01024157",725,158,81,77,534,117,283,112,107,64,86,44,29,13,48,27,21,0,0,33,15,18
"2021","Dartford 013B","E01024158",810,230,134,96,544,100,277,69,155,53,79,41,29,9,83,46,37,5,5,36,15,21
"2021","Dartford 013C","E01024159",644,124,100,24,485,137,284,120,99,65,38,14,16,8,23,11,12,3,3,35,17,18
"2021","Dartford 013D","E01024160",551,111,90,21,405,105,232,62,98,72,39,18,15,6,28,14,14,1,1,35,10,25
"2021","Dover 001A","E01024206",808,158,94,64,608,126,331,141,123,67,95,51,31,13,51,23,28,5,5,42,18,24
"2021","Dover 001B","E01024207",756,176,98,78,538,121,288,113,124,51,67,34,27,6,58,27,31,4,4,42,20,22
"2021","Dover 001C","E01024208",708,190,97,93,483,93,247,104,109,34,69,39,27,3,71,38,33,3,3,35,17,18
"2021","Dover 001D","E01024209",738,198,106,92,493,112,252,107,103,42,72,41,27,4,53,34,19,4,4,47,14,33
"2021","Dover 002A","E01024202",793,239,158,81,503,110,233,94,86,53,84,38,38,8,73,46,27,3,3,51,21,30
"2021","Dover 002B","E01024242",727,163,101,62,525,149,262,119,95,48,66,38,25,3,47,22,25,1,1,39,15,24
"2021","Dover 002C","E01024243",749,248,157,91,464,89,202,60,81,61,75,32,41,2,95,59,36,3,3,37,19,18
"2021","Dover 002D","E01024244",937,415,240,175,501,146,215,120,49,46,84,57,21,6,53,31,22,3,3,21,2,19
"2021","Dover 002E","E01024245",812,174,112,62,597,135,318,144,111,63,71,35,35,1,68,34,34,5,5,41,9,32
"2021","Dover 003A","E01024219",560,170,102,68,365,75,156,59,49,48,55,25,24,6,74,44,30,5,5,25,7,18
"2021","Dover 003B","E01024220",748,288,199,89,440,112,184,87,64,33,72,34,32,6,67,34,33,5,5,20,3,17
"2021","Dover 003C","E01024221",643,155,97,58,462,116,228,92,87,49,58,32,22,4,59,28,31,1,1,26,10,16
"2021","Dover 003D","E01024227",670,258,129,129,378,68,162,72,52,38,75,42,26,7,72,50,22,1,1,34,15,19
"2021","Dover 003E","E01024229",715,308,150,158,380,63,164,82,59,23,81,45,30,6,72,37,35,0,0,27,10,17
"2021","Dover 004A","E01024228",671,323,157,166,314,71,148,80,34,34,49,40,7,2,35,23,12,11,11,34,10,24
"2021","Dover 004B","E01024230",727,360,206,154,347,91,135,74,38,23,62,38,21,3,58,37,21,1,1,20,7,13
"2021","Dover 004C","E01024231",690,332,165,167,330,77,129,64,44,21,65,38,22,5,53,30,23,6,6,28,12,16
"2021","Dover 004D","E01024252",1135,443,223,220,640,138,306,157,81,68,96,60,30,6,93,49,44,7,7,52,17,35
"2021","Dover 005A","E01024201",600,134,76,58,435,82,227,100,78,49,63,33,23,7,61,35,26,2,2,31,25,6
"2021","Dover 005C","E01024223",624,164,85,79,419,68,200,69,80,51,84,29,47,8,64,37,27,3,3,41,18,23
"2021","Dover 005D","E01024225",680,164,86,78,474,54,216,75,97,44,106,43,54,9,96,69,27,2,2,42,14,28
"2021","Dover 005E","E01024226",690,240,163,77,406,86,189,71,75,43,65,29,33,3,65,38,27,1,1,44,19,25
"2021","Dover 005F","E01035312",702,171,69,102,501,81,230,82,115,33,102,40,54,8,87,67,20,1,1,30,13,17
"2021","Dover 005G","E01035313",609,185,90,95,386,33,163,59,73,31,98,43,47,8,89,61,28,3,3,38,10,28
"2021","Dover 006A","E01024190",555,150,83,67,373,74,166,71,62,33,78,44,25,9,49,32,17,6,6,32,11,21
"2021","Dover 006C","E01024192",784,226,124,102,513,64,193,51,98,44,120,54,53,13,132,90,42,4,4,45,22,23
"2021","Dover 006D","E01024204",662,175,98,77,438,66,213,87,93,33,73,36,28,9,84,51,33,2,2,49,27,22
"2021","Dover 006E","E01035314",784,126,34,92,610,19,296,86,180,30,197,99,97,1,94,73,21,4,4,48,26,22
"2021","Dover 006F","E01035315",668,146,64,82,477,44,225,61,121,43,129,50,66,13,73,46,27,6,6,45,21,24
"2021","Dover 007A","E01024218",567,171,67,104,371,36,130,46,51,33,82,34,41,7,119,82,37,4,4,25,17,8
"2021","Dover 007B","E01024222",701,213,102,111,457,58,188,83,66,39,90,34,47,9,119,85,34,2,2,31,14,17
"2021","Dover 007C","E01024224",666,186,116,70,450,110,208,81,88,39,60,23,30,7,71,44,27,1,1,30,10,20
"2021","Dover 007D","E01024250",751,272,188,84,448,107,198,76,73,49,62,26,33,3,79,40,39,2,2,31,11,20
"2021","Dover 007E","E01024251",754,274,187,87,454,145,173,87,51,35,66,40,21,5,68,34,34,2,2,26,10,16
"2021","Dover 008A","E01024200",708,175,83,92,475,111,260,139,75,46,65,30,29,6,35,12,23,4,4,58,21,37
"2021","Dover 008B","E01024203",649,145,82,63,454,108,243,118,82,43,67,39,25,3,35,20,15,1,1,50,18,32
"2021","Dover 008C","E01024205",641,131,57,74,466,92,224,103,85,36,93,62,23,8,56,29,27,1,1,44,26,18
"2021","Dover 008D","E01024255",747,183,123,60,528,152,260,104,100,56,72,36,33,3,42,15,27,2,2,36,16,20
"2021","Dover 009A","E01024232",903,258,173,85,612,191,283,155,85,43,80,48,25,7,58,32,26,0,0,33,14,19
"2021","Dover 009B","E01024236",768,226,134,92,498,136,236,113,84,39,75,46,19,10,50,30,20,1,1,44,20,24
"2021","Dover 009C","E01024237",722,205,151,54,484,173,235,110,84,41,47,28,15,4,29,13,16,0,0,33,10,23
"2021","Dover 009D","E01024253",792,256,173,83,499,190,226,112,69,45,49,34,13,2,31,22,9,3,3,37,13,24
"2021","Dover 010C","E01024233",647,122,80,42,503,122,273,94,121,58,62,28,29,5,45,23,22,1,1,22,8,14
"2021","Dover 010D","E01024235",685,243,123,120,408,107,178,77,66,35,69,36,28,5,53,21,32,1,1,34,12,22
"2021","Dover 010E","E01024254",915,217,93,124,651,95,315,110,144,61,129,55,61,13,109,81,28,3,3,47,22,25
"2021","Dover 010F","E01024256",779,218,161,57,539,123,251,100,102,49,108,56,43,9,54,30,24,3,3,22,13,9
"2021","Dover 010G","E01033210",1002,228,140,88,721,152,372,171,130,71,118,54,54,10,71,42,29,8,8,53,23,30
"2021","Dover 011A","E01024193",689,254,110,144,401,32,145,49,65,31,91,37,40,14,131,89,42,2,2,34,16,18
"2021","Dover 011B","E01024194",627,194,49,145,398,31,170,52,80,38,97,43,49,5,97,65,32,3,3,35,11,24
"2021","Dover 011C","E01024195",552,111,51,60,400,38,178,76,62,40,102,45,52,5,82,49,33,0,0,41,22,19
"2021","Dover 011D","E01024196",614,196,94,102,372,33,134,42,60,32,83,26,53,4,119,76,43,3,3,46,23,23
"2021","Dover 011E","E01024197",673,204,90,114,427,53,188,63,86,39,83,38,44,1,100,60,40,3,3,42,20,22
"2021","Dover 011F","E01024240",670,173,56,117,452,16,172,53,85,34,122,41,69,12,138,101,37,4,4,45,20,25
"2021","Dover 011G","E01024241",897,287,74,213,552,41,212,60,112,40,134,58,65,11,159,110,49,6,6,58,27,31
"2021","Dover 011H","E01024248",874,276,81,195,540,37,197,74,86,37,131,54,61,16,172,130,42,3,3,58,27,31
"2021","Dover 012B","E01024238",535,100,43,57,404,34,265,79,163,23,52,27,22,3,51,33,18,2,2,31,21,10
"2021","Dover 012C","E01024239",882,370,162,208,467,53,164,74,63,27,131,66,60,5,115,87,28,4,4,45,19,26
"2021","Dover 012D","E01024247",958,416,135,281,467,44,186,69,77,40,116,69,41,6,110,62,48,11,11,75,24,51
"2021","Dover 012E","E01033209",588,288,118,170,253,61,100,51,33,16,57,38,18,1,34,16,18,1,1,47,12,35
"2021","Dover 012F","E01033211",765,402,160,242,321,53,100,48,42,10,82,42,38,2,80,46,34,6,6,42,12,30
"2021","Dover 013A","E01024214",730,269,83,186,404,30,144,48,68,28,121,56,59,6,103,81,22,6,6,57,22,35
"2021","Dover 013B","E01024215",721,293,52,241,381,22,135,54,63,18,108,55,46,7,105,79,26,11,11,47,17,30
"2021","Dover 013C","E01024216",622,164,64,100,424,48,191,67,80,44,109,46,56,7,70,47,23,6,6,34,15,19
"2021","Dover 013D","E01024246",945,304,73,231,578,36,207,76,100,31,139,61,70,8,178,132,46,18,18,63,22,41
"2021","Dover 013E","E01024249",933,368,194,174,519,64,209,83,72,54,119,58,50,11,121,77,44,6,6,46,17,29
"2021","Dover 014A","E01024198",1157,362,249,113,738,220,344,178,96,70,105,62,26,17,66,33,33,3,3,57,25,32
"2021","Dover 014B","E01024212",644,199,82,117,413,50,201,89,78,34,92,57,31,4,68,42,26,2,2,32,10,22
"2021","Dover 014C","E01024213",556,106,49,57,422,87,229,91,89,49,73,29,36,8,32,10,22,1,1,28,10,18
"2021","Dover 014D","E01024234",576,115,77,38,419,101,231,106,79,46,49,25,22,2,38,22,16,0,0,42,16,26
"2021","Gravesham 001A","E01024276",978,203,63,140,686,50,355,107,179,69,118,47,65,6,153,101,52,10,10,89,53,36
"2021","Gravesham 001B","E01024277",793,238,62,176,484,25,187,43,109,35,113,43,63,7,147,108,39,12,12,71,39,32
"2021","Gravesham 001C","E01024278",826,271,69,202,502,17,162,47,102,13,121,47,64,10,197,161,36,5,5,53,30,23
"2021","Gravesham 001D","E01024279",622,165,66,99,379,16,175,33,109,33,77,36,38,3,103,67,36,8,8,78,40,38
"2021","Gravesham 002A","E01024257",897,417,99,318,387,17,161,55,87,19,101,53,46,2,97,67,30,11,11,93,46,47
"2021","Gravesham 002C","E01024290",635,217,69,148,336,39,173,38,91,44,65,38,25,2,56,29,27,3,3,82,47,35
"2021","Gravesham 002D","E01024291",793,304,130,174,399,32,181,58,98,25,79,43,36,0,99,78,21,8,8,90,48,42
"2021","Gravesham 002E","E01024295",998,463,141,322,464,17,173,68,83,22,124,67,56,1,131,94,37,19,19,71,34,37
"2021","Gravesham 002F","E01032799",628,263,52,211,288,19,112,28,59,25,77,50,22,5,72,52,20,8,8,77,40,37
"2021","Gravesham 002G","E01032800",704,398,97,301,267,19,84,34,41,9,91,63,26,2,66,52,14,7,7,39,14,25
"2021","Gravesham 003A","E01024258",659,221,49,172,367,25,218,65,104,49,68,39,23,6,49,27,22,7,7,71,40,31
"2021","Gravesham 003B","E01024261",949,268,159,109,632,135,336,112,136,88,89,45,39,5,68,28,40,4,4,49,21,28
"2021","Gravesham 003C","E01024293",598,101,52,49,409,42,223,35,137,51,59,20,35,4,81,51,30,4,4,88,52,36
"2021","Gravesham 003D","E01024294",998,224,49,175,696,26,334,61,229,44,147,52,88,7,177,136,41,12,12,78,47,31
"2021","Gravesham 003E","E01024296",1163,338,82,256,704,32,322,84,193,45,164,76,75,13,165,118,47,21,21,121,67,54
"2021","Gravesham 004A","E01024262",698,218,93,125,433,39,199,62,100,37,87,41,41,5,101,67,34,7,7,47,25,22
"2021","Gravesham 004B","E01024263",593,139,82,57,384,36,171,39,86,46,66,24,31,11,110,62,48,1,1,70,51,19
"2021","Gravesham 004C","E01024282",583,134,39,95,373,23,181,38,111,32,80,28,48,4,80,56,24,9,9,76,49,27
"2021","Gravesham 004D","E01024283",477,107,57,50,317,32,141,34,72,35,77,28,40,9,63,38,25,4,4,53,31,22
"2021","Gravesham 004E","E01024284",606,140,59,81,404,27,193,48,106,39,76,33,39,4,97,55,42,11,11,62,41,21
"2021","Gravesham 005A","E01024259",569,88,52,36,438,81,255,80,117,58,61,26,30,5,38,22,16,3,3,43,23,20
"2021","Gravesham 005B","E01024260",779,287,140,147,443,68,239,86,107,46,83,47,31,5,50,23,27,3,3,49,19,30
"2021","Gravesham 005C","E01024292",570,129,46,83,366,51,194,43,99,52,54,34,16,4,60,33,27,7,7,75,44,31
"2021","Gravesham 005D","E01024313",614,159,99,60,418,60,250,75,117,58,51,21,27,3,54,26,28,3,3,37,24,13
"2021","Gravesham 005E","E01024317",629,160,99,61,421,61,229,59,111,59,73,27,35,11,57,30,27,1,1,48,33,15
"2021","Gravesham 005F","E01024318",619,156,68,88,424,41,223,60,117,46,77,41,32,4,80,45,35,3,3,39,15,24
"2021","Gravesham 006B","E01024281",528,98,61,37,398,58,186,49,84,53,60,21,28,11,92,56,36,2,2,32,21,11
"2021","Gravesham 006C","E01024285",530,131,67,64,367,57,194,61,86,47,54,26,20,8,58,31,27,4,4,32,21,11
"2021","Gravesham 006D","E01024287",629,229,152,77,361,49,167,52,80,35,63,32,30,1,80,55,25,2,2,39,16,23
"2021","Gravesham 006E","E01024288",498,117,94,23,341,78,180,54,77,49,43,15,26,2,40,16,24,0,0,40,20,20
"2021","Gravesham 006F","E01035284",557,124,4,120,395,2,201,60,131,10,124,65,55,4,63,51,12,5,5,38,19,19
"2021","Gravesham 006G","E01035285",606,168,61,107,390,21,157,45,68,44,89,29,54,6,119,86,33,4,4,48,24,24
"2021","Gravesham 007A","E01024308",616,220,96,124,357,34,141,37,71,33,53,11,40,2,116,87,29,13,13,39,22,17
"2021","Gravesham 007B","E01024310",616,159,97,62,424,78,186,52,89,45,65,20,39,6,91,54,37,4,4,33,22,11
"2021","Gravesham 007C","E01024311",472,85,35,50,340,18,159,33,85,41,51,13,35,3,107,72,35,5,5,47,31,16
"2021","Gravesham 007D","E01024314",475,93,53,40,346,54,187,45,95,47,63,17,34,12,41,20,21,1,1,36,18,18
"2021","Gravesham 007E","E01024315",645,204,98,106,380,58,175,46,89,40,48,25,16,7,89,47,42,10,10,61,45,16
"2021","Gravesham 008A","E01024297",567,98,62,36,423,86,240,64,121,55,53,23,25,5,44,17,27,0,0,46,21,25
"2021","Gravesham 008B","E01024298",530,112,76,36,383,90,212,54,93,65,44,19,20,5,34,15,19,3,3,35,22,13
"2021","Gravesham 008C","E01024299",552,131,98,33,394,74,212,46,106,60,55,25,25,5,50,22,28,3,3,27,14,13
"2021","Gravesham 008D","E01024309",465,79,45,34,338,33,142,36,73,33,56,11,39,6,104,62,42,3,3,48,32,16
"2021","Gravesham 008E","E01024312",473,87,57,30,335,45,173,50,83,40,51,13,31,7,65,40,25,1,1,51,32,19
"2021","Gravesham 009A","E01024264",623,160,93,67,399,34,186,47,93,46,78,22,47,9,96,53,43,5,5,64,43,21
"2021","Gravesham 009B","E01024286",618,150,104,46,433,78,260,84,105,71,56,25,25,6,38,23,15,1,1,35,16,19
"2021","Gravesham 009C","E01024316",886,153,67,86,656,73,364,97,189,78,110,55,44,11,107,76,31,2,2,77,48,29
"2021","Gravesham 009D","E01024319",556,92,51,41,410,50,230,69,104,57,48,13,30,5,80,48,32,2,2,54,27,27
"2021","Gravesham 010A","E01024265",497,104,76,28,357,84,198,64,85,49,37,16,20,1,36,20,16,2,2,36,16,20
"2021","Gravesham 010B","E01024266",473,127,78,49,323,61,154,59,63,32,38,16,17,5,64,38,26,6,6,23,14,9
"2021","Gravesham 010C","E01024267",624,153,105,48,442,108,214,75,90,49,72,35,36,1,48,21,27,0,0,29,17,12
"2021","Gravesham 010D","E01024300",555,134,97,37,390,85,227,75,110,42,43,19,19,5,34,12,22,1,1,31,19,12
"2021","Gravesham 010E","E01024301",512,140,87,53,349,105,184,69,77,38,31,10,15,6,25,13,12,4,4,23,11,12
"2021","Gravesham 011A","E01024303",663,210,83,127,426,34,194,54,104,36,91,45,42,4,103,65,38,4,4,27,11,16
"2021","Gravesham 011B","E01024304",660,191,106,85,404,42,187,58,82,47,84,28,40,16,89,44,45,2,2,65,30,35
"2021","Gravesham 011C","E01024305",591,130,38,92,418,25,181,45,97,39,82,15,52,15,121,83,38,9,9,43,30,13
"2021","Gravesham 011D","E01024306",634,142,40,102,447,10,189,33,130,26,86,31,45,10,155,108,47,7,7,45,26,19
"2021","Gravesham 011E","E01024307",612,168,119,49,407,82,211,45,105,61,54,18,31,5,57,30,27,3,3,37,19,18
"2021","Gravesham 012A","E01024268",618,124,96,28,458,147,222,66,98,58,41,15,22,4,45,24,21,3,3,36,16,20
"2021","Gravesham 012B","E01024269",763,163,122,41,560,150,294,105,119,70,65,29,28,8,51,15,36,0,0,40,21,19
"2021","Gravesham 012C","E01024270",600,150,86,64,422,99,228,81,98,49,50,31,16,3,45,24,21,0,0,28,17,11
"2021","Gravesham 012D","E01024271",592,158,108,50,403,74,220,71,97,52,58,31,23,4,50,32,18,1,1,31,17,14
"2021","Gravesham 012E","E01024272",615,139,98,41,451,115,252,87,102,63,45,27,15,3,38,18,20,1,1,25,14,11
"2021","Gravesham 013A","E01024273",587,108,53,55,420,78,255,92,98,65,55,26,26,3,32,17,15,0,0,59,36,23
"2021","Gravesham 013B","E01024274",606,144,85,59,432,115,211,81,81,49,61,33,21,7,45,24,21,0,0,30,17,13
"2021","Gravesham 013C","E01024275",523,98,54,44,395,50,207,45,108,54,79,35,40,4,59,29,30,0,0,30,17,13
"2021","Gravesham 013D","E01024302",600,142,94,48,419,124,216,71,103,42,42,21,14,7,35,18,17,2,2,39,18,21
"2021","Maidstone 001A","E01024333",526,125,28,97,376,33,191,60,99,32,98,55,39,4,51,30,21,3,3,25,11,14
"2021","Maidstone 001C","E01024335",652,136,62,74,462,79,258,89,119,50,82,43,31,8,41,26,15,2,2,54,28,26
"2021","Maidstone 001E","E01024347",727,151,90,61,530,80,323,124,139,60,89,51,32,6,36,18,18,2,2,46,24,22
"2021","Maidstone 001F","E01034990",917,177,65,112,704,92,416,158,189,69,135,73,56,6,57,34,23,4,4,36,18,18
"2021","Maidstone 002A","E01024353",757,133,67,66,561,116,310,87,165,58,74,34,34,6,58,36,22,3,3,63,35,28
"2021","Maidstone 002B","E01024354",595,137,73,64,407,70,190,62,88,40,76,39,31,6,68,45,23,3,3,51,18,33
"2021","Maidstone 002C","E01024355",844,245,95,150,528,43,268,86,137,45,118,64,44,10,92,52,40,7,7,71,24,47
"2021","Maidstone 002D","E01024385",633,118,76,42,480,88,269,68,141,60,61,30,24,7,62,36,26,0,0,35,14,21
"2021","Maidstone 002E","E01024386",764,190,78,112,538,98,286,90,149,47,77,37,31,9,70,40,30,7,7,36,13,23
"2021","Maidstone 003A","E01024320",716,153,70,83,530,94,282,93,138,51,101,58,39,4,52,34,18,1,1,33,15,18
"2021","Maidstone 003B","E01024321",736,205,164,41,503,150,257,78,128,51,54,29,23,2,38,18,20,4,4,28,10,18
"2021","Maidstone 003C","E01024322",490,132,105,27,331,80,194,60,89,45,31,8,21,2,26,11,15,0,0,27,15,12
"2021","Maidstone 003D","E01024323",739,166,112,54,544,105,283,76,160,47,78,37,36,5,72,38,34,6,6,29,18,11
"2021","Maidstone 003E","E01024324",631,177,118,59,433,107,202,68,101,33,74,35,33,6,47,30,17,3,3,21,6,15
"2021","Maidstone 003F","E01024341",738,196,123,73,504,143,258,75,124,59,65,35,27,3,36,16,20,2,2,38,20,18
"2021","Maidstone 004A","E01024352",871,348,117,231,444,31,181,64,95,22,98,62,33,3,124,90,34,10,10,79,36,43
"2021","Maidstone 004C","E01024382",621,181,21,160,364,15,146,52,71,23,119,76,37,6,78,45,33,6,6,76,24,52
"2021","Maidstone 004D","E01024383",1188,509,83,426,600,20,304,121,154,29,182,135,44,3,83,61,22,11,11,79,24,55
"2021","Maidstone 004E","E01024384",813,256,93,163,507,62,228,72,105,51,111,62,44,5,97,61,36,9,9,50,23,27
"2021","Maidstone 004G","E01033092",758,337,49,288,350,15,133,50,72,11,107,71,34,2,86,57,29,9,9,71,16,55
"2021","Maidstone 004H","E01034991",639,317,24,293,274,1,78,39,34,5,107,83,21,3,71,58,13,17,17,48,15,33
"2021","Maidstone 004I","E01034992",589,301,162,139,255,23,78,32,36,10,87,62,22,3,59,32,27,8,8,33,5,28
"2021","Maidstone 005A","E01024330",640,125,93,32,492,123,292,80,169,43,45,18,24,3,31,22,9,1,1,23,9,14
"2021","Maidstone 005B","E01024336",734,137,70,67,566,112,328,99,162,67,74,30,42,2,50,34,16,2,2,31,20,11
"2021","Maidstone 005C","E01024337",612,146,84,62,446,91,250,88,117,45,56,30,24,2,49,30,19,0,0,20,8,12
"2021","Maidstone 005D","E01024348",530,95,48,47,414,74,249,69,132,48,57,24,29,4,32,22,10,2,2,21,11,10
"2021","Maidstone 005E","E01024351",659,187,133,54,417,109,211,60,111,40,45,21,21,3,50,28,22,2,2,55,23,32
"2021","Maidstone 006A","E01024339",1002,366,89,277,556,33,248,86,130,32,146,95,44,7,112,71,41,17,17,80,20,60
"2021","Maidstone 006B","E01024340",1125,401,87,314,650,65,327,107,164,56,140,87,46,7,106,73,33,12,12,74,21,53
"2021","Maidstone 006C","E01024356",719,221,50,171,440,27,210,59,121,30,121,64,49,8,75,48,27,7,7,58,17,41
"2021","Maidstone 006E","E01024373",929,299,99,200,543,42,255,68,141,46,140,69,66,5,98,66,32,8,8,87,30,57
"2021","Maidstone 006F","E01033087",876,379,41,338,430,13,166,60,95,11,149,103,43,3,93,62,31,9,9,67,18,49
"2021","Maidstone 006G","E01033091",743,256,56,200,427,24,186,61,103,22,113,68,40,5,94,67,27,10,10,60,11,49
"2021","Maidstone 007A","E01024326",788,211,163,48,548,172,281,86,142,53,62,25,32,5,31,18,13,2,2,29,13,16
"2021","Maidstone 007B","E01024327",670,165,103,62,475,95,220,59,118,43,76,36,36,4,81,49,32,3,3,30,12,18
"2021","Maidstone 007C","E01024328",688,179,115,64,475,116,252,88,114,50,62,32,27,3,45,26,19,0,0,34,11,23
"2021","Maidstone 007D","E01024329",637,138,94,44,481,122,260,80,120,60,56,23,33,0,42,14,28,1,1,18,8,10
"2021","Maidstone 007E","E01024349",594,195,50,145,377,45,190,67,103,20,93,57,33,3,48,31,17,1,1,22,10,12
"2021","Maidstone 008A","E01024357",683,172,47,125,450,33,209,60,111,38,110,61,43,6,90,56,34,8,8,61,22,39
"2021","Maidstone 008B","E01024358",788,222,115,107,517,64,233,71,107,55,86,42,41,3,125,87,38,9,9,49,17,32
"2021","Maidstone 008C","E01024367",618,132,61,71,429,47,230,72,124,34,72,33,35,4,77,55,22,3,3,57,27,30
"2021","Maidstone 008E","E01024369",621,137,84,53,454,83,250,72,126,52,73,40,30,3,45,23,22,3,3,30,17,13
"2021","Maidstone 008F","E01033088",846,185,28,157,597,23,318,60,217,41,138,65,67,6,110,89,21,8,8,64,29,35
"2021","Maidstone 008G","E01033089",671,150,48,102,462,32,216,51,120,45,95,39,45,11,110,75,35,9,9,59,25,34
"2021","Maidstone 009A","E01024360",652,175,63,112,438,45,214,70,110,34,98,66,22,10,75,48,27,6,6,39,18,21
"2021","Maidstone 009B","E01024372",920,285,49,236,503,22,214,72,109,33,146,96,47,3,107,68,39,14,14,132,46,86
"2021","Maidstone 009C","E01024374",604,102,35,67,425,20,182,33,117,32,78,29,41,8,140,90,50,5,5,77,41,36
"2021","Maidstone 009D","E01024401",816,234,82,152,534,36,243,68,139,36,129,75,49,5,117,73,44,9,9,48,29,19
"2021","Maidstone 009E","E01024403",915,225,80,145,618,57,340,112,188,40,132,83,45,4,82,58,24,7,7,72,31,41
"2021","Maidstone 010A","E01024371",670,136,67,69,476,84,257,72,139,46,79,38,35,6,52,25,27,4,4,58,19,39
"2021","Maidstone 010B","E01024392",622,141,75,66,426,47,216,61,97,58,70,28,32,10,86,57,29,7,7,55,30,25
"2021","Maidstone 010C","E01024393",688,211,138,73,438,114,188,48,95,45,67,26,38,3,67,46,21,2,2,39,16,23
"2021","Maidstone 010D","E01024395",508,108,62,46,355,39,198,53,84,61,63,18,30,15,53,22,31,2,2,45,27,18
"2021","Maidstone 010E","E01024396",621,173,88,85,403,41,192,51,92,49,85,39,36,10,83,56,27,2,2,45,18,27
"2021","Maidstone 011A","E01024361",767,231,148,83,498,117,227,78,94,55,78,38,37,3,73,41,32,3,3,38,9,29
"2021","Maidstone 011B","E01024362",792,200,118,82,541,114,294,124,112,58,102,62,32,8,31,24,7,0,0,51,28,23
"2021","Maidstone 011D","E01024387",1040,215,110,105,720,180,376,156,141,79,112,61,44,7,48,23,25,4,4,105,42,63
"2021","Maidstone 011E","E01034993",653,131,70,61,488,133,238,122,75,41,62,39,22,1,53,31,22,2,2,34,6,28
"2021","Maidstone 011F","E01034994",733,162,76,86,528,72,251,78,142,31,125,66,54,5,80,55,25,0,0,43,24,19
"2021","Maidstone 012A","E01024331",650,139,88,51,477,83,253,91,118,44,81,39,34,8,58,37,21,2,2,34,15,19
"2021","Maidstone 012B","E01024394",543,98,69,29,404,88,224,68,100,56,47,19,21,7,44,14,30,1,1,41,27,14
"2021","Maidstone 012C","E01024402",620,147,101,46,450,113,233,73,124,36,62,34,24,4,42,18,24,0,0,23,16,7
"2021","Maidstone 012D","E01024404",640,126,81,45,478,108,268,82,138,48,61,27,31,3,39,22,17,2,2,36,15,21
"2021","Maidstone 012E","E01024405",1117,312,158,154,738,151,337,88,189,60,122,56,57,9,124,90,34,4,4,67,31,36
"2021","Maidstone 013B","E01024390",704,162,63,99,496,39,196,59,107,30,117,37,69,11,135,97,38,9,9,46,19,27
"2021","Maidstone 013C","E01024391",477,83,41,42,351,20,162,42,69,51,66,15,44,7,101,53,48,2,2,43,25,18
"2021","Maidstone 013D","E01024397",614,235,97,138,347,46,137,45,63,29,72,26,41,5,86,58,28,6,6,32,23,9
"2021","Maidstone 013E","E01024398",678,185,71,114,438,35,184,56,74,54,82,24,46,12,132,81,51,5,5,55,27,28
"2021","Maidstone 013F","E01024399",621,280,154,126,310,40,134,47,53,34,77,29,38,10,54,29,25,5,5,31,17,14
"2021","Maidstone 013G","E01024400",550,140,85,55,376,89,178,47,89,42,51,19,28,4,57,36,21,1,1,34,18,16
"2021","Maidstone 013H","E01034995",567,148,51,97,383,18,166,39,108,19,91,30,58,3,101,82,19,7,7,36,23,13
"2021","Maidstone 013I","E01034996",557,127,42,85,403,21,100,16,70,14,82,22,57,3,194,153,41,6,6,27,13,14
"2021","Maidstone 014A","E01024325",1031,269,199,70,711,222,366,130,152,84,84,47,33,4,37,17,20,2,2,51,24,27
"2021","Maidstone 014B","E01024346",580,148,78,70,400,100,204,86,87,31,67,39,22,6,29,13,16,0,0,32,13,19
"2021","Maidstone 014C","E01024377",733,219,109,110,488,108,235,79,108,48,84,44,32,8,58,27,31,3,3,26,11,15
"2021","Maidstone 014D","E01024378",652,182,85,97,445,74,231,77,109,45,78,41,32,5,60,30,30,2,2,25,11,14
"2021","Maidstone 015A","E01024332",505,124,64,60,349,75,187,79,71,37,47,26,19,2,35,20,15,5,5,32,12,20
"2021","Maidstone 015B","E01024350",799,161,46,115,587,70,324,111,162,51,122,67,47,8,71,46,25,0,0,51,25,26
"2021","Maidstone 015C","E01024375",1012,243,134,109,718,149,403,180,154,69,101,47,47,7,62,28,34,3,3,51,23,28
"2021","Maidstone 015E","E01024410",682,154,77,77,489,115,262,110,93,59,62,34,23,5,47,20,27,3,3,39,19,20
"2021","Maidstone 015F","E01034997",552,100,32,68,425,25,215,65,107,43,93,37,52,4,90,48,42,2,2,27,15,12
"2021","Maidstone 015G","E01034998",550,140,67,73,382,38,186,55,103,28,77,31,42,4,78,59,19,3,3,28,16,12
"2021","Maidstone 015H","E01034999",560,88,8,80,435,6,203,50,145,8,145,61,80,4,79,63,16,2,2,37,21,16
"2021","Maidstone 016A","E01024342",947,280,143,137,620,89,285,94,142,49,122,66,52,4,118,74,44,6,6,47,24,23
"2021","Maidstone 016B","E01024343",532,99,56,43,402,74,225,69,91,65,53,29,18,6,46,20,26,4,4,31,12,19
"2021","Maidstone 016C","E01024344",734,189,118,71,522,118,244,92,107,45,103,58,41,4,52,29,23,5,5,23,9,14
"2021","Maidstone 016D","E01024376",1017,227,132,95,728,168,391,124,200,67,95,52,36,7,71,46,25,3,3,62,29,33
"2021","Maidstone 017A","E01024364",762,221,129,92,510,104,243,105,93,45,80,49,24,7,81,47,34,2,2,31,12,19
"2021","Maidstone 017B","E01024365",1085,279,162,117,769,151,379,134,195,50,118,74,40,4,118,77,41,3,3,37,18,19
"2021","Maidstone 017C","E01024366",690,166,84,82,477,86,266,118,97,51,74,40,23,11,46,22,24,5,5,47,21,26
"2021","Maidstone 017D","E01024411",520,99,41,58,383,52,182,66,82,34,79,48,23,8,64,37,27,6,6,38,19,19
"2021","Maidstone 018A","E01024345",632,144,81,63,440,73,245,91,102,52,77,42,29,6,39,13,26,6,6,48,21,27
"2021","Maidstone 018B","E01024379",696,134,69,65,512,77,321,116,139,66,66,40,23,3,44,18,26,4,4,50,27,23
"2021","Maidstone 018C","E01024380",931,226,105,121,652,75,363,133,167,63,129,74,51,4,83,58,25,2,2,53,24,29
"2021","Maidstone 018D","E01024381",877,221,104,117,624,80,297,109,156,32,146,97,47,2,98,60,38,3,3,32,15,17
"2021","Maidstone 019A","E01024406",701,162,72,90,501,68,279,89,145,45,83,46,35,2,68,43,25,3,3,38,18,20
"2021","Maidstone 019B","E01024407",703,125,61,64,532,83,287,94,140,53,94,55,34,5,65,38,27,3,3,46,21,25
"2021","Maidstone 019C","E01024408",638,132,84,48,481,84,244,81,117,46,74,36,33,5,71,37,34,8,8,25,11,14
"2021","Maidstone 019D","E01024409",622,160,108,52,433,104,208,61,98,49,61,44,12,5,59,31,28,1,1,29,10,19
"2021","Sevenoaks 001A","E01024445",543,138,88,50,379,73,218,69,96,53,55,28,23,4,33,12,21,0,0,26,11,15
"2021","Sevenoaks 001B","E01024446",589,144,81,63,416,84,222,76,88,58,61,27,25,9,45,23,22,4,4,29,9,20
"2021","Sevenoaks 001C","E01024447",558,157,105,52,375,72,177,55,75,47,61,26,29,6,62,37,25,3,3,26,14,12
"2021","Sevenoaks 001D","E01024472",537,103,58,45,392,56,213,57,96,60,64,32,29,3,57,37,20,2,2,42,21,21
"2021","Sevenoaks 001E","E01024479",642,163,96,67,452,80,220,65,94,61,84,37,42,5,63,40,23,5,5,27,11,16
"2021","Sevenoaks 002A","E01024476",656,142,47,95,471,33,192,55,95,42,89,37,41,11,152,95,57,5,5,43,22,21
"2021","Sevenoaks 002B","E01024477",627,194,75,119,384,34,176,47,86,43,67,27,35,5,98,60,38,9,9,49,26,23
"2021","Sevenoaks 002C","E01024478",592,129,75,54,427,75,193,54,101,38,83,34,42,7,71,39,32,5,5,36,19,17
"2021","Sevenoaks 002D","E01024480",817,326,174,152,448,51,185,58,95,32,75,29,41,5,131,74,57,6,6,43,21,22
"2021","Sevenoaks 002E","E01024481",670,190,116,74,436,66,195,53,90,52,66,28,31,7,104,62,42,5,5,44,25,19
"2021","Sevenoaks 002F","E01024482",668,222,104,118,403,42,191,64,94,33,60,25,30,5,108,63,45,2,2,43,24,19
"2021","Sevenoaks 003A","E01024421",832,236,142,94,551,89,278,106,106,66,91,53,32,6,89,50,39,4,4,45,19,26
"2021","Sevenoaks 003B","E01024473",639,151,85,66,457,56,250,83,115,52,84,34,42,8,65,38,27,2,2,31,14,17
"2021","Sevenoaks 003C","E01024474",655,128,62,66,495,92,253,80,128,45,99,60,35,4,47,21,26,4,4,32,22,10
"2021","Sevenoaks 003D","E01024475",691,214,106,108,444,65,198,47,108,43,87,45,33,9,91,53,38,3,3,33,15,18
"2021","Sevenoaks 004A","E01024441",655,141,106,35,496,161,271,92,104,75,30,18,10,2,34,16,18,0,0,18,12,6
"2021","Sevenoaks 004B","E01024442",590,111,79,32,439,123,240,82,102,56,40,16,20,4,35,9,26,1,1,40,19,21
"2021","Sevenoaks 004C","E01024443",659,237,197,40,398,137,199,73,84,42,39,20,14,5,21,10,11,2,2,24,16,8
"2021","Sevenoaks 004D","E01024444",515,144,83,61,336,34,166,65,74,27,53,20,27,6,78,46,32,5,5,35,19,16
"2021","Sevenoaks 005A","E01024431",807,221,135,86,553,115,305,119,128,58,78,45,25,8,52,24,28,3,3,33,19,14
"2021","Sevenoaks 005B","E01024432",600,163,102,61,409,66,212,79,80,53,72,39,29,4,58,34,24,1,1,28,13,15
"2021","Sevenoaks 005C","E01024433",592,143,78,65,417,64,231,75,108,48,65,42,20,3,53,32,21,4,4,32,17,15
"2021","Sevenoaks 005D","E01024434",909,351,178,173,513,89,203,62,102,39,111,58,49,4,104,72,32,6,6,45,17,28
"2021","Sevenoaks 007A","E01024435",632,125,76,49,462,95,244,81,103,60,67,32,29,6,55,28,27,1,1,45,16,29
"2021","Sevenoaks 007B","E01024436",716,276,174,102,400,127,195,86,65,44,38,18,12,8,38,16,22,2,2,40,13,27
"2021","Sevenoaks 007C","E01024437",618,168,91,77,412,89,196,73,81,42,74,42,31,1,52,21,31,1,1,38,16,22
"2021","Sevenoaks 007D","E01024438",614,173,116,57,390,94,184,73,64,47,71,29,38,4,39,20,19,2,2,51,20,31
"2021","Sevenoaks 008B","E01024423",761,255,114,141,475,45,251,63,158,30,107,67,38,2,69,44,25,3,3,31,8,23
"2021","Sevenoaks 008C","E01024439",649,148,79,69,461,95,260,78,122,60,49,23,20,6,55,30,25,2,2,40,19,21
"2021","Sevenoaks 008D","E01024440",774,180,114,66,549,128,296,87,150,59,78,34,35,9,45,19,26,2,2,45,15,30
"2021","Sevenoaks 008E","E01024452",614,152,96,56,426,79,227,88,96,43,65,26,34,5,53,24,29,2,2,36,11,25
"2021","Sevenoaks 008F","E01035000",655,179,45,134,456,31,234,64,144,26,95,61,29,5,92,58,34,4,4,20,13,7
"2021","Sevenoaks 008G","E01035001",603,200,52,148,380,34,170,47,110,13,114,78,35,1,58,41,17,4,4,23,10,13
"2021","Sevenoaks 009A","E01024448",518,124,66,58,369,46,202,68,103,31,59,27,27,5,58,36,22,4,4,25,13,12
"2021","Sevenoaks 009B","E01024449",559,107,89,18,433,116,253,60,134,59,29,12,13,4,34,20,14,1,1,19,8,11
"2021","Sevenoaks 009C","E01024450",642,169,102,67,440,73,231,68,125,38,72,37,32,3,64,35,29,0,0,33,14,19
"2021","Sevenoaks 009D","E01024453",646,133,101,32,486,116,302,71,174,57,30,9,20,1,37,15,22,1,1,27,9,18
"2021","Sevenoaks 009E","E01024454",613,146,78,68,442,80,258,59,146,53,36,13,20,3,65,35,30,3,3,25,8,17
"2021","Sevenoaks 010A","E01024457",530,171,84,87,337,55,165,51,98,16,49,29,17,3,65,47,18,3,3,22,9,13
"2021","Sevenoaks 010B","E01024460",666,166,83,83,462,55,220,43,141,36,84,37,44,3,97,54,43,6,6,38,19,19
"2021","Sevenoaks 010C","E01024461",1017,301,144,157,676,98,401,105,241,55,117,78,36,3,55,40,15,5,5,40,13,27
"2021","Sevenoaks 010D","E01024465",612,179,74,105,397,43,189,62,92,35,99,49,43,7,62,44,18,4,4,36,11,25
"2021","Sevenoaks 010E","E01024466",543,141,68,73,369,50,171,43,104,24,68,24,39,5,78,52,26,2,2,33,18,15
"2021","Sevenoaks 010F","E01024468",660,205,90,115,427,52,240,48,162,30,70,51,19,0,61,36,25,4,4,28,11,17
"2021","Sevenoaks 011A","E01024416",638,154,82,72,453,67,291,78,173,40,50,27,20,3,43,31,12,2,2,31,12,19
"2021","Sevenoaks 011B","E01024418",517,91,64,27,404,91,241,44,155,42,36,7,24,5,36,21,15,0,0,22,14,8
"2021","Sevenoaks 011C","E01024424",489,82,51,31,388,54,283,56,191,36,33,14,17,2,17,9,8,1,1,19,12,7
"2021","Sevenoaks 011D","E01024463",566,87,51,36,457,65,334,72,211,51,35,21,10,4,22,15,7,1,1,22,12,10
"2021","Sevenoaks 011E","E01024464",600,112,70,42,453,105,302,70,183,49,22,10,11,1,24,20,4,0,0,35,15,20
"2021","Sevenoaks 011F","E01024467",640,119,68,51,502,64,325,65,224,36,57,27,28,2,54,29,25,2,2,19,15,4
"2021","Sevenoaks 012A","E01024458",538,103,61,42,404,67,265,86,139,40,35,17,15,3,35,17,18,2,2,31,16,15
"2021","Sevenoaks 012B","E01024459",634,162,88,74,438,79,269,79,147,43,47,16,27,4,42,21,21,1,1,34,13,21
"2021","Sevenoaks 012C","E01024462",647,158,99,59,477,88,310,81,174,55,31,12,17,2,48,26,22,0,0,12,5,7
"2021","Sevenoaks 012D","E01024469",808,300,87,213,473,46,246,80,137,29,121,96,22,3,55,32,23,5,5,35,11,24
"2021","Sevenoaks 012E","E01024470",669,184,102,82,469,75,299,69,200,30,47,34,12,1,47,31,16,1,1,16,4,12
"2021","Sevenoaks 012F","E01024471",773,333,221,112,410,90,210,63,128,19,54,41,12,1,54,33,21,2,2,30,10,20
"2021","Sevenoaks 013A","E01024417",663,158,74,84,471,82,233,79,113,41,82,45,34,3,71,44,27,3,3,34,17,17
"2021","Sevenoaks 013B","E01024419",748,170,90,80,547,103,329,118,164,47,69,44,21,4,44,28,16,2,2,31,11,20
"2021","Sevenoaks 013C","E01024483",692,215,114,101,457,82,221,76,102,43,94,63,27,4,56,33,23,4,4,20,6,14
"2021","Sevenoaks 013D","E01024484",506,106,55,51,379,90,216,90,88,38,39,21,12,6,31,18,13,3,3,21,10,11
"2021","Sevenoaks 013E","E01024485",738,221,102,119,492,55,224,61,117,46,92,43,43,6,119,80,39,2,2,25,12,13
"2021","Sevenoaks 014A","E01024425",931,292,180,112,598,79,288,103,151,34,137,72,56,9,92,61,31,2,2,41,20,21
"2021","Sevenoaks 014B","E01024426",885,253,131,122,598,111,300,102,155,43,109,65,39,5,74,51,23,4,4,34,15,19
"2021","Sevenoaks 014C","E01024427",542,152,63,89,358,36,157,45,76,36,75,23,47,5,88,53,35,2,2,32,12,20
"2021","Sevenoaks 014D","E01024428",527,110,70,40,392,47,186,54,95,37,82,38,37,7,75,48,27,2,2,25,10,15
"2021","Sevenoaks 014E","E01024429",702,201,74,127,473,64,190,61,96,33,107,40,58,9,107,72,35,5,5,28,14,14
"2021","Sevenoaks 014F","E01024430",578,159,78,81,391,87,206,78,92,36,55,34,19,2,41,25,16,2,2,28,9,19
"2021","Sevenoaks 015A","E01024420",874,197,95,102,631,107,368,153,154,61,92,58,31,3,62,33,29,2,2,46,14,32
"2021","Sevenoaks 015B","E01024451",962,191,100,91,734,127,447,128,241,78,86,45,34,7,69,42,27,5,5,37,18,19
"2021","Sevenoaks 015C","E01024455",484,108,60,48,358,61,209,80,96,33,49,31,14,4,37,15,22,2,2,18,13,5
"2021","Sevenoaks 015D","E01024456",512,132,81,51,362,74,210,70,105,35,39,20,17,2,39,21,18,0,0,18,12,6
"2021","Sevenoaks 016A","E01024413",717,239,130,109,451,60,175,59,83,33,98,46,44,8,111,68,43,7,7,27,12,15
"2021","Sevenoaks 016B","E01024414",605,113,56,57,448,55,214,58,104,52,89,38,44,7,88,49,39,2,2,44,25,19
"2021","Sevenoaks 016C","E01024415",506,88,60,28,397,115,221,60,111,50,28,8,17,3,33,10,23,0,0,21,8,13
"2021","Sevenoaks 016D","E01032619",639,160,100,60,443,92,207,65,100,42,78,40,29,9,66,36,30,0,0,36,18,18
"2021","Folkestone and Hythe 001A","E01024490",879,217,133,84,611,168,294,141,93,60,81,55,20,6,64,32,32,4,4,51,19,32
"2021","Folkestone and Hythe 001B","E01024544",585,138,90,48,399,113,193,96,57,40,51,27,20,4,38,15,23,4,4,48,22,26
"2021","Folkestone and Hythe 001C","E01024545",613,165,101,64,412,116,225,90,78,57,47,19,25,3,23,9,14,1,1,36,14,22
"2021","Folkestone and Hythe 001D","E01024547",622,206,148,58,393,126,164,61,81,22,54,33,17,4,49,28,21,0,0,23,9,14
"2021","Folkestone and Hythe 002A","E01024492",635,176,90,86,411,56,183,64,81,38,90,48,34,8,75,37,38,7,7,48,25,23
"2021","Folkestone and Hythe 002B","E01024541",953,199,91,108,698,84,353,107,194,52,124,39,76,9,135,87,48,2,2,56,30,26
"2021","Folkestone and Hythe 002C","E01024542",798,204,109,95,547,123,272,91,123,58,92,46,36,10,59,37,22,1,1,47,25,22
"2021","Folkestone and Hythe 002E","E01033213",717,136,49,87,536,29,282,76,163,43,119,49,61,9,103,77,26,3,3,45,27,18
"2021","Folkestone and Hythe 002F","E01033214",777,171,81,90,567,115,304,95,155,54,96,48,37,11,52,37,15,0,0,39,19,20
"2021","Folkestone and Hythe 003A","E01024496",636,212,92,120,393,38,166,63,62,41,84,32,45,7,94,67,27,11,11,31,14,17
"2021","Folkestone and Hythe 003B","E01024497",651,160,82,78,449,69,199,73,82,44,75,32,35,8,99,65,34,7,7,42,19,23
"2021","Folkestone and Hythe 003C","E01024498",638,179,91,88,421,37,164,44,83,37,93,37,42,14,123,82,41,4,4,38,16,22
"2021","Folkestone and Hythe 003D","E01024503",752,261,149,112,454,91,185,72,76,37,96,42,47,7,79,47,32,3,3,37,12,25
"2021","Folkestone and Hythe 003E","E01024518",672,170,112,58,484,104,250,82,115,53,71,37,29,5,56,25,31,3,3,18,8,10
"2021","Folkestone and Hythe 004A","E01024499",661,195,60,135,423,22,181,53,93,35,104,48,50,6,111,81,30,5,5,43,15,28
"2021","Folkestone and Hythe 004B","E01024500",541,193,79,114,316,26,109,32,57,20,72,31,38,3,101,66,35,8,8,32,16,16
"2021","Folkestone and Hythe 004C","E01024501",603,165,49,116,380,25,145,52,68,25,96,42,52,2,114,74,40,0,0,58,24,34
"2021","Folkestone and Hythe 004D","E01024502",588,203,68,135,326,22,136,38,78,20,67,28,36,3,97,67,30,4,4,59,24,35
"2021","Folkestone and Hythe 004E","E01024505",817,304,112,192,465,41,190,73,94,23,100,42,53,5,129,102,27,5,5,48,25,23
"2021","Folkestone and Hythe 005A","E01024491",551,103,38,65,407,33,197,64,85,48,90,37,43,10,85,47,38,2,2,41,18,23
"2021","Folkestone and Hythe 005B","E01024493",615,192,108,84,384,47,178,52,86,40,73,27,39,7,83,46,37,3,3,39,20,19
"2021","Folkestone and Hythe 005C","E01024494",764,213,116,97,479,62,242,89,100,53,90,33,52,5,84,45,39,1,1,72,38,34
"2021","Folkestone and Hythe 005D","E01024495",859,190,79,111,619,30,332,95,198,39,150,66,75,9,102,65,37,5,5,50,27,23
"2021","Folkestone and Hythe 005E","E01024520",666,218,110,108,408,67,182,57,96,29,81,39,41,1,74,38,36,4,4,40,14,26
"2021","Folkestone and Hythe 005F","E01024528",551,161,83,78,374,64,185,91,70,24,73,38,30,5,50,20,30,2,2,16,9,7
"2021","Folkestone and Hythe 006A","E01024511",694,165,68,97,491,109,249,72,135,42,77,42,32,3,55,31,24,1,1,38,19,19
"2021","Folkestone and Hythe 006B","E01024512",709,195,94,101,469,68,209,67,95,47,100,37,53,10,91,56,35,1,1,45,18,27
"2021","Folkestone and Hythe 006C","E01024513",658,175,102,73,436,60,204,72,91,41,88,43,39,6,83,48,35,1,1,47,28,19
"2021","Folkestone and Hythe 006D","E01024514",506,122,71,51,344,50,199,56,107,36,55,27,26,2,36,24,12,4,4,40,18,22
"2021","Folkestone and Hythe 006E","E01024515",786,223,135,88,516,112,250,96,111,43,88,37,44,7,65,31,34,1,1,47,24,23
"2021","Folkestone and Hythe 006F","E01024516",545,118,70,48,393,91,184,60,78,46,52,18,30,4,64,30,34,2,2,34,14,20
"2021","Folkestone and Hythe 006G","E01024519",678,247,109,138,409,94,172,83,66,23,77,44,28,5,61,40,21,5,5,22,8,14
"2021","Folkestone and Hythe 006H","E01024521",824,351,171,180,445,100,189,96,67,26,78,50,25,3,75,44,31,3,3,28,10,18
"2021","Folkestone and Hythe 008A","E01024523",677,172,126,46,485,171,247,93,102,52,38,20,15,3,28,12,16,1,1,20,9,11
"2021","Folkestone and Hythe 008B","E01024526",662,198,127,71,440,140,220,104,84,32,48,31,14,3,32,13,19,0,0,24,12,12
"2021","Folkestone and Hythe 008C","E01024527",774,295,224,71,456,160,217,107,62,48,45,26,13,6,34,28,6,0,0,23,11,12
"2021","Folkestone and Hythe 008D","E01024550",858,217,143,74,589,159,286,117,120,49,74,45,26,3,67,35,32,3,3,52,17,35
"2021","Folkestone and Hythe 009A","E01024489",749,225,170,55,471,170,213,126,43,44,50,28,15,7,35,8,27,3,3,53,28,25
"2021","Folkestone and Hythe 009B","E01024530",775,184,107,77,553,96,280,117,110,53,120,57,55,8,55,34,21,2,2,38,17,21
"2021","Folkestone and Hythe 009C","E01024536",791,188,98,90,565,127,325,128,129,68,62,34,21,7,49,20,29,2,2,38,15,23
"2021","Folkestone and Hythe 009D","E01024546",713,166,88,78,515,97,258,103,115,40,94,43,43,8,64,36,28,2,2,32,9,23
"2021","Folkestone and Hythe 010A","E01024522",716,297,185,112,393,106,172,86,54,32,70,40,21,9,43,24,19,2,2,26,3,23
"2021","Folkestone and Hythe 010B","E01024524",782,392,223,169,367,91,126,68,38,20,65,32,27,6,79,47,32,6,6,23,6,17
"2021","Folkestone and Hythe 010C","E01024525",835,407,241,166,409,120,131,72,45,14,67,40,23,4,88,60,28,3,3,19,5,14
"2021","Folkestone and Hythe 010D","E01024529",709,245,159,86,442,134,170,84,55,31,65,33,20,12,69,30,39,4,4,22,5,17
"2021","Folkestone and Hythe 010E","E01024531",647,203,122,81,417,106,179,77,69,33,70,31,32,7,60,34,26,2,2,27,14,13
"2021","Folkestone and Hythe 011A","E01024486",870,274,187,87,549,165,226,107,58,61,88,44,33,11,70,32,38,0,0,47,17,30
"2021","Folkestone and Hythe 011B","E01024487",578,170,116,54,371,88,163,95,38,30,64,40,21,3,51,22,29,5,5,37,17,20
"2021","Folkestone and Hythe 011C","E01024488",646,241,191,50,378,144,148,93,29,26,49,26,19,4,35,10,25,2,2,27,12,15
"2021","Folkestone and Hythe 011D","E01024548",517,116,54,62,366,73,197,84,73,40,53,24,24,5,41,22,19,2,2,35,15,20
"2021","Folkestone and Hythe 011E","E01024549",505,105,44,61,348,63,186,80,69,37,65,40,22,3,33,14,19,1,1,52,16,36
"2021","Folkestone and Hythe 012A","E01024537",737,214,125,89,474,146,197,106,54,37,80,48,28,4,49,20,29,2,2,49,14,35
"2021","Folkestone and Hythe 012B","E01024538",718,160,115,45,517,192,233,115,61,57,49,26,20,3,41,17,24,2,2,41,17,24
"2021","Folkestone and Hythe 012C","E01024539",933,330,193,137,561,99,239,101,87,51,92,37,43,12,126,80,46,5,5,42,23,19
"2021","Folkestone and Hythe 012D","E01024540",786,205,134,71,538,146,243,102,82,59,90,52,30,8,58,29,29,1,1,43,14,29
"2021","Folkestone and Hythe 013A","E01024532",533,125,75,50,368,93,181,78,51,52,46,24,12,10,46,24,22,2,2,40,26,14
"2021","Folkestone and Hythe 013B","E01024533",540,168,99,69,336,97,139,85,21,33,62,31,25,6,37,23,14,1,1,36,14,22
"2021","Folkestone and Hythe 013C","E01024534",619,183,94,89,393,44,166,70,60,36,79,31,40,8,98,65,33,6,6,43,21,22
"2021","Folkestone and Hythe 013D","E01024535",1044,303,158,145,688,156,274,136,91,47,153,72,70,11,105,70,35,0,0,53,19,34
"2021","Folkestone and Hythe 014A","E01024504",942,442,77,365,435,17,120,45,60,15,126,69,50,7,167,129,38,5,5,65,27,38
"2021","Folkestone and Hythe 014B","E01024507",980,530,158,372,392,22,124,40,65,19,125,80,43,2,113,83,30,8,8,58,19,39
"2021","Folkestone and Hythe 014C","E01033212",844,444,91,353,353,20,108,61,36,11,119,86,31,2,96,78,18,10,10,47,13,34
"2021","Folkestone and Hythe 014D","E01033215",778,483,196,287,275,69,78,45,22,11,78,59,19,0,46,30,16,4,4,20,5,15
"2021","Folkestone and Hythe 015A","E01024508",1082,550,180,370,462,48,154,85,53,16,145,112,32,1,106,79,27,9,9,70,17,53
"2021","Folkestone and Hythe 015B","E01024509",857,494,252,242,319,61,89,56,28,5,95,77,16,2,68,43,25,6,6,44,8,36
"2021","Folkestone and Hythe 015C","E01024510",812,389,151,238,383,74,137,80,34,23,95,73,20,2,73,44,29,4,4,40,10,30
"2021","Folkestone and Hythe 015D","E01024517",755,288,76,212,389,37,163,68,71,24,113,77,33,3,73,45,28,3,3,78,24,54
"2021","Swale 001A","E01024609",628,261,52,209,324,13,103,30,59,14,91,49,37,5,107,76,31,10,10,43,18,25
"2021","Swale 001B","E01024610",709,218,68,150,451,23,164,48,87,29,121,39,71,11,141,109,32,2,2,40,18,22
"2021","Swale 001C","E01024611",621,135,44,91,427,13,138,42,71,25,120,45,68,7,152,112,40,4,4,59,33,26
"2021","Swale 001D","E01024612",652,168,68,100,423,42,152,58,62,32,104,32,68,4,121,83,38,4,4,61,24,37
"2021","Swale 002A","E01024613",702,264,108,156,376,25,122,47,56,19,111,55,48,8,113,79,34,5,5,62,34,28
"2021","Swale 002B","E01024614",628,169,84,85,416,24,131,36,61,34,90,34,43,13,164,111,53,7,7,43,23,20
"2021","Swale 002C","E01024615",598,189,84,105,366,34,138,55,45,38,65,19,40,6,125,81,44,4,4,43,23,20
"2021","Swale 002D","E01024616",697,197,115,82,454,61,176,56,78,42,108,35,57,16,103,63,40,6,6,46,17,29
"2021","Swale 003A","E01024585",610,205,122,83,366,67,173,59,67,47,53,21,24,8,70,42,28,3,3,39,21,18
"2021","Swale 003B","E01024587",821,243,129,114,534,123,269,124,88,57,94,47,45,2,44,23,21,4,4,44,20,24
"2021","Swale 003C","E01024588",663,142,91,51,466,125,228,97,80,51,62,27,31,4,50,22,28,1,1,55,29,26
"2021","Swale 003D","E01024589",692,156,104,52,483,136,240,122,66,52,69,37,23,9,37,15,22,1,1,53,24,29
"2021","Swale 004A","E01024595",660,183,106,77,432,90,199,80,76,43,83,39,36,8,56,28,28,4,4,45,22,23
"2021","Swale 004B","E01024598",663,148,67,81,464,55,237,92,96,49,121,61,52,8,50,28,22,1,1,51,24,27
"2021","Swale 004D","E01024619",601,164,92,72,393,89,185,75,63,47,62,27,27,8,54,25,29,3,3,44,22,22
"2021","Swale 004E","E01024621",520,142,68,74,336,35,137,40,67,30,66,29,30,7,97,58,39,1,1,42,21,21
"2021","Swale 004F","E01032653",679,205,98,107,436,68,178,74,61,43,82,40,37,5,105,75,30,3,3,38,20,18
"2021","Swale 004H","E01035298",563,126,19,107,408,7,158,39,105,14,136,63,68,5,103,88,15,4,4,29,13,16
"2021","Swale 004I","E01035299",632,110,25,85,482,37,242,76,135,31,116,44,62,10,85,60,25,2,2,40,17,23
"2021","Swale 005A","E01024594",606,176,122,54,392,93,184,70,65,49,65,23,30,12,49,28,21,1,1,38,17,21
"2021","Swale 005B","E01024596",696,195,80,115,443,61,175,71,69,35,107,43,57,7,90,54,36,10,10,58,27,31
"2021","Swale 005C","E01024597",720,196,81,115,469,51,160,62,62,36,115,33,65,17,140,97,43,3,3,55,37,18
"2021","Swale 005D","E01024620",652,169,91,78,432,104,226,97,77,52,69,36,32,1,31,19,12,2,2,51,23,28
"2021","Swale 006A","E01024580",963,375,199,176,535,119,220,119,55,46,90,51,32,7,101,61,40,5,5,53,24,29
"2021","Swale 006B","E01024581",575,139,70,69,398,60,193,89,73,31,74,28,40,6,63,40,23,8,8,38,19,19
"2021","Swale 006C","E01024586",689,178,99,79,461,104,233,96,70,67,73,30,35,8,50,30,20,1,1,50,25,25
"2021","Swale 006E","E01035300",427,116,58,58,273,50,125,67,34,24,44,19,22,3,54,34,20,0,0,38,17,21
"2021","Swale 006F","E01035301",545,132,66,66,371,60,200,76,85,39,63,31,24,8,45,24,21,3,3,42,22,20
"2021","Swale 007B","E01024576",682,164,57,107,479,58,238,89,105,44,122,73,42,7,56,36,20,5,5,39,19,20
"2021","Swale 007C","E01024577",524,110,47,63,371,58,183,59,80,44,57,27,24,6,71,31,40,2,2,43,25,18
"2021","Swale 007D","E01024578",656,141,54,87,479,35,260,98,115,47,115,59,49,7,67,41,26,2,2,36,18,18
"2021","Swale 007F","E01024583",674,140,63,77,492,49,236,94,95,47,114,50,58,6,90,54,36,3,3,42,22,20
"2021","Swale 007G","E01032655",705,112,25,87,551,43,299,87,170,42,127,52,65,10,81,61,20,1,1,42,23,19
"2021","Swale 007H","E01032656",929,156,71,85,716,68,410,111,245,54,157,67,87,3,78,52,26,3,3,57,30,27
"2021","Swale 007I","E01035302",519,81,16,65,368,14,197,46,118,33,80,37,36,7,70,46,24,7,7,70,37,33
"2021","Swale 007J","E01035303",535,131,34,97,335,12,137,54,62,21,89,36,52,1,93,62,31,4,4,69,37,32
"2021","Swale 008A","E01024570",702,127,80,47,524,105,264,97,110,57,79,34,34,11,74,42,32,2,2,51,28,23
"2021","Swale 008B","E01024571",831,214,89,125,565,91,264,98,111,55,140,78,49,13,66,46,20,4,4,52,23,29
"2021","Swale 008C","E01024572",529,124,76,48,374,56,234,84,113,37,59,31,24,4,25,16,9,0,0,31,13,18
"2021","Swale 008D","E01024573",534,122,84,38,385,83,181,54,78,49,66,32,28,6,50,21,29,5,5,27,16,11
"2021","Swale 008E","E01024575",504,108,65,43,380,73,205,96,72,37,65,31,28,6,37,21,16,0,0,16,11,5
"2021","Swale 009A","E01024554",993,186,92,94,753,161,396,154,154,88,129,62,53,14,64,32,32,3,3,54,24,30
"2021","Swale 009B","E01024561",736,185,46,139,492,38,211,57,115,39,146,91,52,3,93,70,23,4,4,59,36,23
"2021","Swale 009E","E01024582",634,156,74,82,430,71,210,82,85,43,83,38,35,10,64,28,36,2,2,48,25,23
"2021","Swale 009F","E01035304",645,87,36,51,514,54,331,92,170,69,80,45,28,7,47,32,15,2,2,44,23,21
"2021","Swale 009G","E01035305",639,162,36,126,418,9,167,38,111,18,137,68,62,7,102,75,27,3,3,59,36,23
"2021","Swale 009H","E01035306",661,149,72,77,475,49,246,68,146,32,90,36,48,6,89,59,30,1,1,37,22,15
"2021","Swale 009I","E01035307",581,164,95,69,380,54,145,52,62,31,87,38,41,8,89,66,23,5,5,37,17,20
"2021","Swale 010A","E01024559",675,289,134,155,341,37,121,39,58,24,101,48,46,7,74,44,30,8,8,45,20,25
"2021","Swale 010B","E01024584",737,248,133,115,436,38,173,64,70,39,119,41,63,15,100,55,45,6,6,53,30,23
"2021","Swale 010C","E01024590",613,235,68,167,318,21,125,35,64,26,73,23,43,7,95,74,21,4,4,60,36,24
"2021","Swale 010D","E01024599",878,281,110,171,541,51,191,64,95,32,151,63,76,12,140,97,43,8,8,56,25,31
"2021","Swale 010E","E01024608",901,349,165,184,472,48,207,59,88,60,123,64,50,9,84,57,27,10,10,80,38,42
"2021","Swale 011A","E01024591",1008,236,62,174,692,47,330,86,206,38,182,71,103,8,123,95,28,10,10,80,44,36
"2021","Swale 011B","E01024592",523,129,66,63,356,59,176,71,70,35,87,39,45,3,32,17,15,2,2,38,17,21
"2021","Swale 011C","E01024593",513,101,46,55,369,38,159,57,75,27,90,34,47,9,81,49,32,1,1,43,31,12
"2021","Swale 011D","E01024600",602,187,105,82,366,37,168,63,71,34,78,40,30,8,80,38,42,3,3,49,30,19
"2021","Swale 011E","E01024601",736,230,133,97,443,82,199,85,77,37,90,49,28,13,71,35,36,1,1,63,33,30
"2021","Swale 012A","E01024560",521,116,53,63,362,31,162,42,83,37,67,28,36,3,94,64,30,8,8,43,23,20
"2021","Swale 012B","E01024562",664,162,60,102,463,62,227,64,118,45,98,40,50,8,70,46,24,6,6,39,18,21
"2021","Swale 012C","E01024569",722,184,116,68,508,93,261,84,119,58,83,37,42,4,69,40,29,2,2,30,12,18
"2021","Swale 012D","E01024630",753,225,156,69,501,146,189,78,73,38,91,38,46,7,70,33,37,5,5,27,11,16
"2021","Swale 012E","E01024632",641,161,128,33,458,141,228,75,94,59,57,32,19,6,28,13,15,4,4,22,13,9
"2021","Swale 013A","E01024606",543,143,66,77,369,72,184,51,82,51,64,30,27,7,49,37,12,0,0,31,19,12
"2021","Swale 013C","E01024628",614,138,91,47,435,88,239,96,92,51,76,32,36,8,31,15,16,1,1,41,21,20
"2021","Swale 013D","E01024629",458,88,58,30,353,73,198,77,76,45,65,29,30,6,17,8,9,0,0,17,8,9
"2021","Swale 013E","E01024631",648,118,100,18,500,154,280,105,119,56,37,16,16,5,29,13,16,0,0,30,12,18
"2021","Swale 013F","E01032735",617,110,61,49,479,100,258,57,137,64,60,24,30,6,59,31,28,2,2,28,14,14
"2021","Swale 013G","E01032737",613,156,72,84,423,60,238,74,124,40,65,25,37,3,60,37,23,0,0,34,20,14
"2021","Swale 014A","E01024564",539,142,93,49,369,109,158,58,72,28,63,37,22,4,39,26,13,0,0,28,13,15
"2021","Swale 014B","E01024603",518,113,60,53,376,60,195,72,82,41,71,41,26,4,49,31,18,1,1,29,8,21
"2021","Swale 014C","E01024604",488,134,42,92,327,23,138,58,55,25,84,32,46,6,82,51,31,0,0,27,18,9
"2021","Swale 014D","E01024605",582,166,113,53,395,92,208,88,72,48,53,24,24,5,42,22,20,0,0,21,7,14
"2021","Swale 014E","E01024626",794,159,81,78,603,84,312,94,173,45,113,62,46,5,91,70,21,3,3,32,14,18
"2021","Swale 014F","E01024627",818,239,119,120,522,77,198,72,87,39,114,49,53,12,127,77,50,6,6,57,30,27
"2021","Swale 015A","E01024551",1002,334,143,191,620,63,250,94,123,33,151,75,68,8,151,89,62,5,5,48,15,33
"2021","Swale 015B","E01024552",902,228,113,115,611,48,273,84,131,58,152,73,70,9,136,88,48,2,2,63,34,29
"2021","Swale 015C","E01024553",1044,466,251,215,531,133,192,91,76,25,124,88,33,3,76,40,36,6,6,47,13,34
"2021","Swale 015D","E01024563",647,179,96,83,427,46,147,46,71,30,96,36,45,15,132,75,57,6,6,41,24,17
"2021","Swale 015E","E01024602",681,256,155,101,397,66,174,78,70,26,95,54,39,2,60,29,31,2,2,28,6,22
"2021","Swale 015F","E01024625",822,202,115,87,575,140,279,120,117,42,103,54,43,6,51,28,23,2,2,45,22,23
"2021","Swale 016A","E01024565",539,129,74,55,378,80,201,89,65,47,61,41,13,7,36,23,13,0,0,32,20,12
"2021","Swale 016B","E01024566",626,150,90,60,433,89,243,104,81,58,50,29,16,5,50,29,21,1,1,43,19,24
"2021","Swale 016C","E01024622",735,199,115,84,482,74,230,107,75,48,101,47,41,13,73,34,39,4,4,54,24,30
"2021","Swale 016D","E01024623",850,227,135,92,551,84,242,76,119,47,108,42,58,8,111,61,50,6,6,72,31,41
"2021","Swale 016E","E01024624",1121,220,96,124,819,98,352,123,169,60,242,125,104,13,121,84,37,6,6,82,36,46
"2021","Swale 017A","E01024555",555,126,87,39,403,84,215,85,87,43,56,28,18,10,44,23,21,4,4,26,9,17
"2021","Swale 017B","E01024556",513,138,89,49,341,72,172,78,70,24,64,32,22,10,32,17,15,1,1,34,11,23
"2021","Swale 017C","E01024557",641,185,97,88,415,59,189,69,84,36,83,46,27,10,83,46,37,1,1,41,19,22
"2021","Swale 017D","E01024558",706,154,91,63,515,108,273,105,111,57,89,39,36,14,42,15,27,3,3,37,15,22
"2021","Thanet 001A","E01024657",1134,485,94,391,570,7,166,61,84,21,189,86,94,9,198,165,33,10,10,79,30,49
"2021","Thanet 001B","E01024658",1132,507,180,327,552,55,163,67,76,20,139,68,67,4,189,144,45,6,6,73,24,49
"2021","Thanet 001C","E01024659",712,277,108,169,368,41,144,42,82,20,79,35,40,4,100,68,32,4,4,67,35,32
"2021","Thanet 001D","E01024660",774,306,102,204,393,31,117,39,58,20,116,52,61,3,119,102,17,10,10,75,29,46
"2021","Thanet 001F","E01035316",615,324,121,203,248,14,68,31,33,4,80,54,25,1,77,56,21,9,9,43,5,38
"2021","Thanet 001G","E01035317",593,276,51,225,275,3,87,34,43,10,89,53,33,3,90,75,15,6,6,42,11,31
"2021","Thanet 002A","E01024653",728,211,141,70,483,118,229,82,111,36,91,50,34,7,42,21,21,3,3,34,18,16
"2021","Thanet 002B","E01024654",755,252,186,66,473,146,186,78,72,36,83,44,36,3,56,27,29,2,2,30,11,19
"2021","Thanet 002C","E01024655",661,175,128,47,447,144,204,92,78,34,58,27,25,6,39,16,23,2,2,39,16,23
"2021","Thanet 002D","E01024656",804,280,162,118,481,136,210,99,69,42,72,48,23,1,61,33,28,2,2,43,17,26
"2021","Thanet 002E","E01024675",895,218,138,80,625,178,307,127,101,79,90,51,34,5,46,29,17,4,4,52,19,33
"2021","Thanet 003A","E01024676",1022,467,94,373,493,18,154,65,72,17,151,81,67,3,155,115,40,15,15,62,26,36
"2021","Thanet 003B","E01024677",723,181,51,130,483,25,173,75,65,33,135,55,73,7,144,96,48,6,6,59,26,33
"2021","Thanet 003C","E01024695",502,127,49,78,335,25,157,47,77,33,87,44,37,6,61,34,27,5,5,40,21,19
"2021","Thanet 003D","E01024697",500,153,64,89,307,21,125,44,63,18,65,19,32,14,94,56,38,2,2,40,17,23
"2021","Thanet 003E","E01024710",788,372,78,294,363,24,129,62,49,18,124,88,33,3,76,52,24,10,10,53,16,37
"2021","Thanet 004A","E01024661",670,223,62,161,392,13,135,57,57,21,119,51,58,10,122,92,30,3,3,55,20,35
"2021","Thanet 004B","E01024664",631,164,62,102,414,41,175,64,80,31,87,28,49,10,110,65,45,1,1,53,28,25
"2021","Thanet 004C","E01024665",614,146,57,89,418,47,187,72,81,34,94,41,48,5,84,60,24,6,6,50,18,32
"2021","Thanet 004D","E01024694",654,204,113,91,391,59,181,54,91,36,85,34,42,9,64,35,29,2,2,59,25,34
"2021","Thanet 004E","E01024696",629,170,88,82,411,78,174,67,81,26,78,31,42,5,77,43,34,4,4,48,19,29
"2021","Thanet 005A","E01024672",630,208,113,95,386,49,165,43,68,54,76,33,36,7,93,51,42,3,3,36,15,21
"2021","Thanet 005B","E01024673",818,261,139,122,510,84,230,77,90,63,108,50,49,9,86,49,37,2,2,47,21,26
"2021","Thanet 005C","E01024674",608,111,68,43,438,75,225,70,106,49,75,35,33,7,61,25,36,2,2,59,31,28
"2021","Thanet 005D","E01024711",571,147,77,70,375,76,201,70,83,48,59,25,31,3,37,21,16,2,2,49,22,27
"2021","Thanet 005E","E01024712",642,168,113,55,419,94,216,75,97,44,69,31,31,7,40,18,22,0,0,55,24,31
"2021","Thanet 006A","E01024633",650,190,103,87,427,36,189,61,94,34,82,31,40,11,117,75,42,3,3,33,15,18
"2021","Thanet 006B","E01024634",535,144,87,57,346,42,163,52,77,34,64,21,29,14,73,45,28,4,4,45,25,20
"2021","Thanet 006C","E01024662",640,169,113,56,446,98,177,68,77,32,76,31,34,11,92,49,43,3,3,25,8,17
"2021","Thanet 006D","E01024663",587,143,51,92,401,15,143,37,73,33,84,19,56,9,156,111,45,3,3,43,23,20
"2021","Thanet 006E","E01024666",691,233,110,123,414,44,153,55,67,31,89,23,60,6,123,77,46,5,5,44,23,21
"2021","Thanet 007A","E01024641",732,272,158,114,439,105,184,73,77,34,66,27,33,6,84,47,37,0,0,21,9,12
"2021","Thanet 007B","E01024713",743,197,103,94,502,74,192,60,96,36,116,40,68,8,115,70,45,5,5,44,21,23
"2021","Thanet 007C","E01024714",823,348,193,155,435,116,173,86,55,32,80,55,21,4,64,35,29,2,2,40,16,24
"2021","Thanet 007D","E01024715",1006,512,195,317,461,92,153,77,56,20,120,85,28,7,92,59,33,4,4,33,13,20
"2021","Thanet 007E","E01024716",873,235,132,103,582,95,255,91,109,55,135,61,60,14,94,56,38,3,3,56,26,30
"2021","Thanet 008A","E01024636",1094,420,281,139,634,234,258,144,75,39,82,53,29,0,58,22,36,2,2,40,14,26
"2021","Thanet 008B","E01024637",773,219,175,44,519,189,237,118,68,51,52,23,25,4,40,17,23,1,1,35,17,18
"2021","Thanet 008C","E01024638",810,282,203,79,477,163,179,83,63,33,71,46,21,4,63,33,30,1,1,51,26,25
"2021","Thanet 008D","E01024639",832,310,196,114,486,130,199,110,62,27,67,41,19,7,90,46,44,0,0,36,16,20
"2021","Thanet 008E","E01024640",778,268,200,68,474,169,184,74,74,36,59,32,24,3,60,34,26,2,2,36,15,21
"2021","Thanet 009A","E01024635",700,173,109,64,499,135,242,84,123,35,64,25,36,3,54,38,16,4,4,28,11,17
"2021","Thanet 009B","E01024642",689,236,166,70,431,145,188,97,56,35,51,23,23,5,47,19,28,0,0,22,8,14
"2021","Thanet 009C","E01024644",600,178,131,47,389,128,196,91,70,35,31,15,14,2,33,19,14,1,1,33,18,15
"2021","Thanet 009D","E01024692",837,325,216,109,471,102,179,80,71,28,88,33,49,6,99,60,39,3,3,41,20,21
"2021","Thanet 009E","E01024693",615,194,124,70,392,79,197,70,85,42,50,22,25,3,62,30,32,4,4,29,12,17
"2021","Thanet 010A","E01024643",587,241,101,140,316,59,131,55,54,22,59,36,20,3,63,41,22,4,4,30,10,20
"2021","Thanet 010B","E01024705",552,274,115,159,255,57,99,50,33,16,64,39,21,4,32,19,13,3,3,23,9,14
"2021","Thanet 010C","E01024706",649,241,126,115,379,81,184,64,92,28,59,31,22,6,53,34,19,2,2,29,13,16
"2021","Thanet 010D","E01024707",598,173,89,84,393,82,190,55,90,45,66,35,26,5,54,37,17,1,1,32,11,21
"2021","Thanet 010E","E01024708",846,211,144,67,594,177,300,144,102,54,63,29,26,8,51,25,26,3,3,41,15,26
"2021","Thanet 011A","E01024686",731,233,140,93,454,90,188,77,64,47,89,44,42,3,84,44,40,3,3,44,23,21
"2021","Thanet 011B","E01024688",771,245,139,106,482,102,195,76,70,49,90,44,38,8,92,51,41,3,3,44,17,27
"2021","Thanet 011C","E01024689",539,154,103,51,357,108,163,69,70,24,43,20,19,4,41,19,22,2,2,28,14,14
"2021","Thanet 011D","E01024690",660,216,157,59,412,128,186,77,72,37,38,16,15,7,56,27,29,4,4,32,10,22
"2021","Thanet 011E","E01024691",485,100,56,44,361,54,196,63,94,39,52,20,28,4,59,30,29,0,0,24,11,13
"2021","Thanet 012A","E01024669",746,223,77,146,462,31,160,73,68,19,121,62,53,6,145,102,43,5,5,61,26,35
"2021","Thanet 012B","E01024698",635,216,97,119,371,47,159,57,72,30,82,42,33,7,78,45,33,5,5,48,18,30
"2021","Thanet 012C","E01024699",762,203,96,107,508,59,185,65,87,33,98,39,48,11,164,103,61,2,2,51,27,24
"2021","Thanet 012D","E01024700",731,186,95,91,498,59,249,89,112,48,92,44,35,13,95,64,31,3,3,47,17,30
"2021","Thanet 012E","E01024709",631,179,131,48,421,144,181,77,67,37,42,18,20,4,52,26,26,2,2,31,14,17
"2021","Thanet 013A","E01024682",836,216,65,151,559,26,215,44,122,49,122,37,77,8,191,135,56,5,5,61,33,28
"2021","Thanet 013B","E01024683",660,189,76,113,422,39,155,50,65,40,96,30,56,10,129,74,55,3,3,49,28,21
"2021","Thanet 013C","E01024684",695,192,100,92,445,51,184,66,75,43,103,30,65,8,99,60,39,8,8,58,28,30
"2021","Thanet 013D","E01024685",729,185,113,72,482,91,197,84,70,43,86,40,42,4,105,68,37,3,3,62,39,23
"2021","Thanet 013E","E01024687",615,230,84,146,348,24,140,46,62,32,65,23,30,12,116,66,50,3,3,37,22,15
"2021","Thanet 014B","E01024702",620,208,145,63,379,98,176,83,60,33,51,28,21,2,54,35,19,0,0,33,14,19
"2021","Thanet 014C","E01024703",800,232,136,96,528,113,283,130,106,47,81,43,30,8,50,29,21,1,1,40,15,25
"2021","Thanet 014D","E01024704",781,208,126,82,542,104,258,107,103,48,105,59,40,6,74,44,30,1,1,31,12,19
"2021","Thanet 014E","E01035318",677,187,64,123,445,75,205,111,73,21,93,57,31,5,68,44,24,4,4,45,15,30
"2021","Thanet 014F","E01035319",593,112,54,58,440,60,219,87,93,39,95,48,42,5,65,41,24,1,1,41,15,26
"2021","Thanet 015A","E01024645",649,180,76,104,431,47,199,55,103,41,97,45,42,10,84,42,42,4,4,38,16,22
"2021","Thanet 015B","E01024647",651,199,64,135,380,38,175,57,85,33,77,42,28,7,82,57,25,8,8,72,30,42
"2021","Thanet 015C","E01024668",496,124,54,70,342,31,152,47,75,30,79,29,45,5,79,54,25,1,1,30,16,14
"2021","Thanet 015D","E01024670",752,270,90,180,430,30,172,70,75,27,97,35,57,5,126,96,30,5,5,52,18,34
"2021","Thanet 015E","E01024681",769,195,63,132,522,43,222,67,112,43,123,51,66,6,130,89,41,4,4,52,23,29
"2021","Thanet 016A","E01024646",1018,478,186,292,481,50,163,73,62,28,135,78,50,7,122,83,39,11,11,59,19,40
"2021","Thanet 016B","E01024648",767,363,131,232,355,57,131,63,53,15,88,50,35,3,74,54,20,5,5,49,22,27
"2021","Thanet 016C","E01024649",969,454,151,303,451,52,135,74,43,18,133,80,49,4,121,90,31,10,10,64,18,46
"2021","Thanet 016D","E01024667",988,522,187,335,415,19,129,59,50,20,95,49,44,2,166,127,39,6,6,51,13,38
"2021","Thanet 016E","E01024671",908,491,216,275,373,48,111,55,38,18,101,56,42,3,107,77,30,6,6,44,18,26
"2021","Thanet 017A","E01024650",656,182,129,53,445,110,232,103,92,37,65,29,31,5,35,17,18,3,3,29,9,20
"2021","Thanet 017B","E01024651",722,302,188,114,393,91,173,76,61,36,65,29,32,4,62,30,32,2,2,27,10,17
"2021","Thanet 017C","E01024652",811,183,120,63,576,134,297,130,98,69,81,40,36,5,64,38,26,0,0,52,22,30
"2021","Thanet 017D","E01024679",610,200,159,41,384,129,162,79,54,29,52,23,22,7,40,12,28,1,1,26,8,18
"2021","Thanet 017E","E01024680",708,189,102,87,476,94,227,81,98,48,82,37,36,9,72,43,29,1,1,43,21,22
"2021","Tonbridge and Malling 001A","E01024719",937,248,97,151,628,53,328,110,152,66,127,69,45,13,114,72,42,6,6,61,11,50
"2021","Tonbridge and Malling 001B","E01024720",541,111,75,36,411,89,235,86,99,50,51,27,21,3,33,9,24,3,3,19,7,12
"2021","Tonbridge and Malling 001C","E01024721",528,115,67,48,384,70,217,83,94,40,56,26,25,5,40,17,23,1,1,29,18,11
"2021","Tonbridge and Malling 001D","E01024722",551,126,60,66,405,59,212,67,101,44,76,36,30,10,57,35,22,1,1,20,11,9
"2021","Tonbridge and Malling 001F","E01024728",731,179,92,87,520,86,256,88,110,58,110,62,43,5,66,40,26,2,2,32,14,18
"2021","Tonbridge and Malling 001G","E01035002",546,134,52,82,394,35,199,57,98,44,93,48,39,6,65,49,16,2,2,18,14,4
"2021","Tonbridge and Malling 001H","E01035003",544,101,12,89,424,8,161,53,100,8,169,102,63,4,83,72,11,3,3,19,11,8
"2021","Tonbridge and Malling 001I","E01035004",564,156,54,102,380,46,182,76,75,31,100,65,29,6,49,30,19,3,3,28,12,16
"2021","Tonbridge and Malling 002C","E01024771",795,240,79,161,518,35,217,80,104,33,144,54,81,9,122,73,49,0,0,37,12,25
"2021","Tonbridge and Malling 002D","E01024772",673,158,75,83,467,78,237,81,110,46,82,39,36,7,65,38,27,5,5,48,29,19
"2021","Tonbridge and Malling 002E","E01024773",738,190,117,73,520,116,259,97,102,60,89,46,37,6,55,25,30,1,1,28,11,17
"2021","Tonbridge and Malling 002G","E01032830",1013,312,121,191,651,59,299,108,132,59,138,66,57,15,149,87,62,6,6,50,28,22
"2021","Tonbridge and Malling 002H","E01035005",575,205,78,127,346,55,159,67,66,26,77,36,38,3,53,34,19,2,2,24,9,15
"2021","Tonbridge and Malling 002I","E01035006",574,185,55,130,374,17,165,64,81,20,102,48,49,5,85,69,16,5,5,15,6,9
"2021","Tonbridge and Malling 002J","E01035007",574,135,33,102,413,13,210,73,116,21,116,52,61,3,71,59,12,3,3,26,10,16
"2021","Tonbridge and Malling 003A","E01024741",573,131,70,61,411,42,167,48,83,36,81,20,56,5,121,84,37,0,0,31,14,17
"2021","Tonbridge and Malling 003B","E01024761",895,234,133,101,618,121,320,104,150,66,102,50,45,7,73,34,39,2,2,43,17,26
"2021","Tonbridge and Malling 003C","E01024762",901,203,99,104,653,72,348,120,177,51,133,73,53,7,93,43,50,7,7,45,22,23
"2021","Tonbridge and Malling 003D","E01024763",517,94,59,35,398,65,195,59,87,49,67,33,27,7,71,38,33,0,0,25,10,15
"2021","Tonbridge and Malling 003E","E01024764",604,216,136,80,359,70,173,62,71,40,60,29,28,3,55,35,20,1,1,29,9,20
"2021","Tonbridge and Malling 003F","E01024765",538,118,66,52,396,84,213,74,96,43,65,24,36,5,31,17,14,3,3,24,9,15
"2021","Tonbridge and Malling 003G","E01024782",479,92,35,57,366,51,223,74,101,48,56,31,20,5,36,18,18,0,0,21,7,14
"2021","Tonbridge and Malling 003H","E01024785",643,161,94,67,472,63,250,81,118,51,100,55,39,6,58,35,23,1,1,10,5,5
"2021","Tonbridge and Malling 005A","E01024717",979,311,187,124,632,100,286,103,134,49,96,42,48,6,145,108,37,5,5,36,19,17
"2021","Tonbridge and Malling 005B","E01024718",523,86,64,22,410,108,227,85,95,47,42,15,24,3,31,15,16,2,2,27,12,15
"2021","Tonbridge and Malling 005C","E01024735",602,115,77,38,444,107,214,64,104,46,77,46,25,6,45,19,26,1,1,43,20,23
"2021","Tonbridge and Malling 005D","E01024736",740,184,99,85,521,86,234,78,118,38,103,41,53,9,97,64,33,1,1,35,9,26
"2021","Tonbridge and Malling 005E","E01024737",961,194,73,121,721,97,312,98,156,58,156,61,90,5,154,116,38,2,2,46,25,21
"2021","Tonbridge and Malling 006A","E01024723",660,171,102,69,461,91,284,88,146,50,45,23,20,2,38,19,19,3,3,28,10,18
"2021","Tonbridge and Malling 006B","E01024724",804,148,98,50,616,122,361,118,187,56,73,36,31,6,57,25,32,3,3,40,15,25
"2021","Tonbridge and Malling 006C","E01024725",846,207,103,104,602,86,299,79,162,58,127,69,51,7,86,59,27,4,4,37,19,18
"2021","Tonbridge and Malling 006D","E01024726",780,206,134,72,535,75,235,70,113,52,115,54,53,8,101,57,44,9,9,39,17,22
"2021","Tonbridge and Malling 006E","E01024755",766,131,72,59,608,132,391,117,209,65,45,16,27,2,38,21,17,2,2,27,13,14
"2021","Tonbridge and Malling 006F","E01024786",776,176,94,82,547,103,274,101,123,50,79,35,34,10,89,58,31,2,2,53,21,32
"2021","Tonbridge and Malling 007A","E01024746",442,102,41,61,311,60,176,69,70,37,45,22,18,5,28,11,17,2,2,29,15,14
"2021","Tonbridge and Malling 007C","E01024760",543,81,40,41,447,63,277,78,156,43,46,14,24,8,61,39,22,0,0,15,8,7
"2021","Tonbridge and Malling 007D","E01024781",831,218,120,98,589,107,327,108,163,56,69,44,21,4,83,41,42,3,3,24,8,16
"2021","Tonbridge and Malling 007E","E01032825",1059,204,47,157,805,65,472,81,348,43,155,65,78,12,112,88,24,1,1,50,26,24
"2021","Tonbridge and Malling 007F","E01032826",649,137,43,94,484,62,281,63,182,36,67,31,33,3,69,53,16,5,5,28,16,12
"2021","Tonbridge and Malling 007G","E01032827",723,95,39,56,602,58,384,67,278,39,75,30,40,5,84,67,17,1,1,26,13,13
"2021","Tonbridge and Malling 007H","E01032828",425,68,36,32,339,54,205,50,121,34,45,19,25,1,34,27,7,1,1,18,9,9
"2021","Tonbridge and Malling 008A","E01024743",766,189,112,77,528,99,255,90,113,52,76,27,39,10,94,47,47,4,4,49,20,29
"2021","Tonbridge and Malling 008B","E01024744",811,186,113,73,586,140,327,122,143,62,72,35,34,3,42,22,20,5,5,39,9,30
"2021","Tonbridge and Malling 008C","E01024745",712,184,105,79,490,116,267,87,113,67,61,36,20,5,45,18,27,1,1,38,19,19
"2021","Tonbridge and Malling 008D","E01024747",652,198,108,90,419,64,184,70,68,46,64,28,32,4,100,59,41,7,7,35,17,18
"2021","Tonbridge and Malling 009A","E01024730",579,161,124,37,388,96,208,63,92,53,41,16,22,3,42,18,24,1,1,30,12,18
"2021","Tonbridge and Malling 009B","E01024731",484,135,101,34,334,89,187,54,92,41,39,27,8,4,19,7,12,0,0,15,3,12
"2021","Tonbridge and Malling 009C","E01024775",660,186,90,96,441,53,159,38,86,35,80,23,45,12,145,99,46,4,4,33,16,17
"2021","Tonbridge and Malling 009D","E01024776",524,120,77,43,375,67,161,41,82,38,54,24,26,4,92,60,32,1,1,29,16,13
"2021","Tonbridge and Malling 009E","E01024777",495,168,88,80,298,58,147,43,71,33,36,17,16,3,55,28,27,2,2,29,17,12
"2021","Tonbridge and Malling 010A","E01024734",678,187,127,60,471,105,247,77,112,58,67,38,26,3,47,22,25,5,5,20,14,6
"2021","Tonbridge and Malling 010B","E01024752",641,138,99,39,462,98,285,70,178,37,45,18,23,4,32,15,17,2,2,41,18,23
"2021","Tonbridge and Malling 010C","E01024753",606,132,72,60,445,84,271,67,153,51,52,21,26,5,38,20,18,0,0,29,11,18
"2021","Tonbridge and Malling 010D","E01024754",665,130,64,66,495,95,304,99,165,40,52,27,19,6,44,22,22,0,0,40,13,27
"2021","Tonbridge and Malling 011A","E01024729",707,209,134,75,470,85,233,63,122,48,69,27,39,3,80,56,24,3,3,28,14,14
"2021","Tonbridge and Malling 011B","E01024748",532,106,80,26,400,103,241,73,110,58,29,15,10,4,27,14,13,0,0,26,16,10
"2021","Tonbridge and Malling 011C","E01024749",614,133,76,57,453,56,217,50,131,36,79,30,39,10,99,58,41,2,2,28,14,14
"2021","Tonbridge and Malling 011D","E01024750",635,176,129,47,434,97,218,49,114,55,57,28,25,4,62,28,34,0,0,25,14,11
"2021","Tonbridge and Malling 011E","E01024751",644,172,133,39,455,153,233,65,131,37,34,15,13,6,35,15,20,0,0,17,7,10
"2021","Tonbridge and Malling 012A","E01024732",795,310,99,211,445,35,220,70,126,24,105,74,28,3,81,54,27,4,4,40,7,33
"2021","Tonbridge and Malling 012B","E01024733",740,210,114,96,497,84,295,73,171,51,70,49,18,3,45,28,17,3,3,33,9,24
"2021","Tonbridge and Malling 012C","E01024756",638,174,81,93,434,34,218,61,115,42,90,47,39,4,85,58,27,7,7,30,8,22
"2021","Tonbridge and Malling 012E","E01024767",775,174,94,80,560,52,269,66,140,63,109,49,48,12,124,86,38,6,6,41,19,22
"2021","Tonbridge and Malling 012F","E01024768",870,361,169,192,474,71,253,64,151,38,87,68,17,2,60,32,28,3,3,35,13,22
"2021","Tonbridge and Malling 012G","E01035008",802,367,101,266,405,27,135,51,78,6,145,102,42,1,94,76,18,4,4,30,10,20
"2021","Tonbridge and Malling 012H","E01035009",752,231,56,175,486,31,253,94,116,43,124,82,34,8,69,39,30,9,9,35,14,21
"2021","Tonbridge and Malling 013A","E01024757",693,208,89,119,451,39,264,68,164,32,80,46,29,5,62,30,32,6,6,34,7,27
"2021","Tonbridge and Malling 013B","E01024758",673,161,61,100,490,56,283,78,154,51,81,42,33,6,67,40,27,3,3,22,9,13
"2021","Tonbridge and Malling 013C","E01024778",757,189,56,133,531,34,305,90,176,39,121,76,40,5,66,42,24,5,5,37,12,25
"2021","Tonbridge and Malling 013D","E01024779",782,263,120,143,478,41,268,76,155,37,94,58,31,5,63,35,28,12,12,41,10,31
"2021","Tonbridge and Malling 013E","E01024780",599,113,48,65,457,42,241,72,122,47,77,37,34,6,97,52,45,0,0,29,12,17
"2021","Tonbridge and Malling 014A","E01024740",844,212,109,103,586,119,312,128,130,54,92,58,32,2,60,30,30,3,3,46,20,26
"2021","Tonbridge and Malling 014B","E01024742",728,176,75,101,507,55,223,67,111,45,113,49,52,12,113,74,39,3,3,45,24,21
"2021","Tonbridge and Malling 014C","E01024783",711,267,145,122,404,84,170,64,71,35,76,48,22,6,71,38,33,3,3,40,15,25
"2021","Tonbridge and Malling 014E","E01032620",962,223,145,78,689,159,383,146,160,77,86,49,30,7,56,19,37,5,5,50,19,31
"2021","Tonbridge and Malling 014F","E01032829",672,131,65,66,501,96,291,96,151,44,77,39,35,3,37,25,12,0,0,40,16,24
"2021","Tonbridge and Malling 014G","E01035010",602,153,18,135,435,4,204,62,126,16,143,73,68,2,82,71,11,2,2,14,3,11
"2021","Tonbridge and Malling 014H","E01035011",640,173,114,59,442,90,238,87,117,34,73,44,28,1,40,28,12,1,1,25,10,15
"2021","Tunbridge Wells 001A","E01024798",914,190,96,94,681,124,378,129,176,73,96,50,36,10,80,46,34,3,3,43,19,24
"2021","Tunbridge Wells 001B","E01024811",483,99,71,28,358,96,199,71,79,49,35,5,27,3,26,14,12,2,2,26,14,12
"2021","Tunbridge Wells 001C","E01024812",564,144,80,64,386,66,206,57,99,50,67,36,22,9,46,26,20,1,1,34,12,22
"2021","Tunbridge Wells 001D","E01024813",802,325,130,195,459,62,178,66,79,33,123,74,47,2,94,66,28,2,2,18,4,14
"2021","Tunbridge Wells 001E","E01024814",517,124,74,50,369,79,197,52,96,49,54,28,23,3,37,17,20,2,2,24,9,15
"2021","Tunbridge Wells 001F","E01024815",487,119,73,46,340,52,172,62,74,36,51,25,22,4,61,35,26,4,4,28,11,17
"2021","Tunbridge Wells 001G","E01024816",573,106,54,52,441,61,230,70,114,46,75,37,33,5,67,43,24,8,8,26,14,12
"2021","Tunbridge Wells 002A","E01024837",647,85,45,40,541,68,344,69,207,68,60,19,26,15,69,37,32,0,0,21,10,11
"2021","Tunbridge Wells 002B","E01024844",654,183,53,130,450,28,213,73,109,31,103,45,53,5,98,64,34,8,8,21,10,11
"2021","Tunbridge Wells 002C","E01024846",657,160,66,94,477,50,245,67,133,45,85,41,37,7,94,56,38,3,3,20,9,11
"2021","Tunbridge Wells 002D","E01024849",681,202,87,115,455,54,252,59,148,45,71,48,20,3,75,45,30,3,3,24,12,12
"2021","Tunbridge Wells 002E","E01024850",488,75,57,18,388,99,226,53,127,46,35,15,17,3,27,11,16,1,1,25,10,15
"2021","Tunbridge Wells 003A","E01024836",692,206,63,143,443,35,210,55,122,33,108,47,54,7,84,59,25,6,6,43,20,23
"2021","Tunbridge Wells 003B","E01024839",1197,321,94,227,842,71,485,142,283,60,188,114,69,5,95,56,39,3,3,34,13,21
"2021","Tunbridge Wells 003C","E01024845",529,117,62,55,387,66,215,54,129,32,54,25,24,5,47,33,14,5,5,25,7,18
"2021","Tunbridge Wells 003D","E01024847",679,181,69,112,473,41,209,70,113,26,119,81,33,5,97,59,38,7,7,25,10,15
"2021","Tunbridge Wells 003E","E01024848",646,281,148,133,346,62,172,45,102,25,57,35,22,0,51,34,17,4,4,19,5,14
"2021","Tunbridge Wells 004A","E01024793",721,173,93,80,505,103,280,93,115,72,68,43,21,4,52,27,25,2,2,43,18,25
"2021","Tunbridge Wells 004B","E01024825",485,106,66,40,361,95,200,61,98,41,38,17,17,4,27,14,13,1,1,18,7,11
"2021","Tunbridge Wells 004C","E01024826",622,205,128,77,394,92,214,72,106,36,51,21,25,5,37,16,21,0,0,23,7,16
"2021","Tunbridge Wells 004D","E01024827",602,148,95,53,421,72,236,50,130,56,53,25,24,4,57,28,29,3,3,33,15,18
"2021","Tunbridge Wells 004E","E01024828",660,202,93,109,420,58,212,63,103,46,73,37,33,3,71,37,34,6,6,38,9,29
"2021","Tunbridge Wells 005A","E01024840",656,159,47,112,431,27,201,44,116,41,97,37,52,8,104,66,38,2,2,66,34,32
"2021","Tunbridge Wells 005B","E01024841",852,307,121,186,502,50,242,66,146,30,103,54,44,5,99,67,32,8,8,43,22,21
"2021","Tunbridge Wells 005C","E01024842",715,224,108,116,465,79,216,67,112,37,69,35,31,3,96,51,45,5,5,26,13,13
"2021","Tunbridge Wells 005D","E01024843",581,163,56,107,392,18,205,69,106,30,75,35,36,4,89,52,37,5,5,26,12,14
"2021","Tunbridge Wells 006A","E01024829",664,180,86,94,470,69,261,72,147,42,70,29,35,6,69,44,25,1,1,14,7,7
"2021","Tunbridge Wells 006B","E01024851",654,157,87,70,463,108,255,78,142,35,50,26,22,2,50,32,18,0,0,34,15,19
"2021","Tunbridge Wells 006C","E01024852",501,77,69,8,408,111,253,69,145,39,22,9,12,1,21,15,6,1,1,16,6,10
"2021","Tunbridge Wells 006D","E01024853",535,129,83,46,391,91,230,55,124,51,32,17,11,4,36,20,16,2,2,15,7,8
"2021","Tunbridge Wells 006E","E01024854",591,102,68,34,468,88,311,72,184,55,34,17,13,4,35,18,17,0,0,21,8,13
"2021","Tunbridge Wells 007A","E01024799",1040,464,242,222,540,83,277,100,146,31,102,80,20,2,73,45,28,5,5,36,7,29
"2021","Tunbridge Wells 007B","E01024800",644,150,89,61,473,96,315,96,172,47,34,21,12,1,27,17,10,1,1,21,12,9
"2021","Tunbridge Wells 007C","E01024835",805,211,58,153,564,27,348,97,228,23,112,65,44,3,74,51,23,3,3,30,14,16
"2021","Tunbridge Wells 007D","E01024838",705,191,80,111,473,45,268,61,178,29,96,59,32,5,59,37,22,5,5,41,8,33
"2021","Tunbridge Wells 008B","E01024802",953,445,93,352,459,26,227,85,116,26,135,110,23,2,58,39,19,13,13,49,9,40
"2021","Tunbridge Wells 008C","E01024823",914,358,93,265,510,59,251,84,139,28,122,103,15,4,68,46,22,10,10,46,9,37
"2021","Tunbridge Wells 008D","E01024833",1244,537,159,378,616,17,269,81,163,25,180,112,64,4,134,94,40,16,16,91,27,64
"2021","Tunbridge Wells 008E","E01035012",594,246,43,203,317,23,155,53,91,11,83,63,17,3,48,39,9,8,8,31,4,27
"2021","Tunbridge Wells 008F","E01035013",930,465,104,361,423,49,164,71,79,14,164,146,18,0,42,29,13,4,4,42,8,34
"2021","Tunbridge Wells 009A","E01024821",974,375,238,137,572,109,286,105,150,31,100,66,32,2,72,49,23,5,5,27,8,19
"2021","Tunbridge Wells 009B","E01024822",953,306,179,127,623,102,334,109,181,44,96,51,44,1,89,57,32,2,2,24,6,18
"2021","Tunbridge Wells 009C","E01024824",652,147,78,69,482,80,286,75,174,37,65,31,31,3,50,35,15,1,1,23,11,12
"2021","Tunbridge Wells 009D","E01024832",654,173,41,132,453,34,271,75,172,24,89,61,24,4,55,32,23,4,4,28,3,25
"2021","Tunbridge Wells 009E","E01024834",900,213,56,157,641,38,325,80,213,32,168,97,68,3,99,65,34,11,11,46,17,29
"2021","Tunbridge Wells 010A","E01024795",620,168,57,111,409,38,164,39,97,28,83,33,45,5,121,79,42,3,3,43,19,24
"2021","Tunbridge Wells 010B","E01024796",609,204,69,135,364,47,190,65,101,24,66,46,16,4,56,34,22,5,5,41,17,24
"2021","Tunbridge Wells 010C","E01024830",867,319,176,143,516,77,231,73,116,42,96,53,41,2,106,73,33,6,6,32,7,25
"2021","Tunbridge Wells 010D","E01024831",597,194,83,111,384,41,172,58,87,27,77,31,36,10,91,65,26,3,3,19,5,14
"2021","Tunbridge Wells 011A","E01024792",722,143,85,58,552,131,334,104,166,64,46,25,17,4,41,20,21,0,0,27,11,16
"2021","Tunbridge Wells 011B","E01024794",706,193,102,91,478,82,256,77,128,51,68,38,30,0,69,40,29,3,3,35,11,24
"2021","Tunbridge Wells 011C","E01024804",574,142,56,86,407,78,240,74,120,46,49,30,17,2,40,19,21,0,0,25,13,12
"2021","Tunbridge Wells 011D","E01024805",645,150,78,72,459,81,262,84,134,44,67,39,26,2,48,24,24,1,1,36,14,22
"2021","Tunbridge Wells 011E","E01024806",624,142,63,79,452,68,262,80,134,48,56,28,24,4,65,39,26,1,1,30,16,14
"2021","Tunbridge Wells 012A","E01024797",743,239,136,103,462,107,247,85,122,40,53,34,16,3,54,33,21,1,1,42,14,28
"2021","Tunbridge Wells 012B","E01024817",731,210,116,94,501,110,282,88,153,41,64,46,15,3,43,21,22,2,2,20,5,15
"2021","Tunbridge Wells 012C","E01024818",765,214,90,124,522,104,293,100,150,43,68,38,23,7,53,27,26,4,4,29,14,15
"2021","Tunbridge Wells 012D","E01024819",793,350,68,282,401,51,175,81,83,11,124,98,25,1,49,29,20,2,2,42,7,35
"2021","Tunbridge Wells 012E","E01024820",665,148,83,65,499,76,341,81,230,30,44,29,12,3,35,25,10,3,3,18,7,11
"2021","Tunbridge Wells 013A","E01024787",482,114,74,40,337,65,188,75,83,30,32,17,11,4,50,26,24,2,2,31,17,14
"2021","Tunbridge Wells 013B","E01024788",608,171,78,93,410,62,189,62,84,43,53,27,23,3,102,59,43,4,4,27,9,18
"2021","Tunbridge Wells 013C","E01024790",502,235,131,104,251,45,106,44,47,15,38,22,12,4,59,44,15,3,3,16,11,5
"2021","Tunbridge Wells 013D","E01024791",561,153,111,42,377,92,177,58,77,42,52,21,24,7,55,37,18,1,1,31,18,13
"2021","Tunbridge Wells 013E","E01024803",926,197,126,71,677,142,383,146,182,55,71,37,30,4,80,47,33,1,1,52,29,23
"2021","Tunbridge Wells 014A","E01024789",759,213,128,85,526,114,284,101,131,52,73,39,29,5,54,37,17,1,1,20,7,13
"2021","Tunbridge Wells 014B","E01024807",746,284,170,114,438,83,200,79,83,38,83,35,41,7,67,42,25,5,5,24,10,14
"2021","Tunbridge Wells 014C","E01024808",781,232,111,121,527,96,250,97,119,34,108,57,45,6,71,52,19,2,2,22,6,16
"2021","Tunbridge Wells 014D","E01024809",585,142,84,58,416,96,223,79,97,47,52,24,21,7,43,29,14,2,2,27,10,17
"2021","Tunbridge Wells 014E","E01024810",615,116,51,65,468,86,268,94,129,45,68,31,27,10,43,25,18,3,3,31,16,15
"2021","Cherwell 001A","E01028479",587,135,74,61,421,95,219,102,86,31,76,47,23,6,29,11,18,2,2,31,13,18
"2021","Cherwell 001B","E01028480",674,172,101,71,487,100,271,129,101,41,76,49,22,5,38,18,20,2,2,15,6,9
"2021","Cherwell 001C","E01028508",454,94,55,39,348,77,209,89,85,35,35,21,12,2,26,15,11,1,1,12,3,9
"2021","Cherwell 001E","E01035723",542,137,67,70,380,78,223,111,81,31,57,38,15,4,20,6,14,2,2,25,7,18
"2021","Cherwell 001F","E01035724",712,184,45,139,492,18,227,79,132,16,179,101,77,1,62,45,17,6,6,36,13,23
"2021","Cherwell 002A","E01028441",984,254,81,173,654,51,300,99,175,26,165,86,68,11,127,91,36,11,11,76,27,49
"2021","Cherwell 002C","E01028443",591,138,40,98,421,49,208,67,100,41,91,46,39,6,68,46,22,5,5,32,10,22
"2021","Cherwell 002D","E01028444",576,125,61,64,426,66,221,70,97,54,82,42,35,5,48,18,30,9,9,25,12,13
"2021","Cherwell 002E","E01032943",862,182,39,143,625,34,309,97,172,40,177,96,74,7,102,75,27,3,3,55,23,32
"2021","Cherwell 002F","E01032944",615,203,59,144,386,31,201,75,81,45,93,57,32,4,57,34,23,4,4,26,5,21
"2021","Cherwell 003A","E01028445",508,103,51,52,338,23,177,42,100,35,56,19,32,5,78,41,37,4,4,67,35,32
"2021","Cherwell 003B","E01028446",625,157,84,73,406,71,193,62,98,33,80,41,31,8,54,34,20,8,8,62,26,36
"2021","Cherwell 003C","E01028447",554,219,74,145,272,17,118,37,65,16,76,56,19,1,56,24,32,5,5,63,26,37
"2021","Cherwell 003D","E01028448",644,195,81,114,383,24,164,42,89,33,68,29,32,7,118,84,34,9,9,66,31,35
"2021","Cherwell 004A","E01028435",1144,630,146,484,427,18,148,72,58,18,154,119,29,6,81,59,22,26,26,87,14,73
"2021","Cherwell 004C","E01028437",571,132,44,88,365,21,205,64,108,33,86,45,37,4,44,24,20,9,9,74,33,41
"2021","Cherwell 004E","E01028439",563,138,34,104,387,29,203,68,94,41,99,61,30,8,53,31,22,3,3,38,17,21
"2021","Cherwell 004F","E01028440",733,266,52,214,379,14,156,61,72,23,138,103,34,1,58,34,24,13,13,88,29,59
"2021","Cherwell 004G","E01032941",628,239,114,125,325,35,141,42,78,21,64,35,21,8,82,42,40,3,3,64,26,38
"2021","Cherwell 004H","E01032942",728,292,65,227,373,9,157,63,85,9,105,72,32,1,88,66,22,14,14,63,16,47
"2021","Cherwell 004I","E01035725",494,104,6,98,356,7,151,47,87,17,140,92,48,0,55,49,6,3,3,34,10,24
"2021","Cherwell 004J","E01035726",762,299,116,183,384,33,173,70,80,23,126,92,32,2,42,25,17,10,10,79,34,45
"2021","Cherwell 005A","E01028449",545,135,68,67,345,32,165,50,80,35,61,24,30,7,86,48,38,1,1,65,31,34
"2021","Cherwell 005B","E01028450",528,98,35,63,391,24,151,39,83,29,84,25,50,9,128,93,35,4,4,39,22,17
"2021","Cherwell 005C","E01028451",491,91,43,48,364,56,177,66,80,31,59,26,25,8,68,34,34,4,4,36,12,24
"2021","Cherwell 005D","E01028452",517,103,42,61,348,28,159,50,80,29,76,28,42,6,78,53,25,7,7,66,31,35
"2021","Cherwell 005E","E01028453",492,95,54,41,351,26,167,37,101,29,67,24,40,3,83,55,28,8,8,46,26,20
"2021","Cherwell 005F","E01028454",692,238,135,103,397,26,163,58,79,26,81,32,46,3,114,78,36,13,13,57,24,33
"2021","Cherwell 006A","E01028430",898,392,110,282,458,56,195,69,103,23,121,96,20,5,78,47,31,8,8,48,10,38
"2021","Cherwell 006B","E01028431",683,181,92,89,457,122,232,89,107,36,59,30,16,13,44,23,21,0,0,45,16,29
"2021","Cherwell 006C","E01028432",837,239,152,87,542,111,252,76,125,51,94,43,43,8,82,45,37,3,3,56,26,30
"2021","Cherwell 006D","E01028433",750,221,164,57,504,138,258,111,81,66,62,40,18,4,45,17,28,1,1,25,9,16
"2021","Cherwell 006E","E01028434",706,141,75,66,530,97,279,105,113,61,78,48,23,7,68,37,31,8,8,35,12,23
"2021","Cherwell 007A","E01028426",722,164,83,81,527,63,273,86,143,44,125,79,35,11,65,43,22,1,1,31,11,20
"2021","Cherwell 007B","E01028427",691,263,51,212,378,31,178,63,89,26,100,67,26,7,60,41,19,9,9,50,15,35
"2021","Cherwell 007C","E01028428",513,91,69,22,390,96,218,69,99,50,36,18,15,3,38,15,23,2,2,32,16,16
"2021","Cherwell 007D","E01028429",507,181,111,70,289,67,140,60,53,27,40,24,15,1,41,23,18,1,1,37,9,28
"2021","Cherwell 008A","E01028422",715,163,84,79,514,87,281,82,152,47,68,32,29,7,77,52,25,1,1,38,18,20
"2021","Cherwell 008B","E01028423",696,180,99,81,484,122,238,95,115,28,69,37,26,6,51,30,21,4,4,32,8,24
"2021","Cherwell 008D","E01028476",1090,242,118,124,818,158,447,138,239,70,103,60,38,5,106,81,25,4,4,30,11,19
"2021","Cherwell 008E","E01035727",665,103,13,90,523,8,280,67,201,12,143,81,58,4,89,76,13,3,3,39,17,22
"2021","Cherwell 008F","E01035728",549,119,57,62,398,66,177,55,91,31,84,34,44,6,65,45,20,6,6,32,17,15
"2021","Cherwell 008G","E01035729",654,164,76,88,473,119,235,82,106,47,72,45,25,2,47,31,16,0,0,17,7,10
"2021","Cherwell 009A","E01028474",807,217,101,116,556,73,275,98,132,45,103,57,41,5,100,76,24,5,5,34,13,21
"2021","Cherwell 009B","E01028485",678,174,99,75,484,80,255,103,116,36,76,37,32,7,72,48,24,1,1,20,2,18
"2021","Cherwell 009C","E01028486",543,143,91,52,379,91,221,88,98,35,43,30,12,1,23,7,16,1,1,21,8,13
"2021","Cherwell 009D","E01028503",512,123,75,48,364,109,195,96,66,33,41,27,12,2,18,7,11,1,1,25,10,15
"2021","Cherwell 009E","E01028504",586,131,63,68,426,94,242,103,106,33,59,37,19,3,31,14,17,0,0,29,18,11
"2021","Cherwell 010A","E01028481",642,206,117,89,410,109,199,59,98,42,58,32,20,6,43,26,17,1,1,26,9,17
"2021","Cherwell 010B","E01028482",574,139,83,56,416,92,228,76,119,33,57,27,27,3,38,20,18,1,1,19,7,12
"2021","Cherwell 010D","E01028506",792,196,91,105,545,73,331,130,164,37,84,57,23,4,57,26,31,0,0,51,17,34
"2021","Cherwell 010E","E01028507",597,135,74,61,433,98,239,96,114,29,58,33,24,1,37,17,20,1,1,29,16,13
"2021","Cherwell 010F","E01035730",633,107,20,87,477,23,249,71,155,23,139,73,63,3,62,44,18,4,4,49,19,30
"2021","Cherwell 010G","E01035731",613,143,63,80,431,59,225,82,112,31,92,55,34,3,51,33,18,4,4,39,17,22
"2021","Cherwell 011B","E01028477",1029,246,69,177,733,66,384,165,168,51,184,137,37,10,96,67,29,3,3,50,23,27
"2021","Cherwell 011C","E01028478",464,82,26,56,357,18,235,69,125,41,58,20,34,4,40,28,12,6,6,25,12,13
"2021","Cherwell 011D","E01028483",525,118,62,56,381,66,229,82,99,48,59,35,17,7,22,11,11,5,5,26,7,19
"2021","Cherwell 011E","E01028484",463,109,51,58,326,50,187,79,84,24,52,30,16,6,36,18,18,1,1,28,7,21
"2021","Cherwell 011F","E01028499",787,171,104,67,580,83,352,142,146,64,97,51,39,7,46,28,18,2,2,36,15,21
"2021","Cherwell 011G","E01035733",625,138,28,110,457,30,222,84,121,17,136,78,56,2,66,53,13,3,3,30,8,22
"2021","Cherwell 011H","E01035734",449,47,7,40,376,2,272,69,184,19,61,32,26,3,40,31,9,1,1,26,13,13
"2021","Cherwell 012A","E01028459",651,207,51,156,417,18,223,85,108,30,127,85,41,1,44,28,16,5,5,27,7,20
"2021","Cherwell 012B","E01028460",726,100,39,61,581,44,368,94,225,49,83,48,32,3,77,50,27,9,9,45,18,27
"2021","Cherwell 012C","E01028461",670,147,32,115,486,23,254,82,125,47,131,74,50,7,72,44,28,6,6,37,9,28
"2021","Cherwell 012D","E01028462",643,147,65,82,450,64,263,91,118,54,67,41,20,6,52,33,19,4,4,46,13,33
"2021","Cherwell 013A","E01028455",576,105,44,61,442,47,254,89,110,55,81,39,37,5,54,29,25,6,6,29,12,17
"2021","Cherwell 013B","E01028456",599,151,89,62,389,59,193,66,86,41,60,33,22,5,77,44,33,0,0,59,19,40
"2021","Cherwell 013C","E01028457",505,87,41,46,371,60,215,68,92,55,55,25,26,4,37,14,23,4,4,47,19,28
"2021","Cherwell 013D","E01028458",614,151,40,111,400,24,202,67,93,42,103,50,45,8,63,39,24,8,8,63,34,29
"2021","Cherwell 013E","E01028467",808,243,95,148,508,70,251,99,113,39,119,77,36,6,63,32,31,5,5,57,22,35
"2021","Cherwell 014A","E01028466",684,160,72,88,458,45,199,56,100,43,95,48,38,9,114,72,42,5,5,66,27,39
"2021","Cherwell 014B","E01028469",596,136,96,40,420,125,224,87,77,60,38,19,17,2,31,6,25,2,2,40,16,24
"2021","Cherwell 014C","E01028470",682,152,79,73,479,88,234,91,98,45,83,36,42,5,64,28,36,10,10,51,14,37
"2021","Cherwell 014D","E01028471",472,81,43,38,341,34,146,40,71,35,66,21,43,2,89,52,37,6,6,50,19,31
"2021","Cherwell 014E","E01028472",475,96,50,46,336,54,190,69,85,36,45,25,16,4,43,18,25,4,4,43,18,25
"2021","Cherwell 014F","E01028473",615,146,53,93,442,58,264,93,107,64,80,52,21,7,39,25,14,1,1,27,9,18
"2021","Cherwell 015A","E01028463",1093,320,55,265,707,25,383,129,197,57,194,132,60,2,90,58,32,15,15,66,20,46
"2021","Cherwell 015B","E01028464",689,175,34,141,490,25,288,97,151,40,111,78,28,5,60,47,13,6,6,24,9,15
"2021","Cherwell 015C","E01028465",529,107,32,75,395,28,249,72,134,43,73,44,29,0,41,27,14,4,4,27,12,15
"2021","Cherwell 015E","E01035735",963,493,288,205,397,79,148,55,69,24,103,76,21,6,58,30,28,9,9,73,11,62
"2021","Cherwell 015F","E01035736",495,114,15,99,337,11,158,56,91,11,106,71,33,2,58,52,6,4,4,44,16,28
"2021","Cherwell 016B","E01028497",623,177,91,86,413,91,223,87,98,38,64,43,15,6,31,15,16,4,4,33,16,17
"2021","Cherwell 016C","E01028498",681,177,75,102,460,63,255,99,116,40,85,41,40,4,54,22,32,3,3,44,16,28
"2021","Cherwell 016D","E01028500",554,121,64,57,398,62,196,88,84,24,87,40,43,4,50,30,20,3,3,35,14,21
"2021","Cherwell 016E","E01028501",485,89,53,36,362,79,202,81,88,33,55,30,22,3,24,9,15,2,2,34,10,24
"2021","Cherwell 016F","E01028502",509,114,68,46,370,67,222,81,109,32,51,34,15,2,28,11,17,2,2,25,8,17
"2021","Cherwell 016G","E01035737",673,102,9,93,511,5,305,77,214,14,121,69,50,2,77,61,16,3,3,60,25,35
"2021","Cherwell 016H","E01035738",606,91,11,80,472,11,267,56,193,18,113,57,54,2,72,59,13,9,9,43,25,18
"2021","Cherwell 016I","E01035739",761,186,97,89,540,100,308,114,138,56,74,43,26,5,56,36,20,2,2,35,11,24
"2021","Cherwell 017A","E01028487",549,161,67,94,353,42,180,68,76,36,81,63,15,3,43,18,25,7,7,35,15,20
"2021","Cherwell 017B","E01028489",668,234,160,74,409,153,192,69,81,42,33,17,13,3,25,8,17,6,6,25,7,18
"2021","Cherwell 017C","E01028490",523,156,92,64,333,61,181,57,79,45,44,24,12,8,44,21,23,3,3,34,15,19
"2021","Cherwell 017D","E01028491",727,243,145,98,441,99,209,64,107,38,77,48,26,3,46,26,20,10,10,43,9,34
"2021","Cherwell 017E","E01028494",469,134,77,57,293,32,144,62,57,25,48,27,16,5,67,32,35,2,2,42,19,23
"2021","Cherwell 018A","E01028492",664,194,118,76,406,79,220,76,90,54,51,34,16,1,47,27,20,9,9,64,28,36
"2021","Cherwell 018B","E01028493",548,118,70,48,376,64,174,51,81,42,58,27,22,9,71,36,35,9,9,54,26,28
"2021","Cherwell 018C","E01028495",519,140,70,70,323,32,196,71,83,42,48,29,17,2,44,19,25,3,3,56,30,26
"2021","Cherwell 018D","E01028496",525,113,56,57,345,43,188,55,90,43,48,22,20,6,65,34,31,1,1,67,20,47
"2021","Cherwell 019A","E01028488",657,231,54,177,384,42,165,76,62,27,111,78,28,5,59,37,22,7,7,42,9,33
"2021","Cherwell 019B","E01028510",665,167,101,66,452,105,243,83,104,56,66,42,19,5,35,14,21,3,3,46,22,24
"2021","Cherwell 019C","E01028511",823,267,158,109,500,123,242,84,102,56,73,43,29,1,57,32,25,5,5,56,20,36
"2021","Cherwell 019D","E01028512",754,176,80,96,533,65,288,99,150,39,93,58,32,3,82,49,33,5,5,45,16,29
"2021","Oxford 001A","E01028594",672,183,109,74,445,102,254,83,129,42,31,20,10,1,53,33,20,5,5,44,12,32
"2021","Oxford 001B","E01028595",662,181,109,72,445,53,223,58,132,33,83,36,39,8,84,53,31,2,2,36,9,27
"2021","Oxford 001C","E01028596",635,223,109,114,374,77,209,62,124,23,42,25,15,2,45,29,16,1,1,38,16,22
"2021","Oxford 001D","E01028597",633,211,94,117,345,51,184,51,108,25,38,25,12,1,63,33,30,9,9,77,29,48
"2021","Oxford 002C","E01028591",526,189,84,105,303,84,155,55,73,27,42,31,9,2,17,10,7,5,5,34,7,27
"2021","Oxford 002D","E01028592",459,157,70,87,250,35,131,48,72,11,48,35,13,0,32,21,11,4,4,52,16,36
"2021","Oxford 002F","E01032554",990,359,194,165,565,98,314,106,175,33,83,66,16,1,67,42,25,3,3,66,13,53
"2021","Oxford 002G","E01032555",770,204,83,121,495,37,246,57,143,46,80,47,32,1,125,82,43,7,7,71,26,45
"2021","Oxford 003A","E01028565",500,108,48,60,336,55,194,55,115,24,47,30,16,1,38,25,13,2,2,56,10,46
"2021","Oxford 003C","E01028584",1052,315,130,185,672,116,397,122,226,49,66,46,19,1,89,68,21,4,4,65,12,53
"2021","Oxford 003E","E01035740",732,309,147,162,368,82,180,76,80,24,60,46,13,1,40,28,12,6,6,55,12,43
"2021","Oxford 004A","E01028560",717,235,129,106,411,65,212,47,125,40,62,38,22,2,64,33,31,8,8,71,26,45
"2021","Oxford 004B","E01028561",681,149,104,45,416,84,239,63,138,38,34,17,14,3,55,23,32,4,4,116,26,90
"2021","Oxford 004C","E01028562",632,116,58,58,413,32,242,58,151,33,68,42,23,3,65,35,30,6,6,103,17,86
"2021","Oxford 004D","E01028563",611,160,62,98,368,39,213,50,132,31,66,42,20,4,44,25,19,6,6,83,18,65
"2021","Oxford 005A","E01028513",927,246,55,191,528,15,233,62,130,41,110,63,37,10,157,108,49,13,13,153,48,105
"2021","Oxford 005B","E01028514",545,123,65,58,332,26,142,38,65,39,44,13,24,7,110,65,45,10,10,90,45,45
"2021","Oxford 005C","E01028516",939,248,78,170,602,53,303,73,183,47,110,63,37,10,128,88,40,8,8,89,24,65
"2021","Oxford 005D","E01028538",699,201,78,123,426,32,196,47,118,31,81,52,20,9,112,70,42,5,5,72,26,46
"2021","Oxford 006A","E01028534",460,119,62,57,274,55,180,45,103,32,31,19,10,2,7,2,5,1,1,67,14,53
"2021","Oxford 006B","E01028535",694,193,64,129,398,54,218,71,127,20,83,61,21,1,31,17,14,12,12,103,11,92
"2021","Oxford 006C","E01028536",617,210,102,108,328,39,182,56,117,9,62,45,15,2,39,16,23,6,6,79,10,69
"2021","Oxford 006D","E01028537",841,280,100,180,391,95,167,63,90,14,73,61,10,2,38,18,20,18,18,170,10,160
"2021","Oxford 006E","E01028539",699,141,48,93,424,28,244,53,148,43,74,50,20,4,61,40,21,17,17,134,35,99
"2021","Oxford 006F","E01028540",549,165,69,96,326,53,193,45,119,29,44,36,8,0,34,20,14,2,2,58,13,45
"2021","Oxford 007A","E01028515",683,155,47,108,443,50,230,76,121,33,99,69,27,3,56,25,31,8,8,85,31,54
"2021","Oxford 007B","E01028571",670,166,78,88,432,50,229,66,131,32,89,61,23,5,57,30,27,7,7,72,14,58
"2021","Oxford 007C","E01028572",791,226,67,159,493,57,261,82,141,38,122,85,30,7,44,26,18,9,9,72,24,48
"2021","Oxford 007D","E01028573",640,143,70,73,423,46,269,64,170,35,59,35,24,0,45,21,24,4,4,74,16,58
"2021","Oxford 007E","E01028574",611,212,133,79,313,39,160,51,89,20,62,39,19,4,44,25,19,8,8,86,22,64
"2021","Oxford 008A","E01028521",563,248,21,227,232,16,118,63,42,13,73,70,3,0,19,12,7,6,6,83,8,75
"2021","Oxford 008B","E01028522",696,321,62,259,242,6,113,72,35,6,57,45,12,0,60,45,15,6,6,133,7,126
"2021","Oxford 008F","E01035741",609,217,90,127,325,42,196,54,122,20,55,49,6,0,26,15,11,6,6,67,10,57
"2021","Oxford 008G","E01035742",609,236,86,150,261,40,113,48,55,10,81,79,2,0,24,11,13,3,3,112,3,109
"2021","Oxford 009A","E01028548",779,251,115,136,389,37,216,66,125,25,78,62,13,3,51,31,20,7,7,139,43,96
"2021","Oxford 009B","E01028549",707,264,77,187,366,24,164,65,87,12,108,87,20,1,59,35,24,11,11,77,9,68
"2021","Oxford 009C","E01028550",707,289,62,227,286,17,103,49,39,15,84,70,11,3,56,33,23,26,26,132,6,126
"2021","Oxford 009D","E01028551",546,139,44,95,290,32,126,69,50,7,61,51,8,2,40,27,13,31,31,117,10,107
"2021","Oxford 010A","E01028523",595,227,29,198,270,25,123,50,58,15,54,37,16,1,59,41,18,9,9,98,22,76
"2021","Oxford 010B","E01028524",629,164,45,119,373,15,190,53,107,30,57,24,30,3,102,70,32,9,9,92,38,54
"2021","Oxford 010C","E01028525",713,202,89,113,419,35,199,53,108,38,56,24,25,7,119,77,42,10,10,92,33,59
"2021","Oxford 010D","E01028526",522,118,49,69,227,20,106,39,48,19,56,43,9,4,36,14,22,9,9,177,15,162
"2021","Oxford 011A","E01028579",529,120,28,92,183,12,83,40,30,13,52,42,10,0,29,14,15,7,7,226,25,201
"2021","Oxford 011B","E01028580",534,160,59,101,211,9,93,42,38,13,73,60,10,3,31,21,10,5,5,163,9,154
"2021","Oxford 011C","E01028581",504,125,47,78,265,48,137,56,59,22,58,30,25,3,22,13,9,0,0,114,12,102
"2021","Oxford 011D","E01028582",515,207,73,134,169,5,68,35,26,7,58,53,3,2,35,20,15,3,3,139,6,133
"2021","Oxford 011E","E01028586",619,206,53,153,238,12,109,40,54,15,74,58,15,1,32,21,11,11,11,175,15,160
"2021","Oxford 011F","E01028587",687,189,45,144,268,9,116,42,60,14,90,65,23,2,45,28,17,8,8,230,16,214
"2021","Oxford 011G","E01028588",466,145,24,121,144,9,63,25,28,10,59,52,7,0,10,3,7,3,3,177,6,171
"2021","Oxford 012A","E01028541",579,172,67,105,315,23,177,46,112,19,64,43,18,3,41,20,21,10,10,92,7,85
"2021","Oxford 012B","E01028542",729,201,54,147,422,32,173,49,103,21,122,83,34,5,85,51,34,10,10,106,21,85
"2021","Oxford 012C","E01028543",559,227,75,152,265,31,130,33,84,13,53,39,12,2,38,19,19,13,13,67,13,54
"2021","Oxford 012D","E01028544",553,243,110,133,231,33,106,40,51,15,67,51,15,1,21,8,13,4,4,79,7,72
"2021","Oxford 014A","E01028545",672,213,48,165,307,39,179,54,97,28,54,38,16,0,30,17,13,5,5,152,14,138
"2021","Oxford 014B","E01028546",724,211,87,124,399,29,173,55,86,32,75,43,27,5,111,58,53,11,11,114,35,79
"2021","Oxford 014C","E01028547",869,203,58,145,445,16,237,129,94,14,125,89,33,3,51,31,20,16,16,221,35,186
"2021","Oxford 015A","E01028527",666,166,67,99,406,41,209,53,128,28,94,56,31,7,54,36,18,8,8,94,23,71
"2021","Oxford 015B","E01028528",594,154,53,101,313,21,159,46,83,30,65,47,15,3,55,32,23,13,13,127,40,87
"2021","Oxford 015C","E01028529",640,193,49,144,352,24,168,36,98,34,69,38,29,2,84,48,36,7,7,95,30,65
"2021","Oxford 015D","E01028530",674,156,71,85,336,34,179,53,97,29,57,39,13,5,52,20,32,14,14,182,97,85
"2021","Oxford 015E","E01028575",652,219,118,101,370,89,175,76,75,24,59,35,22,2,45,26,19,2,2,63,17,46
"2021","Oxford 015F","E01028578",638,207,91,116,345,45,192,61,95,36,65,42,21,2,31,20,11,12,12,86,18,68
"2021","Oxford 016A","E01028552",791,180,65,115,532,37,215,52,135,28,90,37,47,6,174,119,55,16,16,79,28,51
"2021","Oxford 016B","E01028553",754,209,56,153,480,45,213,79,112,22,117,78,34,5,100,64,36,5,5,65,15,50
"2021","Oxford 016C","E01028554",609,181,90,91,324,39,152,44,83,25,80,56,21,3,44,24,20,9,9,104,14,90
"2021","Oxford 016D","E01028555",668,182,67,115,417,43,205,77,90,38,92,57,32,3,64,38,26,13,13,69,31,38
"2021","Oxford 016E","E01028576",508,104,32,72,291,15,132,40,67,25,46,17,20,9,93,57,36,5,5,113,60,53
"2021","Oxford 016F","E01028577",777,200,76,124,483,33,243,53,143,47,67,30,25,12,130,83,47,10,10,94,49,45
"2021","Oxford 017A","E01028517",500,116,36,80,323,17,139,48,61,30,67,36,21,10,96,71,25,4,4,61,25,36
"2021","Oxford 017B","E01028518",644,225,79,146,365,21,151,50,63,38,40,9,27,4,139,94,45,14,14,54,25,29
"2021","Oxford 017C","E01028519",594,127,52,75,373,26,160,36,77,47,72,28,30,14,100,49,51,15,15,94,54,40
"2021","Oxford 017D","E01028567",666,164,79,85,383,23,192,57,79,56,63,28,26,9,99,60,39,6,6,119,54,65
"2021","Oxford 018A","E01028520",608,139,66,73,393,21,142,40,74,28,56,9,37,10,164,107,57,10,10,76,33,43
"2021","Oxford 018B","E01028568",587,180,85,95,366,21,137,37,62,38,66,13,39,14,135,89,46,7,7,41,23,18
"2021","Oxford 018C","E01028569",607,173,33,140,387,6,156,39,82,35,74,23,36,15,147,86,61,4,4,47,16,31
"2021","Oxford 018D","E01028570",789,208,33,175,469,9,233,75,130,28,112,65,42,5,107,64,43,8,8,112,68,44
"2021","Oxford 020B","E01028556",676,159,56,103,416,31,195,56,105,34,86,41,39,6,92,54,38,12,12,101,23,78
"2021","Oxford 020D","E01028557",741,204,87,117,440,29,240,56,143,41,71,36,31,4,90,56,34,10,10,97,35,62
"2021","Oxford 020C","E01028558",593,126,52,74,346,30,193,47,103,43,49,30,16,3,64,29,35,10,10,121,48,73
"2021","Oxford 020A","E01028559",671,157,50,107,358,40,203,75,93,35,59,31,22,6,51,31,20,5,5,156,33,123
"2021","Oxford 019B","E01028531",823,252,51,201,450,28,193,77,97,19,147,103,40,4,74,57,17,8,8,121,18,103
"2021","Oxford 019A","E01028532",1015,287,66,221,461,20,204,64,97,43,138,113,21,4,77,41,36,22,22,267,49,218
"2021","Oxford 019C","E01035743",451,104,40,64,192,12,92,22,54,16,42,32,7,3,35,19,16,11,11,155,68,87
"2021","Oxford 019D","E01035744",457,104,15,89,265,4,136,43,72,21,66,53,13,0,50,33,17,9,9,88,24,64
"2021","South Oxfordshire 001A","E01028666",699,254,110,144,408,60,194,65,85,44,93,58,31,4,57,33,24,4,4,37,7,30
"2021","South Oxfordshire 001B","E01028667",532,116,39,77,405,34,237,81,101,55,79,40,34,5,54,36,18,1,1,11,3,8
"2021","South Oxfordshire 001C","E01028668",553,151,93,58,388,83,209,82,86,41,49,18,27,4,46,22,24,1,1,14,7,7
"2021","South Oxfordshire 001D","E01028669",550,131,71,60,393,71,193,67,94,32,66,30,34,2,63,25,38,0,0,26,10,16
"2021","South Oxfordshire 002A","E01028638",639,158,76,82,428,88,235,96,96,43,69,46,18,5,35,18,17,1,1,53,17,36
"2021","South Oxfordshire 002B","E01028639",584,143,74,69,404,53,218,66,111,41,83,52,25,6,48,26,22,2,2,37,8,29
"2021","South Oxfordshire 002C","E01028640",579,157,88,69,395,79,198,79,79,40,62,26,29,7,54,29,25,2,2,27,10,17
"2021","South Oxfordshire 002D","E01028683",611,158,99,59,418,84,243,91,96,56,61,33,22,6,27,10,17,3,3,35,12,23
"2021","South Oxfordshire 003A","E01028670",576,130,87,43,427,105,246,73,132,41,41,21,16,4,32,19,13,3,3,19,8,11
"2021","South Oxfordshire 003B","E01028671",788,333,214,119,419,80,187,51,101,35,90,55,31,4,59,38,21,3,3,36,6,30
"2021","South Oxfordshire 003C","E01028672",1102,236,122,114,814,167,444,135,236,73,104,57,42,5,96,72,24,3,3,52,18,34
"2021","South Oxfordshire 003D","E01028673",801,182,58,124,582,55,278,73,175,30,125,85,36,4,118,82,36,6,6,37,16,21
"2021","South Oxfordshire 004A","E01028646",496,137,80,57,319,57,168,65,74,29,52,29,17,6,41,17,24,1,1,40,13,27
"2021","South Oxfordshire 004B","E01028647",648,148,70,78,474,88,287,118,126,43,58,33,21,4,37,18,19,4,4,26,7,19
"2021","South Oxfordshire 004C","E01028681",548,150,90,60,371,86,207,73,99,35,61,34,23,4,16,10,6,1,1,27,4,23
"2021","South Oxfordshire 004D","E01028682",520,133,78,55,353,83,170,59,75,36,51,29,19,3,47,16,31,2,2,34,9,25
"2021","South Oxfordshire 004E","E01028684",663,228,109,119,399,79,174,65,77,32,87,64,21,2,59,33,26,0,0,36,10,26
"2021","South Oxfordshire 005A","E01028598",1029,211,114,97,766,144,433,160,175,98,120,77,34,9,65,35,30,4,4,52,14,38
"2021","South Oxfordshire 005B","E01028613",547,94,43,51,434,76,242,74,113,55,78,36,39,3,38,19,19,0,0,19,12,7
"2021","South Oxfordshire 005C","E01028614",1025,219,86,133,756,90,359,103,203,53,187,99,81,7,115,78,37,5,5,50,20,30
"2021","South Oxfordshire 005D","E01028615",793,211,150,61,541,131,283,114,111,58,81,43,34,4,45,26,19,1,1,41,17,24
"2021","South Oxfordshire 005E","E01028616",720,147,64,83,545,84,286,81,159,46,102,61,38,3,69,46,23,4,4,28,14,14
"2021","South Oxfordshire 006A","E01028604",564,121,50,71,399,39,211,62,114,35,67,30,28,9,73,43,30,9,9,44,24,20
"2021","South Oxfordshire 006B","E01028605",634,182,102,80,419,63,213,75,80,58,62,27,29,6,79,43,36,2,2,33,16,17
"2021","South Oxfordshire 006C","E01028607",533,143,85,58,359,68,203,83,84,36,54,34,18,2,33,20,13,1,1,31,10,21
"2021","South Oxfordshire 006D","E01028641",533,152,91,61,360,96,183,91,69,23,43,31,10,2,38,12,26,0,0,21,8,13
"2021","South Oxfordshire 006E","E01028657",550,192,69,123,333,54,186,88,63,35,65,50,11,4,22,7,15,6,6,25,7,18
"2021","South Oxfordshire 006F","E01028658",499,109,56,53,360,64,207,71,99,37,54,28,23,3,33,17,16,2,2,30,15,15
"2021","South Oxfordshire 007A","E01028600",634,184,121,63,429,98,230,92,91,47,50,29,18,3,48,20,28,3,3,21,10,11
"2021","South Oxfordshire 007B","E01028603",525,99,53,46,396,53,245,82,120,43,65,44,19,2,32,23,9,1,1,30,10,20
"2021","South Oxfordshire 007C","E01028606",742,205,140,65,500,133,271,111,110,50,43,25,16,2,45,21,24,8,8,37,14,23
"2021","South Oxfordshire 007D","E01028609",532,92,54,38,421,73,240,85,109,46,66,32,31,3,41,20,21,1,1,19,6,13
"2021","South Oxfordshire 007E","E01028610",604,150,83,67,419,85,233,85,101,47,62,26,26,10,39,14,25,0,0,35,12,23
"2021","South Oxfordshire 008A","E01028678",666,162,90,72,469,80,284,103,127,54,64,32,28,4,41,20,21,0,0,35,11,24
"2021","South Oxfordshire 008B","E01028679",884,212,113,99,633,109,361,134,159,68,89,55,29,5,69,39,30,5,5,39,18,21
"2021","South Oxfordshire 008C","E01028680",787,276,172,104,486,100,265,95,130,40,66,42,20,4,53,30,23,2,2,25,7,18
"2021","South Oxfordshire 009A","E01028625",781,161,34,127,575,17,336,109,194,33,157,111,43,3,56,33,23,9,9,45,10,35
"2021","South Oxfordshire 009B","E01028626",620,107,35,72,483,28,298,96,157,45,106,77,29,0,48,31,17,3,3,30,9,21
"2021","South Oxfordshire 009C","E01028627",624,167,46,121,432,27,221,74,104,43,119,78,37,4,63,37,26,2,2,25,9,16
"2021","South Oxfordshire 009D","E01028628",689,125,29,96,525,33,304,106,146,52,112,68,41,3,72,39,33,4,4,39,4,35
"2021","South Oxfordshire 009E","E01028629",625,186,39,147,405,20,211,77,102,32,115,75,34,6,54,36,18,5,5,34,8,26
"2021","South Oxfordshire 010B","E01028622",855,218,92,126,581,73,298,105,140,53,134,79,55,0,73,46,27,3,3,56,21,35
"2021","South Oxfordshire 010C","E01028623",687,215,76,139,414,48,228,84,91,53,81,48,24,9,52,27,25,5,5,58,7,51
"2021","South Oxfordshire 010D","E01028624",880,202,117,85,606,87,316,106,172,38,118,70,44,4,72,47,25,13,13,72,22,50
"2021","South Oxfordshire 010E","E01035745",650,151,45,106,462,25,236,83,128,25,118,62,51,5,81,61,20,2,2,37,17,20
"2021","South Oxfordshire 010F","E01035746",666,100,10,90,532,11,291,75,195,21,144,83,56,5,79,59,20,7,7,34,12,22
"2021","South Oxfordshire 011A","E01028599",837,219,121,98,579,111,290,99,157,34,105,65,39,1,70,47,23,3,3,39,13,26
"2021","South Oxfordshire 011B","E01028601",479,96,56,40,360,50,244,89,122,33,37,25,12,0,26,14,12,3,3,23,9,14
"2021","South Oxfordshire 011C","E01028602",465,81,14,67,360,19,269,68,190,11,55,31,22,2,16,14,2,1,1,24,11,13
"2021","South Oxfordshire 011E","E01035747",440,112,72,40,315,58,180,67,91,22,48,32,16,0,27,15,12,2,2,13,4,9
"2021","South Oxfordshire 011F","E01035748",663,164,82,82,449,77,259,87,123,49,64,38,18,8,47,21,26,2,2,50,14,36
"2021","South Oxfordshire 012A","E01028608",491,109,67,42,367,82,225,69,110,46,24,11,11,2,33,19,14,3,3,15,5,10
"2021","South Oxfordshire 012B","E01028617",872,244,132,112,588,112,325,96,189,40,88,48,36,4,63,43,20,0,0,40,11,29
"2021","South Oxfordshire 012C","E01028674",561,145,92,53,391,88,218,68,116,34,49,32,16,1,32,19,13,4,4,25,6,19
"2021","South Oxfordshire 012D","E01028675",508,109,57,52,365,40,198,47,112,39,66,33,29,4,60,33,27,1,1,34,14,20
"2021","South Oxfordshire 012E","E01028676",966,319,128,191,600,69,302,88,174,40,118,64,45,9,108,64,44,3,3,47,13,34
"2021","South Oxfordshire 012F","E01028677",788,380,190,190,383,81,154,70,70,14,87,62,23,2,58,32,26,3,3,25,3,22
"2021","South Oxfordshire 013A","E01028630",696,271,44,227,383,16,192,75,81,36,117,90,22,5,50,34,16,8,8,42,10,32
"2021","South Oxfordshire 013B","E01028631",481,136,47,89,293,34,141,55,67,19,66,41,22,3,50,31,19,2,2,52,16,36
"2021","South Oxfordshire 013C","E01028632",550,113,54,59,374,41,189,58,94,37,68,35,23,10,71,31,40,5,5,63,25,38
"2021","South Oxfordshire 013D","E01028633",703,280,55,225,385,28,163,58,80,25,108,77,27,4,82,54,28,4,4,38,7,31
"2021","South Oxfordshire 014A","E01028634",517,121,71,50,366,59,205,62,104,39,59,34,25,0,38,23,15,5,5,30,10,20
"2021","South Oxfordshire 014B","E01028635",647,176,94,82,415,57,200,79,80,41,72,30,37,5,76,41,35,10,10,56,12,44
"2021","South Oxfordshire 014C","E01028636",586,210,145,65,335,40,161,57,61,43,63,37,21,5,66,29,37,5,5,41,16,25
"2021","South Oxfordshire 014D","E01028637",852,191,77,114,599,76,322,97,168,57,129,66,59,4,67,40,27,5,5,62,20,42
"2021","South Oxfordshire 015B","E01028619",753,191,118,73,526,94,254,76,149,29,97,52,40,5,80,53,27,1,1,36,10,26
"2021","South Oxfordshire 015C","E01028644",742,224,155,69,497,144,257,90,141,26,52,29,16,7,43,27,16,1,1,21,8,13
"2021","South Oxfordshire 015E","E01028649",613,130,70,60,451,91,277,109,131,37,47,20,19,8,36,15,21,0,0,32,12,20
"2021","South Oxfordshire 015F","E01035749",1010,158,12,146,797,8,374,86,273,15,295,197,97,1,117,94,23,3,3,55,22,33
"2021","South Oxfordshire 015G","E01035750",485,105,62,43,361,66,201,68,91,42,50,29,18,3,44,18,26,0,0,19,6,13
"2021","South Oxfordshire 015H","E01035751",630,136,57,79,470,45,256,81,146,29,114,63,43,8,55,49,6,0,0,24,11,13
"2021","South Oxfordshire 015I","E01035752",602,132,44,88,443,62,224,75,124,25,93,62,25,6,61,42,19,3,3,27,9,18
"2021","South Oxfordshire 016A","E01028650",845,222,128,94,576,84,322,65,193,64,83,40,33,10,82,58,24,5,5,47,16,31
"2021","South Oxfordshire 016B","E01028651",783,309,167,142,434,120,174,67,72,35,63,41,21,1,75,42,33,2,2,40,13,27
"2021","South Oxfordshire 016C","E01028652",1154,530,262,268,558,129,228,103,98,27,115,88,24,3,78,44,34,8,8,66,11,55
"2021","South Oxfordshire 017A","E01028653",723,275,117,158,411,50,195,67,105,23,87,57,21,9,75,45,30,4,4,37,9,28
"2021","South Oxfordshire 017B","E01028654",640,148,84,64,463,82,278,80,144,54,39,18,21,0,60,35,25,4,4,29,8,21
"2021","South Oxfordshire 017C","E01028655",897,395,174,221,454,64,193,69,103,21,116,87,29,0,66,33,33,15,15,48,15,33
"2021","South Oxfordshire 017D","E01028656",548,123,79,44,405,109,230,66,127,37,34,15,16,3,31,15,16,1,1,20,9,11
"2021","South Oxfordshire 018A","E01028611",486,94,57,37,369,71,237,90,106,41,32,19,10,3,28,16,12,1,1,23,7,16
"2021","South Oxfordshire 018B","E01028642",560,99,58,41,436,84,270,79,153,38,45,24,15,6,34,18,16,3,3,25,9,16
"2021","South Oxfordshire 018C","E01028643",549,118,75,43,411,90,237,66,132,39,40,25,14,1,42,16,26,2,2,20,12,8
"2021","South Oxfordshire 018D","E01028645",651,183,129,54,436,151,213,75,99,39,40,27,13,0,30,19,11,2,2,32,12,20
"2021","South Oxfordshire 018E","E01028685",514,115,76,39,388,92,215,79,97,39,45,20,22,3,35,22,13,1,1,11,5,6
"2021","South Oxfordshire 018F","E01028686",519,135,67,68,365,69,203,56,101,46,43,25,13,5,49,32,17,1,1,19,8,11
"2021","South Oxfordshire 019A","E01028612",534,115,61,54,394,97,222,85,104,33,42,25,10,7,33,12,21,0,0,25,9,16
"2021","South Oxfordshire 019B","E01028660",798,173,92,81,585,106,323,104,153,66,78,42,33,3,73,43,30,5,5,40,9,31
"2021","South Oxfordshire 019C","E01028661",572,96,63,33,451,125,273,78,149,46,33,17,15,1,19,12,7,1,1,25,12,13
"2021","South Oxfordshire 019D","E01028662",542,96,64,32,428,94,260,84,136,40,45,25,14,6,26,12,14,3,3,18,8,10
"2021","South Oxfordshire 020A","E01028659",637,116,62,54,489,102,311,105,157,49,42,22,15,5,32,16,16,2,2,32,14,18
"2021","South Oxfordshire 020B","E01028663",643,160,83,77,449,71,211,51,122,38,67,32,31,4,96,59,37,4,4,34,13,21
"2021","South Oxfordshire 020C","E01028664",626,182,125,57,414,116,211,65,103,43,40,16,20,4,46,22,24,1,1,30,9,21
"2021","South Oxfordshire 020D","E01028665",576,123,85,38,433,118,224,79,102,43,51,33,13,5,39,24,15,1,1,20,7,13
"2021","Vale of White Horse 001A","E01028708",776,208,100,108,509,92,283,116,120,47,79,51,25,3,52,27,25,3,3,59,17,42
"2021","Vale of White Horse 001B","E01028709",788,194,103,91,550,124,294,89,140,65,92,74,17,1,36,16,20,4,4,44,17,27
"2021","Vale of White Horse 001C","E01028710",815,179,84,95,581,115,369,114,199,56,47,29,15,3,47,35,12,3,3,55,22,33
"2021","Vale of White Horse 001D","E01028711",676,152,90,62,483,105,255,101,113,41,69,38,23,8,54,30,24,0,0,41,21,20
"2021","Vale of White Horse 002A","E01028733",565,140,83,57,394,85,226,82,107,37,36,22,14,0,44,26,18,3,3,31,10,21
"2021","Vale of White Horse 002B","E01028734",650,178,97,81,430,82,222,79,112,31,69,37,24,8,55,30,25,2,2,42,13,29
"2021","Vale of White Horse 002C","E01028735",661,148,89,59,475,92,267,77,126,64,68,38,23,7,43,19,24,5,5,38,9,29
"2021","Vale of White Horse 002D","E01028740",678,191,94,97,422,44,257,82,145,30,80,50,23,7,34,18,16,7,7,65,14,51
"2021","Vale of White Horse 002E","E01028741",643,138,43,95,451,56,266,68,152,46,79,42,31,6,45,32,13,5,5,54,9,45
"2021","Vale of White Horse 002F","E01028742",911,300,117,183,513,78,260,106,120,34,121,81,36,4,46,24,22,8,8,98,19,79
"2021","Vale of White Horse 003A","E01028738",450,45,15,30,369,31,287,78,193,16,34,15,19,0,15,9,6,2,2,36,23,13
"2021","Vale of White Horse 003B","E01028739",928,214,108,106,674,118,362,119,186,57,111,46,58,7,81,59,22,2,2,40,11,29
"2021","Vale of White Horse 003C","E01028743",437,159,71,88,259,71,136,53,67,16,32,25,7,0,19,4,15,1,1,19,2,17
"2021","Vale of White Horse 003D","E01028744",544,140,71,69,369,69,212,80,89,43,56,33,18,5,29,8,21,3,3,35,9,26
"2021","Vale of White Horse 003E","E01028750",569,151,85,66,385,77,209,67,101,41,46,26,19,1,52,34,18,1,1,33,13,20
"2021","Vale of White Horse 003F","E01028751",587,141,75,66,407,97,249,106,97,46,40,27,11,2,21,11,10,0,0,39,12,27
"2021","Vale of White Horse 003G","E01028752",672,145,77,68,482,111,269,94,126,49,53,24,23,6,47,32,15,2,2,45,15,30
"2021","Vale of White Horse 004A","E01028693",605,119,68,51,465,99,290,86,147,57,48,27,18,3,27,8,19,1,1,21,5,16
"2021","Vale of White Horse 004B","E01028694",612,169,33,136,429,48,260,87,124,49,74,57,15,2,44,27,17,3,3,14,6,8
"2021","Vale of White Horse 004C","E01028701",639,159,77,82,437,59,239,76,130,33,62,39,19,4,72,38,34,5,5,43,13,30
"2021","Vale of White Horse 004D","E01028705",486,79,57,22,389,92,228,80,99,49,37,16,18,3,31,15,16,1,1,18,6,12
"2021","Vale of White Horse 004E","E01028706",596,142,52,90,428,93,234,83,103,48,69,46,19,4,30,14,16,2,2,26,12,14
"2021","Vale of White Horse 004F","E01028707",600,139,69,70,426,60,261,94,110,57,67,42,22,3,35,13,22,3,3,35,9,26
"2021","Vale of White Horse 005A","E01028688",502,148,60,88,332,46,198,73,94,31,57,40,16,1,28,19,9,3,3,22,7,15
"2021","Vale of White Horse 005B","E01028689",629,210,50,160,392,40,195,60,97,38,82,47,29,6,72,49,23,3,3,27,11,16
"2021","Vale of White Horse 005C","E01028695",644,142,90,52,461,104,259,76,139,44,54,34,15,5,41,21,20,3,3,41,11,30
"2021","Vale of White Horse 005D","E01028699",644,156,95,61,448,115,248,73,139,36,52,22,26,4,30,16,14,3,3,40,11,29
"2021","Vale of White Horse 006B","E01028696",541,131,93,38,381,86,236,75,123,38,31,15,14,2,28,12,16,0,0,29,8,21
"2021","Vale of White Horse 006C","E01028697",689,229,87,142,424,43,197,65,98,34,89,42,44,3,89,58,31,6,6,36,13,23
"2021","Vale of White Horse 006D","E01028698",663,217,62,155,413,50,208,77,111,20,97,70,24,3,53,32,21,5,5,33,4,29
"2021","Vale of White Horse 006E","E01028700",708,207,90,117,462,40,224,81,109,34,97,53,35,9,97,64,33,4,4,39,12,27
"2021","Vale of White Horse 006F","E01028703",850,375,133,242,414,64,156,57,78,21,103,67,33,3,83,47,36,8,8,61,8,53
"2021","Vale of White Horse 006G","E01033305",666,291,59,232,327,28,124,54,62,8,104,83,20,1,70,48,22,1,1,48,10,38
"2021","Vale of White Horse 006H","E01033306",954,433,122,311,466,74,197,77,97,23,119,95,24,0,66,46,20,10,10,55,11,44
"2021","Vale of White Horse 007A","E01028726",1164,244,124,120,854,165,481,181,240,60,135,84,46,5,70,42,28,3,3,66,25,41
"2021","Vale of White Horse 007C","E01028737",984,218,121,97,722,147,444,184,192,68,86,61,18,7,42,30,12,3,3,44,19,25
"2021","Vale of White Horse 007D","E01035753",802,151,67,84,628,71,321,97,184,40,132,66,63,3,102,92,10,2,2,23,9,14
"2021","Vale of White Horse 007E","E01035754",777,176,83,93,570,92,338,144,137,57,89,64,22,3,50,28,22,1,1,31,11,20
"2021","Vale of White Horse 008A","E01028690",712,199,86,113,478,92,219,82,87,50,86,50,29,7,77,44,33,4,4,35,8,27
"2021","Vale of White Horse 008B","E01028691",770,236,136,100,495,75,232,68,121,43,103,51,47,5,83,46,37,2,2,39,10,29
"2021","Vale of White Horse 008C","E01028692",521,115,52,63,355,31,134,27,75,32,88,38,39,11,96,61,35,6,6,51,18,33
"2021","Vale of White Horse 008D","E01028702",509,112,64,48,365,100,204,75,90,39,34,17,11,6,26,13,13,1,1,32,6,26
"2021","Vale of White Horse 008E","E01028704",879,327,175,152,496,82,230,91,100,39,101,61,34,6,77,53,24,6,6,56,15,41
"2021","Vale of White Horse 009A","E01028716",976,259,83,176,689,50,392,129,221,42,149,79,66,4,96,68,28,2,2,28,14,14
"2021","Vale of White Horse 009B","E01028717",815,366,142,224,421,58,153,56,59,38,135,92,35,8,72,49,23,3,3,28,9,19
"2021","Vale of White Horse 009C","E01028718",658,211,82,129,424,60,180,80,75,25,103,59,36,8,76,48,28,5,5,23,7,16
"2021","Vale of White Horse 009D","E01028719",665,160,107,53,479,139,238,82,114,42,64,36,25,3,37,25,12,1,1,26,11,15
"2021","Vale of White Horse 009E","E01028749",1112,292,137,155,775,132,410,157,186,67,123,76,44,3,106,57,49,4,4,45,13,32
"2021","Vale of White Horse 010B","E01028731",843,189,94,95,622,91,328,102,184,42,108,54,50,4,93,61,32,2,2,32,11,21
"2021","Vale of White Horse 010C","E01028732",703,188,59,129,480,46,236,84,113,39,130,85,37,8,65,43,22,3,3,35,16,19
"2021","Vale of White Horse 010D","E01028753",712,168,82,86,498,70,257,87,135,35,82,41,37,4,84,55,29,5,5,46,18,28
"2021","Vale of White Horse 010E","E01028754",657,149,72,77,462,79,255,86,131,38,76,43,30,3,51,32,19,1,1,46,9,37
"2021","Vale of White Horse 010F","E01035755",641,164,74,90,439,61,229,63,131,35,85,45,35,5,62,42,20,2,2,38,13,25
"2021","Vale of White Horse 010G","E01035756",619,135,75,60,449,84,246,74,121,51,72,41,30,1,42,30,12,5,5,35,12,23
"2021","Vale of White Horse 011A","E01028721",524,114,49,65,391,44,232,97,107,28,72,53,15,4,40,28,12,3,3,19,6,13
"2021","Vale of White Horse 011B","E01028722",699,219,118,101,457,107,233,91,100,42,67,43,19,5,47,24,23,3,3,23,8,15
"2021","Vale of White Horse 011C","E01028723",931,235,105,130,658,112,274,82,145,47,158,94,61,3,109,80,29,5,5,38,9,29
"2021","Vale of White Horse 011D","E01028724",513,120,70,50,363,80,174,64,68,42,58,26,28,4,50,24,26,1,1,30,6,24
"2021","Vale of White Horse 011E","E01028725",1161,273,66,207,846,49,433,149,229,55,230,128,95,7,131,93,38,3,3,42,10,32
"2021","Vale of White Horse 014A","E01028755",784,225,127,98,518,85,276,96,132,48,89,53,28,8,65,39,26,3,3,41,7,34
"2021","Vale of White Horse 014C","E01028758",694,160,104,56,498,103,257,73,132,52,65,38,24,3,69,40,29,4,4,36,11,25
"2021","Vale of White Horse 014D","E01028759",727,172,79,93,531,59,280,104,120,56,103,56,41,6,83,51,32,6,6,24,7,17
"2021","Vale of White Horse 014E","E01028760",488,114,69,45,345,64,176,63,84,29,60,31,25,4,45,22,23,0,0,29,10,19
"2021","Vale of White Horse 014F","E01028761",513,112,48,64,393,84,198,65,99,34,54,24,26,4,55,30,25,2,2,8,3,5
"2021","Vale of White Horse 014G","E01035757",599,293,83,210,283,34,108,55,47,6,83,51,28,4,55,36,19,3,3,23,4,19
"2021","Vale of White Horse 014H","E01035758",657,336,160,176,290,59,121,59,53,9,72,53,16,3,38,28,10,0,0,31,7,24
"2021","Vale of White Horse 015A","E01028712",947,291,183,108,609,134,349,133,160,56,77,54,19,4,49,22,27,0,0,47,18,29
"2021","Vale of White Horse 015C","E01028728",534,129,61,68,382,64,203,72,103,28,60,30,30,0,53,36,17,2,2,23,9,14
"2021","Vale of White Horse 015D","E01028729",726,144,62,82,560,58,334,105,199,30,93,50,39,4,73,51,22,2,2,22,8,14
"2021","Vale of White Horse 015E","E01028730",666,161,77,84,478,102,284,96,129,59,53,29,24,0,35,11,24,4,4,27,11,16
"2021","Vale of White Horse 015F","E01028757",958,332,130,202,579,74,287,94,133,60,105,58,43,4,110,78,32,3,3,47,19,28
"2021","Vale of White Horse 015G","E01035759",616,142,62,80,448,59,264,87,143,34,82,50,29,3,42,26,16,1,1,26,9,17
"2021","Vale of White Horse 015H","E01035760",625,152,42,110,440,17,255,63,182,10,114,66,48,0,54,43,11,0,0,33,15,18
"2021","Vale of White Horse 015I","E01035761",610,105,42,63,473,43,269,68,177,24,107,61,44,2,51,43,8,3,3,32,10,22
"2021","Vale of White Horse 016E","E01028713",1063,255,115,140,760,148,431,176,190,65,114,67,41,6,65,36,29,2,2,48,20,28
"2021","Vale of White Horse 016F","E01028715",941,206,62,144,711,104,381,134,205,42,130,79,48,3,92,67,25,4,4,24,7,17
"2021","Vale of White Horse 016G","E01028720",1116,309,182,127,751,150,417,164,176,77,92,51,35,6,89,57,32,3,3,56,18,38
"2021","Vale of White Horse 016A","E01028745",731,205,112,93,493,95,253,127,98,28,86,53,32,1,58,42,16,1,1,33,13,20
"2021","Vale of White Horse 016B","E01028746",651,163,94,69,457,104,254,80,122,52,62,28,32,2,37,25,12,0,0,31,15,16
"2021","Vale of White Horse 016C","E01028747",561,85,25,60,459,37,317,119,169,29,67,38,27,2,38,29,9,0,0,17,12,5
"2021","Vale of White Horse 016D","E01028748",563,154,56,98,388,29,236,79,136,21,56,27,29,0,64,53,11,3,3,21,6,15
"2021","West Oxfordshire 001A","E01028780",1029,350,161,189,631,141,283,120,120,43,119,73,40,6,80,54,26,8,8,48,17,31
"2021","West Oxfordshire 001B","E01028781",727,178,90,88,522,57,223,62,111,50,114,46,61,7,124,91,33,4,4,27,13,14
"2021","West Oxfordshire 001C","E01028782",666,183,109,74,463,101,248,89,110,49,67,39,24,4,44,24,20,3,3,20,8,12
"2021","West Oxfordshire 001D","E01028783",833,358,190,168,446,98,182,81,74,27,87,61,21,5,72,41,31,7,7,29,10,19
"2021","West Oxfordshire 002A","E01028795",679,171,92,79,459,99,242,103,95,44,65,39,23,3,50,22,28,3,3,49,15,34
"2021","West Oxfordshire 002B","E01028796",526,167,76,91,334,59,177,68,82,27,52,26,19,7,40,21,19,6,6,25,6,19
"2021","West Oxfordshire 002C","E01028797",527,155,72,83,347,66,193,73,82,38,54,26,23,5,33,21,12,1,1,25,6,19
"2021","West Oxfordshire 002D","E01028806",826,196,91,105,595,120,326,128,144,54,91,49,35,7,57,34,23,1,1,35,12,23
"2021","West Oxfordshire 003A","E01028763",911,220,119,101,654,169,360,146,155,59,70,38,27,5,54,31,23,1,1,37,12,25
"2021","West Oxfordshire 003B","E01028776",826,234,116,118,556,110,318,132,121,65,73,42,27,4,45,23,22,10,10,36,17,19
"2021","West Oxfordshire 003C","E01028798",988,294,188,106,665,150,347,117,170,60,89,44,33,12,75,42,33,4,4,29,13,16
"2021","West Oxfordshire 004B","E01028804",601,136,77,59,442,91,230,79,106,45,72,42,27,3,47,23,24,2,2,23,10,13
"2021","West Oxfordshire 004D","E01028823",650,255,124,131,360,75,174,82,77,15,71,54,17,0,36,16,20,4,4,35,10,25
"2021","West Oxfordshire 004E","E01028824",799,234,124,110,531,77,264,69,147,48,103,49,45,9,82,60,22,5,5,34,13,21
"2021","West Oxfordshire 004F","E01028825",566,150,86,64,393,84,216,75,117,24,52,33,18,1,41,23,18,0,0,23,7,16
"2021","West Oxfordshire 004I","E01034751",646,170,98,72,446,68,241,83,116,42,68,39,22,7,64,44,20,5,5,30,8,22
"2021","West Oxfordshire 004H","E01035762",626,164,87,77,439,95,228,79,108,41,72,35,34,3,43,29,14,1,1,23,10,13
"2021","West Oxfordshire 005A","E01028777",552,194,91,103,339,78,177,70,72,35,49,27,16,6,34,21,13,1,1,19,8,11
"2021","West Oxfordshire 005B","E01028778",687,249,161,88,419,97,202,67,97,38,58,20,35,3,59,27,32,3,3,19,6,13
"2021","West Oxfordshire 005C","E01028779",488,119,79,40,343,75,187,82,84,21,45,21,20,4,36,18,18,0,0,26,10,16
"2021","West Oxfordshire 005D","E01028799",894,189,108,81,659,133,361,148,139,74,98,53,37,8,67,32,35,0,0,46,14,32
"2021","West Oxfordshire 006A","E01028788",867,282,151,131,539,112,286,97,150,39,72,40,31,1,67,47,20,2,2,46,14,32
"2021","West Oxfordshire 006B","E01028789",807,197,105,92,578,113,308,115,138,55,91,59,31,1,65,40,25,1,1,32,13,19
"2021","West Oxfordshire 006C","E01028790",631,129,65,64,476,76,249,71,128,50,83,45,36,2,65,49,16,3,3,26,7,19
"2021","West Oxfordshire 006D","E01028791",609,124,76,48,463,121,260,102,103,55,48,24,20,4,32,13,19,2,2,22,9,13
"2021","West Oxfordshire 007A","E01028784",1022,239,119,120,735,137,381,143,152,86,116,66,48,2,96,60,36,5,5,48,17,31
"2021","West Oxfordshire 007B","E01028792",459,103,62,41,335,86,194,69,82,43,32,21,11,0,19,4,15,4,4,21,6,15
"2021","West Oxfordshire 007C","E01028793",634,154,75,79,452,70,268,110,111,47,63,33,27,3,47,25,22,4,4,28,16,12
"2021","West Oxfordshire 007D","E01028794",608,131,82,49,444,110,237,98,82,57,56,33,17,6,40,25,15,1,1,33,12,21
"2021","West Oxfordshire 008A","E01028810",590,203,68,135,367,39,203,73,85,45,74,48,23,3,44,27,17,7,7,20,9,11
"2021","West Oxfordshire 008B","E01028811",612,197,105,92,381,49,179,64,81,34,79,33,42,4,72,45,27,2,2,34,12,22
"2021","West Oxfordshire 008D","E01028813",516,131,57,74,354,41,173,50,77,46,66,38,21,7,72,47,25,2,2,31,9,22
"2021","West Oxfordshire 008E","E01028814",654,202,110,92,412,76,208,84,87,37,81,51,27,3,43,18,25,4,4,40,12,28
"2021","West Oxfordshire 008F","E01028815",516,102,74,28,408,124,223,102,84,37,34,16,16,2,27,9,18,0,0,6,2,4
"2021","West Oxfordshire 008G","E01032947",718,184,30,154,492,24,255,56,176,23,123,54,66,3,87,70,17,3,3,42,14,28
"2021","West Oxfordshire 008H","E01032948",740,161,70,91,548,82,315,90,183,42,78,46,26,6,69,51,18,4,4,31,15,16
"2021","West Oxfordshire 008I","E01032952",628,214,110,104,377,79,173,69,80,24,82,52,28,2,42,20,22,1,1,37,9,28
"2021","West Oxfordshire 009A","E01028809",535,130,83,47,371,54,142,42,64,36,58,15,34,9,113,78,35,4,4,34,17,17
"2021","West Oxfordshire 009B","E01028820",1135,264,106,158,824,64,423,133,232,58,220,135,79,6,112,85,27,5,5,47,12,35
"2021","West Oxfordshire 009C","E01028821",636,215,57,158,399,43,200,69,92,39,97,60,32,5,53,33,20,6,6,22,4,18
"2021","West Oxfordshire 009D","E01028822",642,193,92,101,419,62,223,93,100,30,90,54,30,6,43,23,20,1,1,30,9,21
"2021","West Oxfordshire 010A","E01028807",1060,420,166,254,559,101,208,90,86,32,143,106,33,4,95,59,36,12,12,81,13,68
"2021","West Oxfordshire 010B","E01028808",969,240,109,131,670,94,283,97,129,57,146,73,66,7,140,100,40,7,7,59,20,39
"2021","West Oxfordshire 010C","E01028816",492,98,58,40,350,62,200,70,82,48,49,25,18,6,36,14,22,3,3,44,17,27
"2021","West Oxfordshire 010D","E01028817",599,158,73,85,400,62,197,70,81,46,86,48,29,9,52,23,29,3,3,41,15,26
"2021","West Oxfordshire 010E","E01028818",867,378,220,158,437,91,172,82,66,24,100,73,23,4,59,29,30,15,15,52,7,45
"2021","West Oxfordshire 010F","E01028819",895,352,206,146,485,94,222,73,107,42,78,39,34,5,86,50,36,5,5,58,12,46
"2021","West Oxfordshire 011A","E01028785",704,210,122,88,460,77,221,82,85,54,93,59,29,5,66,32,34,3,3,34,11,23
"2021","West Oxfordshire 011B","E01028786",617,157,97,60,435,102,214,71,100,43,59,20,36,3,58,40,18,2,2,25,8,17
"2021","West Oxfordshire 011C","E01028787",602,171,86,85,402,80,184,59,91,34,55,29,24,2,81,47,34,2,2,29,9,20
"2021","West Oxfordshire 011D","E01028800",624,156,73,83,441,68,234,102,95,37,76,45,26,5,63,39,24,0,0,27,10,17
"2021","West Oxfordshire 012A","E01028762",770,184,78,106,559,88,331,141,128,62,77,54,20,3,57,35,22,6,6,27,4,23
"2021","West Oxfordshire 012C","E01028767",888,295,185,110,556,168,250,128,78,44,74,39,29,6,61,32,29,3,3,37,11,26
"2021","West Oxfordshire 012D","E01035255",505,152,73,79,335,68,191,81,72,38,56,43,12,1,19,11,8,1,1,18,5,13
"2021","West Oxfordshire 012E","E01035565",480,105,35,70,355,32,175,59,93,23,97,56,39,2,48,32,16,3,3,20,9,11
"2021","West Oxfordshire 013D","E01028772",1001,232,80,152,726,78,384,147,186,51,170,98,66,6,89,62,27,5,5,43,24,19
"2021","West Oxfordshire 013E","E01032949",560,137,18,119,396,16,209,63,110,36,91,53,36,2,72,54,18,8,8,27,7,20
"2021","West Oxfordshire 013F","E01032950",664,155,14,141,471,17,258,70,148,40,104,59,40,5,89,63,26,3,3,38,9,29
"2021","West Oxfordshire 013G","E01032951",745,103,34,69,610,47,394,115,231,48,80,43,29,8,85,56,29,4,4,32,14,18
"2021","West Oxfordshire 013H","E01032953",901,132,63,69,743,78,478,139,304,35,124,74,47,3,59,41,18,4,4,26,11,15
"2021","West Oxfordshire 014A","E01028771",675,218,101,117,424,71,217,91,81,45,77,41,32,4,58,29,29,1,1,33,6,27
"2021","West Oxfordshire 014B","E01028773",603,176,88,88,390,73,189,84,58,47,66,36,25,5,58,36,22,4,4,37,12,25
"2021","West Oxfordshire 014C","E01028774",564,115,45,70,419,36,288,68,188,32,51,27,24,0,43,23,20,1,1,30,12,18
"2021","West Oxfordshire 014D","E01028775",564,180,87,93,361,66,209,83,72,54,57,38,17,2,29,14,15,0,0,23,5,18
"2021","West Oxfordshire 015A","E01028764",762,214,124,90,521,111,271,107,106,58,81,52,23,6,51,27,24,7,7,27,8,19
"2021","West Oxfordshire 015B","E01028765",1005,237,140,97,723,136,364,127,179,58,133,65,55,13,85,55,30,5,5,45,13,32
"2021","West Oxfordshire 015C","E01028801",614,143,89,54,448,87,261,88,129,44,59,30,24,5,38,22,16,3,3,23,10,13
"2021","West Oxfordshire 015D","E01028802",653,165,88,77,452,106,258,88,118,52,54,41,12,1,31,16,15,3,3,36,12,24
"2021","Elmbridge 001A","E01030330",656,176,113,63,451,66,251,66,150,35,62,30,23,9,68,38,30,4,4,29,7,22
"2021","Elmbridge 001B","E01030331",687,180,89,91,463,71,251,83,133,35,66,40,26,0,73,36,37,2,2,44,19,25
"2021","Elmbridge 001C","E01030332",612,145,79,66,424,45,229,61,127,41,59,21,32,6,87,48,39,4,4,43,22,21
"2021","Elmbridge 001D","E01030333",587,147,92,55,398,64,228,59,124,45,47,22,23,2,58,31,27,1,1,42,14,28
"2021","Elmbridge 002A","E01030326",818,283,95,188,483,67,242,93,115,34,115,96,19,0,50,30,20,9,9,52,11,41
"2021","Elmbridge 002B","E01030327",802,201,82,119,562,91,321,82,190,49,83,45,36,2,65,41,24,2,2,39,9,30
"2021","Elmbridge 002C","E01030328",628,112,71,41,487,72,320,79,188,53,52,33,17,2,39,25,14,4,4,29,10,19
"2021","Elmbridge 002D","E01030329",680,191,87,104,463,86,253,89,131,33,69,36,31,2,51,29,22,4,4,26,9,17
"2021","Elmbridge 003A","E01030334",588,138,74,64,400,52,235,68,122,45,46,21,24,1,59,35,24,8,8,50,24,26
"2021","Elmbridge 003B","E01030335",759,227,115,112,498,46,278,66,161,51,90,51,35,4,80,48,32,4,4,34,16,18
"2021","Elmbridge 003C","E01030336",798,218,95,123,536,33,281,70,167,44,103,49,49,5,114,64,50,5,5,44,18,26
"2021","Elmbridge 003D","E01030337",771,297,132,165,439,35,231,57,144,30,80,46,29,5,90,56,34,3,3,35,18,17
"2021","Elmbridge 004A","E01030361",927,231,104,127,640,62,337,101,190,46,140,80,53,7,97,53,44,4,4,56,24,32
"2021","Elmbridge 004B","E01030362",580,158,59,99,381,32,155,41,94,20,69,33,32,4,120,81,39,5,5,41,18,23
"2021","Elmbridge 004C","E01030363",814,261,75,186,506,48,251,68,140,43,99,57,39,3,102,67,35,6,6,47,15,32
"2021","Elmbridge 004D","E01030364",749,274,64,210,448,14,196,69,101,26,107,71,34,2,125,83,42,6,6,27,12,15
"2021","Elmbridge 005A","E01030350",716,166,82,84,519,72,305,86,193,26,85,55,27,3,52,34,18,5,5,31,6,25
"2021","Elmbridge 005B","E01030351",620,142,72,70,458,40,285,67,181,37,79,40,39,0,51,31,20,3,3,20,4,16
"2021","Elmbridge 005C","E01030352",608,144,74,70,432,56,266,61,169,36,61,35,22,4,47,30,17,2,2,32,16,16
"2021","Elmbridge 005D","E01030353",545,98,56,42,430,50,287,55,189,43,54,26,28,0,38,22,16,1,1,17,7,10
"2021","Elmbridge 006A","E01030322",772,220,88,132,521,42,328,93,207,28,84,59,23,2,65,41,24,2,2,31,11,20
"2021","Elmbridge 006B","E01030323",527,111,61,50,387,58,240,59,140,41,46,32,13,1,35,20,15,8,8,29,9,20
"2021","Elmbridge 006C","E01030324",641,152,89,63,464,39,285,71,178,36,78,46,28,4,58,32,26,4,4,25,13,12
"2021","Elmbridge 006D","E01030325",589,134,82,52,417,59,269,65,170,34,31,9,17,5,54,37,17,4,4,38,18,20
"2021","Elmbridge 007A","E01030357",739,241,129,112,469,84,249,78,137,34,83,54,26,3,49,27,22,4,4,29,12,17
"2021","Elmbridge 007B","E01030358",694,227,141,86,432,75,247,65,155,27,58,39,17,2,48,31,17,4,4,35,9,26
"2021","Elmbridge 007D","E01030360",724,199,106,93,482,75,258,67,143,48,79,51,24,4,64,46,18,6,6,43,11,32
"2021","Elmbridge 007E","E01034285",603,330,90,240,254,28,81,36,37,8,91,75,14,2,52,41,11,2,2,19,2,17
"2021","Elmbridge 007F","E01034286",636,159,41,118,435,52,249,61,164,24,64,38,23,3,66,40,26,4,4,42,12,30
"2021","Elmbridge 008A","E01030354",660,146,44,102,470,26,198,42,124,32,90,32,46,12,151,113,38,5,5,44,19,25
"2021","Elmbridge 008B","E01030355",533,105,54,51,408,40,277,68,166,43,44,29,14,1,45,22,23,2,2,20,5,15
"2021","Elmbridge 008C","E01030356",515,78,50,28,408,41,252,49,162,41,54,31,19,4,57,36,21,4,4,29,12,17
"2021","Elmbridge 008D","E01030365",609,139,53,86,442,49,270,77,150,43,76,46,26,4,44,22,22,3,3,28,12,16
"2021","Elmbridge 008E","E01030368",613,115,66,49,477,65,323,82,198,43,53,33,18,2,32,23,9,4,4,21,8,13
"2021","Elmbridge 009A","E01030319",671,91,50,41,543,66,387,65,263,59,41,16,20,5,49,30,19,0,0,37,15,22
"2021","Elmbridge 009B","E01030320",694,201,123,78,458,56,280,46,183,51,48,26,18,4,72,44,28,2,2,35,13,22
"2021","Elmbridge 009C","E01030321",564,97,76,21,431,74,296,70,180,46,33,13,18,2,27,11,16,1,1,36,20,16
"2021","Elmbridge 009D","E01030369",775,109,73,36,642,100,452,113,268,71,53,30,22,1,36,16,20,1,1,24,8,16
"2021","Elmbridge 009E","E01030370",620,127,58,69,471,55,331,75,211,45,46,26,17,3,38,25,13,1,1,22,5,17
"2021","Elmbridge 010A","E01030313",858,225,78,147,590,41,337,80,219,38,117,71,46,0,89,62,27,6,6,43,19,24
"2021","Elmbridge 010B","E01030314",733,209,112,97,497,72,293,75,189,29,78,54,22,2,53,31,22,1,1,27,10,17
"2021","Elmbridge 010C","E01030366",898,318,126,192,530,45,244,67,143,34,124,91,25,8,101,65,36,16,16,50,22,28
"2021","Elmbridge 010D","E01030367",626,129,76,53,472,99,301,76,182,43,35,16,18,1,33,18,15,4,4,25,11,14
"2021","Elmbridge 011A","E01030338",636,131,80,51,487,92,299,46,205,48,43,26,15,2,53,35,18,0,0,18,8,10
"2021","Elmbridge 011B","E01030339",760,330,175,155,411,72,192,56,123,13,75,54,17,4,69,51,18,3,3,19,9,10
"2021","Elmbridge 011C","E01030340",651,195,102,93,430,64,267,59,168,40,47,30,16,1,47,26,21,5,5,26,11,15
"2021","Elmbridge 011D","E01030341",752,182,98,84,540,97,350,84,210,56,48,29,18,1,40,22,18,5,5,30,15,15
"2021","Elmbridge 012A","E01030371",727,267,95,172,422,37,211,69,112,30,73,41,29,3,95,53,42,6,6,38,15,23
"2021","Elmbridge 012B","E01030372",586,194,95,99,369,36,236,54,148,34,49,30,16,3,43,25,18,5,5,23,5,18
"2021","Elmbridge 012C","E01030373",668,182,68,114,458,45,274,80,165,29,67,41,21,5,68,42,26,4,4,28,9,19
"2021","Elmbridge 012D","E01030374",801,294,133,161,474,57,277,87,163,27,75,54,20,1,55,34,21,10,10,33,14,19
"2021","Elmbridge 012E","E01030375",857,325,115,210,495,43,285,77,180,28,111,83,25,3,50,33,17,6,6,37,10,27
"2021","Elmbridge 012F","E01030376",539,153,73,80,369,46,218,46,149,23,60,44,15,1,38,23,15,7,7,17,5,12
"2021","Elmbridge 013A","E01030307",725,170,71,99,526,84,345,94,197,54,54,36,16,2,40,24,16,3,3,29,13,16
"2021","Elmbridge 013B","E01030308",675,165,93,72,468,110,284,71,163,50,38,25,11,2,34,16,18,2,2,42,23,19
"2021","Elmbridge 013C","E01030309",649,152,95,57,469,102,293,94,152,47,37,13,18,6,33,19,14,4,4,28,10,18
"2021","Elmbridge 013D","E01030310",754,199,61,138,505,44,250,67,144,39,103,53,42,8,105,59,46,3,3,50,19,31
"2021","Elmbridge 014A","E01030311",653,202,104,98,416,38,209,61,118,30,82,44,36,2,84,51,33,3,3,35,18,17
"2021","Elmbridge 014B","E01030312",580,129,48,81,406,28,207,55,122,30,81,49,27,5,87,49,38,3,3,45,23,22
"2021","Elmbridge 014C","E01030315",621,124,65,59,456,51,279,58,168,53,70,29,38,3,56,30,26,0,0,41,16,25
"2021","Elmbridge 014D","E01030316",637,140,68,72,463,86,295,70,183,42,54,31,21,2,25,21,4,3,3,34,20,14
"2021","Elmbridge 014E","E01030317",865,306,150,156,528,66,286,66,183,37,87,51,31,5,81,43,38,8,8,31,13,18
"2021","Elmbridge 014F","E01030318",664,308,274,34,322,93,198,42,118,38,11,5,6,0,20,11,9,0,0,34,18,16
"2021","Elmbridge 015A","E01030296",670,109,84,25,538,111,353,85,216,52,38,24,13,1,35,18,17,1,1,23,9,14
"2021","Elmbridge 015B","E01030297",833,197,113,84,605,102,360,101,200,59,78,50,23,5,60,28,32,5,5,31,14,17
"2021","Elmbridge 015C","E01030298",672,222,148,74,423,62,256,51,157,48,41,22,14,5,64,37,27,0,0,27,14,13
"2021","Elmbridge 015D","E01030299",635,130,76,54,470,60,278,62,163,53,63,32,28,3,67,38,29,2,2,35,15,20
"2021","Elmbridge 016A","E01030346",512,116,38,78,345,40,229,65,124,40,46,29,14,3,26,20,6,4,4,51,20,31
"2021","Elmbridge 016B","E01030347",706,192,40,152,488,27,306,83,177,46,72,46,24,2,80,57,23,3,3,26,11,15
"2021","Elmbridge 016C","E01030348",687,193,72,121,463,73,286,88,156,42,65,43,20,2,37,26,11,2,2,31,16,15
"2021","Elmbridge 016D","E01030349",715,215,100,115,470,97,290,91,161,38,45,30,13,2,35,19,16,3,3,30,14,16
"2021","Elmbridge 017A","E01030300",771,326,186,140,412,43,203,42,128,33,83,52,26,5,74,56,18,9,9,33,9,24
"2021","Elmbridge 017B","E01030301",621,151,84,67,442,83,273,69,164,40,43,22,18,3,40,24,16,3,3,28,15,13
"2021","Elmbridge 017C","E01030302",823,322,183,139,462,102,239,76,131,32,64,47,14,3,52,34,18,5,5,39,13,26
"2021","Elmbridge 017D","E01030304",690,204,84,120,437,33,197,49,104,44,82,42,38,2,121,80,41,4,4,49,23,26
"2021","Elmbridge 017E","E01030305",496,52,34,18,416,81,294,72,187,35,15,4,9,2,26,19,7,0,0,28,14,14
"2021","Elmbridge 017F","E01030306",497,85,47,38,379,54,257,45,160,52,31,10,19,2,33,21,12,4,4,33,20,13
"2021","Elmbridge 018A","E01030303",692,162,85,77,504,112,305,87,180,38,51,34,13,4,36,23,13,0,0,26,11,15
"2021","Elmbridge 018B","E01030342",677,156,96,60,476,85,321,99,173,49,29,17,8,4,38,24,14,3,3,45,24,21
"2021","Elmbridge 018C","E01030343",684,129,73,56,509,82,319,88,188,43,60,31,27,2,46,28,18,2,2,46,23,23
"2021","Elmbridge 018D","E01030344",535,78,40,38,435,77,320,76,186,58,19,12,6,1,17,8,9,2,2,22,11,11
"2021","Elmbridge 018E","E01030345",636,133,81,52,480,72,317,78,198,41,40,21,18,1,48,37,11,3,3,23,12,11
"2021","Epsom and Ewell 001A","E01030386",534,81,61,20,407,89,260,69,127,64,31,21,8,2,27,12,15,0,0,46,22,24
"2021","Epsom and Ewell 001B","E01030387",619,137,69,68,439,44,255,74,131,50,78,35,35,8,56,31,25,6,6,43,13,30
"2021","Epsom and Ewell 001C","E01030388",517,112,75,37,363,67,218,69,102,47,27,15,9,3,47,19,28,4,4,42,22,20
"2021","Epsom and Ewell 001D","E01030389",650,205,105,100,396,59,215,49,113,53,55,33,19,3,63,31,32,4,4,49,21,28
"2021","Epsom and Ewell 001E","E01030393",815,228,137,91,522,132,263,68,127,68,67,26,29,12,56,21,35,4,4,65,29,36
"2021","Epsom and Ewell 002A","E01030394",664,127,78,49,494,67,312,69,160,83,63,20,33,10,50,27,23,2,2,43,25,18
"2021","Epsom and Ewell 002B","E01030399",973,285,114,171,622,56,301,75,164,62,130,65,58,7,127,70,57,8,8,66,44,22
"2021","Epsom and Ewell 002C","E01030400",588,131,48,83,397,18,192,37,117,38,57,14,37,6,118,74,44,12,12,60,32,28
"2021","Epsom and Ewell 002D","E01030414",513,127,62,65,351,29,200,45,110,45,53,16,31,6,68,32,36,1,1,35,13,22
"2021","Epsom and Ewell 003A","E01030377",881,156,118,38,665,147,412,92,227,93,59,19,33,7,41,12,29,6,6,60,27,33
"2021","Epsom and Ewell 003B","E01030378",641,117,66,51,480,69,269,69,152,48,75,42,27,6,62,20,42,5,5,44,20,24
"2021","Epsom and Ewell 003C","E01030406",603,132,72,60,439,65,261,60,151,50,56,28,19,9,54,24,30,3,3,32,8,24
"2021","Epsom and Ewell 003D","E01030407",538,105,73,32,394,90,244,62,122,60,27,14,12,1,32,13,19,1,1,39,18,21
"2021","Epsom and Ewell 003E","E01030408",635,90,71,19,507,101,336,80,183,73,36,14,14,8,33,11,22,1,1,38,20,18
"2021","Epsom and Ewell 004A","E01030395",732,194,149,45,500,139,255,73,122,60,51,26,18,7,51,19,32,4,4,38,15,23
"2021","Epsom and Ewell 004B","E01030413",710,120,61,59,537,49,315,69,186,60,78,32,39,7,90,57,33,5,5,53,22,31
"2021","Epsom and Ewell 004C","E01030415",615,101,52,49,465,49,300,82,170,48,59,17,37,5,53,26,27,4,4,49,13,36
"2021","Epsom and Ewell 004D","E01030416",524,107,67,40,380,71,221,45,124,52,51,24,24,3,33,16,17,4,4,37,13,24
"2021","Epsom and Ewell 005B","E01030384",972,179,60,119,708,31,424,84,281,59,121,46,68,7,126,82,44,6,6,85,30,55
"2021","Epsom and Ewell 005C","E01030401",1010,252,132,120,700,104,405,116,220,69,86,52,30,4,102,54,48,3,3,58,23,35
"2021","Epsom and Ewell 005D","E01030402",938,227,66,161,661,54,385,80,265,40,101,60,38,3,115,86,29,6,6,50,24,26
"2021","Epsom and Ewell 005E","E01034287",588,129,32,97,413,13,232,47,165,20,73,36,35,2,88,65,23,7,7,46,26,20
"2021","Epsom and Ewell 005F","E01034288",510,110,50,60,334,26,178,37,97,44,45,20,20,5,80,37,43,5,5,66,29,37
"2021","Epsom and Ewell 007A","E01030385",705,245,111,134,401,27,176,36,100,40,67,27,35,5,127,75,52,4,4,59,29,30
"2021","Epsom and Ewell 007B","E01030391",836,268,120,148,522,52,285,105,142,38,94,54,35,5,84,49,35,7,7,46,12,34
"2021","Epsom and Ewell 007C","E01030403",617,108,68,40,472,81,265,64,159,42,55,26,27,2,67,46,21,4,4,37,13,24
"2021","Epsom and Ewell 007D","E01030404",633,140,94,46,465,97,264,71,154,39,45,24,19,2,58,31,27,1,1,28,8,20
"2021","Epsom and Ewell 007E","E01030409",558,108,61,47,351,49,186,44,104,38,45,31,13,1,62,29,33,9,9,99,31,68
"2021","Epsom and Ewell 007F","E01030410",760,227,54,173,478,17,239,69,153,17,121,79,39,3,97,56,41,4,4,55,12,43
"2021","Epsom and Ewell 008A","E01030381",625,213,136,77,387,67,229,74,125,30,52,31,19,2,37,23,14,2,2,25,12,13
"2021","Epsom and Ewell 008C","E01030412",956,354,168,186,537,43,238,91,128,19,140,99,41,0,110,70,40,6,6,65,17,48
"2021","Epsom and Ewell 008D","E01030419",751,228,130,98,477,83,272,58,171,43,62,42,18,2,57,39,18,3,3,46,15,31
"2021","Epsom and Ewell 008E","E01034289",767,382,136,246,344,21,161,61,91,9,81,59,22,0,73,50,23,8,8,41,3,38
"2021","Epsom and Ewell 008F","E01034290",596,233,97,136,291,20,144,48,82,14,70,49,18,3,53,41,12,4,4,72,9,63
"2021","Epsom and Ewell 009A","E01030379",478,113,67,46,340,54,216,55,125,36,44,23,19,2,26,14,12,0,0,25,11,14
"2021","Epsom and Ewell 009B","E01030380",516,97,64,33,394,69,258,45,156,57,39,20,16,3,26,11,15,2,2,25,4,21
"2021","Epsom and Ewell 009C","E01030405",693,155,74,81,509,54,288,62,177,49,86,44,36,6,81,41,40,0,0,29,13,16
"2021","Epsom and Ewell 009D","E01030417",517,105,70,35,396,92,253,64,149,40,31,13,17,1,20,9,11,0,0,16,8,8
"2021","Epsom and Ewell 009E","E01030418",578,103,59,44,440,60,267,74,138,55,58,38,15,5,51,23,28,4,4,35,12,23
"2021","Epsom and Ewell 009F","E01030420",529,140,86,54,353,41,195,59,104,32,59,31,24,4,55,29,26,3,3,36,13,23
"2021","Epsom and Ewell 010A","E01030382",603,148,59,89,426,79,253,60,153,40,61,43,15,3,29,16,13,4,4,29,16,13
"2021","Epsom and Ewell 010B","E01030390",845,272,148,124,531,68,253,80,148,25,98,52,35,11,106,69,37,6,6,42,25,17
"2021","Epsom and Ewell 010C","E01030392",847,242,126,116,546,95,317,81,168,68,70,45,19,6,59,31,28,5,5,59,19,40
"2021","Epsom and Ewell 010D","E01030396",851,129,80,49,669,111,452,92,274,86,56,28,25,3,48,31,17,2,2,53,31,22
"2021","Epsom and Ewell 010E","E01030398",620,88,69,19,496,94,337,96,164,77,29,10,15,4,35,16,19,1,1,36,12,24
"2021","Epsom and Ewell 010F","E01032624",668,73,58,15,531,123,350,84,178,88,29,10,14,5,29,15,14,0,0,64,30,34
"2021","Guildford 001A","E01030440",638,124,75,49,478,90,300,112,138,50,44,19,22,3,41,28,13,3,3,36,13,23
"2021","Guildford 001B","E01030458",534,159,82,77,338,73,193,70,95,28,40,25,14,1,32,8,24,0,0,37,11,26
"2021","Guildford 001C","E01030459",577,214,104,110,331,51,159,64,64,31,57,30,22,5,62,38,24,2,2,32,11,21
"2021","Guildford 001D","E01030475",537,110,70,40,387,90,242,73,126,43,30,18,10,2,25,11,14,0,0,40,17,23
"2021","Guildford 001E","E01030476",467,81,57,24,371,109,202,57,98,47,39,24,10,5,19,6,13,2,2,15,5,10
"2021","Guildford 001F","E01030477",715,198,118,80,486,75,261,97,117,47,88,46,36,6,60,41,19,2,2,31,9,22
"2021","Guildford 002A","E01030465",602,134,82,52,442,87,243,82,103,58,63,31,29,3,46,26,20,3,3,26,11,15
"2021","Guildford 002B","E01030466",740,233,153,80,465,147,246,106,104,36,45,30,12,3,27,9,18,0,0,42,14,28
"2021","Guildford 002C","E01030473",678,144,65,79,485,81,308,102,155,51,67,39,26,2,28,16,12,1,1,49,15,34
"2021","Guildford 002D","E01030474",431,35,2,33,364,5,252,68,176,8,74,38,36,0,33,27,6,0,0,32,22,10
"2021","Guildford 003A","E01030441",530,109,62,47,392,84,235,73,131,31,37,21,13,3,35,14,21,1,1,29,8,21
"2021","Guildford 003B","E01030442",552,79,66,13,455,111,297,91,149,57,25,12,12,1,21,7,14,1,1,18,4,14
"2021","Guildford 003C","E01030443",538,109,74,35,407,104,242,68,138,36,29,13,16,0,30,21,9,2,2,22,7,15
"2021","Guildford 003D","E01030444",591,118,77,41,458,96,273,60,164,49,43,13,29,1,44,24,20,2,2,15,7,8
"2021","Guildford 003E","E01030445",624,188,129,59,406,95,215,76,99,40,44,28,15,1,50,27,23,2,2,30,8,22
"2021","Guildford 003F","E01030446",527,107,67,40,380,79,227,78,108,41,31,21,9,1,31,16,15,12,12,40,15,25
"2021","Guildford 003G","E01030447",537,126,73,53,386,76,218,63,114,41,44,25,14,5,47,31,16,1,1,25,7,18
"2021","Guildford 004A","E01030426",618,155,45,110,425,42,214,62,115,37,93,47,43,3,75,49,26,1,1,38,21,17
"2021","Guildford 004B","E01030427",601,148,93,55,430,79,246,89,117,40,66,38,24,4,38,16,22,1,1,23,8,15
"2021","Guildford 004C","E01030428",535,140,54,86,370,76,182,64,79,39,68,42,19,7,41,20,21,3,3,25,11,14
"2021","Guildford 004D","E01030429",710,252,86,166,434,39,188,79,84,25,130,73,56,1,72,45,27,5,5,24,5,19
"2021","Guildford 004E","E01030430",610,153,77,76,432,108,221,87,89,45,62,32,24,6,40,14,26,1,1,25,9,16
"2021","Guildford 005A","E01030499",648,166,119,47,441,114,248,95,115,38,44,25,15,4,35,19,16,0,0,41,8,33
"2021","Guildford 005B","E01030500",612,139,74,65,397,73,227,79,113,35,46,28,16,2,42,20,22,9,9,76,19,57
"2021","Guildford 005C","E01030501",659,160,66,94,459,59,268,90,138,40,82,52,27,3,49,30,19,1,1,40,9,31
"2021","Guildford 005D","E01030502",495,129,65,64,332,66,187,59,88,40,42,21,17,4,37,21,16,0,0,34,15,19
"2021","Guildford 005E","E01030503",554,144,47,97,351,32,183,59,94,30,63,28,29,6,70,51,19,3,3,59,15,44
"2021","Guildford 005F","E01030504",490,141,98,43,318,78,187,69,86,32,33,18,12,3,20,7,13,0,0,31,12,19
"2021","Guildford 006A","E01030485",763,245,57,188,432,24,230,78,128,24,113,84,27,2,59,37,22,6,6,86,13,73
"2021","Guildford 006B","E01030487",653,190,94,96,365,39,195,57,117,21,68,47,12,9,56,34,22,7,7,98,10,88
"2021","Guildford 006C","E01030488",759,203,124,79,500,62,291,84,162,45,81,40,32,9,66,40,26,0,0,56,23,33
"2021","Guildford 006D","E01030489",950,217,83,134,659,70,390,99,233,58,108,67,36,5,88,56,32,3,3,74,21,53
"2021","Guildford 007A","E01030481",634,137,64,73,407,44,230,61,129,40,60,27,29,4,69,43,26,4,4,90,18,72
"2021","Guildford 007B","E01030482",533,113,47,66,358,37,203,60,100,43,63,33,27,3,53,30,23,2,2,62,16,46
"2021","Guildford 007C","E01030483",606,190,83,107,362,35,168,54,77,37,57,29,25,3,96,58,38,6,6,54,17,37
"2021","Guildford 007D","E01030484",685,193,66,127,393,29,201,63,103,35,78,46,25,7,76,50,26,9,9,99,17,82
"2021","Guildford 008A","E01030434",719,241,57,184,453,40,252,72,151,29,111,83,27,1,48,32,16,2,2,25,5,20
"2021","Guildford 008B","E01030435",706,121,86,35,545,87,366,70,243,53,43,21,20,2,47,29,18,2,2,40,12,28
"2021","Guildford 008C","E01030462",720,234,141,93,464,77,266,70,156,40,65,46,19,0,56,37,19,0,0,22,9,13
"2021","Guildford 008D","E01030463",620,161,73,88,432,63,246,90,119,37,66,46,20,0,52,36,16,5,5,27,11,16
"2021","Guildford 008E","E01030464",626,173,68,105,411,19,233,25,156,52,63,22,33,8,93,56,37,3,3,42,15,27
"2021","Guildford 009A","E01030486",612,137,73,64,411,50,244,66,130,48,70,42,25,3,45,19,26,2,2,64,20,44
"2021","Guildford 009B","E01030493",507,127,65,62,296,36,128,40,64,24,53,26,20,7,75,47,28,4,4,84,10,74
"2021","Guildford 009C","E01030495",666,123,55,68,323,43,175,61,81,33,45,28,14,3,51,18,33,9,9,220,9,211
"2021","Guildford 009D","E01030498",506,84,41,43,367,50,227,63,125,39,55,36,17,2,30,16,14,5,5,55,11,44
"2021","Guildford 010A","E01030424",657,218,106,112,412,54,196,58,104,34,78,39,33,6,82,47,35,2,2,27,9,18
"2021","Guildford 010B","E01030431",611,149,97,52,435,100,223,87,100,36,66,49,14,3,45,19,26,1,1,27,4,23
"2021","Guildford 010C","E01030432",629,178,80,98,408,37,202,68,94,40,88,52,30,6,74,43,31,7,7,43,17,26
"2021","Guildford 010D","E01030433",699,240,93,147,424,43,198,66,105,27,100,56,37,7,78,43,35,5,5,35,18,17
"2021","Guildford 011A","E01030436",962,295,144,151,622,84,370,85,225,60,103,69,27,7,60,43,17,5,5,45,13,32
"2021","Guildford 011B","E01030437",915,198,86,112,659,114,384,82,245,57,78,49,28,1,80,55,25,3,3,58,19,39
"2021","Guildford 011C","E01030439",653,131,83,48,485,103,312,61,192,59,30,16,11,3,38,24,14,2,2,37,15,22
"2021","Guildford 011D","E01030460",622,143,81,62,448,102,276,60,181,35,38,17,18,3,30,15,15,2,2,31,11,20
"2021","Guildford 011E","E01030461",660,138,85,53,490,99,313,92,163,58,43,23,16,4,30,19,11,5,5,32,10,22
"2021","Guildford 012A","E01030470",497,82,42,40,238,29,151,37,81,33,27,15,9,3,25,9,16,6,6,177,7,170
"2021","Guildford 012B","E01030494",651,172,82,90,344,40,156,50,68,38,62,32,22,8,82,44,38,4,4,135,28,107
"2021","Guildford 012C","E01030496",621,163,52,111,322,26,136,42,63,31,59,22,31,6,91,50,41,10,10,136,24,112
"2021","Guildford 012D","E01030497",594,130,33,97,360,10,150,48,71,31,68,30,33,5,130,95,35,2,2,104,21,83
"2021","Guildford 013A","E01030438",814,276,129,147,479,65,267,74,145,48,98,72,26,0,46,32,14,3,3,59,11,48
"2021","Guildford 013B","E01030450",1058,257,59,198,587,19,293,97,170,26,177,133,39,5,82,39,43,16,16,214,17,197
"2021","Guildford 013C","E01030451",930,335,58,277,467,20,183,88,83,12,164,123,38,3,82,55,27,18,18,128,13,115
"2021","Guildford 013D","E01030453",764,327,84,243,382,38,174,75,77,22,124,108,16,0,41,30,11,5,5,55,6,49
"2021","Guildford 013E","E01030455",961,418,106,312,463,55,193,70,102,21,148,138,9,1,49,34,15,18,18,80,7,73
"2021","Guildford 013F","E01030457",833,353,58,295,380,11,174,70,90,14,128,112,15,1,57,31,26,10,10,100,10,90
"2021","Guildford 014A","E01030421",733,161,72,89,545,98,306,115,132,59,89,60,26,3,49,27,22,3,3,27,9,18
"2021","Guildford 014B","E01030422",779,222,90,132,516,46,277,98,143,36,113,69,41,3,74,45,29,6,6,41,13,28
"2021","Guildford 014C","E01030423",730,185,85,100,517,72,271,101,113,57,110,60,40,10,60,27,33,4,4,28,10,18
"2021","Guildford 014D","E01030425",781,169,68,101,567,97,306,102,151,53,102,60,41,1,58,35,23,4,4,45,17,28
"2021","Guildford 015A","E01030452",1131,451,82,369,488,15,221,88,118,15,165,139,26,0,59,46,13,28,28,192,9,183
"2021","Guildford 015B","E01030467",634,109,76,33,488,81,332,84,194,54,38,20,17,1,31,12,19,6,6,37,12,25
"2021","Guildford 015C","E01030468",470,149,88,61,178,25,96,36,49,11,34,25,8,1,13,6,7,10,10,143,9,134
"2021","Guildford 015D","E01030469",519,84,53,31,371,47,225,61,127,37,41,19,15,7,55,31,24,3,3,64,10,54
"2021","Guildford 016A","E01030448",623,134,78,56,455,88,282,90,158,34,54,37,17,0,30,17,13,1,1,34,11,23
"2021","Guildford 016B","E01030449",703,322,140,182,324,51,139,68,57,14,89,72,14,3,38,25,13,7,7,57,4,53
"2021","Guildford 016C","E01030454",733,228,94,134,460,47,284,82,157,45,77,60,15,2,48,27,21,4,4,45,10,35
"2021","Guildford 016D","E01030456",555,81,44,37,438,105,289,90,163,36,26,14,10,2,18,9,9,0,0,36,12,24
"2021","Guildford 017A","E01030471",484,85,50,35,375,81,240,90,111,39,36,22,9,5,18,6,12,0,0,24,8,16
"2021","Guildford 017B","E01030472",508,129,61,68,348,67,204,66,103,35,40,22,13,5,36,20,16,1,1,31,14,17
"2021","Guildford 017C","E01030478",674,175,89,86,455,76,269,86,132,51,53,35,16,2,50,29,21,7,7,44,16,28
"2021","Guildford 017D","E01030479",811,252,120,132,520,59,281,85,153,43,93,62,28,3,80,54,26,7,7,39,16,23
"2021","Guildford 017E","E01030480",814,251,153,98,526,119,306,102,166,38,60,45,14,1,41,22,19,0,0,37,13,24
"2021","Guildford 018A","E01030490",702,175,104,71,486,106,287,110,126,51,42,26,10,6,48,25,23,3,3,41,11,30
"2021","Guildford 018B","E01030491",821,228,113,115,543,95,297,99,156,42,68,38,25,5,80,38,42,3,3,50,18,32
"2021","Guildford 018C","E01030492",806,165,97,68,604,142,351,127,154,70,71,41,21,9,39,18,21,1,1,37,15,22
"2021","Mole Valley 001A","E01030506",489,75,59,16,395,65,272,71,155,46,27,9,12,6,31,12,19,0,0,19,7,12
"2021","Mole Valley 001B","E01030508",515,87,64,23,406,113,255,66,139,50,19,8,10,1,19,8,11,0,0,22,11,11
"2021","Mole Valley 001C","E01030509",573,208,115,93,343,74,167,58,75,34,55,31,20,4,45,31,14,2,2,22,10,12
"2021","Mole Valley 001D","E01030513",521,103,74,29,383,65,246,51,153,42,28,14,12,2,44,22,22,0,0,35,19,16
"2021","Mole Valley 001E","E01030514",648,216,139,77,410,81,222,58,126,38,49,26,20,3,56,32,24,2,2,22,12,10
"2021","Mole Valley 002A","E01030505",633,175,93,82,427,64,254,72,143,39,57,27,25,5,50,27,23,2,2,31,11,20
"2021","Mole Valley 002B","E01030507",498,111,61,50,359,58,220,57,124,39,44,29,15,0,35,19,16,2,2,28,11,17
"2021","Mole Valley 002C","E01030511",569,103,69,34,431,87,272,80,155,37,26,13,10,3,45,29,16,1,1,35,18,17
"2021","Mole Valley 002D","E01030512",672,218,129,89,429,98,237,52,140,45,58,27,29,2,36,18,18,0,0,25,12,13
"2021","Mole Valley 003A","E01030548",893,234,62,172,589,50,282,107,133,42,166,100,61,5,89,64,25,2,2,70,28,42
"2021","Mole Valley 003B","E01030549",864,312,94,218,513,44,210,76,102,32,140,86,50,4,112,78,34,7,7,39,15,24
"2021","Mole Valley 003C","E01030550",971,472,175,297,465,50,194,71,100,23,128,90,32,6,89,62,27,4,4,34,9,25
"2021","Mole Valley 003D","E01030551",728,230,81,149,457,26,168,45,90,33,128,68,50,10,128,82,46,7,7,41,13,28
"2021","Mole Valley 004A","E01030510",732,163,121,42,542,126,306,89,162,55,50,28,17,5,60,37,23,0,0,27,13,14
"2021","Mole Valley 004B","E01030552",740,333,129,204,372,40,186,61,105,20,91,67,21,3,50,36,14,5,5,35,5,30
"2021","Mole Valley 004C","E01030553",824,313,166,147,478,116,250,97,103,50,63,42,17,4,45,22,23,4,4,33,11,22
"2021","Mole Valley 004D","E01030554",452,76,65,11,355,89,219,75,106,38,24,10,9,5,22,10,12,1,1,21,8,13
"2021","Mole Valley 005A","E01030539",699,201,98,103,455,61,259,81,113,65,72,38,30,4,63,31,32,0,0,43,21,22
"2021","Mole Valley 005B","E01030540",854,151,121,30,673,227,392,124,171,97,29,13,15,1,25,14,11,0,0,30,14,16
"2021","Mole Valley 005C","E01030541",504,86,62,24,396,109,237,91,108,38,28,17,9,2,22,6,16,0,0,22,11,11
"2021","Mole Valley 005D","E01030542",482,106,75,31,355,51,223,55,132,36,49,16,27,6,30,15,15,2,2,21,9,12
"2021","Mole Valley 005E","E01030543",636,141,85,56,469,77,282,84,149,49,65,40,22,3,44,21,23,1,1,26,7,19
"2021","Mole Valley 006A","E01030516",659,294,131,163,350,82,154,49,72,33,57,31,25,1,54,35,19,3,3,15,6,9
"2021","Mole Valley 006B","E01030517",708,176,104,72,508,132,275,94,132,49,58,34,17,7,37,17,20,6,6,24,13,11
"2021","Mole Valley 006C","E01030518",550,107,84,23,427,146,243,71,112,60,16,2,11,3,22,8,14,0,0,16,6,10
"2021","Mole Valley 006D","E01030519",667,183,106,77,457,87,237,69,123,45,56,26,24,6,73,50,23,4,4,27,9,18
"2021","Mole Valley 007A","E01030520",641,228,176,52,389,74,189,66,80,43,47,30,14,3,78,32,46,1,1,24,13,11
"2021","Mole Valley 007B","E01030521",677,208,116,92,451,91,253,76,123,54,59,28,27,4,47,26,21,1,1,18,8,10
"2021","Mole Valley 007C","E01030522",566,129,99,30,414,117,238,63,128,47,30,10,17,3,27,9,18,2,2,23,14,9
"2021","Mole Valley 007D","E01030523",531,156,89,67,358,92,195,60,101,34,37,19,13,5,33,20,13,1,1,17,6,11
"2021","Mole Valley 008A","E01030524",982,389,211,178,558,181,236,122,64,50,81,61,15,5,55,15,40,5,5,35,13,22
"2021","Mole Valley 008B","E01030525",655,172,117,55,458,113,257,97,112,48,47,27,12,8,39,20,19,2,2,25,9,16
"2021","Mole Valley 008C","E01030526",537,149,106,43,367,62,207,76,102,29,50,24,20,6,48,23,25,0,0,21,12,9
"2021","Mole Valley 008D","E01030527",665,168,108,60,461,107,266,101,113,52,44,27,13,4,44,25,19,0,0,36,12,24
"2021","Mole Valley 009A","E01030532",700,203,80,123,468,52,272,73,157,42,89,63,26,0,52,28,24,3,3,29,9,20
"2021","Mole Valley 009B","E01030533",595,151,68,83,421,76,252,76,127,49,52,36,11,5,37,17,20,4,4,23,7,16
"2021","Mole Valley 009C","E01030534",746,363,192,171,354,42,177,63,96,18,90,69,20,1,41,23,18,4,4,29,9,20
"2021","Mole Valley 009D","E01030556",800,257,122,135,513,104,296,132,113,51,68,47,18,3,43,18,25,2,2,30,7,23
"2021","Mole Valley 010A","E01030535",803,269,129,140,494,70,280,78,167,35,84,58,22,4,59,34,25,1,1,40,7,33
"2021","Mole Valley 010B","E01030536",814,279,135,144,492,106,263,98,118,47,79,51,27,1,40,25,15,4,4,43,17,26
"2021","Mole Valley 010C","E01030537",743,256,146,110,458,107,265,90,123,52,42,23,13,6,39,16,23,5,5,29,11,18
"2021","Mole Valley 010D","E01030538",840,273,99,174,503,47,237,75,123,39,125,76,44,5,89,57,32,5,5,64,19,45
"2021","Mole Valley 011A","E01030544",652,147,87,60,467,79,259,91,123,45,81,47,30,4,44,24,20,4,4,38,16,22
"2021","Mole Valley 011B","E01030545",684,230,81,149,424,62,212,77,101,34,76,50,18,8,73,38,35,1,1,30,15,15
"2021","Mole Valley 011C","E01030546",663,213,116,97,418,65,208,61,104,43,75,36,33,6,69,41,28,1,1,32,14,18
"2021","Mole Valley 011D","E01030547",713,226,87,139,457,42,172,41,91,40,88,36,46,6,153,109,44,2,2,30,18,12
"2021","Mole Valley 012A","E01030529",703,230,116,114,428,78,226,78,102,46,78,44,31,3,41,20,21,5,5,45,27,18
"2021","Mole Valley 012B","E01030555",670,144,79,65,495,92,298,110,127,61,57,32,21,4,47,20,27,1,1,31,6,25
"2021","Mole Valley 012C","E01030557",779,189,108,81,532,81,320,122,138,60,67,43,21,3,60,25,35,4,4,58,29,29
"2021","Mole Valley 012D","E01030558",938,269,144,125,628,119,336,104,163,69,96,62,31,3,74,44,30,3,3,41,8,33
"2021","Mole Valley 013A","E01030515",914,327,178,149,559,115,275,105,119,51,100,71,29,0,66,34,32,3,3,28,10,18
"2021","Mole Valley 013B","E01030528",601,172,78,94,398,97,209,84,78,47,58,33,21,4,33,19,14,1,1,31,9,22
"2021","Mole Valley 013C","E01030530",492,107,69,38,355,81,225,84,92,49,28,13,11,4,20,10,10,1,1,30,8,22
"2021","Mole Valley 013D","E01030531",945,268,131,137,607,83,360,121,158,81,99,57,33,9,61,20,41,4,4,70,24,46
"2021","Reigate and Banstead 001A","E01030603",560,105,72,33,437,96,274,66,143,65,26,16,8,2,37,15,22,4,4,18,8,10
"2021","Reigate and Banstead 001B","E01030604",675,192,99,93,462,95,250,72,127,51,55,26,22,7,61,41,20,1,1,21,11,10
"2021","Reigate and Banstead 001C","E01030605",576,84,49,35,436,43,280,60,164,56,54,22,28,4,57,31,26,2,2,56,21,35
"2021","Reigate and Banstead 001D","E01030607",738,157,91,66,538,104,341,88,171,82,41,17,21,3,50,26,24,2,2,43,19,24
"2021","Reigate and Banstead 002A","E01030559",492,118,85,33,350,108,175,34,95,46,30,18,10,2,31,13,18,6,6,24,5,19
"2021","Reigate and Banstead 002B","E01030560",762,330,202,128,397,93,159,55,83,21,72,37,30,5,73,49,24,0,0,35,14,21
"2021","Reigate and Banstead 002C","E01030561",595,203,140,63,374,92,190,72,76,42,40,25,15,0,48,24,24,4,4,18,7,11
"2021","Reigate and Banstead 002D","E01030562",574,198,80,118,354,30,173,48,97,28,66,30,26,10,84,56,28,1,1,22,10,12
"2021","Reigate and Banstead 002E","E01030563",405,60,45,15,317,61,206,55,101,50,34,12,19,3,16,11,5,0,0,28,9,19
"2021","Reigate and Banstead 002F","E01030564",521,104,69,35,396,68,242,66,118,58,36,16,18,2,49,27,22,1,1,21,8,13
"2021","Reigate and Banstead 003A","E01030606",592,102,70,32,458,96,281,77,139,65,50,28,19,3,31,9,22,0,0,32,14,18
"2021","Reigate and Banstead 003B","E01030641",630,139,94,45,458,97,267,94,104,69,43,17,19,7,51,27,24,0,0,33,14,19
"2021","Reigate and Banstead 003C","E01030642",657,145,82,63,479,87,258,60,139,59,67,28,33,6,64,38,26,3,3,33,16,17
"2021","Reigate and Banstead 003D","E01030644",490,104,72,32,354,90,208,64,94,50,26,9,13,4,26,9,17,4,4,32,10,22
"2021","Reigate and Banstead 004A","E01030565",570,138,83,55,396,84,205,62,100,43,47,24,22,1,57,31,26,3,3,36,20,16
"2021","Reigate and Banstead 004B","E01030566",548,99,56,43,424,41,256,65,138,53,65,32,29,4,60,34,26,2,2,25,8,17
"2021","Reigate and Banstead 004C","E01030567",635,109,57,52,485,94,314,113,142,59,44,28,11,5,30,12,18,3,3,41,15,26
"2021","Reigate and Banstead 004D","E01030568",598,128,72,56,442,72,262,106,109,47,67,38,25,4,40,23,17,1,1,28,14,14
"2021","Reigate and Banstead 004E","E01030569",1013,194,61,133,752,63,414,109,242,63,125,51,55,19,139,83,56,11,11,67,31,36
"2021","Reigate and Banstead 005A","E01030608",593,148,80,68,403,21,199,49,112,38,67,23,38,6,113,73,40,3,3,42,20,22
"2021","Reigate and Banstead 005B","E01030609",875,163,60,103,665,21,322,81,205,36,140,63,71,6,180,143,37,2,2,47,23,24
"2021","Reigate and Banstead 005C","E01030640",703,266,87,179,398,20,172,51,91,30,87,41,40,6,113,80,33,6,6,39,20,19
"2021","Reigate and Banstead 005D","E01030643",641,230,125,105,370,49,191,60,88,43,67,26,32,9,58,38,20,5,5,41,15,26
"2021","Reigate and Banstead 006A","E01030635",671,193,111,82,449,91,237,77,127,33,64,36,25,3,57,35,22,0,0,29,11,18
"2021","Reigate and Banstead 006B","E01030636",442,83,44,39,330,73,206,63,95,48,26,13,7,6,24,13,11,1,1,29,11,18
"2021","Reigate and Banstead 006C","E01030637",463,63,47,16,379,87,237,83,111,43,29,11,10,8,25,13,12,1,1,21,10,11
"2021","Reigate and Banstead 006D","E01030638",623,160,111,49,438,105,257,76,124,57,36,21,13,2,36,17,19,4,4,25,10,15
"2021","Reigate and Banstead 006E","E01030639",693,252,181,71,414,115,223,79,98,46,35,22,12,1,37,20,17,4,4,27,8,19
"2021","Reigate and Banstead 007A","E01030589",679,117,76,41,515,114,344,113,142,89,35,20,10,5,20,7,13,2,2,47,23,24
"2021","Reigate and Banstead 007B","E01030590",745,182,92,90,513,76,296,96,140,60,79,35,34,10,60,29,31,2,2,50,24,26
"2021","Reigate and Banstead 007C","E01030591",668,176,120,56,451,87,254,70,127,57,59,25,28,6,46,24,22,5,5,41,17,24
"2021","Reigate and Banstead 007D","E01030592",803,237,120,117,516,99,267,104,121,42,76,48,26,2,66,39,27,8,8,50,18,32
"2021","Reigate and Banstead 008A","E01030599",700,258,67,191,403,17,195,59,103,33,90,38,44,8,94,68,26,7,7,39,19,20
"2021","Reigate and Banstead 008B","E01030600",633,132,51,81,462,41,243,58,158,27,113,58,42,13,60,30,30,5,5,39,22,17
"2021","Reigate and Banstead 008C","E01030601",600,123,66,57,433,17,249,56,148,45,67,29,35,3,97,62,35,3,3,44,17,27
"2021","Reigate and Banstead 008D","E01030602",731,174,89,85,534,71,296,80,172,44,94,54,36,4,71,53,18,2,2,23,10,13
"2021","Reigate and Banstead 009A","E01030598",672,181,81,100,441,63,248,68,138,42,76,54,19,3,49,25,24,5,5,50,28,22
"2021","Reigate and Banstead 009B","E01030623",912,273,150,123,609,104,354,97,224,33,94,59,33,2,54,33,21,3,3,30,8,22
"2021","Reigate and Banstead 009C","E01030624",578,168,71,97,382,64,218,47,144,27,59,41,15,3,40,23,17,1,1,28,7,21
"2021","Reigate and Banstead 009D","E01030625",461,82,45,37,358,66,236,64,141,31,27,18,8,1,29,18,11,0,0,21,12,9
"2021","Reigate and Banstead 009E","E01030626",441,113,72,41,305,62,192,62,98,32,33,24,9,0,16,10,6,2,2,23,7,16
"2021","Reigate and Banstead 009F","E01030627",957,414,150,264,501,60,238,66,143,29,150,105,42,3,53,40,13,0,0,42,7,35
"2021","Reigate and Banstead 010A","E01030615",845,251,57,194,515,22,260,79,161,20,103,70,32,1,121,85,36,9,9,79,25,54
"2021","Reigate and Banstead 010B","E01030616",710,205,128,77,486,110,277,67,174,36,57,33,18,6,38,24,14,4,4,19,4,15
"2021","Reigate and Banstead 010C","E01030617",730,202,78,124,483,82,271,71,153,47,77,50,23,4,43,26,17,10,10,45,11,34
"2021","Reigate and Banstead 010D","E01030618",765,209,77,132,513,37,266,61,157,48,97,53,37,7,106,76,30,7,7,43,20,23
"2021","Reigate and Banstead 010E","E01030619",622,213,107,106,371,48,160,39,88,33,63,28,29,6,95,63,32,5,5,38,16,22
"2021","Reigate and Banstead 010F","E01030622",830,246,65,181,528,40,302,100,168,34,112,80,30,2,70,40,30,4,4,56,22,34
"2021","Reigate and Banstead 011A","E01030610",612,184,67,117,392,51,219,58,135,26,62,36,19,7,57,38,19,3,3,36,18,18
"2021","Reigate and Banstead 011D","E01030613",909,331,48,283,506,17,292,98,169,25,124,83,40,1,67,42,25,6,6,72,22,50
"2021","Reigate and Banstead 011E","E01030614",629,107,37,70,488,64,295,59,186,50,76,41,30,5,51,23,28,2,2,34,8,26
"2021","Reigate and Banstead 011F","E01035355",626,161,20,141,424,8,223,47,157,19,111,72,37,2,76,57,19,6,6,41,13,28
"2021","Reigate and Banstead 011G","E01035356",640,171,56,115,424,36,244,79,131,34,99,59,36,4,40,18,22,5,5,45,13,32
"2021","Reigate and Banstead 011H","E01035357",655,193,24,169,412,9,222,69,132,21,116,82,34,0,60,35,25,5,5,50,24,26
"2021","Reigate and Banstead 011I","E01035358",685,287,72,215,350,24,154,55,87,12,91,70,21,0,73,59,14,8,8,48,11,37
"2021","Reigate and Banstead 012A","E01030593",622,173,59,114,417,43,239,65,139,35,83,49,32,2,48,29,19,4,4,32,12,20
"2021","Reigate and Banstead 012B","E01030596",527,77,42,35,432,71,308,61,199,48,31,12,16,3,21,11,10,1,1,18,10,8
"2021","Reigate and Banstead 012C","E01030597",654,137,71,66,494,48,307,65,217,25,71,48,20,3,64,37,27,4,4,23,9,14
"2021","Reigate and Banstead 012D","E01030620",883,330,146,184,512,80,266,77,160,29,102,69,31,2,55,34,21,9,9,41,8,33
"2021","Reigate and Banstead 012E","E01030621",648,197,112,85,430,47,253,55,166,32,61,30,27,4,69,45,24,0,0,21,8,13
"2021","Reigate and Banstead 013A","E01030594",723,153,75,78,537,80,299,65,190,44,56,23,29,4,102,59,43,0,0,33,14,19
"2021","Reigate and Banstead 013B","E01030595",643,162,76,86,458,50,265,67,170,28,80,40,33,7,60,33,27,3,3,23,10,13
"2021","Reigate and Banstead 013C","E01030630",622,143,83,60,457,74,249,65,130,54,54,26,27,1,75,49,26,5,5,22,10,12
"2021","Reigate and Banstead 013D","E01030631",666,180,81,99,464,31,236,65,135,36,88,43,39,6,106,66,40,3,3,22,11,11
"2021","Reigate and Banstead 014A","E01030570",692,173,81,92,457,65,236,70,115,51,71,34,34,3,80,49,31,5,5,62,28,34
"2021","Reigate and Banstead 014B","E01030571",607,133,75,58,439,71,248,70,119,59,61,35,22,4,58,27,31,1,1,35,15,20
"2021","Reigate and Banstead 014C","E01030572",946,319,82,237,554,47,273,79,146,48,108,73,33,2,117,68,49,9,9,73,26,47
"2021","Reigate and Banstead 014D","E01030573",738,179,113,66,514,56,282,69,180,33,107,61,43,3,67,36,31,2,2,45,13,32
"2021","Reigate and Banstead 014E","E01030574",807,236,64,172,514,28,306,92,162,52,102,67,31,4,70,49,21,8,8,57,22,35
"2021","Reigate and Banstead 015A","E01030628",608,134,87,47,422,79,241,88,92,61,62,28,25,9,38,14,24,2,2,52,25,27
"2021","Reigate and Banstead 015B","E01030629",564,160,91,69,358,53,203,77,91,35,73,40,28,5,28,14,14,1,1,46,18,28
"2021","Reigate and Banstead 015C","E01030632",521,108,64,44,401,58,261,75,144,42,47,26,17,4,33,19,14,2,2,12,5,7
"2021","Reigate and Banstead 015D","E01030633",581,161,88,73,384,51,204,49,128,27,54,19,26,9,72,48,24,3,3,36,20,16
"2021","Reigate and Banstead 015E","E01030634",571,132,61,71,409,35,188,41,112,35,84,30,42,12,102,65,37,0,0,30,16,14
"2021","Reigate and Banstead 016B","E01030585",625,142,82,60,454,83,236,81,110,45,55,28,24,3,74,35,39,6,6,29,14,15
"2021","Reigate and Banstead 016C","E01030586",726,154,68,86,520,53,269,66,156,47,97,50,37,10,97,62,35,4,4,52,19,33
"2021","Reigate and Banstead 016D","E01030587",622,165,87,78,411,54,208,62,106,40,64,29,32,3,83,50,33,2,2,46,16,30
"2021","Reigate and Banstead 016E","E01030588",604,191,96,95,367,43,160,40,80,40,59,24,31,4,102,75,27,3,3,46,24,22
"2021","Reigate and Banstead 016F","E01035359",742,103,12,91,599,11,304,83,213,8,200,107,89,4,76,62,14,8,8,40,20,20
"2021","Reigate and Banstead 016G","E01035360",760,154,82,72,571,101,317,90,171,56,105,54,45,6,47,23,24,1,1,35,12,23
"2021","Reigate and Banstead 017A","E01030580",894,213,72,141,640,39,373,111,210,52,125,71,47,7,101,65,36,2,2,41,22,19
"2021","Reigate and Banstead 017B","E01030581",932,193,107,86,691,109,409,118,232,59,110,53,53,4,60,45,15,3,3,48,21,27
"2021","Reigate and Banstead 017C","E01030582",561,120,43,77,420,32,248,75,138,35,84,55,29,0,53,41,12,3,3,21,9,12
"2021","Reigate and Banstead 017D","E01030583",615,113,74,39,458,80,288,80,140,68,62,34,23,5,27,13,14,1,1,44,18,26
"2021","Reigate and Banstead 018B","E01030576",676,167,61,106,462,40,264,75,133,56,85,48,36,1,67,38,29,6,6,47,22,25
"2021","Reigate and Banstead 018C","E01030577",754,264,123,141,432,63,214,78,103,33,85,61,22,2,62,39,23,8,8,58,21,37
"2021","Reigate and Banstead 018D","E01030578",613,186,102,84,374,47,190,57,86,47,58,23,26,9,75,40,35,4,4,53,22,31
"2021","Reigate and Banstead 018E","E01030579",643,228,131,97,368,72,174,66,80,28,61,32,25,4,57,33,24,4,4,47,15,32
"2021","Reigate and Banstead 018F","E01035361",646,210,85,125,396,34,183,71,97,15,95,59,31,5,77,56,21,7,7,40,15,25
"2021","Reigate and Banstead 018G","E01035362",614,241,55,186,311,10,130,43,80,7,115,81,31,3,48,40,8,8,8,62,17,45
"2021","Runnymede 001A","E01030667",791,356,127,229,359,25,182,70,84,28,94,75,15,4,57,37,20,1,1,76,13,63
"2021","Runnymede 001B","E01030668",871,291,144,147,465,45,233,76,131,26,108,78,27,3,68,43,25,11,11,115,17,98
"2021","Runnymede 001C","E01030669",689,160,55,105,365,44,171,48,91,32,88,65,21,2,53,31,22,9,9,164,14,150
"2021","Runnymede 001D","E01030670",493,88,37,51,237,33,144,35,80,29,30,19,7,4,27,10,17,3,3,168,14,154
"2021","Runnymede 002A","E01030671",420,123,40,83,203,30,110,52,48,10,39,30,9,0,19,7,12,5,5,94,5,89
"2021","Runnymede 002B","E01030672",798,166,85,81,528,80,334,94,194,46,71,46,24,1,34,21,13,9,9,104,14,90
"2021","Runnymede 002C","E01030673",493,140,68,72,317,71,160,57,75,28,44,28,10,6,40,25,15,2,2,36,12,24
"2021","Runnymede 002D","E01030674",651,270,129,141,312,41,147,55,70,22,74,51,17,6,47,26,21,3,3,69,7,62
"2021","Runnymede 002E","E01030675",621,172,54,118,347,34,171,40,98,33,75,49,22,4,60,38,22,7,7,102,12,90
"2021","Runnymede 002F","E01030676",508,147,78,69,210,18,70,12,40,18,36,10,22,4,83,50,33,3,3,151,15,136
"2021","Runnymede 003A","E01030663",661,164,77,87,430,42,215,54,111,50,62,30,24,8,111,75,36,0,0,67,33,34
"2021","Runnymede 003B","E01030664",758,257,112,145,450,42,226,67,121,38,86,51,20,15,91,54,37,5,5,51,17,34
"2021","Runnymede 003C","E01030665",621,150,49,101,421,22,213,55,133,25,99,51,45,3,85,51,34,2,2,50,22,28
"2021","Runnymede 003D","E01030666",745,215,74,141,485,47,251,72,135,44,108,69,32,7,69,39,30,10,10,45,18,27
"2021","Runnymede 003E","E01030687",496,127,51,76,320,51,185,56,93,36,52,39,10,3,30,13,17,2,2,49,23,26
"2021","Runnymede 003F","E01030688",605,120,64,56,438,53,244,63,122,59,71,41,27,3,65,25,40,5,5,47,19,28
"2021","Runnymede 004A","E01030656",576,137,80,57,396,38,221,56,118,47,66,30,26,10,70,34,36,1,1,43,24,19
"2021","Runnymede 004B","E01030658",781,360,205,155,385,89,169,86,51,32,73,58,13,2,51,22,29,3,3,36,7,29
"2021","Runnymede 004C","E01030685",522,109,49,60,375,71,212,52,116,44,56,28,21,7,34,15,19,2,2,38,19,19
"2021","Runnymede 004D","E01030686",564,121,65,56,383,93,209,75,91,43,47,22,22,3,33,9,24,1,1,60,22,38
"2021","Runnymede 005A","E01030689",608,147,63,84,418,66,261,92,131,38,48,33,14,1,40,12,28,3,3,43,22,21
"2021","Runnymede 005B","E01030690",708,202,99,103,462,72,272,79,162,31,51,35,14,2,64,40,24,3,3,44,23,21
"2021","Runnymede 005C","E01030691",601,127,75,52,432,82,270,77,157,36,35,19,14,2,42,21,21,3,3,42,15,27
"2021","Runnymede 005D","E01030692",567,132,61,71,381,73,214,80,96,38,39,27,11,1,53,39,14,2,2,54,31,23
"2021","Runnymede 006A","E01030652",787,231,100,131,501,52,245,64,136,45,116,71,41,4,82,45,37,6,6,55,21,34
"2021","Runnymede 006B","E01030653",796,235,78,157,503,25,219,71,122,26,159,111,44,4,95,58,37,5,5,58,21,37
"2021","Runnymede 006C","E01030654",654,183,56,127,441,47,227,92,106,29,95,58,31,6,69,42,27,3,3,30,8,22
"2021","Runnymede 006D","E01030657",638,202,85,117,396,29,171,46,92,33,79,35,36,8,111,76,35,6,6,40,12,28
"2021","Runnymede 006E","E01030659",911,362,132,230,509,72,243,95,110,38,119,77,36,6,67,38,29,8,8,40,11,29
"2021","Runnymede 007A","E01030647",763,281,172,109,446,91,225,76,105,44,77,49,25,3,50,24,26,3,3,36,11,25
"2021","Runnymede 007B","E01030648",660,151,59,92,462,49,256,72,140,44,79,44,29,6,75,45,30,3,3,47,17,30
"2021","Runnymede 007C","E01030649",1188,408,133,275,703,50,321,117,175,29,176,111,59,6,141,103,38,15,15,77,19,58
"2021","Runnymede 007D","E01030650",515,142,64,78,330,18,157,42,85,30,62,27,27,8,88,46,42,5,5,43,19,24
"2021","Runnymede 007E","E01030651",568,155,61,94,379,55,187,45,114,28,68,27,35,6,63,39,24,6,6,34,15,19
"2021","Runnymede 007F","E01030655",772,204,65,139,534,74,300,78,166,56,86,49,36,1,69,42,27,5,5,34,13,21
"2021","Runnymede 007G","E01030662",652,144,76,68,463,65,273,65,159,49,67,28,33,6,54,31,23,4,4,45,19,26
"2021","Runnymede 008A","E01030677",677,229,77,152,390,68,216,85,96,35,60,33,23,4,40,18,22,6,6,58,9,49
"2021","Runnymede 008B","E01030678",604,221,89,132,370,34,181,56,104,21,87,51,27,9,64,36,28,4,4,13,4,9
"2021","Runnymede 008C","E01030679",467,81,45,36,361,78,217,77,106,34,42,21,19,2,23,13,10,1,1,25,7,18
"2021","Runnymede 008D","E01030680",629,167,109,58,426,106,218,66,111,41,58,33,19,6,42,18,24,2,2,36,15,21
"2021","Runnymede 009A","E01030645",954,354,163,191,524,49,236,73,120,43,106,52,49,5,126,95,31,7,7,76,24,52
"2021","Runnymede 009B","E01030646",1026,346,147,199,626,75,310,110,150,50,138,80,50,8,94,55,39,9,9,54,22,32
"2021","Runnymede 009C","E01030660",1036,217,79,138,761,81,407,115,208,84,122,60,59,3,145,100,45,6,6,58,19,39
"2021","Runnymede 009D","E01030661",809,228,131,97,540,118,296,98,142,56,64,30,27,7,59,34,25,3,3,41,20,21
"2021","Runnymede 009E","E01030684",658,231,74,157,387,42,188,55,94,39,83,45,31,7,74,43,31,0,0,40,15,25
"2021","Runnymede 010A","E01030681",684,180,78,102,451,56,229,64,115,50,85,48,31,6,77,45,32,4,4,53,16,37
"2021","Runnymede 010B","E01030682",521,116,63,53,382,51,237,51,142,44,54,29,23,2,39,25,14,1,1,23,7,16
"2021","Runnymede 010C","E01030683",573,121,63,58,415,42,237,88,109,40,82,46,31,5,51,29,22,3,3,37,12,25
"2021","Runnymede 010D","E01030693",503,95,66,29,385,94,218,53,129,36,44,29,12,3,24,8,16,5,5,23,12,11
"2021","Runnymede 010E","E01030694",523,125,85,40,353,48,193,48,101,44,53,26,23,4,55,27,28,4,4,45,19,26
"2021","Runnymede 010F","E01030695",480,96,74,22,367,100,227,63,116,48,22,11,9,2,17,3,14,1,1,17,5,12
"2021","Runnymede 010G","E01030696",629,153,95,58,447,82,243,58,131,54,63,33,25,5,58,24,34,1,1,29,14,15
"2021","Spelthorne 001A","E01030743",683,205,76,129,403,59,194,52,99,43,64,34,18,12,76,43,33,10,10,75,42,33
"2021","Spelthorne 001B","E01030744",846,386,76,310,405,21,172,63,86,23,91,55,31,5,113,79,34,8,8,55,20,35
"2021","Spelthorne 001C","E01030745",615,120,44,76,405,25,208,55,107,46,57,18,30,9,111,73,38,4,4,90,57,33
"2021","Spelthorne 001D","E01030747",565,150,50,100,357,42,195,70,85,40,62,36,19,7,55,39,16,3,3,58,36,22
"2021","Spelthorne 002A","E01030709",633,119,46,73,452,37,259,65,148,46,68,38,27,3,79,50,29,9,9,62,33,29
"2021","Spelthorne 002B","E01030710",735,151,58,93,491,18,281,64,163,54,76,33,36,7,111,74,37,5,5,93,52,41
"2021","Spelthorne 002C","E01030711",717,197,77,120,441,34,220,49,121,50,65,21,40,4,115,76,39,7,7,79,38,41
"2021","Spelthorne 002D","E01030746",679,172,81,91,425,36,217,51,110,56,59,24,32,3,101,62,39,12,12,82,44,38
"2021","Spelthorne 003A","E01030707",855,237,71,166,540,62,276,72,167,37,92,54,37,1,99,72,27,11,11,78,32,46
"2021","Spelthorne 003B","E01030708",619,137,70,67,422,59,236,45,134,57,56,23,30,3,68,37,31,3,3,60,26,34
"2021","Spelthorne 003C","E01030712",740,198,56,142,498,62,221,61,123,37,106,66,34,6,101,73,28,8,8,44,16,28
"2021","Spelthorne 003D","E01030713",526,135,61,74,362,38,218,57,110,51,53,30,20,3,50,27,23,3,3,29,13,16
"2021","Spelthorne 003E","E01030714",483,103,45,58,331,48,188,53,99,36,54,22,26,6,41,14,27,0,0,49,19,30
"2021","Spelthorne 003F","E01030715",623,156,86,70,419,54,231,69,100,62,67,30,35,2,66,35,31,1,1,48,21,27
"2021","Spelthorne 003G","E01030716",585,144,79,65,394,69,243,67,111,65,41,22,12,7,39,18,21,2,2,47,19,28
"2021","Spelthorne 004A","E01030734",571,96,43,53,416,49,218,76,97,45,77,46,28,3,62,42,20,10,10,59,25,34
"2021","Spelthorne 004B","E01030735",678,174,75,99,442,57,229,67,115,47,72,41,30,1,79,44,35,5,5,62,17,45
"2021","Spelthorne 004D","E01030737",694,247,91,156,405,45,215,74,109,32,92,61,30,1,48,30,18,5,5,42,13,29
"2021","Spelthorne 004E","E01030738",713,262,85,177,409,34,227,72,106,49,67,41,26,0,73,40,33,8,8,42,14,28
"2021","Spelthorne 004F","E01034291",700,239,42,197,382,18,197,74,109,14,108,85,22,1,42,23,19,17,17,79,15,64
"2021","Spelthorne 004G","E01034292",653,281,40,241,340,8,178,84,83,11,105,92,13,0,44,26,18,5,5,32,10,22
"2021","Spelthorne 005A","E01030701",612,151,85,66,408,55,229,54,119,56,60,27,27,6,60,28,32,4,4,53,21,32
"2021","Spelthorne 005B","E01030702",549,198,80,118,313,22,135,36,68,31,61,27,31,3,92,60,32,3,3,38,16,22
"2021","Spelthorne 005C","E01030703",619,146,93,53,410,71,219,62,103,54,60,27,28,5,60,39,21,0,0,63,24,39
"2021","Spelthorne 005D","E01030704",688,221,123,98,418,87,210,57,98,55,56,29,24,3,53,30,23,12,12,49,22,27
"2021","Spelthorne 005E","E01030705",651,163,73,90,439,77,243,74,117,52,82,36,40,6,36,19,17,1,1,49,20,29
"2021","Spelthorne 005F","E01030706",555,111,58,53,399,46,225,57,117,51,66,36,27,3,59,30,29,3,3,45,24,21
"2021","Spelthorne 006A","E01030697",699,199,90,109,454,78,240,56,125,59,78,39,31,8,54,26,28,4,4,46,26,20
"2021","Spelthorne 006B","E01030698",643,146,80,66,448,63,268,56,152,60,64,24,38,2,50,24,26,3,3,49,24,25
"2021","Spelthorne 006C","E01030699",613,169,103,66,404,66,218,54,98,66,58,31,23,4,58,30,28,4,4,40,19,21
"2021","Spelthorne 006D","E01030700",821,305,113,192,470,60,229,70,112,47,90,52,31,7,83,50,33,8,8,46,20,26
"2021","Spelthorne 006E","E01030725",935,315,65,250,553,24,234,74,140,20,155,88,62,5,124,86,38,16,16,67,23,44
"2021","Spelthorne 007A","E01030729",609,154,86,68,412,61,195,52,102,41,74,31,32,11,78,45,33,4,4,43,15,28
"2021","Spelthorne 007B","E01030739",690,207,115,92,426,28,212,48,121,43,77,24,45,8,101,57,44,8,8,57,26,31
"2021","Spelthorne 007C","E01030740",760,256,157,99,453,64,239,58,122,59,59,23,31,5,88,42,46,3,3,51,34,17
"2021","Spelthorne 007D","E01030741",653,135,56,79,482,47,265,86,130,49,81,43,30,8,85,44,41,4,4,36,15,21
"2021","Spelthorne 008A","E01030748",658,138,73,65,460,57,237,59,124,54,83,37,40,6,80,51,29,3,3,60,25,35
"2021","Spelthorne 008B","E01030749",592,139,75,64,405,35,201,48,101,52,52,18,25,9,113,71,42,4,4,48,22,26
"2021","Spelthorne 008C","E01030750",601,147,50,97,417,38,202,52,104,46,77,35,37,5,96,61,35,4,4,37,14,23
"2021","Spelthorne 008D","E01030751",765,216,70,146,492,51,248,74,136,38,106,64,36,6,80,54,26,7,7,57,28,29
"2021","Spelthorne 008E","E01030752",651,157,52,105,438,22,199,49,118,32,76,23,44,9,133,92,41,8,8,56,21,35
"2021","Spelthorne 009A","E01030726",654,121,76,45,493,92,308,79,164,65,47,24,16,7,43,18,25,3,3,40,19,21
"2021","Spelthorne 009B","E01030727",851,283,134,149,524,88,267,88,141,38,99,62,32,5,65,37,28,5,5,44,15,29
"2021","Spelthorne 009C","E01030728",733,205,117,88,493,120,262,96,114,52,66,39,20,7,37,20,17,8,8,35,12,23
"2021","Spelthorne 009D","E01030742",816,248,150,98,526,87,296,89,162,45,76,50,22,4,58,34,24,9,9,42,11,31
"2021","Spelthorne 010A","E01030753",804,256,164,92,514,104,292,91,148,53,64,39,22,3,50,30,20,4,4,34,11,23
"2021","Spelthorne 010B","E01030754",862,199,115,84,621,112,363,92,203,68,77,41,28,8,68,43,25,1,1,42,18,24
"2021","Spelthorne 010C","E01030755",831,218,104,114,556,47,293,79,170,44,88,47,35,6,124,81,43,4,4,57,22,35
"2021","Spelthorne 010D","E01030756",661,128,77,51,486,107,273,96,133,44,48,29,14,5,54,25,29,4,4,47,20,27
"2021","Spelthorne 011A","E01030717",735,250,130,120,453,66,213,64,107,42,87,49,29,9,86,45,41,1,1,32,15,17
"2021","Spelthorne 011B","E01030718",517,110,64,46,371,59,225,55,110,60,46,20,19,7,38,21,17,3,3,36,17,19
"2021","Spelthorne 011C","E01030719",636,173,106,67,425,73,208,67,94,47,75,36,32,7,63,41,22,6,6,38,19,19
"2021","Spelthorne 011D","E01030720",736,214,116,98,496,90,269,74,143,52,67,27,32,8,68,35,33,2,2,26,11,15
"2021","Spelthorne 012A","E01030721",606,159,88,71,415,67,212,74,91,47,66,38,27,1,68,39,29,2,2,32,15,17
"2021","Spelthorne 012B","E01030722",661,158,97,61,466,78,242,78,125,39,73,30,39,4,70,32,38,3,3,37,13,24
"2021","Spelthorne 012C","E01030723",622,136,75,61,451,91,259,71,134,54,48,21,27,0,53,20,33,0,0,35,13,22
"2021","Spelthorne 012D","E01030724",649,210,99,111,414,38,225,70,107,48,74,33,36,5,72,38,34,5,5,25,8,17
"2021","Spelthorne 013A","E01030730",805,236,160,76,518,148,268,110,118,40,66,39,23,4,35,17,18,1,1,51,19,32
"2021","Spelthorne 013B","E01030731",764,207,121,86,517,89,292,70,153,69,71,33,36,2,63,36,27,2,2,40,13,27
"2021","Spelthorne 013C","E01030732",731,245,143,102,451,118,218,86,101,31,55,37,17,1,56,29,27,4,4,35,15,20
"2021","Spelthorne 013D","E01030733",841,335,182,153,472,108,209,72,100,37,98,59,36,3,52,33,19,5,5,34,8,26
"2021","Surrey Heath 001A","E01030763",534,135,71,64,369,76,215,87,98,30,51,36,12,3,26,17,9,1,1,30,6,24
"2021","Surrey Heath 001B","E01030764",558,151,83,68,383,95,221,84,102,35,42,23,13,6,22,6,16,3,3,24,7,17
"2021","Surrey Heath 001C","E01030765",667,188,87,101,440,64,211,66,108,37,71,33,31,7,90,61,29,4,4,39,16,23
"2021","Surrey Heath 001D","E01030809",661,196,89,107,440,87,224,81,114,29,71,42,26,3,55,28,27,3,3,25,6,19
"2021","Surrey Heath 001E","E01030810",529,119,62,57,399,89,249,81,116,52,38,23,11,4,23,14,9,0,0,11,5,6
"2021","Surrey Heath 001F","E01030811",605,132,81,51,447,83,271,88,139,44,42,28,14,0,49,25,24,2,2,26,15,11
"2021","Surrey Heath 002A","E01030757",710,186,48,138,490,58,270,87,145,38,112,78,30,4,49,30,19,1,1,34,20,14
"2021","Surrey Heath 002B","E01030758",449,112,57,55,305,49,156,40,82,34,54,32,22,0,46,29,17,0,0,32,15,17
"2021","Surrey Heath 002C","E01030759",739,314,165,149,394,58,183,61,92,30,81,40,34,7,68,46,22,4,4,31,14,17
"2021","Surrey Heath 002D","E01030760",684,171,86,85,475,75,260,95,131,34,69,38,27,4,65,38,27,6,6,38,18,20
"2021","Surrey Heath 003A","E01030778",738,194,93,101,516,120,280,106,121,53,70,43,24,3,44,21,23,2,2,28,11,17
"2021","Surrey Heath 003B","E01030779",751,216,152,64,505,123,284,102,124,58,50,33,13,4,46,25,21,2,2,30,14,16
"2021","Surrey Heath 003C","E01030780",652,171,78,93,453,92,266,84,122,60,57,38,17,2,38,17,21,0,0,28,8,20
"2021","Surrey Heath 003D","E01030781",652,168,83,85,456,61,244,62,136,46,80,45,30,5,69,36,33,2,2,28,13,15
"2021","Surrey Heath 004A","E01030786",788,262,112,150,479,32,221,70,108,43,85,45,37,3,136,93,43,5,5,47,16,31
"2021","Surrey Heath 004B","E01030787",531,124,54,70,344,32,180,42,106,32,62,22,31,9,66,35,31,4,4,63,24,39
"2021","Surrey Heath 004C","E01030788",484,115,65,50,322,25,155,45,79,31,58,18,33,7,80,51,29,4,4,47,26,21
"2021","Surrey Heath 004D","E01030801",720,198,60,138,463,26,258,91,132,35,112,72,31,9,61,30,31,6,6,59,18,41
"2021","Surrey Heath 004E","E01030802",724,167,81,86,500,85,270,96,131,43,75,48,26,1,65,33,32,5,5,57,19,38
"2021","Surrey Heath 005A","E01030796",544,95,60,35,424,100,249,78,121,50,29,16,11,2,43,23,20,3,3,25,12,13
"2021","Surrey Heath 005B","E01030797",527,107,51,56,388,64,243,73,127,43,43,27,16,0,37,20,17,1,1,32,15,17
"2021","Surrey Heath 005C","E01030798",563,94,63,31,428,95,270,67,137,66,32,13,15,4,29,13,16,2,2,41,19,22
"2021","Surrey Heath 005D","E01030799",519,87,56,31,388,87,234,75,99,60,35,18,12,5,32,18,14,0,0,44,22,22
"2021","Surrey Heath 005E","E01030800",935,356,161,195,508,91,228,74,111,43,92,73,15,4,93,67,26,4,4,71,20,51
"2021","Surrey Heath 006A","E01030761",752,170,94,76,538,81,327,86,194,47,67,39,23,5,63,39,24,0,0,44,18,26
"2021","Surrey Heath 006B","E01030762",753,180,70,110,536,77,307,100,146,61,86,56,27,3,64,40,24,2,2,37,13,24
"2021","Surrey Heath 006C","E01030806",544,80,50,30,443,78,284,80,150,54,46,21,17,8,34,18,16,1,1,21,11,10
"2021","Surrey Heath 006D","E01030807",896,154,68,86,698,57,417,109,261,47,114,59,49,6,105,81,24,5,5,44,23,21
"2021","Surrey Heath 006E","E01030808",636,125,58,67,485,65,294,69,172,53,64,36,24,4,62,34,28,0,0,26,12,14
"2021","Surrey Heath 007A","E01030774",619,158,55,103,448,52,270,73,148,49,68,39,25,4,57,37,20,1,1,13,5,8
"2021","Surrey Heath 007B","E01030775",580,110,76,34,446,111,256,76,141,39,44,23,17,4,33,15,18,2,2,24,10,14
"2021","Surrey Heath 007C","E01030776",618,118,83,35,464,100,271,92,131,48,44,23,21,0,46,32,14,3,3,36,18,18
"2021","Surrey Heath 007D","E01030777",636,154,76,78,461,54,263,72,152,39,62,33,28,1,79,57,22,3,3,21,7,14
"2021","Surrey Heath 008A","E01030793",867,239,53,186,546,24,255,75,132,48,144,82,54,8,110,76,34,13,13,82,32,50
"2021","Surrey Heath 008B","E01030794",640,176,72,104,424,45,223,79,104,40,89,56,31,2,62,39,23,5,5,40,16,24
"2021","Surrey Heath 008C","E01030795",1097,454,175,279,569,88,272,87,135,50,131,96,35,0,62,37,25,16,16,74,24,50
"2021","Surrey Heath 008D","E01030803",699,183,68,115,436,53,223,68,111,44,83,47,30,6,70,32,38,7,7,80,34,46
"2021","Surrey Heath 008E","E01030804",674,148,85,63,469,114,263,88,124,51,49,36,13,0,41,22,19,2,2,57,23,34
"2021","Surrey Heath 008F","E01030805",613,146,67,79,391,41,205,56,108,41,52,19,25,8,89,55,34,4,4,76,37,39
"2021","Surrey Heath 009A","E01030789",610,107,57,50,455,121,267,71,131,65,35,14,16,5,28,13,15,4,4,48,25,23
"2021","Surrey Heath 009B","E01030790",679,143,94,49,500,82,298,65,186,47,55,29,19,7,61,39,22,4,4,36,16,20
"2021","Surrey Heath 009C","E01030791",650,125,84,41,489,101,299,68,171,60,40,22,16,2,46,14,32,3,3,36,21,15
"2021","Surrey Heath 009D","E01030792",489,87,57,30,361,95,213,69,107,37,29,14,13,2,23,10,13,1,1,41,17,24
"2021","Surrey Heath 010A","E01030766",741,225,83,142,440,51,247,88,120,39,86,58,23,5,51,24,27,5,5,76,33,43
"2021","Surrey Heath 010B","E01030767",654,135,66,69,458,39,226,49,121,56,88,34,49,5,101,71,30,4,4,61,27,34
"2021","Surrey Heath 010C","E01030768",548,162,70,92,346,69,195,52,105,38,35,15,13,7,45,16,29,2,2,40,15,25
"2021","Surrey Heath 010D","E01030769",583,106,75,31,449,97,274,90,131,53,33,17,16,0,45,25,20,0,0,28,14,14
"2021","Surrey Heath 011A","E01030770",604,144,83,61,438,80,252,91,121,40,67,27,35,5,34,20,14,5,5,22,5,17
"2021","Surrey Heath 011B","E01030771",484,94,58,36,366,69,219,68,105,46,49,27,17,5,28,16,12,1,1,24,11,13
"2021","Surrey Heath 011C","E01030772",623,179,91,88,412,62,218,58,108,52,66,33,30,3,64,34,30,2,2,32,15,17
"2021","Surrey Heath 011D","E01030773",538,134,73,61,368,64,209,65,102,42,59,33,21,5,34,17,17,2,2,36,12,24
"2021","Surrey Heath 012A","E01030782",665,180,112,68,456,83,257,87,118,52,74,36,35,3,42,23,19,0,0,29,20,9
"2021","Surrey Heath 012B","E01030783",670,175,94,81,456,61,265,73,142,50,71,47,23,1,59,37,22,0,0,39,18,21
"2021","Surrey Heath 012C","E01030784",901,198,45,153,643,26,389,102,232,55,138,78,56,4,86,50,36,4,4,60,19,41
"2021","Surrey Heath 012D","E01030785",664,216,118,98,408,77,238,91,92,55,62,40,16,6,31,13,18,0,0,40,14,26
"2021","Tandridge 002A","E01030855",844,195,126,69,604,145,334,121,145,68,71,42,26,3,51,24,27,3,3,45,23,22
"2021","Tandridge 002B","E01030856",643,181,111,70,423,67,231,62,123,46,70,38,26,6,54,31,23,1,1,39,15,24
"2021","Tandridge 002C","E01030859",926,323,71,252,558,46,259,84,138,37,142,77,56,9,98,72,26,13,13,45,21,24
"2021","Tandridge 002E","E01035363",624,225,41,184,368,10,139,42,80,17,114,79,33,2,101,81,20,4,4,31,8,23
"2021","Tandridge 002F","E01035364",586,216,47,169,353,29,165,50,97,18,87,63,21,3,66,50,16,6,6,17,8,9
"2021","Tandridge 003A","E01030844",690,162,86,76,483,66,260,54,159,47,71,29,39,3,81,61,20,5,5,45,19,26
"2021","Tandridge 003B","E01030845",518,151,90,61,347,31,175,47,91,37,74,29,42,3,65,46,19,2,2,20,9,11
"2021","Tandridge 003C","E01030846",573,126,80,46,408,70,237,53,130,54,47,18,26,3,52,29,23,2,2,39,22,17
"2021","Tandridge 003D","E01030857",880,243,82,161,600,46,297,82,161,54,94,35,45,14,158,91,67,5,5,37,19,18
"2021","Tandridge 003E","E01030858",1090,322,117,205,724,67,366,93,212,61,136,70,58,8,150,107,43,5,5,44,22,22
"2021","Tandridge 004A","E01030828",527,127,55,72,373,74,224,61,122,41,41,20,17,4,31,16,15,3,3,27,11,16
"2021","Tandridge 004B","E01030829",771,234,93,141,500,70,220,82,113,25,108,73,34,1,96,65,31,6,6,37,14,23
"2021","Tandridge 004C","E01030830",520,126,77,49,361,35,203,42,125,36,70,39,28,3,50,31,19,3,3,33,13,20
"2021","Tandridge 004D","E01030850",1179,490,251,239,648,56,259,86,146,27,160,81,73,6,167,129,38,6,6,41,14,27
"2021","Tandridge 004E","E01030851",811,194,57,137,574,62,288,78,151,59,98,49,43,6,122,74,48,4,4,43,20,23
"2021","Tandridge 004F","E01030861",763,133,82,51,580,117,359,115,180,64,64,33,26,5,36,15,21,4,4,50,25,25
"2021","Tandridge 005A","E01030820",671,117,79,38,511,110,312,93,144,75,43,21,21,1,44,18,26,2,2,43,24,19
"2021","Tandridge 005B","E01030847",713,266,131,135,424,94,242,83,116,43,40,20,16,4,44,18,26,4,4,23,8,15
"2021","Tandridge 005C","E01030848",917,263,141,122,611,83,329,74,193,62,96,37,56,3,97,60,37,6,6,43,12,31
"2021","Tandridge 006A","E01030831",894,185,109,76,667,173,369,110,196,63,82,54,27,1,38,22,16,5,5,42,15,27
"2021","Tandridge 006B","E01030832",562,142,83,59,388,96,216,75,98,43,37,22,13,2,36,20,16,3,3,32,13,19
"2021","Tandridge 006C","E01030836",743,303,206,97,402,56,215,48,125,42,67,36,28,3,60,48,12,4,4,38,11,27
"2021","Tandridge 006D","E01030837",545,124,67,57,401,49,238,44,146,48,55,31,21,3,56,28,28,3,3,20,10,10
"2021","Tandridge 006E","E01030838",544,132,64,68,388,63,221,81,104,36,58,33,21,4,42,25,17,4,4,24,14,10
"2021","Tandridge 006F","E01030839",584,159,103,56,402,102,255,69,145,41,28,15,9,4,16,11,5,1,1,23,13,10
"2021","Tandridge 007A","E01030840",553,144,78,66,381,56,186,49,103,34,58,22,36,0,78,41,37,3,3,28,14,14
"2021","Tandridge 007B","E01030841",510,78,60,18,412,104,262,77,141,44,23,11,11,1,23,9,14,0,0,20,9,11
"2021","Tandridge 007C","E01030842",870,203,81,122,635,65,317,74,181,62,141,65,62,14,106,72,34,6,6,32,12,20
"2021","Tandridge 007D","E01030843",616,175,85,90,408,69,183,62,85,36,79,37,38,4,74,45,29,3,3,33,12,21
"2021","Tandridge 008A","E01030812",688,180,88,92,463,72,214,75,97,42,86,42,37,7,85,55,30,6,6,45,18,27
"2021","Tandridge 008B","E01030813",658,192,91,101,445,69,257,92,121,44,65,35,28,2,49,26,23,5,5,21,7,14
"2021","Tandridge 008C","E01030814",518,116,56,60,372,75,209,73,106,30,48,27,20,1,38,18,20,2,2,30,11,19
"2021","Tandridge 008D","E01030815",625,169,80,89,413,68,226,72,113,41,67,37,27,3,49,27,22,3,3,43,17,26
"2021","Tandridge 009A","E01030824",633,180,81,99,414,48,186,46,101,39,88,33,49,6,88,62,26,4,4,39,18,21
"2021","Tandridge 009B","E01030825",616,208,127,81,387,73,206,74,88,44,70,41,22,7,35,25,10,3,3,21,8,13
"2021","Tandridge 009C","E01030826",594,136,75,61,424,67,203,60,105,38,81,35,39,7,67,41,26,6,6,34,13,21
"2021","Tandridge 009D","E01030827",693,173,81,92,466,67,249,97,97,55,79,39,36,4,69,47,22,2,2,54,22,32
"2021","Tandridge 010A","E01030821",756,181,104,77,537,100,285,99,118,68,84,39,38,7,66,37,29,2,2,38,8,30
"2021","Tandridge 010B","E01030822",798,194,139,55,560,137,318,125,122,71,53,36,13,4,50,34,16,2,2,44,13,31
"2021","Tandridge 010C","E01030833",639,229,147,82,381,68,176,57,101,18,73,43,26,4,62,41,21,2,2,29,16,13
"2021","Tandridge 010D","E01030834",616,163,76,87,422,73,210,70,103,37,70,39,24,7,69,42,27,0,0,31,15,16
"2021","Tandridge 010E","E01030835",603,158,87,71,426,74,225,69,119,37,65,33,28,4,61,35,26,1,1,19,12,7
"2021","Tandridge 011A","E01030816",646,139,77,62,455,78,250,90,114,46,64,30,29,5,59,35,24,4,4,52,21,31
"2021","Tandridge 011B","E01030817",580,132,85,47,428,85,253,88,100,65,48,27,18,3,42,21,21,0,0,20,7,13
"2021","Tandridge 011C","E01030818",524,169,97,72,319,57,142,49,56,37,62,24,28,10,56,32,24,2,2,36,15,21
"2021","Tandridge 011D","E01030819",663,187,90,97,409,73,207,74,79,54,78,45,28,5,49,31,18,2,2,67,24,43
"2021","Tandridge 011E","E01030823",927,201,132,69,663,171,369,123,167,79,83,43,29,11,39,19,20,1,1,63,33,30
"2021","Tandridge 012A","E01030852",800,239,114,125,505,81,242,78,107,57,81,33,37,11,97,54,43,4,4,56,28,28
"2021","Tandridge 012B","E01030853",753,239,167,72,468,78,222,61,117,44,76,31,37,8,88,50,38,4,4,46,29,17
"2021","Tandridge 012C","E01030854",822,227,154,73,551,120,296,92,151,53,67,28,34,5,64,32,32,4,4,44,18,26
"2021","Tandridge 012D","E01032571",778,156,101,55,561,133,299,102,133,64,69,40,23,6,58,41,17,2,2,61,25,36
"2021","Waverley 001A","E01030890",657,206,96,110,421,70,214,64,114,36,73,42,25,6,61,34,27,3,3,30,11,19
"2021","Waverley 001B","E01030902",539,134,78,56,385,79,215,68,112,35,48,27,20,1,40,19,21,3,3,20,8,12
"2021","Waverley 001C","E01030903",844,262,105,157,542,61,266,81,131,54,141,94,41,6,70,42,28,4,4,40,15,25
"2021","Waverley 001D","E01030904",649,203,123,80,422,108,207,62,107,38,61,39,15,7,45,23,22,1,1,24,14,10
"2021","Waverley 002A","E01030891",671,157,86,71,487,97,285,72,160,53,60,30,26,4,43,23,20,2,2,27,9,18
"2021","Waverley 002B","E01030892",522,131,56,75,354,47,211,61,126,24,48,28,20,0,45,25,20,3,3,37,14,23
"2021","Waverley 002C","E01030899",681,164,86,78,501,131,273,95,130,48,65,39,20,6,29,17,12,3,3,16,6,10
"2021","Waverley 002D","E01030900",510,95,59,36,388,75,213,78,101,34,55,31,21,3,44,20,24,1,1,27,13,14
"2021","Waverley 002E","E01030901",501,116,47,69,312,25,135,35,64,36,52,18,25,9,93,53,40,7,7,73,17,56
"2021","Waverley 003A","E01030884",771,297,129,168,409,79,146,58,64,24,101,63,35,3,80,52,28,3,3,65,9,56
"2021","Waverley 003B","E01030885",935,550,311,239,334,75,112,58,47,7,89,73,16,0,51,33,18,7,7,51,13,38
"2021","Waverley 003C","E01030886",544,116,61,55,389,71,224,78,109,37,55,34,18,3,36,21,15,3,3,39,10,29
"2021","Waverley 003D","E01030893",822,203,68,135,551,67,285,89,165,31,107,64,39,4,84,58,26,8,8,68,6,62
"2021","Waverley 003E","E01030895",665,220,81,139,349,19,160,51,86,23,102,64,33,5,64,36,28,4,4,96,16,80
"2021","Waverley 004A","E01030881",550,85,65,20,443,107,285,59,181,45,26,10,13,3,25,17,8,0,0,22,8,14
"2021","Waverley 004B","E01030883",547,117,76,41,401,83,245,66,147,32,44,22,20,2,29,20,9,0,0,29,16,13
"2021","Waverley 004C","E01030888",669,187,83,104,453,61,284,65,176,43,72,45,25,2,32,23,9,4,4,29,10,19
"2021","Waverley 004D","E01030894",638,115,76,39,488,133,294,88,148,58,34,22,9,3,23,12,11,4,4,35,20,15
"2021","Waverley 005A","E01030911",616,154,92,62,428,61,252,68,135,49,58,28,25,5,56,36,20,1,1,34,16,18
"2021","Waverley 005B","E01030912",555,149,83,66,368,55,179,63,82,34,65,31,27,7,67,22,45,2,2,38,18,20
"2021","Waverley 005C","E01030913",570,166,85,81,375,40,160,46,90,24,84,46,35,3,91,60,31,0,0,29,16,13
"2021","Waverley 005D","E01030920",666,186,79,107,435,45,243,79,136,28,87,62,21,4,55,34,21,5,5,45,11,34
"2021","Waverley 005E","E01030921",855,370,181,189,444,50,219,92,108,19,104,69,30,5,69,41,28,2,2,41,13,28
"2021","Waverley 006A","E01030882",540,94,54,40,428,80,277,72,171,34,37,18,17,2,30,20,10,4,4,18,10,8
"2021","Waverley 006B","E01030887",533,118,72,46,394,65,269,58,177,34,31,14,14,3,28,18,10,1,1,21,8,13
"2021","Waverley 006C","E01030889",642,191,109,82,409,50,202,54,121,27,67,31,34,2,88,59,29,2,2,42,10,32
"2021","Waverley 006D","E01030896",550,167,57,110,351,38,168,49,93,26,66,33,31,2,72,43,29,7,7,32,13,19
"2021","Waverley 006E","E01030897",523,112,57,55,400,65,246,55,151,40,38,15,19,4,50,29,21,1,1,11,2,9
"2021","Waverley 007A","E01030916",1074,386,123,263,649,55,313,109,186,18,172,136,32,4,102,67,35,7,7,39,10,29
"2021","Waverley 007B","E01030917",537,187,52,135,319,34,155,46,97,12,89,68,21,0,38,28,10,3,3,31,7,24
"2021","Waverley 007C","E01030918",549,220,87,133,306,48,158,55,88,15,62,49,13,0,34,17,17,4,4,23,9,14
"2021","Waverley 007D","E01030919",518,103,65,38,402,86,245,86,115,44,33,19,13,1,34,17,17,4,4,13,2,11
"2021","Waverley 007E","E01030922",823,249,89,160,539,78,282,95,157,30,99,70,24,5,75,45,30,5,5,35,10,25
"2021","Waverley 008A","E01030863",750,187,110,77,527,109,334,97,177,60,38,23,11,4,45,15,30,1,1,36,14,22
"2021","Waverley 008B","E01030865",681,233,116,117,414,71,218,72,110,36,69,35,27,7,50,29,21,6,6,34,10,24
"2021","Waverley 008C","E01030866",634,146,77,69,471,94,290,88,161,41,54,31,19,4,32,16,16,1,1,17,10,7
"2021","Waverley 008D","E01030940",777,206,124,82,537,104,314,84,179,51,55,25,26,4,61,35,26,3,3,34,11,23
"2021","Waverley 009A","E01030898",623,118,76,42,484,101,302,72,172,58,36,22,11,3,43,19,24,2,2,21,9,12
"2021","Waverley 009B","E01030905",681,182,79,103,455,49,212,55,122,35,96,45,49,2,91,54,37,7,7,44,16,28
"2021","Waverley 009C","E01030906",805,226,103,123,552,92,326,80,187,59,70,43,26,1,61,37,24,3,3,27,10,17
"2021","Waverley 009D","E01030907",501,104,70,34,385,105,228,59,134,35,17,5,9,3,34,21,13,1,1,12,3,9
"2021","Waverley 010A","E01030914",576,178,82,96,370,28,176,64,85,27,82,48,30,4,81,54,27,3,3,28,7,21
"2021","Waverley 010B","E01030915",612,151,74,77,428,55,242,71,132,39,74,48,24,2,54,29,25,3,3,33,7,26
"2021","Waverley 010C","E01030923",587,106,59,47,457,76,294,79,179,36,50,30,18,2,36,21,15,1,1,24,9,15
"2021","Waverley 010D","E01030924",494,125,60,65,352,63,224,62,135,27,43,31,12,0,21,14,7,1,1,17,9,8
"2021","Waverley 010E","E01030925",614,89,51,38,507,90,344,96,200,48,32,16,15,1,40,25,15,1,1,18,4,14
"2021","Waverley 011A","E01030877",530,192,109,83,316,65,170,61,82,27,42,25,15,2,38,19,19,1,1,22,4,18
"2021","Waverley 011B","E01030878",709,192,129,63,494,112,286,92,146,48,47,23,20,4,47,30,17,2,2,23,8,15
"2021","Waverley 011C","E01030937",673,174,94,80,467,68,260,65,146,49,70,30,36,4,68,42,26,1,1,32,6,26
"2021","Waverley 011D","E01030938",618,256,165,91,349,69,174,50,88,36,50,31,17,2,54,30,24,2,2,13,4,9
"2021","Waverley 011E","E01030939",467,107,58,49,343,65,205,53,104,48,40,27,10,3,30,18,12,3,3,17,4,13
"2021","Waverley 012A","E01030864",682,143,65,78,502,75,324,95,174,55,62,38,22,2,40,28,12,1,1,37,7,30
"2021","Waverley 012B","E01030879",473,119,63,56,321,75,192,65,90,37,30,20,7,3,21,9,12,3,3,33,12,21
"2021","Waverley 012C","E01030941",523,110,68,42,402,72,258,89,134,35,41,27,14,0,28,21,7,3,3,11,2,9
"2021","Waverley 012D","E01030942",557,133,73,60,397,87,238,82,119,37,40,28,12,0,32,16,16,0,0,27,16,11
"2021","Waverley 012E","E01030943",529,133,65,68,374,48,203,55,114,34,53,29,19,5,70,45,25,0,0,22,9,13
"2021","Waverley 013A","E01030870",652,145,106,39,485,145,264,80,138,46,37,17,18,2,38,15,23,1,1,22,9,13
"2021","Waverley 013B","E01030871",784,179,92,87,573,119,296,105,145,46,81,37,40,4,76,50,26,1,1,32,14,18
"2021","Waverley 013C","E01030872",843,301,173,128,511,99,224,76,102,46,95,51,39,5,90,58,32,3,3,31,13,18
"2021","Waverley 013D","E01030873",617,195,119,76,397,93,220,70,106,44,39,19,17,3,45,20,25,0,0,25,9,16
"2021","Waverley 013E","E01030874",503,134,92,42,347,85,208,64,111,33,26,20,4,2,28,14,14,0,0,22,11,11
"2021","Waverley 013F","E01030875",818,309,111,198,484,89,214,91,89,34,100,71,24,5,77,49,28,4,4,25,6,19
"2021","Waverley 013G","E01030876",683,163,100,63,501,168,235,76,119,40,56,37,16,3,36,16,20,6,6,19,11,8
"2021","Waverley 015A","E01030862",936,367,283,84,531,146,256,97,109,50,72,49,22,1,55,23,32,2,2,38,18,20
"2021","Waverley 015B","E01030867",652,160,75,85,454,90,264,107,113,44,61,39,21,1,39,21,18,0,0,38,11,27
"2021","Waverley 015C","E01030868",491,86,57,29,389,81,236,49,148,39,33,16,15,2,39,24,15,0,0,16,5,11
"2021","Waverley 015D","E01030869",487,117,62,55,345,55,219,68,114,37,33,23,9,1,38,17,21,0,0,25,8,17
"2021","Waverley 015E","E01030880",874,217,127,90,615,165,317,105,148,64,73,51,19,3,56,26,30,4,4,42,12,30
"2021","Waverley 016A","E01030930",629,151,90,61,461,108,283,91,154,38,38,25,11,2,31,18,13,1,1,17,9,8
"2021","Waverley 016B","E01030931",778,236,140,96,515,106,282,85,160,37,58,40,14,4,66,33,33,3,3,27,8,19
"2021","Waverley 016C","E01030932",647,156,98,58,460,72,270,86,144,40,66,31,31,4,52,25,27,0,0,31,13,18
"2021","Waverley 016D","E01030933",779,237,125,112,522,96,279,79,161,39,79,47,27,5,62,41,21,6,6,20,4,16
"2021","Waverley 017A","E01030926",603,173,97,76,408,64,255,75,149,31,52,28,21,3,36,19,17,1,1,22,9,13
"2021","Waverley 017B","E01030927",544,135,54,81,387,59,195,67,99,29,67,39,23,5,65,35,30,1,1,22,7,15
"2021","Waverley 017C","E01030928",845,336,117,219,489,49,234,84,119,31,121,93,26,2,76,51,25,9,9,20,5,15
"2021","Waverley 017D","E01030929",491,96,49,47,368,49,247,74,127,46,41,28,11,2,29,18,11,2,2,27,12,15
"2021","Waverley 018A","E01030908",611,118,69,49,453,86,289,99,145,45,39,27,12,0,38,17,21,1,1,40,20,20
"2021","Waverley 018B","E01030909",536,119,61,58,389,84,225,87,105,33,46,34,9,3,33,20,13,1,1,28,11,17
"2021","Waverley 018C","E01030910",499,139,84,55,335,90,185,67,85,33,38,26,9,3,21,13,8,1,1,25,12,13
"2021","Waverley 018D","E01030934",592,199,100,99,383,76,217,65,113,39,52,28,21,3,38,17,21,0,0,10,3,7
"2021","Waverley 018E","E01030935",516,125,64,61,373,65,227,77,106,44,47,27,16,4,33,21,12,1,1,18,6,12
"2021","Waverley 018F","E01032626",686,229,104,125,422,99,212,59,118,35,64,41,20,3,45,19,26,2,2,35,13,22
"2021","Woking 001A","E01030946",624,218,101,117,369,39,162,48,81,33,78,36,35,7,84,52,32,6,6,37,17,20
"2021","Woking 001B","E01030947",517,80,53,27,394,57,227,53,122,52,56,23,30,3,54,33,21,0,0,43,19,24
"2021","Woking 001C","E01030948",671,167,88,79,468,63,246,75,122,49,73,42,28,3,78,47,31,8,8,36,10,26
"2021","Woking 001D","E01030949",732,182,83,99,499,45,272,75,157,40,94,45,43,6,82,45,37,6,6,51,25,26
"2021","Woking 001E","E01030950",704,251,158,93,414,58,217,63,120,34,65,34,25,6,73,31,42,1,1,39,9,30
"2021","Woking 002A","E01030996",569,85,57,28,451,114,286,74,163,49,32,15,13,4,18,8,10,1,1,33,11,22
"2021","Woking 002B","E01030998",729,131,104,27,577,166,342,98,170,74,31,11,17,3,37,12,25,1,1,21,6,15
"2021","Woking 002C","E01031002",681,143,94,49,501,108,303,92,155,56,45,26,16,3,44,20,24,1,1,37,17,20
"2021","Woking 002D","E01031003",658,104,63,41,529,106,370,93,221,56,30,20,10,0,21,11,10,2,2,25,8,17
"2021","Woking 002E","E01031004",1094,438,157,281,604,56,285,92,163,30,151,100,48,3,99,67,32,13,13,52,15,37
"2021","Woking 003A","E01030963",533,71,49,22,442,108,286,76,156,54,27,12,13,2,21,10,11,0,0,20,7,13
"2021","Woking 003B","E01030964",745,179,48,131,521,89,302,98,157,47,83,64,17,2,36,23,13,11,11,45,12,33
"2021","Woking 003C","E01030965",569,98,48,50,443,94,268,77,138,53,44,28,15,1,35,15,20,2,2,28,15,13
"2021","Woking 003D","E01030966",501,78,44,34,400,58,255,59,155,41,35,17,16,2,48,26,22,4,4,23,9,14
"2021","Woking 003E","E01030967",634,133,88,45,478,113,279,77,146,56,44,21,20,3,41,12,29,1,1,23,11,12
"2021","Woking 003F","E01030968",552,152,66,86,371,49,202,54,118,30,50,32,15,3,67,49,18,3,3,29,11,18
"2021","Woking 004A","E01030980",579,146,21,125,324,4,188,46,117,25,65,47,16,2,58,31,27,9,9,109,62,47
"2021","Woking 004B","E01030981",467,83,36,47,249,22,173,17,106,50,14,5,6,3,34,15,19,6,6,135,83,52
"2021","Woking 004D","E01030983",796,285,87,198,405,24,200,66,116,18,97,78,15,4,72,43,29,12,12,106,56,50
"2021","Woking 004E","E01030984",667,124,51,73,438,23,265,43,162,60,54,18,26,10,85,47,38,11,11,105,64,41
"2021","Woking 004G","E01034293",977,257,80,177,567,27,314,60,193,61,82,44,28,10,132,75,57,12,12,153,90,63
"2021","Woking 005A","E01030951",597,227,89,138,344,31,167,58,79,30,96,71,20,5,45,26,19,5,5,26,15,11
"2021","Woking 005B","E01030952",609,183,75,108,379,18,167,32,117,18,59,22,31,6,128,88,40,7,7,47,31,16
"2021","Woking 005C","E01030953",641,212,97,115,398,68,230,72,125,33,66,46,15,5,33,10,23,1,1,31,14,17
"2021","Woking 005D","E01030956",512,140,55,85,342,31,204,63,93,48,56,30,21,5,48,25,23,3,3,30,17,13
"2021","Woking 005E","E01030957",474,112,44,68,338,16,181,46,98,37,57,26,28,3,84,53,31,0,0,24,7,17
"2021","Woking 005F","E01030958",619,177,73,104,414,47,232,87,110,35,78,53,25,0,53,27,26,4,4,28,15,13
"2021","Woking 005G","E01030959",477,180,108,72,274,31,147,46,76,25,53,33,20,0,40,24,16,3,3,23,12,11
"2021","Woking 006A","E01030988",828,242,50,192,509,58,286,95,147,44,109,97,10,2,49,27,22,7,7,77,28,49
"2021","Woking 006B","E01030989",671,149,57,92,451,54,250,63,139,48,77,50,21,6,63,33,30,7,7,71,35,36
"2021","Woking 006C","E01030990",583,143,78,65,415,96,262,80,142,40,25,18,7,0,32,17,15,0,0,25,14,11
"2021","Woking 006D","E01030997",684,247,158,89,407,108,201,66,108,27,47,25,18,4,47,25,22,4,4,30,11,19
"2021","Woking 007A","E01030974",637,195,73,122,394,43,192,62,98,32,86,50,29,7,67,38,29,6,6,48,21,27
"2021","Woking 007B","E01030975",565,124,76,48,412,59,225,65,120,40,65,29,27,9,59,38,21,4,4,29,17,12
"2021","Woking 007C","E01030976",632,167,73,94,432,58,234,67,119,48,84,50,29,5,54,28,26,2,2,33,12,21
"2021","Woking 007D","E01030977",734,199,86,113,491,72,297,96,148,53,60,41,17,2,58,34,24,4,4,44,17,27
"2021","Woking 007E","E01030979",816,203,60,143,565,38,313,73,200,40,105,55,46,4,104,71,33,5,5,48,18,30
"2021","Woking 008A","E01030954",1108,397,94,303,629,37,305,97,182,26,186,151,34,1,86,54,32,15,15,82,22,60
"2021","Woking 008B","E01030969",564,118,67,51,427,56,299,75,187,37,36,22,12,2,34,21,13,2,2,19,7,12
"2021","Woking 008C","E01030970",631,204,99,105,403,46,248,65,149,34,65,50,14,1,42,17,25,2,2,24,7,17
"2021","Woking 008D","E01030991",1009,438,180,258,497,31,248,79,144,25,129,91,37,1,74,48,26,15,15,74,19,55
"2021","Woking 008F","E01034294",884,372,26,346,464,0,205,110,93,2,206,193,12,1,35,23,12,18,18,48,5,43
"2021","Woking 008G","E01034295",844,358,130,228,417,29,197,71,112,14,122,105,16,1,55,36,19,14,14,69,15,54
"2021","Woking 009A","E01030960",738,199,69,130,506,47,271,78,146,47,91,52,34,5,91,53,38,6,6,33,15,18
"2021","Woking 009B","E01030961",718,139,98,41,531,89,327,81,181,65,66,24,32,10,49,22,27,0,0,48,25,23
"2021","Woking 009C","E01030962",774,308,143,165,438,43,211,78,98,35,89,56,30,3,91,58,33,4,4,28,11,17
"2021","Woking 009D","E01031000",669,219,124,95,423,85,225,71,124,30,69,45,22,2,38,25,13,6,6,27,11,16
"2021","Woking 010A","E01030955",568,165,86,79,379,64,220,54,127,39,57,28,23,6,36,18,18,2,2,24,16,8
"2021","Woking 010B","E01030992",697,149,56,93,500,75,288,82,158,48,85,68,17,0,47,25,22,5,5,48,14,34
"2021","Woking 010C","E01030999",505,74,52,22,409,95,268,82,137,49,26,15,9,2,20,9,11,0,0,22,11,11
"2021","Woking 010D","E01031001",721,241,113,128,431,62,270,69,148,53,64,47,17,0,32,22,10,3,3,49,22,27
"2021","Woking 011A","E01030971",889,190,81,109,606,60,342,79,218,45,101,51,44,6,98,58,40,5,5,93,50,43
"2021","Woking 011B","E01030972",715,147,73,74,488,44,291,76,168,47,71,42,26,3,76,43,33,6,6,80,40,40
"2021","Woking 011D","E01030994",780,199,81,118,518,30,304,95,165,44,96,58,33,5,85,56,29,3,3,63,29,34
"2021","Woking 011E","E01030995",660,151,57,94,463,17,251,73,140,38,100,52,41,7,88,58,30,7,7,46,17,29
"2021","Woking 011F","E01034296",509,126,71,55,350,55,189,64,90,35,48,34,10,4,55,31,24,3,3,33,13,20
"2021","Woking 011G","E01034297",598,84,20,64,473,6,227,48,155,24,91,36,51,4,148,118,30,1,1,41,28,13
"2021","Woking 012A","E01030944",487,71,32,39,378,46,247,73,144,30,43,21,16,6,41,21,20,1,1,38,19,19
"2021","Woking 012B","E01030945",509,118,64,54,365,47,210,55,118,37,69,45,20,4,37,26,11,2,2,26,11,15
"2021","Woking 012C","E01030978",809,135,51,84,632,37,425,97,271,57,96,60,34,2,71,42,29,3,3,42,15,27
"2021","Woking 012D","E01030986",451,123,97,26,299,71,181,62,87,32,31,23,5,3,13,6,7,3,3,29,4,25
"2021","Woking 012E","E01030987",517,92,52,40,390,82,239,80,106,53,41,22,15,4,28,13,15,0,0,35,12,23
"2021","Adur 001A","E01031349",550,143,100,43,361,75,193,45,94,54,55,18,28,9,36,14,22,2,2,46,21,25
"2021","Adur 001B","E01031350",493,119,60,59,323,33,166,42,78,46,67,20,39,8,52,26,26,5,5,51,27,24
"2021","Adur 001C","E01031351",648,151,106,45,454,84,237,65,114,58,75,31,39,5,56,29,27,2,2,43,18,25
"2021","Adur 001D","E01031352",649,153,103,50,463,92,204,69,82,53,79,34,38,7,85,41,44,3,3,33,11,22
"2021","Adur 001E","E01031370",566,116,67,49,405,66,184,48,95,41,74,27,41,6,77,33,44,4,4,45,21,24
"2021","Adur 001F","E01031374",701,211,102,109,450,57,232,65,125,42,88,46,38,4,69,45,24,4,4,40,17,23
"2021","Adur 002A","E01031338",517,117,78,39,371,84,175,50,103,22,59,27,26,6,50,26,24,3,3,29,11,18
"2021","Adur 002B","E01031339",512,145,80,65,342,50,193,54,103,36,56,35,20,1,41,23,18,2,2,25,9,16
"2021","Adur 002C","E01031340",637,145,115,30,464,128,256,92,120,44,51,23,26,2,28,14,14,1,1,28,12,16
"2021","Adur 002D","E01031365",805,251,148,103,520,78,253,78,138,37,93,44,43,6,89,60,29,7,7,34,12,22
"2021","Adur 002E","E01031367",547,102,81,21,416,106,225,70,117,38,55,21,32,2,28,10,18,2,2,29,9,20
"2021","Adur 003A","E01031345",653,152,107,45,463,83,257,99,111,47,72,39,31,2,48,19,29,3,3,38,13,25
"2021","Adur 003B","E01031353",458,100,69,31,332,89,176,63,78,35,45,23,20,2,21,13,8,1,1,26,6,20
"2021","Adur 003C","E01031354",560,136,87,49,396,95,199,81,78,40,65,31,28,6,34,15,19,3,3,28,7,21
"2021","Adur 003D","E01031355",706,161,86,75,491,77,247,71,133,43,78,31,39,8,85,45,40,4,4,54,18,36
"2021","Adur 003E","E01031359",532,108,59,49,383,57,201,63,93,45,69,26,34,9,55,26,29,1,1,41,16,25
"2021","Adur 004A","E01031347",652,156,74,82,431,44,185,47,105,33,94,38,46,10,102,69,33,6,6,65,20,45
"2021","Adur 004B","E01031348",678,187,75,112,429,31,193,44,115,34,93,30,54,9,109,76,33,3,3,62,25,37
"2021","Adur 004C","E01031366",490,118,50,68,331,31,164,39,89,36,55,11,30,14,79,38,41,2,2,41,16,25
"2021","Adur 004D","E01031371",611,246,138,108,343,41,134,48,59,27,72,31,37,4,93,63,30,3,3,22,9,13
"2021","Adur 004E","E01031372",620,178,100,78,404,59,163,50,87,26,79,35,34,10,99,61,38,4,4,38,13,25
"2021","Adur 004F","E01031373",627,207,114,93,382,53,173,65,81,27,73,35,32,6,80,54,26,3,3,38,17,21
"2021","Adur 004G","E01031375",685,229,131,98,417,76,166,66,66,34,98,50,42,6,74,46,28,3,3,39,16,23
"2021","Adur 005A","E01031356",1051,302,134,168,698,118,353,124,194,35,140,83,48,9,83,51,32,4,4,51,9,42
"2021","Adur 005B","E01031357",1024,344,185,159,607,94,269,98,129,42,143,91,46,6,92,57,35,9,9,73,19,54
"2021","Adur 005C","E01031364",1005,460,167,293,491,66,150,74,52,24,152,99,50,3,117,82,35,6,6,54,13,41
"2021","Adur 005D","E01031368",640,200,114,86,399,83,198,68,105,25,68,33,31,4,49,20,29,1,1,41,11,30
"2021","Adur 005E","E01031369",635,269,187,82,346,88,155,55,75,25,55,36,16,3,43,25,18,5,5,20,6,14
"2021","Adur 006A","E01031344",617,183,70,113,385,70,181,59,75,47,71,30,35,6,59,34,25,4,4,49,20,29
"2021","Adur 006B","E01031346",631,184,106,78,407,91,181,61,83,37,81,42,32,7,50,29,21,4,4,40,16,24
"2021","Adur 006C","E01031361",617,197,107,90,377,55,165,45,86,34,74,33,33,8,80,45,35,3,3,43,17,26
"2021","Adur 006D","E01031362",515,117,59,58,368,64,176,59,83,34,72,32,37,3,55,31,24,1,1,30,11,19
"2021","Adur 006E","E01031363",740,248,176,72,453,113,201,92,63,46,78,40,31,7,59,26,33,2,2,39,12,27
"2021","Adur 007A","E01031358",635,189,123,66,404,61,182,54,83,45,83,31,43,9,72,40,32,6,6,42,18,24
"2021","Adur 007B","E01031360",657,183,97,86,436,71,200,78,71,51,82,39,38,5,82,49,33,1,1,38,21,17
"2021","Adur 007C","E01031376",651,253,161,92,372,110,142,75,38,29,76,45,26,5,43,20,23,1,1,26,5,21
"2021","Adur 007D","E01031378",668,241,124,117,386,88,148,59,66,23,89,49,34,6,59,37,22,2,2,41,17,24
"2021","Adur 008A","E01031341",650,242,114,128,374,44,153,42,70,41,83,37,37,9,92,61,31,2,2,34,14,20
"2021","Adur 008B","E01031342",783,300,186,114,444,135,150,59,61,30,89,60,28,1,66,36,30,4,4,39,18,21
"2021","Adur 008C","E01031343",624,218,131,87,359,80,159,49,67,43,67,43,23,1,51,23,28,2,2,47,18,29
"2021","Adur 008D","E01031377",876,393,162,231,438,65,170,76,71,23,123,67,49,7,76,52,24,4,4,45,12,33
"2021","Adur 008E","E01031379",758,262,183,79,456,108,207,90,78,39,80,37,37,6,58,24,34,3,3,40,16,24
"2021","Arun 001A","E01031390",593,179,121,58,380,83,178,68,67,43,53,29,18,6,64,42,22,2,2,34,15,19
"2021","Arun 001B","E01031391",725,274,175,99,426,96,197,85,78,34,78,44,29,5,48,26,22,7,7,25,8,17
"2021","Arun 001C","E01031392",756,301,180,121,421,127,183,86,62,35,61,49,12,0,46,25,21,4,4,34,10,24
"2021","Arun 001D","E01031465",569,144,96,48,391,98,223,93,87,43,49,33,12,4,20,9,11,1,1,34,14,20
"2021","Arun 002A","E01031386",614,137,88,49,440,87,198,67,76,55,76,42,27,7,76,33,43,3,3,37,15,22
"2021","Arun 002B","E01031387",709,218,154,64,456,95,226,91,87,48,81,37,40,4,53,21,32,1,1,35,9,26
"2021","Arun 002C","E01031425",635,183,120,63,432,143,206,105,64,37,50,32,15,3,32,18,14,1,1,20,10,10
"2021","Arun 002D","E01031426",539,157,92,65,350,81,160,71,52,37,67,45,20,2,42,21,21,0,0,32,9,23
"2021","Arun 003A","E01031393",1006,242,144,98,715,160,368,135,171,62,110,52,51,7,75,52,23,2,2,49,23,26
"2021","Arun 003B","E01031394",693,177,82,95,481,74,226,73,98,55,84,46,34,4,94,50,44,3,3,35,15,20
"2021","Arun 003C","E01031395",689,169,95,74,484,101,258,76,127,55,64,29,24,11,56,26,30,5,5,36,13,23
"2021","Arun 003D","E01031396",990,251,120,131,694,94,372,133,167,72,138,85,49,4,85,57,28,5,5,45,10,35
"2021","Arun 003E","E01031397",731,172,112,60,509,122,278,123,103,52,67,38,26,3,42,22,20,0,0,50,14,36
"2021","Arun 003F","E01031466",623,161,97,64,423,126,215,81,87,47,45,20,21,4,37,19,18,0,0,39,12,27
"2021","Arun 004A","E01031427",697,218,101,117,431,31,154,47,85,22,109,35,64,10,133,81,52,4,4,48,24,24
"2021","Arun 004B","E01031429",574,149,57,92,371,29,152,40,76,36,78,18,51,9,110,79,31,2,2,54,29,25
"2021","Arun 004C","E01031430",626,186,92,94,402,70,157,64,56,37,74,34,33,7,95,41,54,6,6,38,17,21
"2021","Arun 004F","E01034816",775,130,25,105,601,17,276,76,179,21,172,78,91,3,132,109,23,4,4,44,22,22
"2021","Arun 004G","E01034817",788,168,51,117,580,47,327,115,169,43,123,53,67,3,83,53,30,0,0,40,14,26
"2021","Arun 004H","E01034818",624,164,77,87,413,75,190,66,85,39,82,28,40,14,65,36,29,1,1,47,23,24
"2021","Arun 004I","E01034819",710,175,92,83,495,82,243,86,127,30,98,55,42,1,70,45,25,2,2,40,19,21
"2021","Arun 005B","E01031389",943,234,176,58,665,212,325,133,131,61,65,35,24,6,60,33,27,3,3,44,16,28
"2021","Arun 005C","E01031414",627,149,116,33,437,99,201,67,87,47,65,38,25,2,70,29,41,2,2,41,12,29
"2021","Arun 005D","E01031415",801,337,272,65,435,141,174,66,60,48,60,33,22,5,57,34,23,3,3,29,8,21
"2021","Arun 005E","E01031459",830,298,164,134,477,77,206,70,100,36,86,42,34,10,101,57,44,7,7,55,19,36
"2021","Arun 005F","E01034820",795,103,43,60,648,88,348,100,193,55,106,42,58,6,103,75,28,3,3,44,21,23
"2021","Arun 005G","E01034821",714,196,115,81,484,71,230,72,129,29,118,69,42,7,64,37,27,1,1,34,13,21
"2021","Arun 006A","E01031470",651,208,119,89,414,133,190,94,66,30,50,25,20,5,40,21,19,1,1,29,13,16
"2021","Arun 006B","E01031471",866,169,84,85,648,80,334,118,159,57,128,62,55,11,103,71,32,3,3,49,24,25
"2021","Arun 006C","E01031472",684,206,125,81,431,94,215,86,82,47,77,42,26,9,44,26,18,1,1,47,20,27
"2021","Arun 006D","E01031473",524,158,84,74,338,54,147,52,65,30,61,22,34,5,75,45,30,1,1,28,14,14
"2021","Arun 007A","E01031407",622,137,71,66,447,76,230,88,96,46,71,38,25,8,70,39,31,0,0,38,14,24
"2021","Arun 007B","E01031408",868,226,102,124,595,63,290,98,136,56,137,71,55,11,101,52,49,4,4,47,20,27
"2021","Arun 007C","E01031410",614,225,125,100,378,59,176,68,73,35,76,38,34,4,62,33,29,5,5,11,2,9
"2021","Arun 007D","E01031462",650,178,111,67,442,75,202,64,98,40,83,30,48,5,77,52,25,5,5,30,9,21
"2021","Arun 007E","E01031463",659,168,106,62,455,110,236,83,110,43,55,24,26,5,52,25,27,2,2,36,18,18
"2021","Arun 007F","E01031464",836,313,228,85,481,131,174,68,70,36,70,43,25,2,102,58,44,4,4,42,14,28
"2021","Arun 008A","E01031412",640,153,119,34,462,186,219,105,67,47,32,18,10,4,25,13,12,0,0,25,7,18
"2021","Arun 008B","E01031422",786,254,191,63,505,237,201,117,45,39,44,31,9,4,21,11,10,2,2,27,4,23
"2021","Arun 008C","E01031423",883,294,205,89,545,173,246,115,85,46,72,37,28,7,51,32,19,3,3,44,15,29
"2021","Arun 008D","E01031424",697,230,179,51,444,185,174,94,43,37,42,25,11,6,43,17,26,0,0,23,10,13
"2021","Arun 009A","E01031398",607,160,108,52,413,92,209,63,79,67,50,23,17,10,57,36,21,5,5,34,11,23
"2021","Arun 009B","E01031399",752,206,166,40,511,197,204,89,53,62,60,24,27,9,50,23,27,0,0,35,15,20
"2021","Arun 009C","E01031409",519,109,68,41,361,32,180,55,75,50,74,25,40,9,69,41,28,6,6,49,26,23
"2021","Arun 009D","E01031455",717,262,188,74,403,93,181,71,78,32,71,34,29,8,54,21,33,4,4,52,21,31
"2021","Arun 009E","E01031461",856,279,203,76,548,193,245,109,73,63,51,29,17,5,54,26,28,5,5,29,8,21
"2021","Arun 009F","E01031469",771,267,145,122,465,116,205,76,83,46,75,43,28,4,66,46,20,3,3,39,11,28
"2021","Arun 010A","E01031411",667,215,177,38,428,217,169,90,40,39,23,16,6,1,19,6,13,0,0,24,8,16
"2021","Arun 010B","E01031413",692,276,178,98,388,129,177,97,52,28,45,32,12,1,33,15,18,4,4,28,8,20
"2021","Arun 010C","E01031457",955,441,321,120,492,211,155,79,40,36,68,48,19,1,54,31,23,4,4,22,7,15
"2021","Arun 010D","E01031458",917,301,250,51,589,289,215,121,45,49,47,31,13,3,36,11,25,2,2,27,7,20
"2021","Arun 010E","E01031460",959,418,305,113,509,236,170,87,45,38,61,41,17,3,41,13,28,1,1,32,11,21
"2021","Arun 011A","E01031400",827,400,142,258,395,82,130,57,52,21,103,63,31,9,63,39,24,17,17,32,10,22
"2021","Arun 011B","E01031428",654,215,70,145,379,42,164,68,71,25,87,45,38,4,81,50,31,5,5,60,28,32
"2021","Arun 011C","E01031454",1184,516,154,362,599,47,232,102,92,38,153,81,64,8,154,106,48,13,13,69,25,44
"2021","Arun 011D","E01031456",960,551,227,324,358,50,118,58,45,15,106,67,34,5,75,54,21,9,9,51,13,38
"2021","Arun 012B","E01031402",741,198,117,81,501,116,215,75,91,49,107,66,36,5,59,35,24,4,4,42,17,25
"2021","Arun 012C","E01031403",645,194,111,83,403,56,177,58,79,40,90,47,38,5,78,38,40,2,2,48,21,27
"2021","Arun 012D","E01031405",650,198,125,73,427,82,186,95,62,29,86,42,38,6,71,46,25,2,2,25,8,17
"2021","Arun 012E","E01031406",508,97,64,33,359,49,180,64,80,36,71,28,35,8,59,37,22,0,0,52,30,22
"2021","Arun 012F","E01034822",756,143,33,110,567,65,273,81,170,22,139,75,61,3,86,65,21,4,4,46,23,23
"2021","Arun 012G","E01034823",753,197,117,80,494,85,230,94,97,39,104,61,35,8,69,39,30,6,6,62,22,40
"2021","Arun 013A","E01031417",711,193,116,77,476,91,220,72,112,36,81,36,41,4,81,43,38,3,3,42,15,27
"2021","Arun 013B","E01031438",722,275,167,108,422,70,200,77,81,42,90,54,31,5,62,41,21,0,0,25,9,16
"2021","Arun 013C","E01031439",934,334,267,67,556,241,228,112,76,40,50,33,10,7,36,16,20,1,1,44,18,26
"2021","Arun 013D","E01031440",769,261,169,92,479,164,195,113,49,33,73,50,17,6,46,20,26,1,1,29,8,21
"2021","Arun 014A","E01031404",471,146,71,75,286,21,116,34,62,20,50,21,24,5,94,63,31,5,5,39,21,18
"2021","Arun 014B","E01031433",621,174,95,79,383,86,142,55,59,28,64,36,23,5,86,45,41,5,5,64,18,46
"2021","Arun 014C","E01031434",716,271,110,161,375,31,149,65,63,21,109,64,41,4,79,49,30,7,7,70,21,49
"2021","Arun 014D","E01031441",749,241,126,115,460,58,197,60,98,39,105,50,50,5,98,53,45,2,2,48,18,30
"2021","Arun 014E","E01031442",675,160,61,99,421,46,209,71,100,38,87,48,32,7,69,39,30,10,10,94,33,61
"2021","Arun 015A","E01031416",649,141,109,32,475,170,224,98,81,45,46,30,11,5,34,16,18,1,1,33,11,22
"2021","Arun 015B","E01031418",894,250,174,76,604,180,304,112,117,75,71,34,34,3,49,31,18,0,0,40,15,25
"2021","Arun 015C","E01031419",767,307,188,119,416,122,162,61,62,39,67,38,25,4,62,29,33,3,3,44,17,27
"2021","Arun 015D","E01031420",798,260,203,57,506,170,230,90,91,49,64,35,23,6,39,18,21,3,3,32,9,23
"2021","Arun 015F","E01034824",688,117,43,74,526,47,232,61,138,33,134,62,67,5,113,93,20,0,0,45,24,21
"2021","Arun 015G","E01034825",715,165,117,48,510,135,247,78,124,45,74,42,29,3,52,29,23,2,2,40,14,26
"2021","Arun 016A","E01031443",522,120,58,62,351,37,152,41,65,46,73,24,40,9,87,42,45,2,2,51,19,32
"2021","Arun 016B","E01031444",665,200,59,141,384,23,173,62,75,36,86,53,29,4,88,55,33,14,14,81,23,58
"2021","Arun 016C","E01031450",558,127,45,82,372,35,130,42,62,26,89,31,47,11,109,64,45,9,9,59,22,37
"2021","Arun 016D","E01031451",721,226,126,100,442,46,187,54,110,23,99,30,55,14,103,68,35,7,7,53,29,24
"2021","Arun 016E","E01031452",544,137,78,59,341,51,193,68,82,43,55,29,20,6,39,26,13,3,3,66,20,46
"2021","Arun 017A","E01031431",459,264,169,95,160,49,55,34,18,3,33,22,9,2,19,13,6,4,4,35,5,30
"2021","Arun 017B","E01031432",971,419,145,274,469,56,132,63,53,16,147,98,43,6,115,77,38,19,19,83,23,60
"2021","Arun 017C","E01031435",784,278,106,172,454,90,195,74,80,41,99,61,33,5,64,43,21,6,6,52,22,30
"2021","Arun 017D","E01031436",1063,532,175,357,448,55,134,69,47,18,146,97,45,4,92,65,27,21,21,83,25,58
"2021","Arun 017E","E01031437",1013,495,174,321,437,58,148,65,71,12,131,87,41,3,91,58,33,9,9,81,24,57
"2021","Arun 017F","E01031453",759,334,174,160,352,58,141,52,53,36,81,51,28,2,60,32,28,12,12,73,16,57
"2021","Arun 018A","E01031380",752,206,150,56,529,236,213,112,57,44,48,28,16,4,31,16,15,1,1,17,8,9
"2021","Arun 018B","E01031381",775,257,185,72,478,171,217,88,88,41,45,30,11,4,38,14,24,7,7,40,8,32
"2021","Arun 018C","E01031382",801,233,182,51,525,199,208,96,64,48,78,45,26,7,39,18,21,1,1,43,20,23
"2021","Arun 018D","E01031383",743,198,162,36,519,235,226,121,62,43,33,22,7,4,22,9,13,3,3,26,8,18
"2021","Arun 018E","E01031384",779,211,155,56,532,199,232,99,85,48,64,34,26,4,35,16,19,2,2,36,12,24
"2021","Arun 019A","E01031385",746,274,185,89,449,130,192,69,92,31,65,41,21,3,60,31,29,2,2,23,8,15
"2021","Arun 019B","E01031445",826,303,218,85,482,194,183,99,51,33,55,30,19,6,47,22,25,3,3,41,11,30
"2021","Arun 019C","E01031446",619,186,137,49,400,122,177,67,68,42,66,39,24,3,33,17,16,2,2,33,17,16
"2021","Arun 019D","E01031447",758,231,168,63,488,152,215,99,70,46,69,36,26,7,49,20,29,3,3,39,18,21
"2021","Arun 019E","E01031448",763,254,172,82,478,156,188,104,58,26,80,49,26,5,50,25,25,4,4,31,6,25
"2021","Arun 019F","E01031449",707,159,87,72,519,98,254,102,103,49,72,39,25,8,92,64,28,3,3,29,11,18
"2021","Chichester 001A","E01031502",588,106,57,49,455,73,305,79,188,38,53,39,12,2,23,16,7,1,1,27,14,13
"2021","Chichester 001B","E01031503",567,136,61,75,411,59,256,88,129,39,47,27,19,1,49,26,23,0,0,20,9,11
"2021","Chichester 001C","E01031504",939,276,151,125,639,134,329,139,147,43,89,42,42,5,86,56,30,1,1,24,6,18
"2021","Chichester 001D","E01031519",557,121,53,68,401,75,234,88,100,46,52,23,20,9,38,18,20,2,2,35,8,27
"2021","Chichester 002A","E01031517",801,147,88,59,622,148,355,126,153,76,77,47,27,3,41,24,17,1,1,32,15,17
"2021","Chichester 002B","E01031518",648,119,77,42,501,113,295,109,127,59,56,30,20,6,34,18,16,3,3,28,10,18
"2021","Chichester 002C","E01031544",539,140,73,67,370,73,184,74,80,30,64,29,31,4,46,25,21,3,3,29,10,19
"2021","Chichester 002D","E01031545",542,145,87,58,377,89,207,72,91,44,42,23,18,1,38,22,16,1,1,20,5,15
"2021","Chichester 003A","E01031508",874,231,136,95,600,127,354,155,131,68,57,30,24,3,62,32,30,0,0,43,12,31
"2021","Chichester 003B","E01031520",561,161,87,74,373,86,208,80,97,31,43,22,19,2,34,17,17,2,2,27,10,17
"2021","Chichester 003C","E01031521",453,97,55,42,334,84,184,61,85,38,30,17,11,2,35,14,21,1,1,22,6,16
"2021","Chichester 003D","E01031536",539,130,80,50,384,96,189,86,72,31,52,29,20,3,44,24,20,3,3,25,5,20
"2021","Chichester 004A","E01031497",744,235,117,118,489,127,240,109,90,41,75,49,23,3,46,30,16,1,1,20,4,16
"2021","Chichester 004C","E01031511",746,300,197,103,427,121,203,84,96,23,64,41,22,1,39,25,14,0,0,19,6,13
"2021","Chichester 004D","E01031512",898,300,185,115,571,102,251,95,119,37,109,57,46,6,101,75,26,8,8,27,10,17
"2021","Chichester 004G","E01035320",979,397,213,184,544,137,229,102,95,32,101,74,24,3,72,45,27,5,5,38,5,33
"2021","Chichester 004H","E01035321",449,104,65,39,323,93,162,71,61,30,44,21,21,2,21,12,9,3,3,22,6,16
"2021","Chichester 005A","E01031478",470,105,60,45,337,102,175,78,71,26,37,22,15,0,21,10,11,2,2,28,5,23
"2021","Chichester 005B","E01031479",448,134,79,55,296,77,165,77,55,33,27,17,7,3,23,11,12,4,4,18,7,11
"2021","Chichester 005C","E01031498",463,140,74,66,307,65,169,59,76,34,34,22,10,2,39,18,21,0,0,16,6,10
"2021","Chichester 005D","E01031514",771,289,190,99,455,121,219,98,72,49,59,30,24,5,51,21,30,5,5,27,8,19
"2021","Chichester 005E","E01031515",728,236,140,96,469,81,208,81,88,39,92,32,51,9,83,49,34,5,5,23,11,12
"2021","Chichester 005F","E01031516",670,178,106,72,458,110,236,121,78,37,68,35,29,4,44,20,24,0,0,34,13,21
"2021","Chichester 006A","E01031477",1033,343,195,148,637,158,291,129,116,46,115,64,43,8,68,41,27,5,5,53,13,40
"2021","Chichester 006B","E01031485",683,203,159,44,452,160,225,76,100,49,33,19,10,4,32,13,19,2,2,28,8,20
"2021","Chichester 006C","E01031487",684,195,142,53,436,169,188,85,68,35,34,20,11,3,42,28,14,3,3,53,9,44
"2021","Chichester 006E","E01035322",633,182,103,79,433,90,214,94,85,35,64,35,26,3,63,36,27,2,2,18,8,10
"2021","Chichester 006F","E01035323",639,164,72,92,445,77,215,85,104,26,88,46,37,5,65,35,30,0,0,30,13,17
"2021","Chichester 007A","E01031506",551,150,93,57,365,103,196,87,75,34,34,19,12,3,30,15,15,2,2,36,12,24
"2021","Chichester 007B","E01031507",593,140,74,66,421,104,229,112,87,30,57,45,11,1,30,15,15,1,1,32,4,28
"2021","Chichester 007C","E01031531",526,118,91,27,389,96,212,70,96,46,43,16,22,5,34,19,15,4,4,19,8,11
"2021","Chichester 007D","E01031533",617,202,106,96,388,52,181,59,82,40,73,40,26,7,82,56,26,0,0,27,6,21
"2021","Chichester 007E","E01031543",1057,316,145,171,700,138,333,126,150,57,110,59,40,11,119,75,44,0,0,41,18,23
"2021","Chichester 008A","E01031482",696,250,94,156,387,29,150,55,70,25,105,57,45,3,98,62,36,5,5,59,10,49
"2021","Chichester 008B","E01031483",1009,336,90,246,536,44,218,73,104,41,121,66,49,6,146,84,62,7,7,137,18,119
"2021","Chichester 008C","E01031486",839,409,239,170,362,109,134,62,56,16,71,49,20,2,40,20,20,8,8,68,9,59
"2021","Chichester 008E","E01031494",749,244,139,105,463,52,177,61,76,40,88,31,50,7,141,96,45,5,5,42,10,32
"2021","Chichester 008F","E01031495",723,283,154,129,392,97,158,61,75,22,72,50,20,2,62,25,37,3,3,48,2,46
"2021","Chichester 008G","E01035324",652,202,62,140,376,29,143,58,70,15,101,57,39,5,96,70,26,7,7,74,13,61
"2021","Chichester 008H","E01035325",729,224,89,135,443,71,198,75,98,25,84,54,27,3,86,57,29,4,4,62,8,54
"2021","Chichester 009A","E01031475",714,128,72,56,539,115,279,106,137,36,85,48,32,5,58,34,24,2,2,47,20,27
"2021","Chichester 009B","E01031476",719,222,163,59,459,148,225,98,90,37,48,26,16,6,37,22,15,1,1,38,14,24
"2021","Chichester 009C","E01031532",480,98,57,41,374,43,269,70,186,13,28,12,14,2,32,22,10,2,2,8,3,5
"2021","Chichester 009D","E01031534",922,365,196,169,532,150,233,119,72,42,74,49,16,9,74,40,34,1,1,25,10,15
"2021","Chichester 009E","E01031535",889,249,122,127,588,129,263,116,110,37,108,62,42,4,85,55,30,3,3,52,23,29
"2021","Chichester 010A","E01031480",609,205,64,141,366,30,163,65,79,19,111,78,31,2,61,35,26,1,1,38,11,27
"2021","Chichester 010B","E01031481",742,275,131,144,406,58,174,76,63,35,76,49,22,5,85,46,39,13,13,61,19,42
"2021","Chichester 010C","E01031484",941,418,229,189,455,101,170,72,75,23,100,72,24,4,72,37,35,12,12,68,9,59
"2021","Chichester 010D","E01031490",1101,581,355,226,461,129,159,85,55,19,105,86,17,2,51,31,20,17,17,59,4,55
"2021","Chichester 010E","E01031491",958,435,201,234,474,82,196,79,89,28,118,84,30,4,68,41,27,10,10,49,10,39
"2021","Chichester 011A","E01031474",645,215,120,95,400,78,202,80,81,41,62,33,25,4,57,32,25,1,1,30,9,21
"2021","Chichester 011B","E01031493",788,259,160,99,497,136,213,86,100,27,71,41,25,5,65,40,25,12,12,32,10,22
"2021","Chichester 011C","E01031496",1107,286,156,130,762,147,419,160,194,65,107,58,43,6,82,44,38,7,7,59,15,44
"2021","Chichester 011D","E01031505",1098,299,168,131,745,160,389,129,194,66,108,56,43,9,84,59,25,4,4,54,16,38
"2021","Chichester 012A","E01031489",652,200,101,99,408,84,215,75,94,46,64,31,25,8,41,16,25,4,4,44,11,33
"2021","Chichester 012B","E01031492",718,239,132,107,401,45,158,50,68,40,83,31,45,7,109,67,42,6,6,78,18,60
"2021","Chichester 012D","E01031530",556,166,99,67,353,59,177,76,74,27,56,28,25,3,59,37,22,2,2,37,16,21
"2021","Chichester 012E","E01031538",649,178,94,84,429,62,213,70,96,47,65,20,42,3,84,51,33,5,5,42,14,28
"2021","Chichester 012F","E01031539",738,221,67,154,491,40,232,76,139,17,132,76,50,6,84,65,19,3,3,26,14,12
"2021","Chichester 012G","E01035326",653,173,62,111,442,59,203,70,99,34,109,60,46,3,69,51,18,2,2,38,14,24
"2021","Chichester 012H","E01035327",763,206,111,95,502,115,227,93,87,47,87,48,31,8,68,33,35,5,5,55,17,38
"2021","Chichester 013A","E01031499",775,242,118,124,500,86,237,115,91,31,71,30,38,3,103,65,38,3,3,33,9,24
"2021","Chichester 013B","E01031500",976,251,158,93,666,162,317,133,125,59,96,50,37,9,88,54,34,3,3,59,26,33
"2021","Chichester 013C","E01031501",708,270,187,83,403,111,155,81,44,30,65,38,22,5,67,33,34,5,5,35,10,25
"2021","Chichester 013D","E01031529",515,104,61,43,364,88,197,81,68,48,43,21,20,2,32,19,13,4,4,47,17,30
"2021","Chichester 013E","E01031540",640,192,139,53,422,127,196,99,69,28,46,25,18,3,46,24,22,7,7,26,6,20
"2021","Chichester 013F","E01031541",697,250,183,67,419,152,170,77,53,40,43,22,18,3,52,26,26,2,2,28,7,21
"2021","Chichester 013G","E01031542",903,247,160,87,616,174,299,132,117,50,80,49,25,6,58,38,20,5,5,40,10,30
"2021","Chichester 014A","E01031522",931,341,209,132,530,120,210,89,83,38,85,28,49,8,110,51,59,5,5,60,16,44
"2021","Chichester 014B","E01031523",756,251,181,70,466,119,215,89,84,42,62,36,21,5,66,35,31,4,4,39,10,29
"2021","Chichester 014C","E01031524",845,290,211,79,514,170,218,117,58,43,71,39,25,7,52,28,24,3,3,41,14,27
"2021","Chichester 014D","E01031525",617,187,134,53,397,118,164,81,58,25,51,22,28,1,63,24,39,1,1,33,10,23
"2021","Chichester 014E","E01031526",553,153,114,39,368,133,147,79,33,35,42,28,11,3,44,18,26,2,2,32,11,21
"2021","Chichester 014F","E01031527",656,188,130,58,421,144,192,101,52,39,53,27,21,5,32,17,15,0,0,47,19,28
"2021","Chichester 014G","E01031528",719,268,152,116,414,113,186,107,44,35,61,38,21,2,48,28,20,6,6,37,17,20
"2021","Crawley 001A","E01031573",658,162,65,97,412,26,213,50,133,30,59,26,27,6,109,72,37,5,5,84,35,49
"2021","Crawley 001B","E01031574",662,110,44,66,456,35,266,64,146,56,77,24,43,10,72,49,23,6,6,96,47,49
"2021","Crawley 001C","E01031575",624,180,45,135,353,32,177,50,96,31,56,26,26,4,76,39,37,12,12,91,42,49
"2021","Crawley 001D","E01031576",612,132,64,68,379,31,202,40,124,38,47,13,29,5,90,56,34,9,9,101,40,61
"2021","Crawley 001E","E01031577",455,85,36,49,264,21,162,31,86,45,26,9,16,1,47,18,29,8,8,106,50,56
"2021","Crawley 002A","E01031586",708,183,83,100,483,30,221,52,125,44,97,43,51,3,126,85,41,9,9,42,15,27
"2021","Crawley 002C","E01031588",592,146,85,61,413,60,238,80,110,48,67,25,35,7,45,30,15,3,3,33,16,17
"2021","Crawley 002D","E01031590",641,137,76,61,469,64,274,100,119,55,84,53,25,6,46,26,20,1,1,35,16,19
"2021","Crawley 002E","E01031593",622,173,61,112,411,52,251,89,115,47,68,52,13,3,39,20,19,1,1,38,11,27
"2021","Crawley 002F","E01035328",768,145,59,86,563,70,326,87,186,53,104,57,45,2,60,41,19,3,3,60,22,38
"2021","Crawley 002G","E01035329",864,127,12,115,683,17,332,83,232,17,208,124,80,4,120,110,10,6,6,54,31,23
"2021","Crawley 003A","E01031570",515,112,62,50,356,42,188,52,96,40,54,25,22,7,67,36,31,5,5,47,23,24
"2021","Crawley 003B","E01031571",669,172,83,89,434,36,209,50,120,39,90,26,51,13,98,67,31,1,1,63,26,37
"2021","Crawley 003C","E01031572",869,264,106,158,535,50,270,80,150,40,95,45,47,3,112,80,32,8,8,70,30,40
"2021","Crawley 003D","E01031609",687,239,104,135,397,39,202,72,94,36,66,36,27,3,83,51,32,7,7,51,19,32
"2021","Crawley 003E","E01031610",805,223,119,104,481,51,249,76,140,33,82,41,33,8,92,61,31,7,7,101,40,61
"2021","Crawley 004A","E01031583",964,289,53,236,573,28,268,85,146,37,153,90,57,6,104,66,38,20,20,102,31,71
"2021","Crawley 004B","E01031584",660,150,76,74,408,48,220,48,127,45,66,31,32,3,67,37,30,7,7,102,53,49
"2021","Crawley 004C","E01031585",1133,390,113,277,596,57,282,88,156,38,142,107,32,3,92,59,33,23,23,147,41,106
"2021","Crawley 004D","E01031601",524,123,75,48,334,48,171,37,95,39,44,14,24,6,63,36,27,8,8,67,36,31
"2021","Crawley 004F","E01032835",846,236,48,188,505,12,262,76,168,18,116,77,37,2,97,77,20,18,18,105,22,83
"2021","Crawley 004G","E01032836",914,259,88,171,542,62,230,58,131,41,98,50,44,4,136,115,21,16,16,113,48,65
"2021","Crawley 005A","E01031589",704,173,88,85,467,76,270,71,142,57,60,36,19,5,59,23,36,2,2,64,26,38
"2021","Crawley 005B","E01031591",751,214,60,154,469,36,252,82,133,37,90,56,30,4,84,48,36,7,7,68,35,33
"2021","Crawley 005C","E01031594",551,116,64,52,379,48,179,40,97,42,59,15,39,5,88,49,39,5,5,56,15,41
"2021","Crawley 005D","E01031600",685,225,103,122,395,45,182,53,87,42,110,75,27,8,50,34,16,8,8,65,19,46
"2021","Crawley 005E","E01031603",613,141,54,87,401,42,216,71,101,44,75,37,29,9,63,35,28,5,5,71,26,45
"2021","Crawley 006A","E01031564",608,142,74,68,427,62,226,64,115,47,60,26,29,5,70,41,29,9,9,39,10,29
"2021","Crawley 006B","E01031565",846,198,110,88,562,49,295,76,157,62,83,38,41,4,126,65,61,9,9,86,41,45
"2021","Crawley 006C","E01031566",652,154,88,66,455,83,254,78,118,58,60,29,27,4,58,27,31,0,0,43,22,21
"2021","Crawley 006D","E01031567",512,129,74,55,344,58,171,51,73,47,66,33,27,6,47,21,26,2,2,39,14,25
"2021","Crawley 006E","E01031568",642,173,47,126,439,26,192,68,96,28,131,93,34,4,83,59,24,7,7,30,14,16
"2021","Crawley 007A","E01031596",751,201,84,117,451,28,223,43,145,35,84,26,52,6,110,71,39,6,6,99,46,53
"2021","Crawley 007B","E01031597",632,145,92,53,418,76,235,75,104,56,55,32,21,2,48,20,28,4,4,69,33,36
"2021","Crawley 007C","E01031598",818,290,125,165,458,42,182,60,91,31,105,73,29,3,122,90,32,7,7,70,20,50
"2021","Crawley 007D","E01031599",940,312,106,206,540,45,227,66,129,32,141,77,56,8,114,79,35,13,13,88,25,63
"2021","Crawley 007E","E01031608",1078,326,62,264,610,28,275,103,131,41,154,96,54,4,140,101,39,13,13,142,42,100
"2021","Crawley 008A","E01031578",733,191,67,124,508,42,281,83,149,49,105,61,38,6,78,55,23,2,2,34,14,20
"2021","Crawley 008B","E01031580",862,151,58,93,656,40,388,100,227,61,117,50,62,5,101,72,29,10,10,55,25,30
"2021","Crawley 008C","E01031581",610,81,32,49,493,36,326,77,183,66,85,42,40,3,45,22,23,1,1,36,11,25
"2021","Crawley 008D","E01031592",772,140,69,71,586,113,348,123,156,69,67,36,23,8,55,28,27,3,3,46,16,30
"2021","Crawley 009A","E01031560",624,153,90,63,416,99,199,68,78,53,42,15,24,3,70,40,30,6,6,55,24,31
"2021","Crawley 009B","E01031561",593,125,78,47,408,72,230,69,112,49,55,30,24,1,49,17,32,2,2,60,22,38
"2021","Crawley 009C","E01031562",584,198,108,90,336,64,150,52,76,22,47,21,23,3,68,43,25,7,7,50,22,28
"2021","Crawley 009D","E01031563",565,130,84,46,369,58,212,51,103,58,51,21,25,5,41,24,17,7,7,66,19,47
"2021","Crawley 009E","E01031579",680,215,74,141,418,17,223,60,122,41,86,42,36,8,86,58,28,6,6,47,20,27
"2021","Crawley 009F","E01031582",768,181,38,143,550,19,294,97,154,43,139,86,49,4,92,63,29,6,6,37,15,22
"2021","Crawley 010A","E01031547",510,137,36,101,323,19,166,49,84,33,63,33,26,4,72,49,23,3,3,50,21,29
"2021","Crawley 010B","E01031548",676,221,65,156,392,18,180,47,99,34,76,39,33,4,107,70,37,11,11,63,33,30
"2021","Crawley 010C","E01031549",618,128,24,104,419,19,201,53,114,34,84,33,44,7,110,69,41,5,5,71,37,34
"2021","Crawley 010D","E01031550",523,112,20,92,354,6,188,72,69,47,66,30,31,5,90,50,40,4,4,57,33,24
"2021","Crawley 010E","E01031569",626,142,62,80,438,56,195,44,116,35,83,29,50,4,95,42,53,9,9,46,20,26
"2021","Crawley 011A","E01031595",646,145,85,60,424,40,219,52,120,47,56,28,25,3,96,50,46,13,13,77,29,48
"2021","Crawley 011B","E01031604",653,202,114,88,404,43,201,53,100,48,76,36,35,5,80,42,38,4,4,47,19,28
"2021","Crawley 011C","E01031605",592,141,80,61,393,28,205,57,116,32,70,32,35,3,86,61,25,4,4,58,33,25
"2021","Crawley 011D","E01031606",618,154,84,70,381,44,191,40,119,32,71,27,36,8,72,39,33,3,3,83,44,39
"2021","Crawley 011E","E01031607",566,125,67,58,385,40,201,45,112,44,64,26,32,6,76,46,30,4,4,56,24,32
"2021","Crawley 012A","E01031546",481,65,27,38,344,27,173,50,81,42,48,15,30,3,91,58,33,5,5,72,34,38
"2021","Crawley 012B","E01031551",499,62,27,35,357,17,189,41,108,40,58,18,35,5,82,56,26,11,11,80,38,42
"2021","Crawley 012C","E01031553",493,70,20,50,339,16,152,30,75,47,70,21,39,10,97,59,38,4,4,84,36,48
"2021","Crawley 012D","E01031554",703,175,50,125,450,29,227,65,120,42,106,63,37,6,78,40,38,10,10,78,35,43
"2021","Crawley 012E","E01031555",489,75,32,43,330,27,160,35,83,42,46,8,32,6,89,57,32,8,8,84,35,49
"2021","Crawley 013A","E01031552",749,208,92,116,483,47,216,73,97,46,83,45,32,6,126,80,46,11,11,58,24,34
"2021","Crawley 013B","E01031556",644,179,29,150,418,22,193,66,91,36,92,47,38,7,110,58,52,1,1,47,25,22
"2021","Crawley 013C","E01031557",925,378,57,321,518,28,236,103,105,28,162,113,44,5,84,63,21,8,8,29,11,18
"2021","Crawley 013D","E01031558",616,188,93,95,363,31,143,42,74,27,57,17,36,4,127,76,51,5,5,65,31,34
"2021","Crawley 013E","E01031559",516,71,30,41,357,19,183,38,104,41,47,19,22,6,99,59,40,9,9,88,39,49
"2021","Horsham 001A","E01031670",713,274,94,180,390,59,186,64,81,41,78,53,21,4,63,39,24,4,4,49,13,36
"2021","Horsham 001B","E01031671",789,358,119,239,411,55,208,80,104,24,74,45,28,1,72,45,27,2,2,20,4,16
"2021","Horsham 001C","E01031673",646,192,77,115,424,41,226,55,123,48,86,44,37,5,68,37,31,3,3,30,12,18
"2021","Horsham 001E","E01035330",548,149,45,104,357,56,194,63,101,30,63,35,26,2,43,25,18,1,1,42,17,25
"2021","Horsham 001F","E01035331",554,139,98,41,386,110,204,77,84,43,42,31,8,3,30,17,13,0,0,29,9,20
"2021","Horsham 001G","E01035332",617,137,15,122,439,10,212,74,118,20,173,127,44,2,40,32,8,4,4,41,11,30
"2021","Horsham 001H","E01035333",616,107,13,94,475,46,243,84,132,27,144,101,42,1,40,23,17,2,2,34,10,24
"2021","Horsham 002A","E01031644",770,171,61,110,571,72,333,100,189,44,100,53,43,4,65,35,30,1,1,28,10,18
"2021","Horsham 002B","E01031645",546,103,48,55,427,53,260,97,126,37,73,42,28,3,40,26,14,1,1,16,8,8
"2021","Horsham 002C","E01031646",601,163,55,108,419,57,283,100,129,54,51,35,14,2,24,11,13,4,4,19,5,14
"2021","Horsham 002D","E01031647",466,127,45,82,325,52,187,62,85,40,52,25,24,3,32,14,18,2,2,14,5,9
"2021","Horsham 002E","E01031649",452,106,51,55,334,48,177,65,80,32,63,40,18,5,45,23,22,1,1,12,2,10
"2021","Horsham 002F","E01031650",499,82,33,49,399,77,261,102,106,53,40,20,17,3,21,13,8,0,0,18,5,13
"2021","Horsham 002G","E01031666",645,129,94,35,493,124,276,97,130,49,58,27,29,2,32,14,18,3,3,23,6,17
"2021","Horsham 002H","E01031668",653,186,131,55,440,114,223,75,100,48,57,33,19,5,46,24,22,0,0,27,14,13
"2021","Horsham 003A","E01031620",866,243,81,162,587,63,295,94,155,46,121,61,57,3,106,69,37,2,2,36,10,26
"2021","Horsham 003B","E01031648",741,267,123,144,450,83,212,76,92,44,85,57,26,2,60,36,24,10,10,24,5,19
"2021","Horsham 003C","E01031651",652,185,75,110,439,58,250,78,126,46,62,37,23,2,64,40,24,5,5,28,6,22
"2021","Horsham 003D","E01031658",892,254,151,103,596,122,296,121,114,61,108,66,39,3,69,40,29,1,1,42,11,31
"2021","Horsham 003E","E01031689",655,197,79,118,425,71,215,64,117,34,78,49,29,0,60,34,26,1,1,33,14,19
"2021","Horsham 004A","E01031654",651,167,108,59,451,100,252,79,123,50,59,30,24,5,40,27,13,0,0,33,14,19
"2021","Horsham 004B","E01031655",657,171,57,114,454,41,250,78,129,43,101,59,36,6,60,35,25,2,2,32,12,20
"2021","Horsham 004C","E01031667",653,182,109,73,434,93,213,74,89,50,72,42,23,7,56,27,29,0,0,37,9,28
"2021","Horsham 004D","E01031669",720,248,109,139,443,43,224,64,121,39,101,53,46,2,71,41,30,4,4,29,10,19
"2021","Horsham 004E","E01031672",974,441,131,310,497,60,240,92,109,39,139,107,32,0,53,41,12,5,5,36,7,29
"2021","Horsham 005A","E01031657",754,200,92,108,507,89,292,98,137,57,75,46,23,6,47,25,22,4,4,47,17,30
"2021","Horsham 005B","E01031659",644,114,72,42,494,97,285,104,133,48,70,39,26,5,39,19,20,3,3,36,17,19
"2021","Horsham 005C","E01031674",545,141,89,52,371,76,230,84,105,41,43,27,13,3,21,10,11,1,1,33,9,24
"2021","Horsham 005D","E01031675",614,126,71,55,454,101,254,90,119,45,70,43,25,2,28,23,5,1,1,34,13,21
"2021","Horsham 006B","E01031652",623,151,67,84,426,32,213,51,127,35,79,32,40,7,101,54,47,1,1,46,14,32
"2021","Horsham 006C","E01031653",891,342,107,235,501,61,244,87,128,29,118,85,28,5,70,49,21,8,8,48,6,42
"2021","Horsham 006D","E01031656",961,405,152,253,520,44,246,92,126,28,139,90,44,5,83,54,29,8,8,36,8,28
"2021","Horsham 006E","E01031688",619,223,153,70,366,71,187,54,101,32,50,29,19,2,58,23,35,0,0,30,11,19
"2021","Horsham 006F","E01031691",807,276,159,117,494,96,269,67,159,43,67,47,18,2,56,34,22,6,6,37,6,31
"2021","Horsham 006G","E01035334",622,278,156,122,314,56,123,47,61,15,70,51,18,1,58,38,20,7,7,30,6,24
"2021","Horsham 006H","E01035335",715,348,84,264,316,37,121,50,57,14,88,64,23,1,61,47,14,9,9,51,8,43
"2021","Horsham 007C","E01031638",772,242,106,136,502,73,261,80,136,45,105,68,32,5,63,43,20,0,0,28,9,19
"2021","Horsham 007D","E01031690",637,143,109,34,478,123,291,97,139,55,35,20,12,3,28,14,14,1,1,16,9,7
"2021","Horsham 007E","E01035336",499,147,52,95,332,45,180,62,84,34,65,39,24,2,41,24,17,1,1,20,10,10
"2021","Horsham 007F","E01035337",510,104,25,79,376,14,171,27,119,25,104,61,38,5,84,73,11,3,3,30,8,22
"2021","Horsham 007G","E01035338",775,236,100,136,520,68,246,95,130,21,150,103,43,4,50,40,10,6,6,19,9,10
"2021","Horsham 007H","E01035339",637,89,15,74,516,27,302,69,213,20,110,50,56,4,72,59,13,5,5,32,13,19
"2021","Horsham 007I","E01035340",700,201,102,99,458,67,225,69,120,36,73,35,32,6,88,54,34,5,5,41,15,26
"2021","Horsham 008A","E01031639",881,231,113,118,612,119,332,138,142,52,105,76,24,5,51,31,20,5,5,38,4,34
"2021","Horsham 008B","E01031640",712,122,95,27,576,167,344,105,184,55,42,20,16,6,21,8,13,2,2,14,5,9
"2021","Horsham 008C","E01031660",565,124,79,45,409,99,231,94,89,48,52,36,13,3,24,12,12,3,3,32,12,20
"2021","Horsham 008D","E01031661",668,129,72,57,497,107,286,106,126,54,59,24,31,4,43,21,22,2,2,42,19,23
"2021","Horsham 008E","E01031679",530,145,79,66,356,53,201,70,101,30,66,38,27,1,34,22,12,2,2,29,15,14
"2021","Horsham 009A","E01031677",663,180,113,67,459,70,249,78,123,48,78,38,33,7,61,32,29,1,1,24,10,14
"2021","Horsham 009B","E01031678",682,89,49,40,569,85,365,103,187,75,54,25,24,5,62,41,21,3,3,24,6,18
"2021","Horsham 009C","E01031680",570,92,53,39,460,64,318,97,156,65,49,33,15,1,29,18,11,0,0,18,6,12
"2021","Horsham 009D","E01031681",763,238,107,131,509,62,285,78,158,49,97,57,38,2,62,36,26,3,3,16,4,12
"2021","Horsham 009E","E01031682",461,126,52,74,326,27,199,68,101,30,58,30,20,8,39,23,16,3,3,9,1,8
"2021","Horsham 009F","E01031683",634,181,63,118,437,44,252,91,122,39,85,55,24,6,53,29,24,3,3,16,2,14
"2021","Horsham 010A","E01031611",1154,243,109,134,835,139,443,168,209,66,169,98,64,7,82,62,20,2,2,76,38,38
"2021","Horsham 010B","E01031612",890,234,124,110,625,95,338,119,159,60,109,60,47,2,78,47,31,5,5,31,13,18
"2021","Horsham 010D","E01031614",1086,332,157,175,709,62,371,112,202,57,159,90,60,9,117,70,47,0,0,45,19,26
"2021","Horsham 010E","E01031615",794,246,156,90,521,113,266,88,147,31,81,46,31,4,55,29,26,6,6,27,11,16
"2021","Horsham 010F","E01035341",629,134,50,84,472,47,284,85,159,40,80,43,35,2,60,45,15,1,1,23,10,13
"2021","Horsham 010G","E01035342",608,178,79,99,406,68,207,65,109,33,77,47,28,2,48,25,23,6,6,24,13,11
"2021","Horsham 011A","E01031632",666,153,66,87,475,100,274,113,109,52,66,49,11,6,35,16,19,0,0,38,13,25
"2021","Horsham 011B","E01031633",510,98,59,39,391,88,222,94,82,46,57,34,21,2,23,9,14,1,1,21,6,15
"2021","Horsham 011C","E01031634",529,141,74,67,358,50,197,85,89,23,62,40,18,4,48,32,16,1,1,30,7,23
"2021","Horsham 011D","E01031635",552,143,69,74,384,60,237,85,103,49,47,17,25,5,39,20,19,1,1,25,8,17
"2021","Horsham 012A","E01031621",814,167,143,24,614,294,271,168,61,42,28,20,5,3,21,4,17,0,0,33,10,23
"2021","Horsham 012B","E01031623",767,192,137,55,537,172,290,156,85,49,45,26,16,3,30,19,11,0,0,38,13,25
"2021","Horsham 012C","E01031627",836,211,153,58,603,206,301,128,122,51,51,25,23,3,44,16,28,1,1,22,11,11
"2021","Horsham 012D","E01031664",691,144,92,52,507,135,282,128,94,60,58,34,16,8,32,12,20,0,0,40,10,30
"2021","Horsham 013A","E01031626",712,225,148,77,465,155,215,109,79,27,57,40,15,2,38,25,13,0,0,22,8,14
"2021","Horsham 013B","E01031630",865,350,249,101,492,161,212,85,91,36,59,39,16,4,56,27,29,4,4,23,5,18
"2021","Horsham 013C","E01031631",846,343,221,122,466,133,172,70,69,33,74,39,29,6,86,57,29,1,1,37,12,25
"2021","Horsham 013D","E01031662",724,275,131,144,423,94,200,87,82,31,75,50,22,3,52,23,29,2,2,26,4,22
"2021","Horsham 013E","E01031663",963,281,119,162,645,78,307,108,148,51,135,73,59,3,121,74,47,4,4,37,10,27
"2021","Horsham 013F","E01031665",565,152,89,63,387,93,185,94,63,28,71,42,27,2,37,28,9,1,1,26,8,18
"2021","Horsham 014A","E01031618",564,132,80,52,390,96,216,99,80,37,56,31,16,9,20,9,11,2,2,42,13,29
"2021","Horsham 014B","E01031641",754,291,206,85,446,154,194,89,67,38,47,29,16,2,50,18,32,1,1,17,4,13
"2021","Horsham 014C","E01031642",1067,256,155,101,762,139,378,144,179,55,133,74,54,5,107,66,41,5,5,49,15,34
"2021","Horsham 014D","E01031643",845,292,166,126,522,89,239,78,118,43,85,39,41,5,104,75,29,5,5,31,13,18
"2021","Horsham 014E","E01031687",667,222,110,112,406,75,191,60,89,42,65,30,30,5,74,44,30,1,1,39,21,18
"2021","Horsham 015A","E01031622",658,128,71,57,501,89,298,110,135,53,64,37,22,5,48,24,24,2,2,29,7,22
"2021","Horsham 015B","E01031624",670,140,85,55,493,94,288,106,133,49,55,31,22,2,54,25,29,2,2,37,16,21
"2021","Horsham 015C","E01031625",758,128,64,64,600,116,335,121,159,55,89,47,38,4,57,38,19,3,3,30,12,18
"2021","Horsham 015D","E01031628",684,141,62,79,500,89,243,90,104,49,90,41,43,6,75,50,25,3,3,43,14,29
"2021","Horsham 015E","E01031629",654,122,79,43,508,136,271,130,88,53,59,37,18,4,41,23,18,1,1,24,10,14
"2021","Horsham 016A","E01031616",697,227,116,111,439,85,217,62,113,42,78,37,32,9,57,26,31,2,2,31,12,19
"2021","Horsham 016B","E01031617",1011,264,173,91,705,187,366,141,156,69,90,46,37,7,61,25,36,1,1,42,16,26
"2021","Horsham 016C","E01031684",629,163,114,49,441,109,227,97,84,46,50,26,20,4,53,33,20,2,2,25,6,19
"2021","Horsham 016D","E01031685",847,387,254,133,437,130,172,66,77,29,78,51,23,4,55,38,17,2,2,23,9,14
"2021","Horsham 016E","E01031686",633,197,148,49,413,127,220,89,95,36,34,13,16,5,32,14,18,0,0,23,9,14
"2021","Mid Sussex 001A","E01031731",819,267,117,150,519,60,263,62,141,60,91,41,37,13,102,55,47,3,3,33,14,19
"2021","Mid Sussex 001B","E01031732",683,149,67,82,499,62,248,77,122,49,94,41,44,9,90,44,46,5,5,35,16,19
"2021","Mid Sussex 001C","E01031733",757,240,107,133,488,69,232,73,123,36,106,63,39,4,78,37,41,3,3,29,9,20
"2021","Mid Sussex 001D","E01031734",615,105,54,51,479,96,275,96,126,53,56,35,19,2,51,35,16,1,1,31,6,25
"2021","Mid Sussex 001E","E01031741",1020,377,155,222,589,82,281,87,162,32,133,85,45,3,83,58,25,10,10,54,19,35
"2021","Mid Sussex 001G","E01031743",830,351,103,248,444,50,192,72,94,26,105,68,29,8,93,57,36,4,4,35,8,27
"2021","Mid Sussex 001H","E01035343",652,301,54,247,312,9,114,54,52,8,136,108,25,3,39,28,11,14,14,39,3,36
"2021","Mid Sussex 001I","E01035344",572,269,212,57,286,77,146,44,77,25,36,21,12,3,27,16,11,0,0,17,11,6
"2021","Mid Sussex 002A","E01031718",718,143,64,79,539,89,309,102,140,67,82,46,30,6,54,32,22,5,5,36,15,21
"2021","Mid Sussex 002B","E01031719",723,187,95,92,488,72,253,83,118,52,85,48,31,6,71,40,31,7,7,48,15,33
"2021","Mid Sussex 002C","E01031720",537,102,67,35,392,100,216,62,101,53,38,21,12,5,36,21,15,2,2,43,20,23
"2021","Mid Sussex 002D","E01031722",495,137,58,79,312,42,170,68,82,20,56,26,25,5,42,29,13,2,2,46,33,13
"2021","Mid Sussex 003A","E01031695",556,143,85,58,382,80,202,73,93,36,59,33,21,5,41,22,19,0,0,31,11,20
"2021","Mid Sussex 003B","E01031696",568,163,87,76,373,67,194,74,81,39,62,31,26,5,48,28,20,2,2,32,12,20
"2021","Mid Sussex 003C","E01031729",859,161,95,66,660,145,369,118,188,63,74,35,32,7,71,43,28,1,1,38,21,17
"2021","Mid Sussex 003D","E01031730",760,224,84,140,507,25,274,92,130,52,121,81,33,7,87,65,22,0,0,29,13,16
"2021","Mid Sussex 003E","E01031735",668,164,96,68,477,108,252,92,109,51,66,30,29,7,49,30,19,2,2,27,11,16
"2021","Mid Sussex 004A","E01031736",622,124,83,41,460,121,269,87,127,55,40,21,16,3,27,13,14,3,3,38,16,22
"2021","Mid Sussex 004B","E01031737",601,125,60,65,440,59,231,71,119,41,77,39,30,8,71,37,34,2,2,36,14,22
"2021","Mid Sussex 004C","E01031738",608,135,91,44,453,117,265,62,154,49,43,20,20,3,27,19,8,1,1,20,10,10
"2021","Mid Sussex 004D","E01031739",830,232,112,120,560,124,304,101,157,46,69,52,15,2,61,28,33,2,2,38,8,30
"2021","Mid Sussex 004E","E01031740",558,157,80,77,379,89,213,69,94,50,47,26,15,6,27,13,14,3,3,22,13,9
"2021","Mid Sussex 005A","E01031721",856,270,176,94,556,144,263,89,125,49,74,35,33,6,73,41,32,2,2,30,12,18
"2021","Mid Sussex 005B","E01031723",647,140,80,60,469,103,272,96,119,57,60,33,25,2,30,17,13,4,4,38,16,22
"2021","Mid Sussex 005C","E01031724",508,96,55,41,388,72,225,75,106,44,48,23,19,6,42,19,23,1,1,24,11,13
"2021","Mid Sussex 005D","E01031725",599,136,100,36,438,102,237,65,134,38,55,22,30,3,43,21,22,1,1,25,10,15
"2021","Mid Sussex 006A","E01031694",682,177,105,72,476,83,264,96,120,48,64,35,21,8,64,41,23,1,1,29,8,21
"2021","Mid Sussex 006B","E01031764",564,125,73,52,415,91,232,85,109,38,54,32,20,2,37,21,16,1,1,24,6,18
"2021","Mid Sussex 006C","E01031765",645,157,80,77,454,88,246,92,113,41,86,43,38,5,34,24,10,0,0,34,9,25
"2021","Mid Sussex 006D","E01031766",832,191,102,89,590,122,330,127,152,51,86,57,26,3,49,24,25,3,3,51,23,28
"2021","Mid Sussex 007B","E01031693",757,194,100,94,520,83,303,96,157,50,86,50,35,1,45,26,19,3,3,43,17,26
"2021","Mid Sussex 007C","E01031697",471,132,64,68,311,58,193,70,92,31,38,23,14,1,22,11,11,0,0,28,13,15
"2021","Mid Sussex 007D","E01031727",662,149,80,69,486,107,278,86,146,46,61,38,19,4,40,23,17,0,0,27,7,20
"2021","Mid Sussex 007E","E01035345",699,169,36,133,493,31,259,101,126,32,131,87,38,6,72,52,20,0,0,37,12,25
"2021","Mid Sussex 007F","E01035346",592,177,71,106,389,56,180,71,84,25,85,42,39,4,64,47,17,4,4,26,11,15
"2021","Mid Sussex 008A","E01031758",527,85,48,37,415,91,240,72,116,52,40,15,23,2,41,28,13,3,3,27,14,13
"2021","Mid Sussex 008B","E01031760",720,159,79,80,528,71,307,82,186,39,88,54,33,1,61,38,23,1,1,33,12,21
"2021","Mid Sussex 008C","E01031772",866,265,165,100,562,110,282,87,154,41,87,47,38,2,78,51,27,5,5,39,16,23
"2021","Mid Sussex 008D","E01031773",814,245,168,77,553,134,322,84,187,51,57,32,25,0,35,24,11,5,5,16,6,10
"2021","Mid Sussex 008E","E01031774",975,190,126,64,761,161,412,105,258,49,112,54,58,0,75,51,24,1,1,24,14,10
"2021","Mid Sussex 008F","E01031775",755,209,141,68,521,147,278,66,180,32,45,19,24,2,50,29,21,1,1,25,11,14
"2021","Mid Sussex 009A","E01031751",1182,406,120,286,709,82,369,122,195,52,171,108,54,9,83,43,40,4,4,67,17,50
"2021","Mid Sussex 009B","E01031759",781,256,95,161,492,98,270,80,149,41,77,46,28,3,38,16,22,9,9,33,10,23
"2021","Mid Sussex 009E","E01032837",996,316,175,141,645,75,338,84,233,21,139,84,52,3,87,58,29,6,6,35,14,21
"2021","Mid Sussex 009F","E01032838",611,162,39,123,423,26,199,57,124,18,115,69,45,1,78,60,18,5,5,26,10,16
"2021","Mid Sussex 009G","E01032839",605,208,79,129,370,58,197,75,104,18,68,57,11,0,43,23,20,4,4,27,8,19
"2021","Mid Sussex 009H","E01035347",584,261,47,214,294,17,152,57,83,12,89,66,20,3,34,20,14,2,2,29,4,25
"2021","Mid Sussex 009I","E01035348",627,357,203,154,232,45,81,36,44,1,73,60,13,0,26,14,12,7,7,38,6,32
"2021","Mid Sussex 010A","E01031752",735,215,78,137,475,30,227,55,130,42,98,55,37,6,115,83,32,5,5,45,25,20
"2021","Mid Sussex 010B","E01031753",584,140,61,79,422,76,216,62,117,37,64,43,21,0,64,34,30,2,2,22,8,14
"2021","Mid Sussex 010C","E01031754",685,203,97,106,431,58,254,84,126,44,71,44,22,5,47,24,23,1,1,51,14,37
"2021","Mid Sussex 010D","E01031755",593,169,71,98,399,52,214,59,121,34,80,56,21,3,50,27,23,3,3,25,12,13
"2021","Mid Sussex 010E","E01031757",692,285,109,176,391,42,190,70,86,34,85,46,36,3,71,38,33,3,3,16,5,11
"2021","Mid Sussex 011A","E01031726",678,208,75,133,441,55,224,57,140,27,70,33,34,3,90,69,21,2,2,29,13,16
"2021","Mid Sussex 011C","E01031749",616,143,72,71,429,68,238,67,134,37,77,41,33,3,43,19,24,3,3,44,18,26
"2021","Mid Sussex 011D","E01031750",647,192,81,111,426,56,201,70,92,39,80,49,29,2,86,53,33,3,3,29,7,22
"2021","Mid Sussex 011F","E01031763",807,144,82,62,636,123,380,96,214,70,74,46,27,1,56,24,32,3,3,27,11,16
"2021","Mid Sussex 011G","E01035349",633,211,129,82,391,93,205,56,116,33,51,33,16,2,42,21,21,0,0,31,10,21
"2021","Mid Sussex 011H","E01035350",599,196,64,132,373,26,166,60,88,18,102,72,26,4,77,49,28,2,2,30,5,25
"2021","Mid Sussex 011I","E01035351",623,98,41,57,495,72,297,89,165,43,74,39,30,5,47,35,12,5,5,30,13,17
"2021","Mid Sussex 011J","E01035352",628,108,37,71,483,42,273,54,185,34,102,59,38,5,65,45,20,1,1,37,17,20
"2021","Mid Sussex 012A","E01031699",678,162,57,105,486,50,258,94,114,50,112,80,28,4,66,37,29,0,0,30,14,16
"2021","Mid Sussex 012B","E01031700",599,89,49,40,486,52,310,96,153,61,76,31,38,7,47,26,21,1,1,24,8,16
"2021","Mid Sussex 012C","E01031701",777,181,81,100,562,62,283,80,156,47,115,57,52,6,96,56,40,6,6,34,9,25
"2021","Mid Sussex 012D","E01031714",733,174,87,87,516,61,286,76,165,45,101,57,36,8,64,41,23,4,4,43,18,25
"2021","Mid Sussex 013A","E01031704",749,218,106,112,502,73,255,79,125,51,101,55,41,5,68,36,32,5,5,29,10,19
"2021","Mid Sussex 013B","E01031706",690,169,96,73,478,121,246,76,121,49,76,46,27,3,34,15,19,1,1,43,12,31
"2021","Mid Sussex 013D","E01031712",647,206,99,107,411,42,191,61,95,35,93,56,31,6,81,47,34,4,4,30,12,18
"2021","Mid Sussex 013E","E01031713",691,148,89,59,514,116,288,97,140,51,61,26,29,6,47,25,22,2,2,29,10,19
"2021","Mid Sussex 013F","E01035353",643,148,82,66,471,52,250,97,106,47,101,55,39,7,68,41,27,0,0,24,3,21
"2021","Mid Sussex 013G","E01035354",640,96,18,78,520,20,284,71,185,28,150,91,54,5,66,54,12,0,0,24,12,12
"2021","Mid Sussex 014A","E01031705",662,214,94,120,415,35,195,64,92,39,108,57,46,5,76,48,28,1,1,33,6,27
"2021","Mid Sussex 014B","E01031707",672,214,140,74,423,104,218,77,94,47,57,39,14,4,43,11,32,1,1,35,18,17
"2021","Mid Sussex 014C","E01031708",803,302,109,193,443,27,260,87,145,28,84,55,24,5,60,34,26,12,12,58,11,47
"2021","Mid Sussex 014D","E01031709",899,419,224,195,443,77,214,72,98,44,81,47,30,4,64,33,31,7,7,37,13,24
"2021","Mid Sussex 014E","E01031716",459,110,55,55,325,33,144,46,68,30,59,20,37,2,85,53,32,4,4,24,11,13
"2021","Mid Sussex 014F","E01031717",570,153,55,98,382,38,211,56,115,40,79,51,24,4,49,29,20,5,5,35,9,26
"2021","Mid Sussex 015A","E01031702",634,112,62,50,490,117,276,99,124,53,54,26,23,5,42,23,19,1,1,32,15,17
"2021","Mid Sussex 015B","E01031703",675,160,113,47,478,147,266,83,125,58,46,24,16,6,19,7,12,0,0,37,11,26
"2021","Mid Sussex 015C","E01031710",592,147,100,47,416,98,229,70,107,52,44,22,19,3,44,18,26,1,1,29,8,21
"2021","Mid Sussex 015D","E01031715",671,158,65,93,496,45,309,108,156,45,86,41,40,5,55,41,14,1,1,17,6,11
"2021","Mid Sussex 016A","E01031698",662,126,61,65,489,88,288,112,128,48,59,29,22,8,54,31,23,0,0,47,17,30
"2021","Mid Sussex 016B","E01031767",761,153,80,73,576,97,323,86,197,40,92,35,52,5,63,48,15,1,1,32,17,15
"2021","Mid Sussex 016C","E01031769",706,211,104,107,473,60,254,61,156,37,79,34,42,3,76,48,28,4,4,22,5,17
"2021","Mid Sussex 016D","E01031770",722,209,97,112,466,82,245,72,133,40,81,58,21,2,55,30,25,3,3,47,21,26
"2021","Mid Sussex 016E","E01031771",623,145,55,90,450,55,236,74,121,41,79,40,36,3,78,48,30,2,2,28,14,14
"2021","Mid Sussex 017A","E01031744",698,131,88,43,535,98,311,90,177,44,82,52,29,1,42,22,20,2,2,32,11,21
"2021","Mid Sussex 017B","E01031745",863,269,190,79,566,117,308,82,189,37,78,30,36,12,60,38,22,3,3,28,10,18
"2021","Mid Sussex 017C","E01031746",735,230,112,118,467,51,222,74,112,36,100,50,41,9,87,52,35,7,7,38,11,27
"2021","Mid Sussex 017D","E01031747",700,211,151,60,467,121,243,75,127,41,57,31,23,3,43,19,24,3,3,22,9,13
"2021","Mid Sussex 017E","E01031748",584,147,93,54,421,100,230,64,138,28,53,31,21,1,36,15,21,2,2,16,9,7
"2021","Mid Sussex 017F","E01031768",675,205,157,48,457,131,257,79,143,35,35,22,12,1,34,14,20,0,0,13,7,6
"2021","Worthing 001A","E01031793",601,168,115,53,405,111,202,87,64,51,58,33,21,4,32,11,21,2,2,28,15,13
"2021","Worthing 001B","E01031820",800,209,158,51,545,209,250,110,80,60,55,36,17,2,30,10,20,1,1,46,16,30
"2021","Worthing 001C","E01031821",779,236,156,80,495,136,217,71,112,34,88,56,25,7,53,21,32,1,1,48,20,28
"2021","Worthing 001D","E01031828",555,123,89,34,408,131,214,98,69,47,39,18,17,4,24,6,18,0,0,24,8,16
"2021","Worthing 001E","E01031829",634,126,88,38,465,156,237,107,83,47,41,19,16,6,30,11,19,1,1,43,15,28
"2021","Worthing 002A","E01031822",652,149,99,50,470,119,228,84,102,42,68,38,26,4,53,34,19,2,2,33,18,15
"2021","Worthing 002B","E01031825",780,251,164,87,489,153,212,105,70,37,75,53,20,2,49,17,32,0,0,40,12,28
"2021","Worthing 002C","E01031826",616,176,89,87,405,54,193,59,106,28,88,32,48,8,66,38,28,4,4,35,13,22
"2021","Worthing 002D","E01031827",656,220,118,102,393,72,195,75,85,35,64,31,29,4,62,40,22,0,0,43,20,23
"2021","Worthing 002E","E01031839",730,235,125,110,456,65,237,73,127,37,75,35,33,7,77,58,19,2,2,39,16,23
"2021","Worthing 003A","E01031792",621,207,113,94,383,84,179,71,68,40,56,26,29,1,58,36,22,6,6,31,16,15
"2021","Worthing 003B","E01031794",715,286,205,81,394,125,163,55,79,29,63,28,28,7,41,20,21,2,2,35,11,24
"2021","Worthing 003C","E01031795",691,209,80,129,447,27,196,62,109,25,107,51,54,2,114,82,32,3,3,35,9,26
"2021","Worthing 003D","E01031818",772,179,80,99,542,71,263,85,112,66,96,46,46,4,108,67,41,4,4,51,15,36
"2021","Worthing 003E","E01031830",659,163,83,80,455,77,196,73,88,35,76,32,40,4,97,46,51,9,9,41,17,24
"2021","Worthing 004A","E01031778",652,209,96,113,399,67,199,71,91,37,78,45,31,2,48,31,17,7,7,44,20,24
"2021","Worthing 004B","E01031797",508,105,63,42,372,65,228,73,112,43,38,18,17,3,36,20,16,5,5,31,12,19
"2021","Worthing 004C","E01031800",624,141,88,53,450,75,270,67,150,53,59,32,24,3,43,23,20,3,3,33,15,18
"2021","Worthing 004D","E01031823",578,76,47,29,455,89,282,81,145,56,55,29,24,2,26,12,14,3,3,47,15,32
"2021","Worthing 004E","E01031824",504,84,51,33,390,91,219,62,114,43,46,25,18,3,34,20,14,0,0,30,10,20
"2021","Worthing 005A","E01031776",666,192,96,96,437,31,207,63,114,30,115,67,45,3,79,53,26,5,5,37,9,28
"2021","Worthing 005B","E01031777",794,263,123,140,484,46,217,69,110,38,132,72,54,6,83,54,29,6,6,47,20,27
"2021","Worthing 005C","E01031780",547,104,63,41,408,38,250,67,127,56,56,23,30,3,63,36,27,1,1,35,13,22
"2021","Worthing 005D","E01031781",618,128,72,56,453,48,247,61,129,57,72,23,39,10,83,40,43,3,3,37,17,20
"2021","Worthing 005E","E01031798",682,238,70,168,391,35,213,71,102,40,87,49,32,6,52,28,24,4,4,53,22,31
"2021","Worthing 006A","E01031783",610,179,92,87,374,39,188,46,99,43,53,17,28,8,93,55,38,1,1,57,28,29
"2021","Worthing 006B","E01031785",643,202,99,103,406,57,179,60,82,37,93,48,37,8,70,38,32,7,7,35,18,17
"2021","Worthing 006C","E01031786",636,134,61,73,458,57,198,68,87,43,96,41,53,2,105,63,42,2,2,44,26,18
"2021","Worthing 006D","E01031817",713,179,76,103,497,36,260,89,122,49,88,50,29,9,110,67,43,3,3,37,21,16
"2021","Worthing 006F","E01034826",651,116,19,97,485,18,231,55,155,21,104,34,61,9,131,92,39,1,1,50,25,25
"2021","Worthing 006G","E01034827",655,94,25,69,531,22,301,70,209,22,137,53,83,1,68,58,10,3,3,30,13,17
"2021","Worthing 007A","E01031782",781,231,166,65,499,147,232,83,100,49,62,32,28,2,55,30,25,3,3,51,20,31
"2021","Worthing 007C","E01031836",731,269,96,173,430,42,186,64,91,31,95,43,45,7,103,64,39,4,4,32,10,22
"2021","Worthing 007D","E01031838",667,191,101,90,443,73,223,88,98,37,78,37,39,2,68,44,24,1,1,33,12,21
"2021","Worthing 007E","E01031840",756,218,119,99,502,95,227,79,108,40,104,60,39,5,71,41,30,5,5,36,9,27
"2021","Worthing 007F","E01034828",735,249,131,118,458,85,223,85,100,38,84,49,29,6,62,43,19,4,4,28,10,18
"2021","Worthing 007G","E01034829",569,156,29,127,377,10,166,39,114,13,134,87,45,2,61,39,22,6,6,36,12,24
"2021","Worthing 008A","E01031791",1017,437,135,302,515,19,200,70,111,19,137,75,55,7,150,117,33,9,9,65,27,38
"2021","Worthing 008B","E01031796",686,221,74,147,420,26,207,72,99,36,104,63,35,6,78,47,31,5,5,45,21,24
"2021","Worthing 008C","E01031799",667,205,107,98,412,36,199,52,106,41,78,30,43,5,94,54,40,5,5,50,19,31
"2021","Worthing 008D","E01031801",808,338,125,213,428,33,203,65,111,27,95,53,38,4,93,64,29,4,4,42,12,30
"2021","Worthing 008E","E01031837",781,215,69,146,518,34,254,77,143,34,118,59,56,3,106,69,37,6,6,48,15,33
"2021","Worthing 009A","E01031779",515,154,49,105,329,30,131,29,73,29,62,29,28,5,104,70,34,2,2,32,18,14
"2021","Worthing 009B","E01031831",667,204,76,128,425,50,223,70,119,34,69,37,26,6,73,38,35,10,10,38,14,24
"2021","Worthing 009C","E01031832",804,332,183,149,438,104,186,72,81,33,80,48,27,5,60,30,30,8,8,34,12,22
"2021","Worthing 009D","E01031833",671,209,67,142,414,29,174,46,96,32,98,51,44,3,102,67,35,11,11,48,15,33
"2021","Worthing 009E","E01031834",640,176,93,83,412,42,207,61,106,40,79,39,39,1,83,40,43,1,1,52,27,25
"2021","Worthing 010A","E01031790",996,559,193,366,381,47,136,57,58,21,113,80,32,1,83,57,26,2,2,56,17,39
"2021","Worthing 010B","E01031807",901,438,243,195,425,85,152,76,54,22,125,86,38,1,57,40,17,6,6,38,6,32
"2021","Worthing 010C","E01031809",1063,540,252,288,482,116,181,107,52,22,112,83,27,2,62,37,25,11,11,41,9,32
"2021","Worthing 010D","E01031810",867,354,116,238,461,41,212,74,116,22,111,70,36,5,88,66,22,9,9,52,13,39
"2021","Worthing 010E","E01031811",695,375,148,227,287,30,118,49,47,22,92,64,27,1,41,23,18,6,6,33,6,27
"2021","Worthing 011A","E01031787",1155,625,199,426,458,45,148,64,66,18,155,115,37,3,96,61,35,14,14,72,20,52
"2021","Worthing 011B","E01031788",1023,396,152,244,556,31,190,68,101,21,176,110,59,7,141,92,49,18,18,71,15,56
"2021","Worthing 011D","E01031808",991,618,195,423,334,35,99,52,42,5,125,90,33,2,69,46,23,6,6,39,8,31
"2021","Worthing 011E","E01031835",993,495,118,377,441,47,181,72,89,20,127,94,30,3,77,46,31,9,9,57,15,42
"2021","Worthing 011F","E01034830",620,275,133,142,315,72,123,51,49,23,68,46,20,2,49,36,13,3,3,30,6,24
"2021","Worthing 011G","E01034831",658,332,56,276,273,18,76,35,38,3,114,96,16,2,57,38,19,8,8,53,13,40
"2021","Worthing 012A","E01031812",821,362,198,164,422,131,170,72,63,35,80,57,19,4,40,23,17,1,1,37,9,28
"2021","Worthing 012B","E01031813",799,281,113,168,481,90,225,81,107,37,93,54,33,6,66,49,17,7,7,37,15,22
"2021","Worthing 012C","E01031814",833,302,161,141,473,122,209,88,78,43,85,52,29,4,55,21,34,2,2,58,15,43
"2021","Worthing 012D","E01031815",785,296,174,122,458,143,201,89,75,37,67,40,22,5,44,22,22,3,3,31,7,24
"2021","Worthing 012E","E01031816",658,169,78,91,456,43,230,66,138,26,100,55,38,7,81,57,24,2,2,33,13,20
"2021","Worthing 013A","E01031802",873,304,227,77,540,241,185,93,63,29,49,27,21,1,62,30,32,3,3,29,5,24
"2021","Worthing 013B","E01031803",658,146,96,50,472,143,248,87,106,55,40,19,16,5,38,15,23,3,3,40,18,22
"2021","Worthing 013C","E01031804",737,208,156,52,488,139,258,98,106,54,48,26,20,2,41,18,23,2,2,41,15,26
"2021","Worthing 013D","E01031805",822,293,215,78,498,175,233,103,93,37,61,42,16,3,26,16,10,3,3,31,8,23
"2021","Worthing 013E","E01031806",750,210,96,114,491,58,205,64,107,34,101,55,42,4,120,81,39,7,7,49,18,31
"2021","Bath and North East Somerset 001A","E01014399",1044,284,161,123,708,135,305,99,154,52,148,85,60,3,113,84,29,7,7,52,14,38
"2021","Bath and North East Somerset 001B","E01014400",1146,354,150,204,729,120,362,128,184,50,156,99,51,6,84,48,36,7,7,63,16,47
"2021","Bath and North East Somerset 001C","E01014401",670,161,73,88,472,61,225,80,102,43,93,43,40,10,89,48,41,4,4,37,18,19
"2021","Bath and North East Somerset 002B","E01014403",926,418,243,175,484,117,224,86,96,42,104,80,22,2,39,18,21,0,0,24,5,19
"2021","Bath and North East Somerset 002C","E01014404",892,247,118,129,595,66,243,65,127,51,125,57,58,10,155,94,61,6,6,50,25,25
"2021","Bath and North East Somerset 002D","E01035205",732,206,120,86,501,69,211,78,93,40,106,55,48,3,108,54,54,7,7,25,8,17
"2021","Bath and North East Somerset 002E","E01035206",587,129,14,115,453,14,206,59,126,21,165,105,56,4,64,52,12,4,4,5,4,1
"2021","Bath and North East Somerset 003A","E01014395",550,117,92,25,412,150,207,71,96,40,36,18,14,4,19,9,10,0,0,21,6,15
"2021","Bath and North East Somerset 003B","E01014396",682,227,128,99,426,87,194,55,106,33,78,52,20,6,63,38,25,4,4,29,6,23
"2021","Bath and North East Somerset 003C","E01014397",523,120,87,33,385,93,244,61,120,63,26,15,8,3,20,11,9,2,2,18,3,15
"2021","Bath and North East Somerset 003D","E01014398",725,216,110,106,491,96,245,75,120,50,75,48,21,6,74,47,27,1,1,18,7,11
"2021","Bath and North East Somerset 004A","E01014409",749,303,149,154,419,55,203,65,110,28,69,40,25,4,90,63,27,2,2,27,6,21
"2021","Bath and North East Somerset 004B","E01014410",729,176,90,86,512,98,273,85,145,43,74,31,38,5,67,38,29,0,0,41,11,30
"2021","Bath and North East Somerset 004C","E01014411",974,316,146,170,592,92,332,102,181,49,99,77,20,2,61,33,28,8,8,66,11,55
"2021","Bath and North East Somerset 005A","E01014477",626,180,125,55,426,92,245,64,136,45,49,26,19,4,38,21,17,2,2,20,5,15
"2021","Bath and North East Somerset 005B","E01014478",485,137,61,76,311,35,138,36,76,26,49,21,22,6,85,62,23,4,4,37,11,26
"2021","Bath and North East Somerset 005C","E01014479",613,182,94,88,379,81,211,76,110,25,51,35,15,1,31,19,12,5,5,52,11,41
"2021","Bath and North East Somerset 005D","E01014480",635,214,109,105,364,44,181,49,102,30,58,34,24,0,73,46,27,8,8,57,13,44
"2021","Bath and North East Somerset 006A","E01014465",669,176,72,104,457,55,197,72,102,23,117,75,40,2,79,51,28,9,9,36,7,29
"2021","Bath and North East Somerset 006B","E01014466",595,205,54,151,317,23,141,47,72,22,72,40,26,6,79,53,26,2,2,73,17,56
"2021","Bath and North East Somerset 006C","E01014467",784,298,79,219,433,60,197,83,89,25,127,106,19,2,41,18,23,8,8,53,5,48
"2021","Bath and North East Somerset 006D","E01014468",741,300,74,226,358,36,157,65,76,16,116,103,11,2,39,26,13,10,10,83,13,70
"2021","Bath and North East Somerset 007A","E01014370",1007,550,254,296,320,50,102,53,34,15,113,110,3,0,35,17,18,20,20,137,7,130
"2021","Bath and North East Somerset 007B","E01014371",1044,497,146,351,431,58,163,97,55,11,158,147,8,3,34,18,16,18,18,116,8,108
"2021","Bath and North East Somerset 007C","E01014372",1043,481,134,347,431,38,149,84,54,11,176,160,15,1,49,20,29,19,19,131,3,128
"2021","Bath and North East Somerset 007D","E01014412",622,219,91,128,364,53,190,75,92,23,83,67,13,3,37,23,14,1,1,39,6,33
"2021","Bath and North East Somerset 007E","E01014413",922,208,99,109,673,158,373,128,210,35,74,35,36,3,65,46,19,3,3,41,18,23
"2021","Bath and North East Somerset 007F","E01014414",821,367,84,283,372,41,133,67,47,19,128,108,19,1,58,31,27,12,12,82,1,81
"2021","Bath and North East Somerset 008A","E01014427",564,187,75,112,310,31,150,53,74,23,83,62,18,3,41,27,14,5,5,67,7,60
"2021","Bath and North East Somerset 008B","E01014428",527,167,100,67,316,49,215,60,132,23,30,27,3,0,17,7,10,5,5,44,10,34
"2021","Bath and North East Somerset 008C","E01014429",619,141,87,54,430,48,247,70,135,42,76,33,39,4,55,36,19,4,4,48,10,38
"2021","Bath and North East Somerset 008D","E01014430",728,268,180,88,429,96,231,61,120,50,54,29,22,3,41,18,23,7,7,31,4,27
"2021","Bath and North East Somerset 009A","E01014405",835,208,99,109,494,67,283,90,159,34,103,71,31,1,36,17,19,5,5,133,6,127
"2021","Bath and North East Somerset 009C","E01014407",563,276,53,223,220,11,73,35,30,8,73,65,8,0,57,33,24,6,6,67,2,65
"2021","Bath and North East Somerset 009E","E01033080",1156,501,109,392,474,55,163,88,55,20,194,180,14,0,48,26,22,14,14,181,7,174
"2021","Bath and North East Somerset 010A","E01014373",655,180,81,99,440,45,210,65,121,24,102,52,42,8,82,48,34,1,1,35,10,25
"2021","Bath and North East Somerset 010B","E01014374",666,222,141,81,416,76,228,55,133,40,66,37,26,3,45,28,17,1,1,28,9,19
"2021","Bath and North East Somerset 010C","E01014375",527,115,63,52,381,82,245,101,102,42,33,21,8,4,21,11,10,0,0,31,13,18
"2021","Bath and North East Somerset 010D","E01014376",648,161,102,59,463,130,255,75,124,56,49,29,18,2,27,19,8,2,2,24,9,15
"2021","Bath and North East Somerset 010E","E01014377",640,190,115,75,423,114,233,76,123,34,35,22,11,2,39,22,17,2,2,27,12,15
"2021","Bath and North East Somerset 010G","E01033078",684,180,87,93,455,102,255,90,117,48,53,37,16,0,44,28,16,1,1,49,13,36
"2021","Bath and North East Somerset 010H","E01033079",485,122,71,51,335,69,194,76,89,29,36,19,13,4,34,16,18,2,2,28,8,20
"2021","Bath and North East Somerset 011A","E01014461",476,120,51,69,301,22,139,49,61,29,70,32,32,6,64,37,27,6,6,55,9,46
"2021","Bath and North East Somerset 011B","E01014462",594,160,55,105,375,20,128,39,66,23,69,19,46,4,151,101,50,7,7,59,9,50
"2021","Bath and North East Somerset 011C","E01014463",670,246,94,152,354,31,138,46,52,40,86,43,33,10,93,56,37,6,6,70,13,57
"2021","Bath and North East Somerset 011D","E01014464",655,277,52,225,308,20,91,31,42,18,86,49,35,2,105,83,22,6,6,70,9,61
"2021","Bath and North East Somerset 012A","E01014380",608,154,111,43,414,111,203,81,97,25,45,24,19,2,52,36,16,3,3,40,10,30
"2021","Bath and North East Somerset 012B","E01014381",662,225,136,89,381,92,214,87,97,30,47,35,8,4,26,17,9,2,2,56,7,49
"2021","Bath and North East Somerset 012C","E01014481",571,170,64,106,277,20,143,72,54,17,83,67,16,0,24,12,12,7,7,124,4,120
"2021","Bath and North East Somerset 012D","E01014482",484,111,59,52,349,84,216,68,119,29,38,17,17,4,11,4,7,0,0,24,8,16
"2021","Bath and North East Somerset 012E","E01014483",620,205,99,106,331,38,165,70,79,16,58,48,10,0,62,36,26,8,8,84,7,77
"2021","Bath and North East Somerset 012F","E01014484",639,153,53,100,266,32,113,38,54,21,84,68,13,3,23,12,11,14,14,220,11,209
"2021","Bath and North East Somerset 013A","E01014473",590,100,42,58,288,35,149,51,79,19,70,50,19,1,25,15,10,9,9,202,7,195
"2021","Bath and North East Somerset 013B","E01014474",530,138,47,91,284,30,107,50,38,19,74,42,26,6,65,38,27,8,8,108,4,104
"2021","Bath and North East Somerset 013D","E01014476",550,107,41,66,266,43,140,48,74,18,60,44,14,2,21,12,9,2,2,177,4,173
"2021","Bath and North East Somerset 013E","E01035207",847,387,40,347,377,32,113,60,50,3,167,156,10,1,52,33,19,13,13,83,5,78
"2021","Bath and North East Somerset 013F","E01035208",613,161,67,94,251,33,113,37,58,18,68,44,17,7,30,14,16,7,7,201,8,193
"2021","Bath and North East Somerset 014A","E01014435",534,97,39,58,189,32,88,35,42,11,39,28,7,4,23,12,11,7,7,248,6,242
"2021","Bath and North East Somerset 014B","E01014436",620,186,101,85,286,40,143,51,69,23,62,43,18,1,35,27,8,6,6,148,4,144
"2021","Bath and North East Somerset 014C","E01014437",635,214,84,130,364,36,172,60,84,28,60,34,25,1,94,57,37,2,2,57,10,47
"2021","Bath and North East Somerset 014D","E01014438",487,128,42,86,293,35,153,45,75,33,43,21,20,2,57,26,31,5,5,66,15,51
"2021","Bath and North East Somerset 015A","E01014455",567,191,103,88,308,35,146,47,73,26,70,35,29,6,50,25,25,7,7,68,16,52
"2021","Bath and North East Somerset 015B","E01014456",636,170,89,81,400,75,201,71,87,43,67,35,25,7,51,24,27,6,6,66,13,53
"2021","Bath and North East Somerset 015C","E01014457",626,191,111,80,385,95,193,81,77,35,49,28,20,1,43,21,22,5,5,50,12,38
"2021","Bath and North East Somerset 015D","E01014458",508,129,69,60,310,24,125,33,59,33,59,22,33,4,99,70,29,3,3,69,21,48
"2021","Bath and North East Somerset 016A","E01014391",729,177,105,72,523,97,287,127,114,46,85,55,28,2,53,26,27,1,1,29,7,22
"2021","Bath and North East Somerset 016B","E01014392",437,99,69,30,312,92,169,73,58,38,30,16,13,1,20,8,12,1,1,26,8,18
"2021","Bath and North East Somerset 016C","E01014452",657,217,150,67,414,112,205,75,85,45,49,33,16,0,45,14,31,3,3,26,9,17
"2021","Bath and North East Somerset 016D","E01014453",531,116,80,36,391,106,214,60,107,47,46,22,19,5,24,11,13,1,1,24,7,17
"2021","Bath and North East Somerset 016E","E01014454",522,88,69,19,419,101,270,80,131,59,26,10,13,3,21,8,13,1,1,15,7,8
"2021","Bath and North East Somerset 016F","E01014459",632,189,108,81,412,74,183,62,73,48,79,36,38,5,72,49,23,4,4,31,8,23
"2021","Bath and North East Somerset 016G","E01014460",504,136,86,50,345,111,169,66,69,34,47,27,19,1,18,7,11,0,0,23,6,17
"2021","Bath and North East Somerset 017A","E01014415",772,181,79,102,517,59,314,93,183,38,89,62,25,2,50,26,24,5,5,74,12,62
"2021","Bath and North East Somerset 017B","E01014416",725,215,121,94,464,100,244,77,129,38,64,37,23,4,51,32,19,5,5,46,8,38
"2021","Bath and North East Somerset 017C","E01014417",732,169,102,67,520,103,333,105,183,45,52,33,15,4,29,13,16,3,3,43,7,36
"2021","Bath and North East Somerset 018A","E01014387",684,176,78,98,438,52,223,60,127,36,77,48,26,3,79,60,19,7,7,70,13,57
"2021","Bath and North East Somerset 018B","E01014388",550,165,103,62,350,89,182,70,86,26,36,23,11,2,41,27,14,2,2,35,8,27
"2021","Bath and North East Somerset 018C","E01014389",825,278,170,108,481,69,263,76,153,34,60,30,27,3,87,59,28,2,2,66,14,52
"2021","Bath and North East Somerset 018D","E01014390",599,200,63,137,353,25,114,30,58,26,87,32,49,6,121,82,39,6,6,46,14,32
"2021","Bath and North East Somerset 019A","E01014431",492,120,59,61,329,44,152,46,74,32,70,37,25,8,62,30,32,1,1,43,9,34
"2021","Bath and North East Somerset 019B","E01014432",559,165,82,83,322,46,158,49,78,31,56,31,21,4,55,33,22,7,7,72,16,56
"2021","Bath and North East Somerset 019C","E01014433",550,143,57,86,365,17,183,56,101,26,79,45,27,7,84,47,37,2,2,42,11,31
"2021","Bath and North East Somerset 019D","E01014434",762,188,87,101,474,87,261,91,115,55,67,33,33,1,53,23,30,6,6,100,15,85
"2021","Bath and North East Somerset 020A","E01014385",564,100,58,42,431,84,238,93,95,50,66,37,29,0,42,21,21,1,1,33,8,25
"2021","Bath and North East Somerset 020B","E01014386",460,85,53,32,351,61,191,60,94,37,67,23,40,4,31,18,13,1,1,24,9,15
"2021","Bath and North East Somerset 020C","E01014419",598,133,64,69,445,66,228,72,109,47,95,44,44,7,54,31,23,2,2,20,4,16
"2021","Bath and North East Somerset 020D","E01014446",479,101,50,51,339,73,170,58,72,40,67,39,23,5,27,9,18,2,2,39,11,28
"2021","Bath and North East Somerset 020E","E01014447",780,168,69,99,565,93,281,99,128,54,115,59,51,5,73,55,18,3,3,47,20,27
"2021","Bath and North East Somerset 021A","E01014382",997,218,139,79,708,175,408,128,205,75,60,37,23,0,62,35,27,3,3,71,22,49
"2021","Bath and North East Somerset 021B","E01014383",451,90,59,31,330,82,181,59,90,32,41,25,16,0,24,9,15,2,2,31,12,19
"2021","Bath and North East Somerset 021C","E01014384",625,136,89,47,461,80,267,89,136,42,60,20,39,1,50,34,16,4,4,28,11,17
"2021","Bath and North East Somerset 021D","E01014418",608,127,72,55,443,95,253,105,98,50,52,32,17,3,41,22,19,2,2,38,15,23
"2021","Bath and North East Somerset 022B","E01014442",707,183,91,92,479,82,249,89,110,50,78,38,37,3,68,44,24,2,2,45,15,30
"2021","Bath and North East Somerset 022C","E01014443",686,176,80,96,468,84,248,84,109,55,73,44,23,6,61,33,28,2,2,42,17,25
"2021","Bath and North East Somerset 022D","E01014444",652,153,74,79,453,59,271,75,146,50,72,35,30,7,49,25,24,2,2,46,19,27
"2021","Bath and North East Somerset 022E","E01014445",714,245,116,129,426,35,214,71,92,51,72,28,39,5,102,65,37,3,3,43,18,25
"2021","Bath and North East Somerset 022F","E01035209",401,79,39,40,292,60,179,68,76,35,27,17,8,2,24,18,6,2,2,30,15,15
"2021","Bath and North East Somerset 022G","E01035210",451,88,45,43,328,65,177,73,67,37,48,22,19,7,37,21,16,1,1,35,10,25
"2021","Bath and North East Somerset 023A","E01014393",535,110,72,38,398,92,210,74,90,46,63,37,22,4,29,22,7,4,4,27,15,12
"2021","Bath and North East Somerset 023B","E01014394",698,149,98,51,516,100,283,95,128,60,69,33,31,5,61,27,34,3,3,33,10,23
"2021","Bath and North East Somerset 023C","E01014439",742,232,140,92,472,73,247,74,103,70,79,36,35,8,70,36,34,3,3,38,21,17
"2021","Bath and North East Somerset 023D","E01014440",1057,271,82,189,751,97,363,112,195,56,177,93,76,8,110,78,32,4,4,35,13,22
"2021","Bath and North East Somerset 023E","E01014441",913,265,128,137,611,123,265,101,125,39,128,62,58,8,91,69,22,4,4,37,14,23
"2021","Bath and North East Somerset 024A","E01014448",657,216,110,106,408,52,181,68,77,36,86,44,37,5,86,59,27,3,3,33,13,20
"2021","Bath and North East Somerset 024B","E01014449",590,117,48,69,445,45,223,76,103,44,114,54,51,9,60,42,18,3,3,28,8,20
"2021","Bath and North East Somerset 024C","E01014450",580,151,67,84,397,49,172,54,86,32,84,26,52,6,89,59,30,3,3,32,13,19
"2021","Bath and North East Somerset 024D","E01014451",732,202,66,136,491,53,237,80,125,32,116,62,53,1,82,52,30,3,3,39,12,27
"2021","Bath and North East Somerset 025A","E01014420",695,261,95,166,410,45,196,69,83,44,107,57,45,5,60,44,16,2,2,24,6,18
"2021","Bath and North East Somerset 025B","E01014421",585,101,61,40,460,92,259,89,118,52,69,38,25,6,37,24,13,3,3,24,12,12
"2021","Bath and North East Somerset 025C","E01014422",720,170,110,60,523,120,274,101,116,57,82,42,34,6,44,27,17,3,3,27,13,14
"2021","Bath and North East Somerset 025D","E01014423",662,225,96,129,405,56,177,60,72,45,93,52,38,3,74,45,29,5,5,32,13,19
"2021","Bath and North East Somerset 026A","E01014469",530,128,78,50,383,55,173,50,76,47,86,31,47,8,63,36,27,6,6,19,11,8
"2021","Bath and North East Somerset 026B","E01014470",680,134,65,69,516,72,247,79,116,52,116,61,46,9,76,47,29,5,5,30,13,17
"2021","Bath and North East Somerset 026C","E01014471",658,189,70,119,443,54,223,73,103,47,93,51,36,6,65,34,31,8,8,26,12,14
"2021","Bath and North East Somerset 026D","E01014472",742,176,81,95,532,88,258,78,125,55,103,49,49,5,79,53,26,4,4,34,13,21
"2021","Bath and North East Somerset 027A","E01014424",864,174,111,63,652,145,322,117,141,64,98,46,47,5,84,55,29,3,3,38,14,24
"2021","Bath and North East Somerset 027B","E01014425",964,237,135,102,694,150,353,115,157,81,92,43,33,16,97,60,37,2,2,33,14,19
"2021","Bath and North East Somerset 027C","E01014426",638,230,130,100,373,74,160,53,69,38,69,25,34,10,68,37,31,2,2,35,8,27
"2021","Bristol 001A","E01014601",748,231,114,117,466,68,208,47,123,38,82,43,35,4,101,58,43,7,7,51,19,32
"2021","Bristol 001B","E01014602",824,254,82,172,508,44,182,45,99,38,118,50,57,11,153,117,36,11,11,62,23,39
"2021","Bristol 001C","E01014603",1068,282,96,186,697,52,328,102,179,47,179,109,56,14,128,80,48,10,10,89,33,56
"2021","Bristol 001E","E01014605",835,326,127,199,456,42,167,57,81,29,96,45,40,11,139,103,36,12,12,53,19,34
"2021","Bristol 001G","E01032516",858,219,96,123,583,112,259,93,115,51,100,64,31,5,107,73,34,5,5,56,14,42
"2021","Bristol 001H","E01032517",722,197,55,142,449,33,183,51,96,36,85,44,41,0,135,83,52,13,13,76,25,51
"2021","Bristol 002A","E01014688",654,147,66,81,407,25,181,35,105,41,85,32,44,9,114,72,42,2,2,100,30,70
"2021","Bristol 002B","E01014689",604,187,68,119,351,13,148,32,80,36,56,14,34,8,127,76,51,7,7,66,22,44
"2021","Bristol 002C","E01014690",784,178,85,93,491,33,265,61,147,57,83,39,36,8,100,63,37,10,10,115,38,77
"2021","Bristol 002D","E01014691",832,302,199,103,458,53,205,48,114,43,94,57,31,6,100,46,54,6,6,72,25,47
"2021","Bristol 002E","E01014692",623,129,48,81,407,17,182,54,99,29,79,40,30,9,121,71,50,8,8,87,24,63
"2021","Bristol 002F","E01014693",642,227,109,118,370,64,186,69,80,37,70,41,27,2,46,27,19,4,4,45,18,27
"2021","Bristol 002G","E01014694",658,195,86,109,393,45,184,42,102,40,68,30,33,5,89,45,44,7,7,70,25,45
"2021","Bristol 003A","E01014497",687,193,75,118,429,29,167,50,85,32,95,45,45,5,123,90,33,15,15,65,32,33
"2021","Bristol 003B","E01014498",659,159,70,89,458,33,189,71,89,29,91,32,51,8,140,115,25,5,5,42,25,17
"2021","Bristol 003C","E01014638",792,295,132,163,440,31,156,58,64,34,92,41,38,13,151,103,48,10,10,57,22,35
"2021","Bristol 003D","E01014639",616,156,54,102,405,24,105,29,59,17,68,14,52,2,200,158,42,8,8,55,28,27
"2021","Bristol 003E","E01014640",605,150,76,74,389,25,179,40,115,24,66,21,36,9,107,71,36,12,12,66,31,35
"2021","Bristol 004A","E01014631",531,171,95,76,305,47,157,41,81,35,44,30,12,2,53,21,32,4,4,55,10,45
"2021","Bristol 004B","E01014632",866,220,87,133,483,45,225,65,132,28,123,93,24,6,81,47,34,9,9,163,24,139
"2021","Bristol 004C","E01014633",735,166,78,88,485,53,261,70,151,40,83,47,32,4,81,48,33,7,7,84,19,65
"2021","Bristol 004D","E01014636",633,163,72,91,412,39,183,40,111,32,60,34,24,2,122,63,59,8,8,58,12,46
"2021","Bristol 005A","E01014630",876,253,81,172,455,29,164,39,87,38,113,77,30,6,141,94,47,8,8,168,34,134
"2021","Bristol 005B","E01014634",716,165,52,113,370,34,174,71,75,28,114,79,35,0,40,26,14,8,8,181,20,161
"2021","Bristol 005C","E01014659",865,249,62,187,473,27,177,62,88,27,101,78,21,2,158,109,49,10,10,143,18,125
"2021","Bristol 005D","E01014661",606,118,44,74,387,29,181,45,97,39,79,53,23,3,94,59,35,4,4,101,31,70
"2021","Bristol 006A","E01014616",679,252,156,96,384,77,223,62,131,30,50,33,17,0,34,23,11,0,0,43,9,34
"2021","Bristol 006B","E01014719",643,200,93,107,411,62,228,66,137,25,73,59,12,2,47,22,25,1,1,32,7,25
"2021","Bristol 006C","E01014720",755,280,150,130,431,62,220,56,128,36,67,42,22,3,76,43,33,6,6,44,12,32
"2021","Bristol 006D","E01014721",668,193,115,78,449,90,267,81,151,35,45,29,16,0,43,21,22,4,4,26,11,15
"2021","Bristol 007A","E01014641",647,176,101,75,436,92,212,67,106,39,69,38,22,9,63,39,24,0,0,35,10,25
"2021","Bristol 007B","E01014642",633,168,84,84,434,64,228,78,119,31,68,40,24,4,69,39,30,5,5,31,8,23
"2021","Bristol 007C","E01014643",581,169,91,78,371,34,164,46,77,41,64,25,33,6,104,65,39,5,5,41,16,25
"2021","Bristol 007D","E01014644",640,129,68,61,457,53,234,67,114,53,69,38,29,2,97,60,37,4,4,54,23,31
"2021","Bristol 008A","E01014492",784,290,146,144,457,76,190,78,88,24,83,47,34,2,102,59,43,6,6,37,10,27
"2021","Bristol 008B","E01014493",648,189,95,94,408,33,185,57,95,33,82,43,32,7,100,58,42,8,8,51,18,33
"2021","Bristol 008C","E01014494",654,163,89,74,439,70,212,68,97,47,98,57,36,5,50,23,27,9,9,52,21,31
"2021","Bristol 008D","E01014495",755,229,115,114,476,63,227,78,103,46,97,58,34,5,81,54,27,8,8,50,21,29
"2021","Bristol 008E","E01014496",805,262,81,181,433,30,177,55,85,37,132,73,53,6,78,43,35,16,16,110,36,74
"2021","Bristol 008F","E01014499",610,141,58,83,411,45,174,56,81,37,99,41,55,3,92,54,38,1,1,58,30,28
"2021","Bristol 009A","E01014715",623,100,64,36,503,101,331,87,209,35,44,20,23,1,27,15,12,0,0,20,6,14
"2021","Bristol 009B","E01014716",616,138,94,44,456,98,273,72,163,38,53,31,19,3,30,19,11,2,2,22,9,13
"2021","Bristol 009C","E01014717",630,231,203,28,377,99,238,56,152,30,28,9,16,3,11,6,5,1,1,22,8,14
"2021","Bristol 009D","E01014718",640,193,104,89,422,77,230,66,133,31,72,58,12,2,40,22,18,3,3,25,9,16
"2021","Bristol 010A","E01014510",765,158,63,95,446,30,236,48,172,16,122,80,37,5,51,40,11,7,7,161,16,145
"2021","Bristol 010B","E01014635",778,201,65,136,423,40,197,59,111,27,124,91,31,2,54,30,24,8,8,154,19,135
"2021","Bristol 010C","E01014637",564,139,45,94,271,27,141,48,81,12,75,53,22,0,25,15,10,3,3,154,11,143
"2021","Bristol 010D","E01014662",619,133,56,77,388,32,177,43,102,32,101,55,41,5,72,47,25,6,6,98,21,77
"2021","Bristol 011A","E01014615",606,142,98,44,430,79,285,75,170,40,41,23,16,2,23,10,13,2,2,34,9,25
"2021","Bristol 011B","E01014617",524,73,48,25,423,75,286,101,151,34,34,16,18,0,25,12,13,3,3,28,2,26
"2021","Bristol 011C","E01014618",670,162,114,48,489,128,291,75,181,35,38,23,14,1,30,21,9,2,2,19,9,10
"2021","Bristol 011D","E01014620",649,174,128,46,447,88,267,59,178,30,45,21,22,2,47,25,22,0,0,28,4,24
"2021","Bristol 012A","E01014571",644,219,80,139,335,37,147,47,74,26,68,35,30,3,76,47,29,7,7,90,22,68
"2021","Bristol 012B","E01014577",660,179,76,103,412,65,206,78,92,36,91,55,34,2,47,28,19,3,3,69,24,45
"2021","Bristol 012C","E01014586",701,240,123,117,412,81,196,69,81,46,69,46,20,3,64,36,28,2,2,49,14,35
"2021","Bristol 012D","E01014587",610,211,84,127,328,38,155,44,81,30,51,31,18,2,74,40,34,10,10,71,24,47
"2021","Bristol 013A","E01014588",938,323,131,192,470,53,189,58,96,35,146,98,46,2,75,49,26,7,7,145,25,120
"2021","Bristol 013B","E01014589",641,201,66,135,393,13,142,28,80,34,64,27,24,13,171,112,59,3,3,47,22,25
"2021","Bristol 013C","E01014590",918,250,109,141,524,55,215,60,120,35,143,99,39,5,98,76,22,13,13,144,29,115
"2021","Bristol 013D","E01014591",803,237,135,102,489,95,220,71,112,37,108,67,35,6,58,32,26,8,8,77,26,51
"2021","Bristol 013E","E01014592",715,227,108,119,395,35,186,55,106,25,107,64,33,10,61,37,24,6,6,93,18,75
"2021","Bristol 014A","E01014660",862,272,111,161,491,33,212,66,110,36,107,50,43,14,131,83,48,8,8,99,28,71
"2021","Bristol 014B","E01014663",609,183,71,112,352,23,134,23,78,33,68,37,27,4,122,71,51,5,5,74,21,53
"2021","Bristol 014C","E01014664",643,182,83,99,383,31,177,49,99,29,91,54,37,0,76,46,30,8,8,78,24,54
"2021","Bristol 014D","E01014665",783,173,78,95,458,47,210,40,131,39,104,54,47,3,84,52,32,13,13,152,31,121
"2021","Bristol 015A","E01014709",597,210,113,97,361,85,187,74,90,23,64,49,15,0,23,17,6,2,2,26,5,21
"2021","Bristol 015B","E01014710",540,164,87,77,332,59,171,64,86,21,63,52,9,2,34,22,12,5,5,44,4,40
"2021","Bristol 015C","E01014711",536,111,83,28,396,104,222,72,125,25,40,18,20,2,29,13,16,1,1,29,9,20
"2021","Bristol 015D","E01014712",509,126,73,53,352,72,201,64,112,25,28,17,9,2,50,30,20,1,1,31,13,18
"2021","Bristol 015E","E01014713",578,154,91,63,398,108,214,63,114,37,47,30,10,7,27,17,10,2,2,26,10,16
"2021","Bristol 015F","E01014714",534,111,73,38,395,91,244,72,142,30,29,18,11,0,30,16,14,1,1,28,10,18
"2021","Bristol 016A","E01014507",714,182,68,114,406,18,236,50,170,16,119,80,35,4,28,16,12,5,5,126,10,116
"2021","Bristol 016B","E01014508",668,175,42,133,366,33,195,57,115,23,105,80,24,1,19,10,9,14,14,127,11,116
"2021","Bristol 016C","E01014509",1032,271,44,227,568,20,254,63,175,16,218,164,50,4,66,43,23,10,10,193,12,181
"2021","Bristol 016D","E01014511",522,120,42,78,327,21,200,42,134,24,75,35,35,5,31,21,10,0,0,75,12,63
"2021","Bristol 016E","E01014512",616,174,96,78,372,38,193,66,110,17,97,57,35,5,37,23,14,7,7,70,10,60
"2021","Bristol 016F","E01014513",617,138,70,68,415,54,256,54,171,31,67,31,30,6,33,16,17,5,5,64,13,51
"2021","Bristol 016G","E01014514",847,215,69,146,468,30,230,61,155,14,128,93,31,4,70,41,29,10,10,164,4,160
"2021","Bristol 017A","E01014619",581,144,77,67,362,63,189,58,104,27,74,56,18,0,31,23,8,5,5,75,12,63
"2021","Bristol 017B","E01014621",592,135,65,70,398,41,252,75,150,27,75,53,20,2,28,18,10,2,2,59,11,48
"2021","Bristol 017C","E01014666",672,120,56,64,498,62,343,64,223,56,57,22,31,4,34,24,10,2,2,54,12,42
"2021","Bristol 017D","E01014667",636,148,52,96,403,36,270,70,172,28,65,45,20,0,30,23,7,2,2,85,9,76
"2021","Bristol 017E","E01014672",960,376,131,245,444,64,210,80,114,16,135,118,17,0,31,20,11,4,4,140,11,129
"2021","Bristol 018A","E01014624",654,172,81,91,406,28,197,55,103,39,80,36,38,6,96,56,40,5,5,76,34,42
"2021","Bristol 018D","E01014629",550,126,59,67,356,26,172,33,91,48,67,36,27,4,85,47,38,6,6,68,33,35
"2021","Bristol 018E","E01032518",775,212,90,122,498,25,209,56,114,39,85,29,44,12,172,110,62,7,7,65,28,37
"2021","Bristol 018F","E01032519",530,156,79,77,317,36,144,43,76,25,85,46,37,2,46,26,20,6,6,57,12,45
"2021","Bristol 019A","E01014572",851,304,50,254,417,17,183,65,85,33,145,95,44,6,61,45,16,11,11,130,27,103
"2021","Bristol 019B","E01014573",838,293,79,214,424,43,198,57,105,36,103,57,41,5,76,47,29,4,4,121,25,96
"2021","Bristol 019C","E01014575",659,223,65,158,343,27,148,39,81,28,84,47,32,5,73,47,26,11,11,93,36,57
"2021","Bristol 019D","E01014576",902,262,86,176,562,56,262,79,135,48,136,76,58,2,99,60,39,9,9,78,26,52
"2021","Bristol 020A","E01014487",759,203,37,166,378,31,185,58,108,19,125,99,21,5,33,24,9,4,4,178,9,169
"2021","Bristol 020B","E01014491",777,172,46,126,469,44,235,67,148,20,137,87,46,4,36,22,14,17,17,136,15,121
"2021","Bristol 020C","E01014668",619,153,55,98,376,30,228,65,140,23,87,54,27,6,30,15,15,1,1,90,13,77
"2021","Bristol 020D","E01014669",666,207,38,169,364,23,183,57,107,19,123,102,21,0,30,23,7,5,5,95,10,85
"2021","Bristol 020E","E01014670",593,139,25,114,342,41,178,46,103,29,103,86,14,3,15,9,6,5,5,112,7,105
"2021","Bristol 020F","E01014671",697,216,57,159,343,22,175,57,99,19,111,96,15,0,25,17,8,10,10,138,11,127
"2021","Bristol 021A","E01014622",656,167,58,109,381,35,174,54,95,25,94,51,39,4,70,36,34,8,8,108,39,69
"2021","Bristol 021B","E01014623",671,188,77,111,403,32,202,52,116,34,90,55,28,7,75,36,39,4,4,80,25,55
"2021","Bristol 021C","E01014626",1110,335,105,230,660,46,270,82,151,37,162,92,65,5,173,115,58,9,9,115,40,75
"2021","Bristol 021D","E01014627",930,295,88,207,551,57,258,80,130,48,138,82,52,4,93,59,34,5,5,84,24,60
"2021","Bristol 022A","E01014557",613,149,40,109,299,26,149,50,84,15,94,80,14,0,25,14,11,5,5,165,8,157
"2021","Bristol 022B","E01014558",749,255,50,205,261,9,59,33,18,8,165,144,19,2,12,8,4,16,16,233,9,224
"2021","Bristol 022C","E01014559",791,227,70,157,399,62,186,64,97,25,115,99,11,5,27,17,10,9,9,165,14,151
"2021","Bristol 022D","E01014560",743,240,48,192,338,28,133,57,61,15,148,130,15,3,26,18,8,3,3,165,4,161
"2021","Bristol 022E","E01014562",603,161,31,130,252,23,95,37,51,7,109,98,9,2,19,12,7,6,6,190,10,180
"2021","Bristol 025A","E01014539",789,205,60,145,379,50,153,59,71,23,131,107,22,2,34,23,11,11,11,205,7,198
"2021","Bristol 025C","E01014561",756,243,57,186,380,38,153,67,65,21,158,141,15,2,20,14,6,11,11,133,6,127
"2021","Bristol 025D","E01014563",805,263,31,232,352,12,105,52,44,9,195,181,13,1,24,17,7,16,16,190,10,180
"2021","Bristol 025E","E01033342",598,286,21,265,242,4,81,30,47,4,110,103,5,2,30,18,12,17,17,70,2,68
"2021","Bristol 025F","E01033367",669,302,27,275,264,3,90,37,47,6,119,105,12,2,45,35,10,7,7,103,5,98
"2021","Bristol 026A","E01014551",822,286,29,257,310,10,85,50,26,9,181,169,12,0,18,14,4,16,16,226,4,222
"2021","Bristol 026B","E01014552",765,217,45,172,353,24,154,77,65,12,151,137,13,1,17,10,7,7,7,195,6,189
"2021","Bristol 026C","E01014553",766,241,55,186,302,30,118,40,69,9,125,113,9,3,23,13,10,6,6,223,7,216
"2021","Bristol 026D","E01014554",796,278,57,221,340,20,133,61,58,14,156,146,10,0,17,9,8,14,14,178,14,164
"2021","Bristol 026E","E01014556",839,303,109,194,411,48,180,69,95,16,156,134,19,3,24,15,9,3,3,125,8,117
"2021","Bristol 027A","E01014673",839,301,88,213,461,31,194,68,89,37,159,100,50,9,69,42,27,8,8,77,25,52
"2021","Bristol 027B","E01014674",685,169,65,104,444,34,227,73,102,52,86,46,32,8,86,56,30,11,11,72,28,44
"2021","Bristol 027C","E01014675",756,216,74,142,472,42,223,66,110,47,123,76,42,5,71,45,26,13,13,68,22,46
"2021","Bristol 027D","E01014676",675,214,109,105,406,49,194,60,100,34,95,47,39,9,61,36,25,7,7,55,20,35
"2021","Bristol 028A","E01014682",733,220,61,159,440,48,180,62,87,31,133,87,40,6,76,55,21,3,3,73,15,58
"2021","Bristol 028B","E01014683",910,408,121,287,423,36,165,54,79,32,138,94,42,2,75,52,23,9,9,79,16,63
"2021","Bristol 028C","E01014685",633,174,60,114,395,27,183,44,106,33,75,46,24,5,108,66,42,2,2,64,30,34
"2021","Bristol 028D","E01014686",771,200,54,146,497,53,207,49,113,45,126,79,43,4,104,67,37,7,7,74,27,47
"2021","Bristol 028E","E01014687",725,251,72,179,411,50,190,59,95,36,105,70,32,3,61,38,23,5,5,63,14,49
"2021","Bristol 029A","E01014565",810,296,86,210,411,27,138,53,58,27,146,95,48,3,80,47,33,20,20,103,11,92
"2021","Bristol 029B","E01014566",820,303,56,247,393,23,148,52,79,17,160,121,39,0,52,31,21,10,10,124,11,113
"2021","Bristol 029C","E01014567",877,261,53,208,480,27,169,67,82,20,187,142,42,3,85,58,27,12,12,136,15,121
"2021","Bristol 029D","E01014681",1192,429,121,308,627,32,197,77,104,16,252,183,64,5,129,84,45,17,17,136,21,115
"2021","Bristol 029E","E01014684",951,356,39,317,485,23,147,59,76,12,233,172,57,4,69,43,26,13,13,110,13,97
"2021","Bristol 030A","E01014544",546,194,75,119,293,59,136,59,61,16,83,71,12,0,13,11,2,2,2,59,6,53
"2021","Bristol 030B","E01014545",768,319,104,215,338,48,142,64,65,13,120,104,16,0,22,19,3,6,6,111,5,106
"2021","Bristol 030C","E01014546",748,275,77,198,293,31,92,48,33,11,131,118,13,0,26,18,8,13,13,180,9,171
"2021","Bristol 030D","E01014547",811,256,99,157,438,59,166,71,74,21,174,167,7,0,29,17,12,10,10,117,3,114
"2021","Bristol 033A","E01014677",722,210,45,165,466,42,202,82,92,28,152,113,36,3,65,36,29,5,5,46,11,35
"2021","Bristol 033B","E01014678",722,214,82,132,436,61,185,49,94,42,114,73,35,6,65,39,26,11,11,72,14,58
"2021","Bristol 033C","E01014679",677,184,66,118,441,71,210,73,89,48,93,55,32,6,65,36,29,2,2,52,11,41
"2021","Bristol 033D","E01014680",538,123,66,57,384,70,178,59,79,40,82,41,34,7,51,28,23,3,3,31,13,18
"2021","Bristol 034A","E01014548",784,300,67,233,367,34,129,56,60,13,147,124,23,0,52,39,13,5,5,117,11,106
"2021","Bristol 034B","E01014549",529,192,57,135,241,26,105,44,49,12,66,57,8,1,40,25,15,4,4,96,7,89
"2021","Bristol 034C","E01014550",865,282,91,191,434,64,190,93,76,21,139,122,15,2,37,25,12,4,4,149,3,146
"2021","Bristol 034D","E01014555",663,284,65,219,256,17,67,39,23,5,140,127,10,3,25,20,5,7,7,123,2,121
"2021","Bristol 035A","E01014528",714,209,47,162,449,34,195,80,91,24,155,97,55,3,59,44,15,6,6,56,12,44
"2021","Bristol 035B","E01014529",604,191,65,126,355,16,143,44,65,34,87,35,43,9,107,60,47,2,2,58,30,28
"2021","Bristol 035C","E01014530",670,224,43,181,394,42,173,62,89,22,124,94,30,0,52,41,11,3,3,52,18,34
"2021","Bristol 035D","E01014531",967,261,56,205,603,37,250,104,125,21,244,198,41,5,55,32,23,17,17,103,8,95
"2021","Bristol 035E","E01014532",627,163,70,93,417,24,179,59,85,35,146,102,34,10,60,32,28,8,8,47,11,36
"2021","Bristol 035F","E01014537",763,229,94,135,480,34,214,72,102,40,124,70,45,9,102,66,36,6,6,54,16,38
"2021","Bristol 036A","E01014695",981,362,131,231,491,48,204,66,112,26,155,112,33,10,76,43,33,8,8,128,12,116
"2021","Bristol 036B","E01014696",728,167,37,130,461,25,234,54,156,24,156,107,46,3,41,23,18,5,5,100,13,87
"2021","Bristol 036C","E01014698",867,246,61,185,478,27,203,64,122,17,197,154,38,5,45,30,15,6,6,143,7,136
"2021","Bristol 036D","E01014699",771,288,73,215,387,16,136,47,76,13,151,125,26,0,80,62,18,4,4,96,7,89
"2021","Bristol 036E","E01014700",658,141,61,80,416,47,219,56,127,36,112,66,38,8,34,10,24,4,4,101,13,88
"2021","Bristol 036F","E01014701",737,174,31,143,419,19,203,59,128,16,157,127,26,4,33,19,14,7,7,144,12,132
"2021","Bristol 037A","E01014730",873,382,56,326,387,12,147,70,72,5,171,146,24,1,48,29,19,9,9,104,14,90
"2021","Bristol 037B","E01014731",753,228,34,194,404,12,146,74,61,11,172,138,29,5,63,30,33,11,11,121,15,106
"2021","Bristol 037C","E01014732",774,242,37,205,439,11,181,61,111,9,183,143,35,5,49,30,19,15,15,93,16,77
"2021","Bristol 037D","E01014735",754,167,58,109,512,39,244,88,132,24,165,118,47,0,57,32,25,7,7,75,11,64
"2021","Bristol 038A","E01014523",685,197,73,124,444,70,215,67,111,37,100,56,36,8,56,33,23,3,3,44,16,28
"2021","Bristol 038B","E01014524",626,127,66,61,453,56,227,70,108,49,96,47,43,6,69,42,27,5,5,46,17,29
"2021","Bristol 038C","E01014525",678,157,63,94,465,46,232,72,123,37,119,77,36,6,64,37,27,4,4,56,9,47
"2021","Bristol 038D","E01014526",661,188,74,114,429,42,181,57,77,47,74,35,31,8,126,100,26,6,6,44,20,24
"2021","Bristol 038E","E01014527",653,242,119,123,359,44,165,67,68,30,83,61,19,3,58,32,26,9,9,52,13,39
"2021","Bristol 039A","E01014500",822,214,67,147,492,41,198,78,87,33,180,142,32,6,66,42,24,7,7,116,15,101
"2021","Bristol 039B","E01014502",881,232,100,132,547,45,251,96,114,41,147,110,29,8,92,51,41,12,12,102,24,78
"2021","Bristol 039E","E01033359",911,414,27,387,358,6,98,47,49,2,193,180,12,1,48,32,16,13,13,139,7,132
"2021","Bristol 039F","E01033361",784,339,113,226,328,25,104,56,37,11,146,131,14,1,43,20,23,10,10,117,9,108
"2021","Bristol 039G","E01033362",732,318,94,224,312,15,65,37,27,1,192,174,18,0,27,25,2,13,13,102,6,96
"2021","Bristol 039H","E01033364",822,244,66,178,459,21,148,57,81,10,220,183,34,3,46,30,16,24,24,119,10,109
"2021","Bristol 040A","E01014729",703,150,43,107,453,19,168,47,92,29,113,75,32,6,141,88,53,12,12,100,23,77
"2021","Bristol 040B","E01014733",746,182,39,143,446,16,202,68,117,17,154,100,50,4,66,46,20,8,8,118,9,109
"2021","Bristol 040C","E01014734",668,159,46,113,428,18,212,46,153,13,135,83,44,8,54,36,18,9,9,81,8,73
"2021","Bristol 040D","E01014736",870,223,86,137,527,33,231,77,115,39,165,111,50,4,90,58,32,8,8,120,33,87
"2021","Bristol 041A","E01014501",895,229,107,122,606,88,264,74,119,71,109,66,34,9,134,80,54,11,11,60,22,38
"2021","Bristol 041B","E01014504",695,183,63,120,415,41,187,60,108,19,132,96,33,3,46,24,22,9,9,97,6,91
"2021","Bristol 041C","E01014505",828,231,54,177,467,20,209,75,111,23,185,138,44,3,48,30,18,5,5,130,8,122
"2021","Bristol 041D","E01014506",618,121,73,48,445,66,250,67,129,54,85,38,40,7,43,21,22,1,1,52,20,32
"2021","Bristol 042A","E01014645",714,240,115,125,416,56,198,78,81,39,94,61,26,7,63,34,29,5,5,58,16,42
"2021","Bristol 042B","E01014646",666,156,78,78,442,65,208,49,108,51,82,39,37,6,84,43,41,3,3,68,22,46
"2021","Bristol 042C","E01014648",651,180,77,103,404,23,223,58,145,20,118,69,46,3,36,15,21,4,4,67,25,42
"2021","Bristol 042D","E01014649",695,164,57,107,474,51,280,79,170,31,109,64,43,2,24,12,12,10,10,57,19,38
"2021","Bristol 042E","E01014651",716,186,69,117,471,40,248,65,150,33,130,84,40,6,48,29,19,5,5,59,14,45
"2021","Bristol 043A","E01014533",663,180,59,121,441,48,216,76,112,28,116,69,42,5,59,40,19,2,2,42,13,29
"2021","Bristol 043B","E01014534",680,167,44,123,453,42,241,90,118,33,116,71,42,3,46,22,24,8,8,60,16,44
"2021","Bristol 043C","E01014535",748,147,84,63,536,90,298,83,156,59,75,37,34,4,69,39,30,4,4,65,31,34
"2021","Bristol 043D","E01014536",731,293,82,211,412,49,166,56,72,38,100,56,39,5,93,53,40,4,4,26,5,21
"2021","Bristol 044A","E01014578",663,144,66,78,440,30,221,66,104,51,79,42,28,9,105,72,33,5,5,79,30,49
"2021","Bristol 044B","E01014583",655,149,48,101,436,20,162,48,83,31,132,76,42,14,112,73,39,10,10,70,39,31
"2021","Bristol 044C","E01014585",695,167,78,89,476,23,173,45,96,32,92,28,53,11,178,133,45,10,10,52,26,26
"2021","Bristol 044D","E01014647",634,148,64,84,423,26,175,46,94,35,104,35,59,10,108,72,36,10,10,63,30,33
"2021","Bristol 044E","E01014650",644,145,75,70,441,46,220,60,107,53,92,48,37,7,81,39,42,2,2,58,16,42
"2021","Bristol 045A","E01014579",605,152,58,94,389,32,156,48,77,31,111,43,56,12,87,63,24,3,3,64,26,38
"2021","Bristol 045B","E01014580",669,219,109,110,393,48,128,48,41,39,83,36,36,11,129,76,53,5,5,57,29,28
"2021","Bristol 045C","E01014581",629,201,64,137,367,24,141,38,73,30,81,27,45,9,116,83,33,5,5,61,32,29
"2021","Bristol 045D","E01014582",500,106,46,60,340,25,146,37,73,36,60,26,25,9,97,59,38,12,12,54,28,26
"2021","Bristol 045E","E01014584",519,86,34,52,374,24,145,37,78,30,72,23,38,11,125,76,49,8,8,59,30,29
"2021","Bristol 046A","E01014518",775,216,68,148,505,42,204,59,103,42,152,113,34,5,94,60,34,13,13,54,14,40
"2021","Bristol 046B","E01014519",557,163,92,71,346,42,162,45,81,36,75,33,38,4,64,33,31,3,3,48,21,27
"2021","Bristol 046C","E01014520",689,160,104,56,496,108,235,80,96,59,104,49,47,8,47,21,26,2,2,33,12,21
"2021","Bristol 046D","E01014521",530,115,60,55,375,46,177,59,80,38,85,41,41,3,60,36,24,7,7,40,18,22
"2021","Bristol 047A","E01014607",680,155,71,84,491,76,196,66,89,41,111,52,54,5,104,79,25,4,4,34,18,16
"2021","Bristol 047B","E01014608",738,216,65,151,459,35,176,53,80,43,108,42,62,4,134,86,48,6,6,63,31,32
"2021","Bristol 047C","E01014609",724,204,73,131,465,56,197,59,87,51,103,38,52,13,101,64,37,8,8,55,27,28
"2021","Bristol 047D","E01014610",735,286,127,159,410,46,132,46,63,23,111,52,51,8,112,79,33,9,9,39,10,29
"2021","Bristol 047E","E01014613",659,183,94,89,420,63,186,60,80,46,93,60,28,5,74,48,26,4,4,56,18,38
"2021","Bristol 047F","E01014614",541,107,66,41,394,76,203,66,95,42,64,33,25,6,48,18,30,3,3,40,21,19
"2021","Bristol 048A","E01014594",637,152,49,103,439,13,128,38,65,25,91,32,51,8,199,144,55,8,8,46,17,29
"2021","Bristol 048B","E01014598",1062,377,127,250,622,90,249,102,102,45,218,176,36,6,58,31,27,7,7,63,18,45
"2021","Bristol 048C","E01014599",527,138,66,72,366,54,187,47,96,44,74,38,28,8,47,27,20,4,4,23,10,13
"2021","Bristol 048D","E01014600",647,223,153,70,374,62,178,66,70,42,71,32,32,7,61,37,24,2,2,50,15,35
"2021","Bristol 049A","E01014702",602,140,90,50,433,97,211,63,96,52,69,31,37,1,55,24,31,1,1,29,9,20
"2021","Bristol 049B","E01014703",660,229,63,166,387,36,161,53,62,46,72,42,26,4,115,72,43,3,3,44,17,27
"2021","Bristol 049C","E01014704",726,196,69,127,486,58,234,71,105,58,100,49,46,5,90,56,34,4,4,44,21,23
"2021","Bristol 049D","E01014705",615,217,160,57,382,88,195,57,83,55,56,23,27,6,38,16,22,5,5,16,8,8
"2021","Bristol 049E","E01014706",701,342,196,146,338,45,125,42,63,20,80,44,32,4,84,60,24,4,4,21,5,16
"2021","Bristol 049F","E01014707",640,154,102,52,436,100,208,55,85,68,67,29,31,7,58,31,27,3,3,50,26,24
"2021","Bristol 049G","E01014708",724,144,75,69,526,95,268,80,122,66,80,35,36,9,77,40,37,6,6,54,18,36
"2021","Bristol 050A","E01014515",642,174,102,72,422,63,174,60,68,46,80,35,38,7,100,52,48,5,5,46,21,25
"2021","Bristol 050B","E01014516",600,180,86,94,381,31,115,35,48,32,69,26,37,6,159,117,42,7,7,39,17,22
"2021","Bristol 050C","E01014517",510,112,36,76,359,21,143,45,70,28,77,30,41,6,115,84,31,3,3,39,16,23
"2021","Bristol 050D","E01014522",747,202,69,133,484,37,167,51,82,34,120,48,58,14,151,104,47,9,9,61,27,34
"2021","Bristol 051A","E01014593",547,130,47,83,361,21,121,23,66,32,73,15,53,5,143,111,32,3,3,56,31,25
"2021","Bristol 051B","E01014595",626,230,85,145,345,43,130,47,51,32,75,37,30,8,92,60,32,5,5,51,20,31
"2021","Bristol 051C","E01014596",612,167,87,80,385,41,141,28,74,39,85,33,43,9,111,68,43,7,7,60,26,34
"2021","Bristol 051D","E01014597",601,210,53,157,358,44,109,40,39,30,100,42,53,5,103,69,34,2,2,33,12,21
"2021","Bristol 052A","E01014611",573,130,87,43,417,109,200,72,78,50,76,34,37,5,31,14,17,1,1,26,7,19
"2021","Bristol 052B","E01014612",628,172,98,74,422,73,196,65,85,46,78,41,32,5,74,48,26,1,1,34,14,20
"2021","Bristol 052C","E01014722",623,137,75,62,456,93,231,82,100,49,71,27,38,6,61,33,28,0,0,30,9,21
"2021","Bristol 052D","E01014723",537,117,79,38,385,72,182,49,82,51,70,31,31,8,57,23,34,4,4,35,14,21
"2021","Bristol 052E","E01014725",613,142,100,42,443,97,247,95,88,64,52,25,23,4,39,18,21,8,8,28,6,22
"2021","Bristol 053B","E01014726",668,198,68,130,420,23,131,43,53,35,94,27,57,10,166,112,54,6,6,50,27,23
"2021","Bristol 053C","E01014727",598,159,74,85,401,32,123,32,67,24,105,39,54,12,136,101,35,5,5,38,19,19
"2021","Bristol 053E","E01032514",875,290,90,200,528,23,146,32,82,32,122,37,78,7,233,184,49,4,4,57,31,26
"2021","Bristol 053F","E01032515",845,291,88,203,509,39,151,49,72,30,122,46,68,8,189,154,35,8,8,45,25,20
"2021","Bristol 054A","E01033352",918,349,13,336,390,3,99,49,46,4,198,184,13,1,64,41,23,26,26,179,9,170
"2021","Bristol 054B","E01033353",863,425,27,398,324,5,72,42,26,4,185,171,14,0,44,34,10,18,18,114,5,109
"2021","Bristol 054D","E01033358",846,318,60,258,430,8,129,27,96,6,132,105,26,1,137,102,35,24,24,98,18,80
"2021","Bristol 054E","E01033370",668,312,74,238,311,6,116,34,73,9,78,70,7,1,104,73,31,7,7,45,8,37
"2021","Bristol 054F","E01033902",786,397,23,374,324,14,80,63,15,2,182,173,8,1,34,24,10,14,14,65,1,64
"2021","Bristol 054G","E01033903",475,214,10,204,195,1,63,42,20,1,115,109,6,0,7,3,4,9,9,66,1,65
"2021","Bristol 055A","E01014564",726,177,61,116,409,18,166,38,102,26,122,72,40,10,89,46,43,14,14,140,35,105
"2021","Bristol 055B","E01014653",1065,393,66,327,544,14,211,39,155,17,78,38,30,10,219,150,69,22,22,128,37,91
"2021","Bristol 055C","E01014655",1096,414,70,344,474,6,168,54,96,18,132,96,32,4,135,98,37,33,33,208,41,167
"2021","Bristol 056A","E01014654",937,317,70,247,439,11,186,43,127,16,66,43,21,2,157,113,44,19,19,181,56,125
"2021","Bristol 056B","E01014658",851,267,61,206,505,8,198,27,151,20,72,25,40,7,218,166,52,9,9,79,34,45
"2021","Bristol 056C","E01033356",691,279,70,209,337,12,140,37,94,9,72,52,18,2,105,85,20,8,8,75,20,55
"2021","Bristol 056D","E01033369",590,235,91,144,285,10,100,15,66,19,45,26,17,2,120,87,33,10,10,70,18,52
"2021","Bristol 057A","E01014568",1029,293,59,234,521,18,197,49,119,29,163,112,44,7,122,76,46,21,21,215,34,181
"2021","Bristol 057B","E01014569",858,240,57,183,466,11,189,47,113,29,147,88,53,6,107,64,43,12,12,152,30,122
"2021","Bristol 057C","E01014570",781,189,47,142,465,22,191,46,121,24,144,83,59,2,100,64,36,8,8,127,30,97
"2021","Bristol 057D","E01014574",982,352,84,268,460,22,196,51,120,25,115,87,27,1,102,74,28,25,25,170,51,119
"2021","Bristol 058A","E01014485",824,219,89,130,416,18,151,49,87,15,131,79,50,2,99,63,36,17,17,189,28,161
"2021","Bristol 058C","E01014486",1124,367,58,309,510,13,148,46,87,15,153,120,31,2,171,106,65,25,25,247,33,214
"2021","Bristol 058B","E01014488",854,262,61,201,421,28,151,56,82,13,167,114,48,5,65,45,20,10,10,171,21,150
"2021","Bristol 059A","E01014489",1152,412,52,360,471,5,127,47,67,13,200,170,26,4,121,79,42,18,18,269,22,247
"2021","Bristol 059D","E01033347",1031,390,28,362,395,5,93,48,33,12,212,195,17,0,59,49,10,26,26,246,12,234
"2021","Bristol 059C","E01033348",527,211,8,203,210,1,55,16,36,3,94,82,12,0,46,37,9,14,14,106,18,88
"2021","Bristol 059B","E01033366",580,200,31,169,288,1,105,11,90,4,49,41,8,0,124,73,51,9,9,92,27,65
"2021","Bristol 060A","E01014538",608,178,29,149,176,3,61,30,25,6,93,82,10,1,14,8,6,5,5,254,6,248
"2021","Bristol 060D","E01033344",632,239,28,211,238,11,89,51,35,3,96,90,6,0,38,26,12,4,4,155,11,144
"2021","Bristol 060B","E01033904",526,202,51,151,163,11,58,31,26,1,78,72,6,0,11,9,2,5,5,161,8,153
"2021","Bristol 060C","E01033905",531,205,8,197,136,3,46,26,16,4,71,66,5,0,6,5,1,10,10,190,1,189
"2021","Bristol 060E","E01033906",645,282,20,262,293,12,109,65,44,0,125,117,8,0,31,19,12,16,16,70,2,68
"2021","Bristol 061D","E01033350",708,334,79,255,332,40,111,76,28,7,154,136,14,4,18,8,10,9,9,42,2,40
"2021","Bristol 061A","E01033907",545,222,12,210,172,6,45,32,11,2,86,82,4,0,12,8,4,23,23,151,2,149
"2021","Bristol 061B","E01033908",459,200,9,191,140,1,47,32,15,0,77,71,6,0,9,9,0,6,6,119,0,119
"2021","Bristol 061C","E01033909",481,208,27,181,175,15,50,26,21,3,95,90,3,2,7,4,3,8,8,98,3,95
"2021","Bristol 061E","E01033910",627,249,47,202,316,26,117,55,53,9,113,105,8,0,52,33,19,8,8,62,8,54
"2021","North Somerset 001B","E01014790",646,161,107,54,466,103,264,74,140,50,56,31,24,1,38,25,13,5,5,19,5,14
"2021","North Somerset 001C","E01014795",657,211,110,101,411,70,202,65,100,37,74,31,35,8,60,41,19,5,5,35,13,22
"2021","North Somerset 001D","E01014797",783,227,130,97,524,97,266,91,139,36,72,37,32,3,85,48,37,4,4,32,12,20
"2021","North Somerset 001E","E01032675",793,275,93,182,480,84,213,94,99,20,114,89,23,2,65,46,19,4,4,38,11,27
"2021","North Somerset 001F","E01032676",1097,500,184,316,554,109,227,108,92,27,136,101,31,4,77,46,31,5,5,43,6,37
"2021","North Somerset 001G","E01032681",631,261,180,81,346,63,191,48,102,41,46,28,15,3,44,32,12,2,2,24,8,16
"2021","North Somerset 002A","E01014789",616,175,103,72,414,134,209,94,77,38,46,30,13,3,24,10,14,1,1,27,13,14
"2021","North Somerset 002B","E01014793",657,160,102,58,479,111,273,102,117,54,68,42,22,4,27,15,12,0,0,18,9,9
"2021","North Somerset 002C","E01014794",759,178,128,50,544,163,299,124,131,44,46,25,19,2,32,23,9,4,4,37,10,27
"2021","North Somerset 002D","E01014798",585,109,72,37,467,115,275,88,136,51,39,14,22,3,38,24,14,0,0,9,3,6
"2021","North Somerset 003B","E01014792",869,329,213,116,509,131,247,90,122,35,65,36,24,5,64,34,30,2,2,31,13,18
"2021","North Somerset 003C","E01014796",787,244,168,76,516,125,268,103,125,40,69,27,36,6,51,25,26,3,3,27,12,15
"2021","North Somerset 003D","E01032677",821,276,86,190,523,32,265,70,186,9,134,83,47,4,90,73,17,2,2,22,11,11
"2021","North Somerset 003E","E01032678",551,84,31,53,444,29,290,60,198,32,68,31,33,4,57,45,12,0,0,23,13,10
"2021","North Somerset 003F","E01032682",423,98,54,44,304,41,173,54,85,34,39,16,20,3,50,37,13,1,1,21,11,10
"2021","North Somerset 004A","E01014766",586,135,69,66,432,103,241,77,125,39,63,43,15,5,23,9,14,2,2,19,2,17
"2021","North Somerset 004B","E01014767",577,120,86,34,424,150,202,78,89,35,47,27,20,0,24,14,10,1,1,33,18,15
"2021","North Somerset 004C","E01014786",748,234,123,111,479,71,200,73,87,40,103,49,48,6,95,52,43,10,10,35,12,23
"2021","North Somerset 004D","E01014787",823,235,106,129,548,102,259,93,125,41,107,57,44,6,75,50,25,5,5,40,13,27
"2021","North Somerset 005A","E01014752",673,167,91,76,487,92,268,92,132,44,74,40,32,2,51,27,24,2,2,19,8,11
"2021","North Somerset 005B","E01014754",719,324,141,183,377,96,161,87,59,15,79,62,15,2,38,21,17,3,3,18,3,15
"2021","North Somerset 005C","E01014758",509,126,73,53,362,117,197,65,94,38,30,16,12,2,18,8,10,0,0,21,6,15
"2021","North Somerset 005D","E01014759",608,155,121,34,437,131,252,99,121,32,38,24,13,1,16,7,9,0,0,16,7,9
"2021","North Somerset 006B","E01014849",790,194,139,55,567,192,273,85,156,32,70,46,22,2,32,17,15,0,0,29,8,21
"2021","North Somerset 006C","E01014850",852,186,97,89,637,127,384,112,224,48,83,44,36,3,39,24,15,4,4,29,15,14
"2021","North Somerset 006D","E01014851",1092,303,147,156,744,95,398,96,270,32,142,79,61,2,104,64,40,5,5,45,16,29
"2021","North Somerset 006E","E01014852",626,129,67,62,464,82,297,104,147,46,48,30,13,5,34,22,12,3,3,33,10,23
"2021","North Somerset 006G","E01032680",842,216,158,58,585,169,309,142,115,52,65,40,19,6,40,21,19,2,2,41,14,27
"2021","North Somerset 006H","E01035211",528,135,39,96,372,30,223,50,162,11,80,44,32,4,37,28,9,2,2,21,8,13
"2021","North Somerset 006I","E01035212",693,145,83,62,540,77,337,92,199,46,69,29,36,4,57,44,13,0,0,8,3,5
"2021","North Somerset 007A","E01014750",801,323,140,183,449,79,227,75,114,38,87,57,24,6,52,32,20,4,4,29,13,16
"2021","North Somerset 007B","E01014751",708,249,143,106,432,72,178,58,87,33,86,47,32,7,95,60,35,1,1,27,5,22
"2021","North Somerset 007C","E01014753",838,275,125,150,528,66,241,86,116,39,102,48,47,7,116,74,42,3,3,35,11,24
"2021","North Somerset 007D","E01014755",751,373,212,161,358,115,146,67,55,24,72,52,15,5,25,10,15,0,0,20,7,13
"2021","North Somerset 007E","E01014760",619,168,105,63,427,98,221,91,91,39,61,29,30,2,44,28,16,3,3,24,8,16
"2021","North Somerset 008A","E01014780",773,304,151,153,430,75,164,54,72,38,97,59,34,4,90,56,34,4,4,39,18,21
"2021","North Somerset 008B","E01014781",820,321,228,93,473,120,197,71,84,42,75,36,33,6,79,37,42,2,2,26,10,16
"2021","North Somerset 008C","E01014782",600,161,118,43,424,134,203,73,90,40,53,29,20,4,32,17,15,2,2,15,4,11
"2021","North Somerset 008D","E01014783",725,259,123,136,448,97,223,94,98,31,68,41,20,7,59,33,26,1,1,18,7,11
"2021","North Somerset 008E","E01014784",725,228,179,49,463,114,209,77,93,39,75,36,36,3,64,37,27,1,1,34,15,19
"2021","North Somerset 008F","E01014785",603,144,98,46,442,163,218,75,93,50,36,20,11,5,23,6,17,2,2,17,8,9
"2021","North Somerset 009A","E01014775",503,99,64,35,395,89,212,68,97,47,49,28,17,4,44,25,19,1,1,9,6,3
"2021","North Somerset 009B","E01014776",501,111,73,38,369,86,214,74,98,42,26,14,12,0,43,24,19,0,0,21,8,13
"2021","North Somerset 009C","E01014777",619,162,84,78,438,86,226,70,116,40,63,39,22,2,60,41,19,3,3,19,4,15
"2021","North Somerset 009D","E01014778",538,104,77,27,416,153,212,74,100,38,31,18,11,2,18,11,7,2,2,18,10,8
"2021","North Somerset 009E","E01014779",501,152,105,47,337,92,192,77,75,40,27,13,11,3,25,10,15,1,1,12,6,6
"2021","North Somerset 010A","E01014756",769,321,134,187,418,89,205,84,91,30,69,47,21,1,54,34,20,1,1,30,9,21
"2021","North Somerset 010B","E01014757",614,158,91,67,437,73,212,80,98,34,82,40,35,7,63,32,31,7,7,19,10,9
"2021","North Somerset 010C","E01014761",728,242,129,113,463,94,238,102,95,41,73,51,18,4,55,33,22,3,3,23,7,16
"2021","North Somerset 010D","E01014762",626,173,106,67,437,82,242,86,112,44,76,43,31,2,37,23,14,0,0,16,10,6
"2021","North Somerset 010E","E01014763",730,199,86,113,494,52,263,82,124,57,105,52,41,12,73,42,31,1,1,37,12,25
"2021","North Somerset 011A","E01014737",601,107,82,25,460,106,287,83,157,47,32,12,17,3,35,16,19,0,0,34,14,20
"2021","North Somerset 011B","E01014738",585,128,70,58,438,65,243,53,149,41,58,23,32,3,72,50,22,0,0,19,7,12
"2021","North Somerset 011C","E01014739",639,151,88,63,449,118,253,89,119,45,42,18,22,2,35,23,12,1,1,39,13,26
"2021","North Somerset 011D","E01014740",569,117,61,56,427,87,269,74,151,44,41,19,19,3,28,14,14,2,2,25,8,17
"2021","North Somerset 012A","E01014855",596,138,74,64,436,107,248,87,116,45,58,36,21,1,20,10,10,3,3,22,4,18
"2021","North Somerset 012B","E01014856",884,193,111,82,645,92,332,130,153,49,133,82,49,2,86,57,29,2,2,46,16,30
"2021","North Somerset 012C","E01014857",623,143,89,54,455,104,223,73,109,41,59,34,23,2,68,51,17,1,1,25,8,17
"2021","North Somerset 012D","E01014858",738,191,78,113,502,91,267,104,114,49,92,61,29,2,50,34,16,2,2,45,20,25
"2021","North Somerset 012E","E01014859",659,218,142,76,412,78,232,76,108,48,61,39,16,6,40,21,19,1,1,29,7,22
"2021","North Somerset 012F","E01014860",635,184,110,74,416,68,213,65,98,50,74,39,29,6,58,34,24,3,3,35,14,21
"2021","North Somerset 013A","E01014847",701,144,85,59,506,103,254,80,123,51,95,43,43,9,49,27,22,5,5,51,20,31
"2021","North Somerset 013B","E01014848",563,121,69,52,397,79,222,88,88,46,61,34,22,5,32,17,15,3,3,45,13,32
"2021","North Somerset 013C","E01014853",759,239,131,108,496,110,255,94,131,30,79,46,33,0,49,30,19,3,3,24,8,16
"2021","North Somerset 013D","E01014854",584,137,87,50,408,105,218,81,93,44,56,31,23,2,28,18,10,1,1,39,17,22
"2021","North Somerset 014A","E01014764",779,208,139,69,518,123,257,100,110,47,75,38,31,6,62,40,22,1,1,53,20,33
"2021","North Somerset 014B","E01014765",787,199,112,87,534,144,275,110,121,44,56,21,26,9,57,36,21,2,2,54,15,39
"2021","North Somerset 014C","E01014773",673,140,59,81,489,66,293,97,152,44,83,45,33,5,46,31,15,1,1,44,24,20
"2021","North Somerset 014D","E01014774",862,275,146,129,542,152,264,105,91,68,79,49,29,1,41,22,19,6,6,45,17,28
"2021","North Somerset 015A","E01014821",492,147,55,92,326,35,157,60,69,28,80,43,32,5,53,37,16,1,1,19,7,12
"2021","North Somerset 015B","E01014822",532,79,49,30,431,72,261,88,126,47,61,22,36,3,35,22,13,2,2,22,15,7
"2021","North Somerset 015C","E01014823",494,96,60,36,375,60,213,76,101,36,65,29,34,2,37,19,18,0,0,23,7,16
"2021","North Somerset 015D","E01014824",633,165,97,68,447,90,229,96,80,53,77,42,35,0,49,33,16,2,2,21,4,17
"2021","North Somerset 015E","E01014825",485,92,58,34,363,79,188,71,83,34,59,24,28,7,35,22,13,2,2,30,16,14
"2021","North Somerset 015F","E01014826",628,172,61,111,440,44,228,75,92,61,97,55,37,5,70,53,17,1,1,16,9,7
"2021","North Somerset 015G","E01014827",594,205,86,119,353,38,150,47,69,34,77,33,39,5,86,68,18,2,2,36,15,21
"2021","North Somerset 016A","E01014817",716,222,134,88,452,118,182,78,59,45,87,43,38,6,63,35,28,2,2,42,17,25
"2021","North Somerset 016B","E01014820",726,288,198,90,411,104,175,83,62,30,56,26,24,6,74,42,32,2,2,27,10,17
"2021","North Somerset 016C","E01014835",693,295,188,107,367,75,129,49,50,30,67,33,31,3,93,53,40,3,3,31,12,19
"2021","North Somerset 016D","E01014836",657,228,159,69,407,94,166,62,72,32,68,27,32,9,77,46,31,2,2,22,8,14
"2021","North Somerset 016E","E01014838",604,154,95,59,422,114,193,80,76,37,63,31,29,3,46,26,20,6,6,28,16,12
"2021","North Somerset 016F","E01014840",611,181,114,67,399,102,162,65,58,39,64,26,34,4,69,39,30,2,2,31,16,15
"2021","North Somerset 017A","E01014812",680,234,136,98,416,122,183,77,72,34,63,37,22,4,48,27,21,0,0,30,13,17
"2021","North Somerset 017B","E01014813",747,182,107,75,518,86,259,88,114,57,94,49,35,10,78,48,30,1,1,47,23,24
"2021","North Somerset 017C","E01014815",595,198,82,116,371,66,163,50,77,36,84,41,38,5,56,42,14,2,2,26,12,14
"2021","North Somerset 017D","E01014816",639,162,108,54,448,128,229,81,94,54,58,35,20,3,33,18,15,0,0,29,12,17
"2021","North Somerset 017E","E01014818",754,183,126,57,539,152,271,109,108,54,77,34,34,9,39,18,21,0,0,32,8,24
"2021","North Somerset 017F","E01014819",731,223,126,97,479,153,201,97,66,38,69,34,27,8,54,35,19,2,2,29,11,18
"2021","North Somerset 018A","E01014841",1032,557,167,390,424,73,153,109,27,17,115,85,25,5,76,38,38,7,7,51,8,43
"2021","North Somerset 018B","E01014842",871,450,150,300,380,64,130,82,29,19,95,73,19,3,85,60,25,6,6,41,9,32
"2021","North Somerset 018C","E01014843",650,270,101,169,338,70,136,72,40,24,91,66,22,3,40,22,18,1,1,42,14,28
"2021","North Somerset 018D","E01014844",854,499,133,366,308,47,100,51,35,14,92,67,25,0,55,34,21,14,14,47,9,38
"2021","North Somerset 018E","E01014845",597,190,96,94,380,109,159,72,53,34,72,49,18,5,37,17,20,3,3,27,9,18
"2021","North Somerset 018F","E01014846",657,219,90,129,390,81,172,78,65,29,76,50,20,6,59,36,23,2,2,48,21,27
"2021","North Somerset 020A","E01014799",898,402,85,317,428,40,138,52,63,23,125,90,32,3,114,81,33,11,11,68,18,50
"2021","North Somerset 020B","E01014800",931,454,80,374,395,18,123,44,63,16,111,77,32,2,133,101,32,10,10,82,24,58
"2021","North Somerset 020C","E01014801",874,508,197,311,309,69,98,44,30,24,71,50,15,6,57,31,26,14,14,57,20,37
"2021","North Somerset 020D","E01014802",809,438,134,304,308,49,120,60,46,14,70,55,13,2,60,41,19,9,9,63,21,42
"2021","North Somerset 020E","E01014809",874,304,75,229,513,58,216,63,115,38,116,64,45,7,113,60,53,10,10,57,29,28
"2021","North Somerset 020F","E01014811",797,278,141,137,476,68,211,63,111,37,91,39,46,6,103,63,40,3,3,43,19,24
"2021","North Somerset 021A","E01014829",889,336,129,207,498,26,170,66,78,26,116,55,52,9,178,129,49,8,8,55,20,35
"2021","North Somerset 021B","E01014830",662,227,72,155,381,39,169,62,76,31,91,56,32,3,77,59,18,5,5,54,26,28
"2021","North Somerset 021C","E01014831",600,214,77,137,355,11,107,41,42,24,69,14,46,9,164,127,37,4,4,31,15,16
"2021","North Somerset 021D","E01014832",653,232,115,117,378,29,144,52,55,37,81,17,53,11,120,93,27,4,4,43,18,25
"2021","North Somerset 021E","E01014833",653,213,96,117,415,30,132,38,55,39,79,26,47,6,167,119,48,7,7,25,17,8
"2021","North Somerset 022A","E01014804",637,219,122,97,379,119,174,66,68,40,46,24,17,5,37,21,16,3,3,39,10,29
"2021","North Somerset 022B","E01014806",784,396,158,238,333,58,118,56,45,17,82,57,22,3,70,55,15,5,5,55,15,40
"2021","North Somerset 022C","E01014807",782,328,102,226,399,51,165,72,61,32,102,65,31,6,80,53,27,1,1,55,24,31
"2021","North Somerset 022D","E01014808",587,153,69,84,398,82,216,84,93,39,60,29,24,7,39,21,18,1,1,36,18,18
"2021","North Somerset 023A","E01014744",671,180,123,57,460,140,210,102,73,35,65,39,24,2,44,21,23,1,1,31,8,23
"2021","North Somerset 023B","E01014746",666,177,88,89,448,83,212,78,93,41,73,41,27,5,79,56,23,1,1,41,9,32
"2021","North Somerset 023D","E01014770",631,170,124,46,437,161,190,93,60,37,53,34,19,0,31,16,15,2,2,24,6,18
"2021","North Somerset 023E","E01014771",647,197,144,53,419,127,208,97,67,44,45,26,16,3,38,21,17,1,1,31,17,14
"2021","North Somerset 023F","E01014772",672,183,117,66,461,135,213,111,66,36,72,48,22,2,41,24,17,0,0,28,10,18
"2021","North Somerset 023G","E01035213",760,173,37,136,554,37,256,73,169,14,156,86,66,4,103,90,13,2,2,33,10,23
"2021","North Somerset 023H","E01035214",671,156,88,68,478,83,276,101,127,48,64,24,37,3,55,30,25,0,0,37,22,15
"2021","North Somerset 024A","E01014741",680,237,149,88,406,126,190,75,88,27,47,23,19,5,40,25,15,3,3,37,17,20
"2021","North Somerset 024B","E01014742",637,163,117,46,455,155,230,85,97,48,40,18,21,1,29,13,16,1,1,19,3,16
"2021","North Somerset 024C","E01014745",742,232,163,69,478,119,243,103,97,43,58,31,24,3,55,32,23,3,3,32,14,18
"2021","North Somerset 024D","E01014747",607,145,80,65,429,104,222,87,104,31,69,34,32,3,34,22,12,0,0,33,16,17
"2021","North Somerset 024E","E01014748",551,131,70,61,374,83,187,66,92,29,57,32,23,2,45,31,14,2,2,46,13,33
"2021","North Somerset 024F","E01014749",547,96,51,45,399,92,235,84,109,42,47,23,18,6,23,12,11,2,2,52,24,28
"2021","North Somerset 025A","E01014803",662,213,117,96,416,98,206,91,89,26,59,27,25,7,52,29,23,1,1,33,5,28
"2021","North Somerset 025B","E01014805",721,178,131,47,505,178,240,116,74,50,57,38,13,6,30,16,14,0,0,38,14,24
"2021","North Somerset 025C","E01014828",603,161,82,79,398,48,134,39,69,26,72,16,44,12,140,100,40,4,4,44,11,33
"2021","North Somerset 025D","E01014834",616,206,93,113,375,52,140,50,69,21,59,23,29,7,121,79,42,3,3,35,15,20
"2021","North Somerset 026A","E01014839",647,145,75,70,465,67,230,79,105,46,83,43,35,5,83,53,30,2,2,37,17,20
"2021","North Somerset 026B","E01032666",518,126,66,60,353,63,181,52,98,31,53,29,21,3,51,36,15,5,5,39,17,22
"2021","North Somerset 026C","E01032667",445,111,38,73,311,36,154,52,80,22,61,27,28,6,57,48,9,3,3,23,12,11
"2021","North Somerset 026D","E01032668",616,164,32,132,432,22,195,69,100,26,119,60,58,1,95,69,26,1,1,20,10,10
"2021","North Somerset 026E","E01032672",1086,256,79,177,785,52,401,121,252,28,201,101,95,5,127,92,35,4,4,45,23,22
"2021","North Somerset 026F","E01032673",627,265,138,127,340,53,123,52,53,18,89,58,30,1,73,55,18,2,2,22,11,11
"2021","North Somerset 027B","E01032669",575,131,10,121,393,14,176,50,112,14,109,44,62,3,91,76,15,3,3,51,19,32
"2021","North Somerset 027C","E01032670",624,119,15,104,465,10,229,63,136,30,120,57,60,3,100,79,21,6,6,40,19,21
"2021","North Somerset 027D","E01032671",488,107,18,89,348,15,181,43,115,23,81,41,39,1,70,57,13,1,1,33,18,15
"2021","North Somerset 027E","E01032679",541,176,41,135,340,22,143,56,67,20,112,63,47,2,59,47,12,4,4,25,6,19
"2021","North Somerset 027F","E01035215",742,319,123,196,403,35,157,63,74,20,110,65,42,3,96,74,22,5,5,20,8,12
"2021","North Somerset 027G","E01035216",907,138,11,127,710,7,334,73,236,25,242,123,112,7,122,100,22,5,5,59,36,23
"2021","South Gloucestershire 001A","E01014985",634,219,109,110,400,112,213,86,87,40,52,34,16,2,23,15,8,0,0,15,4,11
"2021","South Gloucestershire 001B","E01014986",715,228,153,75,455,120,197,54,101,42,61,32,24,5,75,39,36,2,2,32,14,18
"2021","South Gloucestershire 001C","E01014987",952,187,85,102,723,112,333,91,213,29,194,110,80,4,80,59,21,4,4,42,20,22
"2021","South Gloucestershire 001D","E01014988",689,158,91,67,511,104,268,83,130,55,81,44,33,4,57,39,18,1,1,20,8,12
"2021","South Gloucestershire 001E","E01014989",768,147,64,83,594,92,341,101,191,49,92,53,37,2,69,49,20,0,0,27,13,14
"2021","South Gloucestershire 002A","E01014990",644,174,123,51,452,133,229,83,102,44,54,34,17,3,36,21,15,0,0,18,5,13
"2021","South Gloucestershire 002B","E01014991",1026,414,206,208,553,66,209,79,99,31,124,71,40,13,144,95,49,10,10,59,24,35
"2021","South Gloucestershire 002C","E01014992",581,123,75,48,443,103,229,63,112,54,62,29,26,7,48,28,20,1,1,15,4,11
"2021","South Gloucestershire 002D","E01014993",654,118,65,53,510,94,293,107,124,62,67,35,22,10,55,28,27,1,1,26,6,20
"2021","South Gloucestershire 003A","E01014884",616,134,55,79,456,61,269,97,118,54,74,37,30,7,50,33,17,2,2,26,14,12
"2021","South Gloucestershire 003B","E01014885",916,177,87,90,698,121,376,117,188,71,132,73,52,7,68,52,16,1,1,41,20,21
"2021","South Gloucestershire 003C","E01014929",919,200,105,95,646,129,341,133,138,70,104,65,30,9,68,44,24,4,4,73,24,49
"2021","South Gloucestershire 003D","E01014930",810,151,74,77,629,87,393,145,183,65,73,41,31,1,74,49,25,2,2,30,16,14
"2021","South Gloucestershire 004A","E01014863",660,182,111,71,452,139,200,66,90,44,58,26,26,6,52,33,19,3,3,26,7,19
"2021","South Gloucestershire 004B","E01014864",656,162,108,54,463,144,233,102,89,42,56,30,23,3,29,12,17,1,1,31,14,17
"2021","South Gloucestershire 004C","E01014962",686,130,80,50,498,123,303,130,108,65,46,31,13,2,25,14,11,1,1,58,20,38
"2021","South Gloucestershire 004D","E01014963",782,206,127,79,528,141,287,93,140,54,61,36,22,3,39,17,22,0,0,48,24,24
"2021","South Gloucestershire 005A","E01014861",958,233,104,129,648,107,327,130,149,48,115,66,43,6,93,53,40,6,6,77,31,46
"2021","South Gloucestershire 005B","E01014862",1112,215,107,108,834,158,498,161,248,89,99,48,43,8,77,49,28,2,2,63,25,38
"2021","South Gloucestershire 005C","E01014953",809,184,96,88,563,104,295,102,130,63,97,51,38,8,60,31,29,7,7,62,23,39
"2021","South Gloucestershire 005D","E01014954",684,222,89,133,427,77,212,85,91,36,86,46,33,7,48,30,18,4,4,35,17,18
"2021","South Gloucestershire 006A","E01015014",1194,267,56,211,875,81,469,166,234,69,209,124,83,2,110,89,21,6,6,52,27,25
"2021","South Gloucestershire 006B","E01015015",642,158,40,118,453,44,250,89,113,48,103,61,37,5,53,40,13,3,3,31,5,26
"2021","South Gloucestershire 006C","E01015016",449,78,53,25,347,105,186,71,72,43,39,17,16,6,16,5,11,1,1,24,9,15
"2021","South Gloucestershire 006D","E01015017",587,158,75,83,404,96,188,63,81,44,58,36,17,5,59,29,30,3,3,25,10,15
"2021","South Gloucestershire 006E","E01015018",568,95,58,37,441,82,229,84,85,60,78,44,30,4,52,24,28,0,0,32,18,14
"2021","South Gloucestershire 007A","E01015019",733,225,81,144,469,48,189,75,68,46,126,69,50,7,104,76,28,2,2,39,14,25
"2021","South Gloucestershire 007B","E01015020",643,202,83,119,409,39,175,49,82,44,93,45,42,6,97,64,33,5,5,32,18,14
"2021","South Gloucestershire 007C","E01015021",643,153,89,64,474,96,237,79,97,61,84,43,36,5,46,22,24,11,11,16,7,9
"2021","South Gloucestershire 007D","E01015022",695,227,114,113,442,69,205,75,80,50,112,61,45,6,52,32,20,4,4,26,10,16
"2021","South Gloucestershire 008A","E01014886",828,312,186,126,461,112,180,62,81,37,81,47,28,6,86,45,41,2,2,55,23,32
"2021","South Gloucestershire 008B","E01014887",614,152,94,58,445,127,225,86,96,43,55,33,21,1,36,21,15,2,2,17,6,11
"2021","South Gloucestershire 008C","E01014888",859,288,188,100,539,158,256,105,103,48,80,48,25,7,43,25,18,2,2,32,12,20
"2021","South Gloucestershire 008D","E01014889",590,115,76,39,458,116,210,69,94,47,74,34,36,4,55,33,22,3,3,17,4,13
"2021","South Gloucestershire 009A","E01014872",683,198,29,169,456,14,239,89,115,35,138,105,31,2,63,48,15,2,2,29,15,14
"2021","South Gloucestershire 009B","E01014874",599,169,42,127,397,23,238,61,128,49,83,61,18,4,49,28,21,4,4,33,14,19
"2021","South Gloucestershire 009C","E01014876",735,201,21,180,489,14,227,69,130,28,167,107,53,7,77,56,21,4,4,45,17,28
"2021","South Gloucestershire 009D","E01014877",595,110,26,84,447,31,278,90,154,34,84,50,30,4,53,31,22,1,1,38,16,22
"2021","South Gloucestershire 009E","E01014879",754,230,123,107,486,75,291,98,143,50,74,44,27,3,44,27,17,2,2,38,12,26
"2021","South Gloucestershire 009F","E01014881",709,115,25,90,553,15,375,89,227,59,91,62,24,5,66,47,19,6,6,41,15,26
"2021","South Gloucestershire 010A","E01015009",586,165,108,57,393,93,182,53,87,42,66,31,30,5,52,27,25,0,0,28,12,16
"2021","South Gloucestershire 010B","E01015010",555,135,76,59,395,65,176,58,85,33,89,34,47,8,64,34,30,1,1,25,10,15
"2021","South Gloucestershire 010C","E01015011",768,261,131,130,460,82,209,70,95,44,78,49,25,4,85,53,32,6,6,47,18,29
"2021","South Gloucestershire 010D","E01015012",769,213,121,92,527,111,246,97,98,51,90,44,43,3,78,53,25,2,2,29,13,16
"2021","South Gloucestershire 010E","E01015013",513,101,48,53,377,42,195,61,89,45,73,32,34,7,64,40,24,3,3,35,9,26
"2021","South Gloucestershire 012A","E01014873",554,101,32,69,427,55,260,100,112,48,81,51,25,5,30,17,13,1,1,26,9,17
"2021","South Gloucestershire 012B","E01014875",781,257,47,210,476,17,277,82,155,40,120,93,25,2,55,39,16,7,7,48,21,27
"2021","South Gloucestershire 012C","E01014878",854,184,40,144,612,42,353,100,201,52,138,102,35,1,73,51,22,6,6,58,26,32
"2021","South Gloucestershire 012D","E01014880",778,197,73,124,534,40,322,87,187,48,104,61,38,5,64,47,17,4,4,47,19,28
"2021","South Gloucestershire 012E","E01014882",846,195,35,160,586,29,279,80,157,42,146,88,51,7,121,77,44,11,11,65,18,47
"2021","South Gloucestershire 012F","E01014883",536,152,42,110,364,50,190,56,99,35,84,59,20,5,40,21,19,0,0,20,5,15
"2021","South Gloucestershire 013A","E01014911",579,109,83,26,448,134,240,66,120,54,31,15,14,2,40,23,17,3,3,22,6,16
"2021","South Gloucestershire 013B","E01014912",743,159,97,62,561,114,337,107,167,63,60,34,23,3,49,27,22,1,1,23,8,15
"2021","South Gloucestershire 013C","E01014913",657,128,86,42,509,125,285,84,146,55,53,26,25,2,45,15,30,1,1,20,10,10
"2021","South Gloucestershire 013D","E01014914",848,172,82,90,634,65,295,94,151,50,109,50,50,9,159,120,39,6,6,42,10,32
"2021","South Gloucestershire 014A","E01014892",747,193,74,119,511,40,209,59,106,44,124,65,52,7,132,100,32,6,6,43,13,30
"2021","South Gloucestershire 014B","E01014893",623,165,90,75,430,58,197,62,97,38,113,63,41,9,59,36,23,3,3,28,10,18
"2021","South Gloucestershire 014C","E01014894",490,109,47,62,359,61,186,54,82,50,63,31,27,5,46,22,24,3,3,22,7,15
"2021","South Gloucestershire 014D","E01014895",529,93,35,58,396,40,197,53,101,43,93,43,45,5,66,35,31,0,0,40,19,21
"2021","South Gloucestershire 014E","E01014896",479,81,34,47,371,36,190,57,94,39,75,29,42,4,69,38,31,1,1,27,7,20
"2021","South Gloucestershire 015A","E01014979",658,189,90,99,436,65,235,88,97,50,95,61,30,4,38,16,22,3,3,33,11,22
"2021","South Gloucestershire 015B","E01014980",637,144,73,71,460,87,275,108,103,64,68,42,19,7,29,15,14,1,1,33,11,22
"2021","South Gloucestershire 015C","E01014982",627,175,81,94,418,58,218,75,91,52,73,42,27,4,65,40,25,4,4,34,14,20
"2021","South Gloucestershire 015D","E01014983",643,189,84,105,417,40,191,64,89,38,86,38,40,8,96,66,30,4,4,37,13,24
"2021","South Gloucestershire 015E","E01014984",616,169,91,78,408,60,193,47,98,48,79,34,40,5,70,44,26,6,6,39,13,26
"2021","South Gloucestershire 016A","E01014998",643,199,136,63,422,91,209,63,91,55,54,25,22,7,64,34,30,4,4,22,13,9
"2021","South Gloucestershire 016B","E01014999",654,150,106,44,471,131,245,66,114,65,59,26,28,5,35,21,14,1,1,33,10,23
"2021","South Gloucestershire 016C","E01015000",666,179,107,72,449,81,233,80,91,62,69,37,27,5,59,40,19,7,7,38,16,22
"2021","South Gloucestershire 016D","E01015001",641,147,89,58,469,105,241,69,129,43,63,27,28,8,59,36,23,1,1,25,8,17
"2021","South Gloucestershire 018A","E01014904",642,208,113,95,327,49,137,59,54,24,68,42,21,5,69,41,28,4,4,107,18,89
"2021","South Gloucestershire 018B","E01014905",671,163,68,95,381,55,185,61,87,37,81,47,32,2,47,24,23,13,13,127,19,108
"2021","South Gloucestershire 018C","E01014906",795,341,168,173,385,52,142,38,74,30,86,45,31,10,96,75,21,9,9,69,27,42
"2021","South Gloucestershire 018D","E01014907",663,194,90,104,327,51,156,50,65,41,66,48,14,4,45,22,23,9,9,142,17,125
"2021","South Gloucestershire 018E","E01014908",564,139,69,70,372,74,202,57,104,41,52,26,24,2,41,22,19,3,3,53,9,44
"2021","South Gloucestershire 018F","E01014909",601,164,47,117,277,36,137,36,72,29,59,36,18,5,39,24,15,6,6,160,25,135
"2021","South Gloucestershire 018G","E01014910",657,181,66,115,368,40,170,47,85,38,80,55,23,2,71,47,24,7,7,108,14,94
"2021","South Gloucestershire 019A","E01014867",541,144,93,51,376,104,171,59,60,52,49,25,20,4,50,21,29,2,2,21,11,10
"2021","South Gloucestershire 019D","E01014994",805,199,131,68,539,139,252,102,88,62,83,53,23,7,57,25,32,8,8,67,27,40
"2021","South Gloucestershire 019E","E01014995",697,170,122,48,499,142,260,93,109,58,52,28,19,5,44,18,26,1,1,28,14,14
"2021","South Gloucestershire 019F","E01033338",640,126,33,93,458,51,249,67,132,50,93,45,45,3,62,39,23,3,3,56,20,36
"2021","South Gloucestershire 019G","E01033339",618,176,48,128,406,50,172,56,84,32,112,66,40,6,69,50,19,3,3,36,12,24
"2021","South Gloucestershire 019H","E01035217",613,121,0,121,455,3,175,35,131,9,179,121,54,4,88,82,6,10,10,37,14,23
"2021","South Gloucestershire 019I","E01035218",679,163,24,139,474,20,203,75,103,25,163,110,50,3,87,70,17,1,1,42,24,18
"2021","South Gloucestershire 019J","E01035219",446,122,41,81,307,33,158,51,80,27,70,42,25,3,46,26,20,0,0,17,7,10
"2021","South Gloucestershire 020A","E01014901",657,114,69,45,514,103,309,73,183,53,62,29,29,4,39,20,19,1,1,29,12,17
"2021","South Gloucestershire 020B","E01014902",533,121,85,36,392,86,235,63,128,44,40,20,19,1,31,15,16,0,0,20,3,17
"2021","South Gloucestershire 020C","E01014903",639,171,112,59,442,124,249,70,131,48,43,19,21,3,25,16,9,1,1,26,10,16
"2021","South Gloucestershire 020D","E01014965",614,125,84,41,464,87,270,65,139,66,66,28,31,7,37,19,18,4,4,25,8,17
"2021","South Gloucestershire 021A","E01014964",676,146,75,71,501,86,293,97,151,45,75,46,21,8,44,26,18,3,3,29,13,16
"2021","South Gloucestershire 021C","E01014967",817,166,60,106,610,81,364,103,204,57,99,60,36,3,63,41,22,3,3,41,21,20
"2021","South Gloucestershire 021D","E01014969",637,129,75,54,485,97,256,81,124,51,74,26,43,5,56,34,22,2,2,23,7,16
"2021","South Gloucestershire 021F","E01033334",604,116,18,98,455,18,288,88,174,26,96,63,31,2,48,41,7,5,5,33,11,22
"2021","South Gloucestershire 021G","E01033336",599,80,34,46,487,48,319,77,180,62,75,34,34,7,45,31,14,0,0,32,15,17
"2021","South Gloucestershire 021H","E01035220",800,142,44,98,618,45,322,93,183,46,140,90,47,3,110,80,30,1,1,40,18,22
"2021","South Gloucestershire 021I","E01035221",641,141,9,132,455,9,190,44,136,10,142,86,53,3,111,97,14,3,3,45,25,20
"2021","South Gloucestershire 022A","E01014897",605,125,92,33,455,91,269,68,142,59,61,37,21,3,32,9,23,2,2,25,8,17
"2021","South Gloucestershire 022B","E01014898",752,234,155,79,480,85,270,69,151,50,83,52,25,6,38,16,22,4,4,38,9,29
"2021","South Gloucestershire 022C","E01014899",759,274,144,130,443,84,238,67,124,47,86,57,23,6,34,20,14,1,1,42,16,26
"2021","South Gloucestershire 022D","E01014900",638,206,109,97,389,63,215,68,103,44,72,42,27,3,35,22,13,4,4,43,10,33
"2021","South Gloucestershire 023A","E01014959",538,109,61,48,407,45,224,73,104,47,70,29,36,5,65,31,34,3,3,22,11,11
"2021","South Gloucestershire 023B","E01014960",698,184,97,87,475,64,209,59,104,46,112,61,44,7,84,51,33,6,6,39,7,32
"2021","South Gloucestershire 023C","E01014961",646,177,103,74,431,75,201,53,106,42,64,28,28,8,88,55,33,3,3,38,10,28
"2021","South Gloucestershire 023D","E01014968",780,276,182,94,457,69,166,47,76,43,102,38,53,11,106,68,38,14,14,47,15,32
"2021","South Gloucestershire 024A","E01014865",890,215,99,116,638,92,330,116,155,59,122,74,42,6,91,57,34,3,3,37,13,24
"2021","South Gloucestershire 024B","E01014869",688,201,122,79,459,99,248,91,111,46,69,40,24,5,40,21,19,3,3,28,13,15
"2021","South Gloucestershire 024C","E01014870",648,144,81,63,463,90,281,127,102,52,56,36,16,4,35,22,13,1,1,41,13,28
"2021","South Gloucestershire 024D","E01014871",519,136,97,39,358,79,185,74,69,42,57,24,23,10,36,24,12,1,1,25,11,14
"2021","South Gloucestershire 024E","E01014890",859,180,119,61,629,129,374,136,166,72,78,44,29,5,45,23,22,3,3,50,21,29
"2021","South Gloucestershire 024F","E01014891",696,174,87,87,478,102,268,108,97,63,70,42,21,7,37,20,17,1,1,44,19,25
"2021","South Gloucestershire 025A","E01014955",566,114,70,44,424,89,218,86,95,37,67,33,29,5,47,24,23,3,3,28,8,20
"2021","South Gloucestershire 025B","E01014956",645,172,112,60,444,79,233,77,93,63,82,44,31,7,48,17,31,2,2,29,12,17
"2021","South Gloucestershire 025C","E01014957",500,125,78,47,348,72,170,52,79,39,69,33,33,3,36,15,21,1,1,27,9,18
"2021","South Gloucestershire 025D","E01014974",760,272,164,108,446,75,223,74,112,37,100,52,40,8,42,22,20,6,6,42,8,34
"2021","South Gloucestershire 025E","E01014977",711,299,95,204,369,26,97,35,47,15,107,54,46,7,134,95,39,5,5,43,10,33
"2021","South Gloucestershire 026A","E01014922",551,119,58,61,388,51,189,57,90,42,95,50,38,7,51,25,26,2,2,44,17,27
"2021","South Gloucestershire 026B","E01014923",628,195,80,115,387,61,177,60,78,39,74,44,26,4,75,40,35,0,0,46,16,30
"2021","South Gloucestershire 026C","E01014924",809,284,69,215,463,39,184,68,87,29,133,75,50,8,96,63,33,11,11,62,15,47
"2021","South Gloucestershire 026D","E01014973",650,204,111,93,406,62,189,52,95,42,72,35,34,3,79,49,30,4,4,40,17,23
"2021","South Gloucestershire 026E","E01014975",781,251,92,159,464,64,197,71,99,27,123,76,39,8,68,37,31,12,12,66,13,53
"2021","South Gloucestershire 026F","E01014976",815,290,79,211,489,59,189,65,83,41,123,76,44,3,112,81,31,6,6,36,11,25
"2021","South Gloucestershire 027A","E01014925",620,169,95,74,420,72,189,60,83,46,87,39,39,9,68,33,35,4,4,31,10,21
"2021","South Gloucestershire 027B","E01014926",683,192,118,74,454,55,202,54,97,51,90,32,52,6,103,65,38,4,4,37,16,21
"2021","South Gloucestershire 027C","E01014927",892,380,144,236,454,65,165,59,79,27,141,92,42,7,74,45,29,9,9,58,11,47
"2021","South Gloucestershire 027D","E01014928",628,195,103,92,389,68,167,51,83,33,73,30,34,9,76,44,32,5,5,44,11,33
"2021","South Gloucestershire 027E","E01014958",496,133,56,77,332,41,119,38,54,27,72,26,38,8,100,73,27,0,0,31,18,13
"2021","South Gloucestershire 028A","E01014915",698,206,125,81,445,60,207,68,96,43,105,60,43,2,63,38,25,10,10,47,13,34
"2021","South Gloucestershire 028B","E01015003",661,143,75,68,479,95,233,67,112,54,94,53,36,5,54,35,19,3,3,39,15,24
"2021","South Gloucestershire 028C","E01015005",983,273,70,203,628,50,267,70,147,50,183,114,60,9,122,99,23,6,6,82,24,58
"2021","South Gloucestershire 028D","E01015007",889,305,102,203,526,75,225,84,97,44,116,68,43,5,100,58,42,10,10,58,16,42
"2021","South Gloucestershire 028E","E01015008",691,166,74,92,477,68,214,61,104,49,119,63,44,12,72,38,34,4,4,48,14,34
"2021","South Gloucestershire 029A","E01014943",793,271,68,203,498,20,222,79,100,43,175,119,47,9,79,45,34,2,2,24,8,16
"2021","South Gloucestershire 029B","E01014944",693,137,50,87,535,51,287,100,131,56,112,58,43,11,84,49,35,1,1,21,8,13
"2021","South Gloucestershire 029C","E01014972",712,212,129,83,466,72,280,90,118,72,74,43,25,6,34,17,17,6,6,34,13,21
"2021","South Gloucestershire 029D","E01015002",630,165,70,95,424,55,223,80,92,51,72,43,28,1,70,38,32,4,4,41,10,31
"2021","South Gloucestershire 029E","E01015004",702,187,72,115,475,69,220,77,92,51,111,67,38,6,73,33,40,2,2,40,14,26
"2021","South Gloucestershire 029F","E01015006",671,160,81,79,481,79,244,74,110,60,76,48,24,4,79,45,34,3,3,30,13,17
"2021","South Gloucestershire 030A","E01014936",558,122,59,63,416,50,223,88,87,48,83,34,40,9,60,41,19,0,0,20,8,12
"2021","South Gloucestershire 030B","E01014938",646,142,68,74,489,60,244,93,105,46,107,60,45,2,77,46,31,1,1,15,7,8
"2021","South Gloucestershire 030C","E01014939",499,116,43,73,358,45,157,48,83,26,73,33,33,7,81,52,29,2,2,25,10,15
"2021","South Gloucestershire 030D","E01014940",515,82,40,42,406,84,220,74,90,56,60,27,28,5,40,22,18,2,2,27,7,20
"2021","South Gloucestershire 030E","E01014941",649,171,91,80,451,49,201,68,92,41,69,29,34,6,125,82,43,7,7,27,11,16
"2021","South Gloucestershire 030F","E01014942",641,202,84,118,404,49,177,51,91,35,92,37,50,5,81,43,38,5,5,35,14,21
"2021","South Gloucestershire 030G","E01014945",695,178,92,86,482,87,231,77,94,60,96,55,35,6,62,35,27,6,6,35,12,23
"2021","South Gloucestershire 031A","E01014916",695,236,99,137,420,61,205,55,110,40,93,54,34,5,56,36,20,5,5,39,16,23
"2021","South Gloucestershire 031B","E01014917",684,167,87,80,483,90,251,79,129,43,83,41,36,6,57,34,23,2,2,34,14,20
"2021","South Gloucestershire 031C","E01014918",649,192,118,74,433,100,239,81,94,64,57,33,19,5,36,19,17,1,1,24,6,18
"2021","South Gloucestershire 031D","E01014919",538,109,77,32,407,109,207,48,114,45,47,20,24,3,40,18,22,4,4,22,7,15
"2021","South Gloucestershire 031E","E01014920",567,133,70,63,409,100,230,89,90,51,45,26,15,4,33,19,14,1,1,25,10,15
"2021","South Gloucestershire 031F","E01014921",700,182,85,97,487,83,271,104,105,62,78,44,28,6,54,30,24,1,1,31,11,20
"2021","South Gloucestershire 032A","E01014866",645,132,83,49,482,99,263,110,101,52,68,36,29,3,52,25,27,0,0,31,16,15
"2021","South Gloucestershire 032B","E01014931",717,195,111,84,491,114,240,81,108,51,87,54,29,4,47,25,22,3,3,31,11,20
"2021","South Gloucestershire 032C","E01014932",737,247,155,92,465,120,221,93,93,35,74,41,29,4,47,23,24,3,3,25,8,17
"2021","South Gloucestershire 032D","E01014933",611,195,77,118,403,71,199,72,79,48,86,52,30,4,46,26,20,1,1,13,3,10
"2021","South Gloucestershire 032E","E01014934",515,115,75,40,378,96,212,80,79,53,43,19,17,7,23,12,11,4,4,22,8,14
"2021","South Gloucestershire 032F","E01014935",646,196,99,97,419,66,217,89,81,47,77,45,28,4,56,29,27,3,3,31,5,26
"2021","South Gloucestershire 032G","E01014937",546,127,85,42,387,104,180,59,84,37,48,20,21,7,50,27,23,5,5,32,19,13
"2021","South Gloucestershire 033C","E01014946",621,153,72,81,408,48,196,49,110,37,85,32,47,6,77,41,36,2,2,60,17,43
"2021","South Gloucestershire 033B","E01014947",621,168,125,43,408,133,184,59,73,52,53,27,20,6,32,12,20,6,6,45,15,30
"2021","South Gloucestershire 033A","E01014948",783,309,111,198,433,44,160,59,75,26,96,51,40,5,125,92,33,8,8,41,18,23
"2021","South Gloucestershire 033D","E01014950",625,174,75,99,402,34,212,71,107,34,86,44,36,6,64,40,24,6,6,49,18,31
"2021","South Gloucestershire 033E","E01035222",679,175,88,87,442,69,231,77,98,56,85,46,33,6,51,28,23,6,6,62,23,39
"2021","South Gloucestershire 034B","E01014951",606,174,66,108,389,33,169,65,77,27,92,56,32,4,90,61,29,5,5,43,16,27
"2021","South Gloucestershire 034A","E01035223",629,144,57,87,452,54,222,79,94,49,112,73,36,3,60,40,20,4,4,33,11,22
"2021","South Gloucestershire 034C","E01035224",587,161,43,118,365,13,167,46,104,17,92,56,33,3,88,66,22,5,5,61,23,38
"2021","South Gloucestershire 034D","E01035225",632,127,2,125,432,4,199,57,130,12,129,80,46,3,91,66,25,9,9,73,22,51
"2021","South Gloucestershire 034E","E01035226",743,175,26,149,520,16,229,64,159,6,137,88,48,1,128,101,27,10,10,48,17,31
"2021","South Gloucestershire 035A","E01035227",594,190,31,159,356,19,148,46,84,18,102,75,25,2,76,58,18,11,11,48,15,33
"2021","South Gloucestershire 035B","E01035228",725,254,126,128,333,32,150,51,86,13,78,54,24,0,68,52,16,5,5,138,9,129
"2021","South Gloucestershire 035C","E01035229",401,98,18,80,227,10,75,17,50,8,68,48,19,1,69,60,9,5,5,76,13,63
"2021","South Gloucestershire 035D","E01035230",456,79,5,74,324,7,192,53,126,13,60,40,18,2,59,49,10,6,6,53,8,45
"2021","South Gloucestershire 035E","E01035231",481,112,14,98,223,11,133,53,66,14,55,45,10,0,18,13,5,6,6,146,10,136
"2021","South Gloucestershire 036A","E01014978",580,103,45,58,443,39,290,94,150,46,73,44,29,0,38,27,11,3,3,34,17,17
"2021","South Gloucestershire 036D","E01014996",743,216,113,103,490,114,260,93,123,44,67,45,17,5,40,27,13,9,9,37,9,28
"2021","South Gloucestershire 036B","E01035232",623,107,29,78,445,40,264,79,150,35,74,48,24,2,59,37,22,8,8,71,18,53
"2021","South Gloucestershire 036C","E01035233",711,143,51,92,512,60,257,73,153,31,111,82,26,3,81,61,20,3,3,56,16,40
"2021","Plymouth 001A","E01015025",702,143,106,37,528,143,280,125,111,44,63,35,23,5,36,15,21,6,6,31,12,19
"2021","Plymouth 001B","E01015097",1075,326,210,116,713,239,342,183,92,67,87,54,29,4,42,25,17,3,3,36,13,23
"2021","Plymouth 001C","E01015160",645,165,100,65,452,129,226,98,82,46,55,33,21,1,40,21,19,2,2,28,11,17
"2021","Plymouth 001D","E01015164",736,170,82,88,533,47,303,104,162,37,95,41,49,5,86,58,28,2,2,33,16,17
"2021","Plymouth 002A","E01015027",653,133,76,57,490,85,283,115,112,56,73,30,36,7,47,31,16,2,2,30,10,20
"2021","Plymouth 002B","E01015159",792,246,149,97,515,85,217,91,78,48,96,34,55,7,108,65,43,9,9,31,11,20
"2021","Plymouth 002C","E01015161",719,218,96,122,475,59,177,64,80,33,110,44,59,7,126,83,43,3,3,26,9,17
"2021","Plymouth 002D","E01015162",640,182,101,81,434,52,162,62,62,38,106,35,62,9,111,76,35,3,3,24,11,13
"2021","Plymouth 002E","E01015166",931,298,129,169,599,54,250,73,137,40,125,58,60,7,165,122,43,5,5,34,13,21
"2021","Plymouth 003A","E01015023",745,227,100,127,485,48,224,80,99,45,103,47,46,10,109,69,40,1,1,33,17,16
"2021","Plymouth 003B","E01015026",760,306,117,189,443,41,143,64,52,27,147,73,67,7,112,88,24,0,0,11,5,6
"2021","Plymouth 003C","E01015028",716,229,83,146,444,30,143,55,59,29,116,42,67,7,150,119,31,5,5,43,30,13
"2021","Plymouth 003D","E01015163",673,181,93,88,467,89,205,74,94,37,93,44,38,11,77,48,29,3,3,25,10,15
"2021","Plymouth 003E","E01015165",652,133,56,77,485,37,258,71,142,45,104,47,52,5,84,55,29,2,2,34,15,19
"2021","Plymouth 004A","E01015024",651,225,71,154,400,69,171,79,55,37,98,56,33,9,59,41,18,3,3,26,8,18
"2021","Plymouth 004B","E01015082",725,235,123,112,454,51,189,82,63,44,94,41,46,7,117,63,54,3,3,36,15,21
"2021","Plymouth 004C","E01015083",725,290,103,187,412,48,152,55,64,33,107,55,42,10,102,70,32,3,3,23,6,17
"2021","Plymouth 004D","E01015084",632,189,100,89,408,75,184,82,64,38,75,25,41,9,70,45,25,4,4,35,17,18
"2021","Plymouth 005A","E01015090",573,141,77,64,410,89,218,94,83,41,62,35,23,4,41,28,13,0,0,22,6,16
"2021","Plymouth 005B","E01015091",611,131,81,50,450,146,187,87,61,39,63,23,35,5,54,31,23,0,0,30,10,20
"2021","Plymouth 005C","E01015092",983,274,66,208,657,61,314,98,173,43,161,98,59,4,113,82,31,8,8,52,17,35
"2021","Plymouth 005D","E01015093",632,236,147,89,375,68,186,78,67,41,60,29,29,2,60,36,24,1,1,21,8,13
"2021","Plymouth 005E","E01015094",667,192,122,70,451,71,191,68,83,40,81,36,39,6,106,77,29,2,2,24,13,11
"2021","Plymouth 006A","E01015085",725,229,119,110,463,72,202,85,75,42,105,47,51,7,82,34,48,2,2,33,13,20
"2021","Plymouth 006B","E01015087",570,118,51,67,392,40,180,48,88,44,71,22,40,9,97,57,40,4,4,60,34,26
"2021","Plymouth 006C","E01015088",618,181,82,99,410,19,148,49,71,28,95,27,60,8,148,103,45,0,0,27,13,14
"2021","Plymouth 006D","E01015147",498,125,78,47,333,65,174,60,77,37,54,20,27,7,39,18,21,1,1,40,17,23
"2021","Plymouth 006E","E01015148",668,199,94,105,432,46,186,72,83,31,106,56,41,9,91,60,31,3,3,37,10,27
"2021","Plymouth 007A","E01015030",769,307,113,194,433,44,151,60,61,30,104,54,48,2,130,85,45,4,4,29,14,15
"2021","Plymouth 007B","E01015070",1183,346,127,219,777,74,370,129,180,61,192,98,81,13,134,83,51,7,7,60,26,34
"2021","Plymouth 007C","E01015081",681,176,90,86,479,55,206,73,93,40,98,43,48,7,113,77,36,7,7,26,14,12
"2021","Plymouth 007D","E01015086",652,225,140,85,398,61,149,71,53,25,89,38,45,6,97,53,44,2,2,29,10,19
"2021","Plymouth 007E","E01015089",804,287,146,141,490,67,180,79,75,26,130,74,51,5,108,68,40,5,5,27,11,16
"2021","Plymouth 008A","E01015029",778,173,69,104,575,57,277,94,150,33,124,65,51,8,113,73,40,4,4,30,13,17
"2021","Plymouth 008B","E01015064",718,190,139,51,501,137,265,113,102,50,50,29,15,6,46,23,23,3,3,27,11,16
"2021","Plymouth 008C","E01015065",617,229,133,96,379,71,232,89,111,32,45,27,16,2,31,16,15,0,0,9,6,3
"2021","Plymouth 008D","E01015071",700,247,139,108,421,66,211,73,101,37,75,37,35,3,64,36,28,5,5,32,16,16
"2021","Plymouth 009A","E01015076",635,194,85,109,415,46,207,97,78,32,104,52,47,5,57,31,26,1,1,26,3,23
"2021","Plymouth 009B","E01015142",648,203,92,111,414,68,189,97,49,43,87,50,32,5,63,41,22,7,7,31,11,20
"2021","Plymouth 009C","E01015143",616,204,108,96,386,75,151,62,51,38,87,46,30,11,69,34,35,4,4,26,7,19
"2021","Plymouth 009D","E01015144",643,185,64,121,421,32,180,76,73,31,95,40,47,8,110,76,34,4,4,37,16,21
"2021","Plymouth 009E","E01015146",720,155,46,109,533,28,225,74,117,34,107,40,60,7,168,119,49,5,5,32,13,19
"2021","Plymouth 009F","E01015149",618,181,86,95,406,37,150,47,65,38,74,29,37,8,137,101,36,8,8,31,14,17
"2021","Plymouth 009G","E01015150",648,216,111,105,404,77,204,92,79,33,67,34,25,8,55,30,25,1,1,28,14,14
"2021","Plymouth 010A","E01015063",671,215,70,145,431,42,175,72,68,35,103,47,46,10,110,74,36,1,1,25,6,19
"2021","Plymouth 010B","E01015068",622,128,79,49,458,84,244,72,124,48,73,36,28,9,51,34,17,6,6,36,16,20
"2021","Plymouth 010C","E01015069",655,208,97,111,423,47,176,59,71,46,109,44,57,8,85,50,35,6,6,24,7,17
"2021","Plymouth 010D","E01015095",626,187,118,69,420,102,178,71,64,43,68,35,29,4,72,43,29,0,0,19,4,15
"2021","Plymouth 010E","E01015096",605,184,114,70,389,73,155,56,60,39,64,25,30,9,95,59,36,2,2,32,18,14
"2021","Plymouth 011A","E01015074",672,234,121,113,408,59,163,54,73,36,78,34,37,7,104,58,46,4,4,30,11,19
"2021","Plymouth 011B","E01015077",1044,284,106,178,709,80,329,115,170,44,145,61,75,9,149,92,57,6,6,51,23,28
"2021","Plymouth 011C","E01015079",692,161,84,77,495,88,251,101,105,45,78,34,37,7,76,39,37,2,2,36,19,17
"2021","Plymouth 011D","E01015102",755,258,99,159,460,57,213,85,101,27,108,65,38,5,78,51,27,4,4,37,11,26
"2021","Plymouth 011E","E01015104",585,113,67,46,457,68,272,94,130,48,59,27,26,6,55,37,18,3,3,15,5,10
"2021","Plymouth 012A","E01015035",625,169,82,87,425,55,218,95,79,44,89,40,43,6,61,36,25,2,2,31,13,18
"2021","Plymouth 012B","E01015037",600,183,95,88,384,75,183,78,79,26,67,39,24,4,58,25,33,1,1,33,11,22
"2021","Plymouth 012C","E01015058",624,150,59,91,448,37,174,61,84,29,86,31,44,11,149,101,48,2,2,26,15,11
"2021","Plymouth 012D","E01015066",595,148,81,67,421,78,206,88,77,41,85,43,34,8,49,32,17,3,3,26,10,16
"2021","Plymouth 012E","E01015067",613,144,109,35,445,140,234,94,75,65,37,20,13,4,33,15,18,1,1,24,9,15
"2021","Plymouth 013A","E01015072",543,144,49,95,361,39,171,64,69,38,73,29,39,5,74,44,30,4,4,38,17,21
"2021","Plymouth 013B","E01015073",642,189,84,105,416,40,175,74,69,32,83,36,40,7,115,64,51,3,3,37,14,23
"2021","Plymouth 013C","E01015078",610,176,86,90,397,31,166,65,79,22,92,33,53,6,104,53,51,4,4,37,13,24
"2021","Plymouth 013D","E01015080",564,126,23,103,412,11,176,59,95,22,117,60,56,1,106,76,30,2,2,26,10,16
"2021","Plymouth 013E","E01015106",518,131,57,74,359,71,176,78,69,29,55,24,26,5,54,31,23,3,3,28,15,13
"2021","Plymouth 014A","E01015039",473,153,58,95,290,24,123,54,49,20,64,37,23,4,74,54,20,5,5,30,12,18
"2021","Plymouth 014B","E01015040",602,160,55,105,386,25,154,60,57,37,92,31,51,10,109,61,48,6,6,56,29,27
"2021","Plymouth 014C","E01015041",662,210,55,155,410,30,143,72,57,14,117,65,43,9,115,91,24,5,5,42,15,27
"2021","Plymouth 014D","E01015075",713,248,103,145,430,51,161,70,63,28,97,54,38,5,114,79,35,7,7,35,7,28
"2021","Plymouth 014E","E01015145",471,67,12,55,383,9,124,30,67,27,99,24,70,5,144,100,44,7,7,21,7,14
"2021","Plymouth 015A","E01015120",621,138,81,57,456,95,253,95,104,54,56,26,25,5,52,34,18,0,0,27,13,14
"2021","Plymouth 015B","E01015121",637,150,111,39,458,123,218,77,92,49,66,38,24,4,51,22,29,0,0,29,11,18
"2021","Plymouth 015C","E01015123",762,286,174,112,447,136,195,82,72,41,55,39,14,2,59,34,25,2,2,29,7,22
"2021","Plymouth 015D","E01015124",680,203,145,58,455,111,226,92,88,46,69,31,30,8,49,29,20,0,0,22,11,11
"2021","Plymouth 015E","E01015125",630,141,85,56,465,106,228,88,89,51,68,36,24,8,59,37,22,4,4,24,10,14
"2021","Plymouth 016A","E01015033",629,144,95,49,453,80,252,95,107,50,74,37,34,3,44,25,19,3,3,32,15,17
"2021","Plymouth 016B","E01015034",532,126,54,72,363,63,203,60,103,40,63,37,22,4,34,25,9,0,0,43,21,22
"2021","Plymouth 016C","E01015036",669,220,123,97,422,69,246,83,127,36,76,37,32,7,31,20,11,0,0,27,11,16
"2021","Plymouth 016D","E01015038",718,180,73,107,516,85,246,88,118,40,116,65,46,5,68,40,28,1,1,22,9,13
"2021","Plymouth 016E","E01015101",620,153,111,42,440,111,265,80,133,52,37,21,11,5,27,12,15,0,0,27,15,12
"2021","Plymouth 017A","E01015098",677,206,103,103,429,49,222,68,121,33,99,58,33,8,58,42,16,1,1,42,15,27
"2021","Plymouth 017B","E01015099",647,206,68,138,409,39,200,65,98,37,108,73,32,3,60,39,21,2,2,32,6,26
"2021","Plymouth 017C","E01015100",625,183,48,135,384,37,197,76,95,26,95,66,25,4,53,30,23,2,2,58,17,41
"2021","Plymouth 017D","E01015103",628,170,64,106,427,24,243,98,112,33,88,51,32,5,67,37,30,5,5,31,17,14
"2021","Plymouth 017E","E01015105",632,170,63,107,425,45,226,86,118,22,104,63,37,4,47,29,18,3,3,37,11,26
"2021","Plymouth 018A","E01015107",738,143,45,98,580,54,291,95,161,35,148,84,56,8,84,59,25,3,3,15,5,10
"2021","Plymouth 018B","E01015110",608,111,60,51,478,87,269,124,94,51,66,28,33,5,56,37,19,0,0,19,10,9
"2021","Plymouth 018C","E01015111",749,207,65,142,518,43,244,86,118,40,148,82,61,5,80,66,14,3,3,24,12,12
"2021","Plymouth 018D","E01015119",636,118,54,64,504,73,289,101,133,55,92,52,36,4,50,28,22,0,0,14,8,6
"2021","Plymouth 019A","E01015112",653,159,73,86,470,52,231,83,113,35,111,61,46,4,74,45,29,2,2,24,6,18
"2021","Plymouth 019B","E01015113",620,155,93,62,436,83,238,100,105,33,69,34,32,3,45,28,17,1,1,29,17,12
"2021","Plymouth 019C","E01015114",632,194,87,107,411,71,225,78,104,43,71,32,30,9,40,21,19,4,4,27,12,15
"2021","Plymouth 019D","E01015118",696,179,130,49,500,90,269,91,129,49,73,35,36,2,61,36,25,7,7,17,6,11
"2021","Plymouth 019E","E01015122",646,144,93,51,484,103,240,70,123,47,73,26,43,4,66,37,29,2,2,18,7,11
"2021","Plymouth 020A","E01015042",659,242,50,192,377,22,163,68,74,21,114,64,46,4,73,49,24,5,5,40,15,25
"2021","Plymouth 020B","E01015044",704,310,57,253,353,37,143,50,63,30,104,60,40,4,62,34,28,7,7,41,10,31
"2021","Plymouth 020C","E01015167",712,265,56,209,393,32,166,81,58,27,115,72,39,4,72,44,28,8,8,54,13,41
"2021","Plymouth 020D","E01015168",858,336,80,256,456,33,200,79,94,27,122,76,39,7,96,59,37,5,5,66,16,50
"2021","Plymouth 020E","E01015171",848,390,104,286,397,43,143,66,54,23,125,75,50,0,81,52,29,5,5,61,17,44
"2021","Plymouth 021A","E01015055",597,174,81,93,384,40,177,68,70,39,81,35,44,2,83,46,37,3,3,39,18,21
"2021","Plymouth 021B","E01015056",790,252,106,146,498,102,188,88,65,35,108,66,34,8,96,68,28,4,4,40,16,24
"2021","Plymouth 021C","E01015057",733,254,117,137,440,38,160,52,74,34,98,40,53,5,142,91,51,2,2,39,24,15
"2021","Plymouth 021D","E01015059",647,155,44,111,462,37,195,82,76,37,126,81,39,6,97,62,35,7,7,30,13,17
"2021","Plymouth 021E","E01015060",646,201,91,110,413,57,163,51,79,33,105,48,49,8,83,43,40,5,5,32,10,22
"2021","Plymouth 021F","E01015176",592,191,83,108,363,46,159,46,78,35,81,48,27,6,73,43,30,4,4,38,12,26
"2021","Plymouth 022A","E01015108",766,198,80,118,539,77,264,97,123,44,109,57,50,2,89,64,25,0,0,29,14,15
"2021","Plymouth 022B","E01015109",641,215,81,134,410,50,211,102,72,37,94,59,32,3,55,40,15,0,0,16,6,10
"2021","Plymouth 022C","E01015115",687,337,216,121,324,62,139,49,58,32,65,30,26,9,57,35,22,1,1,26,10,16
"2021","Plymouth 022D","E01015116",602,143,84,59,442,103,222,88,96,38,59,27,29,3,55,38,17,3,3,17,12,5
"2021","Plymouth 022E","E01015117",588,131,78,53,437,86,218,95,82,41,57,30,24,3,74,43,31,2,2,20,9,11
"2021","Plymouth 023A","E01015031",667,245,49,196,356,35,148,61,71,16,122,84,34,4,44,31,13,7,7,66,17,49
"2021","Plymouth 023B","E01015032",790,375,61,314,234,14,69,36,26,7,110,97,9,4,27,18,9,14,14,181,9,172
"2021","Plymouth 023C","E01015049",575,172,44,128,262,21,90,28,44,18,103,79,22,2,44,23,21,4,4,141,11,130
"2021","Plymouth 023D","E01015050",673,271,32,239,186,6,43,31,9,3,99,88,9,2,25,13,12,13,13,216,12,204
"2021","Plymouth 023E","E01015051",512,160,44,116,169,31,56,24,21,11,59,46,11,2,22,11,11,1,1,183,5,178
"2021","Plymouth 024A","E01015169",677,222,88,134,361,47,165,68,66,31,74,48,22,4,69,38,31,6,6,94,22,72
"2021","Plymouth 024B","E01015170",750,302,115,187,394,28,144,56,66,22,86,55,30,1,125,92,33,11,11,54,14,40
"2021","Plymouth 024C","E01015173",741,274,101,173,417,64,195,67,100,28,95,63,28,4,57,27,30,6,6,50,21,29
"2021","Plymouth 024D","E01015174",703,189,88,101,470,70,246,107,96,43,92,48,41,3,61,45,16,1,1,44,12,32
"2021","Plymouth 025A","E01015061",653,234,61,173,339,15,124,54,57,13,117,63,50,4,78,61,17,5,5,80,15,65
"2021","Plymouth 025B","E01015062",638,210,41,169,246,18,98,35,50,13,85,68,14,3,37,23,14,8,8,182,9,173
"2021","Plymouth 025C","E01015175",670,216,60,156,358,29,166,54,83,29,95,53,39,3,57,33,24,11,11,96,17,79
"2021","Plymouth 025D","E01015177",731,232,63,169,421,45,185,60,99,26,128,78,43,7,57,40,17,6,6,78,17,61
"2021","Plymouth 025E","E01015178",823,290,65,225,392,22,151,48,78,25,151,89,58,4,61,43,18,7,7,141,17,124
"2021","Plymouth 026A","E01015043",685,295,65,230,352,21,105,35,50,20,92,36,50,6,127,97,30,7,7,38,11,27
"2021","Plymouth 026B","E01015045",728,333,62,271,356,25,109,50,46,13,115,49,63,3,100,70,30,7,7,39,13,26
"2021","Plymouth 026C","E01015046",895,379,147,232,485,38,162,45,94,23,123,55,59,9,155,100,55,7,7,31,18,13
"2021","Plymouth 026D","E01015047",931,351,97,254,526,54,196,87,70,39,117,57,54,6,157,118,39,2,2,54,23,31
"2021","Plymouth 026E","E01015048",1107,452,84,368,591,18,245,74,138,33,158,87,64,7,161,119,42,9,9,64,18,46
"2021","Plymouth 027A","E01015053",588,269,38,231,194,4,56,25,25,6,96,76,17,3,31,15,16,7,7,125,9,116
"2021","Plymouth 027B","E01015054",557,233,63,170,138,5,42,21,17,4,64,46,17,1,24,19,5,3,3,186,11,175
"2021","Plymouth 027C","E01015152",922,424,113,311,419,20,116,40,63,13,100,49,46,5,176,129,47,7,7,79,19,60
"2021","Plymouth 027E","E01015156",834,456,102,354,314,43,92,55,28,9,116,99,16,1,57,40,17,6,6,64,5,59
"2021","Plymouth 027F","E01032657",663,326,88,238,281,56,75,51,19,5,97,81,13,3,47,31,16,6,6,56,3,53
"2021","Plymouth 027G","E01032658",863,523,138,385,272,34,79,41,34,4,97,81,15,1,51,34,17,11,11,68,8,60
"2021","Plymouth 028A","E01015052",809,319,58,261,279,14,72,37,26,9,125,105,17,3,54,41,13,14,14,211,11,200
"2021","Plymouth 028B","E01015179",689,262,52,210,288,22,103,41,48,14,111,70,38,3,50,34,16,2,2,139,23,116
"2021","Plymouth 028C","E01015180",894,424,116,308,418,23,134,49,66,19,127,76,43,8,133,108,25,1,1,52,14,38
"2021","Plymouth 028D","E01015181",1033,428,79,349,498,32,197,80,93,24,154,104,46,4,100,56,44,15,15,107,21,86
"2021","Plymouth 028E","E01015182",899,324,94,230,499,39,168,67,73,28,151,89,57,5,135,75,60,6,6,76,25,51
"2021","Plymouth 030A","E01015126",656,187,147,40,452,132,237,81,106,50,45,20,21,4,36,19,17,2,2,17,7,10
"2021","Plymouth 030B","E01015127",618,173,99,74,428,104,205,72,92,41,68,39,20,9,48,28,20,3,3,17,9,8
"2021","Plymouth 030C","E01015131",998,239,140,99,706,197,359,131,181,47,97,56,38,3,49,41,8,4,4,53,22,31
"2021","Plymouth 030D","E01015132",646,193,133,60,431,104,225,73,118,34,52,26,19,7,48,28,20,2,2,22,6,16
"2021","Plymouth 030E","E01015133",647,181,131,50,443,124,236,103,95,38,44,21,22,1,38,24,14,1,1,23,8,15
"2021","Plymouth 031B","E01015136",628,176,99,77,411,78,202,69,85,48,64,33,27,4,64,42,22,3,3,41,13,28
"2021","Plymouth 031C","E01015137",721,161,85,76,541,76,299,110,156,33,92,44,39,9,71,34,37,3,3,19,9,10
"2021","Plymouth 031D","E01015138",872,282,152,130,566,122,294,132,119,43,98,54,38,6,50,25,25,2,2,24,9,15
"2021","Plymouth 031E","E01015139",620,184,112,72,406,78,185,74,76,35,69,30,35,4,74,39,35,0,0,30,13,17
"2021","Plymouth 031F","E01015141",746,186,137,49,530,158,280,105,121,54,56,23,28,5,36,19,17,0,0,30,15,15
"2021","Plymouth 031G","E01034157",708,130,26,104,540,18,274,78,166,30,163,95,65,3,84,59,25,1,1,38,14,24
"2021","Plymouth 031H","E01034158",473,138,78,60,310,58,151,54,65,32,45,23,21,1,53,30,23,3,3,25,12,13
"2021","Plymouth 032A","E01015128",748,251,145,106,474,127,211,95,78,38,69,45,21,3,65,41,24,2,2,23,11,12
"2021","Plymouth 032B","E01015129",666,250,101,149,400,37,176,80,63,33,91,50,36,5,92,60,32,4,4,16,7,9
"2021","Plymouth 032C","E01015130",586,103,52,51,462,71,278,89,141,48,69,24,42,3,42,21,21,2,2,21,11,10
"2021","Plymouth 032D","E01015134",685,245,149,96,421,76,220,73,107,40,59,31,24,4,64,40,24,2,2,19,3,16
"2021","Plymouth 032E","E01015140",653,200,147,53,434,122,221,79,118,24,52,29,19,4,38,16,22,1,1,19,6,13
"2021","Plymouth 033A","E01015151",861,402,62,340,316,18,105,37,52,16,89,52,36,1,91,51,40,13,13,143,19,124
"2021","Plymouth 033C","E01015153",986,534,138,396,393,31,132,63,52,17,99,70,25,4,122,88,34,9,9,59,20,39
"2021","Plymouth 033B","E01015172",839,362,89,273,409,32,185,67,94,24,118,82,31,5,70,46,24,4,4,68,11,57
"2021","Plymouth 034A","E01015155",960,496,113,383,417,10,143,57,74,12,105,53,47,5,149,106,43,10,10,47,15,32
"2021","Plymouth 034B","E01034159",648,349,59,290,258,19,97,48,36,13,69,55,13,1,65,43,22,8,8,41,8,33
"2021","Plymouth 034C","E01034160",876,472,172,300,363,70,103,69,24,10,139,123,14,2,40,20,20,11,11,41,5,36
"2021","Plymouth 034D","E01034161",744,420,132,288,270,52,83,56,20,7,95,83,12,0,33,22,11,7,7,54,3,51
"2021","Plymouth 034E","E01034162",599,348,115,233,226,35,81,45,26,10,61,49,11,1,46,29,17,3,3,25,8,17
"2021","Torbay 001A","E01015262",526,120,81,39,357,39,169,58,70,41,69,26,37,6,75,44,31,5,5,49,19,30
"2021","Torbay 001B","E01015263",634,178,70,108,412,23,133,38,62,33,89,24,54,11,161,116,45,6,6,44,19,25
"2021","Torbay 001C","E01015264",624,185,136,49,416,118,184,96,57,31,67,32,30,5,43,23,20,4,4,23,11,12
"2021","Torbay 001D","E01015265",638,198,137,61,404,113,164,89,39,36,58,33,25,0,64,36,28,5,5,36,16,20
"2021","Torbay 001E","E01015266",623,194,104,90,401,31,171,50,83,38,78,31,39,8,115,71,44,6,6,28,13,15
"2021","Torbay 002A","E01015236",693,224,112,112,437,112,202,95,65,42,54,33,19,2,66,37,29,3,3,32,11,21
"2021","Torbay 002B","E01015237",526,116,61,55,368,56,180,62,80,38,69,24,39,6,58,29,29,5,5,42,17,25
"2021","Torbay 002C","E01015238",626,227,104,123,357,74,141,61,64,16,72,35,34,3,67,36,31,3,3,42,15,27
"2021","Torbay 002D","E01015239",870,478,287,191,354,87,142,61,54,27,54,37,14,3,62,36,26,9,9,38,16,22
"2021","Torbay 003A","E01015249",620,199,106,93,389,61,198,57,113,28,61,25,31,5,68,37,31,1,1,32,16,16
"2021","Torbay 003B","E01015250",645,172,88,84,443,61,200,66,93,41,108,57,49,2,74,50,24,0,0,30,16,14
"2021","Torbay 003C","E01015251",481,95,58,37,352,62,206,66,94,46,37,19,17,1,42,26,16,5,5,34,4,30
"2021","Torbay 003E","E01015253",802,147,46,101,619,69,294,118,147,29,138,69,61,8,116,82,34,2,2,36,15,21
"2021","Torbay 003F","E01015254",620,153,96,57,432,120,206,90,80,36,58,30,23,5,44,27,17,4,4,35,11,24
"2021","Torbay 003G","E01034169",623,142,61,81,446,51,195,61,110,24,103,51,45,7,97,66,31,0,0,35,18,17
"2021","Torbay 003H","E01034170",613,195,68,127,392,45,173,68,86,19,101,53,44,4,72,49,23,1,1,26,10,16
"2021","Torbay 004A","E01015257",626,208,81,127,378,31,146,48,61,37,73,26,34,13,121,83,38,7,7,40,20,20
"2021","Torbay 004B","E01015258",937,330,120,210,545,97,218,89,92,37,85,45,36,4,140,91,49,5,5,62,28,34
"2021","Torbay 004C","E01015259",655,183,64,119,427,30,186,56,93,37,93,42,44,7,114,78,36,4,4,45,17,28
"2021","Torbay 004D","E01015260",847,397,114,283,377,43,142,67,56,19,99,67,25,7,92,64,28,1,1,73,23,50
"2021","Torbay 005A","E01015240",812,439,278,161,328,95,118,59,35,24,56,41,14,1,56,36,20,3,3,45,20,25
"2021","Torbay 005B","E01015241",694,259,157,102,384,62,160,47,71,42,81,41,32,8,75,44,31,6,6,51,20,31
"2021","Torbay 005C","E01015242",527,143,64,79,341,34,131,34,69,28,69,26,35,8,102,77,25,5,5,43,24,19
"2021","Torbay 005D","E01015243",587,167,116,51,385,94,162,79,55,28,68,34,24,10,57,31,26,4,4,35,10,25
"2021","Torbay 006A","E01015214",691,268,72,196,362,18,147,54,69,24,82,47,30,5,109,73,36,6,6,61,24,37
"2021","Torbay 006B","E01015215",619,180,94,86,406,44,187,60,78,49,84,39,40,5,89,59,30,2,2,33,10,23
"2021","Torbay 006C","E01015216",666,225,78,147,398,33,138,59,57,22,103,55,38,10,116,80,36,8,8,43,16,27
"2021","Torbay 006D","E01015218",617,203,86,117,355,48,155,53,74,28,78,41,36,1,72,44,28,2,2,59,31,28
"2021","Torbay 008A","E01015217",860,425,119,306,390,39,135,63,44,28,108,66,35,7,102,74,28,6,6,45,18,27
"2021","Torbay 008B","E01015255",962,529,107,422,367,21,123,63,36,24,126,94,27,5,88,61,27,9,9,66,18,48
"2021","Torbay 008C","E01015256",1112,606,192,414,429,72,124,72,40,12,131,87,40,4,87,60,27,15,15,77,19,58
"2021","Torbay 008D","E01015261",1023,446,163,283,476,58,191,92,78,21,110,65,39,6,106,78,28,11,11,101,44,57
"2021","Torbay 010A","E01015267",907,478,183,295,396,103,173,115,37,21,72,48,21,3,45,29,16,3,3,33,6,27
"2021","Torbay 010B","E01015268",930,429,239,190,464,137,171,105,40,26,104,82,22,0,46,25,21,6,6,37,3,34
"2021","Torbay 010C","E01015269",836,419,212,207,394,110,177,103,45,29,56,42,10,4,46,24,22,5,5,23,5,18
"2021","Torbay 010D","E01015270",927,451,206,245,447,141,159,107,34,18,92,65,25,2,50,26,24,5,5,29,7,22
"2021","Torbay 010E","E01015271",738,239,178,61,462,182,214,115,55,44,31,18,11,2,30,18,12,5,5,37,8,29
"2021","Torbay 011A","E01015224",682,177,95,82,453,86,197,74,79,44,80,41,32,7,87,51,36,3,3,52,17,35
"2021","Torbay 011B","E01015225",604,172,109,63,385,79,198,63,91,44,47,21,23,3,56,34,22,5,5,47,29,18
"2021","Torbay 011C","E01015226",614,158,105,53,421,124,211,90,82,39,55,35,20,0,29,13,16,2,2,35,15,20
"2021","Torbay 011D","E01015227",634,142,95,47,450,97,249,94,99,56,64,35,26,3,36,17,19,4,4,42,17,25
"2021","Torbay 011E","E01015228",765,347,221,126,365,69,135,65,50,20,75,42,29,4,83,58,25,3,3,53,16,37
"2021","Torbay 011F","E01015230",632,171,124,47,438,160,195,70,77,48,51,26,21,4,32,7,25,0,0,23,7,16
"2021","Torbay 012A","E01015202",595,132,82,50,429,70,233,84,111,38,65,32,29,4,57,33,24,4,4,34,17,17
"2021","Torbay 012B","E01015203",533,119,82,37,389,103,203,93,72,38,46,25,17,4,36,17,19,1,1,25,11,14
"2021","Torbay 012C","E01015204",656,201,86,115,422,61,180,68,86,26,100,45,49,6,76,44,32,5,5,33,14,19
"2021","Torbay 012D","E01015205",641,178,102,76,421,82,180,76,62,42,90,34,52,4,66,37,29,3,3,42,18,24
"2021","Torbay 012E","E01015206",642,197,81,116,395,59,170,68,75,27,84,40,40,4,81,47,34,1,1,50,16,34
"2021","Torbay 013A","E01015190",839,242,111,131,532,109,252,115,94,43,84,32,51,1,81,48,33,6,6,65,33,32
"2021","Torbay 013B","E01015191",679,178,84,94,466,62,211,72,93,46,117,62,48,7,75,43,32,1,1,35,14,21
"2021","Torbay 013C","E01015192",612,134,69,65,446,62,207,69,97,41,73,31,38,4,101,59,42,3,3,32,18,14
"2021","Torbay 013D","E01015193",571,149,83,66,384,77,168,60,65,43,71,33,32,6,67,36,31,1,1,38,19,19
"2021","Torbay 013E","E01015194",608,194,101,93,386,80,154,63,56,35,80,29,42,9,71,35,36,1,1,28,23,5
"2021","Torbay 013G","E01015196",667,166,69,97,438,24,143,45,67,31,103,31,66,6,160,118,42,8,8,63,31,32
"2021","Torbay 013H","E01034171",500,167,85,82,297,50,131,47,60,24,55,23,27,5,58,33,25,3,3,36,12,24
"2021","Torbay 013I","E01034172",715,123,36,87,541,40,283,75,167,41,127,54,69,4,91,74,17,0,0,51,30,21
"2021","Torbay 014A","E01015229",689,318,194,124,315,94,129,55,42,32,38,28,9,1,53,24,29,1,1,56,23,33
"2021","Torbay 014B","E01015231",957,506,143,363,386,41,109,44,39,26,104,63,35,6,122,88,34,10,10,65,22,43
"2021","Torbay 014C","E01015232",1047,530,235,295,440,92,168,94,47,27,98,69,26,3,71,35,36,11,11,77,19,58
"2021","Torbay 014D","E01015233",785,404,150,254,333,44,126,48,45,33,83,53,24,6,73,47,26,7,7,48,10,38
"2021","Torbay 014E","E01015234",593,210,90,120,348,32,142,57,62,23,90,42,40,8,80,49,31,4,4,35,16,19
"2021","Torbay 014F","E01015235",942,481,263,218,397,150,138,77,25,36,63,43,16,4,42,23,19,4,4,64,15,49
"2021","Torbay 015A","E01015219",709,340,220,120,324,86,142,78,40,24,50,19,27,4,44,29,15,2,2,45,13,32
"2021","Torbay 015B","E01015220",633,165,96,69,438,121,203,92,71,40,70,34,30,6,42,16,26,2,2,30,13,17
"2021","Torbay 015C","E01015221",708,253,164,89,409,79,194,97,64,33,72,40,25,7,62,36,26,2,2,46,17,29
"2021","Torbay 015D","E01015222",738,222,147,75,475,131,214,104,74,36,64,34,28,2,65,42,23,1,1,41,14,27
"2021","Torbay 015E","E01015223",510,101,61,40,388,62,210,88,79,43,66,30,28,8,48,32,16,2,2,21,8,13
"2021","Torbay 016A","E01015197",629,165,130,35,431,175,194,87,66,41,27,12,13,2,35,16,19,0,0,33,13,20
"2021","Torbay 016B","E01015198",741,216,170,46,498,170,225,110,72,43,46,28,13,5,53,27,26,4,4,27,10,17
"2021","Torbay 016C","E01015199",625,160,133,27,434,186,210,113,59,38,24,17,7,0,12,3,9,2,2,31,4,27
"2021","Torbay 016D","E01015200",450,121,82,39,307,77,143,45,65,33,52,25,20,7,33,21,12,2,2,22,4,18
"2021","Torbay 016E","E01015201",589,174,120,54,393,117,166,100,43,23,64,36,21,7,44,20,24,2,2,22,7,15
"2021","Torbay 017A","E01015183",602,188,122,66,380,94,196,88,66,42,42,19,20,3,45,21,24,3,3,34,15,19
"2021","Torbay 017B","E01015184",618,187,139,48,408,176,166,92,38,36,34,18,11,5,28,8,20,4,4,23,6,17
"2021","Torbay 017C","E01015185",700,318,184,134,361,95,153,73,51,29,67,40,24,3,46,33,13,0,0,21,7,14
"2021","Torbay 017D","E01015186",679,291,126,165,359,51,141,86,37,18,75,50,21,4,88,57,31,4,4,29,11,18
"2021","Torbay 017E","E01015187",839,278,178,100,524,165,238,138,66,34,63,42,19,2,56,28,28,2,2,37,14,23
"2021","Torbay 017F","E01015188",689,218,148,70,438,137,167,78,52,37,60,29,26,5,72,47,25,2,2,33,12,21
"2021","Torbay 017G","E01015189",517,197,90,107,289,70,120,64,29,27,50,29,18,3,48,25,23,1,1,31,11,20
"2021","Torbay 018A","E01015244",640,176,116,60,435,103,213,117,58,38,68,37,24,7,51,30,21,0,0,29,11,18
"2021","Torbay 018B","E01015245",585,174,112,62,377,114,160,78,48,34,44,25,16,3,58,25,33,1,1,34,11,23
"2021","Torbay 018C","E01015246",607,184,112,72,394,106,206,96,76,34,45,24,17,4,34,19,15,3,3,29,11,18
"2021","Torbay 018D","E01015247",789,218,130,88,536,119,247,111,93,43,88,43,37,8,82,43,39,0,0,35,15,20
"2021","Torbay 018E","E01015248",673,247,138,109,388,47,171,75,53,43,70,31,31,8,99,63,36,1,1,38,12,26
"2021","Torbay 019E","E01015207",657,186,86,100,427,71,211,82,93,36,71,37,31,3,73,42,31,1,1,44,14,30
"2021","Torbay 019F","E01015208",901,266,196,70,581,230,257,114,82,61,62,40,17,5,32,16,16,0,0,54,25,29
"2021","Torbay 019A","E01015209",725,324,118,206,345,75,147,61,53,33,61,35,24,2,60,43,17,2,2,56,18,38
"2021","Torbay 019B","E01015210",688,193,86,107,441,40,168,49,88,31,92,36,49,7,137,102,35,4,4,54,24,30
"2021","Torbay 019G","E01015211",600,144,88,56,433,83,218,62,119,37,67,30,32,5,64,39,25,1,1,23,11,12
"2021","Torbay 019C","E01015212",631,201,84,117,391,37,177,66,86,25,86,40,37,9,89,59,30,2,2,39,12,27
"2021","Torbay 019D","E01015213",577,115,65,50,416,56,200,73,95,32,88,34,50,4,68,48,20,4,4,46,22,24
"2021","Swindon 001A","E01015519",696,274,170,104,406,83,177,62,80,35,65,29,30,6,79,47,32,2,2,16,8,8
"2021","Swindon 001B","E01015520",579,205,105,100,344,97,150,54,68,28,53,35,16,2,40,16,24,4,4,30,13,17
"2021","Swindon 001C","E01015521",665,142,76,66,502,114,278,99,127,52,64,37,21,6,45,25,20,1,1,21,7,14
"2021","Swindon 001D","E01015522",627,181,101,80,434,80,205,96,70,39,86,51,29,6,61,33,28,2,2,12,7,5
"2021","Swindon 001E","E01015523",710,198,136,62,481,120,261,100,105,56,53,33,13,7,45,23,22,2,2,31,10,21
"2021","Swindon 001F","E01015524",470,132,61,71,322,52,155,56,55,44,62,29,26,7,49,33,16,4,4,16,3,13
"2021","Swindon 003A","E01015543",675,198,104,94,447,69,196,86,71,39,82,38,40,4,96,66,30,4,4,30,15,15
"2021","Swindon 003B","E01015544",745,247,107,140,457,29,153,48,73,32,104,29,66,9,162,114,48,9,9,41,20,21
"2021","Swindon 003C","E01015545",684,203,73,130,451,20,139,33,79,27,95,21,68,6,186,150,36,11,11,30,19,11
"2021","Swindon 003D","E01015546",717,177,74,103,501,24,166,53,87,26,113,22,80,11,196,159,37,2,2,39,25,14
"2021","Swindon 004A","E01015513",663,220,53,167,418,35,231,97,101,33,102,65,34,3,47,27,20,3,3,25,10,15
"2021","Swindon 004B","E01015514",522,132,102,30,371,124,184,66,73,45,31,17,11,3,31,13,18,1,1,19,11,8
"2021","Swindon 004C","E01015515",587,128,57,71,443,87,252,81,120,51,80,46,28,6,22,16,6,2,2,16,6,10
"2021","Swindon 004D","E01015516",615,242,127,115,343,94,144,61,47,36,54,35,16,3,48,25,23,3,3,30,10,20
"2021","Swindon 004E","E01015517",662,217,146,71,422,136,196,94,63,39,47,27,18,2,43,12,31,0,0,23,10,13
"2021","Swindon 005A","E01015555",688,239,131,108,417,102,194,74,70,50,55,30,19,6,62,34,28,4,4,32,11,21
"2021","Swindon 005B","E01015556",673,182,79,103,470,89,238,95,94,49,90,53,30,7,52,30,22,1,1,21,7,14
"2021","Swindon 005C","E01015557",805,246,105,141,521,86,262,108,109,45,104,64,37,3,66,33,33,3,3,38,14,24
"2021","Swindon 005D","E01015558",629,204,135,69,391,57,150,50,71,29,71,29,35,7,113,71,42,0,0,34,20,14
"2021","Swindon 005E","E01015559",645,189,109,80,425,84,233,88,91,54,63,36,23,4,39,23,16,6,6,31,11,20
"2021","Swindon 005F","E01015560",836,196,85,111,577,67,321,121,135,65,125,67,57,1,57,31,26,7,7,63,25,38
"2021","Swindon 006A","E01015526",603,131,33,98,440,49,216,69,100,47,122,72,44,6,49,30,19,4,4,32,15,17
"2021","Swindon 006B","E01015528",910,322,144,178,531,36,240,79,117,44,96,38,49,9,151,102,49,8,8,57,34,23
"2021","Swindon 006C","E01015529",684,206,122,84,440,86,208,76,92,40,85,36,36,13,55,30,25,6,6,38,9,29
"2021","Swindon 006D","E01015530",820,261,133,128,496,61,269,89,141,39,83,33,44,6,77,52,25,6,6,63,34,29
"2021","Swindon 007A","E01015506",634,205,86,119,382,44,186,62,79,45,64,24,29,11,79,46,33,9,9,47,20,27
"2021","Swindon 007B","E01015507",627,170,73,97,401,25,145,48,75,22,77,27,40,10,150,107,43,4,4,56,26,30
"2021","Swindon 007C","E01015527",659,171,92,79,449,75,211,54,108,49,75,27,40,8,85,47,38,3,3,39,21,18
"2021","Swindon 007D","E01015580",636,133,78,55,451,61,221,68,97,56,80,32,42,6,83,51,32,6,6,52,23,29
"2021","Swindon 008A","E01015473",765,156,87,69,555,114,300,124,126,50,89,57,27,5,51,28,23,1,1,54,21,33
"2021","Swindon 008C","E01015547",701,118,52,66,553,79,341,127,155,59,86,55,27,4,46,19,27,1,1,30,12,18
"2021","Swindon 008D","E01015548",643,140,69,71,472,75,302,126,120,56,54,32,19,3,40,20,20,1,1,31,9,22
"2021","Swindon 008E","E01033840",590,125,7,118,436,8,247,54,184,9,114,64,50,0,62,51,11,5,5,29,17,12
"2021","Swindon 008F","E01033841",569,115,20,95,426,19,201,55,134,12,134,72,59,3,66,55,11,6,6,28,16,12
"2021","Swindon 008G","E01033842",556,59,5,54,470,6,259,68,181,10,144,81,58,5,59,51,8,2,2,27,16,11
"2021","Swindon 008H","E01033843",556,125,75,50,397,81,234,99,86,49,55,27,22,6,25,13,12,2,2,34,16,18
"2021","Swindon 008I","E01033844",573,85,8,77,461,14,259,66,167,26,128,61,62,5,60,57,3,0,0,27,14,13
"2021","Swindon 009A","E01015549",687,177,92,85,462,82,248,87,100,61,73,35,28,10,57,28,29,2,2,48,17,31
"2021","Swindon 009B","E01015550",864,278,124,154,544,130,274,110,120,44,86,55,26,5,45,20,25,9,9,42,15,27
"2021","Swindon 009C","E01015551",701,179,90,89,495,114,252,93,107,52,79,45,26,8,49,22,27,1,1,27,12,15
"2021","Swindon 009D","E01015552",916,272,121,151,601,61,337,110,151,76,94,50,39,5,103,67,36,6,6,43,17,26
"2021","Swindon 009E","E01015553",673,211,71,140,440,54,243,107,90,46,90,53,32,5,52,40,12,1,1,22,8,14
"2021","Swindon 009F","E01015554",609,207,126,81,379,96,202,66,94,42,50,24,20,6,31,15,16,0,0,23,13,10
"2021","Swindon 010A","E01015508",630,223,95,128,357,34,190,69,75,46,57,25,29,3,75,44,31,1,1,50,22,28
"2021","Swindon 010B","E01015509",701,192,62,130,439,37,220,62,125,33,107,63,38,6,68,37,31,7,7,70,32,38
"2021","Swindon 010C","E01015510",855,294,107,187,436,39,228,70,114,44,79,43,32,4,79,48,31,11,11,125,57,68
"2021","Swindon 010D","E01015511",694,204,73,131,378,36,205,66,101,38,72,31,34,7,60,32,28,5,5,112,66,46
"2021","Swindon 011A","E01015562",602,133,32,101,439,26,256,85,122,49,85,50,34,1,70,38,32,2,2,30,12,18
"2021","Swindon 011B","E01015563",600,146,36,110,430,56,283,94,134,55,57,36,17,4,31,17,14,3,3,24,9,15
"2021","Swindon 011C","E01015565",634,193,73,120,415,39,236,91,98,47,86,39,40,7,49,33,16,5,5,26,14,12
"2021","Swindon 011D","E01015566",680,185,47,138,471,41,262,102,119,41,101,68,30,3,60,46,14,7,7,24,9,15
"2021","Swindon 012B","E01015578",1034,433,99,334,532,46,244,101,106,37,155,113,31,11,73,53,20,14,14,69,32,37
"2021","Swindon 012C","E01015579",696,206,72,134,447,47,218,68,114,36,112,58,48,6,61,40,21,9,9,43,16,27
"2021","Swindon 012D","E01015581",650,154,69,85,452,76,249,72,112,65,76,33,33,10,47,33,14,4,4,44,19,25
"2021","Swindon 012E","E01015582",871,248,83,165,550,54,319,83,186,50,103,62,40,1,73,42,31,1,1,73,43,30
"2021","Swindon 012F","E01032708",730,219,22,197,430,9,212,78,106,28,125,78,43,4,67,47,20,17,17,81,35,46
"2021","Swindon 012G","E01032716",669,214,46,168,400,22,195,60,106,29,107,56,43,8,65,42,23,11,11,55,20,35
"2021","Swindon 013A","E01015481",755,237,121,116,479,73,227,72,111,44,100,49,42,9,77,45,32,2,2,39,21,18
"2021","Swindon 013B","E01015482",512,112,73,39,369,73,207,84,71,52,45,27,14,4,43,15,28,1,1,31,10,21
"2021","Swindon 013C","E01015483",636,203,138,65,428,125,218,102,73,43,49,24,21,4,36,21,15,0,0,5,3,2
"2021","Swindon 013D","E01015484",628,179,114,65,408,108,207,95,70,42,54,28,21,5,36,14,22,3,3,41,21,20
"2021","Swindon 013E","E01015485",657,226,80,146,408,50,200,87,80,33,102,70,27,5,51,34,17,5,5,23,9,14
"2021","Swindon 013F","E01015486",618,174,94,80,420,106,187,84,61,42,76,35,31,10,51,29,22,0,0,24,7,17
"2021","Swindon 014A","E01015561",712,236,47,189,439,55,247,92,113,42,86,45,38,3,46,29,17,5,5,37,17,20
"2021","Swindon 014B","E01015564",621,136,53,83,457,66,280,105,125,50,70,47,19,4,38,23,15,3,3,28,14,14
"2021","Swindon 014C","E01015567",724,230,53,177,464,47,236,93,113,30,91,58,30,3,87,59,28,3,3,30,10,20
"2021","Swindon 014D","E01015568",779,264,63,201,472,49,255,94,109,52,106,70,32,4,56,41,15,6,6,43,15,28
"2021","Swindon 015A","E01015475",716,183,68,115,308,19,213,32,128,53,20,12,7,1,44,13,31,12,12,225,151,74
"2021","Swindon 015C","E01015477",728,252,87,165,372,22,166,46,91,29,94,50,40,4,78,49,29,12,12,104,42,62
"2021","Swindon 015D","E01015480",783,124,30,94,341,13,256,50,149,57,18,10,7,1,42,18,24,12,12,318,224,94
"2021","Swindon 015E","E01033845",768,308,20,288,385,5,254,76,165,13,65,52,12,1,47,35,12,14,14,75,48,27
"2021","Swindon 015F","E01033846",740,319,64,255,346,12,178,58,101,19,70,47,18,5,80,56,24,6,6,75,24,51
"2021","Swindon 016A","E01015538",836,296,122,174,476,34,195,50,104,41,80,32,39,9,162,126,36,5,5,64,22,42
"2021","Swindon 016B","E01015572",513,134,46,88,338,19,146,38,80,28,65,26,37,2,103,66,37,5,5,41,24,17
"2021","Swindon 016C","E01015573",935,343,135,208,528,24,232,48,135,49,91,30,53,8,172,113,59,9,9,64,39,25
"2021","Swindon 016D","E01015575",502,128,49,79,329,23,139,37,73,29,51,22,24,5,110,77,33,6,6,45,19,26
"2021","Swindon 017A","E01015479",874,224,54,170,556,50,333,91,176,66,94,65,28,1,71,44,27,8,8,94,68,26
"2021","Swindon 017B","E01015493",735,172,67,105,429,38,274,63,156,55,61,33,24,4,47,26,21,9,9,134,83,51
"2021","Swindon 017C","E01015574",628,146,79,67,443,58,250,86,117,47,77,37,33,7,52,30,22,6,6,39,20,19
"2021","Swindon 017D","E01015576",676,202,122,80,429,93,230,87,107,36,54,24,28,2,47,18,29,5,5,45,23,22
"2021","Swindon 018A","E01015499",531,84,30,54,415,51,270,102,114,54,47,28,19,0,46,23,23,1,1,32,17,15
"2021","Swindon 018B","E01015500",649,197,72,125,428,37,222,90,84,48,102,62,34,6,66,38,28,1,1,24,10,14
"2021","Swindon 018C","E01015504",514,100,38,62,396,33,250,101,104,45,60,28,30,2,52,26,26,1,1,18,4,14
"2021","Swindon 018D","E01015505",670,219,42,177,425,28,204,85,97,22,99,53,43,3,89,56,33,5,5,26,13,13
"2021","Swindon 019A","E01015494",909,306,52,254,461,18,234,76,136,22,127,92,34,1,69,40,29,13,13,142,54,88
"2021","Swindon 019C","E01015496",830,297,53,244,418,27,171,49,96,26,134,104,27,3,70,48,22,16,16,115,48,67
"2021","Swindon 019D","E01015497",705,260,55,205,370,24,155,48,91,16,108,68,32,8,75,53,22,8,8,75,16,59
"2021","Swindon 019E","E01032714",822,298,50,248,445,14,283,98,166,19,94,74,19,1,36,20,16,18,18,79,26,53
"2021","Swindon 019F","E01032715",641,300,78,222,304,13,131,71,54,6,104,86,17,1,45,32,13,11,11,37,7,30
"2021","Swindon 020A","E01015537",675,160,62,98,454,34,200,55,105,40,79,26,46,7,136,91,45,5,5,61,28,33
"2021","Swindon 020B","E01015539",608,135,73,62,412,49,187,57,93,37,68,20,38,10,98,62,36,10,10,61,30,31
"2021","Swindon 020C","E01015540",701,159,69,90,480,37,204,69,92,43,71,33,33,5,159,112,47,9,9,62,32,30
"2021","Swindon 020D","E01015541",738,231,100,131,447,47,189,59,87,43,70,21,42,7,133,94,39,8,8,60,33,27
"2021","Swindon 020E","E01015542",542,145,81,64,356,31,158,50,79,29,53,17,25,11,110,75,35,4,4,41,28,13
"2021","Swindon 021A","E01015478",689,231,84,147,404,37,223,75,107,41,81,45,34,2,57,28,29,6,6,54,26,28
"2021","Swindon 021B","E01015498",761,216,50,166,497,52,261,106,121,34,107,79,26,2,69,38,31,8,8,48,14,34
"2021","Swindon 021D","E01015532",664,207,68,139,409,40,235,75,127,33,89,60,27,2,39,21,18,6,6,48,17,31
"2021","Swindon 021E","E01032706",697,244,21,223,402,10,187,59,114,14,112,83,28,1,74,52,22,19,19,51,15,36
"2021","Swindon 021F","E01032707",789,176,84,92,571,95,364,119,205,40,72,33,35,4,36,19,17,4,4,42,22,20
"2021","Swindon 022A","E01015501",517,88,38,50,396,63,227,83,89,55,63,34,22,7,43,19,24,0,0,33,24,9
"2021","Swindon 022B","E01015502",616,173,78,95,403,38,198,69,107,22,83,34,45,4,79,57,22,5,5,40,19,21
"2021","Swindon 022C","E01015503",603,240,118,122,329,35,155,57,71,27,56,30,23,3,77,47,30,6,6,34,18,16
"2021","Swindon 022D","E01015569",629,180,69,111,409,58,186,74,80,32,72,31,35,6,92,63,29,1,1,40,18,22
"2021","Swindon 022E","E01015570",730,353,132,221,343,29,156,51,72,33,65,32,28,5,87,60,27,6,6,34,15,19
"2021","Swindon 022F","E01015571",652,179,104,75,430,81,224,93,88,43,55,28,24,3,68,34,34,2,2,43,18,25
"2021","Swindon 023A","E01015487",597,118,74,44,439,98,256,116,69,71,51,25,20,6,34,15,19,0,0,40,23,17
"2021","Swindon 023B","E01015488",653,270,131,139,358,49,177,58,76,43,63,32,28,3,65,38,27,4,4,25,12,13
"2021","Swindon 023C","E01015489",550,110,62,48,383,101,179,70,72,37,65,29,29,7,36,20,16,2,2,57,36,21
"2021","Swindon 023D","E01015490",538,147,60,87,364,54,183,75,76,32,74,33,39,2,52,28,24,1,1,27,14,13
"2021","Swindon 023E","E01015491",694,288,137,151,383,60,158,65,63,30,60,27,27,6,96,59,37,9,9,23,10,13
"2021","Swindon 023F","E01015492",526,120,56,64,361,40,149,47,67,35,71,25,40,6,98,61,37,3,3,45,16,29
"2021","Swindon 024A","E01015533",671,189,131,58,450,120,244,111,93,40,53,33,19,1,30,13,17,3,3,32,13,19
"2021","Swindon 024B","E01015534",1124,526,238,288,542,85,270,104,132,34,112,80,30,2,65,42,23,10,10,56,20,36
"2021","Swindon 024C","E01015535",877,240,88,152,594,97,301,109,142,50,114,76,36,2,78,57,21,4,4,43,20,23
"2021","Swindon 024E","E01033847",677,141,97,44,509,124,275,93,126,56,67,44,20,3,43,25,18,0,0,27,10,17
"2021","Swindon 024F","E01033848",765,191,15,176,528,9,300,67,206,27,108,67,39,2,102,82,20,9,9,46,20,26
"2021","Swindon 025B","E01015584",648,176,127,49,449,146,181,74,67,40,62,32,26,4,58,33,25,2,2,23,9,14
"2021","Swindon 025C","E01015585",829,218,107,111,578,100,302,98,151,53,96,62,28,6,74,47,27,6,6,33,12,21
"2021","Swindon 025D","E01015586",624,179,135,44,427,145,192,76,76,40,53,24,23,6,37,14,23,0,0,18,8,10
"2021","Swindon 025E","E01015587",857,329,204,125,486,97,238,84,106,48,75,42,27,6,71,44,27,5,5,42,17,25
"2021","Swindon 025F","E01015588",735,172,97,75,528,117,279,102,114,63,61,35,19,7,71,39,32,0,0,35,11,24
"2021","Swindon 025G","E01033849",799,135,17,118,608,18,349,97,217,35,163,92,67,4,76,61,15,2,2,56,28,28
"2021","Swindon 025H","E01033850",819,151,56,95,631,81,370,112,191,67,93,41,43,9,84,49,35,3,3,37,18,19
"2021","Swindon 026A","E01015525",673,183,45,138,473,60,262,99,116,47,109,59,45,5,42,27,15,0,0,17,6,11
"2021","Swindon 026B","E01032700",586,101,21,80,458,21,291,47,214,30,98,49,45,4,45,37,8,3,3,27,17,10
"2021","Swindon 026C","E01032703",580,89,21,68,468,28,257,57,180,20,92,44,44,4,89,70,19,2,2,23,11,12
"2021","Swindon 026D","E01032705",579,152,19,133,397,13,216,43,148,25,99,47,46,6,69,55,14,0,0,30,16,14
"2021","Swindon 026E","E01032709",549,136,19,117,379,19,194,57,118,19,82,45,34,3,82,61,21,2,2,34,18,16
"2021","Swindon 026F","E01032713",690,91,16,75,543,12,357,81,231,45,96,45,46,5,76,55,21,2,2,56,29,27
"2021","Swindon 027A","E01032701",524,157,19,138,336,12,180,46,113,21,95,62,31,2,42,31,11,7,7,31,13,18
"2021","Swindon 027B","E01032702",562,142,42,100,396,34,230,59,150,21,72,38,31,3,57,42,15,3,3,24,11,13
"2021","Swindon 027C","E01032704",720,177,19,158,505,7,255,64,166,25,119,63,50,6,120,102,18,4,4,38,20,18
"2021","Swindon 027D","E01032711",665,200,9,191,429,11,203,56,134,13,128,81,42,5,81,59,22,6,6,36,19,17
"2021","Swindon 027E","E01032712",944,262,30,232,621,19,305,67,210,28,163,83,77,3,123,104,19,11,11,61,27,34
"2021","Swindon 028A","E01015471",861,195,64,131,623,80,364,116,206,42,115,67,46,2,61,45,16,3,3,43,20,23
"2021","Swindon 028C","E01015512",608,106,28,78,471,51,300,88,168,44,74,44,29,1,44,28,16,2,2,31,18,13
"2021","Swindon 028D","E01015518",532,68,17,51,438,42,274,79,151,44,71,39,30,2,49,36,13,2,2,26,18,8
"2021","Swindon 028E","E01032710",550,117,40,77,406,42,227,66,131,30,88,58,25,5,45,29,16,4,4,27,10,17
"2021","Swindon 028F","E01033860",706,167,33,134,496,30,249,75,134,40,118,58,51,9,98,71,27,1,1,43,23,20
"2021","Swindon 028G","E01033861",677,128,21,107,511,27,329,94,193,42,115,64,47,4,38,22,16,2,2,38,17,21
"2021","Cornwall 010A","E01018753",774,188,114,74,547,138,291,142,94,55,70,47,17,6,42,19,23,6,6,39,18,21
"2021","Cornwall 010B","E01018754",837,253,134,119,538,93,237,105,101,31,103,61,40,2,98,66,32,7,7,46,19,27
"2021","Cornwall 010C","E01018755",683,195,104,91,454,115,232,129,55,48,60,39,16,5,46,17,29,1,1,34,14,20
"2021","Cornwall 010D","E01018756",743,235,134,101,471,129,222,122,57,43,63,34,23,6,55,23,32,2,2,37,13,24
"2021","Cornwall 012A","E01018777",890,225,126,99,614,145,312,155,92,65,99,53,40,6,53,27,26,5,5,51,16,35
"2021","Cornwall 012B","E01018782",651,173,98,75,448,91,216,96,71,49,76,39,33,4,63,33,30,2,2,30,14,16
"2021","Cornwall 012C","E01018783",676,185,96,89,458,106,244,124,71,49,61,34,22,5,46,21,25,1,1,33,11,22
"2021","Cornwall 012D","E01018784",676,168,86,82,473,104,246,140,75,31,72,39,26,7,44,20,24,7,7,35,20,15
"2021","Cornwall 013A","E01018750",974,253,157,96,677,142,364,174,118,72,102,62,32,8,67,39,28,2,2,44,17,27
"2021","Cornwall 013B","E01018751",748,312,111,201,387,45,177,89,66,22,93,42,46,5,69,41,28,3,3,49,11,38
"2021","Cornwall 013C","E01018752",964,295,145,150,620,131,270,110,111,49,125,66,51,8,91,51,40,3,3,49,24,25
"2021","Cornwall 013D","E01018779",1030,309,170,139,670,145,330,165,113,52,124,75,45,4,66,41,25,5,5,51,20,31
"2021","Cornwall 016B","E01018768",847,199,100,99,617,74,278,98,136,44,134,66,57,11,126,68,58,5,5,31,13,18
"2021","Cornwall 016D","E01018778",770,208,117,91,519,110,269,130,97,42,90,48,38,4,48,27,21,2,2,43,17,26
"2021","Cornwall 016E","E01034849",638,190,98,92,424,63,186,69,86,31,105,64,41,0,69,59,10,1,1,24,9,15
"2021","Cornwall 016F","E01034850",623,216,96,120,380,47,164,60,78,26,91,48,39,4,75,53,22,3,3,27,11,16
"2021","Cornwall 016G","E01034851",561,179,95,84,361,61,169,83,55,31,69,30,35,4,62,33,29,0,0,21,5,16
"2021","Cornwall 016H","E01034852",676,175,93,82,458,93,221,113,77,31,87,45,38,4,54,32,22,3,3,43,15,28
"2021","Cornwall 017A","E01018767",640,227,121,106,382,47,161,62,64,35,69,24,42,3,104,66,38,1,1,31,13,18
"2021","Cornwall 017B","E01018770",604,222,118,104,353,61,149,52,55,42,55,21,29,5,86,57,29,2,2,29,15,14
"2021","Cornwall 017C","E01018771",750,394,120,274,326,48,124,77,29,18,85,60,22,3,63,35,28,6,6,30,8,22
"2021","Cornwall 017D","E01018772",800,230,140,90,540,145,246,110,96,40,93,46,41,6,56,36,20,0,0,30,11,19
"2021","Cornwall 022A","E01018764",644,149,83,66,470,120,260,129,83,48,54,23,26,5,32,19,13,4,4,25,8,17
"2021","Cornwall 022B","E01018787",644,150,70,80,472,92,248,97,108,43,78,44,30,4,54,38,16,0,0,22,9,13
"2021","Cornwall 022C","E01018795",520,103,68,35,400,120,201,94,70,37,47,27,18,2,32,19,13,0,0,17,3,14
"2021","Cornwall 022D","E01018796",495,116,59,57,366,60,193,76,88,29,59,30,24,5,51,34,17,3,3,13,6,7
"2021","Cornwall 023A","E01018757",997,287,170,117,663,148,378,195,122,61,86,52,31,3,49,21,28,2,2,47,13,34
"2021","Cornwall 023B","E01018763",479,130,60,70,325,59,176,65,75,36,53,38,14,1,36,23,13,1,1,24,7,17
"2021","Cornwall 023C","E01018765",672,168,117,51,467,157,231,120,77,34,54,31,21,2,25,10,15,0,0,37,14,23
"2021","Cornwall 023D","E01018785",828,218,132,86,559,131,311,133,126,52,65,38,22,5,46,26,20,6,6,51,22,29
"2021","Cornwall 025A","E01018786",549,151,84,67,377,85,180,79,68,33,57,25,27,5,54,29,25,1,1,21,9,12
"2021","Cornwall 025B","E01018788",704,301,199,102,386,98,149,60,65,24,62,29,28,5,76,52,24,1,1,17,6,11
"2021","Cornwall 025C","E01018790",486,122,67,55,342,57,153,66,59,28,61,26,29,6,68,42,26,3,3,22,12,10
"2021","Cornwall 025D","E01018794",642,194,99,95,431,105,202,80,77,45,73,41,26,6,51,36,15,0,0,17,9,8
"2021","Cornwall 026A","E01018789",617,155,93,62,431,101,180,74,76,30,66,33,28,5,82,56,26,2,2,31,9,22
"2021","Cornwall 026B","E01018791",541,157,90,67,352,87,146,60,54,32,45,21,22,2,72,49,23,2,2,32,15,17
"2021","Cornwall 026C","E01018792",1188,333,163,170,807,148,415,165,192,58,117,60,51,6,125,81,44,2,2,48,23,25
"2021","Cornwall 026D","E01018793",826,360,184,176,419,69,194,82,73,39,88,49,30,9,61,37,24,7,7,47,20,27
"2021","Cornwall 028A","E01018759",669,170,106,64,449,121,216,108,70,38,63,31,29,3,47,27,20,2,2,50,15,35
"2021","Cornwall 028B","E01018760",578,134,76,58,412,104,214,99,72,43,65,36,22,7,29,18,11,0,0,32,9,23
"2021","Cornwall 028C","E01018761",867,271,177,94,556,172,249,127,75,47,84,46,29,9,48,28,20,3,3,40,12,28
"2021","Cornwall 028D","E01018766",784,250,143,107,487,138,246,124,64,58,61,38,19,4,38,24,14,4,4,47,11,36
"2021","Cornwall 028E","E01018774",802,254,124,130,502,93,213,101,82,30,96,43,41,12,97,57,40,3,3,46,14,32
"2021","Cornwall 029A","E01018797",522,196,83,113,296,40,111,54,36,21,63,28,33,2,77,51,26,5,5,30,9,21
"2021","Cornwall 029B","E01018798",710,280,139,141,400,97,192,77,71,44,62,29,26,7,48,28,20,1,1,30,11,19
"2021","Cornwall 029C","E01018799",524,207,103,104,297,41,140,45,63,32,49,22,26,1,65,34,31,2,2,20,8,12
"2021","Cornwall 029D","E01018800",660,185,84,101,455,78,228,94,96,38,79,47,29,3,66,39,27,4,4,20,11,9
"2021","Cornwall 034A","E01018780",1062,342,212,130,665,164,300,127,118,55,89,42,37,10,108,63,45,4,4,55,15,40
"2021","Cornwall 034B","E01018781",807,235,126,109,538,160,260,136,80,44,77,49,22,6,39,23,16,2,2,34,13,21
"2021","Cornwall 034E","E01033294",1012,329,168,161,669,124,351,183,105,63,102,55,40,7,91,56,35,1,1,14,8,6
"2021","Cornwall 037A","E01018762",547,152,97,55,365,92,183,104,50,29,50,34,15,1,37,24,13,3,3,30,9,21
"2021","Cornwall 037B","E01018773",762,290,180,110,442,129,166,74,51,41,93,61,21,11,48,28,20,6,6,30,11,19
"2021","Cornwall 037E","E01034858",1126,422,231,191,652,176,327,183,86,58,90,54,27,9,58,27,31,1,1,52,17,35
"2021","Cornwall 032A","E01018815",1000,235,96,139,715,92,370,144,178,48,144,75,63,6,108,61,47,1,1,50,20,30
"2021","Cornwall 032B","E01018831",626,167,84,83,417,75,213,77,92,44,66,39,24,3,62,35,27,1,1,42,22,20
"2021","Cornwall 032C","E01018832",566,133,78,55,400,89,206,93,75,38,57,32,21,4,45,32,13,3,3,33,14,19
"2021","Cornwall 032D","E01018847",723,176,90,86,501,69,244,86,113,45,105,60,40,5,81,59,22,2,2,46,17,29
"2021","Cornwall 033A","E01018833",757,178,101,77,504,87,252,96,106,50,89,51,31,7,74,48,26,2,2,75,36,39
"2021","Cornwall 033B","E01018842",737,195,109,86,494,80,218,86,100,32,107,60,38,9,87,47,40,2,2,48,15,33
"2021","Cornwall 033C","E01018843",559,115,67,48,392,88,220,80,101,39,53,29,20,4,30,16,14,1,1,52,20,32
"2021","Cornwall 033D","E01018844",638,256,125,131,345,63,133,58,59,16,85,55,27,3,56,30,26,8,8,37,7,30
"2021","Cornwall 040A","E01018825",718,210,97,113,456,76,225,84,112,29,100,59,37,4,53,30,23,2,2,52,21,31
"2021","Cornwall 040B","E01018826",1096,372,195,177,674,114,320,121,150,49,154,91,53,10,81,53,28,5,5,50,19,31
"2021","Cornwall 040C","E01018851",622,232,130,102,365,81,161,60,75,26,66,35,28,3,53,23,30,4,4,25,5,20
"2021","Cornwall 040E","E01034859",625,161,96,65,423,87,227,80,124,23,57,30,26,1,52,29,23,0,0,41,18,23
"2021","Cornwall 040F","E01034860",629,175,88,87,419,70,241,83,125,33,75,42,31,2,32,14,18,1,1,35,15,20
"2021","Cornwall 042A","E01018823",761,319,193,126,399,106,184,76,76,32,65,44,15,6,42,22,20,2,2,43,11,32
"2021","Cornwall 042B","E01018824",1133,321,165,156,770,145,378,133,192,53,121,52,54,15,121,79,42,5,5,42,15,27
"2021","Cornwall 042C","E01018853",1198,350,187,163,767,112,364,123,180,61,150,62,84,4,135,87,48,6,6,81,30,51
"2021","Cornwall 042D","E01018854",612,202,84,118,369,53,150,47,69,34,68,36,27,5,97,55,42,1,1,41,15,26
"2021","Cornwall 043A","E01018819",690,255,106,149,411,56,194,85,72,37,90,52,32,6,66,39,27,5,5,24,9,15
"2021","Cornwall 043B","E01018822",579,122,77,45,414,95,180,54,83,43,71,38,28,5,63,30,33,5,5,43,15,28
"2021","Cornwall 043D","E01018856",647,244,105,139,362,53,155,72,50,33,74,43,28,3,77,44,33,3,3,41,11,30
"2021","Cornwall 043E","E01018857",617,189,95,94,400,73,146,66,60,20,93,31,57,5,86,50,36,2,2,28,6,22
"2021","Cornwall 043F","E01018858",658,247,154,93,376,93,179,68,79,32,57,38,16,3,44,24,20,3,3,35,5,30
"2021","Cornwall 043G","E01034862",460,92,13,79,325,18,164,46,89,29,77,49,25,3,63,50,13,3,3,43,5,38
"2021","Cornwall 043H","E01034863",924,196,95,101,662,96,296,115,145,36,151,97,47,7,115,84,31,4,4,66,20,46
"2021","Cornwall 044A","E01018807",846,250,120,130,546,85,227,100,101,26,131,88,40,3,97,74,23,6,6,50,17,33
"2021","Cornwall 044B","E01018808",675,229,104,125,409,61,187,66,101,20,76,47,24,5,80,53,27,5,5,37,13,24
"2021","Cornwall 044D","E01018810",580,163,70,93,381,75,193,62,96,35,63,38,20,5,50,26,24,0,0,36,10,26
"2021","Cornwall 044E","E01034864",664,445,281,164,196,35,78,45,26,7,56,45,10,1,25,15,10,2,2,23,4,19
"2021","Cornwall 044F","E01034865",597,289,78,211,254,29,89,43,36,10,73,46,24,3,59,34,25,4,4,54,9,45
"2021","Cornwall 047A","E01018816",715,171,119,52,514,187,262,115,96,51,41,22,17,2,24,12,12,0,0,30,11,19
"2021","Cornwall 047B","E01018817",929,254,156,98,623,152,311,126,129,56,105,73,25,7,50,27,23,5,5,52,18,34
"2021","Cornwall 047C","E01018818",818,244,165,79,541,180,242,96,103,43,53,27,23,3,66,39,27,0,0,33,8,25
"2021","Cornwall 047D","E01018820",791,234,112,122,504,90,265,93,121,51,83,43,32,8,65,32,33,1,1,53,13,40
"2021","Cornwall 047E","E01018821",707,142,52,90,522,61,279,103,139,37,107,63,42,2,72,53,19,3,3,43,18,25
"2021","Cornwall 048A","E01018845",779,214,132,82,530,102,256,100,111,45,105,62,43,0,63,42,21,4,4,35,9,26
"2021","Cornwall 048B","E01018846",628,171,93,78,418,100,206,77,84,45,61,34,24,3,45,21,24,6,6,39,11,28
"2021","Cornwall 048C","E01018848",778,237,143,94,508,106,239,92,101,46,76,49,21,6,81,46,35,6,6,33,11,22
"2021","Cornwall 048D","E01018849",886,318,204,114,523,160,227,121,63,43,75,47,24,4,56,32,24,5,5,45,14,31
"2021","Cornwall 048E","E01018850",604,179,114,65,396,102,218,111,72,35,46,33,10,3,26,13,13,4,4,29,9,20
"2021","Cornwall 056A","E01018827",695,190,131,59,478,171,208,99,77,32,49,26,19,4,47,25,22,3,3,27,11,16
"2021","Cornwall 056B","E01018828",696,206,124,82,462,142,215,109,70,36,58,40,12,6,47,37,10,0,0,28,11,17
"2021","Cornwall 056C","E01018829",548,124,75,49,379,82,204,87,82,35,54,36,16,2,37,19,18,2,2,45,19,26
"2021","Cornwall 056D","E01018830",738,237,139,98,472,140,244,95,106,43,55,35,17,3,31,13,18,2,2,29,11,18
"2021","Cornwall 060A","E01018834",805,189,101,88,519,84,253,94,111,48,98,55,42,1,80,52,28,4,4,97,21,76
"2021","Cornwall 060B","E01018835",753,205,77,128,435,71,156,67,58,31,125,82,39,4,77,50,27,6,6,113,14,99
"2021","Cornwall 060C","E01018836",810,314,93,221,366,23,138,49,57,32,106,67,35,4,90,61,29,9,9,130,6,124
"2021","Cornwall 060D","E01018837",1111,348,133,215,640,91,256,93,117,46,168,106,61,1,119,79,40,6,6,123,17,106
"2021","Cornwall 062A","E01018838",662,201,111,90,371,48,170,58,66,46,60,24,31,5,88,59,29,5,5,90,9,81
"2021","Cornwall 062B","E01018839",575,227,97,130,245,63,95,52,25,18,59,49,9,1,23,13,10,5,5,103,9,94
"2021","Cornwall 062C","E01018840",709,222,65,157,274,37,93,35,38,20,106,82,16,8,30,18,12,8,8,213,13,200
"2021","Cornwall 062D","E01018841",645,171,79,92,398,34,153,66,57,30,72,25,35,12,130,80,50,9,9,76,14,62
"2021","Cornwall 062E","E01018860",839,290,164,126,478,66,170,53,65,52,108,39,59,10,120,60,60,14,14,71,14,57
"2021","Cornwall 063A","E01018803",821,370,237,133,367,132,139,60,49,30,68,55,9,4,26,13,13,2,2,84,9,75
"2021","Cornwall 063B","E01018804",748,243,82,161,260,22,104,47,44,13,99,77,19,3,22,14,8,13,13,245,11,234
"2021","Cornwall 063C","E01018805",673,207,125,82,405,133,201,85,71,45,40,26,11,3,30,12,18,1,1,61,9,52
"2021","Cornwall 063D","E01018806",653,185,82,103,315,40,146,56,58,32,64,46,16,2,58,39,19,7,7,153,9,144
"2021","Cornwall 064A","E01018811",688,167,105,62,484,92,246,82,116,48,91,45,41,5,51,25,26,4,4,37,17,20
"2021","Cornwall 064B","E01018812",734,201,83,118,485,63,200,54,118,28,125,53,66,6,95,67,28,2,2,48,11,37
"2021","Cornwall 064C","E01018813",706,181,99,82,501,88,257,87,126,44,88,59,23,6,65,37,28,3,3,24,13,11
"2021","Cornwall 064D","E01018814",658,186,95,91,432,75,204,67,82,55,88,44,38,6,64,34,30,1,1,40,9,31
"2021","Cornwall 064E","E01018859",786,247,161,86,455,106,237,105,84,48,63,37,23,3,47,24,23,2,2,84,17,67
"2021","Cornwall 045A","E01018889",547,150,93,57,363,65,193,78,78,37,62,35,23,4,43,19,24,0,0,34,11,23
"2021","Cornwall 045B","E01018890",717,185,107,78,493,97,228,109,87,32,105,51,46,8,59,30,29,4,4,39,20,19
"2021","Cornwall 045C","E01018891",613,180,88,92,410,91,172,93,49,30,85,48,35,2,59,35,24,3,3,23,7,16
"2021","Cornwall 045D","E01018892",684,176,91,85,453,83,220,84,108,28,91,50,36,5,57,35,22,2,2,55,20,35
"2021","Cornwall 045E","E01018893",622,220,117,103,366,76,173,79,65,29,64,37,25,2,50,25,25,3,3,36,15,21
"2021","Cornwall 046A","E01018908",819,245,103,142,520,99,251,122,92,37,86,46,36,4,81,46,35,3,3,54,19,35
"2021","Cornwall 046B","E01018909",772,272,126,146,469,51,229,102,95,32,113,58,48,7,73,42,31,3,3,31,9,22
"2021","Cornwall 046C","E01018910",916,339,139,200,547,36,200,63,95,42,144,62,76,6,163,128,35,4,4,30,14,16
"2021","Cornwall 046D","E01018911",913,423,182,241,432,61,165,77,57,31,113,63,47,3,86,56,30,7,7,58,22,36
"2021","Cornwall 049A","E01018912",835,225,120,105,567,89,272,103,124,45,127,57,62,8,76,47,29,3,3,43,21,22
"2021","Cornwall 049B","E01018913",873,352,106,246,456,55,197,63,99,35,127,66,53,8,74,50,24,3,3,65,18,47
"2021","Cornwall 049C","E01018914",947,298,137,161,585,98,263,118,113,32,145,69,71,5,75,42,33,4,4,64,20,44
"2021","Cornwall 049D","E01018915",980,310,153,157,615,102,274,108,133,33,153,86,60,7,84,53,31,2,2,55,17,38
"2021","Cornwall 050A","E01018916",596,156,73,83,406,55,200,97,71,32,92,48,38,6,58,41,17,1,1,34,15,19
"2021","Cornwall 050B","E01018917",638,185,121,64,417,89,200,87,75,38,69,37,26,6,58,39,19,1,1,36,10,26
"2021","Cornwall 050C","E01018918",863,289,143,146,534,104,249,112,88,49,91,48,41,2,89,50,39,1,1,40,13,27
"2021","Cornwall 050D","E01018919",659,176,92,84,449,84,218,99,79,40,86,38,41,7,58,35,23,3,3,34,10,24
"2021","Cornwall 051A","E01018894",845,226,99,127,579,86,260,115,102,43,132,64,63,5,96,63,33,5,5,40,20,20
"2021","Cornwall 051B","E01018895",797,195,95,100,535,87,274,98,130,46,103,53,42,8,67,36,31,4,4,67,17,50
"2021","Cornwall 051C","E01018896",665,214,122,92,409,95,195,101,65,29,64,37,24,3,52,30,22,3,3,42,14,28
"2021","Cornwall 051D","E01018897",995,283,64,219,648,66,294,120,139,35,188,87,96,5,94,61,33,6,6,64,23,41
"2021","Cornwall 051E","E01018898",560,202,75,127,336,31,155,63,68,24,75,27,41,7,73,55,18,2,2,22,8,14
"2021","Cornwall 052A","E01018865",1009,337,126,211,619,87,244,90,115,39,156,78,71,7,124,84,40,8,8,53,20,33
"2021","Cornwall 052B","E01018866",952,263,134,129,652,89,293,133,109,51,143,52,84,7,123,80,43,4,4,37,22,15
"2021","Cornwall 052D","E01018868",888,289,105,184,507,69,196,80,88,28,135,77,54,4,105,59,46,2,2,92,14,78
"2021","Cornwall 052E","E01034866",671,211,76,135,419,44,180,76,69,35,87,43,39,5,106,68,38,2,2,41,18,23
"2021","Cornwall 052F","E01034867",576,148,26,122,393,16,147,47,83,17,125,62,62,1,102,83,19,3,3,35,18,17
"2021","Cornwall 053A","E01018874",579,173,98,75,373,94,183,87,63,33,46,26,15,5,49,24,25,1,1,33,10,23
"2021","Cornwall 053B","E01018875",652,279,155,124,344,61,120,49,39,32,69,32,33,4,87,52,35,7,7,29,13,16
"2021","Cornwall 053C","E01018876",629,162,98,64,424,85,205,91,69,45,76,36,36,4,54,30,24,4,4,43,24,19
"2021","Cornwall 053D","E01018877",682,209,133,76,437,131,200,82,76,42,63,31,24,8,43,23,20,0,0,36,13,23
"2021","Cornwall 053E","E01018878",809,361,167,194,374,36,140,58,54,28,99,44,50,5,95,69,26,4,4,74,15,59
"2021","Cornwall 055A","E01018869",750,227,114,113,464,92,198,76,74,48,84,39,39,6,87,49,38,3,3,59,31,28
"2021","Cornwall 055B","E01018870",536,152,67,85,352,20,114,40,52,22,85,29,49,7,127,97,30,6,6,32,17,15
"2021","Cornwall 055C","E01018871",731,201,106,95,479,104,240,106,87,47,72,38,27,7,63,40,23,0,0,51,17,34
"2021","Cornwall 055D","E01018872",554,161,82,79,363,85,163,79,57,27,71,39,24,8,44,24,20,0,0,30,15,15
"2021","Cornwall 055E","E01018873",515,145,86,59,346,56,159,65,71,23,71,26,40,5,55,39,16,5,5,24,8,16
"2021","Cornwall 059A","E01018863",725,173,92,81,500,70,260,114,106,40,98,54,36,8,69,38,31,3,3,52,20,32
"2021","Cornwall 059B","E01018864",744,177,102,75,521,115,280,136,98,46,84,54,27,3,41,18,23,1,1,46,22,24
"2021","Cornwall 059C","E01018921",934,215,115,100,674,123,335,131,147,57,125,74,39,12,86,54,32,5,5,45,15,30
"2021","Cornwall 059D","E01018922",1015,201,98,103,727,138,416,195,141,80,110,64,40,6,58,28,30,5,5,87,48,39
"2021","Cornwall 066A","E01018879",877,239,150,89,592,217,274,122,113,39,58,29,27,2,38,22,16,5,5,46,21,25
"2021","Cornwall 066B","E01018880",983,267,167,100,661,152,343,157,138,48,97,50,42,5,62,40,22,7,7,55,27,28
"2021","Cornwall 066C","E01018899",712,187,105,82,469,95,209,80,93,36,98,58,32,8,64,42,22,3,3,56,19,37
"2021","Cornwall 066D","E01018900",854,202,95,107,601,124,290,121,131,38,133,71,56,6,54,31,23,0,0,51,18,33
"2021","Cornwall 066E","E01018901",689,210,125,85,436,120,210,91,85,34,71,37,30,4,33,16,17,2,2,43,16,27
"2021","Cornwall 071A","E01018882",619,142,85,57,448,93,233,100,92,41,70,37,27,6,47,28,19,5,5,29,12,17
"2021","Cornwall 071B","E01018883",704,193,109,84,487,89,271,99,117,55,70,33,33,4,55,34,21,2,2,24,11,13
"2021","Cornwall 071C","E01018884",699,175,102,73,498,102,264,99,112,53,73,37,33,3,56,37,19,3,3,26,10,16
"2021","Cornwall 071D","E01018885",689,274,123,151,382,72,177,73,81,23,73,47,23,3,58,32,26,2,2,33,16,17
"2021","Cornwall 071E","E01018886",677,157,65,92,496,59,312,114,163,35,76,44,29,3,48,36,12,1,1,24,12,12
"2021","Cornwall 071F","E01018887",791,234,93,141,531,38,243,72,132,39,110,51,56,3,136,96,40,4,4,26,12,14
"2021","Cornwall 071G","E01018888",1028,379,190,189,620,95,278,81,158,39,108,52,54,2,133,89,44,6,6,29,13,16
"2021","Cornwall 072A","E01018861",675,179,106,73,461,107,204,101,68,35,96,62,30,4,52,28,24,2,2,35,12,23
"2021","Cornwall 072B","E01018862",664,180,118,62,442,141,211,118,57,36,58,37,17,4,29,13,16,3,3,42,16,26
"2021","Cornwall 072C","E01018905",637,185,105,80,409,80,216,100,83,33,65,37,24,4,47,27,20,1,1,43,13,30
"2021","Cornwall 072D","E01018906",525,177,113,64,327,89,157,76,52,29,45,32,10,3,35,23,12,1,1,21,3,18
"2021","Cornwall 072E","E01018907",624,211,122,89,393,78,168,67,69,32,66,36,29,1,79,48,31,2,2,20,12,8
"2021","Cornwall 073A","E01018881",958,302,152,150,612,146,293,141,100,52,90,48,36,6,80,34,46,3,3,44,24,20
"2021","Cornwall 073B","E01018902",508,126,84,42,348,58,188,87,63,38,48,23,24,1,50,23,27,4,4,34,17,17
"2021","Cornwall 073C","E01018903",476,128,71,57,323,78,158,62,68,28,52,34,16,2,35,19,16,0,0,25,10,15
"2021","Cornwall 073D","E01018904",960,251,169,82,654,189,288,122,117,49,90,40,45,5,85,52,33,2,2,55,20,35
"2021","Cornwall 073E","E01018920",897,237,146,91,595,168,267,143,77,47,91,51,33,7,65,34,31,4,4,65,32,33
"2021","Cornwall 001A","E01018936",801,357,185,172,404,86,183,77,71,35,82,60,21,1,50,36,14,3,3,40,10,30
"2021","Cornwall 001B","E01018937",875,238,114,124,598,92,237,89,99,49,122,49,68,5,145,100,45,2,2,39,12,27
"2021","Cornwall 001C","E01018938",825,339,250,89,442,139,185,81,75,29,62,37,21,4,56,31,25,0,0,44,7,37
"2021","Cornwall 001D","E01018959",666,205,140,65,433,160,189,92,66,31,55,37,15,3,27,15,12,2,2,28,8,20
"2021","Cornwall 001E","E01018960",1018,262,128,134,702,128,274,104,132,38,137,63,69,5,156,117,39,7,7,54,24,30
"2021","Cornwall 001F","E01018961",666,228,115,113,416,111,183,85,70,28,71,41,24,6,50,34,16,1,1,22,10,12
"2021","Cornwall 002A","E01018943",965,211,125,86,702,169,360,174,140,46,101,41,54,6,68,44,24,4,4,52,22,30
"2021","Cornwall 002B","E01018951",1023,259,150,109,700,165,358,181,114,63,126,54,68,4,44,26,18,7,7,64,34,30
"2021","Cornwall 002C","E01018974",1093,248,151,97,776,170,405,187,146,72,117,60,50,7,78,40,38,6,6,69,34,35
"2021","Cornwall 003A","E01018940",718,218,126,92,463,115,217,99,76,42,83,44,33,6,45,21,24,3,3,37,16,21
"2021","Cornwall 003B","E01018941",732,238,118,120,452,79,222,116,74,32,84,34,46,4,64,43,21,3,3,42,9,33
"2021","Cornwall 003C","E01018942",710,250,143,107,412,86,204,123,54,27,73,45,23,5,48,22,26,1,1,48,19,29
"2021","Cornwall 003D","E01018969",1026,279,170,109,684,179,318,182,77,59,120,70,42,8,64,32,32,3,3,63,24,39
"2021","Cornwall 004B","E01018953",546,140,80,60,385,84,214,111,67,36,55,28,24,3,31,16,15,1,1,21,12,9
"2021","Cornwall 004C","E01018968",1050,234,148,86,730,174,396,207,117,72,105,57,43,5,53,25,28,2,2,86,31,55
"2021","Cornwall 004D","E01033291",765,186,111,75,533,154,235,107,87,41,75,28,42,5,67,38,29,2,2,46,22,24
"2021","Cornwall 004E","E01033292",675,223,87,136,420,45,152,53,77,22,95,46,44,5,125,92,33,3,3,32,20,12
"2021","Cornwall 005A","E01018946",694,245,145,100,425,109,196,87,74,35,80,41,33,6,40,21,19,0,0,24,12,12
"2021","Cornwall 005C","E01018948",766,223,89,134,504,85,255,141,77,37,97,54,43,0,64,27,37,3,3,39,14,25
"2021","Cornwall 005D","E01018949",527,154,72,82,340,21,145,40,72,33,81,27,44,10,88,66,22,5,5,33,16,17
"2021","Cornwall 005E","E01018950",887,419,153,266,428,67,160,57,68,35,123,74,43,6,71,60,11,7,7,40,11,29
"2021","Cornwall 005F","E01034847",723,164,60,104,526,59,284,94,156,34,118,59,56,3,61,38,23,4,4,33,13,20
"2021","Cornwall 005G","E01034848",843,231,87,144,566,61,249,91,122,36,129,55,62,12,120,94,26,7,7,46,21,25
"2021","Cornwall 006A","E01018925",963,256,142,114,644,154,332,153,112,67,101,62,33,6,56,31,25,1,1,63,23,40
"2021","Cornwall 006B","E01018952",546,140,84,56,386,101,192,85,62,45,64,37,22,5,27,13,14,2,2,20,3,17
"2021","Cornwall 006C","E01018965",1040,272,172,100,724,177,370,187,117,66,102,51,45,6,72,37,35,3,3,44,18,26
"2021","Cornwall 006D","E01018966",482,119,65,54,335,86,190,101,55,34,35,23,10,2,22,8,14,2,2,28,17,11
"2021","Cornwall 006E","E01018967",550,124,77,47,395,105,206,111,66,29,44,27,13,4,40,22,18,0,0,31,9,22
"2021","Cornwall 007A","E01018924",526,133,69,64,351,70,192,74,80,38,48,22,22,4,40,23,17,1,1,42,22,20
"2021","Cornwall 007B","E01018962",882,281,159,122,569,141,257,124,83,50,106,49,52,5,62,36,26,3,3,32,13,19
"2021","Cornwall 007E","E01033289",949,347,203,144,567,150,269,121,105,43,79,41,32,6,64,36,28,5,5,35,10,25
"2021","Cornwall 008A","E01018954",585,97,43,54,442,48,229,79,125,25,96,42,54,0,65,54,11,4,4,46,19,27
"2021","Cornwall 008B","E01018955",702,202,117,85,457,110,194,85,84,25,86,36,47,3,64,42,22,3,3,43,15,28
"2021","Cornwall 008C","E01018956",462,121,76,45,307,80,157,67,53,37,42,26,12,4,28,15,13,0,0,34,11,23
"2021","Cornwall 008D","E01018957",618,148,63,85,425,84,193,82,61,50,89,40,42,7,55,41,14,4,4,45,14,31
"2021","Cornwall 008E","E01018958",499,204,137,67,270,62,125,64,40,21,34,21,10,3,45,26,19,4,4,25,7,18
"2021","Cornwall 009A","E01018970",693,163,88,75,503,119,238,87,104,47,73,45,26,2,71,37,34,2,2,27,11,16
"2021","Cornwall 009B","E01018971",887,321,201,120,543,147,253,91,114,48,72,36,34,2,68,36,32,3,3,23,9,14
"2021","Cornwall 009C","E01018972",889,395,198,197,457,93,187,62,78,47,94,60,30,4,78,54,24,5,5,37,9,28
"2021","Cornwall 009D","E01018973",680,230,130,100,416,84,182,72,78,32,80,42,35,3,69,40,29,1,1,34,16,18
"2021","Cornwall 011A","E01018923",605,151,85,66,417,102,198,87,74,37,72,42,25,5,44,26,18,1,1,37,10,27
"2021","Cornwall 011B","E01018926",1119,294,171,123,751,186,390,217,111,62,101,65,29,7,70,35,35,4,4,74,31,43
"2021","Cornwall 011C","E01018944",467,103,54,49,329,74,158,74,48,36,44,25,14,5,48,27,21,5,5,35,12,23
"2021","Cornwall 011D","E01018945",556,145,87,58,366,85,204,92,79,33,34,21,12,1,42,24,18,1,1,45,20,25
"2021","Cornwall 014A","E01018932",726,236,114,122,448,75,220,100,90,30,79,37,38,4,71,41,30,3,3,42,16,26
"2021","Cornwall 014B","E01018933",821,312,91,221,455,50,171,52,93,26,128,65,58,5,100,63,37,6,6,54,16,38
"2021","Cornwall 014C","E01018934",1079,244,139,105,740,156,385,161,163,61,137,73,57,7,57,36,21,5,5,95,33,62
"2021","Cornwall 014D","E01018935",1121,305,144,161,755,114,314,106,166,42,194,107,80,7,126,83,43,7,7,61,18,43
"2021","Cornwall 015A","E01018927",733,196,96,100,498,67,208,84,80,44,103,47,51,5,115,86,29,5,5,39,10,29
"2021","Cornwall 015B","E01018928",803,329,130,199,420,29,161,61,68,32,118,70,40,8,104,72,32,8,8,54,21,33
"2021","Cornwall 015C","E01018929",785,215,91,124,523,86,211,86,97,28,141,67,65,9,78,59,19,7,7,47,16,31
"2021","Cornwall 015D","E01018930",679,252,104,148,375,26,139,59,59,21,98,34,54,10,107,75,32,5,5,52,39,13
"2021","Cornwall 015E","E01018931",495,145,88,57,323,76,153,72,51,30,48,28,19,1,44,19,25,2,2,27,12,15
"2021","Cornwall 054A","E01019008",621,232,131,101,367,47,138,63,45,30,84,39,39,6,97,58,39,1,1,22,3,19
"2021","Cornwall 054B","E01019009",647,167,72,95,430,56,185,78,63,44,80,36,33,11,108,58,50,1,1,50,23,27
"2021","Cornwall 054C","E01019010",534,170,92,78,336,75,153,55,62,36,40,18,18,4,66,25,41,2,2,28,8,20
"2021","Cornwall 054D","E01019011",698,193,131,62,472,128,212,105,66,41,58,34,22,2,74,45,29,0,0,33,12,21
"2021","Cornwall 054E","E01019012",738,381,204,177,331,95,120,72,27,21,73,65,7,1,43,24,19,0,0,26,7,19
"2021","Cornwall 057A","E01018978",678,212,119,93,425,87,191,80,82,29,76,30,35,11,70,38,32,1,1,41,16,25
"2021","Cornwall 057B","E01018981",941,306,189,117,587,145,261,109,108,44,109,53,51,5,66,38,28,6,6,48,20,28
"2021","Cornwall 057C","E01018982",927,314,159,155,555,95,246,96,103,47,106,55,46,5,104,62,42,4,4,58,18,40
"2021","Cornwall 057D","E01018983",684,209,131,78,443,139,191,88,63,40,64,33,23,8,47,22,25,2,2,32,11,21
"2021","Cornwall 057F","E01034868",579,127,42,85,430,32,192,64,102,26,102,44,51,7,103,78,25,1,1,22,9,13
"2021","Cornwall 057G","E01034869",711,233,113,120,438,43,174,62,63,49,84,39,41,4,135,73,62,2,2,40,11,29
"2021","Cornwall 058A","E01018985",1048,291,168,123,700,191,309,149,112,48,93,46,43,4,103,69,34,4,4,57,19,38
"2021","Cornwall 058B","E01018986",715,258,156,102,428,116,204,108,54,42,56,29,23,4,48,24,24,4,4,29,12,17
"2021","Cornwall 058C","E01018987",919,268,158,110,597,140,315,160,86,69,84,52,24,8,56,23,33,2,2,54,27,27
"2021","Cornwall 061A","E01018975",900,245,153,92,605,151,285,116,121,48,102,41,50,11,67,42,25,0,0,50,15,35
"2021","Cornwall 061B","E01018979",616,139,82,57,443,66,223,93,85,45,91,45,41,5,58,29,29,5,5,34,11,23
"2021","Cornwall 061C","E01018980",645,180,98,82,424,64,224,73,105,46,72,39,30,3,64,40,24,0,0,41,20,21
"2021","Cornwall 061D","E01018990",902,337,205,132,529,131,235,113,78,44,81,43,30,8,78,43,35,4,4,36,12,24
"2021","Cornwall 061E","E01019007",1007,254,138,116,687,133,331,144,133,54,128,73,50,5,87,51,36,8,8,66,25,41
"2021","Cornwall 065A","E01018988",728,212,118,94,483,108,218,85,90,43,93,50,41,2,60,36,24,4,4,33,9,24
"2021","Cornwall 065B","E01018989",748,208,118,90,483,97,232,111,78,43,73,35,27,11,78,51,27,3,3,57,28,29
"2021","Cornwall 065C","E01018991",719,235,125,110,456,102,215,110,72,33,70,37,27,6,66,41,25,3,3,28,11,17
"2021","Cornwall 065D","E01019006",695,202,130,72,452,115,234,119,63,52,58,33,22,3,41,20,21,4,4,41,16,25
"2021","Cornwall 067A","E01018976",1002,328,207,121,629,162,266,126,94,46,89,46,36,7,106,44,62,6,6,45,13,32
"2021","Cornwall 067B","E01018977",607,212,87,125,371,51,153,57,55,41,69,30,34,5,96,58,38,2,2,24,9,15
"2021","Cornwall 067C","E01018994",952,372,157,215,545,140,209,98,73,38,88,35,48,5,103,52,51,5,5,35,12,23
"2021","Cornwall 067D","E01018996",751,341,157,184,381,64,168,72,65,31,73,44,26,3,74,48,26,2,2,29,10,19
"2021","Cornwall 067E","E01018997",600,168,64,104,390,24,118,38,43,37,109,27,78,4,135,95,40,4,4,42,17,25
"2021","Cornwall 068A","E01018995",1090,538,220,318,502,84,162,66,62,34,100,51,48,1,150,90,60,6,6,50,14,36
"2021","Cornwall 068B","E01018998",678,269,114,155,377,35,119,50,45,24,105,60,37,8,112,65,47,6,6,32,13,19
"2021","Cornwall 068C","E01018999",950,520,260,260,394,59,127,62,42,23,86,54,28,4,119,85,34,3,3,36,8,28
"2021","Cornwall 068D","E01019001",898,521,256,265,337,77,130,72,40,18,73,53,19,1,56,29,27,1,1,40,8,32
"2021","Cornwall 069A","E01018992",834,296,168,128,498,117,235,110,74,51,84,43,33,8,60,37,23,2,2,40,15,25
"2021","Cornwall 069B","E01018993",742,311,184,127,414,76,210,109,66,35,75,40,31,4,52,31,21,1,1,17,4,13
"2021","Cornwall 069C","E01019005",950,288,151,137,611,133,309,133,123,53,80,38,36,6,84,56,28,5,5,51,16,35
"2021","Cornwall 070A","E01019000",715,274,179,95,417,124,149,57,51,41,65,34,25,6,77,38,39,2,2,24,9,15
"2021","Cornwall 070B","E01019002",622,249,152,97,338,104,138,76,37,25,49,30,17,2,45,27,18,2,2,35,10,25
"2021","Cornwall 070C","E01019003",785,255,149,106,498,136,231,106,78,47,71,45,22,4,56,34,22,4,4,32,11,21
"2021","Cornwall 070D","E01019004",726,292,127,165,407,67,146,63,53,30,77,36,36,5,113,71,42,4,4,27,5,22
"2021","Cornwall 018A","E01019048",850,268,120,148,519,129,250,100,98,52,89,59,28,2,47,21,26,4,4,63,19,44
"2021","Cornwall 018C","E01019050",755,189,115,74,522,100,257,101,113,43,102,52,41,9,56,32,24,7,7,44,17,27
"2021","Cornwall 018D","E01019051",725,244,133,111,441,68,202,74,90,38,77,31,37,9,86,52,34,8,8,40,15,25
"2021","Cornwall 018E","E01034853",586,177,69,108,371,60,155,57,76,22,76,41,30,5,80,54,26,0,0,38,11,27
"2021","Cornwall 018F","E01034854",564,106,28,78,426,31,211,74,124,13,106,44,56,6,77,56,21,1,1,32,10,22
"2021","Cornwall 018G","E01034855",612,137,32,105,443,18,179,58,108,13,157,75,80,2,86,57,29,3,3,32,13,19
"2021","Cornwall 019A","E01019060",578,159,88,71,375,85,198,83,83,32,50,35,9,6,37,18,19,5,5,44,19,25
"2021","Cornwall 019B","E01019061",790,224,111,113,521,90,261,102,106,53,97,58,36,3,69,46,23,4,4,45,11,34
"2021","Cornwall 019C","E01019062",767,225,95,130,501,77,200,70,95,35,86,33,45,8,134,75,59,4,4,41,19,22
"2021","Cornwall 019D","E01019063",899,203,81,122,641,94,297,122,120,55,164,74,85,5,82,52,30,4,4,55,18,37
"2021","Cornwall 019E","E01019064",908,228,92,136,618,96,302,112,129,61,134,68,55,11,82,55,27,4,4,62,27,35
"2021","Cornwall 019F","E01019065",535,120,62,58,386,60,190,68,77,45,76,33,35,8,53,32,21,7,7,29,13,16
"2021","Cornwall 020A","E01019028",1055,469,169,300,494,58,201,82,81,38,132,87,39,6,95,61,34,8,8,92,20,72
"2021","Cornwall 020B","E01019029",772,348,114,234,336,38,143,53,50,40,91,67,20,4,60,36,24,4,4,88,12,76
"2021","Cornwall 020C","E01019030",921,264,103,161,605,95,308,128,136,44,132,78,45,9,67,46,21,3,3,52,15,37
"2021","Cornwall 020D","E01019031",808,277,114,163,487,97,196,88,72,36,130,68,53,9,62,42,20,2,2,44,8,36
"2021","Cornwall 021A","E01019018",667,153,103,50,483,132,244,102,97,45,56,29,25,2,49,25,24,2,2,31,10,21
"2021","Cornwall 021B","E01019019",839,323,151,172,470,102,197,78,83,36,107,74,31,2,56,36,20,8,8,46,23,23
"2021","Cornwall 021C","E01019020",772,354,69,285,340,30,142,64,50,28,89,55,26,8,69,44,25,10,10,78,15,63
"2021","Cornwall 021D","E01019021",708,208,101,107,450,77,215,96,77,42,90,50,35,5,63,35,28,5,5,50,23,27
"2021","Cornwall 021E","E01019022",819,300,153,147,469,71,195,64,91,40,99,45,41,13,100,57,43,4,4,50,17,33
"2021","Cornwall 021F","E01019023",653,133,60,73,476,43,224,65,120,39,107,48,52,7,97,74,23,5,5,44,10,34
"2021","Cornwall 024A","E01019052",817,218,87,131,543,70,267,102,109,56,118,58,52,8,85,49,36,3,3,56,25,31
"2021","Cornwall 024B","E01019053",1014,313,123,190,637,119,287,136,100,51,135,69,57,9,90,52,38,6,6,64,24,40
"2021","Cornwall 024C","E01019054",798,191,92,99,545,97,265,118,106,41,104,49,50,5,69,50,19,10,10,62,27,35
"2021","Cornwall 024D","E01019055",612,172,82,90,401,44,215,75,88,52,76,30,40,6,65,43,22,1,1,39,16,23
"2021","Cornwall 027A","E01019035",834,318,188,130,478,114,219,109,82,28,98,62,34,2,42,26,16,5,5,38,12,26
"2021","Cornwall 027B","E01019036",788,216,117,99,516,126,273,131,94,48,74,45,26,3,40,23,17,3,3,56,21,35
"2021","Cornwall 027C","E01019037",667,172,87,85,467,92,201,78,80,43,104,61,36,7,62,40,22,8,8,28,14,14
"2021","Cornwall 027D","E01019074",804,210,79,131,555,68,231,98,95,38,143,64,74,5,106,76,30,7,7,39,14,25
"2021","Cornwall 027E","E01019075",749,161,73,88,530,85,251,98,96,57,119,43,68,8,74,42,32,1,1,58,22,36
"2021","Cornwall 027F","E01019076",890,240,93,147,588,77,242,100,97,45,156,72,76,8,107,73,34,6,6,62,30,32
"2021","Cornwall 030A","E01019069",541,166,75,91,350,35,170,70,67,33,78,36,41,1,64,39,25,3,3,25,10,15
"2021","Cornwall 030B","E01019070",903,268,123,145,594,92,277,129,93,55,134,58,66,10,88,49,39,3,3,41,16,25
"2021","Cornwall 030C","E01019071",725,166,82,84,530,93,265,99,115,51,96,45,42,9,74,52,22,2,2,29,14,15
"2021","Cornwall 030D","E01019072",624,162,98,64,426,59,198,81,78,39,64,35,29,0,104,74,30,1,1,36,14,22
"2021","Cornwall 030E","E01019073",670,167,88,79,473,100,244,111,87,46,80,43,32,5,48,29,19,1,1,30,17,13
"2021","Cornwall 031A","E01019056",544,169,70,99,333,34,130,43,62,25,67,18,43,6,100,62,38,2,2,42,17,25
"2021","Cornwall 031B","E01019057",820,247,120,127,518,86,210,84,83,43,107,53,46,8,111,80,31,4,4,55,13,42
"2021","Cornwall 031C","E01019058",934,227,113,114,666,108,300,121,131,48,147,66,77,4,107,72,35,4,4,41,14,27
"2021","Cornwall 031D","E01019059",671,207,126,81,434,97,220,95,79,46,57,34,22,1,60,32,28,0,0,30,13,17
"2021","Cornwall 035A","E01019024",637,172,98,74,420,74,196,91,67,38,72,43,25,4,75,48,27,3,3,45,23,22
"2021","Cornwall 035B","E01019025",689,191,119,72,466,126,231,117,74,40,66,39,26,1,39,28,11,4,4,32,10,22
"2021","Cornwall 035C","E01019026",671,211,151,60,432,134,189,90,57,42,62,37,19,6,44,22,22,3,3,28,12,16
"2021","Cornwall 035D","E01019027",605,220,134,86,357,106,152,68,51,33,48,32,13,3,51,32,19,0,0,28,4,24
"2021","Cornwall 036A","E01019013",945,301,188,113,597,124,268,111,108,49,103,45,46,12,99,54,45,3,3,47,8,39
"2021","Cornwall 036B","E01019014",647,158,93,65,466,101,217,88,88,41,78,35,38,5,68,44,24,2,2,23,10,13
"2021","Cornwall 036C","E01019015",587,156,87,69,412,83,201,83,76,42,76,39,30,7,49,31,18,3,3,19,8,11
"2021","Cornwall 036D","E01019016",721,136,57,79,548,59,305,109,141,55,88,43,39,6,93,61,32,3,3,37,17,20
"2021","Cornwall 036F","E01034856",747,222,160,62,501,185,223,99,81,43,58,38,16,4,32,21,11,3,3,24,8,16
"2021","Cornwall 036G","E01034857",584,183,77,106,381,83,182,86,64,32,63,41,19,3,52,33,19,1,1,20,11,9
"2021","Cornwall 038A","E01019032",631,172,93,79,423,109,232,110,85,37,44,18,22,4,37,20,17,1,1,36,12,24
"2021","Cornwall 038B","E01019034",686,225,77,148,408,57,188,78,83,27,88,58,28,2,73,42,31,2,2,53,18,35
"2021","Cornwall 038C","E01019045",1128,298,126,172,781,97,343,121,163,59,198,107,81,10,133,91,42,10,10,49,20,29
"2021","Cornwall 038D","E01019047",684,253,104,149,380,68,162,59,73,30,62,34,23,5,83,54,29,5,5,51,20,31
"2021","Cornwall 039A","E01019033",786,366,133,233,378,51,127,61,40,26,93,41,50,2,103,76,27,4,4,42,10,32
"2021","Cornwall 039B","E01019041",832,314,133,181,466,45,157,59,78,20,111,57,49,5,147,94,53,6,6,52,21,31
"2021","Cornwall 039C","E01019042",783,300,122,178,441,62,192,71,81,40,97,42,47,8,84,61,23,6,6,42,19,23
"2021","Cornwall 039D","E01019043",849,234,115,119,568,122,267,95,121,51,85,44,32,9,92,59,33,2,2,47,19,28
"2021","Cornwall 039E","E01019044",716,240,180,60,454,115,205,97,68,40,76,48,24,4,57,23,34,1,1,22,4,18
"2021","Cornwall 039F","E01019046",610,212,128,84,368,42,140,60,55,25,88,54,27,7,94,48,46,4,4,30,10,20
"2021","Cornwall 041A","E01019038",538,198,116,82,312,88,133,83,30,20,55,44,10,1,34,21,13,2,2,28,6,22
"2021","Cornwall 041B","E01019039",602,174,114,60,397,137,183,75,66,42,44,29,13,2,31,21,10,2,2,31,12,19
"2021","Cornwall 041C","E01019040",582,167,84,83,383,111,170,75,70,25,66,29,30,7,33,19,14,3,3,32,8,24
"2021","Cornwall 041D","E01019066",600,159,87,72,405,85,206,92,66,48,63,37,25,1,50,23,27,1,1,36,8,28
"2021","Cornwall 041E","E01019067",607,189,108,81,391,100,196,71,84,41,48,31,15,2,46,31,15,1,1,27,7,20
"2021","Cornwall 041F","E01019068",750,231,161,70,488,166,235,110,80,45,45,23,16,6,41,17,24,1,1,31,8,23
"2021","Isles of Scilly 001A","E01019077",942,307,162,145,563,132,275,147,110,18,101,77,21,3,53,32,21,2,2,72,20,52
"2021","Wiltshire 012A","E01031841",798,227,130,97,552,126,287,102,142,43,69,32,27,10,63,37,26,7,7,19,4,15
"2021","Wiltshire 012B","E01031868",722,169,77,92,511,104,287,112,127,48,64,38,19,7,54,31,23,2,2,42,19,23
"2021","Wiltshire 012C","E01031873",769,194,109,85,537,98,320,133,134,53,73,48,19,6,44,19,25,2,2,38,11,27
"2021","Wiltshire 012D","E01031874",669,189,108,81,455,113,255,85,127,43,33,17,10,6,50,25,25,4,4,25,12,13
"2021","Wiltshire 012E","E01031884",671,163,84,79,472,98,281,128,104,49,57,38,15,4,34,16,18,2,2,36,11,25
"2021","Wiltshire 019A","E01031861",1163,358,218,140,757,150,386,146,175,65,107,59,44,4,111,68,43,3,3,48,15,33
"2021","Wiltshire 019B","E01031862",709,274,130,144,403,47,179,69,80,30,81,45,30,6,93,53,40,3,3,32,11,21
"2021","Wiltshire 019C","E01031863",574,268,122,146,286,88,116,53,41,22,45,34,7,4,36,25,11,1,1,20,5,15
"2021","Wiltshire 019D","E01031864",518,141,88,53,366,83,222,82,98,42,30,11,19,0,31,19,12,0,0,11,5,6
"2021","Wiltshire 019E","E01031865",717,269,152,117,425,103,175,60,72,43,71,41,28,2,73,51,22,3,3,23,6,17
"2021","Wiltshire 024A","E01031866",695,178,90,88,483,111,264,113,105,46,60,43,16,1,48,26,22,0,0,34,14,20
"2021","Wiltshire 024B","E01031869",895,321,172,149,536,103,248,88,98,62,86,41,40,5,92,48,44,7,7,38,13,25
"2021","Wiltshire 024C","E01031870",899,319,169,150,545,140,258,134,93,31,77,52,22,3,65,35,30,5,5,35,11,24
"2021","Wiltshire 024D","E01031871",724,190,101,89,502,91,301,118,129,54,72,44,20,8,35,20,15,3,3,32,14,18
"2021","Wiltshire 025A","E01031850",989,400,219,181,560,128,222,96,87,39,126,73,47,6,83,48,35,1,1,29,8,21
"2021","Wiltshire 025B","E01031851",649,194,77,117,427,49,181,66,74,41,104,53,45,6,86,48,38,7,7,28,11,17
"2021","Wiltshire 025C","E01031852",856,205,119,86,616,120,315,124,135,56,104,57,44,3,76,45,31,1,1,35,14,21
"2021","Wiltshire 025E","E01032688",538,146,52,94,373,58,196,68,100,28,70,42,25,3,48,30,18,1,1,19,8,11
"2021","Wiltshire 025F","E01032689",552,147,81,66,383,76,178,66,81,31,69,25,35,9,58,36,22,2,2,22,9,13
"2021","Wiltshire 025G","E01032692",507,146,41,105,336,48,154,65,73,16,81,55,26,0,53,33,20,0,0,25,8,17
"2021","Wiltshire 025H","E01032693",749,202,57,145,509,71,222,81,112,29,114,53,53,8,97,76,21,5,5,38,21,17
"2021","Wiltshire 026A","E01031853",716,261,135,126,426,87,191,84,57,50,76,34,42,0,67,50,17,5,5,29,8,21
"2021","Wiltshire 026B","E01031854",1070,591,282,309,448,92,169,97,45,27,98,67,28,3,78,46,32,11,11,31,12,19
"2021","Wiltshire 026C","E01031855",665,179,116,63,459,141,247,104,91,52,36,19,13,4,33,12,21,2,2,27,7,20
"2021","Wiltshire 026D","E01031856",777,293,154,139,454,103,183,73,68,42,78,40,31,7,85,58,27,5,5,30,15,15
"2021","Wiltshire 028A","E01031845",733,194,103,91,513,133,258,107,80,71,75,48,25,2,45,24,21,2,2,26,3,23
"2021","Wiltshire 028B","E01031846",703,202,107,95,473,100,252,119,87,46,64,42,21,1,52,30,22,5,5,28,11,17
"2021","Wiltshire 028C","E01031848",736,157,95,62,548,123,299,134,106,59,70,50,18,2,55,35,20,1,1,31,12,19
"2021","Wiltshire 028D","E01031872",673,180,105,75,465,111,240,115,77,48,54,26,23,5,59,34,25,1,1,28,10,18
"2021","Wiltshire 028E","E01031876",668,169,84,85,462,128,216,98,84,34,66,44,17,5,52,24,28,0,0,37,12,25
"2021","Wiltshire 029A","E01031843",798,238,134,104,542,115,300,106,136,58,60,39,17,4,64,44,20,3,3,18,5,13
"2021","Wiltshire 029B","E01031847",793,186,95,91,579,135,321,111,152,58,65,35,28,2,56,36,20,2,2,28,10,18
"2021","Wiltshire 029C","E01031849",688,163,74,89,490,80,283,133,112,38,84,52,27,5,39,22,17,4,4,35,10,25
"2021","Wiltshire 029D","E01031877",815,168,97,71,603,138,353,139,156,58,67,45,16,6,41,21,20,4,4,44,15,29
"2021","Wiltshire 034B","E01031857",639,178,87,91,435,68,242,101,82,59,59,34,21,4,65,36,29,1,1,26,12,14
"2021","Wiltshire 034C","E01031858",711,195,108,87,491,101,252,107,98,47,70,39,30,1,65,36,29,3,3,25,9,16
"2021","Wiltshire 034D","E01031883",862,216,138,78,616,165,316,145,122,49,59,42,16,1,71,45,26,5,5,30,11,19
"2021","Wiltshire 034E","E01034538",568,148,66,82,400,93,197,93,80,24,58,30,23,5,52,33,19,0,0,20,10,10
"2021","Wiltshire 034F","E01034539",670,175,39,136,476,38,246,97,121,28,101,56,43,2,89,66,23,2,2,19,4,15
"2021","Wiltshire 038A","E01031842",812,192,87,105,586,122,336,151,127,58,74,40,28,6,53,26,27,1,1,34,14,20
"2021","Wiltshire 038B","E01031867",795,210,101,109,560,100,301,139,106,56,91,59,25,7,64,29,35,4,4,25,13,12
"2021","Wiltshire 038C","E01031882",834,221,134,87,583,120,348,160,144,44,62,41,13,8,52,31,21,1,1,30,13,17
"2021","Wiltshire 001A","E01031887",746,195,121,74,519,107,293,110,140,43,67,32,27,8,52,26,26,0,0,32,12,20
"2021","Wiltshire 001B","E01031934",784,160,104,56,589,138,343,129,151,63,62,35,18,9,42,19,23,4,4,35,15,20
"2021","Wiltshire 001C","E01031935",756,198,112,86,521,123,291,129,106,56,68,34,26,8,39,17,22,0,0,37,11,26
"2021","Wiltshire 001D","E01031936",654,224,120,104,402,62,188,74,79,35,69,36,26,7,81,49,32,2,2,28,9,19
"2021","Wiltshire 002A","E01031885",705,158,75,83,518,105,294,110,138,46,66,36,29,1,50,30,20,3,3,29,11,18
"2021","Wiltshire 002B","E01031947",744,278,177,101,431,68,204,60,99,45,63,26,33,4,96,57,39,0,0,35,9,26
"2021","Wiltshire 002C","E01031948",1034,226,95,131,740,91,421,136,230,55,126,60,60,6,98,70,28,4,4,68,22,46
"2021","Wiltshire 002D","E01031949",864,310,131,179,524,93,256,104,108,44,108,73,30,5,64,42,22,3,3,30,4,26
"2021","Wiltshire 003B","E01031955",664,163,100,63,481,112,278,118,98,62,57,33,17,7,33,15,18,1,1,20,7,13
"2021","Wiltshire 003C","E01031956",571,155,78,77,383,49,187,88,66,33,71,32,33,6,74,46,28,2,2,33,7,26
"2021","Wiltshire 003D","E01031962",571,108,76,32,438,113,266,106,98,62,39,24,13,2,20,7,13,0,0,25,11,14
"2021","Wiltshire 003E","E01034520",665,168,86,82,466,77,266,98,115,53,77,40,32,5,46,28,18,0,0,31,14,17
"2021","Wiltshire 003F","E01034521",762,108,10,98,624,15,362,55,287,20,162,70,87,5,80,65,15,5,5,30,17,13
"2021","Wiltshire 004A","E01031886",581,112,64,48,442,119,235,86,101,48,63,39,18,6,24,16,8,1,1,27,7,20
"2021","Wiltshire 004B","E01031892",589,122,71,51,428,111,241,100,102,39,50,31,16,3,25,18,7,1,1,39,16,23
"2021","Wiltshire 004C","E01031893",664,122,65,57,502,95,307,135,115,57,63,34,25,4,36,13,23,1,1,40,11,29
"2021","Wiltshire 004D","E01031894",634,120,73,47,484,120,270,99,116,55,56,37,17,2,36,24,12,2,2,30,12,18
"2021","Wiltshire 005A","E01031957",638,176,97,79,435,73,261,105,122,34,53,31,21,1,48,22,26,0,0,27,7,20
"2021","Wiltshire 005B","E01031958",594,160,97,63,405,90,251,85,115,51,37,23,12,2,25,14,11,2,2,29,11,18
"2021","Wiltshire 005C","E01031959",830,252,140,112,548,128,298,120,133,45,82,47,29,6,39,28,11,1,1,30,11,19
"2021","Wiltshire 005D","E01031960",575,96,48,48,454,75,296,103,160,33,52,23,23,6,30,18,12,1,1,25,10,15
"2021","Wiltshire 006A","E01031963",861,236,114,122,576,77,238,66,126,46,115,46,58,11,143,84,59,3,3,49,23,26
"2021","Wiltshire 006B","E01031964",882,282,139,143,568,124,274,111,108,55,90,50,30,10,76,41,35,4,4,32,13,19
"2021","Wiltshire 006C","E01031967",1008,377,166,211,597,68,296,113,133,50,121,75,38,8,110,68,42,2,2,34,13,21
"2021","Wiltshire 006D","E01031969",587,142,50,92,431,68,275,103,111,61,58,38,19,1,28,18,10,2,2,14,8,6
"2021","Wiltshire 007B","E01031944",461,103,39,64,330,63,193,97,63,33,41,27,10,4,31,18,13,2,2,28,14,14
"2021","Wiltshire 007D","E01031946",467,54,7,47,398,8,315,76,220,19,47,19,23,5,28,22,6,0,0,15,8,7
"2021","Wiltshire 007E","E01031961",561,118,59,59,411,102,239,103,87,49,47,33,13,1,21,12,9,2,2,32,14,18
"2021","Wiltshire 007F","E01031965",628,186,105,81,413,112,196,68,82,46,57,34,18,5,47,19,28,1,1,29,12,17
"2021","Wiltshire 007G","E01031966",1116,254,114,140,825,126,450,156,240,54,130,64,59,7,114,83,31,5,5,37,15,22
"2021","Wiltshire 007H","E01031968",758,211,98,113,515,122,277,101,115,61,62,42,17,3,51,33,18,3,3,32,11,21
"2021","Wiltshire 007I","E01032699",988,289,157,132,667,153,378,179,141,58,87,56,28,3,43,22,21,6,6,32,14,18
"2021","Wiltshire 008A","E01031939",973,190,123,67,731,143,422,180,178,64,86,39,40,7,78,40,38,2,2,52,30,22
"2021","Wiltshire 008B","E01031940",947,258,157,101,651,129,379,144,164,71,82,53,24,5,59,30,29,2,2,38,21,17
"2021","Wiltshire 008C","E01031950",570,119,59,60,423,73,267,120,112,35,62,35,22,5,19,10,9,2,2,28,11,17
"2021","Wiltshire 008D","E01031951",468,97,64,33,343,73,181,75,75,31,57,35,19,3,31,15,16,1,1,28,16,12
"2021","Wiltshire 009A","E01031907",936,186,62,124,712,84,451,161,204,86,105,61,37,7,68,48,20,4,4,38,17,21
"2021","Wiltshire 009B","E01031910",642,174,50,124,444,54,227,74,117,36,80,48,27,5,80,49,31,3,3,24,11,13
"2021","Wiltshire 009C","E01031914",515,123,48,75,357,24,150,47,72,31,72,24,40,8,107,72,35,4,4,35,20,15
"2021","Wiltshire 009D","E01031915",709,230,108,122,455,67,221,79,98,44,117,79,35,3,47,30,17,3,3,24,10,14
"2021","Wiltshire 009E","E01031919",607,95,59,36,487,107,279,78,144,57,57,23,29,5,43,26,17,1,1,25,15,10
"2021","Wiltshire 009F","E01031920",537,172,61,111,340,34,184,63,84,37,78,45,29,4,41,18,23,3,3,25,8,17
"2021","Wiltshire 010A","E01031905",502,74,28,46,400,67,265,105,106,54,41,18,19,4,26,11,15,1,1,28,14,14
"2021","Wiltshire 010B","E01031906",642,208,57,151,413,28,206,88,86,32,115,86,25,4,60,35,25,4,4,21,6,15
"2021","Wiltshire 010C","E01031908",733,202,69,133,501,52,219,68,114,37,116,53,58,5,108,69,39,6,6,30,8,22
"2021","Wiltshire 010D","E01031909",533,125,80,45,391,94,211,65,95,51,52,27,20,5,31,13,18,3,3,17,4,13
"2021","Wiltshire 010E","E01031925",574,187,97,90,355,29,186,55,97,34,56,25,26,5,76,54,22,8,8,32,12,20
"2021","Wiltshire 010F","E01031926",622,155,89,66,441,59,227,75,103,49,85,41,37,7,70,45,25,0,0,26,10,16
"2021","Wiltshire 010G","E01031927",505,92,57,35,396,98,224,71,101,52,40,21,16,3,32,17,15,2,2,17,7,10
"2021","Wiltshire 011A","E01031911",561,173,76,97,355,27,166,52,79,35,83,40,38,5,75,42,33,4,4,33,14,19
"2021","Wiltshire 011B","E01031912",904,511,191,320,348,41,136,67,55,14,85,61,18,6,80,59,21,6,6,45,9,36
"2021","Wiltshire 011C","E01031913",653,171,75,96,448,82,255,94,119,42,65,46,18,1,46,29,17,0,0,34,14,20
"2021","Wiltshire 011D","E01031917",706,310,82,228,361,39,152,73,56,23,87,57,26,4,73,50,23,10,10,35,12,23
"2021","Wiltshire 011E","E01031918",1164,395,222,173,733,175,351,130,155,66,120,83,34,3,83,53,30,4,4,36,8,28
"2021","Wiltshire 011F","E01031928",597,246,110,136,318,50,122,36,52,34,51,23,25,3,93,53,40,2,2,33,6,27
"2021","Wiltshire 013B","E01031904",1044,201,108,93,808,149,477,207,185,85,119,68,45,6,61,38,23,2,2,35,13,22
"2021","Wiltshire 013C","E01031937",466,106,66,40,340,65,186,88,67,31,50,30,14,6,38,17,21,1,1,20,9,11
"2021","Wiltshire 013D","E01031938",637,120,57,63,493,76,289,127,125,37,89,60,24,5,37,23,14,2,2,24,9,15
"2021","Wiltshire 013E","E01034522",577,114,67,47,437,94,253,105,98,50,52,26,23,3,38,20,18,0,0,26,8,18
"2021","Wiltshire 013F","E01034523",633,178,91,87,422,67,195,86,80,29,123,90,28,5,36,17,19,1,1,33,13,20
"2021","Wiltshire 014A","E01031916",553,142,73,69,386,54,202,76,91,35,66,32,29,5,63,44,19,1,1,25,14,11
"2021","Wiltshire 014B","E01031921",543,115,48,67,411,39,268,116,107,45,56,33,19,4,48,22,26,0,0,17,8,9
"2021","Wiltshire 014C","E01031922",600,238,65,173,342,27,192,85,79,28,79,47,25,7,41,25,16,3,3,20,8,12
"2021","Wiltshire 014D","E01031923",531,130,46,84,383,61,224,80,85,59,62,38,23,1,33,18,15,3,3,18,3,15
"2021","Wiltshire 014E","E01031924",664,176,41,135,463,30,285,94,136,55,85,54,27,4,60,29,31,3,3,25,9,16
"2021","Wiltshire 015A","E01031895",1032,222,103,119,750,85,346,131,146,69,184,113,58,13,129,94,35,6,6,60,28,32
"2021","Wiltshire 015B","E01031896",683,271,107,164,375,35,157,62,64,31,103,51,46,6,77,53,24,3,3,37,13,24
"2021","Wiltshire 015C","E01031897",844,226,89,137,591,100,319,121,143,55,96,52,40,4,75,48,27,1,1,27,9,18
"2021","Wiltshire 015D","E01031898",644,196,95,101,424,68,204,79,90,35,68,37,30,1,82,50,32,2,2,24,9,15
"2021","Wiltshire 015F","E01032690",704,161,44,117,510,38,292,89,168,35,102,48,48,6,74,54,20,4,4,33,15,18
"2021","Wiltshire 015G","E01032691",600,168,70,98,408,39,231,80,116,35,80,45,33,2,55,37,18,3,3,24,9,15
"2021","Wiltshire 016B","E01031901",664,235,105,130,407,44,192,82,81,29,80,53,22,5,88,61,27,3,3,22,8,14
"2021","Wiltshire 016C","E01031902",758,191,70,121,542,53,283,118,133,32,129,65,61,3,74,48,26,3,3,25,9,16
"2021","Wiltshire 016D","E01031903",1004,251,130,121,720,159,374,167,141,66,129,79,42,8,57,28,29,1,1,33,9,24
"2021","Wiltshire 016E","E01034524",636,265,152,113,357,124,147,81,45,21,42,27,11,4,44,32,12,0,0,14,5,9
"2021","Wiltshire 016F","E01034525",575,162,60,102,406,62,219,112,65,42,74,39,30,5,51,29,22,0,0,7,2,5
"2021","Wiltshire 017A","E01031888",587,152,81,71,409,92,237,82,117,38,57,31,21,5,21,9,12,2,2,26,11,15
"2021","Wiltshire 017B","E01031889",1025,251,82,169,727,56,378,133,210,35,162,89,67,6,129,80,49,2,2,47,23,24
"2021","Wiltshire 017C","E01031890",756,208,135,73,526,124,266,94,132,40,84,49,30,5,50,31,19,2,2,22,5,17
"2021","Wiltshire 017D","E01031929",566,150,92,58,403,94,216,69,99,48,46,23,22,1,46,20,26,1,1,13,3,10
"2021","Wiltshire 017E","E01031930",456,59,22,37,377,21,263,71,172,20,53,31,19,3,40,32,8,0,0,20,11,9
"2021","Wiltshire 018A","E01031931",844,245,133,112,567,129,293,99,155,39,80,58,20,2,60,32,28,5,5,32,13,19
"2021","Wiltshire 018B","E01031932",714,237,152,85,461,114,235,94,102,39,55,33,19,3,55,35,20,2,2,16,4,12
"2021","Wiltshire 018C","E01031933",703,173,78,95,504,70,235,67,129,39,100,45,50,5,98,64,34,1,1,26,13,13
"2021","Wiltshire 018D","E01031941",715,179,106,73,511,128,275,104,128,43,62,34,23,5,43,29,14,3,3,25,11,14
"2021","Wiltshire 018E","E01031942",540,112,67,45,396,81,229,104,85,40,47,28,15,4,37,23,14,2,2,32,10,22
"2021","Wiltshire 018F","E01031952",1141,462,207,255,624,87,245,95,117,33,129,68,53,8,150,95,55,13,13,55,15,40
"2021","Wiltshire 018H","E01034526",597,185,94,91,390,96,178,60,81,37,51,31,15,5,64,36,28,1,1,22,8,14
"2021","Wiltshire 018I","E01034527",605,144,50,94,444,41,253,69,149,35,72,40,30,2,78,57,21,0,0,17,6,11
"2021","Wiltshire 045B","E01031988",735,54,2,52,658,2,570,134,418,18,54,31,22,1,29,22,7,3,3,23,20,3
"2021","Wiltshire 045D","E01032026",702,175,109,66,499,95,297,141,108,48,64,43,18,3,41,19,22,2,2,28,13,15
"2021","Wiltshire 045F","E01032696",876,198,99,99,632,92,376,156,161,59,84,53,26,5,78,40,38,2,2,46,16,30
"2021","Wiltshire 045G","E01034542",412,74,1,73,319,1,233,50,179,4,62,37,24,1,21,21,0,2,2,19,12,7
"2021","Wiltshire 045H","E01034543",408,32,2,30,350,1,283,60,207,16,52,25,25,2,14,12,2,0,0,26,20,6
"2021","Wiltshire 046A","E01031989",750,143,78,65,563,55,373,89,236,48,72,35,36,1,58,32,26,5,5,44,23,21
"2021","Wiltshire 046B","E01031996",580,141,78,63,404,59,209,71,90,48,54,32,16,6,79,41,38,3,3,35,14,21
"2021","Wiltshire 046C","E01031997",593,160,67,93,401,67,223,100,75,48,63,33,23,7,47,23,24,1,1,32,11,21
"2021","Wiltshire 046D","E01031999",954,207,94,113,715,122,406,117,223,66,103,57,39,7,79,50,29,5,5,32,13,19
"2021","Wiltshire 048A","E01031974",610,200,139,61,377,98,202,104,56,42,38,18,18,2,39,18,21,0,0,33,17,16
"2021","Wiltshire 048B","E01031975",528,174,112,62,316,53,126,45,51,30,54,19,27,8,79,40,39,4,4,38,14,24
"2021","Wiltshire 048C","E01031976",867,165,25,140,657,30,381,88,243,50,140,62,72,6,105,80,25,1,1,45,24,21
"2021","Wiltshire 048E","E01031978",682,171,58,113,476,48,240,92,99,49,100,53,43,4,84,54,30,4,4,35,15,20
"2021","Wiltshire 048F","E01031979",951,329,170,159,583,109,287,137,106,44,107,75,28,4,76,42,34,4,4,39,8,31
"2021","Wiltshire 048G","E01034544",667,198,104,94,425,68,240,113,81,46,60,35,19,6,55,24,31,2,2,44,13,31
"2021","Wiltshire 048H","E01034545",493,116,47,69,337,19,194,58,116,20,65,30,30,5,58,40,18,1,1,40,20,20
"2021","Wiltshire 048I","E01034546",542,88,6,82,418,6,236,59,163,14,114,74,38,2,61,53,8,1,1,36,19,17
"2021","Wiltshire 049A","E01032013",847,204,118,86,595,104,328,144,127,57,86,48,35,3,73,50,23,4,4,48,16,32
"2021","Wiltshire 049B","E01032032",675,168,114,54,485,117,286,124,105,57,49,33,9,7,33,14,19,0,0,22,3,19
"2021","Wiltshire 049C","E01032033",584,126,69,57,430,108,231,96,90,45,57,32,23,2,33,16,17,1,1,28,12,16
"2021","Wiltshire 049D","E01032034",601,133,86,47,442,95,270,102,127,41,47,26,17,4,30,11,19,0,0,26,10,16
"2021","Wiltshire 050A","E01032010",941,256,155,101,643,175,308,154,104,50,110,56,41,13,49,21,28,1,1,42,15,27
"2021","Wiltshire 050B","E01032035",746,212,157,55,501,170,231,119,76,36,66,38,22,6,33,14,19,1,1,33,11,22
"2021","Wiltshire 050C","E01032036",647,181,103,78,447,117,213,101,67,45,61,36,19,6,55,33,22,1,1,19,9,10
"2021","Wiltshire 050D","E01032037",739,281,147,134,436,105,180,80,65,35,85,54,29,2,66,41,25,0,0,22,4,18
"2021","Wiltshire 051A","E01031984",1094,243,83,160,815,84,450,129,267,54,149,79,64,6,129,96,33,3,3,36,19,17
"2021","Wiltshire 051B","E01031985",530,156,79,77,338,34,167,51,89,27,66,31,27,8,68,37,31,3,3,36,14,22
"2021","Wiltshire 051C","E01031986",600,253,125,128,316,55,141,56,59,26,54,26,26,2,63,34,29,3,3,31,9,22
"2021","Wiltshire 051D","E01032017",617,157,99,58,440,99,253,77,118,58,44,19,20,5,44,22,22,0,0,20,9,11
"2021","Wiltshire 052A","E01031980",1029,222,71,151,744,36,346,102,208,36,215,117,90,8,142,108,34,5,5,63,33,30
"2021","Wiltshire 052B","E01031981",609,142,63,79,408,35,150,54,63,33,94,34,51,9,124,84,40,5,5,59,22,37
"2021","Wiltshire 052C","E01031982",572,127,71,56,413,60,212,78,81,53,61,30,25,6,75,40,35,5,5,32,12,20
"2021","Wiltshire 052D","E01031983",786,214,68,146,514,46,193,59,99,35,110,34,68,8,161,115,46,4,4,58,20,38
"2021","Wiltshire 053A","E01032018",636,112,74,38,497,135,277,100,117,60,43,22,16,5,42,20,22,0,0,27,14,13
"2021","Wiltshire 053B","E01032019",644,250,144,106,366,56,176,61,83,32,55,27,25,3,78,45,33,1,1,28,8,20
"2021","Wiltshire 053C","E01032020",627,175,106,69,415,84,234,85,112,37,44,20,17,7,53,22,31,0,0,37,7,30
"2021","Wiltshire 053D","E01032025",650,208,104,104,402,71,228,111,78,39,49,31,14,4,49,16,33,5,5,40,16,24
"2021","Wiltshire 054A","E01031990",826,191,117,74,602,146,336,142,126,68,57,29,20,8,57,34,23,6,6,33,16,17
"2021","Wiltshire 054B","E01032004",1029,277,157,120,708,160,377,174,137,66,99,62,34,3,66,32,34,6,6,44,12,32
"2021","Wiltshire 054C","E01032027",625,185,122,63,410,107,218,105,67,46,51,37,12,2,31,16,15,3,3,30,4,26
"2021","Wiltshire 054D","E01032038",644,227,149,78,403,114,194,79,88,27,61,41,15,5,31,14,17,3,3,14,2,12
"2021","Wiltshire 054E","E01032039",1016,385,162,223,587,83,279,107,141,31,138,85,47,6,84,56,28,3,3,44,13,31
"2021","Wiltshire 054F","E01032040",614,184,108,76,401,79,182,69,79,34,69,31,31,7,67,29,38,4,4,29,8,21
"2021","Wiltshire 055A","E01032001",625,178,94,84,403,77,223,80,98,45,58,33,20,5,44,24,20,1,1,44,9,35
"2021","Wiltshire 055B","E01032002",609,229,93,136,332,46,165,83,60,22,81,54,20,7,35,17,18,5,5,48,9,39
"2021","Wiltshire 055C","E01032003",878,397,181,216,419,66,179,75,91,13,106,73,30,3,58,35,23,10,10,62,16,46
"2021","Wiltshire 055D","E01032024",1150,452,116,336,630,59,274,97,140,37,177,121,50,6,107,69,38,13,13,68,18,50
"2021","Wiltshire 056A","E01032014",1016,521,276,245,428,88,157,66,68,23,108,82,23,3,65,40,25,10,10,67,12,55
"2021","Wiltshire 056B","E01032015",578,199,64,135,340,38,169,65,71,33,62,41,17,4,68,45,23,3,3,39,7,32
"2021","Wiltshire 056C","E01032016",624,220,92,128,360,61,165,65,81,19,76,55,21,0,54,27,27,4,4,44,16,28
"2021","Wiltshire 056D","E01032021",738,256,98,158,430,69,193,91,78,24,106,68,33,5,56,32,24,6,6,52,11,41
"2021","Wiltshire 057A","E01032000",905,257,135,122,594,154,307,117,136,54,73,39,31,3,57,25,32,3,3,54,16,38
"2021","Wiltshire 057C","E01032012",762,211,162,49,514,172,259,86,121,52,41,23,16,2,40,19,21,2,2,37,9,28
"2021","Wiltshire 057D","E01034547",533,115,8,107,394,14,203,54,134,15,111,61,49,1,66,60,6,0,0,24,11,13
"2021","Wiltshire 057E","E01034548",566,97,38,59,441,44,269,68,165,36,70,29,41,0,58,41,17,0,0,28,11,17
"2021","Wiltshire 057F","E01034549",545,139,16,123,371,4,176,43,120,13,88,44,41,3,99,82,17,4,4,35,13,22
"2021","Wiltshire 057G","E01034550",486,132,58,74,327,67,163,55,76,32,44,22,19,3,52,33,19,1,1,27,11,16
"2021","Wiltshire 058A","E01032008",672,238,127,111,398,72,193,64,93,36,65,31,29,5,68,28,40,0,0,36,9,27
"2021","Wiltshire 058B","E01032009",866,288,207,81,546,183,237,113,89,35,75,45,24,6,43,20,23,8,8,32,15,17
"2021","Wiltshire 058C","E01032022",981,525,263,262,384,95,140,68,56,16,84,65,18,1,59,35,24,6,6,72,13,59
"2021","Wiltshire 059A","E01032005",530,144,94,50,360,67,211,78,106,27,36,20,13,3,45,26,19,1,1,26,12,14
"2021","Wiltshire 059B","E01032006",498,123,78,45,349,62,213,68,114,31,37,20,14,3,35,16,19,2,2,26,8,18
"2021","Wiltshire 059C","E01032007",702,180,56,124,484,46,277,86,155,36,76,40,31,5,84,57,27,1,1,38,12,26
"2021","Wiltshire 059D","E01032023",828,358,185,173,407,61,152,57,70,25,83,43,36,4,104,71,33,7,7,63,16,47
"2021","Wiltshire 060A","E01031970",710,169,98,71,509,129,262,117,108,37,85,50,29,6,30,16,14,3,3,32,11,21
"2021","Wiltshire 060B","E01031971",511,128,61,67,353,60,186,75,77,34,58,41,16,1,47,29,18,2,2,30,10,20
"2021","Wiltshire 060C","E01031972",626,126,86,40,465,104,275,104,115,56,49,31,14,4,36,19,17,1,1,35,19,16
"2021","Wiltshire 060D","E01032041",816,181,117,64,596,158,354,134,142,78,58,37,17,4,25,9,16,1,1,39,16,23
"2021","Wiltshire 060E","E01032042",700,152,88,64,518,110,306,118,135,53,58,41,12,5,43,24,19,1,1,30,8,22
"2021","Wiltshire 061A","E01031991",851,228,130,98,583,148,323,159,116,48,69,41,24,4,43,26,17,0,0,40,10,30
"2021","Wiltshire 061B","E01032029",618,170,106,64,420,106,220,103,68,49,55,31,20,4,37,21,16,2,2,28,9,19
"2021","Wiltshire 061C","E01032030",808,314,176,138,471,99,226,94,77,55,70,40,24,6,72,46,26,4,4,23,8,15
"2021","Wiltshire 061D","E01032031",516,129,86,43,373,98,191,95,69,27,49,30,19,0,33,16,17,2,2,14,2,12
"2021","Wiltshire 062A","E01031973",731,142,90,52,539,130,325,135,134,56,56,28,24,4,28,16,12,0,0,50,21,29
"2021","Wiltshire 062B","E01031992",625,140,101,39,451,138,243,109,95,39,39,18,16,5,30,13,17,1,1,34,15,19
"2021","Wiltshire 062C","E01031993",628,179,124,55,425,98,198,65,85,48,65,42,21,2,64,30,34,0,0,24,6,18
"2021","Wiltshire 062D","E01031994",525,122,71,51,384,80,204,74,90,40,53,22,23,8,45,26,19,2,2,19,7,12
"2021","Wiltshire 062E","E01031995",840,252,124,128,567,127,290,99,145,46,82,55,22,5,67,41,26,1,1,21,13,8
"2021","Wiltshire 020A","E01032063",940,249,96,153,643,109,285,101,129,55,124,69,47,8,120,80,40,5,5,48,20,28
"2021","Wiltshire 020B","E01032064",521,132,58,74,362,34,153,48,68,37,85,34,39,12,87,56,31,3,3,27,17,10
"2021","Wiltshire 020C","E01032065",660,178,98,80,446,74,213,80,80,53,84,48,35,1,75,50,25,0,0,36,13,23
"2021","Wiltshire 020D","E01032073",592,161,52,109,410,43,201,63,104,34,83,38,40,5,77,58,19,6,6,21,11,10
"2021","Wiltshire 020E","E01032074",602,187,124,63,388,125,182,82,69,31,50,20,24,6,29,17,12,2,2,27,8,19
"2021","Wiltshire 021A","E01032043",531,137,100,37,381,95,181,69,84,28,54,33,18,3,49,21,28,2,2,13,5,8
"2021","Wiltshire 021B","E01032044",623,139,90,49,441,118,224,100,91,33,63,24,36,3,35,21,14,1,1,43,18,25
"2021","Wiltshire 021C","E01032057",508,128,80,48,354,79,200,62,104,34,40,25,11,4,32,17,15,3,3,26,9,17
"2021","Wiltshire 021D","E01032070",822,256,125,131,527,104,218,88,82,48,108,62,42,4,94,64,30,3,3,39,14,25
"2021","Wiltshire 021F","E01032072",765,159,61,98,572,76,332,126,134,72,88,44,35,9,74,56,18,2,2,34,14,20
"2021","Wiltshire 021G","E01034528",570,100,41,59,434,77,238,90,114,34,76,39,32,5,41,18,23,2,2,36,18,18
"2021","Wiltshire 021H","E01034529",552,105,25,80,433,29,238,71,139,28,91,39,46,6,73,61,12,2,2,14,6,8
"2021","Wiltshire 021I","E01034530",646,100,55,45,524,88,312,97,147,68,88,53,29,6,35,17,18,1,1,22,9,13
"2021","Wiltshire 022A","E01032062",877,404,161,243,442,54,166,63,67,36,115,54,53,8,99,65,34,8,8,31,7,24
"2021","Wiltshire 022B","E01032066",701,196,100,96,478,58,236,72,116,48,91,48,38,5,88,47,41,5,5,27,12,15
"2021","Wiltshire 022C","E01032067",656,206,117,89,416,116,198,72,69,57,52,33,17,2,47,31,16,3,3,34,9,25
"2021","Wiltshire 022D","E01032068",728,344,208,136,363,92,161,64,69,28,62,36,21,5,44,20,24,4,4,21,6,15
"2021","Wiltshire 022E","E01032069",507,105,60,45,378,79,205,82,71,52,56,27,27,2,38,15,23,0,0,24,6,18
"2021","Wiltshire 023A","E01032058",613,199,101,98,396,88,201,75,88,38,61,32,21,8,45,31,14,1,1,18,7,11
"2021","Wiltshire 023B","E01032059",768,171,116,55,568,138,338,119,152,67,56,38,17,1,34,20,14,2,2,29,8,21
"2021","Wiltshire 023C","E01032060",687,204,140,64,456,129,250,82,127,41,43,22,17,4,32,17,15,2,2,27,11,16
"2021","Wiltshire 023D","E01032061",523,151,109,42,349,99,175,75,74,26,40,26,12,2,32,20,12,3,3,23,7,16
"2021","Wiltshire 027A","E01032045",702,174,111,63,506,110,280,94,139,47,55,30,24,1,59,33,26,2,2,22,7,15
"2021","Wiltshire 027B","E01032046",708,232,123,109,450,87,219,72,107,40,74,38,28,8,70,42,28,0,0,26,7,19
"2021","Wiltshire 027C","E01032047",643,194,122,72,426,101,238,73,129,36,44,18,24,2,43,23,20,0,0,23,9,14
"2021","Wiltshire 027D","E01032048",762,252,164,88,480,108,224,69,112,43,69,30,31,8,71,40,31,8,8,30,10,20
"2021","Wiltshire 027E","E01032049",737,250,153,97,471,123,212,88,93,31,62,36,19,7,72,37,35,2,2,16,4,12
"2021","Wiltshire 027G","E01034531",623,293,145,148,320,77,133,62,57,14,67,48,18,1,43,27,16,0,0,10,1,9
"2021","Wiltshire 027H","E01034532",594,221,111,110,356,81,173,78,70,25,65,48,17,0,36,22,14,1,1,17,4,13
"2021","Wiltshire 030A","E01032077",769,194,97,97,546,114,295,137,100,58,86,48,29,9,48,28,20,3,3,29,11,18
"2021","Wiltshire 030B","E01032078",1195,334,103,231,802,84,411,142,220,49,159,91,57,11,145,99,46,3,3,59,23,36
"2021","Wiltshire 030C","E01032079",646,165,104,61,445,90,236,93,94,49,53,27,20,6,64,33,31,2,2,36,13,23
"2021","Wiltshire 030D","E01032080",709,136,60,76,536,65,333,109,168,56,83,30,48,5,54,42,12,1,1,37,13,24
"2021","Wiltshire 031A","E01032085",701,220,76,144,438,65,235,89,104,42,87,43,40,4,45,20,25,6,6,43,10,33
"2021","Wiltshire 031C","E01032087",984,331,158,173,576,130,243,94,94,55,107,55,50,2,90,45,45,6,6,77,24,53
"2021","Wiltshire 031D","E01034533",954,388,103,285,500,39,192,62,98,32,145,82,58,5,111,82,29,13,13,66,26,40
"2021","Wiltshire 031E","E01034534",579,304,89,215,242,15,66,29,35,2,91,75,16,0,64,55,9,6,6,33,9,24
"2021","Wiltshire 032B","E01032100",775,227,115,112,501,102,246,101,115,30,84,42,38,4,67,39,28,2,2,47,16,31
"2021","Wiltshire 032C","E01032101",849,383,166,217,426,60,184,81,74,29,92,53,28,11,80,55,25,10,10,40,10,30
"2021","Wiltshire 032D","E01032102",1022,243,130,113,734,127,375,140,182,53,121,48,70,3,110,72,38,1,1,45,16,29
"2021","Wiltshire 032E","E01034535",539,121,65,56,394,111,195,48,114,33,51,29,22,0,36,24,12,1,1,24,7,17
"2021","Wiltshire 032F","E01034536",530,116,27,89,384,28,185,50,117,18,86,39,42,5,83,66,17,2,2,30,17,13
"2021","Wiltshire 032G","E01034537",527,87,13,74,421,17,266,53,187,26,79,41,36,2,57,46,11,2,2,19,9,10
"2021","Wiltshire 033A","E01032096",795,242,94,148,502,42,194,47,96,51,103,40,53,10,159,92,67,4,4,51,23,28
"2021","Wiltshire 033B","E01032097",768,172,111,61,563,124,311,122,119,70,79,40,31,8,44,16,28,5,5,33,15,18
"2021","Wiltshire 033C","E01032098",629,140,88,52,438,81,242,84,102,56,51,20,27,4,61,32,29,3,3,51,17,34
"2021","Wiltshire 035A","E01032092",679,199,79,120,456,84,227,111,77,39,87,62,23,2,56,35,21,2,2,24,10,14
"2021","Wiltshire 035B","E01032093",1002,267,90,177,680,59,317,108,157,52,141,64,66,11,163,115,48,0,0,55,20,35
"2021","Wiltshire 035C","E01032094",1040,331,103,228,632,48,270,97,140,33,180,90,82,8,127,87,40,7,7,77,30,47
"2021","Wiltshire 035D","E01032095",730,180,89,91,506,92,275,87,126,62,77,43,31,3,60,30,30,2,2,44,18,26
"2021","Wiltshire 036A","E01032088",626,160,102,58,440,101,225,87,91,47,66,30,27,9,48,17,31,0,0,26,6,20
"2021","Wiltshire 036B","E01032089",672,229,51,178,390,18,168,63,78,27,102,69,25,8,86,48,38,16,16,53,14,39
"2021","Wiltshire 036C","E01032090",648,212,109,103,404,60,176,63,81,32,77,42,29,6,87,49,38,4,4,32,11,21
"2021","Wiltshire 036D","E01032091",548,165,73,92,355,57,156,85,44,27,82,61,20,1,59,34,25,1,1,28,14,14
"2021","Wiltshire 037A","E01032053",613,162,98,64,427,109,221,79,100,42,55,33,19,3,39,21,18,3,3,24,12,12
"2021","Wiltshire 037B","E01032083",1023,234,131,103,727,169,346,141,145,60,122,58,56,8,87,53,34,3,3,62,29,33
"2021","Wiltshire 037D","E01034540",660,160,101,59,471,145,254,117,93,44,48,32,15,1,24,8,16,0,0,29,12,17
"2021","Wiltshire 037E","E01034541",626,126,59,67,469,62,229,84,116,29,93,39,51,3,83,61,22,2,2,31,17,14
"2021","Wiltshire 039A","E01032052",580,163,99,64,378,110,199,102,61,36,45,26,17,2,23,8,15,1,1,39,13,26
"2021","Wiltshire 039B","E01032054",533,146,74,72,357,67,175,68,74,33,62,28,28,6,51,28,23,2,2,30,8,22
"2021","Wiltshire 039C","E01032055",533,142,93,49,376,103,220,117,70,33,32,19,13,0,21,7,14,0,0,15,8,7
"2021","Wiltshire 039D","E01032056",555,149,73,76,369,93,185,68,70,47,47,22,23,2,42,26,16,2,2,37,12,25
"2021","Wiltshire 039E","E01032121",866,238,133,105,603,109,274,103,128,43,162,105,52,5,55,36,19,3,3,25,11,14
"2021","Wiltshire 042A","E01032104",560,154,85,69,373,48,145,58,51,36,55,18,31,6,121,79,42,4,4,33,15,18
"2021","Wiltshire 042B","E01032105",672,198,133,65,447,132,221,105,73,43,54,27,24,3,37,21,16,3,3,27,12,15
"2021","Wiltshire 042C","E01032107",430,58,6,52,355,5,266,53,198,15,65,38,27,0,19,15,4,0,0,17,11,6
"2021","Wiltshire 042D","E01032108",625,236,158,78,365,91,178,73,76,29,62,32,23,7,31,10,21,3,3,24,12,12
"2021","Wiltshire 043A","E01032110",997,230,122,108,711,148,351,129,159,63,123,64,54,5,88,44,44,1,1,56,17,39
"2021","Wiltshire 043B","E01032111",578,181,100,81,370,53,191,74,77,40,62,32,24,6,62,27,35,2,2,27,10,17
"2021","Wiltshire 043C","E01032112",624,175,78,97,415,57,199,81,88,30,83,38,38,7,72,44,28,4,4,34,14,20
"2021","Wiltshire 043D","E01032113",604,189,103,86,389,47,188,73,61,54,86,41,36,9,66,28,38,2,2,26,8,18
"2021","Wiltshire 044A","E01032103",923,431,200,231,449,94,184,91,62,31,90,51,37,2,73,31,42,8,8,43,12,31
"2021","Wiltshire 044B","E01032106",639,164,104,60,455,147,220,95,81,44,48,24,23,1,38,18,20,2,2,20,9,11
"2021","Wiltshire 044C","E01032109",684,239,117,122,415,75,180,82,66,32,89,55,32,2,69,37,32,2,2,30,12,18
"2021","Wiltshire 044D","E01032114",694,310,162,148,357,58,163,72,64,27,73,42,28,3,58,30,28,5,5,27,8,19
"2021","Wiltshire 047A","E01032051",590,136,83,53,426,123,217,85,95,37,50,23,21,6,34,19,15,2,2,28,8,20
"2021","Wiltshire 047B","E01032075",606,175,104,71,403,105,189,79,80,30,60,37,21,2,47,24,23,2,2,28,9,19
"2021","Wiltshire 047C","E01032076",540,155,96,59,353,107,173,70,62,41,39,21,15,3,32,15,17,2,2,32,9,23
"2021","Wiltshire 047D","E01032081",550,148,79,69,376,78,208,92,77,39,50,31,18,1,36,21,15,4,4,26,6,20
"2021","Wiltshire 047E","E01032082",530,139,85,54,372,90,205,111,63,31,52,33,15,4,23,9,14,2,2,19,6,13
"2021","Wiltshire 063D","E01032117",1078,252,105,147,784,107,387,144,178,65,156,68,79,9,134,80,54,0,0,42,13,29
"2021","Wiltshire 063C","E01032118",618,149,56,93,431,35,212,76,90,46,89,31,43,15,92,56,36,3,3,38,20,18
"2021","Wiltshire 063A","E01034551",723,163,75,88,535,75,254,89,119,46,134,70,60,4,69,49,20,3,3,25,13,12
"2021","Wiltshire 063B","E01034552",695,164,79,85,501,73,239,82,121,36,113,54,53,6,74,47,27,2,2,30,7,23
"2021","Wiltshire 064A","E01032115",828,361,158,203,433,72,178,79,68,31,111,62,43,6,71,46,25,1,1,34,10,24
"2021","Wiltshire 064B","E01032119",973,428,150,278,508,57,215,91,85,39,148,103,39,6,84,51,33,4,4,37,12,25
"2021","Wiltshire 064D","E01032694",698,131,32,99,521,32,267,90,134,43,109,49,55,5,113,88,25,0,0,46,19,27
"2021","Wiltshire 064C","E01032695",632,165,90,75,427,105,221,91,89,41,58,43,13,2,42,26,16,1,1,40,16,24
"2021","Wiltshire 065B","E01031859",745,276,108,168,424,66,191,90,67,34,74,47,23,4,87,55,32,6,6,45,14,31
"2021","Wiltshire 065A","E01031860",659,179,77,102,441,72,204,93,72,39,88,45,38,5,74,44,30,3,3,39,16,23
"2021","Wiltshire 065C","E01034553",541,90,24,66,424,25,285,68,198,19,50,22,26,2,61,54,7,3,3,27,15,12
"2021","Wiltshire 065D","E01034554",609,101,39,62,475,15,280,62,203,15,89,41,47,1,91,76,15,0,0,33,23,10
"2021","Wiltshire 065E","E01034555",596,91,29,62,461,36,301,92,180,29,74,44,25,5,47,38,9,3,3,44,12,32
"2021","Wiltshire 066A","E01031879",542,56,6,50,459,7,354,141,204,9,57,31,25,1,39,34,5,2,2,27,18,9
"2021","Wiltshire 066C","E01032697",622,175,24,151,400,7,211,42,155,14,70,33,36,1,107,82,25,5,5,47,22,25
"2021","Wiltshire 066B","E01034556",601,118,35,83,446,22,257,84,143,30,86,45,37,4,79,63,16,2,2,37,19,18
"2021","Wiltshire 066D","E01034557",458,54,18,36,364,10,286,60,198,28,35,15,17,3,30,18,12,3,3,40,15,25
"2021","Wiltshire 066E","E01034558",462,27,1,26,415,0,368,60,299,9,27,7,20,0,18,16,2,2,2,20,15,5
"2021","Bournemouth, Christchurch and Poole 003A","E01015301",685,185,121,64,438,79,220,94,85,41,69,37,29,3,69,40,29,1,1,62,25,37
"2021","Bournemouth, Christchurch and Poole 003B","E01015303",706,219,128,91,444,84,200,87,72,41,87,48,34,5,71,35,36,2,2,43,21,22
"2021","Bournemouth, Christchurch and Poole 003C","E01015305",635,175,101,74,416,43,180,61,77,42,78,31,41,6,111,58,53,4,4,44,23,21
"2021","Bournemouth, Christchurch and Poole 003D","E01015306",726,228,112,116,463,76,191,68,84,39,95,42,43,10,95,46,49,6,6,35,12,23
"2021","Bournemouth, Christchurch and Poole 005A","E01015302",847,264,170,94,531,111,222,103,81,38,96,50,39,7,96,55,41,6,6,52,17,35
"2021","Bournemouth, Christchurch and Poole 005B","E01015304",783,263,144,119,468,48,198,63,93,42,105,60,34,11,112,55,57,5,5,52,18,34
"2021","Bournemouth, Christchurch and Poole 005C","E01015308",748,196,82,114,495,50,224,74,110,40,107,57,45,5,107,71,36,7,7,57,18,39
"2021","Bournemouth, Christchurch and Poole 005D","E01015311",696,204,147,57,472,191,177,95,38,44,68,47,17,4,34,12,22,2,2,20,7,13
"2021","Bournemouth, Christchurch and Poole 006A","E01015332",724,230,145,85,447,110,233,105,95,33,70,38,31,1,32,17,15,2,2,47,19,28
"2021","Bournemouth, Christchurch and Poole 006B","E01015333",678,188,126,62,449,105,246,99,103,44,53,27,17,9,42,21,21,3,3,41,11,30
"2021","Bournemouth, Christchurch and Poole 006C","E01015334",721,209,134,75,469,83,222,90,93,39,72,43,23,6,89,56,33,3,3,43,14,29
"2021","Bournemouth, Christchurch and Poole 006D","E01015335",712,180,100,80,483,96,259,92,120,47,66,30,31,5,61,36,25,1,1,49,17,32
"2021","Bournemouth, Christchurch and Poole 006E","E01015337",773,226,100,126,495,52,267,78,146,43,90,61,26,3,78,48,30,8,8,52,13,39
"2021","Bournemouth, Christchurch and Poole 007A","E01015343",660,163,84,79,447,49,247,74,134,39,70,38,30,2,79,44,35,2,2,50,21,29
"2021","Bournemouth, Christchurch and Poole 007B","E01015349",706,198,107,91,466,57,227,68,123,36,93,36,48,9,85,53,32,4,4,42,19,23
"2021","Bournemouth, Christchurch and Poole 007C","E01015351",610,170,71,99,415,51,219,68,125,26,73,40,30,3,71,47,24,1,1,25,8,17
"2021","Bournemouth, Christchurch and Poole 007D","E01015352",640,171,77,94,441,27,239,55,155,29,93,51,40,2,81,55,26,1,1,28,10,18
"2021","Bournemouth, Christchurch and Poole 007E","E01015353",502,167,96,71,312,52,154,56,73,25,47,28,16,3,55,34,21,4,4,23,13,10
"2021","Bournemouth, Christchurch and Poole 007F","E01015354",719,158,85,73,513,61,266,81,147,38,92,50,39,3,87,56,31,7,7,48,18,30
"2021","Bournemouth, Christchurch and Poole 010A","E01015307",588,171,59,112,365,31,152,35,86,31,69,26,39,4,111,68,43,2,2,52,24,28
"2021","Bournemouth, Christchurch and Poole 010B","E01015309",583,142,45,97,392,33,152,52,67,33,74,26,42,6,128,78,50,5,5,49,21,28
"2021","Bournemouth, Christchurch and Poole 010C","E01015312",596,173,92,81,382,44,159,51,84,24,70,23,43,4,105,76,29,4,4,41,16,25
"2021","Bournemouth, Christchurch and Poole 010D","E01015313",521,138,61,77,338,20,140,36,71,33,54,18,26,10,122,67,55,2,2,45,20,25
"2021","Bournemouth, Christchurch and Poole 010E","E01015359",767,305,141,164,398,59,166,72,65,29,92,48,36,8,75,41,34,6,6,64,18,46
"2021","Bournemouth, Christchurch and Poole 009A","E01015320",675,157,80,77,465,62,271,78,152,41,74,42,23,9,56,30,26,2,2,53,18,35
"2021","Bournemouth, Christchurch and Poole 009B","E01015323",610,123,58,65,431,41,269,76,159,34,67,30,32,5,51,36,15,3,3,56,15,41
"2021","Bournemouth, Christchurch and Poole 009C","E01015324",694,172,62,110,468,55,231,74,127,30,91,38,45,8,89,63,26,2,2,54,18,36
"2021","Bournemouth, Christchurch and Poole 009D","E01015325",677,124,57,67,501,63,301,80,172,49,70,40,25,5,63,47,16,4,4,52,22,30
"2021","Bournemouth, Christchurch and Poole 009E","E01015350",635,164,115,49,442,78,262,92,114,56,57,28,24,5,41,22,19,4,4,29,11,18
"2021","Bournemouth, Christchurch and Poole 011A","E01015310",622,165,77,88,389,33,184,57,90,37,66,30,34,2,102,65,37,4,4,68,32,36
"2021","Bournemouth, Christchurch and Poole 011B","E01015336",718,188,93,95,468,66,241,77,113,51,80,43,31,6,78,46,32,3,3,62,24,38
"2021","Bournemouth, Christchurch and Poole 011C","E01015355",709,180,113,67,448,67,221,84,95,42,70,39,28,3,85,56,29,5,5,81,28,53
"2021","Bournemouth, Christchurch and Poole 011D","E01015357",700,277,140,137,368,54,160,61,78,21,60,37,23,0,93,56,37,1,1,55,23,32
"2021","Bournemouth, Christchurch and Poole 011E","E01015358",802,190,91,99,484,63,250,77,138,35,90,53,34,3,73,46,27,8,8,128,29,99
"2021","Bournemouth, Christchurch and Poole 012A","E01015338",813,338,180,158,429,69,197,69,100,28,60,13,41,6,97,52,45,6,6,46,16,30
"2021","Bournemouth, Christchurch and Poole 012B","E01015339",671,212,97,115,417,44,202,47,116,39,76,46,23,7,90,52,38,5,5,42,17,25
"2021","Bournemouth, Christchurch and Poole 012C","E01015340",744,224,131,93,478,123,231,86,104,41,70,37,28,5,49,21,28,5,5,42,19,23
"2021","Bournemouth, Christchurch and Poole 012D","E01015341",535,135,74,61,350,29,156,36,82,38,52,15,30,7,110,54,56,3,3,50,26,24
"2021","Bournemouth, Christchurch and Poole 015A","E01015321",751,213,83,130,427,28,216,60,126,30,70,33,29,8,103,69,34,10,10,111,21,90
"2021","Bournemouth, Christchurch and Poole 015B","E01015356",655,144,76,68,406,64,202,64,101,37,70,30,37,3,70,48,22,0,0,105,21,84
"2021","Bournemouth, Christchurch and Poole 015C","E01015374",998,298,61,237,435,22,151,49,85,17,116,73,38,5,133,94,39,13,13,265,12,253
"2021","Bournemouth, Christchurch and Poole 015D","E01015375",787,203,61,142,352,25,136,52,61,23,95,61,31,3,82,59,23,14,14,232,26,206
"2021","Bournemouth, Christchurch and Poole 015E","E01015377",633,131,39,92,369,31,177,49,97,31,77,42,32,3,80,56,24,4,4,133,26,107
"2021","Bournemouth, Christchurch and Poole 017A","E01015322",676,155,75,80,459,73,265,75,147,43,60,30,24,6,56,37,19,5,5,62,22,40
"2021","Bournemouth, Christchurch and Poole 017B","E01015330",777,248,119,129,457,73,247,74,145,28,71,41,26,4,61,39,22,5,5,72,25,47
"2021","Bournemouth, Christchurch and Poole 017C","E01015342",640,128,75,53,452,97,260,92,132,36,53,21,29,3,42,25,17,0,0,60,25,35
"2021","Bournemouth, Christchurch and Poole 017D","E01015373",693,183,54,129,382,14,192,56,109,27,103,70,29,4,68,46,22,5,5,128,22,106
"2021","Bournemouth, Christchurch and Poole 017E","E01015378",653,124,53,71,395,33,214,52,124,38,73,41,25,7,69,44,25,6,6,134,25,109
"2021","Bournemouth, Christchurch and Poole 020A","E01015314",624,153,101,52,428,79,264,81,135,48,52,27,20,5,30,16,14,3,3,43,12,31
"2021","Bournemouth, Christchurch and Poole 020B","E01015315",733,132,93,39,555,133,324,97,174,53,49,24,22,3,44,24,20,5,5,46,20,26
"2021","Bournemouth, Christchurch and Poole 020C","E01015318",748,215,91,124,479,51,234,66,135,33,98,62,33,3,88,57,31,8,8,54,17,37
"2021","Bournemouth, Christchurch and Poole 020D","E01015319",533,137,58,79,355,46,206,64,106,36,58,36,18,4,42,23,19,3,3,41,17,24
"2021","Bournemouth, Christchurch and Poole 028A","E01015344",769,191,78,113,522,128,278,105,128,45,72,52,19,1,40,17,23,4,4,56,18,38
"2021","Bournemouth, Christchurch and Poole 028B","E01015346",681,228,80,148,356,48,170,62,77,31,76,44,27,5,58,40,18,4,4,97,17,80
"2021","Bournemouth, Christchurch and Poole 028C","E01015348",766,213,102,111,464,123,226,74,108,44,71,55,13,3,41,19,22,3,3,89,13,76
"2021","Bournemouth, Christchurch and Poole 028D","E01015360",648,120,48,72,326,38,170,38,101,31,65,44,17,4,47,33,14,6,6,202,20,182
"2021","Bournemouth, Christchurch and Poole 027A","E01015326",814,263,78,185,424,32,186,67,98,21,112,72,37,3,80,52,28,14,14,127,29,98
"2021","Bournemouth, Christchurch and Poole 027B","E01015331",1026,341,87,254,573,27,252,69,168,15,161,101,57,3,123,87,36,10,10,112,24,88
"2021","Bournemouth, Christchurch and Poole 027C","E01015345",747,221,50,171,384,28,186,66,89,31,102,66,32,4,58,39,19,10,10,142,17,125
"2021","Bournemouth, Christchurch and Poole 027D","E01015376",657,158,49,109,335,27,147,41,84,22,87,59,24,4,67,39,28,7,7,164,23,141
"2021","Bournemouth, Christchurch and Poole 026A","E01015316",695,179,127,52,462,104,257,83,121,53,60,40,17,3,41,25,16,0,0,54,22,32
"2021","Bournemouth, Christchurch and Poole 026B","E01015317",703,187,88,99,463,60,247,75,132,40,86,40,35,11,68,38,30,2,2,53,14,39
"2021","Bournemouth, Christchurch and Poole 026C","E01015361",562,139,57,82,383,32,185,53,105,27,87,48,38,1,74,40,34,5,5,40,17,23
"2021","Bournemouth, Christchurch and Poole 026D","E01015362",448,94,37,57,321,24,166,51,82,33,48,22,23,3,82,48,34,1,1,33,13,20
"2021","Bournemouth, Christchurch and Poole 026E","E01015363",684,188,68,120,450,39,240,60,154,26,89,50,37,2,78,48,30,4,4,46,14,32
"2021","Bournemouth, Christchurch and Poole 025A","E01015292",765,243,65,178,425,25,169,51,94,24,106,60,38,8,112,87,25,13,13,97,31,66
"2021","Bournemouth, Christchurch and Poole 025B","E01015293",667,192,57,135,391,24,161,47,80,34,88,44,38,6,109,72,37,9,9,84,24,60
"2021","Bournemouth, Christchurch and Poole 025C","E01015294",886,268,55,213,509,13,218,66,119,33,118,60,50,8,144,96,48,16,16,109,24,85
"2021","Bournemouth, Christchurch and Poole 025D","E01015327",840,206,50,156,479,29,209,58,122,29,117,76,38,3,111,78,33,13,13,155,32,123
"2021","Bournemouth, Christchurch and Poole 025E","E01015329",686,193,40,153,393,36,200,75,88,37,79,46,29,4,72,41,31,6,6,100,26,74
"2021","Bournemouth, Christchurch and Poole 035A","E01015272",839,275,152,123,495,118,234,98,104,32,86,53,30,3,52,31,21,5,5,69,16,53
"2021","Bournemouth, Christchurch and Poole 035B","E01015273",1013,408,102,306,511,29,204,75,108,21,124,73,48,3,149,103,46,5,5,94,20,74
"2021","Bournemouth, Christchurch and Poole 035C","E01015275",727,240,76,164,386,47,177,65,79,33,88,55,31,2,70,44,26,4,4,101,14,87
"2021","Bournemouth, Christchurch and Poole 035D","E01015276",696,176,61,115,447,32,206,48,130,28,100,51,44,5,105,80,25,4,4,73,16,57
"2021","Bournemouth, Christchurch and Poole 035E","E01015277",860,284,95,189,475,28,206,72,113,21,115,66,47,2,117,82,35,9,9,101,29,72
"2021","Bournemouth, Christchurch and Poole 038A","E01015286",1125,530,265,265,510,109,189,113,63,13,142,108,28,6,61,28,33,9,9,85,16,69
"2021","Bournemouth, Christchurch and Poole 038B","E01015328",978,442,185,257,429,33,185,82,86,17,127,97,28,2,65,48,17,19,19,107,24,83
"2021","Bournemouth, Christchurch and Poole 038C","E01033242",590,329,94,235,217,15,83,38,38,7,83,67,16,0,29,19,10,7,7,44,7,37
"2021","Bournemouth, Christchurch and Poole 038D","E01033285",712,323,73,250,290,7,107,43,56,8,117,95,21,1,37,26,11,22,22,99,16,83
"2021","Bournemouth, Christchurch and Poole 038E","E01034271",424,254,128,126,134,22,44,24,19,1,57,51,4,2,9,6,3,2,2,36,7,29
"2021","Bournemouth, Christchurch and Poole 038F","E01034272",530,239,61,178,239,21,101,50,45,6,84,75,9,0,26,15,11,7,7,52,11,41
"2021","Bournemouth, Christchurch and Poole 038G","E01034273",621,264,22,242,263,9,82,46,30,6,115,97,17,1,38,19,19,19,19,94,8,86
"2021","Bournemouth, Christchurch and Poole 038H","E01034274",779,345,60,285,319,14,105,58,39,8,146,135,10,1,37,21,16,17,17,115,11,104
"2021","Bournemouth, Christchurch and Poole 036A","E01015274",919,371,128,243,477,58,219,70,112,37,109,74,30,5,86,50,36,5,5,71,17,54
"2021","Bournemouth, Christchurch and Poole 036B","E01015297",748,352,201,151,368,79,169,81,65,23,53,44,8,1,62,38,24,5,5,28,4,24
"2021","Bournemouth, Christchurch and Poole 036C","E01015364",694,184,117,67,469,97,254,70,135,49,60,31,26,3,55,34,21,3,3,41,8,33
"2021","Bournemouth, Christchurch and Poole 036D","E01015365",761,292,63,229,400,41,174,67,81,26,103,74,25,4,77,53,24,5,5,69,13,56
"2021","Bournemouth, Christchurch and Poole 036E","E01015366",950,481,243,238,403,83,154,74,60,20,101,77,19,5,62,29,33,3,3,66,11,55
"2021","Bournemouth, Christchurch and Poole 037A","E01015279",1013,488,66,422,455,16,166,78,74,14,159,122,34,3,104,81,23,10,10,70,11,59
"2021","Bournemouth, Christchurch and Poole 037B","E01015280",1025,456,73,383,502,11,196,79,105,12,172,122,49,1,112,79,33,11,11,67,20,47
"2021","Bournemouth, Christchurch and Poole 037C","E01015281",898,394,108,286,421,5,170,72,71,27,91,57,33,1,142,99,43,13,13,83,22,61
"2021","Bournemouth, Christchurch and Poole 037D","E01033241",631,333,89,244,251,30,89,45,34,10,79,63,14,2,45,28,17,8,8,47,9,38
"2021","Bournemouth, Christchurch and Poole 037E","E01033283",692,366,136,230,282,42,107,62,40,5,82,67,15,0,41,28,13,10,10,44,4,40
"2021","Bournemouth, Christchurch and Poole 037F","E01034275",649,402,49,353,222,8,70,25,41,4,79,52,26,1,53,39,14,12,12,25,11,14
"2021","Bournemouth, Christchurch and Poole 037G","E01034276",623,339,50,289,233,4,68,29,33,6,88,64,24,0,65,50,15,8,8,51,10,41
"2021","Bournemouth, Christchurch and Poole 039A","E01015295",658,154,111,43,480,141,261,110,103,48,45,25,19,1,32,12,20,1,1,24,6,18
"2021","Bournemouth, Christchurch and Poole 039B","E01015296",1054,526,280,246,479,92,159,78,58,23,147,113,32,2,76,49,27,5,5,49,11,38
"2021","Bournemouth, Christchurch and Poole 039C","E01015298",761,245,182,63,496,189,221,104,80,37,44,27,17,0,42,14,28,0,0,20,6,14
"2021","Bournemouth, Christchurch and Poole 039D","E01015299",808,253,168,85,513,101,263,89,128,46,69,37,28,4,76,44,32,4,4,42,10,32
"2021","Bournemouth, Christchurch and Poole 039E","E01015300",661,163,90,73,452,118,218,61,122,35,62,43,17,2,52,31,21,2,2,46,15,31
"2021","Bournemouth, Christchurch and Poole 041A","E01015288",942,398,95,303,420,7,155,50,87,18,121,84,36,1,127,92,35,10,10,124,28,96
"2021","Bournemouth, Christchurch and Poole 041B","E01015289",1041,474,138,336,460,49,171,76,86,9,138,103,32,3,77,50,27,25,25,107,12,95
"2021","Bournemouth, Christchurch and Poole 041C","E01015290",971,429,112,317,440,39,169,76,79,14,152,119,32,1,61,39,22,19,19,102,14,88
"2021","Bournemouth, Christchurch and Poole 041D","E01015291",1040,451,212,239,518,171,179,107,56,16,102,84,15,3,51,32,19,15,15,71,15,56
"2021","Bournemouth, Christchurch and Poole 041E","E01034277",680,321,43,278,279,24,109,55,48,6,86,70,16,0,43,33,10,17,17,80,10,70
"2021","Bournemouth, Christchurch and Poole 041F","E01034278",584,246,60,186,260,41,100,42,53,5,83,74,7,2,27,11,16,9,9,78,7,71
"2021","Bournemouth, Christchurch and Poole 001A","E01015431",417,84,61,23,312,94,171,56,75,40,28,16,12,0,19,10,9,0,0,21,8,13
"2021","Bournemouth, Christchurch and Poole 001B","E01015432",763,225,153,72,511,132,249,81,126,42,69,40,24,5,60,33,27,1,1,27,10,17
"2021","Bournemouth, Christchurch and Poole 001C","E01015433",623,125,94,31,467,150,237,88,96,53,46,27,18,1,33,10,23,1,1,31,14,17
"2021","Bournemouth, Christchurch and Poole 001D","E01015434",677,151,129,22,499,168,265,96,108,61,36,15,17,4,30,17,13,0,0,27,4,23
"2021","Bournemouth, Christchurch and Poole 008A","E01015379",482,74,41,33,342,36,174,53,90,31,57,21,31,5,69,41,28,6,6,66,40,26
"2021","Bournemouth, Christchurch and Poole 008B","E01015435",787,197,45,152,557,44,260,89,132,39,166,107,54,5,85,53,32,2,2,33,14,19
"2021","Bournemouth, Christchurch and Poole 008C","E01015436",551,113,76,37,407,80,229,88,89,52,58,25,28,5,40,19,21,0,0,31,4,27
"2021","Bournemouth, Christchurch and Poole 008D","E01015437",515,121,69,52,366,86,190,70,75,45,53,30,20,3,36,16,20,1,1,28,17,11
"2021","Bournemouth, Christchurch and Poole 004A","E01015395",676,259,172,87,390,132,191,74,76,41,33,22,9,2,31,16,15,3,3,27,9,18
"2021","Bournemouth, Christchurch and Poole 004B","E01015396",636,128,94,34,467,135,256,93,106,57,41,26,11,4,33,11,22,2,2,41,16,25
"2021","Bournemouth, Christchurch and Poole 004C","E01015397",524,74,50,24,432,73,286,95,123,68,42,26,13,3,31,15,16,0,0,18,10,8
"2021","Bournemouth, Christchurch and Poole 004D","E01015398",513,78,57,21,408,108,234,81,108,45,35,19,13,3,31,19,12,0,0,27,12,15
"2021","Bournemouth, Christchurch and Poole 004E","E01015399",643,183,138,45,434,134,240,87,109,44,30,16,10,4,27,10,17,3,3,26,11,15
"2021","Bournemouth, Christchurch and Poole 004F","E01015400",643,126,99,27,489,122,284,91,138,55,50,17,25,8,30,15,15,3,3,28,8,20
"2021","Bournemouth, Christchurch and Poole 004G","E01015401",635,182,144,38,409,142,216,73,83,60,25,11,10,4,26,12,14,0,0,44,14,30
"2021","Bournemouth, Christchurch and Poole 013A","E01015412",495,68,50,18,394,96,236,84,107,45,34,18,14,2,27,8,19,1,1,33,12,21
"2021","Bournemouth, Christchurch and Poole 013B","E01015413",631,185,101,84,423,53,222,87,94,41,76,37,35,4,68,42,26,4,4,23,6,17
"2021","Bournemouth, Christchurch and Poole 013C","E01015414",695,197,82,115,460,85,224,91,89,44,57,32,19,6,92,67,25,2,2,38,13,25
"2021","Bournemouth, Christchurch and Poole 013D","E01015415",535,194,67,127,307,16,136,53,67,16,73,37,31,5,79,59,20,3,3,34,16,18
"2021","Bournemouth, Christchurch and Poole 013E","E01015416",538,144,79,65,366,61,193,59,98,36,65,39,26,0,42,33,9,5,5,28,10,18
"2021","Bournemouth, Christchurch and Poole 016A","E01015407",632,160,101,59,438,77,230,74,110,46,67,32,32,3,61,32,29,3,3,34,15,19
"2021","Bournemouth, Christchurch and Poole 016B","E01015408",634,109,78,31,480,76,256,73,142,41,85,40,39,6,63,37,26,0,0,45,19,26
"2021","Bournemouth, Christchurch and Poole 016C","E01015409",593,165,51,114,413,13,184,68,76,40,94,42,44,8,119,72,47,3,3,15,7,8
"2021","Bournemouth, Christchurch and Poole 016D","E01015410",659,207,56,151,409,38,197,80,83,34,109,63,41,5,59,39,20,6,6,43,22,21
"2021","Bournemouth, Christchurch and Poole 016E","E01015411",535,113,56,57,382,51,197,72,87,38,78,37,37,4,53,31,22,3,3,40,14,26
"2021","Bournemouth, Christchurch and Poole 021A","E01015417",642,173,111,62,435,85,194,78,78,38,81,30,44,7,71,43,28,4,4,34,16,18
"2021","Bournemouth, Christchurch and Poole 021B","E01015418",703,229,106,123,450,56,232,94,105,33,107,59,38,10,53,31,22,2,2,24,6,18
"2021","Bournemouth, Christchurch and Poole 021C","E01015419",791,214,119,95,542,131,232,85,104,43,103,59,42,2,74,40,34,2,2,35,11,24
"2021","Bournemouth, Christchurch and Poole 021D","E01015420",675,174,109,65,458,48,213,75,89,49,96,46,40,10,93,55,38,8,8,43,20,23
"2021","Bournemouth, Christchurch and Poole 021E","E01015421",672,182,124,58,450,109,214,86,81,47,53,26,19,8,66,31,35,8,8,40,13,27
"2021","Bournemouth, Christchurch and Poole 021F","E01015422",620,171,59,112,432,38,231,100,95,36,121,74,44,3,42,24,18,0,0,17,5,12
"2021","Bournemouth, Christchurch and Poole 022A","E01015380",770,188,125,63,510,127,226,100,78,48,86,49,28,9,68,30,38,3,3,72,18,54
"2021","Bournemouth, Christchurch and Poole 022B","E01015381",652,139,81,58,437,48,184,50,99,35,91,31,50,10,107,64,43,7,7,76,21,55
"2021","Bournemouth, Christchurch and Poole 022C","E01015382",789,190,61,129,538,33,217,73,108,36,140,67,69,4,143,101,42,5,5,61,22,39
"2021","Bournemouth, Christchurch and Poole 022D","E01015383",682,219,138,81,394,113,169,90,51,28,59,38,17,4,49,18,31,4,4,69,14,55
"2021","Bournemouth, Christchurch and Poole 022E","E01015384",484,52,22,30,350,12,162,30,93,39,57,14,42,1,110,75,35,9,9,82,40,42
"2021","Bournemouth, Christchurch and Poole 022F","E01015385",790,273,152,121,460,80,198,79,80,39,98,54,39,5,78,47,31,6,6,57,25,32
"2021","Bournemouth, Christchurch and Poole 023A","E01015438",637,126,63,63,451,69,225,101,91,33,83,39,40,4,69,40,29,5,5,60,27,33
"2021","Bournemouth, Christchurch and Poole 023B","E01015439",759,229,88,141,465,37,226,75,113,38,99,56,38,5,97,66,31,6,6,65,21,44
"2021","Bournemouth, Christchurch and Poole 023C","E01015441",910,343,148,195,490,53,249,96,103,50,89,62,23,4,90,63,27,9,9,77,27,50
"2021","Bournemouth, Christchurch and Poole 023D","E01015442",846,290,158,132,492,56,214,60,106,48,95,38,46,11,120,74,46,7,7,64,30,34
"2021","Bournemouth, Christchurch and Poole 023E","E01015443",834,232,106,126,535,76,225,74,99,52,131,84,43,4,96,62,34,7,7,67,23,44
"2021","Bournemouth, Christchurch and Poole 023F","E01015444",718,175,70,105,475,55,229,89,98,42,105,62,38,5,80,42,38,6,6,68,24,44
"2021","Bournemouth, Christchurch and Poole 029A","E01015386",829,344,135,209,420,49,159,70,71,18,113,76,32,5,91,55,36,8,8,65,22,43
"2021","Bournemouth, Christchurch and Poole 029B","E01015387",666,190,109,81,434,76,229,85,102,42,73,23,47,3,54,36,18,2,2,42,16,26
"2021","Bournemouth, Christchurch and Poole 029C","E01015388",489,92,52,40,340,60,190,66,84,40,38,20,17,1,51,26,25,1,1,57,19,38
"2021","Bournemouth, Christchurch and Poole 029D","E01015389",677,230,93,137,399,73,192,86,80,26,85,62,19,4,41,21,20,8,8,48,11,37
"2021","Bournemouth, Christchurch and Poole 032A","E01015390",776,271,97,174,444,33,195,70,99,26,108,72,32,4,99,66,33,9,9,61,24,37
"2021","Bournemouth, Christchurch and Poole 032B","E01015391",616,144,67,77,428,71,214,85,91,38,92,59,31,2,44,20,24,7,7,44,16,28
"2021","Bournemouth, Christchurch and Poole 032C","E01015392",677,223,117,106,413,46,201,68,96,37,101,61,36,4,60,36,24,5,5,41,9,32
"2021","Bournemouth, Christchurch and Poole 032D","E01015393",541,147,64,83,358,32,175,61,71,43,87,48,33,6,60,37,23,4,4,36,11,25
"2021","Bournemouth, Christchurch and Poole 032E","E01015394",653,133,67,66,463,56,250,76,132,42,104,68,30,6,49,30,19,4,4,57,17,40
"2021","Bournemouth, Christchurch and Poole 030A","E01015440",892,244,101,143,579,83,283,101,130,52,117,69,43,5,92,67,25,4,4,69,27,42
"2021","Bournemouth, Christchurch and Poole 030B","E01015447",694,161,103,58,480,97,258,87,132,39,80,47,29,4,44,12,32,1,1,53,17,36
"2021","Bournemouth, Christchurch and Poole 030C","E01015449",752,229,101,128,467,45,209,72,99,38,101,51,41,9,101,60,41,11,11,56,28,28
"2021","Bournemouth, Christchurch and Poole 030D","E01015456",805,275,144,131,467,58,197,81,75,41,90,50,35,5,114,67,47,8,8,63,14,49
"2021","Bournemouth, Christchurch and Poole 030E","E01015457",900,335,174,161,518,114,229,93,106,30,92,67,24,1,74,41,33,9,9,47,9,38
"2021","Bournemouth, Christchurch and Poole 034A","E01015445",780,181,104,77,542,109,310,107,133,70,58,35,16,7,61,29,32,4,4,57,25,32
"2021","Bournemouth, Christchurch and Poole 034B","E01015446",664,193,124,69,418,66,215,73,101,41,80,42,35,3,52,30,22,5,5,53,21,32
"2021","Bournemouth, Christchurch and Poole 034C","E01015448",632,145,87,58,443,64,242,76,123,43,81,43,32,6,53,31,22,3,3,44,19,25
"2021","Bournemouth, Christchurch and Poole 034D","E01015450",686,163,90,73,453,86,253,82,117,54,59,32,27,0,51,28,23,4,4,70,24,46
"2021","Bournemouth, Christchurch and Poole 034E","E01015451",655,158,110,48,447,98,250,82,108,60,52,31,16,5,44,21,23,3,3,50,17,33
"2021","Bournemouth, Christchurch and Poole 043A","E01015458",670,150,105,45,502,150,269,102,145,22,46,29,15,2,37,16,21,0,0,18,7,11
"2021","Bournemouth, Christchurch and Poole 043B","E01015460",759,224,95,129,472,31,227,58,142,27,107,65,41,1,103,75,28,4,4,63,22,41
"2021","Bournemouth, Christchurch and Poole 043C","E01015461",725,266,65,201,407,28,202,62,112,28,98,59,34,5,72,44,28,7,7,52,13,39
"2021","Bournemouth, Christchurch and Poole 043D","E01015462",700,199,49,150,447,34,225,61,128,36,103,58,38,7,78,57,21,7,7,54,17,37
"2021","Bournemouth, Christchurch and Poole 043E","E01015463",796,271,109,162,499,88,241,99,121,21,107,85,22,0,55,29,26,8,8,26,3,23
"2021","Bournemouth, Christchurch and Poole 043F","E01015464",692,156,78,78,500,108,306,117,143,46,58,41,16,1,26,16,10,2,2,36,9,27
"2021","Bournemouth, Christchurch and Poole 042A","E01015427",648,178,49,129,428,25,234,77,121,36,90,45,37,8,79,55,24,0,0,42,21,21
"2021","Bournemouth, Christchurch and Poole 042B","E01015428",1072,280,139,141,730,163,316,139,134,43,145,90,50,5,100,60,40,6,6,62,16,46
"2021","Bournemouth, Christchurch and Poole 042C","E01015429",693,188,89,99,448,55,216,74,101,41,84,32,44,8,91,58,33,2,2,57,30,27
"2021","Bournemouth, Christchurch and Poole 042D","E01015430",561,152,54,98,364,29,155,39,83,33,76,26,38,12,98,56,42,6,6,45,28,17
"2021","Bournemouth, Christchurch and Poole 044A","E01015465",755,232,102,130,451,44,199,78,93,28,88,51,37,0,109,68,41,11,11,72,22,50
"2021","Bournemouth, Christchurch and Poole 044B","E01015466",790,267,161,106,451,90,212,80,90,42,71,42,26,3,76,41,35,2,2,72,15,57
"2021","Bournemouth, Christchurch and Poole 044C","E01032659",654,305,98,207,307,44,99,46,42,11,73,47,26,0,81,55,26,10,10,42,11,31
"2021","Bournemouth, Christchurch and Poole 044D","E01032660",745,317,94,223,380,51,159,71,68,20,89,53,32,4,76,46,30,5,5,48,16,32
"2021","Bournemouth, Christchurch and Poole 044E","E01032661",716,314,135,179,360,89,126,68,38,20,76,57,15,4,67,45,22,2,2,42,9,33
"2021","Bournemouth, Christchurch and Poole 044F","E01032662",610,310,155,155,273,40,80,27,40,13,61,35,24,2,88,63,25,4,4,27,10,17
"2021","Bournemouth, Christchurch and Poole 044G","E01034281",666,361,227,134,265,92,91,38,42,11,44,38,6,0,35,20,15,3,3,40,5,35
"2021","Bournemouth, Christchurch and Poole 044H","E01034282",627,243,65,178,353,28,132,52,63,17,88,51,35,2,100,83,17,5,5,31,12,19
"2021","Bournemouth, Christchurch and Poole 046A","E01015424",623,175,91,84,412,68,183,69,73,41,89,50,34,5,69,47,22,3,3,36,15,21
"2021","Bournemouth, Christchurch and Poole 046B","E01015425",565,135,70,65,387,90,183,93,50,40,67,31,30,6,43,25,18,4,4,43,12,31
"2021","Bournemouth, Christchurch and Poole 046C","E01015426",574,172,72,100,355,60,155,54,68,33,71,24,32,15,65,35,30,4,4,47,19,28
"2021","Bournemouth, Christchurch and Poole 046D","E01034283",677,214,103,111,426,72,188,63,77,48,87,49,35,3,78,56,22,1,1,37,11,26
"2021","Bournemouth, Christchurch and Poole 046E","E01034284",560,244,80,164,289,37,128,48,64,16,66,48,17,1,53,35,18,5,5,27,10,17
"2021","Bournemouth, Christchurch and Poole 047A","E01015452",944,320,204,116,577,128,314,106,162,46,77,51,23,3,55,35,20,3,3,47,14,33
"2021","Bournemouth, Christchurch and Poole 047B","E01015453",1023,466,210,256,514,65,227,99,105,23,130,88,40,2,89,61,28,3,3,43,7,36
"2021","Bournemouth, Christchurch and Poole 047C","E01015454",951,350,120,230,534,66,238,94,112,32,134,92,39,3,90,69,21,6,6,67,20,47
"2021","Bournemouth, Christchurch and Poole 047D","E01015455",914,331,224,107,566,149,282,91,146,45,68,43,22,3,65,40,25,2,2,17,4,13
"2021","Bournemouth, Christchurch and Poole 047E","E01015459",807,244,143,101,535,159,295,124,134,37,51,37,12,2,28,13,15,2,2,28,10,18
"2021","Bournemouth, Christchurch and Poole 048A","E01015402",863,349,209,140,474,125,221,100,91,30,69,51,16,2,52,20,32,7,7,40,14,26
"2021","Bournemouth, Christchurch and Poole 048B","E01015403",1059,543,365,178,489,261,128,76,30,22,63,52,11,0,33,9,24,4,4,27,4,23
"2021","Bournemouth, Christchurch and Poole 048C","E01015404",868,283,200,83,555,249,228,103,92,33,51,28,21,2,25,12,13,2,2,30,9,21
"2021","Bournemouth, Christchurch and Poole 048D","E01015405",777,250,135,115,483,167,229,114,77,38,46,27,18,1,36,21,15,5,5,44,12,32
"2021","Bournemouth, Christchurch and Poole 048E","E01015406",750,266,142,124,448,148,197,105,65,27,52,35,17,0,43,22,21,8,8,36,9,27
"2021","Bournemouth, Christchurch and Poole 002A","E01020343",664,162,107,55,467,131,239,102,80,57,47,25,17,5,47,24,23,3,3,35,11,24
"2021","Bournemouth, Christchurch and Poole 002B","E01020344",577,115,50,65,437,52,214,61,111,42,109,52,51,6,61,39,22,1,1,25,6,19
"2021","Bournemouth, Christchurch and Poole 002C","E01020345",585,178,119,59,384,108,197,82,71,44,41,26,11,4,36,19,17,2,2,23,4,19
"2021","Bournemouth, Christchurch and Poole 002D","E01020365",856,265,171,94,536,190,260,104,103,53,35,16,14,5,49,25,24,2,2,55,23,32
"2021","Bournemouth, Christchurch and Poole 014A","E01020351",527,130,79,51,369,85,191,55,97,39,42,21,18,3,46,27,19,5,5,28,18,10
"2021","Bournemouth, Christchurch and Poole 014B","E01020352",564,142,90,52,394,66,239,64,126,49,43,15,25,3,45,28,17,1,1,28,13,15
"2021","Bournemouth, Christchurch and Poole 014C","E01020353",700,230,152,78,432,44,222,65,119,38,65,24,34,7,99,59,40,2,2,38,17,21
"2021","Bournemouth, Christchurch and Poole 014D","E01020359",539,147,78,69,369,46,196,61,99,36,54,22,25,7,73,43,30,0,0,23,10,13
"2021","Bournemouth, Christchurch and Poole 014E","E01020366",962,231,185,46,679,203,352,120,153,79,71,33,35,3,51,20,31,2,2,52,21,31
"2021","Bournemouth, Christchurch and Poole 019A","E01020349",1085,604,464,140,450,215,137,68,49,20,61,40,16,5,34,20,14,3,3,31,7,24
"2021","Bournemouth, Christchurch and Poole 019B","E01020350",1015,364,282,82,614,311,212,110,60,42,44,27,15,2,45,22,23,2,2,37,12,25
"2021","Bournemouth, Christchurch and Poole 019C","E01020357",929,240,152,88,635,143,334,117,151,66,82,40,34,8,71,40,31,5,5,54,24,30
"2021","Bournemouth, Christchurch and Poole 019D","E01020358",694,175,135,40,490,204,226,99,82,45,37,22,13,2,23,9,14,0,0,29,8,21
"2021","Bournemouth, Christchurch and Poole 018A","E01020369",655,233,167,66,398,119,169,68,69,32,55,36,16,3,53,31,22,2,2,24,9,15
"2021","Bournemouth, Christchurch and Poole 018B","E01020370",718,208,106,102,483,96,254,85,125,44,75,33,34,8,58,34,24,0,0,27,11,16
"2021","Bournemouth, Christchurch and Poole 018C","E01020371",754,193,156,37,537,222,241,98,97,46,51,29,16,6,23,8,15,0,0,24,9,15
"2021","Bournemouth, Christchurch and Poole 018D","E01020372",721,221,153,68,473,147,212,86,90,36,68,45,16,7,45,25,20,1,1,27,11,16
"2021","Bournemouth, Christchurch and Poole 024A","E01020346",715,259,140,119,426,55,209,70,97,42,72,29,34,9,85,54,31,5,5,30,13,17
"2021","Bournemouth, Christchurch and Poole 024B","E01020347",779,290,101,189,452,43,171,55,87,29,95,38,45,12,135,96,39,8,8,37,13,24
"2021","Bournemouth, Christchurch and Poole 024C","E01020348",641,171,92,79,419,28,191,56,83,52,83,34,42,7,110,63,47,7,7,51,20,31
"2021","Bournemouth, Christchurch and Poole 024D","E01020363",514,154,73,81,338,43,150,58,59,33,59,34,17,8,85,47,38,1,1,22,8,14
"2021","Bournemouth, Christchurch and Poole 031A","E01020360",727,220,120,100,473,55,236,65,137,34,95,46,46,3,83,52,31,4,4,34,11,23
"2021","Bournemouth, Christchurch and Poole 031B","E01020361",746,229,87,142,476,55,224,60,133,31,108,64,39,5,84,56,28,5,5,41,12,29
"2021","Bournemouth, Christchurch and Poole 031C","E01020364",827,377,234,143,413,97,148,65,56,27,76,46,28,2,92,63,29,0,0,37,14,23
"2021","Bournemouth, Christchurch and Poole 031D","E01020367",945,397,245,152,523,149,225,100,89,36,69,50,18,1,73,42,31,7,7,25,10,15
"2021","Bournemouth, Christchurch and Poole 031E","E01034279",742,323,148,175,379,57,151,55,75,21,80,48,27,5,89,64,25,2,2,40,11,29
"2021","Bournemouth, Christchurch and Poole 031F","E01034280",526,216,174,42,298,91,140,36,79,25,28,15,10,3,38,21,17,1,1,12,3,9
"2021","Bournemouth, Christchurch and Poole 033A","E01020354",713,260,159,101,428,105,188,76,76,36,73,40,30,3,61,40,21,1,1,25,11,14
"2021","Bournemouth, Christchurch and Poole 033B","E01020355",937,279,200,79,628,279,268,119,83,66,47,24,21,2,31,17,14,3,3,30,12,18
"2021","Bournemouth, Christchurch and Poole 033C","E01020356",778,248,185,63,502,197,219,114,74,31,41,27,11,3,41,20,21,4,4,28,9,19
"2021","Bournemouth, Christchurch and Poole 033D","E01020362",687,216,161,55,432,124,213,97,77,39,52,35,10,7,41,17,24,2,2,39,7,32
"2021","Bournemouth, Christchurch and Poole 040A","E01015371",793,409,84,325,317,25,124,66,44,14,96,75,21,0,64,36,28,8,8,67,13,54
"2021","Bournemouth, Christchurch and Poole 040B","E01015372",1202,671,355,316,467,98,148,77,62,9,141,112,29,0,62,38,24,18,18,64,11,53
"2021","Bournemouth, Christchurch and Poole 040C","E01033286",608,264,91,173,291,41,104,59,37,8,102,69,30,3,39,21,18,5,5,53,6,47
"2021","Bournemouth, Christchurch and Poole 040D","E01033288",648,294,118,176,304,48,120,69,40,11,95,74,19,2,33,16,17,8,8,50,6,44
"2021","Bournemouth, Christchurch and Poole 045A","E01015367",1182,539,97,442,528,45,188,97,73,18,185,144,40,1,79,52,27,31,31,115,16,99
"2021","Bournemouth, Christchurch and Poole 045B","E01015368",1028,512,252,260,461,146,177,102,56,19,86,73,12,1,40,18,22,12,12,55,8,47
"2021","Bournemouth, Christchurch and Poole 045C","E01015369",958,475,235,240,441,99,162,95,52,15,117,100,15,2,54,24,30,9,9,42,4,38
"2021","Bournemouth, Christchurch and Poole 045D","E01015370",805,324,86,238,416,82,159,78,64,17,143,114,26,3,29,12,17,3,3,65,8,57
"2021","Dorset 007A","E01020373",511,84,39,45,401,52,214,83,95,36,64,29,32,3,69,42,27,2,2,26,12,14
"2021","Dorset 007B","E01020374",664,142,101,41,489,144,269,125,97,47,49,28,16,5,27,13,14,0,0,33,11,22
"2021","Dorset 007C","E01020389",871,203,109,94,607,118,350,151,127,72,80,46,30,4,58,35,23,1,1,61,31,30
"2021","Dorset 007D","E01020397",646,186,107,79,441,94,229,96,101,32,61,41,16,4,56,37,19,1,1,19,8,11
"2021","Dorset 010A","E01020416",677,215,84,131,442,57,200,71,99,30,118,68,42,8,64,44,20,3,3,20,4,16
"2021","Dorset 010B","E01020417",480,110,68,42,341,84,157,54,77,26,56,32,22,2,43,24,19,1,1,29,13,16
"2021","Dorset 010C","E01020418",704,177,142,35,500,192,243,110,85,48,43,23,16,4,22,7,15,0,0,27,6,21
"2021","Dorset 010D","E01020419",855,179,110,69,641,146,340,127,145,68,90,52,30,8,63,39,24,2,2,35,12,23
"2021","Dorset 010E","E01020420",579,132,91,41,422,88,239,71,124,44,45,28,16,1,49,28,21,1,1,25,9,16
"2021","Dorset 012A","E01020411",432,91,52,39,323,66,136,51,61,24,64,33,26,5,57,33,24,0,0,18,7,11
"2021","Dorset 012B","E01020412",574,153,79,74,377,61,169,53,83,33,77,44,25,8,69,44,25,1,1,44,16,28
"2021","Dorset 012C","E01020413",625,128,90,38,480,122,243,89,112,42,83,62,15,6,30,18,12,2,2,17,9,8
"2021","Dorset 012D","E01020414",852,213,135,78,609,169,279,105,114,60,86,48,33,5,74,52,22,1,1,30,13,17
"2021","Dorset 012E","E01020415",612,119,88,31,469,135,243,96,109,38,58,25,27,6,32,14,18,1,1,24,10,14
"2021","Dorset 015A","E01020403",680,153,104,49,476,163,257,112,94,51,37,23,13,1,19,10,9,0,0,51,16,35
"2021","Dorset 015B","E01020404",747,190,123,67,519,207,226,109,75,42,53,29,20,4,31,18,13,2,2,38,20,18
"2021","Dorset 015C","E01020405",913,240,137,103,612,153,297,135,115,47,98,62,31,5,61,39,22,3,3,61,19,42
"2021","Dorset 015D","E01020406",1141,260,203,57,823,348,383,207,101,75,58,35,18,5,33,13,20,1,1,58,27,31
"2021","Dorset 013A","E01020396",483,105,67,38,353,73,195,90,74,31,53,30,21,2,32,19,13,0,0,25,8,17
"2021","Dorset 013B","E01020398",964,170,99,71,722,186,404,171,147,86,66,41,16,9,62,31,31,4,4,72,27,45
"2021","Dorset 013C","E01020409",512,94,46,48,390,85,221,88,82,51,42,21,18,3,39,16,23,3,3,28,9,19
"2021","Dorset 013D","E01020410",517,126,80,46,361,59,209,89,73,47,57,35,18,4,36,21,15,0,0,30,16,14
"2021","Dorset 016A","E01020421",525,104,76,28,382,119,183,67,82,34,40,20,18,2,39,17,22,1,1,39,17,22
"2021","Dorset 016B","E01020422",883,394,275,119,462,204,140,75,44,21,58,32,21,5,56,36,20,4,4,27,9,18
"2021","Dorset 016C","E01020423",653,156,121,35,463,185,200,88,66,46,49,32,15,2,27,10,17,2,2,34,11,23
"2021","Dorset 016D","E01020424",650,172,129,43,447,143,200,94,50,56,55,38,12,5,45,19,26,4,4,31,9,22
"2021","Dorset 016E","E01020425",820,269,206,63,517,226,196,100,63,33,48,29,16,3,45,25,20,2,2,34,8,26
"2021","Dorset 017A","E01020377",639,120,85,35,494,111,283,96,133,54,57,34,19,4,41,23,18,2,2,25,9,16
"2021","Dorset 017B","E01020379",669,202,123,79,432,98,209,81,86,42,53,18,30,5,68,44,24,4,4,35,9,26
"2021","Dorset 017C","E01020380",701,150,82,68,528,119,270,75,142,53,87,47,36,4,50,40,10,2,2,23,9,14
"2021","Dorset 017D","E01020381",505,90,62,28,397,118,227,85,106,36,24,11,9,4,28,12,16,0,0,18,7,11
"2021","Dorset 018A","E01020390",709,279,203,76,404,187,151,74,43,34,31,24,7,0,34,13,21,1,1,26,11,15
"2021","Dorset 018B","E01020391",685,185,126,59,467,183,211,101,62,48,37,26,11,0,33,13,20,3,3,33,11,22
"2021","Dorset 018C","E01020392",896,395,274,121,458,155,187,83,65,39,66,47,18,1,47,22,25,3,3,43,17,26
"2021","Dorset 018D","E01020393",559,125,41,84,396,14,196,48,112,36,68,32,32,4,117,75,42,1,1,38,15,23
"2021","Dorset 018E","E01020394",814,287,211,76,489,182,175,81,51,43,52,26,23,3,76,42,34,4,4,38,14,24
"2021","Dorset 020A","E01020375",625,196,145,51,409,112,190,75,70,45,57,34,17,6,49,23,26,1,1,20,4,16
"2021","Dorset 020B","E01020376",488,122,84,38,347,87,171,71,66,34,52,26,23,3,34,18,16,3,3,19,7,12
"2021","Dorset 020C","E01020378",642,157,97,60,461,96,228,69,108,51,75,45,29,1,61,38,23,1,1,24,12,12
"2021","Dorset 020D","E01020407",523,133,87,46,363,106,179,73,87,19,41,23,16,2,36,18,18,1,1,27,10,17
"2021","Dorset 020E","E01020408",489,115,78,37,341,93,164,78,51,35,51,31,15,5,31,10,21,2,2,33,12,21
"2021","Dorset 021A","E01020426",816,279,185,94,508,155,237,85,110,42,47,29,15,3,66,35,31,3,3,29,7,22
"2021","Dorset 021B","E01020427",986,295,131,164,661,93,234,79,124,31,129,74,51,4,202,164,38,3,3,30,10,20
"2021","Dorset 021C","E01020428",1106,578,343,235,488,150,184,78,72,34,87,61,23,3,64,30,34,3,3,40,9,31
"2021","Dorset 021D","E01020429",974,406,191,215,534,80,253,81,139,33,101,62,33,6,96,67,29,4,4,34,11,23
"2021","Dorset 024A","E01020395",950,349,252,97,570,282,210,95,52,63,40,29,9,2,37,15,22,1,1,31,7,24
"2021","Dorset 024B","E01020400",686,153,104,49,474,147,247,106,78,63,63,36,21,6,14,4,10,3,3,59,16,43
"2021","Dorset 024C","E01020401",785,253,212,41,504,198,224,103,70,51,44,33,7,4,38,15,23,0,0,28,11,17
"2021","Dorset 024D","E01020402",648,121,86,35,504,163,262,103,107,52,35,17,17,1,41,22,19,3,3,23,9,14
"2021","Dorset 024E","E01034372",619,150,102,48,436,111,211,83,91,37,68,36,30,2,46,21,25,0,0,33,11,22
"2021","Dorset 024F","E01034373",604,109,49,60,454,73,265,82,130,53,66,32,33,1,49,26,23,1,1,41,17,24
"2021","Dorset 025A","E01020382",636,169,84,85,434,72,248,81,117,50,63,34,27,2,51,26,25,0,0,33,13,20
"2021","Dorset 025B","E01020383",827,183,132,51,596,178,300,105,135,60,72,29,33,10,45,19,26,1,1,48,20,28
"2021","Dorset 025C","E01020384",633,105,48,57,505,68,279,76,143,60,73,39,31,3,85,52,33,0,0,23,10,13
"2021","Dorset 025D","E01020385",514,110,60,50,383,57,196,62,98,36,56,30,23,3,71,19,52,3,3,21,12,9
"2021","Dorset 025E","E01020386",572,160,78,82,381,84,218,72,103,43,45,26,15,4,34,15,19,0,0,31,12,19
"2021","Dorset 025F","E01020387",474,113,81,32,335,112,181,80,69,32,21,6,10,5,20,6,14,1,1,26,5,21
"2021","Dorset 025G","E01020388",638,195,114,81,409,62,196,64,97,35,70,31,35,4,81,49,32,0,0,34,14,20
"2021","Dorset 001A","E01020443",1148,436,174,262,663,95,276,109,122,45,145,76,67,2,138,90,48,9,9,49,15,34
"2021","Dorset 001B","E01020447",850,317,215,102,514,150,227,107,71,49,70,38,25,7,65,41,24,2,2,19,9,10
"2021","Dorset 001C","E01020463",759,247,151,96,481,126,239,101,90,48,59,31,23,5,52,34,18,5,5,31,12,19
"2021","Dorset 001D","E01020464",701,226,160,66,454,137,212,92,85,35,56,28,26,2,47,25,22,2,2,21,6,15
"2021","Dorset 002A","E01020440",877,204,123,81,624,174,317,169,96,52,82,49,26,7,47,27,20,4,4,49,25,24
"2021","Dorset 002B","E01020450",975,252,143,109,692,143,364,139,162,63,110,62,45,3,72,41,31,3,3,31,13,18
"2021","Dorset 002C","E01020462",833,209,124,85,581,158,316,169,93,54,66,43,19,4,39,18,21,2,2,43,16,27
"2021","Dorset 002D","E01033156",660,158,66,92,462,67,230,63,132,35,89,48,37,4,73,58,15,3,3,40,21,19
"2021","Dorset 002E","E01033158",593,177,103,74,391,93,213,97,81,35,58,32,25,1,26,14,12,1,1,25,9,16
"2021","Dorset 003A","E01020454",1051,489,280,209,524,115,194,70,72,52,88,65,19,4,88,55,33,39,39,38,10,28
"2021","Dorset 003B","E01020456",784,225,88,137,534,84,239,81,116,42,123,63,55,5,86,62,24,2,2,25,10,15
"2021","Dorset 003C","E01020457",796,285,188,97,488,155,192,102,57,33,66,44,18,4,75,59,16,0,0,23,8,15
"2021","Dorset 003D","E01034374",821,185,42,143,603,27,252,68,162,22,199,87,108,4,124,102,22,1,1,33,15,18
"2021","Dorset 003E","E01034375",691,212,107,105,457,93,229,95,98,36,82,42,33,7,51,28,23,2,2,22,5,17
"2021","Dorset 005A","E01020433",780,205,127,78,536,157,277,124,103,50,63,25,31,7,37,19,18,2,2,39,11,28
"2021","Dorset 005B","E01020434",840,285,178,107,528,164,234,104,81,49,68,30,35,3,58,28,30,4,4,27,11,16
"2021","Dorset 005C","E01020449",947,266,185,81,642,225,282,149,85,48,80,49,29,2,52,23,29,3,3,39,11,28
"2021","Dorset 005D","E01020458",948,258,167,91,634,169,322,142,120,60,99,52,41,6,39,24,15,5,5,56,26,30
"2021","Dorset 005E","E01034376",561,160,87,73,374,60,182,67,73,42,55,20,31,4,69,42,27,8,8,27,12,15
"2021","Dorset 005F","E01034377",673,291,173,118,342,70,141,77,50,14,61,38,20,3,59,43,16,11,11,40,11,29
"2021","Dorset 006A","E01020444",773,179,97,82,559,118,283,124,111,48,59,33,22,4,97,49,48,2,2,35,21,14
"2021","Dorset 006B","E01020445",516,128,74,54,364,127,186,96,70,20,31,20,11,0,20,15,5,0,0,24,8,16
"2021","Dorset 006C","E01020446",703,194,143,51,478,162,220,114,69,37,61,37,19,5,34,16,18,1,1,31,14,17
"2021","Dorset 006D","E01020460",868,208,137,71,615,183,310,152,106,52,73,44,22,7,47,26,21,2,2,45,18,27
"2021","Dorset 009A","E01020442",883,209,123,86,633,178,309,150,104,55,87,53,28,6,57,30,27,2,2,41,15,26
"2021","Dorset 009B","E01020452",857,240,120,120,586,107,280,125,108,47,114,70,38,6,81,46,35,4,4,31,15,16
"2021","Dorset 009C","E01020453",775,174,103,71,560,138,292,129,116,47,82,50,29,3,47,24,23,1,1,41,22,19
"2021","Dorset 009D","E01034378",752,124,56,68,591,95,377,114,229,34,74,37,32,5,42,29,13,3,3,37,17,20
"2021","Dorset 011A","E01020435",795,260,108,152,503,90,273,117,100,56,87,43,41,3,53,37,16,0,0,32,12,20
"2021","Dorset 011B","E01020436",910,225,82,143,634,91,330,125,151,54,123,63,57,3,87,64,23,3,3,51,19,32
"2021","Dorset 011C","E01020437",826,195,126,69,613,136,296,119,127,50,89,41,42,6,90,56,34,2,2,18,6,12
"2021","Dorset 011D","E01020438",1121,583,278,305,501,105,183,98,65,20,128,95,33,0,80,51,29,5,5,37,15,22
"2021","Dorset 011E","E01020439",1111,435,247,188,634,94,296,125,131,40,123,52,58,13,115,72,43,6,6,42,15,27
"2021","Dorset 014A","E01020430",653,164,102,62,467,117,236,125,64,47,72,45,23,4,41,18,23,1,1,22,8,14
"2021","Dorset 014B","E01020431",453,102,57,45,332,72,172,92,59,21,53,31,16,6,35,18,17,0,0,19,4,15
"2021","Dorset 014C","E01020432",569,134,79,55,409,99,205,101,73,31,74,41,26,7,30,19,11,1,1,26,10,16
"2021","Dorset 014D","E01020441",871,199,103,96,625,135,327,160,101,66,91,50,31,10,68,34,34,4,4,47,15,32
"2021","Dorset 014E","E01020448",863,193,107,86,621,162,332,169,97,66,85,52,27,6,37,22,15,5,5,49,14,35
"2021","Dorset 027A","E01020465",871,270,150,120,568,121,300,120,126,54,90,50,37,3,55,27,28,2,2,33,13,20
"2021","Dorset 027B","E01020469",860,232,140,92,587,91,306,101,153,52,93,44,39,10,93,59,34,4,4,41,15,26
"2021","Dorset 027C","E01020470",775,173,122,51,571,173,312,137,125,50,46,29,14,3,39,15,24,1,1,31,9,22
"2021","Dorset 028A","E01020471",533,141,64,77,365,30,163,61,69,33,88,37,45,6,83,60,23,1,1,27,9,18
"2021","Dorset 028B","E01020472",658,208,125,83,425,94,197,77,80,40,64,33,25,6,67,39,28,3,3,25,11,14
"2021","Dorset 028C","E01020473",698,195,98,97,469,92,222,89,96,37,85,45,36,4,67,39,28,3,3,34,15,19
"2021","Dorset 028D","E01020474",864,218,144,74,598,192,292,136,99,57,81,53,25,3,31,12,19,2,2,48,18,30
"2021","Dorset 028E","E01020475",942,215,116,99,674,105,345,114,160,71,125,60,58,7,97,65,32,2,2,53,18,35
"2021","Dorset 033A","E01020476",517,144,88,56,347,96,187,80,70,37,40,23,14,3,23,13,10,1,1,26,8,18
"2021","Dorset 033B","E01020477",584,141,85,56,412,94,211,65,92,54,49,24,22,3,57,35,22,1,1,31,11,20
"2021","Dorset 033C","E01020485",740,326,203,123,373,109,139,67,36,36,69,37,25,7,55,30,25,1,1,41,10,31
"2021","Dorset 033D","E01020486",817,269,156,113,514,139,213,104,69,40,79,34,43,2,83,48,35,0,0,34,9,25
"2021","Dorset 033E","E01020487",515,137,90,47,349,84,177,56,89,32,43,18,21,4,44,27,17,1,1,29,4,25
"2021","Dorset 033F","E01020488",671,203,115,88,429,112,171,62,71,38,72,29,34,9,72,37,35,2,2,39,15,24
"2021","Dorset 035A","E01020489",562,146,77,69,381,85,198,85,74,39,59,35,22,2,35,22,13,4,4,35,12,23
"2021","Dorset 035B","E01020490",727,177,105,72,512,152,239,129,78,32,77,45,27,5,42,23,19,2,2,38,18,20
"2021","Dorset 035C","E01020491",707,176,98,78,496,124,237,101,95,41,69,34,34,1,62,42,20,4,4,35,14,21
"2021","Dorset 035D","E01020492",553,207,134,73,321,90,135,56,50,29,50,27,19,4,43,19,24,3,3,25,10,15
"2021","Dorset 035E","E01020493",781,139,43,96,608,31,387,106,239,42,100,50,46,4,85,53,32,5,5,34,13,21
"2021","Dorset 039A","E01020466",754,235,162,73,482,137,238,114,75,49,60,40,17,3,43,22,21,4,4,37,10,27
"2021","Dorset 039B","E01020467",794,185,123,62,561,172,293,150,97,46,53,24,25,4,39,21,18,4,4,48,16,32
"2021","Dorset 039C","E01020468",690,190,116,74,451,147,209,114,60,35,56,30,23,3,37,21,16,2,2,49,16,33
"2021","Dorset 042A","E01020478",497,153,102,51,326,87,165,73,59,33,33,20,13,0,40,25,15,1,1,18,8,10
"2021","Dorset 042B","E01020479",626,307,206,101,299,130,97,55,25,17,28,16,12,0,43,28,15,1,1,20,4,16
"2021","Dorset 042C","E01020480",831,265,177,88,535,205,218,119,59,40,60,40,18,2,47,28,19,5,5,31,8,23
"2021","Dorset 042D","E01020481",684,274,141,133,380,128,157,81,48,28,54,40,11,3,38,22,16,3,3,30,4,26
"2021","Dorset 042E","E01020482",756,287,153,134,425,83,189,87,65,37,78,43,34,1,74,41,33,1,1,44,16,28
"2021","Dorset 042F","E01020483",474,97,45,52,361,62,171,65,68,38,64,25,33,6,61,33,28,3,3,16,5,11
"2021","Dorset 042G","E01020484",642,197,122,75,412,86,201,82,77,42,52,25,18,9,72,43,29,1,1,33,12,21
"2021","Dorset 004A","E01020542",713,282,192,90,408,143,145,78,42,25,71,55,16,0,48,30,18,1,1,23,5,18
"2021","Dorset 004B","E01020543",651,223,124,99,405,67,154,50,78,26,74,34,36,4,108,70,38,2,2,23,11,12
"2021","Dorset 004C","E01020544",856,409,269,140,423,156,154,85,52,17,48,36,12,0,60,35,25,5,5,24,3,21
"2021","Dorset 004D","E01020546",535,283,160,123,230,69,88,38,32,18,28,17,10,1,45,30,15,0,0,22,8,14
"2021","Dorset 004E","E01020547",584,269,168,101,302,54,128,61,42,25,53,22,26,5,65,47,18,2,2,13,5,8
"2021","Dorset 004F","E01034379",643,210,123,87,412,82,159,40,99,20,92,48,42,2,79,62,17,0,0,21,11,10
"2021","Dorset 004G","E01034380",718,244,155,89,453,165,197,80,71,46,39,21,18,0,49,29,20,3,3,21,8,13
"2021","Dorset 008A","E01020497",826,217,139,78,588,157,308,130,119,59,61,32,23,6,60,30,30,2,2,21,7,14
"2021","Dorset 008B","E01020508",884,209,124,85,632,193,329,151,109,69,64,35,27,2,42,21,21,4,4,43,17,26
"2021","Dorset 008C","E01020541",949,218,130,88,690,192,337,160,130,47,101,84,15,2,58,36,22,2,2,41,17,24
"2021","Dorset 008D","E01020550",779,220,141,79,537,150,272,126,92,54,69,46,20,3,46,26,20,0,0,22,7,15
"2021","Dorset 019A","E01020494",549,129,71,58,398,87,209,98,81,30,65,41,21,3,35,20,15,2,2,22,9,13
"2021","Dorset 019B","E01020495",674,218,149,69,440,154,182,88,71,23,57,35,19,3,45,23,22,2,2,16,3,13
"2021","Dorset 019C","E01020496",819,307,206,101,486,154,176,95,56,25,77,41,30,6,78,43,35,1,1,26,5,21
"2021","Dorset 019D","E01020506",794,214,141,73,539,171,265,133,84,48,69,42,23,4,33,15,18,1,1,41,11,30
"2021","Dorset 019E","E01020530",822,208,96,112,565,145,298,148,84,66,79,47,25,7,38,16,22,5,5,49,17,32
"2021","Dorset 019F","E01020534",927,247,140,107,633,140,328,161,122,45,90,47,38,5,71,42,29,4,4,47,19,28
"2021","Dorset 022A","E01020509",1193,307,210,97,815,223,400,173,156,71,100,55,39,6,90,54,36,2,2,71,27,44
"2021","Dorset 022B","E01020510",1117,386,232,154,694,138,324,134,142,48,128,64,57,7,98,62,36,6,6,37,9,28
"2021","Dorset 022C","E01020529",1013,281,164,117,688,165,363,170,133,60,100,66,29,5,59,34,25,1,1,44,16,28
"2021","Dorset 022D","E01020539",901,228,128,100,632,136,354,159,139,56,100,65,31,4,39,21,18,3,3,41,19,22
"2021","Dorset 022E","E01020540",1125,259,156,103,807,176,435,198,173,64,112,72,34,6,83,49,34,1,1,59,18,41
"2021","Dorset 023A","E01020511",808,282,192,90,491,172,201,106,62,33,61,32,26,3,56,37,19,1,1,35,12,23
"2021","Dorset 023B","E01020532",832,320,191,129,486,240,184,105,45,34,30,21,8,1,32,19,13,0,0,26,8,18
"2021","Dorset 023C","E01020533",1003,350,202,148,628,153,276,115,102,59,99,54,41,4,99,59,40,1,1,25,10,15
"2021","Dorset 023D","E01020535",781,201,116,85,532,165,257,142,68,47,60,33,22,5,48,24,24,2,2,48,18,30
"2021","Dorset 026A","E01020498",956,285,187,98,645,198,279,126,97,56,96,52,39,5,71,38,33,1,1,26,7,19
"2021","Dorset 026B","E01020499",626,257,125,132,355,48,143,59,53,31,80,34,37,9,84,48,36,0,0,14,3,11
"2021","Dorset 026C","E01020500",926,460,273,187,428,103,161,84,52,25,89,57,31,1,72,44,28,3,3,38,6,32
"2021","Dorset 026D","E01020501",610,150,100,50,432,115,213,109,73,31,51,27,20,4,53,31,22,0,0,28,4,24
"2021","Dorset 029A","E01020507",887,259,188,71,600,204,273,153,70,50,72,39,30,3,50,20,30,1,1,28,7,21
"2021","Dorset 029B","E01020517",846,253,164,89,552,178,252,131,69,52,70,41,26,3,48,16,32,4,4,41,12,29
"2021","Dorset 029C","E01020531",795,229,140,89,538,148,262,134,83,45,70,40,27,3,54,28,26,4,4,28,10,18
"2021","Dorset 029D","E01020536",973,244,127,117,689,129,355,166,129,60,106,50,49,7,94,54,40,5,5,40,17,23
"2021","Dorset 030A","E01020502",866,364,176,188,478,82,178,71,79,28,97,46,41,10,121,91,30,0,0,24,8,16
"2021","Dorset 030B","E01020503",916,449,261,188,433,109,169,85,52,32,81,50,28,3,68,40,28,6,6,34,12,22
"2021","Dorset 030C","E01020504",1078,346,230,116,707,287,315,188,76,51,53,32,21,0,50,26,24,2,2,25,2,23
"2021","Dorset 034A","E01020518",824,364,183,181,433,65,186,82,79,25,86,46,36,4,91,59,32,5,5,27,8,19
"2021","Dorset 034B","E01020519",802,293,161,132,485,94,227,83,109,35,89,41,42,6,72,47,25,3,3,24,12,12
"2021","Dorset 034C","E01020520",682,231,134,97,432,88,211,71,102,38,62,39,20,3,66,40,26,5,5,19,8,11
"2021","Dorset 034D","E01020523",521,143,64,79,359,55,215,69,108,38,58,32,19,7,29,16,13,2,2,19,7,12
"2021","Dorset 034E","E01020524",620,172,136,36,419,109,206,75,92,39,53,25,23,5,49,24,25,2,2,29,10,19
"2021","Dorset 034F","E01020525",516,97,75,22,403,100,248,87,111,50,27,10,14,3,27,15,12,1,1,16,7,9
"2021","Dorset 036A","E01020505",850,199,135,64,617,163,338,137,139,62,60,40,18,2,54,24,30,2,2,34,15,19
"2021","Dorset 036B","E01020537",898,198,122,76,652,171,319,148,110,61,99,56,38,5,63,38,25,0,0,48,16,32
"2021","Dorset 036C","E01020538",836,243,155,88,576,123,307,136,112,59,88,49,33,6,57,32,25,1,1,17,7,10
"2021","Dorset 036D","E01020549",930,270,166,104,609,140,300,135,112,53,107,65,36,6,60,36,24,2,2,51,15,36
"2021","Dorset 037A","E01020512",959,260,162,98,646,199,305,158,97,50,85,49,28,8,54,24,30,3,3,53,16,37
"2021","Dorset 037B","E01020513",748,230,149,81,493,105,233,96,86,51,88,44,35,9,66,33,33,1,1,25,9,16
"2021","Dorset 037C","E01020514",822,211,90,121,573,103,293,124,128,41,102,48,51,3,73,47,26,2,2,38,15,23
"2021","Dorset 037D","E01020515",506,176,101,75,307,54,146,63,60,23,59,27,28,4,48,26,22,0,0,23,6,17
"2021","Dorset 037E","E01020516",694,206,124,82,450,118,204,95,64,45,71,43,21,7,55,27,28,2,2,38,20,18
"2021","Dorset 038A","E01020551",1020,348,124,224,624,71,252,110,108,34,163,88,65,10,132,95,37,6,6,48,21,27
"2021","Dorset 038B","E01020552",766,278,119,159,448,39,174,64,77,33,88,25,49,14,144,95,49,3,3,40,20,20
"2021","Dorset 038C","E01020570",732,202,118,84,499,125,241,128,64,49,77,52,22,3,55,17,38,1,1,31,7,24
"2021","Dorset 038D","E01020571",968,321,123,198,597,65,256,96,114,46,161,88,70,3,112,72,40,3,3,50,23,27
"2021","Dorset 040A","E01020557",800,275,204,71,506,217,202,118,52,32,43,32,11,0,43,15,28,1,1,19,7,12
"2021","Dorset 040B","E01020558",821,204,131,73,576,211,267,142,78,47,46,31,11,4,51,28,23,1,1,41,16,25
"2021","Dorset 040C","E01020559",819,209,168,41,581,250,262,134,68,60,45,30,14,1,22,5,17,2,2,29,7,22
"2021","Dorset 040D","E01020560",815,203,123,80,578,186,286,128,101,57,62,28,30,4,41,21,20,3,3,34,8,26
"2021","Dorset 040E","E01020561",854,324,144,180,478,71,210,83,91,36,109,54,48,7,83,54,29,5,5,52,15,37
"2021","Dorset 041A","E01020574",783,188,114,74,544,102,248,97,93,58,101,46,48,7,92,52,40,1,1,51,22,29
"2021","Dorset 041B","E01020575",749,250,129,121,460,30,178,54,79,45,109,43,59,7,138,96,42,5,5,39,21,18
"2021","Dorset 041C","E01020576",759,219,171,48,502,137,247,113,88,46,71,35,32,4,47,27,20,0,0,38,14,24
"2021","Dorset 041D","E01020579",909,259,129,130,604,155,310,111,129,70,78,43,31,4,60,32,28,1,1,46,16,30
"2021","Dorset 041E","E01020580",646,160,105,55,450,120,225,77,100,48,54,33,20,1,47,27,20,4,4,36,11,25
"2021","Dorset 044A","E01020553",681,306,83,223,314,53,105,43,51,11,73,44,26,3,78,55,23,5,5,61,18,43
"2021","Dorset 044B","E01020554",1078,656,221,435,363,37,122,79,31,12,114,94,17,3,84,63,21,6,6,59,11,48
"2021","Dorset 044C","E01020555",742,349,123,226,335,42,116,51,47,18,102,66,28,8,73,51,22,2,2,58,15,43
"2021","Dorset 044D","E01020556",853,406,171,235,399,103,131,78,29,24,102,84,17,1,58,42,16,5,5,48,11,37
"2021","Dorset 044E","E01020581",926,379,201,178,501,153,196,107,59,30,83,50,26,7,67,34,33,2,2,46,12,34
"2021","Dorset 044F","E01020582",782,362,185,177,388,75,132,56,57,19,78,41,28,9,96,62,34,7,7,32,10,22
"2021","Dorset 043A","E01020572",893,326,112,214,474,55,218,83,91,44,123,77,42,4,70,38,32,8,8,93,41,52
"2021","Dorset 043B","E01020573",920,408,211,197,464,86,198,96,60,42,88,56,32,0,86,41,45,6,6,48,11,37
"2021","Dorset 043C","E01020577",788,212,100,112,534,67,249,86,109,54,126,59,56,11,92,52,40,0,0,42,14,28
"2021","Dorset 043D","E01020578",927,322,212,110,559,106,249,101,97,51,103,60,39,4,99,49,50,2,2,46,24,22
"2021","Dorset 045A","E01020583",819,230,137,93,555,142,284,142,96,46,78,39,28,11,51,33,18,0,0,34,8,26
"2021","Dorset 045B","E01020584",752,242,96,146,468,89,198,93,61,44,105,54,40,11,73,45,28,3,3,42,14,28
"2021","Dorset 045C","E01020585",605,154,76,78,413,65,197,63,92,42,56,23,25,8,93,60,33,2,2,38,15,23
"2021","Dorset 046A","E01020586",536,143,89,54,363,66,178,74,70,34,63,32,28,3,52,33,19,4,4,30,13,17
"2021","Dorset 046B","E01020587",659,208,112,96,423,87,184,74,72,38,83,44,28,11,67,44,23,2,2,28,14,14
"2021","Dorset 046C","E01020588",599,134,85,49,434,97,180,66,71,43,108,39,66,3,45,27,18,4,4,31,18,13
"2021","Dorset 046D","E01020589",638,203,102,101,403,81,171,74,54,43,77,37,34,6,72,41,31,2,2,32,10,22
"2021","Dorset 047A","E01020563",545,153,89,64,368,78,167,84,60,23,59,31,26,2,64,43,21,0,0,24,7,17
"2021","Dorset 047B","E01020569",809,319,94,225,450,50,174,84,58,32,89,42,41,6,134,105,29,3,3,40,11,29
"2021","Dorset 047C","E01033200",1073,400,133,267,612,79,275,139,88,48,130,76,46,8,118,76,42,10,10,61,21,40
"2021","Dorset 048A","E01020562",986,313,158,155,615,111,295,148,95,52,128,73,47,8,76,41,35,5,5,58,20,38
"2021","Dorset 048B","E01020564",663,164,63,101,468,71,175,63,73,39,100,34,57,9,120,83,37,2,2,31,15,16
"2021","Dorset 048C","E01020565",688,193,124,69,470,95,210,98,73,39,75,40,32,3,88,49,39,2,2,25,11,14
"2021","Dorset 048D","E01020566",954,278,163,115,637,171,305,156,95,54,99,51,42,6,56,34,22,6,6,39,12,27
"2021","Dorset 031A","E01032643",763,301,137,164,432,61,214,103,75,36,89,51,34,4,65,37,28,3,3,30,6,24
"2021","Dorset 031B","E01032644",729,434,246,188,264,59,94,56,31,7,59,51,8,0,47,29,18,5,5,31,5,26
"2021","Dorset 031C","E01032645",831,446,249,197,348,108,124,63,50,11,75,41,32,2,38,22,16,3,3,37,5,32
"2021","Dorset 031D","E01034381",708,247,141,106,446,111,165,76,67,22,89,45,40,4,78,64,14,3,3,15,4,11
"2021","Dorset 032A","E01020526",529,129,77,52,375,93,209,73,88,48,26,10,13,3,45,30,15,2,2,25,12,13
"2021","Dorset 032B","E01020527",619,190,67,123,392,41,199,70,97,32,75,36,32,7,74,40,34,3,3,37,9,28
"2021","Dorset 032C","E01020528",1103,353,177,176,706,162,302,101,151,50,90,39,39,12,147,93,54,5,5,44,20,24
"2021","Dorset 032D","E01034382",751,239,100,139,480,132,156,63,65,28,73,39,31,3,115,87,28,4,4,32,12,20
"2021","East Devon 001A","E01019902",1003,308,157,151,646,163,302,133,117,52,116,70,40,6,61,37,24,4,4,49,19,30
"2021","East Devon 001B","E01019938",942,189,119,70,663,179,341,143,132,66,95,62,29,4,45,22,23,3,3,90,35,55
"2021","East Devon 001C","E01019967",570,117,64,53,419,129,211,103,74,34,56,33,20,3,22,13,9,1,1,34,9,25
"2021","East Devon 002A","E01019927",660,292,164,128,342,68,107,39,53,15,89,47,35,7,74,46,28,4,4,26,6,20
"2021","East Devon 002B","E01019932",867,401,185,216,428,88,163,64,70,29,94,60,33,1,79,42,37,4,4,38,13,25
"2021","East Devon 002C","E01019933",664,258,132,126,383,88,149,77,46,26,89,51,34,4,54,32,22,3,3,23,1,22
"2021","East Devon 002D","E01019934",838,256,175,81,533,179,224,104,90,30,72,40,28,4,58,27,31,0,0,49,19,30
"2021","East Devon 003A","E01019928",619,162,84,78,428,66,208,93,79,36,87,47,37,3,64,38,26,3,3,29,8,21
"2021","East Devon 003B","E01019929",628,199,106,93,406,68,192,66,84,42,81,54,24,3,64,39,25,1,1,23,6,17
"2021","East Devon 003C","E01019930",695,222,132,90,449,125,200,99,75,26,71,40,31,0,52,28,24,1,1,24,12,12
"2021","East Devon 003D","E01019931",527,125,77,48,391,122,182,80,70,32,57,31,20,6,27,18,9,3,3,11,5,6
"2021","East Devon 004A","E01019925",551,136,73,63,402,65,217,81,109,27,76,40,33,3,42,22,20,2,2,13,4,9
"2021","East Devon 004D","E01019959",519,114,73,41,371,87,206,98,77,31,46,26,20,0,28,16,12,4,4,34,12,22
"2021","East Devon 004E","E01019960",566,98,62,36,437,96,258,101,115,42,57,27,26,4,24,11,13,2,2,31,15,16
"2021","East Devon 004F","E01019962",1012,261,155,106,715,171,384,160,153,71,95,60,30,5,62,36,26,3,3,36,8,28
"2021","East Devon 004G","E01032628",1074,271,157,114,747,158,387,148,173,66,137,85,45,7,65,37,28,0,0,56,23,33
"2021","East Devon 005B","E01019887",780,259,137,122,487,93,180,73,77,30,101,49,49,3,110,76,34,3,3,34,12,22
"2021","East Devon 005C","E01019888",865,373,202,171,461,122,187,88,68,31,93,59,29,5,54,19,35,5,5,31,1,30
"2021","East Devon 005D","E01019889",826,252,165,87,543,136,248,112,91,45,98,50,37,11,59,31,28,2,2,31,12,19
"2021","East Devon 005E","E01019966",496,124,89,35,347,103,176,82,60,34,42,25,14,3,26,10,16,0,0,25,9,16
"2021","East Devon 005F","E01034618",756,229,115,114,497,82,231,92,102,37,95,38,46,11,89,57,32,0,0,30,10,20
"2021","East Devon 005G","E01034619",691,147,80,67,490,114,246,103,103,40,69,35,31,3,60,32,28,1,1,54,30,24
"2021","East Devon 007A","E01019899",666,227,144,83,425,95,199,81,79,39,69,35,28,6,59,32,27,3,3,14,4,10
"2021","East Devon 007B","E01019900",850,240,183,57,575,233,237,114,67,56,59,31,22,6,45,25,20,1,1,35,13,22
"2021","East Devon 007C","E01019935",598,143,94,49,425,139,193,83,72,38,50,29,15,6,42,16,26,1,1,30,11,19
"2021","East Devon 007D","E01019936",515,150,109,41,341,101,175,80,61,34,38,19,14,5,24,8,16,3,3,24,7,17
"2021","East Devon 007E","E01019961",1108,275,172,103,792,211,430,211,149,70,84,36,37,11,61,30,31,6,6,41,18,23
"2021","East Devon 008A","E01019939",708,151,104,47,520,172,266,103,119,44,45,21,22,2,37,17,20,0,0,37,12,25
"2021","East Devon 008B","E01019940",706,160,116,44,508,163,283,99,121,63,45,23,19,3,17,7,10,0,0,38,17,21
"2021","East Devon 008C","E01019942",1069,336,186,150,698,135,337,125,169,43,103,49,53,1,123,78,45,0,0,35,10,25
"2021","East Devon 008D","E01019943",729,167,124,43,519,126,244,80,120,44,78,34,35,9,71,36,35,0,0,43,23,20
"2021","East Devon 008E","E01019944",804,261,119,142,512,84,227,86,114,27,111,59,43,9,87,59,28,3,3,31,12,19
"2021","East Devon 009A","E01019890",818,247,162,85,530,134,243,124,77,42,84,44,35,5,66,28,38,3,3,41,14,27
"2021","East Devon 009B","E01019901",598,152,77,75,396,118,209,89,74,46,49,23,18,8,20,8,12,0,0,50,12,38
"2021","East Devon 009C","E01019951",1003,281,203,78,683,269,292,151,92,49,66,42,22,2,53,29,24,3,3,39,10,29
"2021","East Devon 010A","E01019946",662,188,148,40,454,203,172,97,50,25,35,21,9,5,42,17,25,2,2,20,2,18
"2021","East Devon 010B","E01019947",1174,607,348,259,525,150,186,93,65,28,111,74,36,1,74,48,26,4,4,42,16,26
"2021","East Devon 010C","E01019948",638,215,163,52,409,162,157,87,39,31,50,22,23,5,40,20,20,0,0,14,4,10
"2021","East Devon 010D","E01019949",763,239,155,84,500,189,193,86,66,41,65,45,17,3,53,29,24,0,0,24,6,18
"2021","East Devon 010E","E01019950",638,227,138,89,393,132,156,81,50,25,50,30,16,4,53,29,24,2,2,18,4,14
"2021","East Devon 011A","E01019952",844,290,202,88,527,174,230,96,90,44,65,40,22,3,56,31,25,2,2,27,11,16
"2021","East Devon 011B","E01019953",747,211,154,57,503,188,215,107,71,37,40,18,20,2,58,32,26,2,2,33,11,22
"2021","East Devon 011C","E01019954",894,279,131,148,585,123,238,94,95,49,98,38,48,12,121,83,38,5,5,30,15,15
"2021","East Devon 011D","E01019955",776,284,201,83,458,144,194,77,83,34,53,35,17,1,61,31,30,6,6,34,13,21
"2021","East Devon 012A","E01019956",928,464,327,137,412,134,157,65,69,23,70,52,13,5,49,24,25,2,2,52,10,42
"2021","East Devon 012B","E01019957",947,381,312,69,531,313,165,118,30,17,32,24,7,1,21,8,13,0,0,35,7,28
"2021","East Devon 012C","E01019958",832,258,182,76,551,205,249,113,84,52,54,27,23,4,41,20,21,2,2,23,9,14
"2021","East Devon 013A","E01019937",989,237,166,71,703,176,329,151,112,66,114,60,41,13,81,45,36,3,3,49,15,34
"2021","East Devon 013B","E01019945",904,236,133,103,626,162,301,124,107,70,100,57,41,2,61,32,29,2,2,42,21,21
"2021","East Devon 013C","E01019963",782,234,122,112,525,120,272,102,139,31,83,49,30,4,50,29,21,0,0,23,5,18
"2021","East Devon 014A","E01019898",1171,269,150,119,834,245,395,160,170,65,121,68,48,5,71,39,32,2,2,68,34,34
"2021","East Devon 014B","E01019964",430,90,54,36,307,88,176,67,76,33,28,21,7,0,15,7,8,0,0,33,8,25
"2021","East Devon 014C","E01019965",783,195,123,72,551,123,300,116,152,32,75,48,23,4,52,32,20,1,1,37,12,25
"2021","East Devon 015A","E01019904",644,205,122,83,415,93,188,72,79,37,52,17,32,3,78,37,41,4,4,24,8,16
"2021","East Devon 015B","E01019905",765,135,87,48,584,157,335,145,133,57,62,35,23,4,28,12,16,2,2,46,21,25
"2021","East Devon 015C","E01019906",667,201,116,85,452,80,247,104,95,48,75,35,35,5,48,34,14,2,2,14,5,9
"2021","East Devon 015D","E01019907",689,201,159,42,463,140,237,111,88,38,45,19,24,2,41,16,25,0,0,25,7,18
"2021","East Devon 016A","E01019908",707,181,76,105,496,49,232,82,114,36,111,54,46,11,102,78,24,2,2,30,10,20
"2021","East Devon 016B","E01019909",820,231,171,60,549,186,256,103,97,56,64,32,28,4,41,18,23,2,2,40,11,29
"2021","East Devon 016C","E01019910",702,167,115,52,498,119,258,97,113,48,63,21,36,6,57,33,24,1,1,37,11,26
"2021","East Devon 016D","E01019911",803,274,212,62,496,182,210,115,56,39,64,42,19,3,39,19,20,1,1,33,8,25
"2021","East Devon 017A","E01019894",754,296,244,52,439,223,149,84,41,24,40,31,8,1,27,13,14,0,0,19,3,16
"2021","East Devon 017B","E01019895",718,194,148,46,497,205,207,94,62,51,52,25,21,6,33,19,14,0,0,27,12,15
"2021","East Devon 017C","E01019896",770,273,197,76,479,224,187,92,60,35,37,21,14,2,31,18,13,0,0,18,6,12
"2021","East Devon 017D","E01019897",713,254,144,110,433,69,210,75,95,40,76,34,37,5,78,47,31,0,0,26,11,15
"2021","East Devon 018A","E01019920",698,181,71,110,486,61,245,110,94,41,97,52,43,2,79,55,24,4,4,31,13,18
"2021","East Devon 018B","E01019921",641,156,96,60,453,91,247,87,104,56,58,29,25,4,55,35,20,2,2,32,11,21
"2021","East Devon 018C","E01019922",651,215,146,69,376,59,181,52,85,44,64,28,29,7,69,35,34,3,3,60,21,39
"2021","East Devon 018D","E01019923",543,143,86,57,368,75,186,79,70,37,53,23,26,4,52,26,26,2,2,32,12,20
"2021","East Devon 018E","E01019924",620,149,53,96,442,60,193,77,82,34,99,52,46,1,90,50,40,0,0,29,9,20
"2021","East Devon 019A","E01019916",1001,432,147,285,478,50,156,65,69,22,151,106,42,3,112,68,44,9,9,91,22,69
"2021","East Devon 019B","E01019917",675,212,95,117,418,61,194,69,87,38,90,50,36,4,72,46,26,1,1,45,11,34
"2021","East Devon 019C","E01019918",908,411,147,264,450,102,179,93,60,26,94,72,17,5,68,44,24,7,7,47,13,34
"2021","East Devon 019D","E01019919",784,265,117,148,473,60,180,73,84,23,119,67,37,15,101,53,48,13,13,46,13,33
"2021","East Devon 020A","E01019912",851,366,224,142,445,146,177,95,52,30,70,47,19,4,43,24,19,9,9,40,10,30
"2021","East Devon 020B","E01019913",898,409,296,113,463,229,173,97,47,29,42,27,10,5,17,7,10,2,2,26,7,19
"2021","East Devon 020C","E01019914",1097,360,193,167,678,142,275,109,122,44,130,53,70,7,127,78,49,4,4,59,24,35
"2021","East Devon 020D","E01019915",837,259,187,72,547,184,254,111,97,46,69,38,26,5,40,22,18,0,0,31,11,20
"2021","East Devon 021B","E01019891",664,155,76,79,460,82,266,93,116,57,65,42,20,3,44,32,12,3,3,49,21,28
"2021","East Devon 021A","E01019903",938,299,165,134,591,128,322,131,135,56,88,54,29,5,49,25,24,4,4,48,20,28
"2021","East Devon 021C","E01034620",718,170,109,61,499,64,294,103,144,47,81,49,26,6,55,35,20,5,5,49,12,37
"2021","East Devon 021D","E01034621",683,127,31,96,520,39,240,65,152,23,138,71,66,1,102,85,17,1,1,36,16,20
"2021","East Devon 021E","E01034622",688,107,19,88,530,25,229,79,136,14,199,134,64,1,74,64,10,3,3,51,21,30
"2021","East Devon 021F","E01034623",648,129,60,69,472,71,258,89,122,47,70,36,30,4,70,46,24,3,3,47,14,33
"2021","East Devon 022A","E01034624",711,139,4,135,540,7,213,67,136,10,241,162,75,4,72,58,14,7,7,32,13,19
"2021","East Devon 022B","E01034625",604,105,8,97,472,13,243,55,172,16,134,69,62,3,77,66,11,5,5,27,15,12
"2021","East Devon 022C","E01034626",509,80,11,69,399,12,201,59,132,10,105,58,42,5,79,56,23,2,2,30,13,17
"2021","East Devon 022D","E01034627",446,90,8,82,338,7,166,35,121,10,101,48,52,1,63,51,12,1,1,18,7,11
"2021","Exeter 001C","E01019998",594,158,81,77,402,76,209,77,111,21,70,44,23,3,43,24,19,4,4,34,9,25
"2021","Exeter 001D","E01019999",516,125,64,61,304,75,165,61,81,23,40,23,14,3,23,11,12,1,1,87,10,77
"2021","Exeter 001E","E01020001",608,177,77,100,398,98,200,90,82,28,62,47,15,0,27,13,14,11,11,33,10,23
"2021","Exeter 001G","E01034628",497,130,82,48,329,103,153,68,55,30,42,31,10,1,29,12,17,2,2,38,6,32
"2021","Exeter 001H","E01034629",476,137,61,76,263,68,116,45,47,24,30,20,9,1,44,21,23,5,5,76,9,67
"2021","Exeter 002A","E01019990",620,189,72,117,397,28,165,64,67,34,79,30,47,2,114,80,34,11,11,34,10,24
"2021","Exeter 002B","E01019991",633,169,69,100,418,34,159,42,98,19,108,43,56,9,114,76,38,3,3,46,13,33
"2021","Exeter 002C","E01019993",496,131,67,64,330,57,184,72,75,37,51,31,18,2,36,18,18,2,2,35,16,19
"2021","Exeter 002D","E01020000",584,216,87,129,307,37,142,52,65,25,56,30,23,3,66,34,32,6,6,61,9,52
"2021","Exeter 002E","E01020007",496,120,23,97,146,5,76,28,37,11,45,31,11,3,16,14,2,4,4,230,8,222
"2021","Exeter 003A","E01019992",634,155,71,84,428,73,218,64,101,53,70,44,20,6,64,36,28,3,3,51,8,43
"2021","Exeter 003B","E01020002",900,214,103,111,636,71,323,104,171,48,124,57,59,8,115,76,39,3,3,50,17,33
"2021","Exeter 003C","E01020003",742,184,125,59,525,127,250,86,126,38,87,50,34,3,61,36,25,0,0,33,10,23
"2021","Exeter 003D","E01020004",993,235,103,132,696,97,360,121,184,55,151,97,49,5,86,56,30,2,2,62,17,45
"2021","Exeter 003E","E01020005",828,231,114,117,544,80,257,91,115,51,99,43,47,9,106,64,42,2,2,53,24,29
"2021","Exeter 004A","E01019997",610,187,39,148,222,16,92,40,46,6,80,60,18,2,25,15,10,9,9,201,8,193
"2021","Exeter 004B","E01020019",605,182,80,102,143,22,70,22,34,14,31,25,5,1,10,7,3,10,10,280,6,274
"2021","Exeter 004C","E01020020",612,213,34,179,195,23,83,41,36,6,57,47,9,1,23,12,11,9,9,204,8,196
"2021","Exeter 004D","E01020021",546,141,58,83,247,34,121,43,63,15,64,51,12,1,21,16,5,7,7,158,7,151
"2021","Exeter 004E","E01020022",703,298,62,236,197,7,59,26,28,5,81,67,12,2,39,26,13,11,11,208,8,200
"2021","Exeter 005A","E01019980",737,239,73,166,443,25,185,70,88,27,121,62,55,4,108,76,32,4,4,55,14,41
"2021","Exeter 005B","E01019982",736,243,57,186,448,26,178,82,68,28,141,84,54,3,96,69,27,7,7,45,24,21
"2021","Exeter 005C","E01019983",636,169,102,67,432,101,203,85,71,47,71,32,32,7,56,39,17,1,1,35,8,27
"2021","Exeter 005D","E01019984",550,126,55,71,384,57,190,73,82,35,83,49,30,4,54,31,23,0,0,40,15,25
"2021","Exeter 005E","E01019985",586,162,59,103,388,33,147,49,69,29,81,35,39,7,121,80,41,6,6,36,9,27
"2021","Exeter 006A","E01019987",686,310,153,157,272,48,116,31,65,20,64,46,16,2,33,25,8,11,11,104,8,96
"2021","Exeter 006B","E01019989",522,154,74,80,317,39,142,54,66,22,87,60,24,3,46,22,24,3,3,51,7,44
"2021","Exeter 006C","E01020006",846,192,74,118,534,36,244,70,140,34,116,74,38,4,128,78,50,10,10,120,22,98
"2021","Exeter 006D","E01020008",601,135,29,106,234,12,130,40,74,16,66,48,17,1,21,13,8,5,5,232,8,224
"2021","Exeter 006E","E01020009",600,194,64,130,333,39,188,53,111,24,69,50,14,5,36,19,17,1,1,73,5,68
"2021","Exeter 007A","E01019986",603,170,90,80,398,68,223,76,119,28,66,37,26,3,39,22,17,2,2,35,10,25
"2021","Exeter 007B","E01020036",647,218,117,101,394,62,212,71,99,42,61,35,19,7,55,32,23,4,4,35,11,24
"2021","Exeter 007C","E01020037",603,171,85,86,400,41,158,53,70,35,76,34,39,3,119,76,43,6,6,32,12,20
"2021","Exeter 007D","E01020039",842,313,155,158,493,68,202,68,88,46,107,43,54,10,115,80,35,1,1,36,12,24
"2021","Exeter 007E","E01020040",565,174,78,96,356,57,196,68,91,37,55,25,29,1,45,28,17,3,3,35,10,25
"2021","Exeter 008A","E01019994",647,268,102,166,248,18,101,45,47,9,88,64,24,0,34,23,11,7,7,131,12,119
"2021","Exeter 008B","E01019995",856,497,158,339,272,33,100,44,40,16,83,58,22,3,53,29,24,3,3,87,3,84
"2021","Exeter 008D","E01020017",991,446,82,364,357,22,122,51,57,14,140,113,25,2,60,41,19,13,13,188,12,176
"2021","Exeter 008E","E01020018",1124,617,206,411,351,37,102,57,39,6,145,121,22,2,54,35,19,13,13,156,7,149
"2021","Exeter 008F","E01034630",591,323,80,243,214,24,71,48,21,2,83,76,6,1,25,16,9,11,11,54,5,49
"2021","Exeter 008G","E01034631",649,369,88,281,213,14,67,41,21,5,77,58,18,1,45,29,16,10,10,67,6,61
"2021","Exeter 009A","E01019996",536,248,74,174,231,13,118,56,54,8,63,51,12,0,34,20,14,3,3,57,4,53
"2021","Exeter 009B","E01020023",985,330,154,176,584,104,314,96,187,31,94,62,29,3,71,35,36,1,1,71,15,56
"2021","Exeter 009C","E01020024",671,237,113,124,397,57,223,70,127,26,66,50,12,4,51,27,24,0,0,37,2,35
"2021","Exeter 009D","E01020025",739,310,84,226,371,26,148,57,78,13,142,113,26,3,49,31,18,6,6,58,4,54
"2021","Exeter 010A","E01019975",484,104,55,49,332,27,168,45,84,39,63,31,28,4,72,43,29,2,2,48,13,35
"2021","Exeter 010B","E01020029",670,186,76,110,407,39,192,72,91,29,109,65,38,6,61,36,25,6,6,77,15,62
"2021","Exeter 010C","E01020030",970,402,160,242,486,40,186,81,82,23,166,120,42,4,85,56,29,9,9,82,21,61
"2021","Exeter 010D","E01020031",683,185,73,112,429,32,220,77,111,32,94,54,32,8,80,51,29,3,3,69,10,59
"2021","Exeter 010E","E01020032",689,256,102,154,357,53,164,58,77,29,96,66,27,3,39,20,19,5,5,76,13,63
"2021","Exeter 011A","E01020026",742,195,120,75,509,130,246,71,111,64,88,55,29,4,42,21,21,3,3,38,9,29
"2021","Exeter 011B","E01020027",701,208,86,122,431,62,220,82,96,42,87,52,27,8,57,22,35,5,5,62,19,43
"2021","Exeter 011E","E01020038",1047,242,86,156,742,93,393,118,226,49,159,84,67,8,88,58,30,9,9,63,21,42
"2021","Exeter 011F","E01033232",594,146,38,108,402,30,190,51,119,20,101,67,31,3,71,51,20,10,10,46,13,33
"2021","Exeter 011G","E01033234",851,195,56,139,604,82,341,113,179,49,109,65,39,5,71,44,27,1,1,52,7,45
"2021","Exeter 011H","E01034632",487,129,88,41,340,90,176,65,68,43,49,26,18,5,24,8,16,1,1,18,6,12
"2021","Exeter 011I","E01034633",804,142,32,110,596,47,323,96,198,29,136,82,47,7,89,72,17,1,1,66,19,47
"2021","Exeter 012A","E01019973",632,194,114,80,390,86,194,74,81,39,60,30,28,2,50,19,31,0,0,48,19,29
"2021","Exeter 012B","E01019974",619,177,94,83,408,93,190,79,81,30,81,51,26,4,42,19,23,2,2,34,11,23
"2021","Exeter 012C","E01019976",622,186,111,75,400,103,209,82,94,33,51,29,18,4,37,18,19,0,0,36,11,25
"2021","Exeter 012D","E01019977",608,168,113,55,408,66,216,68,105,43,71,30,34,7,50,30,20,5,5,32,8,24
"2021","Exeter 012E","E01019981",596,148,62,86,408,53,179,73,78,28,69,33,28,8,103,72,31,4,4,40,11,29
"2021","Exeter 013A","E01019988",634,222,155,67,367,61,188,63,85,40,66,39,22,5,48,28,20,4,4,45,11,34
"2021","Exeter 013B","E01020010",808,223,88,135,542,64,263,83,145,35,105,41,43,21,102,66,36,8,8,43,12,31
"2021","Exeter 013C","E01020013",594,211,75,136,306,34,147,61,55,31,73,57,16,0,48,29,19,4,4,77,16,61
"2021","Exeter 013D","E01020014",637,217,78,139,383,28,176,60,73,43,75,30,38,7,98,57,41,6,6,37,12,25
"2021","Exeter 013E","E01020015",860,262,131,131,534,87,212,73,96,43,111,43,55,13,115,70,45,9,9,64,22,42
"2021","Exeter 014A","E01019968",682,246,150,96,404,113,187,67,83,37,56,29,22,5,46,23,23,2,2,32,11,21
"2021","Exeter 014B","E01019969",603,220,101,119,359,55,168,68,68,32,83,57,22,4,50,30,20,3,3,24,9,15
"2021","Exeter 014C","E01019970",507,150,76,74,328,57,155,60,64,31,72,50,21,1,42,19,23,2,2,29,6,23
"2021","Exeter 014D","E01019971",799,344,111,233,380,26,124,64,49,11,159,131,26,2,64,40,24,7,7,75,7,68
"2021","Exeter 014E","E01019972",612,165,40,125,388,32,187,75,77,35,95,54,35,6,69,44,25,5,5,59,10,49
"2021","Exeter 015A","E01020011",568,143,89,54,390,106,190,75,88,27,53,32,17,4,40,18,22,1,1,35,11,24
"2021","Exeter 015B","E01020012",628,169,71,98,410,41,215,76,96,43,85,44,34,7,67,40,27,2,2,49,14,35
"2021","Exeter 015E","E01033235",702,354,234,120,328,88,125,64,51,10,66,52,13,1,46,29,17,3,3,20,4,16
"2021","Exeter 015F","E01033236",546,226,135,91,301,105,112,50,47,15,53,39,10,4,31,13,18,0,0,19,4,15
"2021","Exeter 015G","E01034634",697,158,60,98,499,55,260,88,144,28,98,46,49,3,81,61,20,5,5,40,17,23
"2021","Exeter 015H","E01034635",638,241,178,63,378,103,180,66,91,23,52,35,14,3,39,23,16,4,4,19,6,13
"2021","Mid Devon 001A","E01020046",650,136,72,64,477,105,252,111,110,31,70,42,26,2,48,23,25,2,2,37,12,25
"2021","Mid Devon 001B","E01020049",571,129,79,50,406,99,227,104,76,47,52,32,17,3,26,14,12,2,2,36,18,18
"2021","Mid Devon 001C","E01020050",1005,323,184,139,634,195,301,157,92,52,83,45,35,3,53,30,23,2,2,48,15,33
"2021","Mid Devon 001D","E01020077",686,140,84,56,498,87,294,133,119,42,68,28,32,8,42,25,17,7,7,48,16,32
"2021","Mid Devon 002A","E01020047",954,272,181,91,645,166,311,155,97,59,103,73,27,3,64,25,39,1,1,37,15,22
"2021","Mid Devon 002B","E01020051",815,232,157,75,552,197,245,127,73,45,68,47,17,4,38,15,23,4,4,31,13,18
"2021","Mid Devon 002D","E01020080",769,157,96,61,570,107,294,102,150,42,117,62,50,5,51,36,15,1,1,42,20,22
"2021","Mid Devon 002E","E01034636",628,115,65,50,474,102,264,88,120,56,71,50,20,1,37,18,19,0,0,39,16,23
"2021","Mid Devon 002F","E01034637",648,172,49,123,435,46,173,58,90,25,128,74,49,5,85,65,20,3,3,41,10,31
"2021","Mid Devon 003A","E01020063",1057,336,204,132,670,129,328,129,146,53,117,50,58,9,95,61,34,1,1,51,24,27
"2021","Mid Devon 003B","E01020074",962,210,101,109,700,142,390,164,155,71,110,61,41,8,58,37,21,0,0,52,18,34
"2021","Mid Devon 003C","E01020075",828,222,125,97,570,122,299,97,148,54,81,42,33,6,66,38,28,2,2,36,19,17
"2021","Mid Devon 004A","E01020052",916,395,177,218,486,88,198,84,80,34,114,70,38,6,80,52,28,6,6,35,10,25
"2021","Mid Devon 004B","E01020053",608,156,85,71,418,91,159,60,73,26,82,34,39,9,84,51,33,2,2,34,12,22
"2021","Mid Devon 004C","E01020065",779,236,100,136,511,72,221,90,102,29,121,58,59,4,94,62,32,3,3,32,15,17
"2021","Mid Devon 004D","E01020067",769,247,107,140,487,30,208,63,104,41,113,47,62,4,130,81,49,6,6,35,17,18
"2021","Mid Devon 005A","E01020048",1100,461,153,308,575,71,219,95,96,28,144,90,46,8,137,87,50,4,4,64,23,41
"2021","Mid Devon 005B","E01020078",657,303,140,163,332,33,151,63,74,14,73,32,37,4,72,47,25,3,3,22,4,18
"2021","Mid Devon 005C","E01020079",599,211,105,106,367,56,169,61,81,27,58,25,30,3,78,49,29,6,6,21,8,13
"2021","Mid Devon 005D","E01020081",592,147,93,54,416,103,181,86,63,32,53,22,27,4,77,50,27,2,2,29,13,16
"2021","Mid Devon 006A","E01020045",720,171,106,65,499,118,261,89,123,49,51,25,21,5,66,30,36,3,3,50,20,30
"2021","Mid Devon 006B","E01020059",902,190,94,96,653,103,368,149,159,60,105,48,52,5,70,42,28,7,7,59,27,32
"2021","Mid Devon 006C","E01020062",715,189,117,72,501,108,279,109,105,65,70,46,21,3,43,33,10,1,1,25,9,16
"2021","Mid Devon 006D","E01020064",754,212,107,105,512,66,271,93,123,55,109,51,48,10,65,37,28,1,1,30,12,18
"2021","Mid Devon 007A","E01020054",1084,272,113,159,773,95,405,152,186,67,151,87,62,2,118,80,38,4,4,39,18,21
"2021","Mid Devon 007B","E01020055",825,318,140,178,451,76,204,82,85,37,96,57,32,7,69,42,27,6,6,56,22,34
"2021","Mid Devon 007C","E01020057",999,308,126,182,642,65,315,114,152,49,155,86,65,4,103,67,36,4,4,49,24,25
"2021","Mid Devon 007D","E01020058",891,266,128,138,581,124,283,117,120,46,90,47,35,8,80,50,30,4,4,44,14,30
"2021","Mid Devon 008A","E01020043",849,237,117,120,578,104,268,94,130,44,105,49,51,5,100,71,29,1,1,34,19,15
"2021","Mid Devon 008B","E01020044",705,185,103,82,477,115,267,116,108,43,52,22,26,4,42,23,19,1,1,43,11,32
"2021","Mid Devon 008C","E01020056",1169,247,104,143,852,131,486,184,230,72,160,95,57,8,72,47,25,3,3,70,30,40
"2021","Mid Devon 008D","E01020071",885,279,164,115,582,131,271,112,115,44,103,61,38,4,77,41,36,0,0,24,9,15
"2021","Mid Devon 009A","E01020072",688,155,92,63,496,111,279,118,110,51,59,32,19,8,47,14,33,0,0,37,9,28
"2021","Mid Devon 009B","E01020073",762,223,115,108,507,115,264,123,96,45,61,36,24,1,64,42,22,3,3,32,15,17
"2021","Mid Devon 009C","E01020076",744,177,97,80,517,98,277,127,105,45,94,59,31,4,45,23,22,3,3,50,22,28
"2021","Mid Devon 009D","E01020082",518,118,75,43,362,80,195,77,80,38,58,33,22,3,26,18,8,3,3,38,15,23
"2021","Mid Devon 010A","E01020068",682,184,101,83,467,101,249,105,111,33,68,37,27,4,48,26,22,1,1,31,12,19
"2021","Mid Devon 010B","E01020069",630,162,84,78,435,106,224,109,80,35,57,23,29,5,47,23,24,1,1,33,15,18
"2021","Mid Devon 010C","E01020070",776,195,110,85,526,133,286,127,106,53,62,35,23,4,45,25,20,0,0,55,31,24
"2021","Mid Devon 010D","E01020083",1030,262,139,123,710,120,376,126,190,60,139,75,60,4,69,36,33,6,6,58,25,33
"2021","Mid Devon 011A","E01020041",1087,317,123,194,725,68,296,107,141,48,192,105,78,9,165,121,44,4,4,45,15,30
"2021","Mid Devon 011B","E01020042",776,238,140,98,513,122,232,92,113,27,91,57,31,3,65,42,23,3,3,25,9,16
"2021","Mid Devon 011C","E01020060",928,453,220,233,437,106,152,60,67,25,81,49,28,4,95,67,28,3,3,38,10,28
"2021","Mid Devon 011D","E01020061",915,274,143,131,600,123,290,104,133,53,99,49,40,10,86,53,33,2,2,41,16,25
"2021","North Devon 001A","E01020111",628,267,118,149,333,34,132,53,61,18,78,31,41,6,80,50,30,9,9,28,9,19
"2021","North Devon 001B","E01020112",733,375,130,245,319,36,111,51,39,21,88,55,30,3,78,56,22,6,6,39,18,21
"2021","North Devon 001C","E01020114",569,228,98,130,316,56,142,68,57,17,69,40,22,7,44,30,14,5,5,25,7,18
"2021","North Devon 001D","E01020115",512,149,82,67,332,81,151,68,52,31,58,28,27,3,40,18,22,2,2,31,12,19
"2021","North Devon 002A","E01020099",613,158,89,69,414,134,197,103,65,29,45,32,10,3,36,22,14,2,2,41,19,22
"2021","North Devon 002B","E01020100",492,139,74,65,312,81,155,76,50,29,44,16,24,4,32,17,15,0,0,41,20,21
"2021","North Devon 002C","E01020101",635,206,118,88,393,101,172,82,63,27,64,29,30,5,53,39,14,3,3,36,14,22
"2021","North Devon 002D","E01020126",750,264,144,120,457,100,241,145,57,39,74,54,19,1,41,16,25,1,1,29,11,18
"2021","North Devon 003A","E01020113",670,283,111,172,345,63,127,63,44,20,72,44,25,3,78,52,26,5,5,42,14,28
"2021","North Devon 003B","E01020116",693,225,109,116,429,75,197,76,83,38,77,34,37,6,76,45,31,4,4,39,21,18
"2021","North Devon 003C","E01020117",697,205,125,80,465,116,218,97,77,44,75,39,30,6,55,27,28,1,1,27,6,21
"2021","North Devon 003D","E01020118",544,154,77,77,363,43,146,49,65,32,77,31,36,10,96,62,34,1,1,27,13,14
"2021","North Devon 004A","E01020090",739,146,92,54,553,157,302,102,148,52,55,27,26,2,36,17,19,3,3,40,9,31
"2021","North Devon 004B","E01020108",887,266,126,140,567,151,277,105,123,49,84,49,30,5,52,27,25,3,3,54,15,39
"2021","North Devon 004C","E01020109",563,163,87,76,368,74,213,80,94,39,50,26,17,7,31,16,15,0,0,32,13,19
"2021","North Devon 005A","E01020089",959,290,146,144,630,131,303,105,150,48,97,43,49,5,94,48,46,5,5,39,16,23
"2021","North Devon 005B","E01020091",562,171,112,59,368,100,173,60,81,32,55,31,24,0,39,24,15,1,1,23,7,16
"2021","North Devon 005C","E01020092",639,186,137,49,426,144,211,90,86,35,36,19,15,2,35,19,16,0,0,27,8,19
"2021","North Devon 005D","E01020093",705,293,156,137,389,78,163,58,81,24,72,43,25,4,71,44,27,5,5,23,10,13
"2021","North Devon 005E","E01020110",999,210,97,113,755,98,416,138,235,43,143,70,71,2,95,68,27,3,3,34,15,19
"2021","North Devon 006A","E01020088",855,207,111,96,602,139,305,129,117,59,94,54,31,9,63,36,27,1,1,46,21,25
"2021","North Devon 006B","E01020120",898,191,115,76,669,133,358,149,152,57,103,58,39,6,73,49,24,2,2,38,20,18
"2021","North Devon 006C","E01020127",863,179,97,82,612,139,331,124,147,60,88,51,34,3,51,21,30,3,3,72,37,35
"2021","North Devon 007A","E01020132",805,303,184,119,472,104,226,79,103,44,82,53,23,6,56,22,34,4,4,30,11,19
"2021","North Devon 007B","E01020133",667,202,106,96,431,88,207,74,96,37,66,43,19,4,63,39,24,7,7,34,12,22
"2021","North Devon 007C","E01020134",472,144,65,79,308,41,125,50,52,23,66,35,27,4,74,45,29,2,2,20,4,16
"2021","North Devon 007D","E01020139",630,222,108,114,381,48,164,65,76,23,88,39,42,7,75,52,23,6,6,27,8,19
"2021","North Devon 008A","E01020094",1065,694,268,426,319,48,108,60,37,11,91,67,20,4,64,40,24,8,8,52,12,40
"2021","North Devon 008B","E01020095",662,260,93,167,356,33,147,45,75,27,84,44,33,7,89,52,37,3,3,46,10,36
"2021","North Devon 008C","E01020140",575,166,99,67,381,93,154,63,54,37,59,35,21,3,72,40,32,3,3,28,10,18
"2021","North Devon 008D","E01020141",734,194,78,116,497,46,203,65,89,49,119,57,54,8,127,88,39,2,2,43,22,21
"2021","North Devon 009A","E01020096",826,364,146,218,414,64,178,83,68,27,81,53,28,0,81,48,33,10,10,48,12,36
"2021","North Devon 009B","E01020123",625,185,123,62,410,90,178,76,56,46,62,20,37,5,79,41,38,1,1,30,14,16
"2021","North Devon 009C","E01020124",624,187,100,87,400,125,192,80,65,47,54,28,22,4,28,14,14,1,1,37,9,28
"2021","North Devon 009D","E01020125",615,163,109,54,423,149,171,91,54,26,58,30,26,2,45,17,28,0,0,29,13,16
"2021","North Devon 010A","E01020102",654,163,73,90,475,53,256,113,92,51,106,55,47,4,57,39,18,3,3,16,4,12
"2021","North Devon 010B","E01020103",604,153,71,82,405,36,179,55,92,32,91,29,52,10,95,65,30,4,4,46,21,25
"2021","North Devon 010C","E01020104",577,203,39,164,362,16,123,48,59,16,113,56,55,2,106,80,26,4,4,12,4,8
"2021","North Devon 010D","E01020128",593,137,79,58,431,112,230,80,110,40,45,22,19,4,40,27,13,4,4,25,10,15
"2021","North Devon 010E","E01020129",541,191,92,99,330,52,143,52,64,27,60,29,29,2,69,43,26,6,6,20,9,11
"2021","North Devon 010F","E01020130",682,279,97,182,362,32,151,47,80,24,100,51,42,7,70,42,28,9,9,41,19,22
"2021","North Devon 011A","E01020105",927,187,108,79,694,133,338,148,141,49,115,54,56,5,103,71,32,5,5,46,20,26
"2021","North Devon 011B","E01020106",618,167,117,50,423,151,193,98,59,36,43,26,16,1,36,22,14,0,0,28,10,18
"2021","North Devon 011C","E01020107",742,224,165,59,489,167,218,106,68,44,59,34,24,1,44,20,24,1,1,29,9,20
"2021","North Devon 011D","E01020119",679,190,114,76,452,127,220,116,56,48,60,43,16,1,43,18,25,2,2,37,11,26
"2021","North Devon 012A","E01020084",669,225,141,84,428,94,195,89,71,35,75,46,25,4,62,34,28,2,2,16,8,8
"2021","North Devon 012B","E01020085",653,176,86,90,447,60,206,73,99,34,99,57,38,4,77,44,33,5,5,30,12,18
"2021","North Devon 012D","E01020121",837,221,116,105,573,108,312,123,120,69,80,38,39,3,71,46,25,2,2,43,17,26
"2021","North Devon 012E","E01020122",949,210,111,99,681,126,333,150,137,46,130,56,63,11,89,57,32,3,3,58,20,38
"2021","North Devon 012F","E01034638",662,149,69,80,487,77,217,82,97,38,131,69,54,8,60,48,12,2,2,26,10,16
"2021","North Devon 012G","E01034639",591,151,78,73,411,76,176,64,91,21,94,43,48,3,64,44,20,1,1,29,8,21
"2021","North Devon 013A","E01020097",980,230,126,104,674,164,355,159,129,67,95,54,33,8,57,31,26,3,3,76,27,49
"2021","North Devon 013B","E01020131",934,215,108,107,662,138,348,166,126,56,116,61,46,9,57,40,17,3,3,57,25,32
"2021","North Devon 013C","E01020135",765,261,162,99,475,91,217,86,88,43,77,38,35,4,86,47,39,4,4,29,8,21
"2021","North Devon 013D","E01020136",1074,282,158,124,750,172,317,142,130,45,128,56,70,2,127,82,45,6,6,42,17,25
"2021","North Devon 013E","E01020137",861,329,143,186,493,80,221,92,92,37,111,58,48,5,79,56,23,2,2,39,14,25
"2021","North Devon 014A","E01020087",946,254,175,79,636,175,315,162,100,53,109,63,37,9,36,17,19,1,1,56,26,30
"2021","North Devon 014B","E01020098",1085,354,196,158,677,166,317,150,102,65,112,71,37,4,79,51,28,3,3,54,20,34
"2021","North Devon 014C","E01020138",1069,273,176,97,728,165,389,169,142,78,120,70,43,7,52,30,22,2,2,68,26,42
"2021","South Hams 001A","E01020144",616,130,44,86,478,56,278,126,104,48,90,60,30,0,54,32,22,0,0,8,3,5
"2021","South Hams 001B","E01020145",830,197,98,99,583,122,305,128,126,51,96,55,36,5,59,36,23,1,1,50,22,28
"2021","South Hams 001C","E01020146",550,200,55,145,321,37,177,77,69,31,67,47,17,3,39,30,9,1,1,29,12,17
"2021","South Hams 001D","E01020149",614,165,74,91,414,73,205,86,82,37,71,40,27,4,62,38,24,3,3,35,10,25
"2021","South Hams 002A","E01020148",499,129,66,63,343,73,185,90,54,41,46,26,17,3,38,17,21,1,1,27,7,20
"2021","South Hams 002B","E01020157",997,232,132,100,685,164,370,156,144,70,93,51,38,4,54,28,26,4,4,80,36,44
"2021","South Hams 002C","E01020160",1011,213,97,116,739,103,407,185,176,46,143,87,45,11,81,57,24,5,5,59,22,37
"2021","South Hams 002D","E01020176",524,162,96,66,340,81,167,83,57,27,46,32,13,1,43,22,21,3,3,22,7,15
"2021","South Hams 002E","E01020177",659,211,145,66,417,92,194,73,74,47,62,31,26,5,67,45,22,2,2,31,12,19
"2021","South Hams 003A","E01020180",1041,354,210,144,626,92,268,92,119,57,116,61,49,6,144,92,52,6,6,61,11,50
"2021","South Hams 003B","E01020181",867,280,172,108,538,126,230,91,97,42,82,34,40,8,96,62,34,4,4,49,12,37
"2021","South Hams 003C","E01020182",678,178,81,97,462,54,229,97,96,36,76,37,32,7,99,70,29,4,4,38,14,24
"2021","South Hams 003D","E01020183",823,421,224,197,349,65,132,68,50,14,79,58,18,3,65,46,19,8,8,53,11,42
"2021","South Hams 003E","E01020184",918,438,214,224,433,91,190,79,76,35,85,45,36,4,66,47,19,1,1,47,17,30
"2021","South Hams 004A","E01020153",535,165,108,57,344,106,177,102,38,37,36,27,6,3,23,11,12,2,2,26,5,21
"2021","South Hams 004B","E01020156",951,252,155,97,651,156,344,141,142,61,90,55,26,9,61,36,25,0,0,48,18,30
"2021","South Hams 004C","E01020170",995,239,158,81,705,185,362,152,152,58,91,55,28,8,63,30,33,4,4,51,20,31
"2021","South Hams 004D","E01020188",929,231,140,91,642,170,327,168,108,51,93,53,36,4,47,26,21,5,5,56,20,36
"2021","South Hams 005A","E01020161",1100,410,247,163,636,142,307,100,143,64,101,48,41,12,86,52,34,0,0,54,21,33
"2021","South Hams 005B","E01020162",645,120,50,70,501,68,255,96,121,38,96,50,43,3,78,48,30,4,4,24,10,14
"2021","South Hams 005C","E01020163",707,136,80,56,538,101,313,111,147,55,64,29,27,8,60,32,28,0,0,33,12,21
"2021","South Hams 005D","E01020164",655,199,103,96,431,75,209,80,83,46,66,34,28,4,79,45,34,2,2,25,9,16
"2021","South Hams 005E","E01020165",622,165,69,96,440,72,224,86,100,38,72,35,33,4,68,47,21,4,4,17,8,9
"2021","South Hams 005F","E01020166",590,114,74,40,460,95,242,86,111,45,78,52,24,2,44,24,20,1,1,16,6,10
"2021","South Hams 005G","E01020167",667,126,55,71,517,61,293,90,151,52,106,53,50,3,54,36,18,3,3,24,11,13
"2021","South Hams 006A","E01020142",1140,301,162,139,792,138,421,162,200,59,135,70,63,2,94,57,37,4,4,47,20,27
"2021","South Hams 006B","E01020143",1051,274,131,143,701,133,389,177,143,69,105,60,39,6,73,36,37,1,1,76,25,51
"2021","South Hams 006C","E01020150",917,283,160,123,566,112,265,100,113,52,87,30,54,3,99,58,41,3,3,68,20,48
"2021","South Hams 007A","E01020151",755,228,149,79,503,193,197,130,43,24,65,45,16,4,44,26,18,4,4,24,5,19
"2021","South Hams 007B","E01020152",778,396,216,180,356,101,158,101,22,35,60,51,7,2,34,13,21,3,3,26,4,22
"2021","South Hams 007C","E01020154",497,128,62,66,349,33,186,66,81,39,63,23,34,6,66,38,28,1,1,20,7,13
"2021","South Hams 007D","E01020155",485,188,87,101,273,40,107,47,43,17,60,19,37,4,63,40,23,3,3,24,13,11
"2021","South Hams 008A","E01020147",910,238,140,98,610,178,302,147,113,42,72,39,27,6,53,31,22,5,5,62,25,37
"2021","South Hams 008B","E01020158",902,268,153,115,604,123,311,139,124,48,95,55,35,5,74,41,33,1,1,30,14,16
"2021","South Hams 008C","E01020159",657,161,91,70,463,87,278,117,124,37,62,38,24,0,35,20,15,1,1,33,14,19
"2021","South Hams 008D","E01020190",1018,267,172,95,709,200,335,117,162,56,95,48,44,3,78,55,23,1,1,42,18,24
"2021","South Hams 009A","E01020171",833,239,150,89,566,209,259,131,88,40,55,25,24,6,40,23,17,3,3,28,9,19
"2021","South Hams 009B","E01020185",664,169,108,61,466,139,227,97,89,41,54,31,21,2,45,25,20,1,1,29,7,22
"2021","South Hams 009C","E01020186",652,161,125,36,466,178,231,128,62,41,32,20,10,2,25,8,17,0,0,25,10,15
"2021","South Hams 009D","E01020187",1056,279,134,145,718,103,357,118,184,55,157,84,62,11,95,65,30,6,6,59,28,31
"2021","South Hams 010A","E01020168",910,281,194,87,598,168,276,116,112,48,75,34,37,4,77,52,25,2,2,31,7,24
"2021","South Hams 010B","E01020169",1030,356,168,188,620,115,284,116,124,44,123,78,42,3,95,53,42,3,3,54,14,40
"2021","South Hams 010C","E01020189",986,409,244,165,540,95,238,106,98,34,114,60,47,7,90,44,46,3,3,37,15,22
"2021","South Hams 011A","E01020174",724,207,127,80,476,149,234,123,74,37,59,31,23,5,34,17,17,0,0,41,13,28
"2021","South Hams 011B","E01020175",988,296,201,95,656,218,301,164,97,40,87,54,27,6,48,29,19,2,2,36,14,22
"2021","South Hams 011C","E01020178",941,261,192,69,634,209,280,125,108,47,83,43,35,5,59,26,33,3,3,46,14,32
"2021","South Hams 012A","E01020172",922,287,162,125,590,146,255,112,96,47,114,58,48,8,73,37,36,2,2,45,18,27
"2021","South Hams 012B","E01020173",631,256,145,111,355,119,154,89,37,28,46,28,17,1,32,16,16,4,4,20,2,18
"2021","South Hams 012C","E01020179",857,222,142,80,592,202,282,130,101,51,58,38,16,4,49,20,29,1,1,43,16,27
"2021","Teignbridge 001A","E01020243",533,134,77,57,372,78,191,79,81,31,63,36,20,7,40,19,21,0,0,27,11,16
"2021","Teignbridge 001B","E01020262",546,129,73,56,370,97,202,96,67,39,51,35,15,1,20,8,12,0,0,47,15,32
"2021","Teignbridge 001C","E01020263",755,280,204,76,441,156,196,90,69,37,62,40,20,2,26,11,15,1,1,34,15,19
"2021","Teignbridge 001D","E01020274",549,116,54,62,398,96,227,102,92,33,57,33,19,5,18,9,9,0,0,35,9,26
"2021","Teignbridge 002A","E01020240",809,245,141,104,532,104,263,95,137,31,99,43,53,3,66,33,33,0,0,32,14,18
"2021","Teignbridge 002B","E01020241",834,245,85,160,540,107,267,109,119,39,111,84,24,3,51,29,22,4,4,49,17,32
"2021","Teignbridge 002C","E01020242",803,197,104,93,580,92,308,95,176,37,101,60,36,5,77,58,19,2,2,26,11,15
"2021","Teignbridge 002D","E01020244",631,218,125,93,396,74,185,83,72,30,83,46,33,4,54,31,23,0,0,17,4,13
"2021","Teignbridge 002E","E01020245",729,214,115,99,478,101,236,111,91,34,91,56,30,5,48,23,25,2,2,37,13,24
"2021","Teignbridge 003A","E01020205",629,158,97,61,439,136,228,132,58,38,49,30,16,3,23,6,17,3,3,32,13,19
"2021","Teignbridge 003B","E01020258",790,273,147,126,477,101,219,100,90,29,91,52,32,7,63,33,30,3,3,40,18,22
"2021","Teignbridge 003C","E01020259",504,135,79,56,341,92,181,102,52,27,51,39,9,3,16,5,11,1,1,28,7,21
"2021","Teignbridge 003D","E01020273",648,159,110,49,460,107,239,108,94,37,58,27,28,3,54,30,24,2,2,29,14,15
"2021","Teignbridge 004A","E01020203",860,307,219,88,526,196,240,119,90,31,43,26,14,3,45,23,22,2,2,27,8,19
"2021","Teignbridge 004B","E01020206",710,234,124,110,454,91,221,86,98,37,77,43,32,2,62,37,25,3,3,22,4,18
"2021","Teignbridge 004C","E01020220",742,208,112,96,505,70,258,90,128,40,95,46,49,0,81,57,24,1,1,29,11,18
"2021","Teignbridge 004D","E01020221",761,203,102,101,513,87,266,117,105,44,90,51,30,9,65,34,31,5,5,45,19,26
"2021","Teignbridge 004E","E01020222",543,183,102,81,343,67,178,70,83,25,61,36,24,1,35,27,8,2,2,17,8,9
"2021","Teignbridge 004F","E01020223",792,216,118,98,547,114,262,101,115,46,100,66,28,6,68,35,33,3,3,29,15,14
"2021","Teignbridge 005B","E01020230",830,265,138,127,523,120,241,111,84,46,78,45,24,9,82,56,26,2,2,42,10,32
"2021","Teignbridge 005C","E01020231",678,199,130,69,441,114,210,107,56,47,65,25,36,4,49,30,19,3,3,38,15,23
"2021","Teignbridge 005D","E01020232",763,198,108,90,514,96,237,81,102,54,87,39,41,7,92,60,32,2,2,51,17,34
"2021","Teignbridge 005E","E01034165",733,227,118,109,473,133,235,141,55,39,54,38,12,4,47,32,15,4,4,33,16,17
"2021","Teignbridge 005F","E01034166",754,189,78,111,518,99,233,86,115,32,98,44,50,4,87,63,24,1,1,47,24,23
"2021","Teignbridge 006A","E01020228",960,534,270,264,398,103,145,82,35,28,77,50,25,2,71,36,35,2,2,28,6,22
"2021","Teignbridge 006B","E01020233",913,266,183,83,607,229,267,161,63,43,62,42,16,4,49,22,27,0,0,40,16,24
"2021","Teignbridge 006C","E01020234",605,174,96,78,405,69,174,78,51,45,75,29,39,7,81,50,31,6,6,26,17,9
"2021","Teignbridge 006D","E01020235",847,353,207,146,443,136,177,88,53,36,74,45,25,4,56,28,28,0,0,51,19,32
"2021","Teignbridge 007A","E01020202",1088,337,237,100,715,217,307,129,141,37,114,56,55,3,76,52,24,1,1,36,11,25
"2021","Teignbridge 007B","E01020204",652,184,59,125,450,32,204,91,76,37,122,70,45,7,92,65,27,0,0,18,6,12
"2021","Teignbridge 007C","E01020236",545,154,107,47,377,106,186,87,61,38,48,26,19,3,35,16,19,2,2,14,5,9
"2021","Teignbridge 007D","E01020237",673,149,76,73,472,98,236,99,100,37,87,51,30,6,49,28,21,2,2,52,23,29
"2021","Teignbridge 008A","E01020265",789,193,130,63,568,146,259,107,104,48,93,44,42,7,68,37,31,2,2,28,11,17
"2021","Teignbridge 008B","E01020266",714,183,83,100,487,121,232,105,86,41,72,41,28,3,62,29,33,0,0,44,14,30
"2021","Teignbridge 008C","E01020267",671,244,138,106,396,120,185,75,74,36,47,37,9,1,44,25,19,0,0,31,6,25
"2021","Teignbridge 008D","E01020268",810,239,158,81,536,172,258,134,85,39,61,31,26,4,45,25,20,0,0,35,14,21
"2021","Teignbridge 008E","E01020270",724,199,107,92,489,99,243,108,94,41,83,45,34,4,62,43,19,2,2,36,19,17
"2021","Teignbridge 009A","E01020250",703,218,129,89,454,116,218,93,77,48,75,39,32,4,45,25,20,0,0,31,9,22
"2021","Teignbridge 009B","E01020252",958,308,115,193,608,63,275,108,133,34,153,76,70,7,114,79,35,3,3,42,15,27
"2021","Teignbridge 009C","E01020253",599,165,77,88,418,53,227,65,113,49,78,44,30,4,60,41,19,0,0,16,5,11
"2021","Teignbridge 009D","E01020254",589,169,91,78,379,47,161,57,77,27,82,31,41,10,85,48,37,4,4,41,19,22
"2021","Teignbridge 009E","E01020255",631,177,112,65,424,99,181,64,77,40,85,38,33,14,57,37,20,2,2,30,8,22
"2021","Teignbridge 009F","E01020257",504,112,66,46,352,92,181,59,80,42,48,22,18,8,30,16,14,1,1,40,10,30
"2021","Teignbridge 010A","E01020264",701,315,138,177,342,75,137,60,46,31,60,30,28,2,70,44,26,0,0,44,11,33
"2021","Teignbridge 010B","E01020269",1123,678,347,331,405,103,132,93,24,15,103,82,18,3,67,34,33,0,0,40,8,32
"2021","Teignbridge 010C","E01020271",683,237,112,125,414,44,181,75,57,49,82,46,31,5,105,65,40,2,2,32,10,22
"2021","Teignbridge 010D","E01020272",746,210,102,108,496,46,206,73,93,40,100,33,60,7,139,96,43,5,5,40,13,27
"2021","Teignbridge 011A","E01020200",534,176,118,58,329,104,147,78,50,19,43,31,12,0,34,16,18,1,1,29,7,22
"2021","Teignbridge 011B","E01020201",716,200,149,51,495,205,206,109,68,29,50,28,16,6,34,16,18,0,0,21,6,15
"2021","Teignbridge 011C","E01020251",615,156,76,80,425,76,247,94,100,53,67,35,24,8,34,19,15,1,1,34,12,22
"2021","Teignbridge 011D","E01020260",593,196,134,62,379,120,180,93,61,26,41,24,13,4,37,18,19,1,1,18,4,14
"2021","Teignbridge 011E","E01020261",534,129,88,41,369,117,160,77,60,23,51,34,12,5,39,23,16,2,2,36,10,26
"2021","Teignbridge 012A","E01020208",533,169,94,75,329,40,167,58,75,34,56,25,26,5,66,43,23,0,0,35,11,24
"2021","Teignbridge 012B","E01020209",637,187,99,88,426,71,169,66,68,35,106,47,51,8,75,52,23,5,5,24,7,17
"2021","Teignbridge 012C","E01020210",594,148,85,63,419,96,221,99,72,50,61,27,30,4,40,18,22,1,1,27,12,15
"2021","Teignbridge 012D","E01020219",889,261,81,180,592,83,313,104,145,64,100,54,38,8,94,51,43,2,2,36,11,25
"2021","Teignbridge 013A","E01020191",601,163,64,99,406,76,178,70,83,25,103,71,27,5,49,39,10,0,0,32,11,21
"2021","Teignbridge 013B","E01020194",617,131,66,65,459,77,267,107,114,46,65,41,20,4,49,31,18,1,1,27,9,18
"2021","Teignbridge 013D","E01020256",840,219,94,125,576,99,271,106,127,38,132,74,50,8,71,44,27,3,3,45,20,25
"2021","Teignbridge 013E","E01034167",716,122,52,70,561,86,280,111,136,33,106,52,49,5,89,69,20,0,0,33,12,21
"2021","Teignbridge 013F","E01034168",682,127,12,115,526,8,241,78,144,19,188,98,83,7,87,73,14,2,2,29,14,15
"2021","Teignbridge 014A","E01020211",697,234,104,130,432,57,167,56,80,31,102,38,58,6,105,64,41,1,1,31,14,17
"2021","Teignbridge 014B","E01020217",919,444,221,223,433,72,149,60,64,25,129,93,28,8,75,45,30,8,8,42,12,30
"2021","Teignbridge 014C","E01020218",808,368,129,239,393,27,163,64,73,26,109,67,37,5,89,62,27,5,5,47,16,31
"2021","Teignbridge 014D","E01020224",542,180,53,127,331,25,129,51,60,18,73,47,21,5,99,63,36,5,5,31,4,27
"2021","Teignbridge 015A","E01020216",692,224,85,139,419,40,176,72,71,33,92,34,50,8,106,68,38,5,5,49,25,24
"2021","Teignbridge 015B","E01020225",601,232,86,146,339,29,146,59,60,27,85,51,28,6,75,50,25,4,4,30,2,28
"2021","Teignbridge 015C","E01020226",626,192,107,85,407,105,214,74,99,41,54,28,21,5,33,23,10,1,1,27,11,16
"2021","Teignbridge 015D","E01020227",622,210,130,80,372,84,171,67,71,33,59,37,19,3,56,30,26,2,2,40,13,27
"2021","Teignbridge 016A","E01020212",499,123,54,69,344,39,155,59,58,38,67,20,41,6,79,51,28,4,4,32,14,18
"2021","Teignbridge 016B","E01020213",657,180,111,69,444,101,166,80,50,36,102,63,33,6,69,33,36,6,6,33,14,19
"2021","Teignbridge 016C","E01020214",681,167,95,72,470,117,218,96,66,56,67,44,16,7,65,33,32,3,3,44,17,27
"2021","Teignbridge 016D","E01020215",575,125,87,38,424,123,239,119,76,44,45,30,13,2,17,8,9,0,0,26,9,17
"2021","Teignbridge 017A","E01020195",747,211,128,83,493,97,259,109,107,43,66,33,29,4,70,50,20,1,1,43,22,21
"2021","Teignbridge 017B","E01020196",833,346,171,175,433,67,159,61,73,25,101,57,36,8,101,75,26,5,5,54,15,39
"2021","Teignbridge 017C","E01020197",581,173,115,58,376,110,176,81,71,24,49,29,16,4,38,16,22,3,3,32,12,20
"2021","Teignbridge 017D","E01020198",641,235,117,118,379,48,153,53,61,39,91,33,48,10,85,54,31,2,2,27,5,22
"2021","Teignbridge 017E","E01020199",716,243,113,130,433,63,205,76,100,29,93,44,42,7,69,45,24,3,3,40,14,26
"2021","Teignbridge 018A","E01020246",577,145,71,74,396,75,199,76,84,39,74,44,27,3,47,30,17,1,1,36,10,26
"2021","Teignbridge 018B","E01020247",699,218,134,84,433,98,185,75,72,38,61,30,29,2,88,60,28,1,1,48,17,31
"2021","Teignbridge 018C","E01020248",781,197,121,76,545,141,275,121,111,43,72,45,20,7,52,31,21,5,5,39,12,27
"2021","Teignbridge 018D","E01020249",635,200,141,59,405,105,218,101,69,48,45,25,13,7,34,20,14,3,3,30,11,19
"2021","Teignbridge 019A","E01020192",651,181,122,59,437,142,213,109,81,23,48,30,14,4,34,14,20,0,0,33,14,19
"2021","Teignbridge 019B","E01020193",650,145,81,64,465,99,255,102,112,41,65,31,29,5,44,25,19,2,2,40,12,28
"2021","Teignbridge 019C","E01020238",545,171,104,67,354,93,165,66,66,33,49,20,28,1,44,27,17,3,3,20,5,15
"2021","Teignbridge 019D","E01020239",555,143,93,50,383,117,194,83,74,37,45,27,14,4,27,12,15,0,0,29,9,20
"2021","Torridge 001A","E01020275",628,246,125,121,361,81,164,90,48,26,58,39,18,1,55,26,29,3,3,21,8,13
"2021","Torridge 001B","E01020276",683,226,150,76,435,117,204,79,79,46,65,34,26,5,48,28,20,1,1,22,3,19
"2021","Torridge 001C","E01020297",773,334,181,153,417,77,174,78,65,31,80,46,29,5,80,45,35,6,6,22,8,14
"2021","Torridge 001D","E01020299",918,342,219,123,551,171,248,134,70,44,89,57,30,2,43,24,19,0,0,25,8,17
"2021","Torridge 002A","E01020298",997,289,190,99,674,242,289,143,110,36,84,48,33,3,56,30,26,3,3,34,6,28
"2021","Torridge 002B","E01020300",780,197,129,68,544,178,249,119,86,44,67,32,33,2,48,20,28,2,2,39,18,21
"2021","Torridge 002D","E01034640",608,293,149,144,290,99,107,58,31,18,49,33,13,3,32,16,16,3,3,25,5,20
"2021","Torridge 002E","E01034641",649,232,118,114,394,129,174,99,55,20,42,27,13,2,48,29,19,1,1,23,11,12
"2021","Torridge 003A","E01020280",1141,565,154,411,520,52,189,82,68,39,140,83,54,3,132,99,33,7,7,56,13,43
"2021","Torridge 003B","E01020281",868,227,122,105,590,132,309,143,106,60,83,38,37,8,64,38,26,2,2,51,13,38
"2021","Torridge 003C","E01020282",771,328,200,128,418,88,175,69,76,30,85,44,38,3,67,40,27,3,3,25,8,17
"2021","Torridge 004A","E01020277",945,351,166,185,541,81,218,94,73,51,118,50,58,10,121,83,38,3,3,53,22,31
"2021","Torridge 004B","E01020278",654,142,85,57,472,90,272,111,110,51,62,34,22,6,47,24,23,1,1,40,13,27
"2021","Torridge 004C","E01020279",1197,349,142,207,794,107,334,132,163,39,190,95,88,7,161,112,49,2,2,54,24,30
"2021","Torridge 004D","E01020283",1095,318,183,135,743,144,331,141,140,50,178,90,75,13,90,61,29,0,0,34,16,18
"2021","Torridge 004E","E01020284",896,282,97,185,564,64,237,97,102,38,124,56,59,9,136,98,38,3,3,50,14,36
"2021","Torridge 004F","E01020285",829,236,102,134,550,54,229,83,93,53,107,53,48,6,154,117,37,6,6,43,20,23
"2021","Torridge 005A","E01020288",706,190,103,87,464,105,227,107,70,50,88,52,30,6,40,28,12,4,4,52,25,27
"2021","Torridge 005B","E01020292",704,199,118,81,460,115,219,112,71,36,69,35,28,6,54,22,32,3,3,45,13,32
"2021","Torridge 005C","E01020295",704,144,95,49,514,138,263,124,87,52,88,58,27,3,24,12,12,1,1,46,20,26
"2021","Torridge 005D","E01020296",659,163,105,58,459,130,240,130,67,43,62,34,25,3,27,9,18,0,0,37,14,23
"2021","Torridge 006A","E01020304",739,237,134,103,466,91,200,88,83,29,107,50,48,9,64,49,15,4,4,36,15,21
"2021","Torridge 006B","E01020305",521,202,105,97,296,53,117,50,42,25,66,39,24,3,58,40,18,2,2,23,8,15
"2021","Torridge 006C","E01020306",560,155,92,63,381,86,187,68,78,41,59,30,25,4,48,31,17,1,1,24,9,15
"2021","Torridge 006D","E01020307",697,200,115,85,461,72,198,73,89,36,95,42,46,7,95,59,36,1,1,36,19,17
"2021","Torridge 007A","E01020287",678,184,100,84,449,120,227,119,58,50,58,42,14,2,38,16,22,6,6,45,14,31
"2021","Torridge 007B","E01020303",781,204,129,75,534,140,271,159,76,36,78,47,29,2,44,20,24,1,1,43,17,26
"2021","Torridge 007C","E01020308",801,191,108,83,557,140,300,138,115,47,77,45,25,7,36,16,20,4,4,53,22,31
"2021","Torridge 007D","E01020311",993,291,165,126,646,170,311,167,104,40,90,49,35,6,72,45,27,3,3,56,24,32
"2021","Torridge 008A","E01020291",705,190,112,78,471,112,245,104,103,38,76,42,31,3,36,24,12,2,2,44,18,26
"2021","Torridge 008B","E01020293",1121,356,166,190,686,130,342,163,119,60,120,70,42,8,86,57,29,8,8,79,32,47
"2021","Torridge 008C","E01020294",1011,338,178,160,645,132,260,88,121,51,137,57,76,4,112,71,41,4,4,28,12,16
"2021","Torridge 008D","E01020302",764,198,118,80,522,139,265,123,89,53,75,43,28,4,41,22,19,2,2,44,14,30
"2021","Torridge 008E","E01020309",776,155,92,63,569,131,319,166,92,61,71,42,26,3,44,29,15,4,4,52,26,26
"2021","Torridge 009A","E01020286",785,205,100,105,536,119,289,142,104,43,84,46,33,5,42,21,21,2,2,44,21,23
"2021","Torridge 009B","E01020289",701,175,95,80,469,125,234,127,61,46,73,38,30,5,32,12,20,5,5,57,19,38
"2021","Torridge 009C","E01020290",773,222,136,86,507,130,255,129,80,46,68,41,27,0,52,21,31,2,2,44,13,31
"2021","Torridge 009D","E01020301",844,173,94,79,622,156,333,170,104,59,84,50,29,5,47,26,21,2,2,49,21,28
"2021","West Devon 001A","E01020320",753,148,89,59,544,150,293,137,101,55,70,51,15,4,27,12,15,4,4,61,18,43
"2021","West Devon 001B","E01020321",1016,292,141,151,654,121,333,164,120,49,108,72,31,5,89,60,29,3,3,70,26,44
"2021","West Devon 001D","E01020326",993,273,139,134,664,108,352,161,134,57,114,68,42,4,88,54,34,2,2,56,28,28
"2021","West Devon 001E","E01034642",604,134,83,51,403,97,229,111,76,42,46,28,17,1,31,15,16,0,0,67,32,35
"2021","West Devon 001F","E01034643",684,135,52,83,518,56,258,89,145,24,114,57,56,1,86,71,15,4,4,31,13,18
"2021","West Devon 002A","E01020327",845,268,151,117,550,130,235,86,107,42,93,54,33,6,89,48,41,3,3,27,10,17
"2021","West Devon 002B","E01020328",979,271,99,172,671,73,305,104,156,45,145,62,76,7,142,86,56,6,6,37,17,20
"2021","West Devon 002C","E01020329",760,292,181,111,439,112,219,101,77,41,64,32,25,7,42,24,18,2,2,29,8,21
"2021","West Devon 002D","E01020330",926,403,212,191,478,112,193,68,97,28,86,53,28,5,81,41,40,6,6,45,14,31
"2021","West Devon 003A","E01020318",761,278,160,118,449,128,187,88,68,31,70,42,23,5,64,41,23,0,0,34,9,25
"2021","West Devon 003B","E01020319",747,180,94,86,515,121,260,129,83,48,92,50,39,3,39,19,20,3,3,52,20,32
"2021","West Devon 003C","E01020323",680,174,93,81,477,78,247,124,78,45,87,59,26,2,63,31,32,2,2,29,13,16
"2021","West Devon 003D","E01020339",724,187,111,76,493,118,242,102,96,44,91,49,30,12,41,25,16,1,1,44,17,27
"2021","West Devon 004A","E01020314",721,169,100,69,496,115,282,141,88,53,74,47,23,4,24,11,13,1,1,56,28,28
"2021","West Devon 004B","E01020325",710,155,74,81,515,109,282,116,101,65,73,50,22,1,47,25,22,4,4,40,21,19
"2021","West Devon 004C","E01020331",709,148,91,57,527,130,288,135,96,57,66,41,24,1,38,16,22,5,5,34,12,22
"2021","West Devon 004D","E01020340",758,198,108,90,509,113,270,122,103,45,76,44,28,4,48,30,18,2,2,51,24,27
"2021","West Devon 005A","E01020332",973,473,211,262,465,97,205,100,74,31,98,67,29,2,63,35,28,2,2,35,8,27
"2021","West Devon 005B","E01020333",963,248,142,106,679,160,334,137,135,62,104,59,42,3,80,61,19,1,1,36,14,22
"2021","West Devon 005C","E01020334",875,317,173,144,528,97,237,95,103,39,98,61,34,3,92,68,24,4,4,30,8,22
"2021","West Devon 005D","E01020335",719,226,158,68,465,158,213,91,78,44,47,25,19,3,45,22,23,2,2,28,10,18
"2021","West Devon 005E","E01020336",631,166,126,40,455,166,229,111,72,46,30,14,15,1,29,12,17,1,1,10,5,5
"2021","West Devon 005F","E01020337",587,232,135,97,342,72,173,72,79,22,47,27,18,2,48,35,13,2,2,13,2,11
"2021","West Devon 005G","E01020338",1083,355,183,172,699,140,316,126,141,49,109,54,46,9,133,90,43,1,1,29,9,20
"2021","West Devon 006A","E01020317",649,174,107,67,451,124,239,134,61,44,55,29,25,1,28,17,11,5,5,24,11,13
"2021","West Devon 006B","E01020324",702,182,122,60,481,125,263,135,81,47,59,36,19,4,33,13,20,1,1,39,9,30
"2021","West Devon 006C","E01020341",690,154,102,52,485,148,250,127,84,39,47,32,13,2,38,17,21,2,2,51,20,31
"2021","West Devon 006D","E01020342",676,204,116,88,449,68,217,103,84,30,90,39,47,4,74,43,31,0,0,23,10,13
"2021","West Devon 007A","E01020312",755,207,138,69,500,157,232,115,64,53,62,45,13,4,45,28,17,4,4,48,16,32
"2021","West Devon 007B","E01020313",652,217,110,107,413,74,194,83,75,36,75,33,38,4,67,33,34,3,3,22,8,14
"2021","West Devon 007C","E01020315",712,254,144,110,419,101,213,96,90,27,59,26,28,5,45,26,19,1,1,39,18,21
"2021","West Devon 007D","E01020316",782,184,123,61,560,161,307,141,117,49,45,29,16,0,44,21,23,3,3,38,15,23
"2021","Cheltenham 001A","E01022163",614,153,66,87,423,63,215,71,99,45,77,49,22,6,66,36,30,2,2,38,12,26
"2021","Cheltenham 001B","E01022164",626,221,66,155,360,22,143,52,63,28,87,50,31,6,103,68,35,5,5,45,20,25
"2021","Cheltenham 001C","E01022165",712,252,101,151,432,85,211,94,77,40,93,67,22,4,41,21,20,2,2,28,9,19
"2021","Cheltenham 001D","E01022166",533,153,86,67,360,68,195,68,89,38,65,33,28,4,30,15,15,2,2,20,7,13
"2021","Cheltenham 002A","E01022143",803,222,147,75,551,150,274,113,128,33,80,53,22,5,46,28,18,1,1,30,7,23
"2021","Cheltenham 002B","E01022144",671,222,134,88,433,97,216,76,114,26,75,52,18,5,42,24,18,3,3,16,8,8
"2021","Cheltenham 002C","E01022145",516,135,88,47,371,68,222,85,94,43,58,27,25,6,22,10,12,1,1,10,4,6
"2021","Cheltenham 002D","E01022146",632,203,138,65,409,128,209,89,87,33,45,31,13,1,24,8,16,3,3,20,4,16
"2021","Cheltenham 003A","E01022122",574,180,86,94,351,24,137,36,86,15,71,22,42,7,113,82,31,6,6,43,18,25
"2021","Cheltenham 003B","E01022160",906,270,105,165,567,29,228,68,131,29,163,88,62,13,144,95,49,3,3,69,18,51
"2021","Cheltenham 003C","E01022161",636,169,40,129,438,49,182,77,83,22,124,77,44,3,75,48,27,8,8,29,9,20
"2021","Cheltenham 003D","E01022162",714,228,113,115,452,101,190,83,76,31,91,44,37,10,67,34,33,3,3,34,10,24
"2021","Cheltenham 004A","E01022139",683,190,113,77,471,121,204,77,99,28,91,57,28,6,54,36,18,1,1,22,9,13
"2021","Cheltenham 004B","E01022151",675,248,50,198,314,22,116,55,46,15,114,89,25,0,51,34,17,11,11,113,16,97
"2021","Cheltenham 004C","E01022152",538,196,67,129,287,21,96,34,47,15,69,35,31,3,91,67,24,10,10,55,12,43
"2021","Cheltenham 004D","E01022153",710,290,32,258,291,12,92,49,35,8,120,103,14,3,58,37,21,9,9,129,7,122
"2021","Cheltenham 004E","E01022154",746,231,54,177,293,14,105,38,55,12,114,90,23,1,48,27,21,12,12,222,7,215
"2021","Cheltenham 005A","E01022120",721,292,66,226,395,26,166,53,74,39,87,29,48,10,111,77,34,5,5,34,17,17
"2021","Cheltenham 005B","E01022121",736,217,63,154,468,19,176,40,102,34,114,46,60,8,148,104,44,11,11,51,21,30
"2021","Cheltenham 005C","E01022147",765,313,68,245,419,29,142,49,59,34,95,34,56,5,150,105,45,3,3,33,10,23
"2021","Cheltenham 005D","E01022157",643,172,61,111,434,35,160,62,70,28,102,43,54,5,125,88,37,12,12,37,14,23
"2021","Cheltenham 005E","E01022159",651,176,73,103,427,37,198,56,110,32,81,34,39,8,108,72,36,3,3,48,19,29
"2021","Cheltenham 006A","E01022131",562,149,79,70,385,35,171,57,85,29,72,28,37,7,103,71,32,4,4,28,12,16
"2021","Cheltenham 006B","E01022132",613,164,78,86,417,44,177,60,90,27,93,44,42,7,87,52,35,16,16,32,9,23
"2021","Cheltenham 006C","E01022133",499,99,33,66,358,24,151,37,76,38,84,31,42,11,89,52,37,10,10,42,24,18
"2021","Cheltenham 006D","E01022134",795,358,149,209,398,61,192,79,89,24,77,46,24,7,65,43,22,3,3,39,12,27
"2021","Cheltenham 007A","E01022148",666,208,101,107,421,63,205,73,93,39,102,70,27,5,48,19,29,3,3,37,9,28
"2021","Cheltenham 007B","E01022149",562,125,45,80,391,21,197,70,87,40,90,44,36,10,80,38,42,3,3,46,16,30
"2021","Cheltenham 007C","E01022150",669,217,65,152,410,42,179,80,73,26,114,73,34,7,68,42,26,7,7,42,11,31
"2021","Cheltenham 007D","E01022155",672,195,74,121,423,66,214,86,98,30,86,55,25,6,51,23,28,6,6,54,12,42
"2021","Cheltenham 007E","E01022156",806,232,41,191,489,26,223,70,129,24,159,113,44,2,72,42,30,9,9,85,16,69
"2021","Cheltenham 007G","E01034777",659,276,61,215,292,17,111,52,47,12,121,101,17,3,36,23,13,7,7,91,9,82
"2021","Cheltenham 007H","E01034778",584,291,85,206,253,9,91,36,49,6,119,98,19,2,31,19,12,3,3,40,4,36
"2021","Cheltenham 008A","E01022100",761,250,80,170,462,78,245,101,115,29,90,60,30,0,47,23,24,2,2,49,12,37
"2021","Cheltenham 008B","E01022101",835,300,104,196,472,49,242,99,123,20,109,89,20,0,65,42,23,7,7,63,6,57
"2021","Cheltenham 008C","E01022102",1164,623,82,541,427,18,141,83,43,15,203,176,25,2,45,25,20,20,20,114,3,111
"2021","Cheltenham 008D","E01022140",670,244,136,108,414,59,206,88,94,24,90,63,25,2,53,24,29,6,6,12,5,7
"2021","Cheltenham 008E","E01022141",788,381,89,292,355,75,150,85,47,18,103,88,12,3,26,13,13,1,1,52,5,47
"2021","Cheltenham 008F","E01022142",765,365,101,264,337,26,115,41,61,13,137,115,20,2,50,32,18,9,9,63,7,56
"2021","Cheltenham 009A","E01022116",577,271,88,183,256,40,94,38,46,10,99,88,10,1,20,11,9,3,3,50,3,47
"2021","Cheltenham 009B","E01022117",973,545,108,437,368,82,110,66,33,11,128,120,8,0,43,20,23,5,5,60,4,56
"2021","Cheltenham 009C","E01022119",578,213,64,149,346,30,189,61,105,23,75,58,14,3,48,30,18,4,4,19,1,18
"2021","Cheltenham 009D","E01022124",750,476,132,344,249,41,77,49,21,7,92,84,8,0,39,26,13,0,0,25,2,23
"2021","Cheltenham 009E","E01022125",575,230,84,146,320,58,166,62,77,27,75,69,6,0,21,11,10,0,0,25,5,20
"2021","Cheltenham 009F","E01022126",872,489,106,383,339,40,118,73,36,9,115,113,1,1,59,38,21,7,7,44,3,41
"2021","Cheltenham 009G","E01022127",736,399,86,313,274,36,99,54,33,12,105,100,5,0,27,18,9,7,7,63,6,57
"2021","Cheltenham 010A","E01022106",735,214,121,93,493,94,275,85,142,48,70,36,32,2,49,23,26,5,5,28,7,21
"2021","Cheltenham 010B","E01022107",646,188,85,103,437,78,247,79,130,38,75,45,27,3,36,17,19,1,1,21,5,16
"2021","Cheltenham 010C","E01022108",721,203,123,80,484,107,278,98,118,62,49,25,18,6,46,20,26,4,4,34,9,25
"2021","Cheltenham 010D","E01022123",1020,368,125,243,573,93,264,105,128,31,144,83,49,12,66,37,29,6,6,79,20,59
"2021","Cheltenham 011A","E01022135",643,228,133,95,399,108,204,73,110,21,54,39,14,1,29,16,13,4,4,16,2,14
"2021","Cheltenham 011B","E01022136",770,371,217,154,371,89,146,77,55,14,81,60,20,1,52,30,22,3,3,28,4,24
"2021","Cheltenham 011C","E01022137",852,410,167,243,395,73,161,76,61,24,117,104,12,1,38,31,7,6,6,47,5,42
"2021","Cheltenham 011D","E01022138",751,299,111,188,425,109,198,83,94,21,82,61,19,2,35,21,14,1,1,27,7,20
"2021","Cheltenham 011E","E01022174",596,179,109,70,388,73,204,65,104,35,57,33,20,4,52,23,29,2,2,29,11,18
"2021","Cheltenham 012B","E01022104",713,222,99,123,447,53,235,59,143,33,93,53,38,2,63,42,21,3,3,44,18,26
"2021","Cheltenham 012C","E01022105",588,145,96,49,421,88,265,66,155,44,26,15,6,5,41,22,19,1,1,22,9,13
"2021","Cheltenham 012D","E01022109",628,148,96,52,463,94,293,87,153,53,37,16,20,1,37,27,10,2,2,17,8,9
"2021","Cheltenham 012E","E01022110",624,226,116,110,383,37,214,52,136,26,59,30,27,2,70,52,18,3,3,15,5,10
"2021","Cheltenham 012F","E01022111",602,167,90,77,421,64,260,69,163,28,44,21,20,3,52,38,14,1,1,14,9,5
"2021","Cheltenham 012G","E01022112",473,84,49,35,372,52,241,53,152,36,45,14,27,4,33,27,6,1,1,17,7,10
"2021","Cheltenham 012H","E01034779",669,168,29,139,457,13,227,72,137,18,141,92,46,3,75,55,20,1,1,44,12,32
"2021","Cheltenham 012I","E01034780",621,163,72,91,434,82,249,86,117,46,70,38,28,4,32,19,13,1,1,24,9,15
"2021","Cheltenham 013A","E01022167",544,133,91,42,396,120,211,83,101,27,36,21,12,3,28,15,13,1,1,15,8,7
"2021","Cheltenham 013B","E01022168",475,137,88,49,319,71,160,45,93,22,52,27,22,3,36,17,19,0,0,19,6,13
"2021","Cheltenham 013C","E01022169",666,232,127,105,412,63,189,53,110,26,87,36,43,8,70,45,25,3,3,22,8,14
"2021","Cheltenham 013D","E01022170",611,179,89,90,416,49,248,100,110,38,71,46,23,2,47,31,16,1,1,16,5,11
"2021","Cheltenham 013E","E01022171",550,144,54,90,399,38,256,89,131,36,66,48,16,2,36,25,11,3,3,7,1,6
"2021","Cheltenham 013F","E01022172",713,252,163,89,445,114,197,76,82,39,77,50,24,3,56,20,36,1,1,16,3,13
"2021","Cheltenham 013G","E01022173",616,222,110,112,377,54,146,61,69,16,89,53,32,4,87,54,33,1,1,17,10,7
"2021","Cheltenham 014A","E01022113",731,192,149,43,515,150,300,93,161,46,32,16,14,2,30,16,14,3,3,24,9,15
"2021","Cheltenham 014B","E01022114",657,168,100,68,476,118,266,82,144,40,48,19,25,4,43,28,15,1,1,13,7,6
"2021","Cheltenham 014C","E01022115",755,273,127,146,455,103,225,85,102,38,82,59,19,4,43,25,18,2,2,27,9,18
"2021","Cheltenham 014D","E01022118",618,163,84,79,432,67,252,70,135,47,73,45,26,2,37,26,11,3,3,23,7,16
"2021","Cheltenham 015A","E01022128",641,160,108,52,457,116,267,81,155,31,47,30,15,2,26,14,12,1,1,24,8,16
"2021","Cheltenham 015B","E01022129",977,289,200,89,662,128,400,130,231,39,72,37,30,5,62,35,27,0,0,26,9,17
"2021","Cheltenham 015C","E01022130",737,275,138,137,446,76,259,84,146,29,74,55,18,1,35,23,12,2,2,16,5,11
"2021","Cotswold 001A","E01022179",900,265,138,127,599,136,310,151,104,55,91,51,35,5,59,37,22,3,3,36,12,24
"2021","Cotswold 001B","E01022182",778,224,123,101,525,153,261,131,87,43,58,33,20,5,51,30,21,2,2,29,12,17
"2021","Cotswold 001C","E01022183",764,284,173,111,458,148,211,98,82,31,54,35,18,1,43,25,18,2,2,22,5,17
"2021","Cotswold 001D","E01022184",699,187,119,68,484,150,230,110,78,42,61,34,21,6,40,23,17,3,3,28,8,20
"2021","Cotswold 001E","E01022185",870,248,146,102,601,147,300,120,133,47,77,44,31,2,74,48,26,3,3,21,6,15
"2021","Cotswold 002A","E01022177",966,402,264,138,532,145,240,119,80,41,97,66,29,2,48,21,27,2,2,32,4,28
"2021","Cotswold 002B","E01022178",588,158,93,65,410,102,212,91,85,36,53,33,18,2,43,21,22,0,0,20,5,15
"2021","Cotswold 002C","E01022205",836,250,134,116,549,135,263,128,93,42,94,56,29,9,56,27,29,1,1,37,11,26
"2021","Cotswold 002D","E01022211",1026,437,260,177,552,143,239,117,86,36,91,62,29,0,77,45,32,2,2,37,5,32
"2021","Cotswold 002F","E01034781",720,173,41,132,523,54,257,82,151,24,134,80,51,3,76,61,15,2,2,24,13,11
"2021","Cotswold 002G","E01034782",618,193,104,89,403,98,195,95,68,32,68,48,15,5,39,14,25,3,3,22,9,13
"2021","Cotswold 003B","E01022181",841,275,188,87,532,167,254,109,110,35,61,34,22,5,44,32,12,6,6,34,9,25
"2021","Cotswold 003D","E01022222",868,250,110,140,574,138,291,144,94,53,101,62,34,5,36,20,16,8,8,44,16,28
"2021","Cotswold 003E","E01034783",568,152,62,90,396,43,192,67,104,21,92,56,32,4,66,52,14,3,3,20,5,15
"2021","Cotswold 003F","E01034784",635,184,116,68,419,93,200,72,93,35,62,34,24,4,61,35,26,3,3,32,6,26
"2021","Cotswold 003G","E01034785",623,147,77,70,446,84,248,121,92,35,60,37,16,7,49,24,25,5,5,30,11,19
"2021","Cotswold 003H","E01034786",597,115,25,90,463,31,283,71,183,29,83,47,32,4,62,42,20,4,4,19,6,13
"2021","Cotswold 004A","E01022186",694,162,89,73,503,113,280,120,115,45,65,41,20,4,43,25,18,2,2,29,7,22
"2021","Cotswold 004B","E01022187",751,180,89,91,529,118,303,121,134,48,64,39,20,5,43,26,17,1,1,42,15,27
"2021","Cotswold 004C","E01022201",790,191,97,94,568,124,340,156,138,46,69,48,19,2,33,19,14,2,2,31,6,25
"2021","Cotswold 004D","E01022216",861,241,115,126,591,114,327,146,131,50,95,72,16,7,54,33,21,1,1,29,10,19
"2021","Cotswold 005A","E01022175",817,230,115,115,553,124,293,139,100,54,74,48,20,6,57,24,33,5,5,34,8,26
"2021","Cotswold 005B","E01022207",732,178,110,68,524,129,284,125,116,43,64,37,17,10,47,22,25,0,0,30,6,24
"2021","Cotswold 005C","E01022213",862,245,136,109,590,130,292,116,131,45,101,59,36,6,64,46,18,3,3,27,15,12
"2021","Cotswold 005D","E01022215",807,240,112,128,543,105,299,157,101,41,83,60,21,2,55,34,21,1,1,24,3,21
"2021","Cotswold 006A","E01022188",888,260,87,173,598,63,277,80,143,54,124,52,70,2,131,81,50,3,3,30,12,18
"2021","Cotswold 006B","E01022189",512,110,66,44,381,81,219,80,96,43,49,29,14,6,31,19,12,1,1,21,8,13
"2021","Cotswold 006C","E01022190",589,129,48,81,430,52,234,78,111,45,68,34,31,3,76,49,27,0,0,30,12,18
"2021","Cotswold 006D","E01022196",769,219,121,98,525,119,279,101,140,38,76,45,24,7,49,29,20,2,2,25,5,20
"2021","Cotswold 006E","E01022197",775,176,102,74,574,130,319,122,145,52,75,40,31,4,43,21,22,7,7,25,7,18
"2021","Cotswold 007A","E01022194",1069,635,360,275,385,94,146,52,75,19,82,67,13,2,58,32,26,5,5,49,8,41
"2021","Cotswold 007B","E01022195",665,255,144,111,376,123,158,56,75,27,64,45,17,2,31,17,14,0,0,34,7,27
"2021","Cotswold 007C","E01022199",840,368,173,195,430,85,196,91,73,32,92,71,17,4,56,38,18,1,1,42,10,32
"2021","Cotswold 007D","E01022200",582,267,95,172,300,42,119,44,54,21,56,26,24,6,82,57,25,1,1,15,7,8
"2021","Cotswold 008A","E01022191",663,249,99,150,383,54,170,72,68,30,107,72,32,3,49,22,27,3,3,31,6,25
"2021","Cotswold 008B","E01022192",512,138,62,76,317,33,151,49,61,41,52,23,22,7,78,44,34,3,3,57,8,49
"2021","Cotswold 008C","E01022193",419,78,55,23,330,97,179,57,90,32,36,16,15,5,17,7,10,1,1,11,1,10
"2021","Cotswold 008D","E01022198",602,218,87,131,348,54,161,65,66,30,72,45,24,3,55,38,17,6,6,36,10,26
"2021","Cotswold 008E","E01022225",1045,318,172,146,677,108,361,123,189,49,117,68,46,3,88,62,26,3,3,50,14,36
"2021","Cotswold 009A","E01022202",550,122,65,57,409,71,229,78,115,36,54,31,20,3,53,34,19,2,2,19,4,15
"2021","Cotswold 009B","E01022203",941,263,177,86,652,141,331,124,158,49,103,51,41,11,74,48,26,3,3,26,7,19
"2021","Cotswold 009C","E01022204",602,169,90,79,407,74,200,75,82,43,74,38,30,6,58,35,23,1,1,26,8,18
"2021","Cotswold 009D","E01022208",723,182,98,84,519,127,300,133,125,42,56,30,23,3,34,17,17,2,2,22,7,15
"2021","Cotswold 009E","E01022209",491,100,41,59,379,84,216,90,95,31,48,29,14,5,28,14,14,3,3,12,4,8
"2021","Cotswold 009F","E01022210",765,290,172,118,460,121,204,111,68,25,66,42,23,1,66,40,26,3,3,15,4,11
"2021","Cotswold 010A","E01022221",855,188,79,109,625,126,372,142,162,68,69,39,26,4,55,32,23,3,3,42,16,26
"2021","Cotswold 010C","E01022224",686,179,100,79,483,119,288,142,99,47,56,36,17,3,18,5,13,2,2,24,11,13
"2021","Cotswold 010D","E01034787",708,173,83,90,506,96,292,115,129,48,73,45,25,3,44,25,19,1,1,29,11,18
"2021","Cotswold 010E","E01034788",509,115,62,53,384,71,193,72,92,29,59,29,27,3,60,41,19,1,1,10,4,6
"2021","Cotswold 011A","E01022176",824,228,108,120,570,106,325,134,135,56,81,48,29,4,53,37,16,5,5,26,6,20
"2021","Cotswold 011C","E01022217",559,168,94,74,373,75,202,78,90,34,51,31,16,4,43,25,18,2,2,18,6,12
"2021","Cotswold 011D","E01022218",526,159,76,83,346,50,156,61,65,30,69,37,27,5,68,40,28,3,3,21,10,11
"2021","Cotswold 011E","E01022219",671,204,131,73,448,138,214,78,104,32,59,34,24,1,34,17,17,3,3,19,5,14
"2021","Cotswold 011F","E01022220",837,346,180,166,470,137,200,103,77,20,83,57,20,6,41,29,12,9,9,21,7,14
"2021","Cotswold 011G","E01034789",584,163,39,124,404,41,197,91,88,18,117,78,36,3,47,36,11,2,2,17,4,13
"2021","Cotswold 011H","E01034790",631,176,100,76,432,86,253,106,101,46,52,38,11,3,41,18,23,0,0,23,10,13
"2021","Forest of Dean 001A","E01022233",811,223,120,103,534,141,290,122,116,52,64,40,19,5,37,18,19,2,2,54,28,26
"2021","Forest of Dean 001B","E01022235",765,201,117,84,531,140,264,111,110,43,72,36,29,7,52,34,18,3,3,33,15,18
"2021","Forest of Dean 001C","E01022247",705,172,104,68,483,113,260,114,92,54,61,36,22,3,47,18,29,2,2,50,15,35
"2021","Forest of Dean 001D","E01022270",798,168,84,84,578,111,322,139,131,52,87,42,41,4,53,29,24,5,5,52,22,30
"2021","Forest of Dean 001E","E01022271",716,157,99,58,525,157,269,113,91,65,60,34,23,3,34,20,14,5,5,34,12,22
"2021","Forest of Dean 002A","E01022261",990,248,127,121,686,142,303,111,136,56,117,56,51,10,118,67,51,6,6,56,28,28
"2021","Forest of Dean 002B","E01022262",1057,430,207,223,568,90,266,102,108,56,103,55,44,4,102,62,40,7,7,59,25,34
"2021","Forest of Dean 002C","E01022267",784,222,137,85,510,134,250,113,89,48,71,40,24,7,49,30,19,6,6,52,18,34
"2021","Forest of Dean 003A","E01022251",634,195,106,89,413,73,193,79,73,41,74,33,34,7,73,42,31,0,0,26,13,13
"2021","Forest of Dean 003B","E01022252",741,176,111,65,510,111,273,104,110,59,83,35,43,5,40,15,25,3,3,55,18,37
"2021","Forest of Dean 003C","E01022258",535,176,73,103,334,39,157,53,70,34,66,32,29,5,68,45,23,4,4,25,13,12
"2021","Forest of Dean 003D","E01022259",641,153,83,70,462,91,268,116,104,48,63,34,24,5,38,19,19,2,2,26,12,14
"2021","Forest of Dean 003E","E01022260",779,207,123,84,529,91,261,102,105,54,91,43,37,11,84,48,36,2,2,43,22,21
"2021","Forest of Dean 004A","E01022236",888,248,119,129,599,100,284,113,115,56,118,54,51,13,95,61,34,2,2,41,16,25
"2021","Forest of Dean 004B","E01022237",638,203,105,98,403,46,181,68,74,39,87,37,40,10,86,54,32,3,3,32,13,19
"2021","Forest of Dean 004C","E01022238",732,286,158,128,416,56,162,67,64,31,80,36,39,5,118,82,36,0,0,30,7,23
"2021","Forest of Dean 004D","E01022239",693,199,101,98,460,81,231,103,80,48,90,56,32,2,56,31,25,2,2,34,12,22
"2021","Forest of Dean 004E","E01022240",986,354,135,219,578,86,240,102,100,38,140,82,55,3,98,48,50,14,14,54,18,36
"2021","Forest of Dean 004F","E01022249",893,243,114,129,586,125,304,142,106,56,98,62,28,8,56,33,23,3,3,64,25,39
"2021","Forest of Dean 004G","E01022250",907,253,118,135,615,88,288,133,114,41,136,56,73,7,99,65,34,4,4,39,21,18
"2021","Forest of Dean 005A","E01022228",706,195,96,99,470,92,226,104,79,43,95,43,44,8,56,29,27,1,1,41,13,28
"2021","Forest of Dean 005B","E01022230",753,187,101,86,524,120,300,132,114,54,67,34,28,5,36,14,22,1,1,42,16,26
"2021","Forest of Dean 005C","E01022265",752,257,144,113,452,112,218,101,74,43,72,46,20,6,49,28,21,1,1,43,13,30
"2021","Forest of Dean 005D","E01022266",534,113,63,50,378,80,199,80,78,41,56,32,21,3,39,18,21,4,4,43,14,29
"2021","Forest of Dean 006A","E01022234",684,192,122,70,452,119,240,125,63,52,57,40,11,6,33,13,20,3,3,40,19,21
"2021","Forest of Dean 006B","E01022253",739,211,109,102,495,87,260,136,82,42,91,57,27,7,56,30,26,1,1,33,17,16
"2021","Forest of Dean 006C","E01022263",817,176,105,71,595,145,302,147,109,46,84,49,31,4,62,36,26,2,2,46,17,29
"2021","Forest of Dean 007A","E01022229",679,173,101,72,472,99,213,94,80,39,96,46,41,9,62,32,30,2,2,34,20,14
"2021","Forest of Dean 007B","E01022241",970,459,230,229,479,108,203,88,78,37,102,52,48,2,62,34,28,4,4,32,9,23
"2021","Forest of Dean 007C","E01022242",772,206,103,103,536,101,256,110,96,50,86,38,41,7,92,58,34,1,1,30,11,19
"2021","Forest of Dean 007D","E01022243",599,175,93,82,400,66,177,68,71,38,80,29,41,10,75,50,25,2,2,24,11,13
"2021","Forest of Dean 007E","E01022244",669,186,108,78,462,77,229,85,83,61,88,51,29,8,65,39,26,3,3,21,11,10
"2021","Forest of Dean 007F","E01022245",622,223,91,132,378,56,164,73,60,31,86,45,38,3,72,43,29,0,0,21,7,14
"2021","Forest of Dean 007G","E01022246",550,135,81,54,392,95,191,77,82,32,71,36,29,6,32,14,18,3,3,23,10,13
"2021","Forest of Dean 008A","E01022231",718,209,122,87,483,83,237,108,88,41,92,41,47,4,69,52,17,2,2,26,9,17
"2021","Forest of Dean 008B","E01022232",689,176,82,94,493,97,231,92,85,54,94,48,41,5,67,35,32,4,4,20,7,13
"2021","Forest of Dean 008C","E01022264",664,174,99,75,457,107,223,87,76,60,76,37,29,10,51,31,20,0,0,33,14,19
"2021","Forest of Dean 008D","E01022268",729,196,109,87,509,104,262,118,86,58,77,41,33,3,61,40,21,5,5,24,5,19
"2021","Forest of Dean 008E","E01022269",802,177,110,67,589,144,298,138,103,57,80,45,26,9,62,28,34,5,5,36,15,21
"2021","Forest of Dean 009A","E01022226",692,265,134,131,403,89,164,58,64,42,78,42,27,9,69,39,30,3,3,24,9,15
"2021","Forest of Dean 009B","E01022227",723,205,111,94,490,136,218,91,82,45,82,44,28,10,52,28,24,2,2,28,9,19
"2021","Forest of Dean 009C","E01022254",1049,284,113,171,727,73,267,113,109,45,182,75,94,13,201,137,64,4,4,38,16,22
"2021","Forest of Dean 009D","E01022255",946,214,86,128,695,108,340,132,146,62,166,96,63,7,75,54,21,6,6,37,16,21
"2021","Forest of Dean 009E","E01022256",841,332,172,160,469,81,177,68,68,41,104,50,48,6,99,51,48,8,8,40,10,30
"2021","Forest of Dean 009F","E01022257",785,208,128,80,541,148,253,111,86,56,76,44,29,3,64,30,34,0,0,36,14,22
"2021","Forest of Dean 010A","E01022248",714,158,100,58,517,156,261,109,98,54,58,37,19,2,39,16,23,3,3,39,13,26
"2021","Forest of Dean 010B","E01022272",597,184,124,60,383,67,181,90,61,30,63,33,27,3,67,42,25,5,5,30,13,17
"2021","Forest of Dean 010C","E01022273",433,80,46,34,328,69,186,61,107,18,41,27,14,0,31,17,14,1,1,25,11,14
"2021","Forest of Dean 010D","E01022274",494,104,63,41,363,85,188,87,73,28,66,42,19,5,24,13,11,0,0,27,16,11
"2021","Forest of Dean 010E","E01022275",818,216,123,93,570,117,307,105,155,47,89,50,34,5,55,33,22,2,2,32,13,19
"2021","Gloucester 001A","E01022313",716,210,87,123,481,75,242,86,111,45,101,66,30,5,63,36,27,0,0,25,7,18
"2021","Gloucester 001B","E01022315",629,159,95,64,433,101,220,84,84,52,64,29,28,7,44,23,21,4,4,37,14,23
"2021","Gloucester 001C","E01022316",680,187,78,109,475,72,254,100,101,53,90,58,31,1,56,38,18,3,3,18,6,12
"2021","Gloucester 001D","E01022317",606,138,72,66,441,68,271,97,138,36,64,28,30,6,36,14,22,2,2,27,10,17
"2021","Gloucester 001E","E01022318",657,168,118,50,458,109,250,94,97,59,63,32,27,4,32,19,13,4,4,31,11,20
"2021","Gloucester 002A","E01022309",606,169,78,91,375,54,193,60,91,42,67,31,28,8,56,27,29,5,5,62,15,47
"2021","Gloucester 002B","E01022310",720,221,87,134,409,63,179,74,68,37,82,50,24,8,79,44,35,6,6,90,12,78
"2021","Gloucester 002C","E01022311",1062,621,161,460,349,15,131,61,53,17,96,63,32,1,92,70,22,15,15,92,15,77
"2021","Gloucester 002D","E01022312",1017,450,138,312,495,49,248,81,130,37,125,97,25,3,62,42,20,11,11,72,22,50
"2021","Gloucester 002E","E01022314",725,195,120,75,509,109,288,107,129,52,61,35,24,2,47,27,20,4,4,21,9,12
"2021","Gloucester 003A","E01022295",593,163,109,54,415,80,215,76,98,41,71,40,28,3,47,31,16,2,2,15,6,9
"2021","Gloucester 003B","E01022296",619,168,75,93,417,37,198,47,102,49,93,43,43,7,85,47,38,4,4,34,13,21
"2021","Gloucester 003C","E01022297",534,115,70,45,394,84,233,72,110,51,60,31,24,5,15,6,9,2,2,25,9,16
"2021","Gloucester 003D","E01022298",625,138,59,79,444,57,260,82,124,54,69,37,29,3,55,33,22,3,3,43,10,33
"2021","Gloucester 004A","E01022332",764,270,50,220,406,27,169,52,82,35,110,66,39,5,90,60,30,10,10,88,28,60
"2021","Gloucester 004E","E01032932",985,533,244,289,387,61,130,57,61,12,115,90,22,3,72,50,22,9,9,65,13,52
"2021","Gloucester 004F","E01032937",843,505,89,416,272,5,94,52,35,7,95,72,22,1,70,51,19,8,8,66,12,54
"2021","Gloucester 004G","E01034791",727,305,65,240,380,49,126,55,49,22,112,74,36,2,80,65,15,13,13,42,11,31
"2021","Gloucester 004H","E01034792",690,391,63,328,239,12,80,50,22,8,105,88,13,4,34,23,11,8,8,60,4,56
"2021","Gloucester 004I","E01034793",750,362,28,334,295,12,95,56,29,10,112,88,20,4,56,38,18,20,20,93,17,76
"2021","Gloucester 004J","E01034794",792,192,77,115,541,76,275,95,135,45,118,72,41,5,72,38,34,0,0,59,23,36
"2021","Gloucester 005A","E01022288",824,257,60,197,487,22,223,60,130,33,94,49,39,6,138,102,36,10,10,80,34,46
"2021","Gloucester 005B","E01022289",703,239,77,162,398,24,200,53,119,28,59,33,25,1,103,60,43,12,12,66,27,39
"2021","Gloucester 005C","E01022290",547,157,64,93,335,21,171,43,90,38,50,13,32,5,90,56,34,3,3,55,21,34
"2021","Gloucester 005D","E01022291",659,172,44,128,395,12,208,58,119,31,77,40,34,3,97,65,32,1,1,92,44,48
"2021","Gloucester 005E","E01022292",511,131,34,97,296,19,178,38,105,35,35,14,19,2,54,33,21,10,10,84,39,45
"2021","Gloucester 006A","E01022283",639,175,103,72,443,107,251,103,103,45,50,31,17,2,31,14,17,4,4,21,10,11
"2021","Gloucester 006B","E01022303",642,219,139,80,395,81,185,67,76,42,67,35,28,4,60,24,36,2,2,28,15,13
"2021","Gloucester 006C","E01022304",826,288,177,111,513,148,220,89,95,36,76,44,27,5,65,33,32,4,4,25,11,14
"2021","Gloucester 006D","E01022305",593,153,94,59,416,102,222,70,93,59,48,33,13,2,44,14,30,0,0,24,9,15
"2021","Gloucester 006E","E01022308",645,178,118,60,445,112,199,71,92,36,67,41,21,5,60,32,28,7,7,22,9,13
"2021","Gloucester 007A","E01022278",663,148,65,83,491,91,258,93,115,50,74,38,30,6,65,40,25,3,3,24,15,9
"2021","Gloucester 007B","E01022279",568,118,68,50,424,61,217,74,105,38,88,39,41,8,57,28,29,1,1,26,15,11
"2021","Gloucester 007C","E01022282",1032,228,69,159,770,80,471,134,246,91,117,65,48,4,101,59,42,1,1,34,12,22
"2021","Gloucester 007D","E01022284",525,151,56,95,335,46,144,52,53,39,78,33,40,5,66,41,25,1,1,39,11,28
"2021","Gloucester 007E","E01022285",507,99,63,36,360,33,167,53,77,37,59,24,26,9,94,37,57,7,7,48,25,23
"2021","Gloucester 007F","E01022286",647,154,55,99,434,32,212,68,102,42,80,25,48,7,106,61,45,4,4,59,31,28
"2021","Gloucester 007G","E01022287",838,273,122,151,519,67,251,77,126,48,118,75,36,7,78,50,28,5,5,46,24,22
"2021","Gloucester 008A","E01022293",646,223,52,171,354,18,160,38,78,44,87,48,27,12,86,51,35,3,3,69,26,43
"2021","Gloucester 008B","E01022294",722,208,49,159,459,31,198,61,102,35,111,49,54,8,115,79,36,4,4,55,23,32
"2021","Gloucester 008C","E01022323",659,148,48,100,463,23,183,55,91,37,107,36,53,18,145,87,58,5,5,48,22,26
"2021","Gloucester 008D","E01022328",535,151,71,80,340,24,165,52,77,36,68,27,32,9,79,41,38,4,4,44,17,27
"2021","Gloucester 008E","E01022329",612,146,55,91,407,24,156,42,82,32,93,31,53,9,128,88,40,6,6,59,23,36
"2021","Gloucester 009A","E01022326",560,166,45,121,337,24,122,38,65,19,100,45,52,3,85,60,25,6,6,57,13,44
"2021","Gloucester 009B","E01022327",609,167,67,100,399,45,203,70,88,45,66,37,22,7,85,57,28,0,0,43,9,34
"2021","Gloucester 009C","E01022330",616,183,50,133,380,32,166,49,78,39,99,45,48,6,72,44,28,11,11,53,16,37
"2021","Gloucester 009D","E01022331",516,118,47,71,363,26,189,63,74,52,62,34,21,7,82,44,38,4,4,35,14,21
"2021","Gloucester 009E","E01022333",684,267,91,176,382,26,141,46,67,28,75,29,36,10,137,90,47,3,3,35,10,25
"2021","Gloucester 009F","E01022334",790,208,127,81,528,87,273,99,134,40,108,58,42,8,59,32,27,1,1,54,21,33
"2021","Gloucester 010A","E01022276",669,175,116,59,454,119,225,84,101,40,61,36,20,5,48,21,27,1,1,40,14,26
"2021","Gloucester 010B","E01022277",638,184,117,67,433,105,226,86,92,48,58,31,27,0,41,22,19,3,3,21,6,15
"2021","Gloucester 010C","E01022280",694,238,51,187,446,23,213,97,85,31,135,84,50,1,74,54,20,1,1,10,4,6
"2021","Gloucester 010D","E01022281",688,136,67,69,533,82,311,117,137,57,74,42,27,5,66,43,23,0,0,19,7,12
"2021","Gloucester 010E","E01022306",582,164,64,100,396,56,228,91,99,38,67,40,23,4,44,23,21,1,1,22,6,16
"2021","Gloucester 010F","E01022307",634,139,37,102,473,44,264,97,124,43,109,67,35,7,55,31,24,1,1,22,7,15
"2021","Gloucester 011A","E01022319",745,290,78,212,432,13,113,24,70,19,97,33,56,8,204,154,50,5,5,23,10,13
"2021","Gloucester 011B","E01022320",683,200,75,125,455,48,233,89,92,52,91,49,38,4,82,50,32,1,1,28,8,20
"2021","Gloucester 011C","E01022321",657,177,76,101,432,46,224,75,89,60,79,36,36,7,80,40,40,3,3,48,21,27
"2021","Gloucester 011D","E01022322",623,269,133,136,323,41,127,47,56,24,78,29,44,5,73,49,24,4,4,31,15,16
"2021","Gloucester 011E","E01022324",691,206,75,131,443,47,161,54,68,39,100,43,44,13,132,97,35,3,3,42,13,29
"2021","Gloucester 011F","E01022325",581,183,91,92,371,77,170,71,64,35,70,46,22,2,50,32,18,4,4,27,14,13
"2021","Gloucester 012A","E01022343",538,147,88,59,352,74,197,74,76,47,46,24,21,1,34,23,11,1,1,39,19,20
"2021","Gloucester 012B","E01022344",628,142,82,60,458,76,223,99,73,51,90,43,41,6,68,38,30,1,1,28,11,17
"2021","Gloucester 012C","E01022345",698,191,118,73,470,107,235,84,104,47,69,29,33,7,58,25,33,1,1,37,16,21
"2021","Gloucester 012D","E01022346",667,216,82,134,425,40,151,66,46,39,84,36,42,6,147,96,51,3,3,26,11,15
"2021","Gloucester 013A","E01022299",625,199,115,84,399,106,190,97,60,33,63,34,26,3,39,17,22,1,1,27,10,17
"2021","Gloucester 013B","E01022300",626,207,138,69,399,128,159,74,47,38,65,38,24,3,46,22,24,1,1,20,9,11
"2021","Gloucester 013C","E01022301",673,222,106,116,424,46,184,70,81,33,85,36,39,10,103,72,31,6,6,27,12,15
"2021","Gloucester 013D","E01022302",631,159,102,57,438,107,200,69,82,49,62,34,23,5,66,39,27,3,3,34,20,14
"2021","Gloucester 014A","E01022339",681,120,50,70,537,67,296,100,151,45,113,57,44,12,60,40,20,1,1,24,8,16
"2021","Gloucester 014B","E01022340",616,185,37,148,408,30,190,83,76,31,129,79,44,6,56,35,21,3,3,23,7,16
"2021","Gloucester 014C","E01022341",1021,290,87,203,688,57,340,136,146,58,167,97,59,11,116,80,36,8,8,43,17,26
"2021","Gloucester 014D","E01022342",687,167,27,140,494,27,294,95,144,55,109,66,40,3,62,46,16,2,2,26,12,14
"2021","Gloucester 015A","E01022335",649,191,111,80,432,86,215,98,82,35,72,31,36,5,56,33,23,3,3,26,8,18
"2021","Gloucester 015B","E01022336",501,134,78,56,346,68,168,68,59,41,64,32,27,5,41,23,18,5,5,21,8,13
"2021","Gloucester 015D","E01022338",648,263,61,202,368,28,142,54,61,27,121,70,46,5,73,53,20,4,4,17,4,13
"2021","Gloucester 015E","E01032933",611,130,13,117,448,12,215,67,129,19,101,52,49,0,119,87,32,1,1,33,16,17
"2021","Gloucester 015G","E01032935",580,119,9,110,417,13,230,72,130,28,90,47,38,5,77,57,20,7,7,44,22,22
"2021","Gloucester 015I","E01034795",729,108,12,96,547,14,292,75,186,31,103,43,56,4,137,113,24,1,1,74,35,39
"2021","Gloucester 015J","E01034796",760,157,13,144,554,11,256,45,197,14,135,55,77,3,150,127,23,2,2,49,17,32
"2021","Gloucester 015K","E01034797",585,144,64,80,416,54,221,84,91,46,77,39,35,3,59,39,20,5,5,25,13,12
"2021","Gloucester 015L","E01034798",712,123,9,114,563,11,261,77,164,20,172,86,83,3,118,110,8,1,1,26,15,11
"2021","Stroud 001A","E01022378",922,231,73,158,657,91,348,125,166,57,146,81,60,5,72,49,23,0,0,34,15,19
"2021","Stroud 001B","E01022379",664,261,89,172,371,31,173,64,70,39,103,57,43,3,62,40,22,2,2,32,11,21
"2021","Stroud 001E","E01034799",660,132,13,119,498,12,238,55,167,16,135,84,49,2,107,76,31,6,6,30,10,20
"2021","Stroud 001F","E01034800",731,176,75,101,511,83,285,98,144,43,89,50,28,11,52,37,15,2,2,44,17,27
"2021","Stroud 001G","E01034801",834,199,131,68,576,173,298,124,119,55,59,31,18,10,41,16,25,5,5,59,34,25
"2021","Stroud 001H","E01034802",700,99,14,85,574,19,312,82,207,23,172,108,61,3,67,52,15,4,4,27,12,15
"2021","Stroud 002A","E01022354",970,250,159,91,678,183,371,145,161,65,67,35,26,6,54,26,28,3,3,42,10,32
"2021","Stroud 002B","E01022390",591,217,143,74,352,93,175,74,71,30,45,24,19,2,39,23,16,0,0,22,7,15
"2021","Stroud 002C","E01022391",685,178,117,61,467,134,262,124,102,36,38,27,9,2,30,15,15,3,3,40,12,28
"2021","Stroud 002D","E01022392",678,151,98,53,486,124,270,104,115,51,55,38,14,3,35,19,16,2,2,41,19,22
"2021","Stroud 003A","E01022376",1110,266,132,134,795,110,394,137,196,61,188,115,64,9,97,58,39,6,6,49,18,31
"2021","Stroud 003B","E01022396",762,181,89,92,537,116,289,125,131,33,81,54,21,6,46,29,17,5,5,44,15,29
"2021","Stroud 003C","E01022397",798,173,90,83,581,98,340,116,154,70,88,41,40,7,52,31,21,3,3,44,22,22
"2021","Stroud 003D","E01022398",502,119,61,58,358,85,201,96,69,36,43,24,16,3,28,15,13,1,1,25,5,20
"2021","Stroud 004A","E01022355",668,148,83,65,494,87,242,90,98,54,97,37,50,10,67,38,29,1,1,26,11,15
"2021","Stroud 004B","E01022356",1066,360,166,194,635,76,318,110,152,56,133,72,54,7,102,62,40,6,6,71,21,50
"2021","Stroud 004C","E01022357",857,290,141,149,550,106,260,104,104,52,113,53,55,5,68,45,23,3,3,17,9,8
"2021","Stroud 004D","E01022358",674,222,130,92,427,78,181,51,81,49,87,35,41,11,78,45,33,3,3,25,10,15
"2021","Stroud 004E","E01022377",976,348,155,193,602,107,285,99,134,52,118,63,52,3,85,45,40,7,7,26,6,20
"2021","Stroud 004F","E01022389",726,180,91,89,518,123,287,110,113,64,69,36,29,4,38,21,17,1,1,28,9,19
"2021","Stroud 005A","E01022400",841,247,134,113,556,91,284,108,128,48,105,71,32,2,69,31,38,7,7,38,9,29
"2021","Stroud 005B","E01022401",598,192,106,86,371,63,190,69,78,43,63,34,26,3,53,27,26,2,2,35,16,19
"2021","Stroud 005C","E01022402",647,177,83,94,447,53,225,89,84,52,103,55,39,9,65,35,30,1,1,23,7,16
"2021","Stroud 005D","E01022403",685,222,130,92,426,54,164,66,74,24,101,53,38,10,101,59,42,6,6,37,16,21
"2021","Stroud 005E","E01022404",670,196,101,95,432,74,220,74,107,39,82,51,27,4,50,23,27,6,6,42,10,32
"2021","Stroud 006B","E01022399",974,349,111,238,576,62,235,96,90,49,119,61,48,10,153,106,47,7,7,49,17,32
"2021","Stroud 006C","E01022410",1025,371,157,214,592,79,256,114,94,48,132,74,50,8,125,79,46,0,0,62,21,41
"2021","Stroud 006D","E01022411",953,349,176,173,574,83,278,110,117,51,124,74,48,2,87,51,36,2,2,30,15,15
"2021","Stroud 006E","E01022414",1164,434,162,272,659,79,288,102,133,53,161,95,59,7,121,71,50,10,10,71,19,52
"2021","Stroud 006F","E01034803",524,171,51,120,325,36,140,40,77,23,83,43,31,9,60,42,18,6,6,28,13,15
"2021","Stroud 006G","E01034804",725,403,153,250,276,59,110,48,47,15,69,49,18,2,34,15,19,4,4,46,12,34
"2021","Stroud 007A","E01022393",620,168,108,60,427,109,214,83,97,34,59,33,23,3,45,24,21,0,0,25,7,18
"2021","Stroud 007B","E01022394",676,220,73,147,425,41,201,67,108,26,118,70,39,9,62,41,21,3,3,31,10,21
"2021","Stroud 007C","E01022395",665,187,112,75,455,89,242,85,113,44,70,43,22,5,53,33,20,1,1,23,4,19
"2021","Stroud 007D","E01022408",436,94,51,43,333,69,190,83,84,23,46,24,19,3,28,10,18,0,0,9,2,7
"2021","Stroud 007E","E01022409",539,146,59,87,369,51,203,83,90,30,71,29,36,6,44,23,21,0,0,24,11,13
"2021","Stroud 008A","E01022366",683,142,78,64,522,92,325,117,161,47,64,36,25,3,39,19,20,2,2,19,7,12
"2021","Stroud 008B","E01022367",694,166,106,60,512,125,276,105,131,40,63,39,20,4,46,22,24,2,2,16,7,9
"2021","Stroud 008C","E01022368",590,147,91,56,418,107,228,95,91,42,49,29,18,2,33,15,18,1,1,25,7,18
"2021","Stroud 008D","E01022369",739,242,81,161,483,37,237,85,111,41,114,71,40,3,95,67,28,0,0,14,6,8
"2021","Stroud 009A","E01022370",550,138,80,58,376,79,208,97,86,25,55,34,18,3,33,17,16,1,1,36,15,21
"2021","Stroud 009B","E01022371",452,73,50,23,362,97,194,80,79,35,40,27,10,3,30,21,9,1,1,17,6,11
"2021","Stroud 009C","E01022405",875,227,125,102,609,112,293,89,146,58,103,44,49,10,99,56,43,2,2,39,14,25
"2021","Stroud 009D","E01022406",565,159,85,74,387,105,194,83,76,35,57,42,11,4,31,22,9,0,0,19,10,9
"2021","Stroud 009E","E01022407",579,149,87,62,400,97,200,97,64,39,61,32,24,5,40,17,23,2,2,30,10,20
"2021","Stroud 010A","E01022350",939,246,163,83,661,203,325,119,155,51,72,38,29,5,59,29,30,2,2,32,10,22
"2021","Stroud 010B","E01022382",683,167,111,56,491,180,240,101,111,28,50,26,21,3,20,10,10,1,1,25,6,19
"2021","Stroud 010C","E01022383",660,219,142,77,411,89,186,55,88,43,62,22,37,3,69,34,35,5,5,30,10,20
"2021","Stroud 010D","E01022384",632,211,138,73,394,117,193,69,79,45,49,36,13,0,34,17,17,1,1,27,11,16
"2021","Stroud 011A","E01022359",671,174,114,60,481,103,245,86,101,58,77,44,27,6,53,30,23,3,3,16,7,9
"2021","Stroud 011B","E01022360",631,134,74,60,473,138,241,105,92,44,62,35,24,3,31,13,18,1,1,24,9,15
"2021","Stroud 011C","E01022361",583,226,127,99,344,69,165,77,65,23,63,32,23,8,44,29,15,3,3,13,8,5
"2021","Stroud 011D","E01022362",533,170,110,60,341,77,175,91,49,35,54,29,21,4,32,16,16,3,3,22,5,17
"2021","Stroud 011E","E01022363",899,254,115,139,614,110,294,113,138,43,130,76,46,8,80,46,34,0,0,31,11,20
"2021","Stroud 011F","E01022364",509,174,107,67,312,47,131,49,57,25,63,31,23,9,71,40,31,0,0,23,14,9
"2021","Stroud 012A","E01022351",687,188,97,91,466,59,239,90,99,50,96,49,40,7,67,41,26,5,5,33,10,23
"2021","Stroud 012B","E01022352",595,192,118,74,388,88,190,89,67,34,75,46,19,10,34,16,18,1,1,15,7,8
"2021","Stroud 012C","E01022353",729,224,106,118,484,77,222,88,99,35,119,67,46,6,63,37,26,3,3,21,6,15
"2021","Stroud 012D","E01022413",782,162,83,79,557,105,328,128,136,64,80,43,30,7,40,19,21,4,4,63,22,41
"2021","Stroud 013A","E01022385",671,169,81,88,452,97,240,81,117,42,57,33,23,1,58,27,31,0,0,50,18,32
"2021","Stroud 013B","E01022386",745,291,181,110,427,100,231,112,87,32,60,41,19,0,35,17,18,1,1,27,5,22
"2021","Stroud 013C","E01022387",715,266,114,152,420,60,216,94,90,32,72,48,20,4,70,42,28,2,2,29,9,20
"2021","Stroud 013D","E01022388",752,190,93,97,522,96,232,86,104,42,95,54,35,6,97,67,30,2,2,40,15,25
"2021","Stroud 014A","E01022372",1034,275,109,166,732,125,368,140,183,45,158,90,65,3,72,44,28,9,9,27,11,16
"2021","Stroud 014B","E01022373",750,229,102,127,495,72,261,109,99,53,93,51,34,8,66,47,19,3,3,26,7,19
"2021","Stroud 014C","E01022374",985,388,167,221,557,94,238,92,112,34,118,71,45,2,99,71,28,8,8,40,12,28
"2021","Stroud 014D","E01022375",484,108,39,69,352,13,157,40,90,27,81,28,47,6,99,71,28,2,2,24,11,13
"2021","Stroud 015A","E01022381",870,183,93,90,646,108,373,122,198,53,100,54,38,8,63,38,25,2,2,41,14,27
"2021","Stroud 015B","E01022415",618,151,86,65,433,123,234,74,102,58,44,21,19,4,29,11,18,3,3,34,12,22
"2021","Stroud 015C","E01022416",608,143,68,75,445,77,223,65,110,48,61,21,35,5,82,44,38,2,2,20,5,15
"2021","Stroud 015D","E01022417",790,236,138,98,534,111,281,103,132,46,83,41,39,3,57,28,29,2,2,20,10,10
"2021","Stroud 015E","E01022418",789,336,170,166,428,98,212,71,104,37,67,41,22,4,48,25,23,3,3,25,8,17
"2021","Tewkesbury 001B","E01022450",911,311,127,184,558,42,260,108,108,44,145,75,62,8,108,65,43,3,3,42,18,24
"2021","Tewkesbury 001C","E01022451",656,193,97,96,443,82,207,86,82,39,91,45,38,8,61,20,41,2,2,20,12,8
"2021","Tewkesbury 001D","E01022452",531,118,50,68,387,45,217,80,91,46,67,39,24,4,55,29,26,3,3,26,12,14
"2021","Tewkesbury 001E","E01022455",810,195,129,66,593,156,298,130,109,59,80,41,33,6,57,24,33,2,2,22,6,16
"2021","Tewkesbury 001F","E01032938",935,186,41,145,707,71,352,124,190,38,182,106,72,4,95,67,28,7,7,42,23,19
"2021","Tewkesbury 001G","E01032939",582,130,59,71,428,36,242,77,125,40,85,41,39,5,63,43,20,2,2,24,9,15
"2021","Tewkesbury 001H","E01032940",584,123,31,92,440,20,258,75,164,19,98,57,39,2,63,46,17,1,1,21,10,11
"2021","Tewkesbury 002A","E01022456",548,126,70,56,403,83,201,83,75,43,70,40,27,3,46,20,26,3,3,19,8,11
"2021","Tewkesbury 002B","E01022457",600,216,113,103,362,50,157,67,60,30,77,30,43,4,75,41,34,3,3,22,8,14
"2021","Tewkesbury 002C","E01022458",670,272,118,154,372,31,124,40,61,23,97,31,63,3,116,78,38,4,4,26,11,15
"2021","Tewkesbury 002D","E01022459",876,471,205,266,378,71,143,83,34,26,103,81,17,5,54,28,26,7,7,27,7,20
"2021","Tewkesbury 002E","E01022460",930,370,199,171,538,91,260,112,114,34,116,69,44,3,68,43,25,3,3,22,8,14
"2021","Tewkesbury 002F","E01022461",613,187,128,59,405,125,204,80,89,35,45,22,20,3,31,10,21,0,0,21,9,12
"2021","Tewkesbury 002G","E01022462",856,206,133,73,597,179,297,143,113,41,77,50,25,2,40,18,22,4,4,53,18,35
"2021","Tewkesbury 003A","E01022449",918,220,123,97,666,169,371,180,121,70,78,55,21,2,47,27,20,1,1,32,9,23
"2021","Tewkesbury 003B","E01022463",709,262,139,123,430,116,205,110,62,33,57,31,22,4,52,25,27,0,0,17,6,11
"2021","Tewkesbury 003C","E01022464",752,278,196,82,452,129,175,69,74,32,71,29,34,8,77,48,29,0,0,22,11,11
"2021","Tewkesbury 003D","E01022465",760,164,92,72,573,148,313,139,127,47,66,37,27,2,46,30,16,0,0,23,7,16
"2021","Tewkesbury 003E","E01022466",986,263,148,115,699,175,355,126,171,58,90,48,38,4,78,57,21,1,1,24,12,12
"2021","Tewkesbury 004A","E01022434",864,180,114,66,649,180,373,146,171,56,63,35,23,5,30,18,12,3,3,35,20,15
"2021","Tewkesbury 004B","E01022441",680,194,75,119,437,105,224,99,88,37,66,50,15,1,41,23,18,1,1,49,17,32
"2021","Tewkesbury 004C","E01022445",599,132,79,53,429,90,222,109,80,33,83,44,32,7,33,18,15,1,1,38,16,22
"2021","Tewkesbury 004D","E01022453",960,197,109,88,718,161,400,136,210,54,99,53,42,4,57,38,19,1,1,45,17,28
"2021","Tewkesbury 006A","E01022440",1050,331,116,215,685,100,326,127,162,37,160,101,54,5,97,63,34,2,2,34,14,20
"2021","Tewkesbury 006B","E01022442",685,136,70,66,493,101,278,124,96,58,88,58,25,5,22,12,10,4,4,56,23,33
"2021","Tewkesbury 006C","E01022443",637,144,79,65,470,135,239,88,118,33,56,30,22,4,39,21,18,1,1,23,6,17
"2021","Tewkesbury 006D","E01022444",637,118,67,51,475,131,241,85,107,49,60,32,27,1,41,26,15,2,2,44,17,27
"2021","Tewkesbury 007A","E01022425",494,118,70,48,354,56,197,62,104,31,50,23,23,4,50,33,17,1,1,22,7,15
"2021","Tewkesbury 007B","E01022426",638,181,137,44,436,159,219,70,102,47,27,13,11,3,31,12,19,0,0,21,5,16
"2021","Tewkesbury 007C","E01022427",659,259,153,106,382,76,209,77,90,42,50,30,18,2,44,24,20,3,3,18,6,12
"2021","Tewkesbury 007D","E01022428",836,310,119,191,500,51,219,65,118,36,101,55,39,7,127,82,45,2,2,26,8,18
"2021","Tewkesbury 007E","E01022429",683,206,102,104,447,79,242,74,108,60,61,36,20,5,64,38,26,1,1,30,14,16
"2021","Tewkesbury 007F","E01022430",628,163,107,56,448,99,230,79,108,43,60,38,18,4,58,32,26,1,1,17,6,11
"2021","Tewkesbury 007G","E01022431",886,288,98,190,577,86,315,136,132,47,114,76,35,3,61,39,22,1,1,21,9,12
"2021","Tewkesbury 007H","E01022447",493,82,20,62,383,9,284,90,180,14,47,22,24,1,43,27,16,0,0,28,16,12
"2021","Tewkesbury 008B","E01022448",899,190,103,87,663,84,313,116,160,37,167,101,60,6,97,60,37,2,2,46,26,20
"2021","Tewkesbury 008C","E01022454",1095,310,176,134,750,123,360,110,183,67,133,60,64,9,131,87,44,3,3,35,18,17
"2021","Tewkesbury 008D","E01034805",800,240,126,114,526,112,244,98,109,37,95,54,36,5,71,43,28,4,4,34,9,25
"2021","Tewkesbury 008E","E01034806",465,116,76,40,327,58,195,75,82,38,36,23,12,1,37,19,18,1,1,22,7,15
"2021","Tewkesbury 009A","E01022421",734,232,96,136,470,68,224,86,101,37,92,41,45,6,81,56,25,5,5,32,10,22
"2021","Tewkesbury 009C","E01022423",948,231,119,112,662,107,321,133,125,63,125,78,41,6,104,54,50,5,5,55,27,28
"2021","Tewkesbury 009D","E01022424",658,184,99,85,438,61,183,67,76,40,79,34,31,14,112,61,51,3,3,36,17,19
"2021","Tewkesbury 009F","E01034807",684,233,109,124,406,77,197,75,91,31,75,46,21,8,54,36,18,3,3,45,12,33
"2021","Tewkesbury 009G","E01034808",688,152,22,130,495,13,227,74,132,21,148,96,49,3,105,84,21,2,2,41,14,27
"2021","Tewkesbury 009H","E01034809",506,83,8,75,398,2,180,54,116,10,148,96,51,1,65,46,19,3,3,25,10,15
"2021","Tewkesbury 009I","E01034810",850,190,71,119,621,86,330,118,171,41,119,66,47,6,81,55,26,5,5,39,15,24
"2021","Tewkesbury 010D","E01022437",598,175,79,96,398,63,228,78,121,29,56,26,25,5,49,36,13,2,2,25,11,14
"2021","Tewkesbury 010E","E01022438",604,208,76,132,381,60,202,76,92,34,84,55,25,4,35,20,15,0,0,15,7,8
"2021","Tewkesbury 010C","E01022439",1140,320,104,216,788,55,378,110,214,54,224,150,71,3,128,98,30,3,3,32,13,19
"2021","Tewkesbury 010A","E01034811",649,169,74,95,467,45,236,51,162,23,92,55,34,3,92,67,25,2,2,13,8,5
"2021","Tewkesbury 010B","E01034812",448,82,11,71,354,23,165,30,122,13,94,49,44,1,69,59,10,3,3,12,7,5
"2021","Tewkesbury 011E","E01022432",924,332,184,148,574,132,275,95,123,57,97,53,40,4,66,37,29,4,4,18,8,10
"2021","Tewkesbury 011C","E01022433",867,217,142,75,622,184,318,129,143,46,51,26,24,1,68,47,21,1,1,28,14,14
"2021","Tewkesbury 011A","E01034813",512,143,66,77,358,48,152,51,74,27,79,38,37,4,78,47,31,1,1,11,6,5
"2021","Tewkesbury 011B","E01034814",614,233,167,66,366,115,165,64,61,40,50,33,13,4,36,19,17,0,0,15,7,8
"2021","Tewkesbury 011D","E01034815",603,168,116,52,412,56,194,72,83,39,71,18,45,8,87,53,34,4,4,23,10,13
"2021","Mendip 001A","E01029022",646,184,105,79,430,96,225,96,97,32,63,39,20,4,45,30,15,1,1,32,11,21
"2021","Mendip 001B","E01029023",565,142,81,61,406,93,220,98,90,32,47,23,22,2,45,28,17,1,1,17,7,10
"2021","Mendip 001C","E01029044",599,181,72,109,394,44,180,65,86,29,90,45,37,8,77,58,19,3,3,24,5,19
"2021","Mendip 001D","E01029053",978,241,141,100,665,162,338,134,140,64,101,50,46,5,63,20,43,1,1,72,30,42
"2021","Mendip 001E","E01029057",946,192,101,91,704,176,352,161,139,52,111,65,40,6,63,35,28,2,2,50,24,26
"2021","Mendip 002A","E01029024",934,220,119,101,685,137,361,122,155,84,108,45,57,6,75,45,30,4,4,29,13,16
"2021","Mendip 002B","E01029025",576,163,76,87,388,71,180,67,78,35,71,27,38,6,61,42,19,5,5,25,13,12
"2021","Mendip 002D","E01029068",506,130,75,55,358,61,198,61,95,42,45,23,17,5,49,23,26,5,5,18,7,11
"2021","Mendip 002F","E01035107",898,220,132,88,642,139,350,151,122,77,109,67,33,9,41,21,20,3,3,36,11,25
"2021","Mendip 003A","E01029030",787,172,86,86,598,133,313,128,123,62,93,50,36,7,57,33,24,2,2,17,3,14
"2021","Mendip 003B","E01029031",680,177,104,73,479,128,241,87,99,55,60,25,31,4,47,32,15,3,3,24,13,11
"2021","Mendip 003C","E01029032",504,145,117,28,345,144,142,65,53,24,33,18,11,4,26,10,16,0,0,14,5,9
"2021","Mendip 003D","E01029033",623,182,104,78,417,62,198,73,82,43,88,53,29,6,69,45,24,0,0,24,9,15
"2021","Mendip 003E","E01029034",588,176,88,88,396,85,168,62,83,23,86,48,33,5,54,40,14,3,3,16,3,13
"2021","Mendip 004A","E01029036",868,324,118,206,492,52,190,61,99,30,132,71,50,11,112,78,34,6,6,52,17,35
"2021","Mendip 004B","E01029041",983,436,175,261,499,64,209,59,122,28,107,57,44,6,112,85,27,7,7,48,12,36
"2021","Mendip 004C","E01029042",691,283,115,168,369,37,137,39,72,26,92,42,42,8,101,62,39,2,2,39,14,25
"2021","Mendip 004D","E01029043",705,185,75,110,484,54,222,76,121,25,114,60,49,5,90,62,28,4,4,36,21,15
"2021","Mendip 004E","E01029045",706,222,109,113,451,60,214,90,84,40,94,38,50,6,79,55,24,4,4,33,10,23
"2021","Mendip 005A","E01029052",873,239,139,100,587,164,281,113,112,56,79,30,48,1,59,35,24,4,4,47,19,28
"2021","Mendip 005B","E01029060",812,174,100,74,571,143,300,127,123,50,76,45,23,8,49,26,23,3,3,67,27,40
"2021","Mendip 005D","E01029083",554,203,156,47,341,117,167,72,68,27,24,13,11,0,31,15,16,2,2,10,4,6
"2021","Mendip 005E","E01035108",702,192,83,109,486,74,235,86,119,30,99,49,43,7,76,51,25,2,2,24,10,14
"2021","Mendip 005F","E01035109",573,146,80,66,387,82,199,78,84,37,68,43,19,6,38,20,18,0,0,40,19,21
"2021","Mendip 006A","E01029018",971,210,120,90,705,139,372,154,150,68,122,65,50,7,69,33,36,3,3,56,18,38
"2021","Mendip 006B","E01029056",967,268,128,140,655,136,361,151,146,64,99,59,37,3,56,28,28,3,3,44,20,24
"2021","Mendip 006C","E01029064",679,209,104,105,440,78,202,84,81,37,91,59,29,3,65,32,33,4,4,30,10,20
"2021","Mendip 006D","E01029084",663,201,133,68,432,103,190,71,87,32,64,32,24,8,73,44,29,2,2,30,14,16
"2021","Mendip 007A","E01029029",736,228,107,121,461,63,193,81,79,33,95,44,45,6,106,64,42,4,4,47,16,31
"2021","Mendip 007C","E01029037",630,219,89,130,384,41,186,62,102,22,92,56,35,1,63,37,26,2,2,27,11,16
"2021","Mendip 007D","E01029038",663,168,65,103,470,41,192,76,94,22,130,58,62,10,106,77,29,1,1,25,12,13
"2021","Mendip 007E","E01029039",642,181,123,58,436,103,215,75,93,47,70,25,39,6,45,26,19,3,3,25,2,23
"2021","Mendip 007F","E01029040",733,236,115,121,464,84,216,78,102,36,101,53,38,10,63,36,27,0,0,33,15,18
"2021","Mendip 007G","E01035110",563,174,59,115,360,22,177,57,108,12,102,51,49,2,57,44,13,2,2,29,18,11
"2021","Mendip 007H","E01035111",714,159,56,103,523,38,253,67,156,30,166,73,88,5,63,45,18,3,3,32,11,21
"2021","Mendip 008A","E01029078",995,476,294,182,475,127,192,84,81,27,82,54,25,3,72,36,36,2,2,44,13,31
"2021","Mendip 008B","E01029079",752,314,151,163,405,74,161,70,62,29,68,39,24,5,102,59,43,0,0,33,11,22
"2021","Mendip 008C","E01029080",788,252,137,115,507,96,254,105,95,54,86,49,34,3,69,45,24,2,2,29,10,19
"2021","Mendip 008D","E01029081",958,377,214,163,552,115,212,82,94,36,113,78,31,4,103,67,36,9,9,29,10,19
"2021","Mendip 008E","E01029082",655,225,142,83,413,134,185,82,71,32,58,39,18,1,35,21,14,1,1,17,2,15
"2021","Mendip 009A","E01029062",723,285,52,233,389,13,151,67,69,15,116,62,52,2,100,72,28,9,9,49,20,29
"2021","Mendip 009B","E01029063",1091,283,104,179,768,89,372,149,170,53,184,101,73,10,119,85,34,4,4,40,12,28
"2021","Mendip 009C","E01029065",664,184,88,96,457,63,247,90,100,57,101,61,38,2,45,24,21,1,1,23,8,15
"2021","Mendip 009D","E01029066",749,221,114,107,498,97,231,92,92,47,100,50,42,8,68,33,35,2,2,30,19,11
"2021","Mendip 009E","E01029067",741,225,131,94,486,69,204,66,94,44,116,49,62,5,92,60,32,5,5,30,10,20
"2021","Mendip 010A","E01029020",627,156,77,79,433,78,223,98,92,33,74,40,28,6,58,34,24,0,0,38,18,20
"2021","Mendip 010B","E01029021",516,109,59,50,387,83,209,87,82,40,60,27,27,6,34,15,19,1,1,20,8,12
"2021","Mendip 010C","E01029027",613,130,72,58,451,84,231,96,94,41,82,36,39,7,52,32,20,2,2,32,8,24
"2021","Mendip 010D","E01029028",562,220,110,110,322,70,152,68,41,43,65,34,26,5,30,21,9,5,5,20,5,15
"2021","Mendip 010E","E01029058",954,215,116,99,679,156,345,133,140,72,104,56,40,8,71,39,32,3,3,60,20,40
"2021","Mendip 011A","E01029046",804,484,157,327,273,27,93,60,25,8,74,51,22,1,78,46,32,1,1,47,11,36
"2021","Mendip 011D","E01029050",1189,354,166,188,768,131,331,139,137,55,158,81,65,12,143,91,52,5,5,67,22,45
"2021","Mendip 011E","E01029051",699,239,134,105,411,116,174,84,54,36,59,39,18,2,60,26,34,2,2,49,16,33
"2021","Mendip 011F","E01032627",1000,368,185,183,559,104,226,110,64,52,112,71,34,7,114,66,48,3,3,73,18,55
"2021","Mendip 012A","E01029047",611,201,82,119,389,59,164,68,62,34,84,45,35,4,74,40,34,8,8,21,5,16
"2021","Mendip 012B","E01029054",685,136,84,52,506,98,286,131,108,47,72,41,27,4,50,36,14,0,0,43,11,32
"2021","Mendip 012C","E01029055",512,105,55,50,385,88,202,80,91,31,42,16,23,3,51,26,25,2,2,22,11,11
"2021","Mendip 012D","E01029074",547,125,88,37,391,92,216,76,101,39,51,23,24,4,31,15,16,1,1,31,17,14
"2021","Mendip 012E","E01029076",923,196,121,75,676,149,346,128,152,66,106,48,47,11,73,36,37,2,2,51,25,26
"2021","Mendip 013A","E01029019",1100,245,135,110,798,176,427,164,166,97,116,68,43,5,79,55,24,0,0,57,17,40
"2021","Mendip 013B","E01029059",928,226,126,100,644,165,316,127,120,69,92,44,36,12,70,27,43,1,1,58,21,37
"2021","Mendip 013C","E01029077",850,182,90,92,592,137,316,142,122,52,94,45,41,8,41,16,25,4,4,76,29,47
"2021","Mendip 014A","E01029070",1119,400,143,257,656,62,310,103,164,43,166,97,60,9,114,84,30,4,4,63,21,42
"2021","Mendip 014B","E01029071",702,284,131,153,385,50,168,59,72,37,98,55,40,3,63,41,22,6,6,33,10,23
"2021","Mendip 014C","E01029072",766,296,156,140,442,48,182,74,73,35,88,58,27,3,119,71,48,5,5,28,11,17
"2021","Mendip 014D","E01029073",556,203,106,97,324,52,160,57,85,18,56,25,28,3,56,37,19,0,0,29,9,20
"2021","Mendip 014E","E01029075",641,251,142,109,370,94,156,57,64,35,64,28,29,7,51,31,20,5,5,20,8,12
"2021","Sedgemoor 001A","E01029085",883,308,147,161,548,98,279,102,134,43,84,49,31,4,85,53,32,2,2,27,8,19
"2021","Sedgemoor 001B","E01029126",677,190,109,81,461,98,234,88,97,49,73,32,36,5,53,32,21,3,3,26,5,21
"2021","Sedgemoor 001C","E01029127",828,384,208,176,423,109,157,55,75,27,80,47,28,5,72,47,25,5,5,21,3,18
"2021","Sedgemoor 001D","E01029128",770,162,104,58,570,143,323,127,132,64,57,29,24,4,44,27,17,3,3,38,15,23
"2021","Sedgemoor 001E","E01029129",903,196,114,82,659,130,344,105,171,68,105,53,47,5,80,48,32,0,0,48,23,25
"2021","Sedgemoor 002C","E01029089",915,171,111,60,679,138,389,144,160,85,84,40,35,9,67,35,32,1,1,65,23,42
"2021","Sedgemoor 002D","E01029113",730,206,154,52,499,176,227,116,69,42,65,36,24,5,27,17,10,4,4,25,6,19
"2021","Sedgemoor 002E","E01029115",730,216,147,69,494,139,243,122,81,40,58,31,25,2,53,30,23,1,1,20,5,15
"2021","Sedgemoor 002G","E01032633",1042,314,180,134,665,201,309,172,76,61,91,52,32,7,62,30,32,2,2,63,20,43
"2021","Sedgemoor 002H","E01035112",759,201,115,86,511,143,274,130,82,62,50,39,6,5,41,20,21,3,3,47,17,30
"2021","Sedgemoor 002I","E01035113",612,141,40,101,439,66,204,69,101,34,91,41,47,3,74,55,19,4,4,32,18,14
"2021","Sedgemoor 003A","E01029086",906,190,117,73,660,166,365,157,142,66,84,36,40,8,42,26,16,3,3,56,24,32
"2021","Sedgemoor 003B","E01029147",701,136,93,43,528,173,258,102,113,43,54,28,21,5,41,26,15,2,2,37,12,25
"2021","Sedgemoor 003C","E01029148",666,173,100,73,453,122,229,96,93,40,60,29,27,4,42,29,13,0,0,40,16,24
"2021","Sedgemoor 003D","E01029149",584,127,88,39,425,94,235,108,88,39,64,29,28,7,32,20,12,0,0,32,14,18
"2021","Sedgemoor 004A","E01029114",693,239,186,53,429,177,182,94,55,33,32,15,15,2,36,12,24,2,2,25,5,20
"2021","Sedgemoor 004B","E01029116",833,414,221,193,383,88,155,76,53,26,91,63,22,6,46,30,16,3,3,36,10,26
"2021","Sedgemoor 004C","E01029117",795,304,146,158,437,112,154,74,46,34,78,51,24,3,87,53,34,6,6,54,17,37
"2021","Sedgemoor 004D","E01029119",782,346,220,126,403,93,175,82,59,34,76,33,36,7,54,30,24,5,5,33,9,24
"2021","Sedgemoor 004E","E01029120",659,192,117,75,444,91,187,86,61,40,86,43,41,2,77,41,36,3,3,23,15,8
"2021","Sedgemoor 005A","E01029118",716,158,106,52,524,123,258,108,98,52,81,30,42,9,60,30,30,2,2,34,13,21
"2021","Sedgemoor 005B","E01029131",1058,413,111,302,590,45,215,79,97,39,159,86,63,10,166,119,47,5,5,55,25,30
"2021","Sedgemoor 005C","E01029132",654,201,88,113,420,41,143,43,66,34,89,26,53,10,143,93,50,4,4,33,14,19
"2021","Sedgemoor 005D","E01029133",583,182,115,67,383,114,184,83,60,41,42,22,16,4,42,18,24,1,1,18,6,12
"2021","Sedgemoor 005E","E01029134",939,268,163,105,623,149,238,115,76,47,102,51,43,8,124,94,30,10,10,48,19,29
"2021","Sedgemoor 006A","E01029135",746,204,123,81,504,132,260,136,80,44,63,34,25,4,45,17,28,4,4,38,14,24
"2021","Sedgemoor 006B","E01029136",907,223,132,91,612,128,307,122,117,68,109,57,47,5,62,38,24,6,6,72,34,38
"2021","Sedgemoor 006C","E01029145",984,244,151,93,704,139,357,154,141,62,136,74,52,10,70,36,34,2,2,36,16,20
"2021","Sedgemoor 006D","E01029152",1021,275,168,107,702,167,311,158,101,52,125,64,57,4,92,53,39,7,7,44,14,30
"2021","Sedgemoor 007A","E01029121",540,140,82,58,366,92,192,88,68,36,48,30,16,2,30,11,19,4,4,34,12,22
"2021","Sedgemoor 007B","E01029122",612,157,91,66,420,93,221,94,87,40,67,40,26,1,37,13,24,2,2,35,10,25
"2021","Sedgemoor 007C","E01029123",488,187,113,74,281,66,123,56,42,25,50,28,22,0,41,27,14,1,1,20,8,12
"2021","Sedgemoor 007D","E01029124",858,293,191,102,532,143,262,115,98,49,64,33,26,5,62,37,25,1,1,33,12,21
"2021","Sedgemoor 007E","E01029125",578,119,71,48,416,99,222,95,89,38,62,37,18,7,32,17,15,1,1,43,15,28
"2021","Sedgemoor 008A","E01029093",729,264,87,177,444,56,170,85,65,20,123,62,52,9,94,69,25,1,1,21,11,10
"2021","Sedgemoor 008B","E01029096",689,178,53,125,439,40,173,68,70,35,124,60,57,7,93,64,29,9,9,72,25,47
"2021","Sedgemoor 008C","E01029106",632,180,70,110,406,40,143,50,63,30,87,22,61,4,131,95,36,5,5,46,25,21
"2021","Sedgemoor 008D","E01029107",631,179,92,87,414,59,176,57,84,35,83,32,41,10,94,53,41,2,2,38,17,21
"2021","Sedgemoor 008E","E01029109",517,125,58,67,342,44,143,38,69,36,78,28,42,8,72,42,30,5,5,50,24,26
"2021","Sedgemoor 009A","E01029094",847,269,74,195,519,48,214,81,97,36,149,74,68,7,94,57,37,14,14,59,28,31
"2021","Sedgemoor 009B","E01029095",832,356,97,259,385,34,130,43,71,16,110,62,44,4,93,64,29,18,18,91,34,57
"2021","Sedgemoor 009C","E01029110",1048,411,136,275,574,52,216,92,78,46,149,97,40,12,145,102,43,12,12,63,23,40
"2021","Sedgemoor 009D","E01029111",975,249,91,158,649,40,283,90,148,45,165,67,87,11,145,92,53,16,16,77,28,49
"2021","Sedgemoor 009E","E01029112",1170,629,217,412,468,73,174,82,66,26,121,78,39,4,87,57,30,13,13,73,16,57
"2021","Sedgemoor 010B","E01029091",744,259,84,175,457,52,213,90,83,40,126,70,51,5,63,44,19,3,3,28,8,20
"2021","Sedgemoor 010C","E01029092",610,153,65,88,436,36,241,105,92,44,98,50,41,7,60,37,23,1,1,21,13,8
"2021","Sedgemoor 010D","E01029108",946,305,174,131,611,155,277,112,105,60,98,47,49,2,76,54,22,5,5,30,9,21
"2021","Sedgemoor 010E","E01035114",470,81,9,72,348,17,138,43,84,11,92,36,54,2,101,85,16,0,0,41,26,15
"2021","Sedgemoor 010F","E01035115",521,72,12,60,413,21,179,52,99,28,181,113,60,8,27,16,11,5,5,36,18,18
"2021","Sedgemoor 010G","E01035116",526,172,76,96,338,70,145,70,45,30,75,47,21,7,43,26,17,5,5,16,7,9
"2021","Sedgemoor 011A","E01029102",836,258,126,132,518,72,252,90,106,56,103,54,43,6,89,60,29,2,2,60,23,37
"2021","Sedgemoor 011B","E01029103",609,154,111,43,426,118,224,78,87,59,57,36,17,4,26,12,14,1,1,29,11,18
"2021","Sedgemoor 011C","E01029104",768,154,95,59,584,95,309,88,165,56,116,44,67,5,62,40,22,2,2,30,12,18
"2021","Sedgemoor 011E","E01032631",572,160,40,120,367,20,172,52,99,21,97,42,52,3,73,60,13,5,5,45,15,30
"2021","Sedgemoor 011F","E01032632",598,119,67,52,450,95,252,93,114,45,58,29,25,4,43,27,16,2,2,29,11,18
"2021","Sedgemoor 011G","E01032634",534,126,71,55,387,115,187,81,73,33,52,24,24,4,31,17,14,2,2,21,9,12
"2021","Sedgemoor 012A","E01029130",891,244,148,96,593,160,302,138,102,62,82,47,34,1,48,26,22,1,1,54,27,27
"2021","Sedgemoor 012B","E01029137",720,160,101,59,517,123,276,131,78,67,77,45,28,4,40,19,21,1,1,43,12,31
"2021","Sedgemoor 012C","E01029138",615,145,91,54,444,94,226,97,80,49,78,34,35,9,46,29,17,0,0,26,13,13
"2021","Sedgemoor 012D","E01029139",641,155,89,66,444,116,212,88,88,36,74,41,25,8,39,20,19,3,3,42,18,24
"2021","Sedgemoor 012E","E01029150",544,93,62,31,418,117,223,108,74,41,51,35,12,4,25,14,11,2,2,33,11,22
"2021","Sedgemoor 012F","E01029151",614,166,98,68,428,117,214,111,73,30,62,41,16,5,34,18,16,1,1,20,5,15
"2021","Sedgemoor 013A","E01029097",616,168,70,98,403,33,141,59,58,24,115,50,55,10,113,79,34,1,1,45,19,26
"2021","Sedgemoor 013B","E01029098",799,310,75,235,418,39,182,79,68,35,109,63,38,8,85,67,18,3,3,71,22,49
"2021","Sedgemoor 013C","E01029099",492,121,67,54,334,43,135,36,63,36,71,21,40,10,81,46,35,4,4,37,17,20
"2021","Sedgemoor 013D","E01029100",544,112,47,65,378,34,158,43,82,33,87,31,50,6,93,68,25,6,6,54,21,33
"2021","Sedgemoor 013E","E01029105",790,332,152,180,425,57,169,59,76,34,86,34,40,12,108,77,31,5,5,33,11,22
"2021","Sedgemoor 014A","E01029101",481,129,64,65,326,52,151,64,64,23,66,31,29,6,56,34,22,1,1,26,10,16
"2021","Sedgemoor 014C","E01029142",660,189,118,71,446,112,217,85,97,35,67,35,28,4,48,27,21,2,2,25,6,19
"2021","Sedgemoor 014D","E01029143",624,204,121,83,394,77,193,81,77,35,61,32,25,4,61,27,34,2,2,26,10,16
"2021","Sedgemoor 014E","E01029144",507,122,67,55,344,64,216,90,64,62,38,19,15,4,25,15,10,1,1,41,13,28
"2021","Sedgemoor 014H","E01035117",662,108,10,98,511,24,241,83,135,23,159,92,58,9,86,62,24,1,1,43,24,19
"2021","Sedgemoor 014I","E01035118",523,96,40,56,387,35,193,61,107,25,89,39,46,4,66,44,22,4,4,40,22,18
"2021","Sedgemoor 014J","E01035119",608,113,12,101,451,18,234,76,139,19,127,66,58,3,69,61,8,3,3,44,25,19
"2021","Sedgemoor 014K","E01035120",633,130,67,63,469,94,245,101,99,45,82,46,29,7,47,32,15,1,1,34,13,21
"2021","South Somerset 001A","E01029157",618,244,128,116,362,68,154,66,64,24,52,28,21,3,87,66,21,1,1,12,4,8
"2021","South Somerset 001B","E01029158",560,146,63,83,390,59,193,71,96,26,73,33,32,8,59,44,15,6,6,24,8,16
"2021","South Somerset 001C","E01029221",1033,265,160,105,716,171,409,177,164,68,78,37,34,7,56,29,27,2,2,52,22,30
"2021","South Somerset 002A","E01029166",1043,244,135,109,741,194,385,177,133,75,96,57,28,11,60,30,30,6,6,58,18,40
"2021","South Somerset 002B","E01029167",787,318,173,145,442,85,184,74,85,25,76,36,33,7,90,55,35,7,7,27,5,22
"2021","South Somerset 002C","E01029168",850,298,192,106,536,137,244,101,89,54,94,55,34,5,61,39,22,0,0,16,2,14
"2021","South Somerset 002D","E01029210",721,149,82,67,544,130,305,124,112,69,59,35,20,4,46,29,17,4,4,28,9,19
"2021","South Somerset 002E","E01029211",619,153,97,56,446,134,235,117,74,44,43,22,15,6,33,22,11,1,1,20,5,15
"2021","South Somerset 003A","E01029224",877,208,111,97,628,161,310,140,115,55,100,54,38,8,55,35,20,2,2,41,17,24
"2021","South Somerset 003B","E01029225",1092,310,199,111,748,169,342,144,147,51,131,63,61,7,105,70,35,1,1,34,15,19
"2021","South Somerset 003C","E01029226",843,361,223,138,452,120,168,72,62,34,81,42,33,6,82,49,33,1,1,30,13,17
"2021","South Somerset 004A","E01029200",742,291,128,163,410,76,168,75,62,31,96,52,41,3,68,41,27,2,2,41,18,23
"2021","South Somerset 004B","E01029201",811,274,136,138,506,123,236,106,89,41,80,44,36,0,66,39,27,1,1,31,13,18
"2021","South Somerset 004C","E01029222",708,143,78,65,526,130,279,128,97,54,73,37,27,9,43,21,22,1,1,39,17,22
"2021","South Somerset 004D","E01029223",531,124,73,51,381,127,190,82,70,38,37,22,12,3,26,10,16,1,1,26,8,18
"2021","South Somerset 005A","E01029155",809,196,131,65,579,167,311,161,97,53,56,40,13,3,44,14,30,1,1,34,17,17
"2021","South Somerset 005B","E01029227",941,241,128,113,660,112,321,127,143,51,127,60,59,8,97,69,28,3,3,40,21,19
"2021","South Somerset 005C","E01029228",920,238,118,120,643,110,325,127,154,44,114,58,50,6,93,57,36,1,1,39,15,24
"2021","South Somerset 005D","E01029229",1062,445,192,253,577,79,260,106,113,41,142,76,59,7,90,56,34,6,6,40,14,26
"2021","South Somerset 006A","E01029164",664,193,125,68,441,106,215,90,95,30,70,31,35,4,49,20,29,1,1,30,11,19
"2021","South Somerset 006B","E01029165",532,137,82,55,373,118,185,83,64,38,38,21,13,4,26,12,14,6,6,22,6,16
"2021","South Somerset 006C","E01029198",448,97,30,67,333,21,224,60,147,17,48,13,33,2,39,29,10,1,1,18,8,10
"2021","South Somerset 006D","E01029199",867,230,127,103,590,107,321,162,102,57,89,47,32,10,69,31,38,4,4,47,22,25
"2021","South Somerset 007A","E01029187",507,143,93,50,334,74,156,62,61,33,56,23,29,4,45,31,14,3,3,30,15,15
"2021","South Somerset 007B","E01029188",686,173,122,51,490,159,237,117,82,38,50,34,13,3,40,22,18,4,4,23,12,11
"2021","South Somerset 007C","E01029196",731,186,96,90,510,105,266,114,110,42,84,28,51,5,54,34,20,1,1,35,18,17
"2021","South Somerset 007D","E01029197",561,134,81,53,400,102,219,114,72,33,46,28,18,0,29,15,14,4,4,27,13,14
"2021","South Somerset 008A","E01029154",829,233,105,128,561,143,259,112,97,50,91,37,46,8,67,46,21,1,1,35,13,22
"2021","South Somerset 008B","E01029156",881,244,123,121,605,132,295,142,99,54,101,52,45,4,74,47,27,3,3,32,13,19
"2021","South Somerset 008C","E01029206",756,225,138,87,507,100,233,85,100,48,102,45,50,7,66,44,22,6,6,24,7,17
"2021","South Somerset 008D","E01029207",685,218,103,115,448,116,200,90,70,40,72,39,28,5,59,39,20,1,1,19,7,12
"2021","South Somerset 009A","E01029202",573,235,142,93,308,57,136,59,41,36,62,27,29,6,49,29,20,4,4,30,14,16
"2021","South Somerset 009B","E01029203",654,167,89,78,457,113,239,105,90,44,71,42,25,4,33,14,19,1,1,30,9,21
"2021","South Somerset 009C","E01029204",561,157,98,59,384,104,180,79,59,42,55,37,16,2,43,15,28,2,2,20,9,11
"2021","South Somerset 009D","E01029205",787,249,131,118,508,104,229,102,80,47,85,48,35,2,84,55,29,6,6,30,8,22
"2021","South Somerset 010A","E01029163",987,257,149,108,683,157,374,190,109,75,107,59,40,8,43,23,20,2,2,47,11,36
"2021","South Somerset 010B","E01029216",736,194,123,71,513,172,224,112,75,37,61,33,24,4,56,34,22,0,0,29,7,22
"2021","South Somerset 010C","E01029217",748,219,133,86,509,143,265,127,98,40,62,46,14,2,36,19,17,3,3,20,6,14
"2021","South Somerset 010D","E01029218",952,303,180,123,614,160,233,96,95,42,110,55,51,4,108,69,39,3,3,35,12,23
"2021","South Somerset 011A","E01029238",646,198,98,100,417,52,181,60,81,40,92,45,43,4,88,65,23,4,4,31,14,17
"2021","South Somerset 011B","E01029252",606,162,82,80,422,89,233,97,98,38,60,33,25,2,38,25,13,2,2,22,11,11
"2021","South Somerset 011D","E01029254",591,144,105,39,420,128,202,99,75,28,55,32,17,6,32,17,15,3,3,27,12,15
"2021","South Somerset 011E","E01035121",722,245,118,127,458,63,225,109,82,34,95,47,38,10,70,33,37,5,5,19,12,7
"2021","South Somerset 011F","E01035122",799,170,20,150,574,24,306,84,189,33,158,89,62,7,84,65,19,2,2,55,24,31
"2021","South Somerset 012B","E01029248",645,195,95,100,418,47,203,63,102,38,73,24,45,4,88,49,39,7,7,32,13,19
"2021","South Somerset 012C","E01029250",548,143,78,65,373,103,196,75,80,41,47,33,10,4,26,10,16,1,1,32,8,24
"2021","South Somerset 012D","E01029251",731,166,97,69,530,140,277,83,127,67,72,42,27,3,39,18,21,2,2,35,14,21
"2021","South Somerset 012E","E01035123",635,120,43,77,489,52,279,88,157,34,87,46,37,4,70,44,26,1,1,26,8,18
"2021","South Somerset 012F","E01035124",530,106,32,74,398,31,215,57,132,26,113,60,48,5,38,25,13,1,1,26,16,10
"2021","South Somerset 013A","E01029161",658,177,57,120,450,30,190,67,89,34,113,63,45,5,114,81,33,3,3,31,13,18
"2021","South Somerset 013B","E01029162",760,332,119,213,406,65,163,78,58,27,114,80,34,0,62,38,24,2,2,22,7,15
"2021","South Somerset 013C","E01029247",613,164,68,96,404,25,145,40,75,30,89,28,54,7,142,100,42,3,3,45,25,20
"2021","South Somerset 013D","E01029255",599,188,117,71,386,80,182,64,87,31,70,28,40,2,51,32,19,3,3,25,11,14
"2021","South Somerset 014A","E01029231",665,234,115,119,389,62,220,87,88,45,70,37,28,5,33,22,11,4,4,42,10,32
"2021","South Somerset 014B","E01029233",680,175,55,120,442,36,193,47,109,37,93,27,56,10,116,91,25,4,4,63,24,39
"2021","South Somerset 014C","E01029235",627,221,89,132,374,75,168,64,66,38,73,35,32,6,57,35,22,1,1,32,13,19
"2021","South Somerset 014D","E01029236",623,210,74,136,377,41,139,48,66,25,89,29,51,9,105,67,38,3,3,36,15,21
"2021","South Somerset 014E","E01029237",733,244,112,132,452,38,177,52,84,41,102,43,51,8,132,100,32,3,3,37,19,18
"2021","South Somerset 015A","E01029232",670,210,51,159,381,23,179,71,91,17,69,41,25,3,95,64,31,15,15,79,17,62
"2021","South Somerset 015C","E01029239",838,364,121,243,417,33,167,57,86,24,100,49,46,5,109,82,27,8,8,57,18,39
"2021","South Somerset 015D","E01029240",654,193,58,135,410,39,221,70,109,42,79,41,32,6,69,41,28,2,2,51,22,29
"2021","South Somerset 015E","E01035125",632,343,111,232,246,20,71,35,26,10,95,69,23,3,46,35,11,14,14,43,9,34
"2021","South Somerset 015F","E01035126",620,328,102,226,255,27,98,52,33,13,78,52,24,2,49,38,11,3,3,37,11,26
"2021","South Somerset 016A","E01029241",885,222,44,178,590,42,251,87,126,38,174,95,73,6,117,79,38,6,6,73,28,45
"2021","South Somerset 016B","E01029245",945,230,101,129,672,126,319,113,156,50,132,70,58,4,89,60,29,6,6,43,16,27
"2021","South Somerset 016C","E01029246",620,199,86,113,382,88,194,71,99,24,66,45,21,0,33,16,17,1,1,39,10,29
"2021","South Somerset 016D","E01029249",637,226,128,98,395,75,160,76,60,24,92,46,39,7,67,41,26,1,1,16,8,8
"2021","South Somerset 017A","E01029189",494,151,88,63,331,71,177,74,68,35,42,18,22,2,39,18,21,2,2,12,3,9
"2021","South Somerset 017B","E01029190",649,184,112,72,432,136,191,98,69,24,70,38,25,7,34,16,18,1,1,33,22,11
"2021","South Somerset 017C","E01029191",584,173,105,68,399,101,186,69,77,40,56,29,22,5,55,34,21,1,1,12,3,9
"2021","South Somerset 017D","E01029192",618,184,106,78,412,82,206,88,81,37,73,41,29,3,49,33,16,2,2,22,5,17
"2021","South Somerset 017E","E01029212",513,135,77,58,364,90,200,108,63,29,46,29,14,3,28,16,12,0,0,14,4,10
"2021","South Somerset 017F","E01029213",568,147,102,45,394,105,192,89,65,38,63,37,24,2,33,20,13,1,1,27,5,22
"2021","South Somerset 017G","E01029214",492,99,53,46,374,108,192,82,75,35,43,22,12,9,31,20,11,0,0,19,8,11
"2021","South Somerset 017H","E01029215",524,173,99,74,337,65,158,73,61,24,55,28,25,2,59,37,22,0,0,14,5,9
"2021","South Somerset 018A","E01029159",836,216,56,160,589,70,305,110,149,46,155,91,59,5,57,44,13,2,2,31,13,18
"2021","South Somerset 018B","E01029242",657,198,83,115,445,77,204,92,71,41,99,53,44,2,57,38,19,8,8,14,5,9
"2021","South Somerset 018C","E01029243",772,286,192,94,455,145,224,104,73,47,56,32,21,3,27,15,12,3,3,31,9,22
"2021","South Somerset 018D","E01029244",642,158,98,60,460,130,233,96,91,46,59,25,30,4,35,17,18,3,3,24,8,16
"2021","South Somerset 019A","E01029193",955,394,194,200,524,104,216,97,88,31,110,53,51,6,91,67,24,3,3,37,8,29
"2021","South Somerset 019B","E01029194",1197,368,234,134,794,192,344,136,156,52,147,84,55,8,108,62,46,3,3,35,12,23
"2021","South Somerset 019C","E01029195",723,260,161,99,442,109,198,83,69,46,73,37,31,5,59,39,20,3,3,21,8,13
"2021","South Somerset 019D","E01029208",534,133,94,39,376,93,197,85,68,44,48,30,15,3,36,13,23,2,2,25,10,15
"2021","South Somerset 019E","E01029209",596,153,108,45,418,106,233,113,81,39,48,34,11,3,26,15,11,5,5,25,12,13
"2021","South Somerset 020A","E01029178",693,189,126,63,484,141,257,106,99,52,54,33,18,3,29,14,15,3,3,20,7,13
"2021","South Somerset 020B","E01029179",503,165,94,71,318,75,139,61,55,23,56,30,23,3,47,31,16,1,1,20,9,11
"2021","South Somerset 020C","E01029180",649,176,117,59,451,101,220,93,91,36,75,43,25,7,53,24,29,2,2,22,12,10
"2021","South Somerset 020D","E01029181",603,187,100,87,385,94,194,98,62,34,60,36,23,1,37,27,10,0,0,31,6,25
"2021","South Somerset 021A","E01029182",730,177,102,75,521,146,247,104,94,49,90,50,34,6,37,25,12,1,1,32,11,21
"2021","South Somerset 021B","E01029183",702,169,77,92,499,81,233,78,112,43,97,54,40,3,86,57,29,2,2,34,10,24
"2021","South Somerset 021C","E01029184",834,257,141,116,552,168,235,113,88,34,86,46,36,4,60,35,25,3,3,25,12,13
"2021","South Somerset 021D","E01029185",869,374,159,215,458,118,182,95,61,26,90,55,32,3,65,34,31,3,3,37,14,23
"2021","South Somerset 021E","E01029186",738,311,196,115,391,69,162,74,58,30,87,44,37,6,70,39,31,3,3,36,10,26
"2021","South Somerset 022A","E01029169",731,185,101,84,500,93,230,93,100,37,115,62,47,6,61,46,15,1,1,46,19,27
"2021","South Somerset 022B","E01029172",652,174,93,81,444,108,234,93,95,46,65,31,24,10,37,20,17,0,0,34,12,22
"2021","South Somerset 022C","E01029173",629,181,92,89,413,53,172,64,77,31,106,53,45,8,79,66,13,3,3,35,10,25
"2021","South Somerset 022D","E01029176",594,164,74,90,399,98,196,91,67,38,76,44,29,3,28,16,12,1,1,31,11,20
"2021","South Somerset 022E","E01029177",628,261,135,126,347,62,128,43,58,27,81,39,38,4,74,48,26,2,2,20,8,12
"2021","South Somerset 023A","E01029170",550,191,98,93,343,32,121,48,54,19,99,34,59,6,91,66,25,0,0,16,6,10
"2021","South Somerset 023B","E01029171",1087,395,211,184,630,131,265,107,107,51,119,64,45,10,105,71,34,10,10,62,28,34
"2021","South Somerset 023C","E01029174",494,167,111,56,302,89,127,60,41,26,59,27,26,6,27,12,15,0,0,25,8,17
"2021","South Somerset 023D","E01029175",999,338,153,185,615,95,235,83,118,34,144,66,73,5,130,94,36,11,11,46,10,36
"2021","South Somerset 024A","E01029153",1082,299,184,115,716,210,371,200,118,53,87,53,28,6,46,21,25,2,2,67,26,41
"2021","South Somerset 024B","E01029219",606,141,95,46,421,125,209,91,73,45,59,33,25,1,27,11,16,1,1,44,19,25
"2021","South Somerset 024C","E01029220",554,150,106,44,379,92,187,75,72,40,64,31,30,3,35,19,16,1,1,25,6,19
"2021","South Somerset 024D","E01029230",1033,246,148,98,734,231,358,182,105,71,88,41,43,4,54,25,29,3,3,53,22,31
"2021","Somerset West and Taunton 006A","E01029258",700,171,102,69,497,122,240,88,110,42,87,52,33,2,47,30,17,1,1,32,14,18
"2021","Somerset West and Taunton 006B","E01029259",638,193,120,73,414,106,188,75,76,37,74,35,34,5,46,24,22,0,0,31,16,15
"2021","Somerset West and Taunton 006C","E01029260",936,207,89,118,697,63,372,107,207,58,136,73,58,5,122,84,38,4,4,32,16,16
"2021","Somerset West and Taunton 006D","E01029268",687,157,77,80,494,128,270,108,107,55,56,33,17,6,40,14,26,0,0,36,10,26
"2021","Somerset West and Taunton 007A","E01029276",588,209,120,89,355,85,173,61,79,33,57,31,23,3,39,24,15,1,1,24,11,13
"2021","Somerset West and Taunton 007B","E01029278",620,153,80,73,430,93,217,91,89,37,61,36,19,6,54,33,21,5,5,37,17,20
"2021","Somerset West and Taunton 007C","E01029290",648,211,87,124,402,60,177,57,79,41,92,54,33,5,66,45,21,7,7,35,9,26
"2021","Somerset West and Taunton 007D","E01029306",627,188,127,61,405,97,196,90,75,31,66,40,16,10,43,24,19,3,3,34,16,18
"2021","Somerset West and Taunton 007E","E01029319",836,188,37,151,601,51,325,110,177,38,141,74,62,5,76,57,19,8,8,47,18,29
"2021","Somerset West and Taunton 013A","E01029267",755,220,122,98,497,116,248,109,90,49,70,40,24,6,60,35,25,3,3,38,15,23
"2021","Somerset West and Taunton 013B","E01029320",790,285,154,131,479,80,214,83,89,42,103,58,37,8,78,47,31,4,4,26,7,19
"2021","Somerset West and Taunton 013C","E01029321",987,228,143,85,703,174,370,158,148,64,89,55,27,7,67,28,39,3,3,56,13,43
"2021","Somerset West and Taunton 010A","E01029297",616,229,124,105,350,50,153,48,74,31,70,40,23,7,73,50,23,4,4,37,14,23
"2021","Somerset West and Taunton 010B","E01029298",614,194,92,102,397,53,191,65,81,45,66,22,37,7,86,55,31,1,1,23,12,11
"2021","Somerset West and Taunton 010C","E01029304",631,215,125,90,381,57,157,68,46,43,69,33,33,3,95,53,42,3,3,35,16,19
"2021","Somerset West and Taunton 010D","E01029305",604,180,103,77,403,68,184,89,61,34,77,38,34,5,69,40,29,5,5,21,9,12
"2021","Somerset West and Taunton 010E","E01029307",574,189,107,82,363,48,145,42,69,34,68,26,36,6,101,54,47,1,1,22,10,12
"2021","Somerset West and Taunton 009A","E01029271",828,239,141,98,552,158,280,110,127,43,66,39,20,7,46,27,19,2,2,37,17,20
"2021","Somerset West and Taunton 009B","E01029273",585,144,102,42,415,96,193,60,109,24,64,32,26,6,62,47,15,0,0,26,10,16
"2021","Somerset West and Taunton 009C","E01029274",790,179,115,64,574,157,283,113,112,58,69,37,26,6,63,39,24,2,2,37,12,25
"2021","Somerset West and Taunton 009D","E01029275",590,196,128,68,367,104,170,81,61,28,58,29,26,3,35,22,13,0,0,27,10,17
"2021","Somerset West and Taunton 009E","E01029279",663,167,99,68,452,100,242,113,87,42,67,33,27,7,42,24,18,1,1,44,20,24
"2021","Somerset West and Taunton 008A","E01029282",634,217,63,154,390,22,195,73,87,35,112,71,39,2,56,40,16,5,5,27,14,13
"2021","Somerset West and Taunton 008B","E01029291",770,323,120,203,410,73,158,76,48,34,96,44,45,7,74,43,31,9,9,37,9,28
"2021","Somerset West and Taunton 008C","E01029294",731,186,73,113,515,68,286,101,139,46,87,51,29,7,68,45,23,6,6,30,12,18
"2021","Somerset West and Taunton 008D","E01029317",794,201,90,111,558,73,281,100,147,34,127,79,42,6,77,56,21,0,0,35,14,21
"2021","Somerset West and Taunton 008E","E01035127",762,161,90,71,565,116,325,114,157,54,73,39,29,5,49,35,14,2,2,36,11,25
"2021","Somerset West and Taunton 008F","E01035128",828,185,27,158,614,38,280,62,197,21,180,80,96,4,113,93,20,3,3,29,11,18
"2021","Somerset West and Taunton 011A","E01029285",1181,440,106,334,644,53,260,91,145,24,201,129,64,8,106,75,31,24,24,97,20,77
"2021","Somerset West and Taunton 011B","E01029287",741,285,56,229,414,24,182,80,76,26,118,77,37,4,80,59,21,10,10,42,12,30
"2021","Somerset West and Taunton 011C","E01029288",667,243,108,135,386,47,183,58,95,30,92,50,36,6,61,39,22,3,3,38,9,29
"2021","Somerset West and Taunton 011D","E01029289",962,447,169,278,454,62,203,78,109,16,106,75,31,0,73,45,28,10,10,61,9,52
"2021","Somerset West and Taunton 011E","E01029299",793,356,149,207,394,62,162,66,69,27,95,61,32,2,71,43,28,4,4,43,8,35
"2021","Somerset West and Taunton 011F","E01029300",1082,376,105,271,641,76,255,114,110,31,185,117,64,4,105,82,23,20,20,65,15,50
"2021","Somerset West and Taunton 012A","E01029256",936,263,140,123,641,147,316,102,168,46,93,44,44,5,83,56,27,2,2,32,11,21
"2021","Somerset West and Taunton 012B","E01029257",896,236,127,109,600,98,306,116,142,48,80,28,40,12,111,67,44,5,5,60,33,27
"2021","Somerset West and Taunton 012C","E01029277",624,198,59,139,402,41,187,72,89,26,107,61,41,5,67,48,19,0,0,24,11,13
"2021","Somerset West and Taunton 012D","E01032651",756,211,74,137,501,71,225,101,95,29,131,91,33,7,70,45,25,4,4,44,13,31
"2021","Somerset West and Taunton 012E","E01032652",878,216,80,136,630,60,342,116,190,36,148,78,62,8,76,53,23,4,4,32,14,18
"2021","Somerset West and Taunton 014A","E01029280",753,255,91,164,453,71,189,64,102,23,71,27,35,9,114,78,36,8,8,45,16,29
"2021","Somerset West and Taunton 014B","E01029281",774,281,138,143,459,64,203,84,79,40,91,44,39,8,96,52,44,5,5,34,13,21
"2021","Somerset West and Taunton 014C","E01029283",789,235,117,118,515,84,223,93,88,42,89,46,33,10,117,69,48,2,2,39,13,26
"2021","Somerset West and Taunton 014D","E01029292",665,257,91,166,373,31,141,44,67,30,89,42,42,5,107,66,41,5,5,35,19,16
"2021","Somerset West and Taunton 014E","E01029293",631,147,48,99,442,18,156,31,100,25,89,21,62,6,176,138,38,3,3,42,20,22
"2021","Somerset West and Taunton 015A","E01029266",587,254,159,95,311,84,137,48,65,24,42,27,14,1,45,30,15,3,3,22,8,14
"2021","Somerset West and Taunton 015B","E01029284",1091,680,256,424,354,66,129,66,48,15,92,66,22,4,55,38,17,12,12,57,9,48
"2021","Somerset West and Taunton 015C","E01029286",796,318,91,227,428,33,180,57,103,20,113,84,29,0,95,63,32,7,7,50,13,37
"2021","Somerset West and Taunton 015D","E01029301",1161,626,347,279,492,128,220,104,90,26,73,56,15,2,68,50,18,3,3,43,12,31
"2021","Somerset West and Taunton 015E","E01029303",829,244,179,65,556,157,285,107,140,38,63,40,18,5,46,22,24,5,5,29,8,21
"2021","Somerset West and Taunton 016A","E01029263",585,163,89,74,400,63,213,63,119,31,66,34,29,3,56,36,20,2,2,22,11,11
"2021","Somerset West and Taunton 016B","E01029264",582,149,115,34,402,110,196,74,90,32,54,28,26,0,42,21,21,0,0,31,11,20
"2021","Somerset West and Taunton 016C","E01029265",607,170,104,66,424,124,218,81,90,47,48,22,20,6,33,15,18,1,1,13,5,8
"2021","Somerset West and Taunton 016D","E01029302",761,257,149,108,465,103,252,82,130,40,58,25,29,4,46,24,22,6,6,39,10,29
"2021","Somerset West and Taunton 016E","E01029308",880,229,164,65,614,175,328,108,176,44,53,26,25,2,54,33,21,4,4,37,15,22
"2021","Somerset West and Taunton 018A","E01029311",995,281,112,169,667,78,323,122,153,48,139,65,66,8,118,76,42,9,9,47,21,26
"2021","Somerset West and Taunton 018B","E01029312",601,207,133,74,371,53,204,75,90,39,50,24,22,4,63,32,31,1,1,23,10,13
"2021","Somerset West and Taunton 018C","E01029313",724,225,68,157,473,56,197,76,91,30,144,80,58,6,72,44,28,4,4,26,12,14
"2021","Somerset West and Taunton 018D","E01029316",890,391,245,146,456,95,200,91,66,43,85,55,24,6,71,44,27,5,5,43,13,30
"2021","Somerset West and Taunton 018E","E01035129",751,149,39,110,564,69,290,98,163,29,105,58,46,1,98,78,20,2,2,38,18,20
"2021","Somerset West and Taunton 018F","E01035130",657,302,156,146,317,44,133,65,47,21,68,31,30,7,71,51,20,1,1,38,11,27
"2021","Somerset West and Taunton 017A","E01029262",999,241,141,100,706,172,376,175,132,69,90,59,27,4,64,38,26,4,4,52,18,34
"2021","Somerset West and Taunton 017B","E01029269",866,205,116,89,606,144,327,147,109,71,94,61,32,1,38,14,24,3,3,55,16,39
"2021","Somerset West and Taunton 017C","E01029310",861,258,173,85,578,197,248,106,94,48,72,41,28,3,59,35,24,2,2,25,6,19
"2021","Somerset West and Taunton 017D","E01029315",664,210,162,48,442,146,210,87,82,41,44,22,15,7,39,12,27,3,3,12,6,6
"2021","Somerset West and Taunton 017E","E01035131",591,170,65,105,394,58,179,77,74,28,69,27,33,9,82,55,27,6,6,27,16,11
"2021","Somerset West and Taunton 017F","E01035132",653,193,104,89,438,83,231,109,83,39,65,32,30,3,59,33,26,0,0,22,13,9
"2021","Somerset West and Taunton 019A","E01029261",971,234,121,113,682,151,392,184,125,83,86,57,22,7,48,20,28,5,5,55,24,31
"2021","Somerset West and Taunton 019B","E01029270",970,249,146,103,673,177,368,168,124,76,83,54,27,2,44,18,26,1,1,48,21,27
"2021","Somerset West and Taunton 019C","E01029295",705,199,103,96,482,110,235,89,98,48,88,59,26,3,47,25,22,2,2,24,9,15
"2021","Somerset West and Taunton 019D","E01029296",819,208,122,86,575,124,299,120,131,48,89,51,33,5,57,30,27,6,6,36,8,28
"2021","Somerset West and Taunton 001A","E01029324",745,233,130,103,476,64,214,72,102,40,102,45,52,5,95,59,36,1,1,36,14,22
"2021","Somerset West and Taunton 001B","E01029329",785,331,193,138,398,97,173,68,59,46,79,45,30,4,44,28,16,5,5,56,16,40
"2021","Somerset West and Taunton 001C","E01029330",988,421,255,166,526,202,196,117,43,36,73,45,24,4,48,25,23,7,7,41,5,36
"2021","Somerset West and Taunton 001D","E01032636",979,377,220,157,559,148,232,105,95,32,101,54,41,6,74,45,29,4,4,43,16,27
"2021","Somerset West and Taunton 002A","E01029322",735,281,162,119,427,118,157,86,48,23,78,38,36,4,72,40,32,2,2,27,13,14
"2021","Somerset West and Taunton 002B","E01029331",728,234,170,64,481,204,174,104,46,24,56,33,20,3,47,23,24,0,0,13,4,9
"2021","Somerset West and Taunton 002C","E01029333",562,200,116,84,342,89,127,58,44,25,68,29,35,4,53,35,18,5,5,20,2,18
"2021","Somerset West and Taunton 002D","E01029336",990,290,194,96,662,227,291,173,76,42,87,60,20,7,54,26,28,3,3,38,8,30
"2021","Somerset West and Taunton 003A","E01029326",585,169,120,49,389,131,167,94,35,38,58,37,19,2,32,16,16,1,1,27,6,21
"2021","Somerset West and Taunton 003B","E01029334",562,208,119,89,327,119,137,76,40,21,45,20,17,8,25,14,11,1,1,27,11,16
"2021","Somerset West and Taunton 003C","E01029339",724,267,153,114,430,73,191,80,77,34,79,34,36,9,83,48,35,4,4,27,9,18
"2021","Somerset West and Taunton 003D","E01029341",690,308,174,134,362,109,142,75,43,24,55,27,21,7,54,25,29,2,2,20,6,14
"2021","Somerset West and Taunton 003E","E01032635",1027,282,176,106,705,163,299,147,101,51,119,52,56,11,117,71,46,7,7,40,13,27
"2021","Somerset West and Taunton 004A","E01029327",894,187,99,88,660,200,324,156,114,54,80,54,23,3,51,28,23,5,5,47,13,34
"2021","Somerset West and Taunton 004B","E01029335",516,147,86,61,341,87,167,100,44,23,57,42,12,3,29,13,16,1,1,28,8,20
"2021","Somerset West and Taunton 004C","E01029337",954,266,157,109,628,170,316,165,93,58,99,62,32,5,41,25,16,2,2,60,21,39
"2021","Somerset West and Taunton 004D","E01029342",528,163,122,41,347,128,170,90,52,28,29,20,7,2,20,7,13,0,0,18,5,13
"2021","Somerset West and Taunton 004E","E01029343",751,258,149,109,462,139,177,90,55,32,89,54,25,10,55,32,23,2,2,31,10,21
"2021","Somerset West and Taunton 005A","E01029325",953,312,183,129,599,186,272,140,78,54,83,52,22,9,53,27,26,5,5,42,16,26
"2021","Somerset West and Taunton 005B","E01029328",972,361,224,137,587,164,245,124,72,49,109,69,35,5,64,35,29,5,5,24,7,17
"2021","Somerset West and Taunton 005C","E01029338",783,230,125,105,509,122,277,158,71,48,74,50,21,3,34,10,24,2,2,44,15,29
"2021","Isle of Anglesey 001A","W01000003",1142,434,190,244,670,103,276,128,95,53,142,50,77,15,147,98,49,2,2,38,22,16
"2021","Isle of Anglesey 001B","W01000004",584,166,98,68,389,107,167,96,43,28,44,24,19,1,66,45,21,5,5,29,12,17
"2021","Isle of Anglesey 001C","W01000018",583,211,114,97,347,98,138,65,42,31,63,31,30,2,48,32,16,0,0,25,10,15
"2021","Isle of Anglesey 001D","W01000028",812,215,93,122,551,98,253,108,84,61,114,39,64,11,85,57,28,1,1,46,24,22
"2021","Isle of Anglesey 001E","W01000031",674,201,98,103,434,95,224,106,70,48,60,26,28,6,54,31,23,1,1,39,12,27
"2021","Isle of Anglesey 002A","W01000010",880,315,220,95,537,164,236,116,74,46,59,26,30,3,75,34,41,3,3,28,15,13
"2021","Isle of Anglesey 002C","W01000021",1013,277,151,126,695,148,361,172,111,78,91,53,32,6,90,51,39,5,5,41,12,29
"2021","Isle of Anglesey 002E","W01002005",1032,309,189,120,680,176,314,146,100,68,93,50,37,6,95,50,45,2,2,43,14,29
"2021","Isle of Anglesey 003A","W01000016",585,266,72,194,299,29,90,33,37,20,73,37,34,2,102,71,31,5,5,20,7,13
"2021","Isle of Anglesey 003B","W01000017",732,239,96,143,475,51,203,75,84,44,96,39,52,5,123,77,46,2,2,18,10,8
"2021","Isle of Anglesey 003C","W01000029",712,250,89,161,440,47,143,46,66,31,96,36,57,3,148,103,45,6,6,22,11,11
"2021","Isle of Anglesey 003D","W01000030",1059,406,179,227,610,69,213,78,84,51,118,44,63,11,202,145,57,8,8,43,15,28
"2021","Isle of Anglesey 003E","W01000033",722,283,122,161,415,64,127,50,44,33,73,25,44,4,146,87,59,5,5,24,9,15
"2021","Isle of Anglesey 003F","W01000036",514,205,74,131,286,20,102,40,34,28,69,26,37,6,89,64,25,6,6,23,15,8
"2021","Isle of Anglesey 003G","W01000037",498,170,83,87,312,57,123,38,52,33,64,29,30,5,67,50,17,1,1,16,8,8
"2021","Isle of Anglesey 004A","W01000022",677,192,108,84,440,95,203,91,66,46,76,34,39,3,63,26,37,3,3,45,21,24
"2021","Isle of Anglesey 004B","W01000034",636,196,99,97,432,71,195,73,83,39,76,32,40,4,90,58,32,0,0,8,2,6
"2021","Isle of Anglesey 004D","W01000040",494,148,92,56,329,103,164,83,41,40,27,22,5,0,34,13,21,1,1,17,6,11
"2021","Isle of Anglesey 004F","W01000044",512,150,93,57,353,104,164,79,59,26,45,25,18,2,38,17,21,2,2,9,7,2
"2021","Isle of Anglesey 004G","W01002007",994,327,180,147,625,158,275,131,90,54,91,30,54,7,99,53,46,2,2,42,17,25
"2021","Isle of Anglesey 005A","W01000005",818,311,178,133,485,150,169,97,44,28,70,34,33,3,93,61,32,3,3,22,8,14
"2021","Isle of Anglesey 005B","W01000013",959,289,175,114,639,150,332,126,138,68,81,48,32,1,73,46,27,3,3,31,14,17
"2021","Isle of Anglesey 005C","W01000019",647,227,147,80,394,149,178,89,45,44,38,24,13,1,28,13,15,1,1,26,6,20
"2021","Isle of Anglesey 005D","W01000026",576,189,106,83,370,92,162,90,47,25,65,27,33,5,49,23,26,2,2,17,8,9
"2021","Isle of Anglesey 005E","W01000035",795,256,127,129,504,123,233,94,86,53,90,40,42,8,57,33,24,1,1,35,19,16
"2021","Isle of Anglesey 006A","W01000006",654,187,110,77,441,84,225,85,82,58,81,33,43,5,50,18,32,1,1,26,9,17
"2021","Isle of Anglesey 006B","W01000012",776,301,183,118,456,100,212,71,94,47,79,40,35,4,61,42,19,4,4,19,14,5
"2021","Isle of Anglesey 006C","W01000014",968,327,155,172,608,76,282,94,139,49,138,59,69,10,108,65,43,4,4,33,11,22
"2021","Isle of Anglesey 006D","W01000041",635,195,93,102,418,34,132,37,62,33,86,20,60,6,162,115,47,4,4,22,11,11
"2021","Isle of Anglesey 007C","W01000009",781,234,108,126,500,91,215,76,83,56,105,43,57,5,84,51,33,5,5,47,20,27
"2021","Isle of Anglesey 007D","W01000023",632,188,77,111,412,66,200,67,72,61,72,25,43,4,72,44,28,2,2,32,21,11
"2021","Isle of Anglesey 007E","W01000024",507,128,40,88,352,23,166,60,89,17,83,37,42,4,79,55,24,1,1,27,11,16
"2021","Isle of Anglesey 007F","W01002008",970,337,205,132,591,125,281,128,91,62,96,48,39,9,84,36,48,5,5,42,16,26
"2021","Isle of Anglesey 008A","W01000008",640,221,114,107,406,96,203,59,99,45,53,27,24,2,53,21,32,1,1,13,6,7
"2021","Isle of Anglesey 008B","W01000011",568,290,137,153,252,59,112,56,34,22,40,31,8,1,39,15,24,2,2,26,4,22
"2021","Isle of Anglesey 008C","W01000015",648,195,124,71,435,121,194,73,78,43,65,35,28,2,52,28,24,3,3,18,7,11
"2021","Isle of Anglesey 008D","W01000042",908,316,153,163,561,82,265,93,120,52,114,57,52,5,98,50,48,2,2,31,9,22
"2021","Isle of Anglesey 009A","W01000007",756,219,126,93,503,115,260,106,98,56,62,34,22,6,58,32,26,8,8,34,13,21
"2021","Isle of Anglesey 009B","W01000025",925,268,142,126,617,77,311,114,126,71,114,57,50,7,110,63,47,5,5,40,22,18
"2021","Isle of Anglesey 009C","W01000027",781,234,128,106,513,83,238,95,93,50,100,34,56,10,82,51,31,10,10,34,18,16
"2021","Isle of Anglesey 009D","W01000038",1011,317,155,162,649,153,300,135,97,68,85,32,49,4,106,61,45,5,5,45,15,30
"2021","Gwynedd 001A","W01000062",556,255,63,192,160,5,49,23,21,5,70,53,15,2,23,16,7,13,13,141,6,135
"2021","Gwynedd 001B","W01000076",496,174,66,108,206,33,89,34,40,15,46,33,13,0,36,18,18,2,2,116,7,109
"2021","Gwynedd 001C","W01000077",539,203,75,128,231,20,67,20,38,9,68,50,15,3,66,43,23,10,10,105,4,101
"2021","Gwynedd 001D","W01000091",484,169,50,119,279,25,98,40,40,18,52,20,28,4,100,79,21,4,4,36,16,20
"2021","Gwynedd 001E","W01000092",616,185,58,127,168,35,64,25,29,10,47,42,5,0,13,6,7,9,9,263,16,247
"2021","Gwynedd 002A","W01000064",774,188,88,100,526,46,248,59,143,46,91,29,53,9,134,80,54,7,7,60,17,43
"2021","Gwynedd 002B","W01000072",695,201,95,106,441,69,230,80,100,50,64,29,33,2,75,42,33,3,3,53,11,42
"2021","Gwynedd 002C","W01000075",635,234,77,157,310,18,113,43,43,27,84,47,27,10,86,59,27,9,9,91,6,85
"2021","Gwynedd 002D","W01000090",520,126,61,65,363,26,120,36,48,36,73,21,45,7,141,100,41,3,3,31,15,16
"2021","Gwynedd 002E","W01000102",760,205,101,104,530,64,268,70,151,47,117,48,65,4,80,54,26,1,1,25,11,14
"2021","Gwynedd 003A","W01000050",604,185,93,92,383,74,177,67,67,43,70,40,26,4,61,39,22,1,1,36,18,18
"2021","Gwynedd 003B","W01000071",1002,361,137,224,594,50,252,98,104,50,165,82,78,5,122,69,53,5,5,47,21,26
"2021","Gwynedd 003C","W01000096",528,169,88,81,341,40,139,40,72,27,73,27,38,8,85,60,25,4,4,18,5,13
"2021","Gwynedd 003D","W01000097",538,220,72,148,291,37,112,39,50,23,66,38,27,1,73,51,22,3,3,27,10,17
"2021","Gwynedd 003E","W01000115",890,239,121,118,611,87,305,108,129,68,122,50,62,10,95,55,40,2,2,40,15,25
"2021","Gwynedd 004A","W01000052",466,131,66,65,330,62,142,46,67,29,63,21,34,8,63,43,20,0,0,5,2,3
"2021","Gwynedd 004B","W01000053",492,139,50,89,326,46,162,52,71,39,70,38,29,3,47,13,34,1,1,27,8,19
"2021","Gwynedd 004C","W01000087",757,210,118,92,513,86,230,82,111,37,100,40,56,4,94,62,32,3,3,34,17,17
"2021","Gwynedd 004D","W01000119",1047,365,143,222,633,88,265,96,116,53,176,99,68,9,101,63,38,3,3,49,13,36
"2021","Gwynedd 005A","W01000063",807,259,121,138,503,56,202,59,88,55,133,63,64,6,109,63,46,3,3,45,15,30
"2021","Gwynedd 005B","W01000081",881,305,132,173,525,56,215,74,78,63,128,67,57,4,124,76,48,2,2,51,14,37
"2021","Gwynedd 005C","W01000099",708,206,91,115,460,78,216,76,84,56,102,46,47,9,59,33,26,5,5,42,14,28
"2021","Gwynedd 005D","W01000103",521,174,68,106,318,48,152,58,60,34,54,27,22,5,61,26,35,3,3,29,9,20
"2021","Gwynedd 006A","W01000059",948,363,157,206,544,67,183,54,78,51,128,39,74,15,158,101,57,8,8,41,14,27
"2021","Gwynedd 006B","W01000093",1045,400,168,232,598,136,279,107,118,54,97,43,49,5,82,42,40,4,4,47,16,31
"2021","Gwynedd 006C","W01000098",1030,304,99,205,670,30,224,75,103,46,162,67,82,13,239,174,65,15,15,56,27,29
"2021","Gwynedd 006D","W01000110",650,154,73,81,471,83,198,72,81,45,98,35,57,6,92,63,29,0,0,25,10,15
"2021","Gwynedd 007A","W01000054",449,148,84,64,282,58,152,55,55,42,37,7,27,3,34,12,22,1,1,19,4,15
"2021","Gwynedd 007B","W01000088",822,193,106,87,594,90,298,103,133,62,115,51,56,8,90,58,32,1,1,35,18,17
"2021","Gwynedd 007C","W01000111",747,336,119,217,385,51,132,55,56,21,104,52,42,10,89,47,42,9,9,26,6,20
"2021","Gwynedd 007D","W01000118",712,214,114,100,452,77,229,75,104,50,79,41,34,4,66,34,32,1,1,46,24,22
"2021","Gwynedd 008A","W01000073",724,206,124,82,501,104,229,95,81,53,96,38,55,3,72,40,32,0,0,17,7,10
"2021","Gwynedd 008B","W01000086",920,275,148,127,595,96,266,119,89,58,127,57,64,6,99,66,33,7,7,50,24,26
"2021","Gwynedd 008C","W01000104",800,301,138,163,477,81,189,59,78,52,118,55,56,7,86,52,34,3,3,22,9,13
"2021","Gwynedd 008D","W01000112",841,260,118,142,551,84,229,97,87,45,121,60,56,5,107,67,40,10,10,30,16,14
"2021","Gwynedd 009A","W01000056",811,331,126,205,453,51,194,79,80,35,116,44,67,5,91,65,26,1,1,27,14,13
"2021","Gwynedd 009B","W01000065",533,252,104,148,271,48,110,52,38,20,54,18,31,5,59,37,22,0,0,10,7,3
"2021","Gwynedd 009C","W01000113",815,288,134,154,501,76,202,78,83,41,113,49,50,14,107,66,41,3,3,26,7,19
"2021","Gwynedd 009D","W01000114",642,229,120,109,390,67,172,63,60,49,72,35,35,2,75,38,37,4,4,23,7,16
"2021","Gwynedd 010A","W01000066",497,149,81,68,329,83,135,61,39,35,64,27,34,3,44,26,18,3,3,19,5,14
"2021","Gwynedd 010B","W01000100",478,162,84,78,294,60,135,59,50,26,57,26,30,1,40,17,23,2,2,22,10,12
"2021","Gwynedd 010C","W01000105",727,256,126,130,429,63,168,61,70,37,101,38,57,6,94,59,35,3,3,42,16,26
"2021","Gwynedd 010D","W01000106",795,344,227,117,424,128,176,97,38,41,70,48,18,4,45,24,21,5,5,27,6,21
"2021","Gwynedd 010E","W01000107",566,234,115,119,308,63,132,57,48,27,66,24,36,6,45,18,27,2,2,24,11,13
"2021","Gwynedd 011A","W01000047",567,193,109,84,354,75,173,65,67,41,57,23,28,6,46,25,21,3,3,20,13,7
"2021","Gwynedd 011B","W01000061",766,285,161,124,452,145,178,77,65,36,75,32,34,9,53,33,20,1,1,29,10,19
"2021","Gwynedd 011C","W01000078",685,234,106,128,424,65,201,81,67,53,92,45,42,5,63,33,30,3,3,27,17,10
"2021","Gwynedd 011D","W01000089",824,250,132,118,538,113,275,114,105,56,77,35,38,4,68,35,33,5,5,36,16,20
"2021","Gwynedd 012A","W01000070",540,143,75,68,373,73,212,76,75,61,50,21,25,4,35,15,20,3,3,24,8,16
"2021","Gwynedd 012B","W01000094",527,168,94,74,337,68,168,67,62,39,54,19,31,4,45,24,21,2,2,22,11,11
"2021","Gwynedd 012C","W01000095",562,193,101,92,353,68,144,61,55,28,75,35,39,1,65,32,33,1,1,16,9,7
"2021","Gwynedd 012D","W01000108",1030,441,182,259,551,92,204,66,80,58,134,63,63,8,111,61,50,10,10,38,15,23
"2021","Gwynedd 012E","W01000109",814,299,144,155,471,73,194,76,83,35,109,53,52,4,88,54,34,7,7,44,21,23
"2021","Gwynedd 013B","W01000074",898,341,170,171,534,154,218,127,50,41,82,43,38,1,77,45,32,3,3,23,7,16
"2021","Gwynedd 013D","W01000101",619,229,124,105,369,50,171,71,65,35,82,35,40,7,59,37,22,7,7,21,10,11
"2021","Gwynedd 013E","W01002003",1155,429,269,160,669,195,301,181,78,42,96,47,44,5,75,40,35,2,2,57,21,36
"2021","Gwynedd 014C","W01000080",705,292,162,130,384,91,172,86,52,34,64,26,34,4,52,27,25,5,5,29,11,18
"2021","Gwynedd 014D","W01000084",498,166,84,82,310,74,144,65,39,40,58,33,23,2,32,14,18,2,2,22,6,16
"2021","Gwynedd 014E","W01001932",1129,321,187,134,758,156,397,152,140,105,121,51,62,8,78,43,35,6,6,50,19,31
"2021","Gwynedd 015A","W01000051",943,378,193,185,527,86,226,78,92,56,103,50,46,7,104,57,47,8,8,38,20,18
"2021","Gwynedd 015B","W01000060",599,213,108,105,364,60,181,89,56,36,74,46,25,3,49,18,31,0,0,22,6,16
"2021","Gwynedd 015C","W01000082",449,126,71,55,302,51,162,77,54,31,51,25,23,3,35,21,14,3,3,21,7,14
"2021","Gwynedd 015D","W01000083",563,175,82,93,368,58,205,74,90,41,58,28,30,0,46,26,20,1,1,20,10,10
"2021","Gwynedd 016C","W01000057",632,206,107,99,407,115,195,95,63,37,64,32,25,7,31,16,15,2,2,19,9,10
"2021","Gwynedd 016D","W01000067",569,227,97,130,317,68,137,67,44,26,74,44,28,2,35,19,16,3,3,25,9,16
"2021","Gwynedd 016E","W01000068",665,242,119,123,405,68,169,83,56,30,76,34,36,6,89,60,29,3,3,18,3,15
"2021","Gwynedd 016F","W01002004",1013,408,194,214,565,105,233,109,78,46,101,48,47,6,119,85,34,7,7,40,13,27
"2021","Gwynedd 017C","W01000085",947,367,210,157,548,155,254,135,70,49,83,44,33,6,55,23,32,1,1,32,11,21
"2021","Gwynedd 017D","W01000116",866,377,241,136,463,146,205,122,54,29,62,40,21,1,47,25,22,3,3,26,14,12
"2021","Gwynedd 017E","W01000117",698,273,145,128,397,63,163,91,49,23,87,43,37,7,81,56,25,3,3,28,9,19
"2021","Gwynedd 017F","W01001933",969,380,201,179,561,140,267,151,63,53,93,54,35,4,58,28,30,3,3,28,9,19
"2021","Conwy 001A","W01000132",743,328,119,209,377,74,163,65,62,36,79,41,35,3,55,29,26,6,6,38,12,26
"2021","Conwy 001B","W01000146",1014,486,187,299,456,89,172,85,50,37,103,71,30,2,86,54,32,6,6,72,20,52
"2021","Conwy 001C","W01000147",770,343,217,126,403,135,174,95,53,26,39,17,19,3,54,34,20,1,1,24,8,16
"2021","Conwy 001D","W01000169",922,454,202,252,416,60,171,88,53,30,93,63,28,2,84,48,36,8,8,52,15,37
"2021","Conwy 001E","W01000186",786,356,179,177,386,70,139,53,53,33,52,28,20,4,120,72,48,5,5,44,16,28
"2021","Conwy 002A","W01000133",823,280,196,84,494,197,197,95,66,36,48,28,16,4,51,24,27,1,1,49,20,29
"2021","Conwy 002B","W01000168",753,219,117,102,483,70,188,67,81,40,85,36,38,11,132,81,51,8,8,51,20,31
"2021","Conwy 002C","W01000187",661,253,100,153,381,23,121,36,54,31,69,20,38,11,167,120,47,1,1,27,15,12
"2021","Conwy 002D","W01000188",748,243,158,85,490,105,229,114,70,45,70,30,28,12,82,41,41,4,4,15,9,6
"2021","Conwy 003A","W01000154",601,183,112,71,400,88,198,94,64,40,67,37,29,1,47,23,24,0,0,18,3,15
"2021","Conwy 003B","W01000173",646,212,103,109,410,66,181,74,80,27,73,45,24,4,86,63,23,4,4,24,13,11
"2021","Conwy 003C","W01000174",730,225,140,85,481,120,226,82,95,49,73,27,41,5,60,33,27,2,2,24,7,17
"2021","Conwy 003D","W01000175",764,244,186,58,499,219,206,97,65,44,36,24,10,2,36,13,23,2,2,21,3,18
"2021","Conwy 004A","W01000155",653,242,151,91,390,128,178,67,81,30,37,23,12,2,45,28,17,2,2,21,11,10
"2021","Conwy 004B","W01000156",833,415,293,122,388,131,153,71,54,28,53,36,16,1,48,20,28,3,3,30,10,20
"2021","Conwy 004C","W01000157",688,293,126,167,363,54,142,52,66,24,64,26,37,1,102,73,29,1,1,32,14,18
"2021","Conwy 004D","W01000158",777,285,196,89,482,158,223,111,63,49,49,27,22,0,52,23,29,0,0,10,5,5
"2021","Conwy 005A","W01000149",694,234,147,87,415,105,170,76,57,37,52,27,24,1,86,52,34,2,2,45,20,25
"2021","Conwy 005B","W01000150",637,158,96,62,447,110,220,96,75,49,62,30,29,3,54,26,28,1,1,32,17,15
"2021","Conwy 005C","W01000151",619,159,77,82,420,50,159,64,59,36,96,32,50,14,113,87,26,2,2,40,19,21
"2021","Conwy 005D","W01000152",609,187,91,96,385,67,167,79,56,32,78,25,41,12,70,39,31,3,3,37,16,21
"2021","Conwy 005E","W01000184",1060,349,185,164,661,168,257,136,66,55,113,52,49,12,123,74,49,0,0,50,18,32
"2021","Conwy 006A","W01000135",996,348,246,102,623,220,289,146,89,54,62,41,18,3,51,22,29,1,1,25,6,19
"2021","Conwy 006B","W01000136",845,332,192,140,480,112,204,101,68,35,76,35,38,3,88,54,34,0,0,33,10,23
"2021","Conwy 006C","W01000165",859,258,171,87,568,153,285,121,98,66,56,29,23,4,71,30,41,3,3,33,18,15
"2021","Conwy 006D","W01000166",1175,356,177,179,770,87,343,111,166,66,169,77,82,10,165,109,56,6,6,49,17,32
"2021","Conwy 007A","W01000139",670,193,106,87,451,72,241,78,101,62,73,31,37,5,60,40,20,5,5,26,10,16
"2021","Conwy 007B","W01000143",655,202,80,122,412,42,162,55,73,34,86,29,46,11,114,75,39,8,8,41,19,22
"2021","Conwy 007C","W01000144",817,374,75,299,395,24,95,35,46,14,83,40,36,7,181,134,47,12,12,48,20,28
"2021","Conwy 007D","W01000182",1002,504,220,284,441,114,141,64,53,24,83,55,26,2,98,61,37,5,5,57,21,36
"2021","Conwy 008A","W01000138",945,384,190,194,537,103,220,88,93,39,113,62,44,7,101,67,34,0,0,24,12,12
"2021","Conwy 008B","W01000145",570,196,87,109,360,43,163,64,73,26,70,25,39,6,81,51,30,3,3,14,9,5
"2021","Conwy 008C","W01000180",551,92,53,39,423,90,266,109,102,55,35,24,11,0,30,11,19,2,2,36,22,14
"2021","Conwy 008D","W01000181",609,136,46,90,451,63,226,95,86,45,100,41,54,5,60,38,22,2,2,22,10,12
"2021","Conwy 008E","W01000183",664,274,140,134,361,89,174,76,65,33,42,17,21,4,55,27,28,1,1,29,11,18
"2021","Conwy 009A","W01000126",731,224,95,129,468,73,243,91,110,42,69,27,39,3,82,56,26,1,1,39,15,24
"2021","Conwy 009B","W01000127",579,181,66,115,378,58,135,54,55,26,73,36,31,6,111,62,49,1,1,20,11,9
"2021","Conwy 009C","W01000128",649,233,130,103,377,70,168,46,88,34,67,31,34,2,65,38,27,7,7,39,21,18
"2021","Conwy 009D","W01000153",746,232,126,106,486,121,227,101,78,48,64,38,21,5,70,36,34,4,4,28,7,21
"2021","Conwy 009E","W01000163",522,114,49,65,377,35,123,50,48,25,68,25,39,4,148,104,44,3,3,31,15,16
"2021","Conwy 009F","W01000164",548,131,54,77,391,41,176,64,73,39,78,31,38,9,89,65,24,7,7,26,11,15
"2021","Conwy 010B","W01000140",786,240,109,131,514,77,214,90,73,51,102,51,44,7,117,76,41,4,4,32,11,21
"2021","Conwy 010C","W01000141",814,313,225,88,488,203,186,105,47,34,48,20,27,1,47,22,25,4,4,13,6,7
"2021","Conwy 010D","W01000142",730,237,171,66,470,156,227,111,68,48,50,22,19,9,36,15,21,1,1,23,5,18
"2021","Conwy 010E","W01000178",882,333,170,163,508,71,183,60,85,38,96,41,45,10,155,113,42,3,3,41,25,16
"2021","Conwy 010F","W01000179",921,298,191,107,592,175,236,104,92,40,112,59,49,4,66,36,30,3,3,31,14,17
"2021","Conwy 010G","W01001927",591,161,105,56,403,112,160,73,59,28,65,33,26,6,63,41,22,3,3,27,10,17
"2021","Conwy 010H","W01001928",639,330,124,206,298,79,95,63,12,20,60,37,20,3,63,39,24,1,1,11,4,7
"2021","Conwy 011C","W01000167",850,254,113,141,560,80,209,73,103,33,121,53,57,11,143,87,56,7,7,36,19,17
"2021","Conwy 011D","W01000176",712,238,91,147,444,43,164,50,78,36,120,50,64,6,111,74,37,6,6,30,9,21
"2021","Conwy 011E","W01000177",616,171,89,82,427,62,206,63,92,51,81,44,32,5,78,51,27,0,0,18,7,11
"2021","Conwy 011F","W01001926",1000,295,155,140,665,152,305,151,105,49,123,70,40,13,83,52,31,2,2,40,12,28
"2021","Conwy 012A","W01000124",880,247,128,119,591,157,281,126,90,65,81,48,27,6,66,38,28,6,6,42,20,22
"2021","Conwy 012B","W01000129",529,178,92,86,315,51,141,56,53,32,65,38,22,5,54,34,20,4,4,36,17,19
"2021","Conwy 012C","W01000130",743,311,166,145,410,100,184,96,49,39,72,43,22,7,49,32,17,5,5,22,11,11
"2021","Conwy 012D","W01000131",699,179,102,77,497,81,224,78,102,44,89,39,50,0,99,63,36,4,4,23,11,12
"2021","Conwy 013A","W01000123",828,344,162,182,452,66,204,75,78,51,77,42,31,4,104,77,27,1,1,32,15,17
"2021","Conwy 013B","W01000125",709,210,121,89,474,90,205,96,72,37,102,59,38,5,73,41,32,4,4,25,11,14
"2021","Conwy 013C","W01000170",818,258,131,127,539,114,244,99,95,50,94,43,41,10,85,50,35,2,2,21,11,10
"2021","Conwy 013D","W01000171",683,244,111,133,391,64,175,74,65,36,67,45,17,5,85,58,27,0,0,48,15,33
"2021","Conwy 013E","W01000172",635,264,95,169,354,31,134,69,40,25,82,42,36,4,103,75,28,4,4,17,8,9
"2021","Conwy 014A","W01000122",854,227,114,113,583,117,290,119,103,68,100,60,36,4,69,37,32,7,7,44,22,22
"2021","Conwy 014B","W01000159",580,129,61,68,424,93,218,92,74,52,72,35,35,2,38,20,18,3,3,27,12,15
"2021","Conwy 014C","W01000162",754,201,92,109,523,98,286,110,104,72,82,49,30,3,54,28,26,3,3,30,17,13
"2021","Conwy 014D","W01000190",608,180,101,79,401,78,229,93,91,45,54,29,21,4,38,18,20,2,2,27,18,9
"2021","Conwy 015A","W01000121",517,163,94,69,329,64,162,86,47,29,57,30,23,4,43,20,23,3,3,25,9,16
"2021","Conwy 015B","W01000134",949,362,208,154,558,104,196,73,86,37,131,56,61,14,124,69,55,3,3,29,11,18
"2021","Conwy 015C","W01000137",623,143,88,55,440,89,250,109,84,57,60,27,25,8,40,21,19,1,1,40,16,24
"2021","Conwy 015D","W01000148",451,126,61,65,310,42,147,43,59,45,65,23,35,7,56,37,19,0,0,15,8,7
"2021","Conwy 015E","W01000185",546,161,76,85,352,59,165,76,52,37,75,42,31,2,53,31,22,0,0,33,13,20
"2021","Conwy 015F","W01000189",637,193,90,103,415,71,228,90,84,54,79,50,28,1,34,13,21,3,3,29,10,19
"2021","Denbighshire 001A","W01000218",741,293,163,130,421,92,171,64,64,43,76,35,34,7,80,48,32,2,2,27,18,9
"2021","Denbighshire 001B","W01000219",1088,284,158,126,742,124,305,110,136,59,145,68,69,8,162,111,51,6,6,62,36,26
"2021","Denbighshire 001C","W01000220",887,350,232,118,513,180,193,127,23,43,65,30,27,8,74,37,37,1,1,24,5,19
"2021","Denbighshire 002A","W01000213",602,233,116,117,344,54,124,47,50,27,68,20,35,13,95,59,36,3,3,25,14,11
"2021","Denbighshire 002B","W01000214",523,182,108,74,312,54,124,46,47,31,51,23,23,5,80,50,30,3,3,29,12,17
"2021","Denbighshire 002C","W01000215",587,113,74,39,435,130,223,82,83,58,44,22,18,4,35,19,16,3,3,39,17,22
"2021","Denbighshire 002D","W01000216",581,213,90,123,331,40,134,53,52,29,67,29,30,8,90,46,44,0,0,37,17,20
"2021","Denbighshire 003A","W01000212",944,278,157,121,635,156,326,107,126,93,66,36,25,5,84,38,46,3,3,31,17,14
"2021","Denbighshire 003B","W01000221",688,284,149,135,385,75,122,56,34,32,78,36,38,4,107,74,33,3,3,19,8,11
"2021","Denbighshire 003C","W01000222",862,312,192,120,530,150,217,91,81,45,74,32,38,4,88,53,35,1,1,20,9,11
"2021","Denbighshire 004A","W01000226",742,277,160,117,424,98,158,80,48,30,61,29,28,4,104,58,46,3,3,41,19,22
"2021","Denbighshire 004B","W01000227",727,286,175,111,409,117,186,75,72,39,44,23,21,0,58,30,28,4,4,32,13,19
"2021","Denbighshire 004C","W01000228",614,271,90,181,305,61,113,40,53,20,58,28,27,3,64,33,31,9,9,38,14,24
"2021","Denbighshire 004D","W01000239",844,426,118,308,370,34,119,46,54,19,74,34,38,2,135,98,37,8,8,48,21,27
"2021","Denbighshire 004E","W01000240",826,491,106,385,290,12,71,18,39,14,86,43,41,2,118,85,33,3,3,45,22,23
"2021","Denbighshire 004F","W01000241",570,188,49,139,322,23,109,34,52,23,68,22,42,4,120,92,28,2,2,60,32,28
"2021","Denbighshire 006A","W01000236",816,279,120,159,477,32,146,32,80,34,95,27,52,16,197,140,57,7,7,60,36,24
"2021","Denbighshire 006B","W01000237",650,179,90,89,427,29,142,48,63,31,78,14,54,10,174,118,56,4,4,44,29,15
"2021","Denbighshire 006C","W01000238",699,182,74,108,486,49,219,70,93,56,92,34,48,10,124,90,34,2,2,31,14,17
"2021","Denbighshire 008A","W01000200",536,131,65,66,383,78,193,75,69,49,55,24,26,5,54,33,21,3,3,22,10,12
"2021","Denbighshire 008B","W01000201",727,210,98,112,490,62,198,79,88,31,101,47,50,4,125,80,45,4,4,27,18,9
"2021","Denbighshire 008C","W01000217",886,262,138,124,586,110,240,118,83,39,116,45,63,8,114,68,46,6,6,38,22,16
"2021","Denbighshire 008D","W01000248",699,184,103,81,479,104,250,99,104,47,76,45,24,7,46,25,21,3,3,36,20,16
"2021","Denbighshire 009A","W01000191",871,241,111,130,579,97,272,94,119,59,102,46,50,6,104,61,43,4,4,51,23,28
"2021","Denbighshire 009B","W01000223",591,172,100,72,393,92,192,89,60,43,44,23,17,4,63,40,23,2,2,26,10,16
"2021","Denbighshire 009C","W01000224",696,204,121,83,462,91,175,69,74,32,84,32,47,5,108,64,44,4,4,30,11,19
"2021","Denbighshire 009D","W01000225",709,280,123,157,407,87,156,65,52,39,82,46,31,5,80,44,36,2,2,22,6,16
"2021","Denbighshire 010A","W01000245",842,273,140,133,532,114,255,103,105,47,78,35,39,4,84,49,35,1,1,37,10,27
"2021","Denbighshire 010B","W01000246",728,248,122,126,437,82,175,76,60,39,87,42,39,6,89,59,30,4,4,43,19,24
"2021","Denbighshire 010C","W01000247",792,236,142,94,529,148,232,109,77,46,85,49,29,7,61,34,27,3,3,27,16,11
"2021","Denbighshire 011A","W01000194",920,406,115,291,475,60,178,68,70,40,97,60,33,4,133,84,49,7,7,39,11,28
"2021","Denbighshire 011B","W01000198",613,207,98,109,381,38,108,37,44,27,73,21,44,8,156,114,42,6,6,25,8,17
"2021","Denbighshire 011C","W01000199",716,218,103,115,457,65,192,71,71,50,88,40,37,11,109,65,44,3,3,41,26,15
"2021","Denbighshire 012A","W01000195",656,202,126,76,439,115,206,82,85,39,67,34,31,2,51,23,28,0,0,15,6,9
"2021","Denbighshire 012B","W01000196",557,133,56,77,400,45,195,54,97,44,82,34,46,2,74,45,29,4,4,24,4,20
"2021","Denbighshire 012C","W01000197",731,245,135,110,462,74,244,86,100,58,72,25,41,6,69,41,28,3,3,24,7,17
"2021","Denbighshire 012D","W01000211",761,210,104,106,520,107,280,125,100,55,71,44,25,2,54,29,25,8,8,31,20,11
"2021","Denbighshire 013A","W01000203",1051,258,153,105,751,164,423,206,135,82,87,49,33,5,73,41,32,4,4,42,13,29
"2021","Denbighshire 013B","W01000204",671,212,106,106,435,107,222,100,82,40,62,34,25,3,41,23,18,3,3,24,12,12
"2021","Denbighshire 013C","W01000206",889,231,121,110,618,117,325,121,131,73,103,50,42,11,69,40,29,4,4,40,21,19
"2021","Denbighshire 014A","W01000242",958,398,182,216,532,85,193,64,89,40,134,64,57,13,113,73,40,7,7,28,12,16
"2021","Denbighshire 014B","W01000243",935,368,161,207,548,99,228,74,106,48,112,54,50,8,109,83,26,0,0,19,8,11
"2021","Denbighshire 014C","W01000244",736,228,160,68,488,125,244,108,97,39,62,30,29,3,57,32,25,0,0,20,10,10
"2021","Denbighshire 015A","W01000193",562,190,89,101,360,54,142,58,47,37,80,40,33,7,81,48,33,3,3,12,4,8
"2021","Denbighshire 015B","W01000202",670,187,102,85,449,89,262,100,116,46,56,28,24,4,39,24,15,3,3,34,13,21
"2021","Denbighshire 015C","W01000207",975,261,146,115,665,143,329,135,142,52,122,70,45,7,66,46,20,5,5,49,22,27
"2021","Denbighshire 016A","W01000192",447,139,76,63,292,65,144,68,50,26,38,19,13,6,40,22,18,5,5,16,6,10
"2021","Denbighshire 016B","W01000205",544,162,82,80,367,88,168,78,62,28,62,32,27,3,46,30,16,3,3,15,5,10
"2021","Denbighshire 016C","W01000208",626,248,108,140,341,63,155,85,43,27,67,41,24,2,52,31,21,4,4,37,6,31
"2021","Denbighshire 016D","W01000209",662,244,144,100,403,72,172,73,67,32,75,43,28,4,84,50,34,0,0,15,7,8
"2021","Denbighshire 016E","W01000210",613,208,112,96,384,95,179,81,67,31,54,35,14,5,53,39,14,3,3,21,7,14
"2021","Denbighshire 017E","W01000229",772,291,149,142,444,149,152,84,42,26,71,30,35,6,71,44,27,1,1,37,17,20
"2021","Denbighshire 017F","W01000230",913,333,183,150,541,123,237,105,86,46,94,40,41,13,85,48,37,2,2,39,21,18
"2021","Denbighshire 017A","W01000231",618,228,123,105,372,43,177,70,62,45,74,34,31,9,77,50,27,1,1,18,9,9
"2021","Denbighshire 017B","W01000232",705,188,110,78,482,94,227,105,75,47,78,36,38,4,79,53,26,4,4,35,16,19
"2021","Denbighshire 017C","W01000233",585,180,104,76,380,76,152,60,58,34,70,32,32,6,79,41,38,3,3,25,11,14
"2021","Denbighshire 017G","W01000234",877,205,76,129,635,42,226,56,137,33,177,65,99,13,183,134,49,7,7,37,18,19
"2021","Denbighshire 017D","W01000235",577,170,79,91,385,60,197,70,81,46,61,32,24,5,65,48,17,2,2,22,6,16
"2021","Flintshire 001A","W01000287",874,311,170,141,531,95,214,98,56,60,113,57,47,9,102,59,43,7,7,32,11,21
"2021","Flintshire 001B","W01000298",678,199,118,81,442,94,193,105,55,33,76,45,25,6,73,41,32,6,6,37,18,19
"2021","Flintshire 001C","W01000338",779,227,124,103,523,91,285,128,97,60,87,39,40,8,60,31,29,0,0,29,10,19
"2021","Flintshire 002A","W01000306",993,288,127,161,667,107,313,111,133,69,126,48,71,7,119,71,48,2,2,38,22,16
"2021","Flintshire 002B","W01000320",789,224,117,107,533,63,257,109,79,69,90,43,40,7,120,71,49,3,3,32,14,18
"2021","Flintshire 002C","W01000340",968,245,139,106,691,140,383,173,139,71,104,46,51,7,57,24,33,7,7,32,9,23
"2021","Flintshire 003A","W01000253",783,225,129,96,513,65,246,100,71,75,102,38,55,9,95,45,50,5,5,45,22,23
"2021","Flintshire 003B","W01000254",929,305,142,163,581,70,271,102,97,72,106,46,50,10,130,91,39,4,4,43,14,29
"2021","Flintshire 003C","W01000296",648,219,100,119,403,45,155,54,62,39,87,27,48,12,111,79,32,5,5,26,19,7
"2021","Flintshire 003D","W01000297",515,133,42,91,359,28,155,61,67,27,94,39,47,8,77,64,13,5,5,23,9,14
"2021","Flintshire 003E","W01000304",959,418,158,260,507,51,184,59,78,47,91,43,41,7,172,115,57,9,9,34,15,19
"2021","Flintshire 003F","W01000305",808,235,109,126,543,88,224,76,96,52,94,32,54,8,134,97,37,3,3,30,13,17
"2021","Flintshire 004A","W01000288",998,363,174,189,574,65,191,73,79,39,94,38,47,9,206,116,90,18,18,61,28,33
"2021","Flintshire 004B","W01000290",710,411,242,169,267,43,98,49,32,17,55,25,26,4,63,37,26,8,8,32,18,14
"2021","Flintshire 004C","W01000292",542,124,57,67,381,31,147,46,71,30,78,23,43,12,118,72,46,7,7,37,21,16
"2021","Flintshire 004D","W01000293",1120,277,69,208,790,55,313,107,161,45,281,155,114,12,135,81,54,6,6,53,31,22
"2021","Flintshire 005A","W01000289",518,108,40,68,389,52,227,76,98,53,54,25,22,7,55,34,21,1,1,21,10,11
"2021","Flintshire 005B","W01000291",585,166,72,94,396,69,163,61,64,38,74,31,37,6,87,62,25,3,3,23,8,15
"2021","Flintshire 005C","W01000294",747,142,82,60,580,118,314,111,120,83,78,37,39,2,65,35,30,5,5,25,13,12
"2021","Flintshire 005D","W01000295",630,161,90,71,433,73,213,76,79,58,88,47,33,8,56,34,22,3,3,36,17,19
"2021","Flintshire 006A","W01000258",916,261,155,106,622,144,295,114,113,68,97,45,44,8,81,34,47,5,5,33,15,18
"2021","Flintshire 006B","W01000270",516,111,58,53,375,83,206,83,78,45,59,34,22,3,24,11,13,3,3,30,11,19
"2021","Flintshire 006C","W01000271",589,202,121,81,368,74,163,71,62,30,65,38,21,6,62,33,29,4,4,19,8,11
"2021","Flintshire 006D","W01000272",768,178,119,59,555,148,286,124,104,58,68,37,21,10,49,20,29,4,4,35,16,19
"2021","Flintshire 006E","W01000301",737,192,109,83,501,107,273,113,92,68,72,45,26,1,48,17,31,1,1,44,22,22
"2021","Flintshire 007A","W01000273",655,180,94,86,438,71,179,68,67,44,78,28,46,4,105,63,42,5,5,37,19,18
"2021","Flintshire 007B","W01000274",900,372,153,219,468,43,167,58,78,31,117,53,59,5,131,90,41,10,10,60,25,35
"2021","Flintshire 007C","W01000275",489,106,56,50,357,57,172,65,54,53,63,36,24,3,60,32,28,5,5,26,12,14
"2021","Flintshire 007D","W01000278",605,166,62,104,400,32,147,46,64,37,67,24,38,5,150,104,46,4,4,39,18,21
"2021","Flintshire 008A","W01000276",487,102,20,82,359,30,168,49,83,36,89,49,35,5,71,48,23,1,1,26,13,13
"2021","Flintshire 008B","W01000277",552,119,49,70,397,41,183,54,91,38,99,52,38,9,69,42,27,5,5,36,9,27
"2021","Flintshire 008C","W01000279",516,153,100,53,336,82,164,67,57,40,44,14,24,6,41,17,24,5,5,27,15,12
"2021","Flintshire 008D","W01000281",515,129,77,52,364,85,155,60,62,33,62,31,28,3,61,41,20,1,1,22,11,11
"2021","Flintshire 008E","W01000283",950,234,105,129,656,85,341,133,128,80,112,50,51,11,114,73,41,4,4,60,29,31
"2021","Flintshire 009A","W01000332",757,189,68,121,519,53,245,80,117,48,136,88,42,6,76,59,17,9,9,49,26,23
"2021","Flintshire 009B","W01000333",649,212,80,132,409,20,149,42,71,36,92,40,43,9,139,104,35,9,9,28,16,12
"2021","Flintshire 009C","W01000334",816,303,110,193,453,68,201,74,81,46,87,52,30,5,89,49,40,8,8,60,21,39
"2021","Flintshire 009D","W01000335",493,179,111,68,288,36,97,26,48,23,60,21,35,4,90,54,36,5,5,26,12,14
"2021","Flintshire 009E","W01000336",554,155,86,69,352,24,123,34,57,32,59,21,32,6,137,83,54,9,9,47,26,21
"2021","Flintshire 009F","W01000337",970,328,137,191,582,81,260,85,116,59,123,86,36,1,108,62,46,10,10,60,22,38
"2021","Flintshire 010A","W01000252",728,204,133,71,497,153,206,82,73,51,61,31,25,5,77,29,48,0,0,27,14,13
"2021","Flintshire 010B","W01000280",691,156,85,71,518,82,282,81,147,54,86,43,40,3,65,34,31,3,3,17,7,10
"2021","Flintshire 010C","W01000282",571,60,13,47,493,31,317,89,151,77,85,42,39,4,60,36,24,0,0,18,6,12
"2021","Flintshire 010D","W01000325",733,154,90,64,549,125,280,109,128,43,77,40,34,3,66,47,19,1,1,30,11,19
"2021","Flintshire 011A","W01000311",757,254,144,110,470,76,236,98,94,44,65,30,28,7,89,49,40,4,4,33,20,13
"2021","Flintshire 011B","W01000312",759,282,123,159,443,71,193,85,74,34,70,37,30,3,106,65,41,3,3,34,15,19
"2021","Flintshire 011C","W01000328",876,317,133,184,487,54,217,100,79,38,114,67,38,9,94,45,49,8,8,72,27,45
"2021","Flintshire 012A","W01000264",709,193,81,112,480,53,254,71,124,59,97,41,47,9,74,48,26,2,2,36,19,17
"2021","Flintshire 012B","W01000265",678,198,102,96,459,111,206,86,83,37,72,37,28,7,67,43,24,3,3,21,8,13
"2021","Flintshire 012C","W01000323",690,194,111,83,475,115,240,99,98,43,71,43,25,3,46,27,19,3,3,21,6,15
"2021","Flintshire 012D","W01000324",647,148,88,60,481,105,254,104,100,50,69,38,27,4,51,26,25,2,2,18,7,11
"2021","Flintshire 013A","W01000251",626,167,97,70,436,69,212,65,105,42,70,36,33,1,84,59,25,1,1,23,9,14
"2021","Flintshire 013B","W01000268",688,165,104,61,502,92,299,99,152,48,71,39,24,8,38,19,19,2,2,21,7,14
"2021","Flintshire 013C","W01000284",719,179,104,75,520,76,298,101,141,56,85,45,33,7,60,30,30,1,1,20,9,11
"2021","Flintshire 013D","W01000285",676,156,95,61,503,136,266,102,104,60,61,32,24,5,36,19,17,4,4,17,7,10
"2021","Flintshire 013E","W01000286",890,250,73,177,607,78,345,93,198,54,108,52,46,10,75,50,25,1,1,33,14,19
"2021","Flintshire 013F","W01000302",881,270,185,85,581,140,284,106,123,55,89,52,32,5,65,35,30,3,3,30,12,18
"2021","Flintshire 014A","W01000249",515,138,97,41,359,77,191,67,80,44,56,30,23,3,34,21,13,1,1,18,9,9
"2021","Flintshire 014B","W01000250",627,176,119,57,426,104,201,71,82,48,56,33,21,2,64,38,26,1,1,25,11,14
"2021","Flintshire 014C","W01000261",633,196,107,89,416,85,192,73,81,38,74,43,25,6,62,35,27,3,3,21,11,10
"2021","Flintshire 014D","W01000321",710,186,107,79,504,109,268,93,112,63,69,42,25,2,58,30,28,0,0,20,9,11
"2021","Flintshire 014E","W01000322",602,165,116,49,423,113,184,66,86,32,67,36,26,5,57,28,29,2,2,14,5,9
"2021","Flintshire 015A","W01000255",959,263,137,126,655,94,314,100,138,76,130,72,55,3,111,66,45,6,6,41,23,18
"2021","Flintshire 015B","W01000256",656,186,67,119,447,38,219,77,99,43,94,55,35,4,96,67,29,0,0,23,12,11
"2021","Flintshire 015C","W01000257",1173,297,146,151,836,122,435,157,199,79,178,101,72,5,96,63,33,5,5,40,12,28
"2021","Flintshire 015D","W01000329",720,209,65,144,473,29,172,67,76,29,136,83,50,3,132,84,48,4,4,38,15,23
"2021","Flintshire 015E","W01000330",907,280,106,174,589,49,234,90,103,41,156,82,60,14,139,86,53,11,11,38,15,23
"2021","Flintshire 015F","W01000331",618,159,84,75,438,57,227,92,77,58,81,44,32,5,68,37,31,5,5,21,7,14
"2021","Flintshire 016A","W01000313",689,190,91,99,477,74,215,71,100,44,84,40,40,4,102,66,36,2,2,22,6,16
"2021","Flintshire 016B","W01000314",605,289,131,158,301,62,120,46,48,26,43,29,11,3,72,39,33,4,4,15,4,11
"2021","Flintshire 016C","W01000315",902,311,168,143,564,99,226,82,89,55,105,47,51,7,130,86,44,4,4,27,12,15
"2021","Flintshire 016D","W01000316",503,131,85,46,364,75,188,68,75,45,60,34,25,1,40,24,16,1,1,8,4,4
"2021","Flintshire 016E","W01000317",652,130,62,68,505,97,300,117,138,45,69,32,34,3,37,24,13,2,2,17,8,9
"2021","Flintshire 016F","W01000318",503,180,99,81,300,37,99,31,42,26,58,13,39,6,102,65,37,4,4,23,11,12
"2021","Flintshire 016G","W01000319",715,295,120,175,394,66,156,63,64,29,82,42,36,4,83,58,25,7,7,26,8,18
"2021","Flintshire 017A","W01000259",780,310,127,183,444,82,179,70,71,38,81,46,29,6,99,72,27,3,3,26,11,15
"2021","Flintshire 017B","W01000260",761,213,122,91,523,101,254,93,102,59,93,43,48,2,70,33,37,5,5,25,13,12
"2021","Flintshire 017C","W01000262",631,199,57,142,415,48,150,58,54,38,93,41,43,9,119,78,41,5,5,17,12,5
"2021","Flintshire 017D","W01000263",606,228,96,132,356,37,142,51,60,31,69,39,27,3,103,63,40,5,5,22,8,14
"2021","Flintshire 017E","W01000266",770,285,119,166,455,66,204,75,99,30,115,61,51,3,66,39,27,4,4,30,20,10
"2021","Flintshire 017F","W01000267",871,218,104,114,635,105,311,98,163,50,143,74,60,9,71,43,28,5,5,18,7,11
"2021","Flintshire 018A","W01000303",736,171,96,75,540,117,293,115,127,51,81,34,45,2,49,32,17,0,0,25,12,13
"2021","Flintshire 018B","W01000326",901,205,95,110,675,103,364,122,196,46,127,57,62,8,73,49,24,8,8,21,11,10
"2021","Flintshire 018C","W01000327",1031,259,117,142,740,112,396,141,182,73,135,70,61,4,93,60,33,4,4,32,19,13
"2021","Flintshire 019A","W01000299",825,206,136,70,587,178,294,118,107,69,64,35,26,3,49,24,25,2,2,32,15,17
"2021","Flintshire 019B","W01000300",740,215,118,97,507,125,254,102,99,53,67,51,13,3,58,30,28,3,3,18,8,10
"2021","Flintshire 019C","W01000309",928,270,137,133,627,76,269,101,106,62,137,79,47,11,139,93,46,6,6,31,14,17
"2021","Flintshire 019D","W01000339",706,176,96,80,499,95,246,88,102,56,82,45,31,6,75,41,34,1,1,31,13,18
"2021","Flintshire 020A","W01000269",730,273,127,146,434,74,183,66,75,42,83,32,40,11,87,48,39,7,7,23,9,14
"2021","Flintshire 020B","W01000307",570,134,75,59,413,76,236,76,97,63,59,35,22,2,42,30,12,0,0,23,17,6
"2021","Flintshire 020C","W01000308",502,128,68,60,355,61,159,51,74,34,59,32,19,8,74,49,25,2,2,19,7,12
"2021","Flintshire 020D","W01000310",794,195,112,83,565,101,305,128,116,61,87,50,34,3,69,48,21,3,3,34,16,18
"2021","Wrexham 003A","W01000374",595,188,98,90,371,69,151,51,61,39,77,32,38,7,69,47,22,5,5,36,14,22
"2021","Wrexham 003B","W01000375",890,251,85,166,615,42,319,111,158,50,151,66,74,11,99,74,25,4,4,24,12,12
"2021","Wrexham 003C","W01000376",564,144,83,61,395,81,203,70,90,43,64,20,37,7,46,27,19,1,1,25,10,15
"2021","Wrexham 003D","W01000391",622,179,99,80,425,92,196,60,84,52,61,19,35,7,75,45,30,1,1,18,7,11
"2021","Wrexham 003E","W01000392",644,183,74,109,432,33,174,48,81,45,93,33,54,6,123,94,29,9,9,29,17,12
"2021","Wrexham 004A","W01000377",626,145,68,77,457,61,247,101,98,48,88,40,43,5,59,41,18,2,2,24,12,12
"2021","Wrexham 004B","W01000378",516,123,45,78,374,34,137,42,65,30,82,28,49,5,117,84,33,4,4,19,10,9
"2021","Wrexham 004C","W01000379",721,242,107,135,458,52,192,71,79,42,88,39,43,6,117,86,31,9,9,21,8,13
"2021","Wrexham 004D","W01000380",536,137,44,93,385,46,214,86,92,36,84,42,38,4,39,26,13,2,2,14,9,5
"2021","Wrexham 005A","W01000351",886,241,99,142,615,76,281,110,98,73,138,72,55,11,115,79,36,5,5,30,10,20
"2021","Wrexham 005B","W01000373",731,219,90,129,480,35,184,64,79,41,99,41,50,8,156,96,60,6,6,32,17,15
"2021","Wrexham 005C","W01000400",813,255,91,164,521,61,239,84,121,34,121,68,48,5,93,68,25,7,7,37,9,28
"2021","Wrexham 005D","W01000401",870,268,104,164,573,60,260,92,120,48,139,75,56,8,113,88,25,1,1,29,17,12
"2021","Wrexham 006A","W01000347",1170,327,74,253,799,52,382,120,205,57,217,115,93,9,142,104,38,6,6,44,11,33
"2021","Wrexham 006B","W01000348",609,202,82,120,379,37,136,34,75,27,89,32,49,8,115,80,35,2,2,28,14,14
"2021","Wrexham 006C","W01000362",597,150,77,73,425,39,168,58,73,37,88,27,56,5,129,91,38,1,1,22,8,14
"2021","Wrexham 006D","W01000363",675,223,127,96,428,70,182,73,71,38,101,62,35,4,72,36,36,3,3,24,11,13
"2021","Wrexham 006E","W01000364",649,204,91,113,420,82,220,81,77,62,64,45,17,2,51,27,24,3,3,25,10,15
"2021","Wrexham 008A","W01000368",918,296,195,101,601,149,293,126,114,53,105,43,51,11,52,31,21,2,2,21,12,9
"2021","Wrexham 008B","W01000371",500,196,89,107,273,24,126,58,48,20,66,35,27,4,51,34,17,6,6,31,11,20
"2021","Wrexham 008C","W01000372",712,369,145,224,288,28,99,55,24,20,78,46,29,3,79,49,30,4,4,55,11,44
"2021","Wrexham 008D","W01000387",495,119,82,37,362,103,166,61,60,45,53,27,25,1,39,22,17,1,1,14,2,12
"2021","Wrexham 008E","W01000388",474,121,65,56,337,72,158,47,73,38,50,20,25,5,55,34,21,2,2,16,7,9
"2021","Wrexham 008F","W01000422",973,324,173,151,603,123,243,92,98,53,120,57,56,7,114,63,51,3,3,46,15,31
"2021","Wrexham 010C","W01000413",514,134,40,94,347,7,67,22,33,12,72,18,50,4,192,158,34,9,9,33,23,10
"2021","Wrexham 010D","W01000414",523,175,61,114,322,16,100,29,45,26,80,28,46,6,122,92,30,4,4,26,16,10
"2021","Wrexham 010E","W01000425",804,228,83,145,518,28,161,43,74,44,93,21,58,14,226,161,65,10,10,58,31,27
"2021","Wrexham 010F","W01001969",929,307,127,180,566,65,225,67,103,55,120,42,71,7,145,89,56,11,11,56,30,26
"2021","Wrexham 011A","W01000349",1045,360,94,266,652,59,289,98,145,46,165,98,60,7,127,88,39,12,12,33,18,15
"2021","Wrexham 011B","W01000350",860,346,79,267,439,18,168,65,86,17,116,64,47,5,121,80,41,16,16,75,19,56
"2021","Wrexham 011C","W01000365",816,212,112,100,551,126,265,89,110,66,80,35,40,5,74,45,29,6,6,53,18,35
"2021","Wrexham 011D","W01000402",1147,399,112,287,650,52,250,95,101,54,191,122,64,5,132,81,51,25,25,98,35,63
"2021","Wrexham 012A","W01000381",497,203,97,106,263,42,117,40,46,31,53,33,17,3,40,29,11,11,11,31,17,14
"2021","Wrexham 012B","W01000382",678,301,74,227,346,23,127,39,62,26,76,37,33,6,114,84,30,6,6,31,15,16
"2021","Wrexham 012D","W01000423",880,218,60,158,613,35,245,68,127,50,142,66,70,6,184,144,40,7,7,49,28,21
"2021","Wrexham 012E","W01000424",598,219,85,134,347,48,163,61,68,34,64,32,29,3,68,43,25,4,4,32,16,16
"2021","Wrexham 012F","W01001929",588,224,54,170,311,22,108,49,39,20,91,54,35,2,82,51,31,8,8,53,19,34
"2021","Wrexham 012G","W01001931",691,291,97,194,342,29,117,43,53,21,72,43,24,5,109,86,23,15,15,58,19,39
"2021","Wrexham 013A","W01000398",545,173,93,80,353,71,170,75,58,37,59,33,23,3,50,24,26,3,3,19,9,10
"2021","Wrexham 013B","W01000399",473,113,44,69,340,77,183,82,72,29,49,27,18,4,31,21,10,0,0,20,9,11
"2021","Wrexham 013C","W01000406",862,223,105,118,587,75,250,88,102,60,122,44,69,9,137,99,38,3,3,52,28,24
"2021","Wrexham 013D","W01000408",505,129,69,60,346,54,155,60,57,38,62,30,24,8,73,53,20,2,2,30,13,17
"2021","Wrexham 014A","W01000366",624,185,93,92,419,45,175,66,68,41,107,37,62,8,88,59,29,4,4,20,14,6
"2021","Wrexham 014B","W01000367",542,143,56,87,387,55,226,89,89,48,58,24,29,5,48,30,18,0,0,12,6,6
"2021","Wrexham 014C","W01000385",761,193,123,70,552,125,273,114,91,68,77,31,40,6,76,43,33,1,1,16,9,7
"2021","Wrexham 014D","W01000410",743,220,106,114,505,83,215,78,86,51,108,49,53,6,98,60,38,1,1,18,7,11
"2021","Wrexham 015A","W01000386",660,258,111,147,378,32,154,59,58,37,93,35,53,5,94,57,37,5,5,24,12,12
"2021","Wrexham 015B","W01000405",915,252,127,125,626,62,237,71,96,70,131,49,74,8,188,131,57,8,8,37,16,21
"2021","Wrexham 015C","W01000411",762,335,144,191,405,46,151,69,52,30,88,42,37,9,116,91,25,4,4,22,5,17
"2021","Wrexham 015D","W01000412",657,204,84,120,424,64,213,87,75,51,82,35,40,7,62,47,15,3,3,29,16,13
"2021","Wrexham 016A","W01000394",502,118,51,67,357,71,204,93,63,48,50,31,13,6,30,12,18,2,2,27,17,10
"2021","Wrexham 016B","W01000395",452,121,69,52,315,63,148,51,63,34,42,19,18,5,60,40,20,2,2,16,9,7
"2021","Wrexham 016C","W01000407",623,191,85,106,409,82,205,73,91,41,72,41,29,2,48,33,15,2,2,23,8,15
"2021","Wrexham 016D","W01000419",613,195,89,106,401,32,196,65,91,40,77,29,43,5,92,69,23,4,4,17,7,10
"2021","Wrexham 016E","W01000420",675,222,86,136,423,54,199,70,83,46,80,32,42,6,87,58,29,3,3,30,11,19
"2021","Wrexham 017A","W01000354",731,218,114,104,486,101,230,95,91,44,85,39,39,7,65,40,25,5,5,27,14,13
"2021","Wrexham 017B","W01000355",825,321,148,173,478,50,169,61,66,42,121,50,66,5,133,97,36,5,5,26,15,11
"2021","Wrexham 017C","W01000356",622,158,68,90,448,54,185,57,70,58,102,20,71,11,100,52,48,7,7,16,7,9
"2021","Wrexham 017D","W01000389",862,221,118,103,610,100,315,128,122,65,117,59,48,10,73,44,29,5,5,31,11,20
"2021","Wrexham 017E","W01000409",785,240,124,116,521,35,127,37,64,26,112,21,82,9,241,190,51,6,6,24,12,12
"2021","Wrexham 018A","W01000345",697,178,112,66,499,131,241,103,89,49,65,36,28,1,61,34,27,1,1,20,8,12
"2021","Wrexham 018B","W01000346",627,140,87,53,453,90,264,124,78,62,54,33,17,4,39,19,20,6,6,34,14,20
"2021","Wrexham 018C","W01000403",566,144,81,63,400,84,213,98,79,36,53,27,21,5,46,17,29,4,4,22,14,8
"2021","Wrexham 018D","W01000404",868,260,135,125,566,85,294,124,124,46,93,52,39,2,93,62,31,1,1,42,21,21
"2021","Wrexham 019C","W01000359",528,137,70,67,366,61,175,81,63,31,69,30,36,3,59,31,28,2,2,25,11,14
"2021","Wrexham 019D","W01000360",511,158,93,65,334,44,141,55,58,28,64,24,35,5,85,46,39,0,0,19,10,9
"2021","Wrexham 019E","W01000361",882,314,147,167,541,86,249,106,101,42,91,34,50,7,111,67,44,4,4,27,12,15
"2021","Wrexham 019F","W01001930",900,269,135,134,593,122,288,120,92,76,95,51,32,12,83,54,29,5,5,38,16,22
"2021","Wrexham 021B","W01000369",607,208,143,65,376,104,158,58,49,51,48,24,21,3,65,31,34,1,1,23,8,15
"2021","Wrexham 021D","W01000370",684,232,113,119,435,97,208,65,95,48,70,43,24,3,58,29,29,2,2,17,7,10
"2021","Wrexham 021A","W01000390",754,198,103,95,523,123,246,102,94,50,99,47,49,3,53,21,32,2,2,33,12,21
"2021","Wrexham 021C","W01001970",926,205,124,81,702,177,391,147,170,74,71,33,31,7,59,22,37,4,4,19,8,11
"2021","Wrexham 022C","W01000384",487,154,100,54,320,84,157,64,63,30,45,24,16,5,34,25,9,0,0,13,5,8
"2021","Wrexham 022B","W01000417",676,169,105,64,487,107,273,107,105,61,53,26,23,4,52,23,29,2,2,20,9,11
"2021","Wrexham 022A","W01000418",741,223,112,111,491,93,270,89,130,51,74,38,34,2,54,30,24,0,0,27,11,16
"2021","Wrexham 022D","W01001971",458,104,54,50,327,51,182,66,73,43,52,26,21,5,39,20,19,3,3,27,14,13
"2021","Wrexham 022E","W01001972",512,107,29,78,377,34,236,84,118,34,74,33,34,7,32,25,7,1,1,28,20,8
"2021","Wrexham 023C","W01000341",673,207,84,123,429,63,158,50,70,38,90,35,46,9,116,72,44,2,2,37,16,21
"2021","Wrexham 023E","W01000342",691,239,103,136,421,54,145,52,69,24,92,43,40,9,128,88,40,2,2,31,13,18
"2021","Wrexham 023B","W01000343",465,137,102,35,314,92,160,52,68,40,29,10,17,2,31,9,22,2,2,14,5,9
"2021","Wrexham 023A","W01000344",583,170,117,53,408,138,179,83,56,40,55,24,27,4,36,20,16,0,0,5,3,2
"2021","Wrexham 023G","W01000393",811,220,134,86,553,108,253,85,104,64,85,34,41,10,101,69,32,6,6,38,16,22
"2021","Wrexham 023F","W01000415",668,211,130,81,443,99,206,82,83,41,67,30,32,5,69,34,35,2,2,14,5,9
"2021","Wrexham 023D","W01000416",503,110,53,57,387,72,212,86,72,54,57,33,21,3,44,28,16,2,2,6,2,4
"2021","Ceredigion 001C","W01000523",798,212,90,122,544,104,249,105,80,64,108,60,46,2,80,45,35,3,3,42,14,28
"2021","Ceredigion 001D","W01000548",761,234,123,111,490,97,232,100,93,39,82,42,34,6,78,56,22,1,1,37,11,26
"2021","Ceredigion 001E","W01000549",770,206,115,91,540,84,253,93,102,58,125,68,53,4,77,44,33,1,1,24,7,17
"2021","Ceredigion 001F","W01001937",919,334,161,173,538,115,249,102,97,50,98,55,36,7,73,41,32,3,3,47,13,34
"2021","Ceredigion 002A","W01000512",560,223,85,138,251,49,114,43,55,16,50,34,14,2,33,13,20,5,5,86,6,80
"2021","Ceredigion 002B","W01000513",910,399,63,336,277,19,65,27,32,6,141,125,15,1,36,21,15,16,16,234,8,226
"2021","Ceredigion 002D","W01000517",529,244,74,170,151,14,55,23,24,8,63,49,12,2,15,7,8,4,4,134,7,127
"2021","Ceredigion 002G","W01002000",529,165,90,75,296,64,121,45,55,21,57,34,22,1,52,39,13,2,2,68,6,62
"2021","Ceredigion 002H","W01002001",422,178,61,117,148,13,55,26,22,7,52,43,8,1,21,14,7,7,7,96,7,89
"2021","Ceredigion 003A","W01000515",595,197,71,126,380,42,132,48,60,24,95,34,52,9,102,62,40,9,9,18,5,13
"2021","Ceredigion 003B","W01000516",691,205,83,122,464,52,173,57,80,36,109,41,59,9,128,82,46,2,2,22,7,15
"2021","Ceredigion 003C","W01000518",528,233,126,107,242,40,96,49,34,13,61,44,16,1,43,26,17,2,2,53,6,47
"2021","Ceredigion 003E","W01001935",488,184,59,125,258,25,101,37,51,13,87,55,30,2,41,26,15,4,4,46,7,39
"2021","Ceredigion 003F","W01001936",416,129,62,67,260,64,129,50,51,28,39,20,19,0,28,15,13,0,0,27,4,23
"2021","Ceredigion 005A","W01000506",659,293,178,115,346,101,146,79,44,23,41,21,16,4,57,30,27,1,1,20,6,14
"2021","Ceredigion 005B","W01000524",840,238,128,110,552,128,272,110,105,57,81,46,22,13,64,35,29,7,7,50,16,34
"2021","Ceredigion 005C","W01000538",665,176,101,75,449,121,206,84,77,45,59,24,30,5,59,30,29,4,4,40,16,24
"2021","Ceredigion 005D","W01000539",512,134,78,56,338,73,172,84,48,40,57,30,21,6,35,11,24,1,1,40,18,22
"2021","Ceredigion 005E","W01000540",556,196,111,85,337,81,138,73,44,21,63,32,27,4,53,29,24,2,2,23,8,15
"2021","Ceredigion 007D","W01000545",876,225,132,93,597,152,315,172,78,65,82,44,31,7,42,18,24,6,6,54,23,31
"2021","Ceredigion 007E","W01002002",1980,600,341,259,1273,331,620,299,207,114,181,103,69,9,134,74,60,7,7,107,38,69
"2021","Ceredigion 008A","W01000527",431,167,72,95,234,36,94,30,46,18,64,27,35,2,35,28,7,5,5,30,9,21
"2021","Ceredigion 008B","W01000528",622,231,133,98,362,67,134,54,55,25,69,27,40,2,86,57,29,6,6,29,13,16
"2021","Ceredigion 008C","W01000535",892,241,123,118,588,134,262,133,72,57,102,56,41,5,84,43,41,6,6,63,28,35
"2021","Ceredigion 008D","W01000537",636,208,109,99,392,96,192,87,61,44,62,34,26,2,39,13,26,3,3,36,12,24
"2021","Ceredigion 008E","W01000541",757,220,115,105,498,110,261,125,88,48,61,35,25,1,63,29,34,3,3,39,16,23
"2021","Ceredigion 009A","W01000507",526,171,109,62,326,101,146,75,54,17,47,24,23,0,30,14,16,2,2,29,13,16
"2021","Ceredigion 009B","W01000508",506,190,100,90,300,68,115,57,39,19,53,24,26,3,61,45,16,3,3,16,6,10
"2021","Ceredigion 009C","W01000509",886,329,215,114,527,150,199,90,74,35,68,30,33,5,105,60,45,5,5,30,9,21
"2021","Ceredigion 009D","W01000510",627,329,142,187,275,42,102,40,52,10,62,30,28,4,66,38,28,3,3,23,6,17
"2021","Ceredigion 009E","W01000511",556,247,66,181,281,29,98,33,46,19,54,19,30,5,94,70,24,6,6,28,11,17
"2021","Ceredigion 009F","W01000546",543,197,110,87,316,94,134,73,33,28,39,19,18,2,45,27,18,4,4,30,10,20
"2021","Ceredigion 009G","W01000547",531,163,104,59,347,91,179,96,52,31,41,24,16,1,35,16,19,1,1,21,4,17
"2021","Ceredigion 010A","W01000519",768,203,126,77,529,118,262,127,91,44,90,48,37,5,58,31,27,1,1,36,21,15
"2021","Ceredigion 010B","W01000522",555,169,97,72,347,84,165,84,33,48,62,37,22,3,35,12,23,1,1,39,10,29
"2021","Ceredigion 010C","W01000531",819,270,154,116,525,117,227,119,64,44,99,53,42,4,78,43,35,4,4,24,10,14
"2021","Ceredigion 010D","W01000533",654,262,121,141,367,69,166,71,63,32,59,32,25,2,68,43,25,5,5,25,6,19
"2021","Ceredigion 010E","W01000551",593,157,79,78,400,92,191,93,58,40,65,33,29,3,49,26,23,3,3,36,15,21
"2021","Ceredigion 011A","W01000525",510,145,96,49,335,93,163,58,67,38,37,18,16,3,41,18,23,1,1,30,6,24
"2021","Ceredigion 011B","W01000534",652,183,97,86,440,108,209,72,99,38,74,41,31,2,46,23,23,3,3,29,11,18
"2021","Ceredigion 011E","W01000536",623,199,118,81,385,80,190,87,65,38,66,36,26,4,48,21,27,1,1,39,13,26
"2021","Ceredigion 011F","W01000542",956,271,142,129,635,115,308,141,98,69,121,69,42,10,86,41,45,5,5,50,24,26
"2021","Ceredigion 011C","W01000543",874,234,120,114,596,108,306,142,101,63,109,60,42,7,72,46,26,1,1,44,23,21
"2021","Ceredigion 011G","W01000550",532,190,106,84,322,70,159,64,58,37,53,25,26,2,40,25,15,0,0,20,3,17
"2021","Ceredigion 011D","W01000552",853,225,117,108,598,115,320,133,125,62,101,58,38,5,60,39,21,2,2,30,8,22
"2021","Pembrokeshire 001A","W01000558",910,258,139,119,611,128,261,96,117,48,115,57,48,10,103,69,34,4,4,41,16,25
"2021","Pembrokeshire 001B","W01000559",625,160,98,62,424,87,217,100,75,42,55,35,16,4,56,31,25,9,9,41,18,23
"2021","Pembrokeshire 001C","W01000560",577,173,85,88,377,82,180,76,64,40,57,29,25,3,52,24,28,6,6,27,12,15
"2021","Pembrokeshire 001D","W01000561",574,183,93,90,358,79,161,67,53,41,71,34,30,7,45,31,14,2,2,33,15,18
"2021","Pembrokeshire 001E","W01000613",958,325,193,132,574,144,267,129,88,50,82,49,28,5,77,45,32,4,4,59,27,32
"2021","Pembrokeshire 002A","W01000562",717,221,125,96,445,109,199,91,66,42,69,36,27,6,66,42,24,2,2,51,22,29
"2021","Pembrokeshire 002B","W01000565",888,359,200,159,497,134,190,85,62,43,72,34,33,5,97,58,39,4,4,32,14,18
"2021","Pembrokeshire 002C","W01000566",750,277,147,130,445,97,181,89,63,29,76,34,37,5,89,51,38,2,2,28,11,17
"2021","Pembrokeshire 002D","W01000567",931,330,153,177,560,89,249,115,83,51,111,63,46,2,107,66,41,4,4,41,14,27
"2021","Pembrokeshire 002E","W01000597",524,202,115,87,300,102,101,47,29,25,46,21,20,5,49,30,19,2,2,22,10,12
"2021","Pembrokeshire 002F","W01000617",633,170,98,72,428,91,198,82,73,43,71,38,32,1,66,38,28,2,2,35,20,15
"2021","Pembrokeshire 003A","W01000579",1027,305,169,136,682,165,341,132,145,64,100,45,48,7,74,43,31,2,2,40,19,21
"2021","Pembrokeshire 003B","W01000581",628,163,103,60,442,118,204,95,53,56,73,38,24,11,46,20,26,1,1,23,9,14
"2021","Pembrokeshire 003C","W01000612",845,334,203,131,472,127,216,107,65,44,54,32,19,3,73,39,34,2,2,39,7,32
"2021","Pembrokeshire 003D","W01000618",683,228,119,109,417,93,207,84,73,50,54,23,23,8,60,32,28,3,3,38,17,21
"2021","Pembrokeshire 004A","W01000582",696,199,101,98,439,99,225,108,83,34,57,33,19,5,54,19,35,4,4,58,37,21
"2021","Pembrokeshire 004B","W01000583",594,157,90,67,414,72,213,70,89,54,54,24,28,2,73,47,26,2,2,23,9,14
"2021","Pembrokeshire 004C","W01000611",933,270,142,128,624,146,303,118,124,61,99,58,35,6,75,50,25,1,1,39,22,17
"2021","Pembrokeshire 004D","W01000623",821,174,89,85,601,127,316,143,116,57,94,52,38,4,62,32,30,2,2,46,16,30
"2021","Pembrokeshire 005B","W01000569",471,146,61,85,309,40,159,61,79,19,51,23,26,2,58,35,23,1,1,16,7,9
"2021","Pembrokeshire 005C","W01000570",639,226,40,186,378,7,107,34,62,11,73,29,43,1,189,148,41,2,2,35,16,19
"2021","Pembrokeshire 005D","W01000572",848,319,171,148,496,73,254,97,108,49,69,29,37,3,96,61,35,4,4,33,14,19
"2021","Pembrokeshire 005E","W01002009",618,294,100,194,292,49,126,51,43,32,43,30,13,0,66,47,19,8,8,32,6,26
"2021","Pembrokeshire 005F","W01002010",607,329,88,241,262,14,101,41,43,17,63,34,27,2,82,59,23,2,2,16,4,12
"2021","Pembrokeshire 006A","W01000571",1091,398,218,180,645,107,286,114,115,57,100,48,46,6,149,108,41,3,3,48,15,33
"2021","Pembrokeshire 006B","W01000573",1160,388,183,205,728,113,337,127,147,63,145,74,62,9,125,91,34,8,8,44,15,29
"2021","Pembrokeshire 006C","W01000586",930,261,150,111,627,94,248,100,97,51,127,51,67,9,151,83,68,7,7,42,26,16
"2021","Pembrokeshire 007A","W01000577",649,155,85,70,452,116,220,100,73,47,70,38,29,3,42,29,13,4,4,42,18,24
"2021","Pembrokeshire 007B","W01000585",565,165,88,77,365,66,205,87,66,52,63,39,22,2,29,9,20,2,2,35,10,25
"2021","Pembrokeshire 007C","W01000595",1178,487,254,233,653,120,271,108,119,44,122,68,48,6,132,92,40,8,8,38,14,24
"2021","Pembrokeshire 007D","W01000596",734,213,112,101,482,105,261,101,109,51,64,33,27,4,50,34,16,2,2,39,16,23
"2021","Pembrokeshire 008A","W01000555",649,158,76,82,446,133,222,99,80,43,49,25,19,5,42,16,26,0,0,45,25,20
"2021","Pembrokeshire 008B","W01000556",521,147,93,54,354,83,172,74,65,33,56,26,27,3,41,21,20,2,2,20,6,14
"2021","Pembrokeshire 008C","W01000575",1128,340,157,183,742,124,353,138,139,76,131,59,65,7,134,96,38,0,0,46,21,25
"2021","Pembrokeshire 008D","W01000614",621,173,107,66,419,100,189,93,62,34,70,41,25,4,59,35,24,1,1,29,16,13
"2021","Pembrokeshire 008E","W01000622",619,183,97,86,408,102,210,97,69,44,51,27,20,4,38,21,17,7,7,28,6,22
"2021","Pembrokeshire 009A","W01000554",763,179,102,77,550,131,310,138,121,51,73,46,27,0,35,22,13,1,1,34,11,23
"2021","Pembrokeshire 009B","W01000580",985,261,144,117,680,155,329,127,143,59,111,53,50,8,79,43,36,6,6,44,22,22
"2021","Pembrokeshire 009C","W01000598",1019,353,179,174,635,135,297,138,101,58,101,51,45,5,101,64,37,1,1,31,9,22
"2021","Pembrokeshire 009D","W01000599",896,278,147,131,580,108,262,115,97,50,103,54,41,8,102,60,42,5,5,38,21,17
"2021","Pembrokeshire 010A","W01000587",1050,516,234,282,508,92,205,94,65,46,125,66,56,3,85,56,29,1,1,26,11,15
"2021","Pembrokeshire 010B","W01000588",1043,359,124,235,649,86,270,129,103,38,144,48,90,6,141,99,42,8,8,35,14,21
"2021","Pembrokeshire 010D","W01002011",711,233,117,116,460,84,198,93,72,33,87,35,50,2,88,61,27,3,3,18,8,10
"2021","Pembrokeshire 010E","W01002012",612,186,78,108,409,78,170,58,75,37,53,24,26,3,104,78,26,4,4,17,10,7
"2021","Pembrokeshire 011A","W01000553",553,156,86,70,368,87,188,93,58,37,52,32,17,3,39,26,13,2,2,29,14,15
"2021","Pembrokeshire 011B","W01000563",457,115,69,46,312,69,165,72,55,38,45,23,21,1,28,14,14,5,5,30,13,17
"2021","Pembrokeshire 011C","W01000564",585,200,111,89,363,76,184,88,62,34,55,24,29,2,47,27,20,1,1,22,8,14
"2021","Pembrokeshire 011D","W01000576",1047,331,211,120,665,161,315,146,101,68,103,52,39,12,83,47,36,3,3,51,18,33
"2021","Pembrokeshire 011G","W01002013",1153,419,238,181,691,213,293,154,85,54,90,59,27,4,87,53,34,8,8,43,16,27
"2021","Pembrokeshire 012A","W01000589",543,210,93,117,322,33,136,50,57,29,65,28,31,6,85,62,23,3,3,11,5,6
"2021","Pembrokeshire 012B","W01000590",564,204,129,75,342,81,153,73,53,27,53,28,22,3,50,31,19,5,5,18,7,11
"2021","Pembrokeshire 012C","W01000591",698,192,85,107,490,60,225,91,91,43,100,42,47,11,104,74,30,1,1,16,5,11
"2021","Pembrokeshire 012D","W01000592",522,136,60,76,365,30,146,46,71,29,73,19,45,9,114,83,31,2,2,21,8,13
"2021","Pembrokeshire 012E","W01000594",1006,391,161,230,563,64,195,79,76,40,136,51,73,12,164,114,50,4,4,52,20,32
"2021","Pembrokeshire 013A","W01000600",840,434,159,275,378,42,156,66,57,33,100,46,47,7,76,50,26,4,4,28,13,15
"2021","Pembrokeshire 013B","W01000601",658,214,96,118,424,42,137,58,54,25,82,20,54,8,159,124,35,4,4,20,14,6
"2021","Pembrokeshire 013C","W01000602",581,226,95,131,337,83,138,57,47,34,43,26,17,0,67,46,21,6,6,18,7,11
"2021","Pembrokeshire 013D","W01000603",833,321,114,207,470,70,208,85,89,34,99,56,39,4,88,55,33,5,5,42,20,22
"2021","Pembrokeshire 013E","W01000604",755,229,98,131,500,81,172,61,62,49,84,38,40,6,160,120,40,3,3,26,13,13
"2021","Pembrokeshire 013F","W01000605",773,257,119,138,469,60,247,92,97,58,83,34,44,5,77,54,23,2,2,47,27,20
"2021","Pembrokeshire 014A","W01000557",637,163,87,76,450,90,265,93,128,44,56,29,20,7,38,24,14,1,1,24,11,13
"2021","Pembrokeshire 014B","W01000578",770,225,126,99,514,145,256,116,82,58,63,42,18,3,47,26,21,3,3,31,17,14
"2021","Pembrokeshire 014C","W01000584",875,252,142,110,573,132,273,115,110,48,89,38,44,7,75,33,42,4,4,50,22,28
"2021","Pembrokeshire 014D","W01000609",1167,371,243,128,766,250,344,168,102,74,99,58,35,6,71,40,31,2,2,30,12,18
"2021","Pembrokeshire 015A","W01000574",772,219,126,93,518,119,278,133,89,56,69,43,24,2,49,21,28,3,3,35,12,23
"2021","Pembrokeshire 015B","W01000606",725,236,94,142,466,49,143,63,53,27,90,29,54,7,175,136,39,9,9,23,15,8
"2021","Pembrokeshire 015C","W01000607",1064,363,159,204,663,84,274,94,128,52,120,45,66,9,181,132,49,4,4,38,17,21
"2021","Pembrokeshire 015D","W01000608",734,338,135,203,378,80,164,70,55,39,64,35,25,4,65,38,27,5,5,18,11,7
"2021","Pembrokeshire 016A","W01000610",744,235,143,92,465,130,213,100,63,50,62,36,24,2,58,35,23,2,2,44,16,28
"2021","Pembrokeshire 016B","W01000619",951,326,194,132,585,152,243,108,84,51,86,45,27,14,102,60,42,2,2,40,17,23
"2021","Pembrokeshire 016E","W01002014",1077,516,255,261,520,89,193,91,59,43,103,51,45,7,133,90,43,2,2,41,11,30
"2021","Carmarthenshire 001A","W01000685",674,198,89,109,437,81,203,89,73,41,81,41,36,4,72,41,31,0,0,39,15,24
"2021","Carmarthenshire 001B","W01000686",539,160,94,66,351,86,180,76,59,45,52,26,21,5,31,11,20,2,2,28,9,19
"2021","Carmarthenshire 001C","W01000701",680,192,105,87,461,108,209,74,80,55,93,53,38,2,49,22,27,2,2,27,11,16
"2021","Carmarthenshire 001D","W01000702",514,175,107,68,307,53,135,62,42,31,63,23,37,3,55,32,23,1,1,32,14,18
"2021","Carmarthenshire 002A","W01000647",624,189,102,87,392,86,199,98,61,40,64,38,23,3,40,20,20,3,3,43,23,20
"2021","Carmarthenshire 002B","W01000650",703,186,96,90,472,107,237,128,60,49,66,31,31,4,59,20,39,3,3,45,15,30
"2021","Carmarthenshire 002C","W01000678",587,201,131,70,356,94,191,99,47,45,38,19,18,1,32,14,18,1,1,30,19,11
"2021","Carmarthenshire 002D","W01000679",533,204,102,102,301,58,115,56,39,20,68,34,32,2,56,30,26,4,4,28,15,13
"2021","Carmarthenshire 003A","W01000646",946,327,147,180,564,137,253,109,97,47,71,35,30,6,99,50,49,4,4,55,19,36
"2021","Carmarthenshire 003B","W01000688",766,263,145,118,462,84,222,99,79,44,80,49,31,0,73,45,28,3,3,41,15,26
"2021","Carmarthenshire 003C","W01000689",755,210,132,78,492,113,267,127,86,54,65,40,18,7,42,18,24,5,5,53,22,31
"2021","Carmarthenshire 003D","W01000728",852,191,114,77,600,136,324,151,97,76,87,58,25,4,50,17,33,3,3,61,25,36
"2021","Carmarthenshire 004A","W01000676",669,217,118,99,424,101,217,85,95,37,49,30,17,2,56,30,26,1,1,28,10,18
"2021","Carmarthenshire 004B","W01000677",703,332,152,180,342,45,147,50,62,35,64,35,26,3,80,53,27,6,6,29,11,18
"2021","Carmarthenshire 004C","W01000687",819,230,141,89,540,120,284,130,100,54,72,45,24,3,59,29,30,5,5,49,21,28
"2021","Carmarthenshire 004D","W01000709",925,230,127,103,636,145,338,155,109,74,79,41,32,6,67,35,32,7,7,59,21,38
"2021","Carmarthenshire 005A","W01000624",963,255,143,112,660,133,366,134,141,91,92,42,40,10,66,23,43,3,3,48,22,26
"2021","Carmarthenshire 005B","W01000682",580,146,85,61,400,94,210,75,86,49,43,21,20,2,49,20,29,4,4,34,12,22
"2021","Carmarthenshire 005C","W01000683",481,136,69,67,315,61,168,88,49,31,56,40,14,2,27,6,21,3,3,30,9,21
"2021","Carmarthenshire 005D","W01000684",770,190,111,79,539,137,267,127,88,52,84,50,29,5,47,20,27,4,4,41,17,24
"2021","Carmarthenshire 006A","W01000643",697,212,90,122,451,57,186,56,104,26,83,36,41,6,121,85,36,4,4,34,18,16
"2021","Carmarthenshire 006B","W01000644",737,227,78,149,479,48,222,74,120,28,108,60,46,2,98,67,31,3,3,31,12,19
"2021","Carmarthenshire 006C","W01000645",844,297,111,186,494,57,218,65,125,28,104,58,44,2,107,64,43,8,8,53,17,36
"2021","Carmarthenshire 006D","W01000648",566,129,74,55,388,92,214,82,90,42,48,31,14,3,29,7,22,5,5,49,23,26
"2021","Carmarthenshire 006E","W01000649",646,157,98,59,452,112,248,105,84,59,55,31,20,4,35,19,16,2,2,37,15,22
"2021","Carmarthenshire 007A","W01000637",642,248,114,134,375,39,142,62,51,29,82,25,53,4,110,74,36,2,2,19,8,11
"2021","Carmarthenshire 007B","W01000638",488,144,38,106,327,29,115,46,52,17,85,38,39,8,95,68,27,3,3,17,6,11
"2021","Carmarthenshire 007C","W01000639",679,256,99,157,391,51,154,60,74,20,83,33,46,4,97,62,35,6,6,32,13,19
"2021","Carmarthenshire 007D","W01000640",538,149,84,65,369,91,188,75,79,34,55,36,18,1,33,18,15,2,2,20,5,15
"2021","Carmarthenshire 008A","W01000641",1195,669,239,430,472,69,147,65,65,17,124,79,38,7,111,74,37,21,21,54,18,36
"2021","Carmarthenshire 008B","W01000642",774,259,155,104,495,117,221,92,86,43,92,48,38,6,64,29,35,1,1,20,7,13
"2021","Carmarthenshire 008C","W01000693",520,207,139,68,302,71,127,34,68,25,46,22,20,4,57,31,26,1,1,11,6,5
"2021","Carmarthenshire 008D","W01000694",654,184,107,77,444,134,195,78,86,31,49,26,20,3,61,33,28,5,5,26,15,11
"2021","Carmarthenshire 010A","W01000656",887,276,127,149,570,95,254,100,99,55,102,42,49,11,110,70,40,9,9,41,17,24
"2021","Carmarthenshire 010B","W01000657",520,173,92,81,319,50,141,64,48,29,67,30,31,6,56,30,26,5,5,28,9,19
"2021","Carmarthenshire 010C","W01000658",584,188,83,105,361,57,164,67,61,36,73,32,37,4,65,41,24,2,2,35,15,20
"2021","Carmarthenshire 010D","W01000718",623,212,99,113,389,66,170,61,60,49,65,29,31,5,82,50,32,6,6,22,11,11
"2021","Carmarthenshire 010E","W01000719",623,172,82,90,425,77,214,97,78,39,72,29,35,8,59,39,20,3,3,26,11,15
"2021","Carmarthenshire 011A","W01000680",950,228,135,93,674,167,338,122,158,58,74,27,45,2,87,54,33,8,8,48,29,19
"2021","Carmarthenshire 011B","W01000681",893,273,132,141,580,97,269,103,113,53,88,37,47,4,120,86,34,6,6,40,17,23
"2021","Carmarthenshire 011C","W01000724",811,219,114,105,558,100,257,96,117,44,95,45,42,8,102,62,40,4,4,34,16,18
"2021","Carmarthenshire 011D","W01000725",1023,337,197,140,644,147,302,109,120,73,93,45,38,10,100,58,42,2,2,42,19,23
"2021","Carmarthenshire 012A","W01000675",856,203,132,71,586,143,301,116,119,66,71,44,22,5,70,29,41,1,1,67,28,39
"2021","Carmarthenshire 012B","W01000695",968,273,108,165,647,98,310,137,125,48,145,70,68,7,86,47,39,8,8,48,24,24
"2021","Carmarthenshire 012C","W01000696",682,181,108,73,460,84,234,105,89,40,84,37,38,9,57,27,30,1,1,41,25,16
"2021","Carmarthenshire 012D","W01000722",578,161,112,49,384,103,206,90,75,41,44,27,15,2,30,7,23,1,1,33,16,17
"2021","Carmarthenshire 012E","W01000723",646,215,119,96,402,103,207,103,61,43,43,25,15,3,48,23,25,1,1,29,12,17
"2021","Carmarthenshire 013A","W01000625",497,181,89,92,296,44,125,35,55,35,44,15,24,5,81,49,32,2,2,20,10,10
"2021","Carmarthenshire 013B","W01000626",757,315,143,172,407,58,166,58,70,38,85,37,41,7,96,64,32,2,2,35,17,18
"2021","Carmarthenshire 013C","W01000627",987,271,125,146,685,118,347,125,163,59,109,40,63,6,104,58,46,7,7,31,15,16
"2021","Carmarthenshire 013D","W01000714",655,250,113,137,376,51,174,54,77,43,64,38,20,6,83,55,28,4,4,29,15,14
"2021","Carmarthenshire 013E","W01000715",563,155,91,64,377,92,171,65,61,45,58,21,34,3,50,24,26,6,6,31,9,22
"2021","Carmarthenshire 015A","W01000697",844,242,114,128,566,89,214,87,83,44,122,57,57,8,133,71,62,8,8,36,12,24
"2021","Carmarthenshire 015B","W01000698",808,213,104,109,549,85,275,106,116,53,85,33,44,8,104,62,42,0,0,46,15,31
"2021","Carmarthenshire 015C","W01000699",575,122,60,62,416,81,251,89,106,56,43,18,22,3,38,18,20,3,3,37,16,21
"2021","Carmarthenshire 015D","W01000712",724,196,80,116,499,79,244,90,104,50,87,46,36,5,87,52,35,2,2,29,15,14
"2021","Carmarthenshire 015E","W01000713",591,157,82,75,414,75,195,82,66,47,78,31,40,7,63,41,22,3,3,20,9,11
"2021","Carmarthenshire 016A","W01000662",942,260,140,120,643,95,314,135,114,65,125,57,63,5,107,66,41,2,2,39,11,28
"2021","Carmarthenshire 016B","W01000663",1090,295,176,119,741,142,383,161,145,77,109,50,55,4,105,55,50,2,2,54,25,29
"2021","Carmarthenshire 016C","W01000664",1066,283,109,174,729,115,369,131,181,57,158,77,71,10,80,55,25,7,7,54,26,28
"2021","Carmarthenshire 016D","W01000716",571,155,88,67,387,71,206,83,78,45,51,23,26,2,54,21,33,5,5,29,10,19
"2021","Carmarthenshire 016E","W01000717",643,204,99,105,419,52,197,77,79,41,72,24,43,5,95,58,37,3,3,20,9,11
"2021","Carmarthenshire 017A","W01000665",767,179,92,87,543,88,312,142,120,50,81,40,34,7,59,38,21,3,3,45,16,29
"2021","Carmarthenshire 017B","W01000666",724,225,100,125,477,54,229,84,106,39,112,51,55,6,80,61,19,2,2,22,10,12
"2021","Carmarthenshire 017C","W01000731",1059,293,150,143,729,122,353,155,130,68,123,49,67,7,122,71,51,9,9,37,13,24
"2021","Carmarthenshire 018A","W01000670",721,268,146,122,414,65,178,81,67,30,61,23,32,6,105,62,43,5,5,39,14,25
"2021","Carmarthenshire 018B","W01000671",885,213,126,87,625,138,303,125,112,66,76,26,45,5,104,70,34,4,4,47,13,34
"2021","Carmarthenshire 018C","W01000729",520,162,93,69,329,50,139,55,55,29,71,20,46,5,64,38,26,5,5,29,16,13
"2021","Carmarthenshire 018D","W01000730",541,144,73,71,367,62,182,78,50,54,64,27,29,8,57,38,19,2,2,30,12,18
"2021","Carmarthenshire 019A","W01000690",766,229,144,85,513,95,262,93,110,59,79,39,35,5,72,40,32,5,5,24,16,8
"2021","Carmarthenshire 019B","W01000691",780,236,130,106,515,111,248,84,113,51,77,34,38,5,77,49,28,2,2,29,13,16
"2021","Carmarthenshire 019C","W01000692",638,181,77,104,436,69,214,75,96,43,83,34,42,7,69,46,23,1,1,21,11,10
"2021","Carmarthenshire 019F","W01001999",1099,303,195,108,751,212,385,150,144,91,76,36,29,11,77,39,38,1,1,45,19,26
"2021","Carmarthenshire 020A","W01000651",692,237,117,120,427,67,208,87,72,49,60,31,26,3,89,51,38,3,3,28,12,16
"2021","Carmarthenshire 020B","W01000652",722,221,113,108,462,67,196,80,77,39,74,27,42,5,121,75,46,4,4,39,25,14
"2021","Carmarthenshire 020C","W01000655",798,264,126,138,499,62,202,61,97,44,90,33,52,5,142,103,39,3,3,35,19,16
"2021","Carmarthenshire 021A","W01000632",596,174,96,78,399,66,182,71,65,46,70,37,29,4,79,46,33,2,2,23,7,16
"2021","Carmarthenshire 021B","W01000633",705,314,165,149,367,65,150,67,43,40,66,29,33,4,84,52,32,2,2,24,13,11
"2021","Carmarthenshire 021C","W01000634",636,224,161,63,400,125,160,72,51,37,51,25,23,3,63,32,31,1,1,12,3,9
"2021","Carmarthenshire 021D","W01000710",890,223,143,80,621,151,336,132,129,75,78,42,31,5,53,23,30,3,3,46,22,24
"2021","Carmarthenshire 021E","W01000711",888,252,145,107,583,116,229,96,64,69,102,37,56,9,130,74,56,6,6,53,23,30
"2021","Carmarthenshire 022A","W01000703",816,318,101,217,458,50,190,73,79,38,99,45,47,7,111,69,42,8,8,40,9,31
"2021","Carmarthenshire 022B","W01000704",716,222,127,95,470,106,227,73,102,52,59,27,29,3,74,46,28,4,4,24,12,12
"2021","Carmarthenshire 022C","W01000705",801,261,119,142,503,62,193,61,92,40,85,27,51,7,160,104,56,3,3,37,15,22
"2021","Carmarthenshire 023A","W01000653",644,211,118,93,407,87,194,70,83,41,67,31,35,1,58,25,33,1,1,26,9,17
"2021","Carmarthenshire 023B","W01000654",752,285,106,179,423,54,190,68,79,43,94,47,41,6,84,51,33,1,1,44,17,27
"2021","Carmarthenshire 023C","W01000667",942,282,106,176,625,78,284,101,136,47,141,85,54,2,120,78,42,2,2,35,10,25
"2021","Carmarthenshire 023F","W01001925",971,275,152,123,665,150,297,133,93,71,106,63,37,6,107,61,46,5,5,31,14,17
"2021","Carmarthenshire 024A","W01000628",637,200,108,92,410,65,203,67,81,55,67,29,36,2,75,41,34,0,0,27,14,13
"2021","Carmarthenshire 024B","W01000629",734,270,117,153,418,48,208,68,82,58,77,44,30,3,78,59,19,7,7,46,22,24
"2021","Carmarthenshire 024C","W01000630",647,180,64,116,437,65,200,72,85,43,77,25,46,6,91,61,30,4,4,30,10,20
"2021","Carmarthenshire 024D","W01000631",759,220,111,109,506,56,181,52,74,55,93,36,47,10,167,117,50,9,9,33,23,10
"2021","Carmarthenshire 025A","W01000635",998,253,101,152,700,88,364,140,152,72,142,78,54,10,104,65,39,2,2,45,25,20
"2021","Carmarthenshire 025B","W01000636",982,249,102,147,705,69,319,117,143,59,161,69,81,11,155,101,54,1,1,28,16,12
"2021","Carmarthenshire 025C","W01000706",668,209,99,110,440,65,189,60,86,43,86,36,39,11,94,65,29,6,6,19,13,6
"2021","Carmarthenshire 025D","W01000707",604,170,78,92,407,44,159,56,66,37,74,22,45,7,126,93,33,4,4,27,13,14
"2021","Carmarthenshire 025E","W01000708",594,219,99,120,352,42,138,35,64,39,70,27,38,5,102,69,33,0,0,23,9,14
"2021","Carmarthenshire 026A","W01000659",755,238,90,148,462,45,175,63,66,46,98,36,53,9,135,98,37,9,9,55,23,32
"2021","Carmarthenshire 026B","W01000660",728,315,135,180,382,61,131,46,47,38,79,40,36,3,105,77,28,6,6,31,12,19
"2021","Carmarthenshire 026D","W01000732",609,242,93,149,334,42,160,67,55,38,47,21,23,3,80,52,28,5,5,33,11,22
"2021","Carmarthenshire 026E","W01000733",595,287,99,188,278,29,85,26,32,27,67,34,27,6,96,65,31,1,1,30,12,18
"2021","Carmarthenshire 026F","W01000734",601,220,58,162,349,28,135,40,56,39,79,33,40,6,105,70,35,2,2,32,13,19
"2021","Carmarthenshire 026G","W01001923",819,282,85,197,507,49,237,113,88,36,126,68,56,2,92,53,39,3,3,30,11,19
"2021","Carmarthenshire 026H","W01001924",595,231,95,136,335,36,133,44,68,21,64,19,35,10,100,74,26,2,2,29,14,15
"2021","Carmarthenshire 027E","W01000672",638,185,106,79,416,91,208,86,77,45,59,32,23,4,56,23,33,2,2,37,20,17
"2021","Carmarthenshire 027F","W01000673",512,176,92,84,316,73,154,74,44,36,48,21,23,4,38,26,12,3,3,20,7,13
"2021","Carmarthenshire 027A","W01000674",856,214,107,107,573,127,313,141,104,68,76,48,25,3,53,24,29,4,4,69,33,36
"2021","Carmarthenshire 027G","W01000700",891,264,153,111,575,155,281,134,87,60,73,43,29,1,59,24,35,7,7,52,25,27
"2021","Carmarthenshire 027B","W01000720",782,254,116,138,504,99,252,99,107,46,83,37,46,0,64,40,24,6,6,24,10,14
"2021","Carmarthenshire 027C","W01000721",587,163,85,78,404,54,194,86,77,31,72,39,32,1,83,44,39,1,1,20,15,5
"2021","Carmarthenshire 027D","W01000735",1063,343,168,175,664,128,327,140,124,63,113,53,54,6,95,59,36,1,1,56,24,32
"2021","Swansea 001A","W01000845",837,219,116,103,596,92,321,97,161,63,81,44,34,3,99,49,50,3,3,22,8,14
"2021","Swansea 001B","W01000846",970,414,127,287,533,47,229,77,113,39,136,60,67,9,117,78,39,4,4,23,13,10
"2021","Swansea 001C","W01000847",521,153,74,79,338,60,167,59,65,43,51,24,25,2,60,33,27,0,0,30,17,13
"2021","Swansea 001D","W01000848",502,154,91,63,328,38,118,48,49,21,62,22,36,4,109,80,29,1,1,20,12,8
"2021","Swansea 002A","W01000750",670,247,135,112,400,92,164,62,58,44,66,35,23,8,77,52,25,1,1,23,7,16
"2021","Swansea 002B","W01000751",621,177,102,75,422,110,193,61,87,45,66,45,20,1,50,20,30,3,3,22,9,13
"2021","Swansea 002C","W01000752",637,196,71,125,410,50,132,42,58,32,82,27,49,6,137,107,30,9,9,31,12,19
"2021","Swansea 002D","W01000753",601,167,71,96,414,51,177,50,86,41,67,31,32,4,117,81,36,2,2,20,9,11
"2021","Swansea 002E","W01000754",696,273,99,174,403,58,202,62,87,53,71,31,34,6,70,44,26,2,2,20,6,14
"2021","Swansea 002F","W01000803",798,251,125,126,501,97,254,94,110,50,62,27,29,6,80,40,40,8,8,46,20,26
"2021","Swansea 003A","W01000806",615,178,92,86,416,80,175,52,75,48,80,39,34,7,79,42,37,2,2,21,10,11
"2021","Swansea 003B","W01000807",553,131,66,65,401,81,219,93,80,46,49,23,19,7,50,23,27,2,2,21,9,12
"2021","Swansea 003C","W01000808",616,195,114,81,396,95,173,61,60,52,57,33,20,4,69,42,27,2,2,25,7,18
"2021","Swansea 003D","W01000810",634,257,113,144,348,29,114,37,51,26,42,13,26,3,158,120,38,5,5,29,10,19
"2021","Swansea 003E","W01000815",648,173,99,74,448,105,201,70,87,44,73,36,30,7,67,34,33,2,2,27,13,14
"2021","Swansea 003F","W01000816",746,202,79,123,510,81,271,84,125,62,76,41,27,8,77,43,34,5,5,34,15,19
"2021","Swansea 004A","W01000791",620,195,69,126,407,43,225,75,95,55,81,50,26,5,58,36,22,0,0,18,8,10
"2021","Swansea 004B","W01000792",693,187,102,85,486,96,250,79,102,69,73,33,33,7,65,35,30,2,2,20,7,13
"2021","Swansea 004C","W01000793",749,189,66,123,534,62,313,94,166,53,87,41,41,5,72,43,29,0,0,26,9,17
"2021","Swansea 004D","W01000837",917,199,84,115,690,109,410,106,237,67,110,67,40,3,60,48,12,1,1,28,10,18
"2021","Swansea 004E","W01000838",559,191,96,95,345,37,122,39,59,24,71,28,38,5,111,67,44,4,4,23,10,13
"2021","Swansea 005B","W01000774",759,313,166,147,407,50,205,72,91,42,72,38,34,0,76,36,40,4,4,39,19,20
"2021","Swansea 005C","W01000841",648,211,113,98,407,69,176,67,71,38,68,26,34,8,88,46,42,6,6,30,14,16
"2021","Swansea 005D","W01000842",594,167,90,77,399,77,183,54,79,50,66,28,28,10,69,25,44,4,4,28,10,18
"2021","Swansea 005E","W01000843",575,148,62,86,403,70,201,70,95,36,64,33,27,4,67,32,35,1,1,24,13,11
"2021","Swansea 005F","W01000844",611,179,56,123,412,48,159,47,70,42,81,30,43,8,117,82,35,7,7,20,9,11
"2021","Swansea 005G","W01001991",650,269,97,172,353,26,141,48,63,30,72,37,28,7,114,86,28,0,0,28,18,10
"2021","Swansea 005H","W01001992",659,273,110,163,355,21,175,53,101,21,82,42,36,4,75,50,25,2,2,31,13,18
"2021","Swansea 006A","W01000795",693,201,61,140,471,76,248,92,99,57,79,45,28,6,67,44,23,1,1,21,11,10
"2021","Swansea 006C","W01000800",587,124,60,64,439,85,242,96,94,52,60,26,30,4,52,31,21,0,0,24,7,17
"2021","Swansea 006D","W01000801",759,237,85,152,498,45,171,71,75,25,152,101,47,4,127,71,56,3,3,24,15,9
"2021","Swansea 006E","W01001993",589,85,12,73,475,15,277,71,171,35,113,48,60,5,68,59,9,2,2,29,16,13
"2021","Swansea 006F","W01001994",625,168,50,118,435,55,208,71,98,39,86,47,35,4,84,46,38,2,2,22,11,11
"2021","Swansea 007A","W01000784",591,193,119,74,377,70,180,63,72,45,53,23,25,5,73,45,28,1,1,21,9,12
"2021","Swansea 007B","W01000785",737,170,94,76,549,99,300,100,153,47,78,38,37,3,70,38,32,2,2,18,6,12
"2021","Swansea 007C","W01000786",574,165,86,79,393,86,196,73,65,58,67,38,23,6,43,19,24,1,1,16,8,8
"2021","Swansea 007D","W01000802",1007,323,135,188,638,107,301,100,139,62,110,47,56,7,117,68,49,3,3,46,26,20
"2021","Swansea 007E","W01000877",723,208,114,94,488,90,229,74,106,49,88,42,41,5,80,51,29,1,1,27,11,16
"2021","Swansea 007F","W01000878",590,194,116,78,377,57,164,62,61,41,82,46,34,2,72,46,26,2,2,19,8,11
"2021","Swansea 008A","W01000809",715,287,126,161,398,49,171,63,66,42,80,39,35,6,90,59,31,8,8,30,9,21
"2021","Swansea 008B","W01000811",668,283,81,202,346,21,146,50,54,42,69,36,29,4,106,67,39,4,4,39,10,29
"2021","Swansea 008C","W01000812",710,319,97,222,359,32,138,62,46,30,79,51,27,1,107,80,27,3,3,32,13,19
"2021","Swansea 008D","W01000813",686,204,91,113,445,74,225,87,87,51,81,44,31,6,60,29,31,5,5,37,12,25
"2021","Swansea 008E","W01000814",639,236,71,165,373,46,134,40,54,40,76,28,43,5,111,67,44,6,6,30,8,22
"2021","Swansea 009A","W01000817",867,292,104,188,540,32,142,41,73,28,147,92,47,8,211,146,65,8,8,35,16,19
"2021","Swansea 009B","W01000818",655,203,111,92,415,80,128,40,63,25,64,27,32,5,140,94,46,3,3,37,21,16
"2021","Swansea 009C","W01000819",638,172,111,61,430,132,197,75,63,59,54,23,26,5,43,25,18,4,4,36,19,17
"2021","Swansea 009D","W01000820",618,224,90,134,376,68,157,51,56,50,82,35,45,2,64,41,23,5,5,18,6,12
"2021","Swansea 009E","W01000821",628,189,93,96,410,69,206,66,99,41,64,30,26,8,67,38,29,4,4,29,13,16
"2021","Swansea 009F","W01000822",581,193,126,67,373,122,157,80,47,30,47,26,16,5,47,27,20,0,0,15,5,10
"2021","Swansea 010A","W01000794",924,234,54,180,648,56,348,135,156,57,132,60,63,9,111,76,35,1,1,42,16,26
"2021","Swansea 010B","W01000797",653,183,90,93,448,88,227,92,79,56,59,32,24,3,73,46,27,1,1,22,12,10
"2021","Swansea 010C","W01000798",649,208,126,82,417,100,188,63,70,55,63,27,31,5,66,40,26,0,0,24,6,18
"2021","Swansea 010D","W01000799",760,218,77,141,502,24,175,49,86,40,115,48,58,9,185,133,52,3,3,40,24,16
"2021","Swansea 011A","W01000830",710,199,57,142,479,20,151,37,85,29,73,18,48,7,226,179,47,9,9,32,23,9
"2021","Swansea 011B","W01000832",748,329,111,218,388,28,155,65,57,33,66,18,40,8,130,92,38,9,9,31,16,15
"2021","Swansea 011C","W01000833",737,279,73,206,436,34,147,40,71,36,78,28,43,7,174,141,33,3,3,22,12,10
"2021","Swansea 011D","W01000834",559,148,82,66,380,47,132,38,61,33,49,13,31,5,146,101,45,6,6,31,15,16
"2021","Swansea 011E","W01000836",913,215,53,162,652,29,257,70,153,34,130,52,69,9,230,164,66,6,6,46,24,22
"2021","Swansea 012A","W01000759",670,213,130,83,435,115,206,85,78,43,61,29,27,5,47,25,22,6,6,22,10,12
"2021","Swansea 012B","W01000777",766,240,145,95,498,122,250,76,100,74,60,30,24,6,65,41,24,1,1,28,7,21
"2021","Swansea 012C","W01000778",763,206,76,130,526,60,269,98,115,56,96,53,35,8,97,58,39,4,4,31,13,18
"2021","Swansea 012D","W01000779",590,155,70,85,409,58,193,54,91,48,52,19,27,6,102,50,52,4,4,26,15,11
"2021","Swansea 013A","W01000760",708,250,99,151,419,51,172,58,73,41,92,48,36,8,103,68,35,1,1,39,18,21
"2021","Swansea 013B","W01000761",635,190,84,106,403,48,180,52,83,45,85,38,37,10,90,56,34,0,0,42,16,26
"2021","Swansea 013C","W01000762",619,132,59,73,442,41,162,50,80,32,77,17,47,13,151,104,47,11,11,45,29,16
"2021","Swansea 013D","W01000831",809,277,111,166,512,38,169,62,70,37,75,28,37,10,224,178,46,6,6,20,4,16
"2021","Swansea 013E","W01000835",602,204,127,77,373,48,152,42,73,37,55,15,34,6,116,71,45,2,2,25,14,11
"2021","Swansea 014A","W01000738",735,220,85,135,471,39,166,50,74,42,65,22,36,7,201,132,69,0,0,44,24,20
"2021","Swansea 014B","W01000739",1114,471,72,399,598,39,215,79,84,52,154,107,41,6,180,125,55,10,10,45,13,32
"2021","Swansea 014C","W01000740",621,184,95,89,411,95,193,73,62,58,64,24,34,6,56,24,32,3,3,26,16,10
"2021","Swansea 014D","W01000741",861,294,117,177,538,59,185,67,77,41,143,72,67,4,145,89,56,6,6,29,13,16
"2021","Swansea 015A","W01000763",613,168,65,103,427,40,180,66,65,49,83,38,39,6,118,80,38,6,6,18,7,11
"2021","Swansea 015B","W01000764",714,239,75,164,442,46,179,69,76,34,94,51,36,7,117,61,56,6,6,33,13,20
"2021","Swansea 015C","W01000765",757,258,77,181,475,60,218,94,72,52,88,42,41,5,107,68,39,2,2,24,11,13
"2021","Swansea 015D","W01000766",625,171,77,94,434,54,202,73,81,48,81,33,41,7,95,61,34,2,2,20,9,11
"2021","Swansea 015E","W01000767",715,325,147,178,366,59,160,53,66,41,44,23,18,3,102,56,46,1,1,24,8,16
"2021","Swansea 016A","W01000742",806,382,94,288,388,31,155,47,79,29,63,31,22,10,130,82,48,9,9,36,10,26
"2021","Swansea 016B","W01000744",767,346,68,278,376,27,139,50,63,26,110,65,37,8,86,53,33,14,14,45,12,33
"2021","Swansea 016C","W01000787",672,257,64,193,386,35,159,57,71,31,91,57,32,2,95,64,31,6,6,29,6,23
"2021","Swansea 016D","W01000788",713,267,94,173,416,37,146,59,55,32,98,56,33,9,129,79,50,6,6,30,15,15
"2021","Swansea 016E","W01000789",635,215,73,142,394,38,135,35,60,40,98,44,49,5,112,67,45,11,11,26,10,16
"2021","Swansea 016F","W01000790",908,392,100,292,456,41,197,57,101,39,101,65,30,6,109,58,51,8,8,60,24,36
"2021","Swansea 017A","W01000755",887,306,136,170,541,64,252,93,104,55,114,48,58,8,101,64,37,10,10,40,19,21
"2021","Swansea 017B","W01000756",725,307,84,223,396,40,158,53,64,41,59,26,26,7,136,81,55,3,3,22,9,13
"2021","Swansea 017C","W01000757",699,278,180,98,400,89,176,62,69,45,56,31,21,4,77,38,39,2,2,21,8,13
"2021","Swansea 017D","W01000758",808,260,101,159,517,66,261,80,126,55,100,54,38,8,83,52,31,7,7,31,14,17
"2021","Swansea 018A","W01000772",619,154,93,61,447,93,260,96,100,64,43,16,23,4,51,34,17,0,0,18,10,8
"2021","Swansea 018B","W01000828",729,199,123,76,509,147,248,100,90,58,64,36,28,0,48,16,32,2,2,21,9,12
"2021","Swansea 018C","W01000829",853,278,145,133,527,94,253,89,102,62,84,43,40,1,93,49,44,3,3,48,20,28
"2021","Swansea 019A","W01000862",688,196,51,145,468,7,109,29,59,21,86,24,55,7,258,211,47,8,8,24,13,11
"2021","Swansea 019B","W01000863",764,305,107,198,427,22,95,23,56,16,71,21,43,7,234,178,56,5,5,32,13,19
"2021","Swansea 019C","W01000864",674,197,56,141,444,12,133,30,80,23,81,15,62,4,206,167,39,12,12,33,17,16
"2021","Swansea 019D","W01000865",588,174,75,99,396,35,166,50,81,35,80,25,52,3,108,67,41,7,7,18,7,11
"2021","Swansea 019E","W01000866",494,142,64,78,328,20,103,32,40,31,68,37,28,3,132,98,34,5,5,24,11,13
"2021","Swansea 019F","W01000867",570,189,66,123,366,31,112,44,39,29,61,18,35,8,161,110,51,1,1,15,7,8
"2021","Swansea 021A","W01000849",1021,357,103,254,599,42,216,82,93,41,150,79,60,11,183,130,53,8,8,65,14,51
"2021","Swansea 021C","W01000851",731,252,83,169,434,54,163,53,68,42,88,53,29,6,127,93,34,2,2,45,17,28
"2021","Swansea 021D","W01000852",614,178,79,99,368,41,157,58,55,44,82,44,29,9,79,48,31,9,9,68,14,54
"2021","Swansea 021E","W01001995",637,252,102,150,332,39,133,55,52,26,64,36,22,6,90,64,26,6,6,53,14,39
"2021","Swansea 021F","W01001996",821,406,89,317,364,59,138,82,43,13,87,77,9,1,50,29,21,30,30,51,8,43
"2021","Swansea 022A","W01000853",722,209,82,127,485,72,253,69,130,54,87,60,24,3,69,47,22,4,4,28,10,18
"2021","Swansea 022B","W01000854",588,124,47,77,440,68,247,87,125,35,59,28,27,4,62,38,24,4,4,24,13,11
"2021","Swansea 022C","W01000855",639,206,129,77,408,105,216,90,79,47,44,23,20,1,43,22,21,0,0,25,15,10
"2021","Swansea 022D","W01000856",923,477,202,275,420,48,179,52,94,33,69,38,23,8,104,67,37,20,20,26,12,14
"2021","Swansea 022E","W01000857",978,472,304,168,462,105,174,51,89,34,65,37,28,0,109,67,42,9,9,44,13,31
"2021","Swansea 024A","W01000747",669,290,44,246,241,8,110,32,63,15,63,47,13,3,50,33,17,10,10,138,13,125
"2021","Swansea 024B","W01000868",480,126,60,66,336,70,148,53,69,26,70,47,20,3,48,29,19,0,0,18,5,13
"2021","Swansea 024C","W01000869",684,308,84,224,282,43,126,52,52,22,54,39,12,3,47,33,14,12,12,94,8,86
"2021","Swansea 024D","W01000870",583,246,67,179,231,30,115,42,43,30,46,38,8,0,33,19,14,7,7,106,9,97
"2021","Swansea 024E","W01000872",631,201,91,110,399,67,194,64,97,33,71,46,25,0,55,23,32,12,12,31,6,25
"2021","Swansea 024F","W01000874",614,171,64,107,239,21,121,45,52,24,52,35,15,2,40,17,23,5,5,204,11,193
"2021","Swansea 025B","W01000745",1015,490,101,389,348,25,139,51,65,23,80,70,9,1,89,64,25,15,15,177,26,151
"2021","Swansea 025C","W01000746",717,326,86,240,311,30,99,44,37,18,101,62,38,1,71,42,29,10,10,80,9,71
"2021","Swansea 025F","W01001955",1252,936,191,745,278,20,92,65,21,6,109,97,11,1,39,19,20,18,18,38,3,35
"2021","Swansea 025H","W01001958",799,463,111,352,278,48,100,68,26,6,81,77,4,0,30,19,11,19,19,58,1,57
"2021","Swansea 025I","W01001997",1099,658,180,478,348,48,133,81,39,13,107,96,9,2,46,21,25,14,14,93,12,81
"2021","Swansea 026A","W01000749",903,419,237,182,339,56,142,46,65,31,64,40,17,7,70,45,25,7,7,145,18,127
"2021","Swansea 026B","W01000871",805,376,64,312,246,22,88,35,37,16,78,62,13,3,46,25,21,12,12,183,15,168
"2021","Swansea 026C","W01000873",531,197,33,164,131,15,59,19,27,13,29,24,5,0,21,13,8,7,7,203,11,192
"2021","Swansea 026D","W01000875",740,289,74,215,194,20,84,30,41,13,58,44,13,1,27,15,12,5,5,257,10,247
"2021","Swansea 026E","W01000876",564,137,38,99,186,22,65,27,26,12,39,25,14,0,55,38,17,5,5,241,9,232
"2021","Swansea 027A","W01000858",680,187,93,94,447,68,244,81,119,44,71,37,26,8,47,26,21,17,17,46,6,40
"2021","Swansea 027B","W01000859",655,214,151,63,419,144,210,74,92,44,36,22,14,0,27,14,13,2,2,22,5,17
"2021","Swansea 027C","W01000860",651,164,121,43,471,128,272,97,126,49,39,19,15,5,31,14,17,1,1,16,9,7
"2021","Swansea 027D","W01000861",434,175,102,73,239,57,111,35,57,19,42,20,21,1,25,16,9,4,4,20,1,19
"2021","Swansea 028A","W01000736",770,210,117,93,544,155,274,84,139,51,45,23,18,4,70,41,29,0,0,16,6,10
"2021","Swansea 028B","W01000737",690,238,168,70,434,108,221,88,90,43,30,17,7,6,70,28,42,5,5,18,11,7
"2021","Swansea 028C","W01000804",708,285,205,80,410,132,213,83,91,39,35,17,17,1,30,23,7,0,0,13,4,9
"2021","Swansea 028D","W01000805",471,98,68,30,355,82,209,74,96,39,34,14,17,3,29,13,16,1,1,18,7,11
"2021","Swansea 029A","W01000879",753,230,157,73,506,134,259,85,131,43,58,33,22,3,54,21,33,1,1,17,3,14
"2021","Swansea 029B","W01000880",754,266,178,88,462,144,215,91,91,33,61,36,22,3,39,17,22,3,3,26,8,18
"2021","Swansea 029C","W01000881",688,363,163,200,311,66,112,38,55,19,46,26,18,2,86,47,39,1,1,14,6,8
"2021","Swansea 029D","W01000882",818,294,154,140,507,67,188,63,84,41,89,51,33,5,161,95,66,2,2,17,6,11
"2021","Swansea 030A","W01000775",694,200,113,87,452,127,225,118,71,36,55,23,30,2,43,17,26,2,2,42,20,22
"2021","Swansea 030B","W01000776",725,173,117,56,492,144,262,108,93,61,40,21,17,2,43,21,22,3,3,60,25,35
"2021","Swansea 030C","W01000839",465,153,106,47,288,90,130,34,60,36,39,14,21,4,27,16,11,2,2,24,8,16
"2021","Swansea 030D","W01000840",700,205,151,54,472,145,250,91,105,54,32,20,12,0,43,19,24,2,2,23,8,15
"2021","Swansea 031A","W01000823",780,230,157,73,526,159,270,87,138,45,46,19,22,5,47,30,17,4,4,24,9,15
"2021","Swansea 031B","W01000824",753,294,150,144,440,130,212,70,100,42,43,27,14,2,54,33,21,1,1,19,9,10
"2021","Swansea 031C","W01000825",650,261,117,144,356,83,168,68,67,33,61,38,22,1,42,26,16,2,2,33,9,24
"2021","Swansea 031D","W01000826",603,208,110,98,373,99,201,95,71,35,37,19,16,2,33,18,15,3,3,22,6,16
"2021","Swansea 031E","W01000827",586,212,115,97,346,93,174,68,87,19,36,21,15,0,38,17,21,5,5,28,7,21
"2021","Swansea 032A","W01000768",606,200,113,87,387,74,194,68,84,42,57,27,24,6,62,35,27,0,0,19,9,10
"2021","Swansea 032B","W01000769",601,167,98,69,411,97,186,58,82,46,57,28,28,1,67,36,31,4,4,23,11,12
"2021","Swansea 032D","W01000770",641,153,88,65,471,88,248,83,108,57,66,25,37,4,66,35,31,3,3,17,6,11
"2021","Swansea 032G","W01000771",538,130,84,46,386,83,192,53,86,53,56,32,22,2,50,27,23,5,5,22,9,13
"2021","Swansea 032E","W01000781",705,186,127,59,503,155,248,81,111,56,44,14,22,8,54,26,28,2,2,16,11,5
"2021","Swansea 032F","W01000782",514,179,105,74,327,73,172,66,65,41,45,28,15,2,36,18,18,1,1,8,3,5
"2021","Swansea 032C","W01001956",813,289,162,127,496,99,257,95,116,46,79,45,33,1,58,33,25,3,3,28,10,18
"2021","Neath Port Talbot 002A","W01000918",865,274,136,138,559,96,277,93,116,68,90,41,36,13,94,42,52,2,2,32,11,21
"2021","Neath Port Talbot 002B","W01000944",511,169,81,88,321,50,161,71,56,34,41,14,25,2,67,37,30,2,2,21,11,10
"2021","Neath Port Talbot 002C","W01000965",867,247,138,109,582,98,251,100,92,59,87,35,47,5,140,86,54,6,6,38,15,23
"2021","Neath Port Talbot 003A","W01000893",818,232,103,129,555,83,259,104,87,68,99,44,50,5,110,67,43,4,4,31,18,13
"2021","Neath Port Talbot 003B","W01000925",665,219,104,115,414,63,169,65,63,41,64,21,36,7,113,83,30,5,5,32,18,14
"2021","Neath Port Talbot 003C","W01000926",868,288,155,133,553,128,233,93,81,59,95,45,39,11,94,60,34,3,3,27,14,13
"2021","Neath Port Talbot 004A","W01000888",1112,290,123,167,795,90,414,152,170,92,153,77,67,9,134,80,54,4,4,27,15,12
"2021","Neath Port Talbot 004B","W01000946",721,190,84,106,503,70,233,87,96,50,87,37,43,7,109,71,38,4,4,28,12,16
"2021","Neath Port Talbot 004C","W01000947",899,251,105,146,610,78,230,73,113,44,129,50,73,6,166,113,53,7,7,38,18,20
"2021","Neath Port Talbot 004D","W01000948",873,346,174,172,487,70,233,91,80,62,93,49,38,6,85,52,33,6,6,40,7,33
"2021","Neath Port Talbot 004E","W01000955",597,184,89,95,392,71,199,60,83,56,68,35,28,5,52,34,18,2,2,21,7,14
"2021","Neath Port Talbot 004F","W01000956",535,137,98,39,383,117,182,79,58,45,47,23,17,7,36,15,21,1,1,15,6,9
"2021","Neath Port Talbot 004G","W01000971",595,165,75,90,405,68,187,62,73,52,55,27,24,4,92,60,32,3,3,25,13,12
"2021","Neath Port Talbot 006C","W01000904",655,178,86,92,460,98,233,86,98,49,66,34,30,2,60,36,24,3,3,17,8,9
"2021","Neath Port Talbot 006D","W01000905",643,190,83,107,429,60,189,52,86,51,61,24,34,3,113,71,42,6,6,24,12,12
"2021","Neath Port Talbot 006E","W01000908",743,250,150,100,476,111,234,75,87,72,73,34,30,9,55,24,31,3,3,17,6,11
"2021","Neath Port Talbot 006F","W01001985",923,261,189,72,649,201,322,109,127,86,68,23,40,5,57,29,28,1,1,13,7,6
"2021","Neath Port Talbot 007B","W01000907",748,246,125,121,472,78,179,53,86,40,68,34,25,9,140,85,55,7,7,30,12,18
"2021","Neath Port Talbot 007C","W01000922",734,289,123,166,422,52,194,72,73,49,73,27,39,7,97,58,39,6,6,23,10,13
"2021","Neath Port Talbot 007E","W01001986",1128,322,201,121,776,203,372,160,118,94,95,56,34,5,101,53,48,5,5,30,14,16
"2021","Neath Port Talbot 008A","W01000934",640,278,98,180,348,41,121,58,42,21,80,39,36,5,98,65,33,8,8,14,6,8
"2021","Neath Port Talbot 008B","W01000935",837,416,147,269,391,48,143,60,53,30,76,45,28,3,117,70,47,7,7,30,15,15
"2021","Neath Port Talbot 008C","W01000938",637,229,148,81,387,86,186,68,82,36,53,18,26,9,58,30,28,4,4,21,8,13
"2021","Neath Port Talbot 008D","W01000939",655,396,157,239,236,45,70,29,23,18,50,32,17,1,67,36,31,4,4,23,6,17
"2021","Neath Port Talbot 008E","W01000940",578,207,93,114,349,44,115,48,41,26,60,20,32,8,126,88,38,4,4,22,9,13
"2021","Neath Port Talbot 009A","W01000909",487,132,69,63,342,86,137,47,51,39,44,19,19,6,71,40,31,4,4,13,4,9
"2021","Neath Port Talbot 009B","W01000910",648,208,113,95,415,105,202,101,48,53,61,24,31,6,46,28,18,1,1,25,13,12
"2021","Neath Port Talbot 009C","W01000911",494,118,66,52,367,82,189,72,72,45,53,24,25,4,43,24,19,0,0,9,5,4
"2021","Neath Port Talbot 009D","W01000969",653,151,73,78,482,62,276,112,110,54,78,45,29,4,66,38,28,0,0,20,11,9
"2021","Neath Port Talbot 010A","W01000912",563,216,95,121,315,40,131,45,47,39,60,30,23,7,81,50,31,3,3,32,11,21
"2021","Neath Port Talbot 010B","W01000913",546,224,89,135,298,40,135,44,59,32,52,32,18,2,70,46,24,1,1,24,17,7
"2021","Neath Port Talbot 010C","W01000914",692,235,83,152,428,46,150,52,52,46,81,24,48,9,148,97,51,3,3,29,13,16
"2021","Neath Port Talbot 010D","W01000915",486,125,54,71,341,55,138,47,57,34,75,45,25,5,72,42,30,1,1,20,12,8
"2021","Neath Port Talbot 010E","W01000916",493,146,62,84,331,40,166,65,66,35,62,32,22,8,62,38,24,1,1,16,5,11
"2021","Neath Port Talbot 010G","W01001987",602,134,51,83,442,58,220,65,110,45,84,35,43,6,78,56,22,2,2,26,12,14
"2021","Neath Port Talbot 010H","W01001988",591,154,16,138,420,13,247,62,157,28,112,64,45,3,47,32,15,1,1,17,10,7
"2021","Neath Port Talbot 010I","W01001989",584,129,53,76,422,77,224,78,96,50,69,29,36,4,48,28,20,4,4,33,14,19
"2021","Neath Port Talbot 012A","W01000936",629,218,65,153,390,30,156,54,59,43,67,26,37,4,131,88,43,6,6,21,5,16
"2021","Neath Port Talbot 012B","W01000941",659,207,69,138,419,35,179,64,76,39,85,40,34,11,116,81,35,4,4,33,15,18
"2021","Neath Port Talbot 012C","W01000942",787,251,75,176,513,56,188,54,83,51,79,39,32,8,184,130,54,6,6,23,14,9
"2021","Neath Port Talbot 012D","W01000943",609,124,71,53,475,101,247,80,100,67,65,35,25,5,61,30,31,1,1,10,3,7
"2021","Neath Port Talbot 013A","W01000894",665,231,127,104,412,78,174,59,70,45,88,36,45,7,69,38,31,3,3,22,11,11
"2021","Neath Port Talbot 013B","W01000895",799,387,117,270,389,44,147,66,54,27,77,38,33,6,118,82,36,3,3,23,7,16
"2021","Neath Port Talbot 013C","W01000896",649,185,56,129,423,34,144,45,52,47,77,18,50,9,158,112,46,10,10,41,24,17
"2021","Neath Port Talbot 013D","W01000897",613,205,81,124,389,69,154,53,55,46,60,36,22,2,104,69,35,2,2,19,11,8
"2021","Neath Port Talbot 013E","W01000937",936,394,129,265,514,60,215,83,88,44,103,44,54,5,130,97,33,6,6,28,14,14
"2021","Neath Port Talbot 014A","W01000898",646,188,94,94,438,70,202,75,80,47,84,42,37,5,77,41,36,5,5,20,9,11
"2021","Neath Port Talbot 014B","W01000899",795,205,106,99,574,101,309,105,144,60,82,37,40,5,81,47,34,1,1,16,10,6
"2021","Neath Port Talbot 014C","W01000900",794,348,152,196,421,53,160,81,47,32,80,37,33,10,127,75,52,1,1,25,12,13
"2021","Neath Port Talbot 014D","W01000901",753,234,93,141,496,72,214,90,76,48,87,42,33,12,120,87,33,3,3,23,11,12
"2021","Neath Port Talbot 014E","W01000945",506,148,70,78,329,53,163,68,58,37,48,22,22,4,65,39,26,0,0,29,12,17
"2021","Neath Port Talbot 015A","W01000889",807,242,114,128,535,107,250,89,111,50,102,59,34,9,73,40,33,3,3,30,16,14
"2021","Neath Port Talbot 015B","W01000890",691,184,95,89,489,120,253,97,102,54,68,36,25,7,45,19,26,3,3,18,7,11
"2021","Neath Port Talbot 015C","W01000891",632,208,96,112,400,55,165,59,63,43,78,33,41,4,99,60,39,3,3,24,14,10
"2021","Neath Port Talbot 015D","W01000892",826,214,123,91,577,124,274,75,135,64,85,35,45,5,91,55,36,3,3,35,19,16
"2021","Neath Port Talbot 016A","W01000883",610,189,118,71,406,99,215,104,51,60,42,23,16,3,50,29,21,0,0,15,8,7
"2021","Neath Port Talbot 016B","W01000958",638,183,81,102,415,36,147,52,59,36,62,25,28,9,163,105,58,7,7,40,24,16
"2021","Neath Port Talbot 016C","W01000961",703,242,113,129,421,57,175,59,66,50,63,19,35,9,122,76,46,4,4,40,22,18
"2021","Neath Port Talbot 016D","W01000962",602,161,70,91,407,32,161,53,76,32,58,12,40,6,152,97,55,4,4,34,23,11
"2021","Neath Port Talbot 016E","W01000963",792,249,133,116,496,60,177,60,76,41,88,32,45,11,165,88,77,6,6,47,14,33
"2021","Neath Port Talbot 016F","W01000964",765,278,136,142,450,46,170,62,68,40,89,33,48,8,138,88,50,7,7,37,15,22
"2021","Neath Port Talbot 017A","W01000884",585,216,60,156,329,31,128,48,55,25,65,32,28,5,95,58,37,10,10,40,13,27
"2021","Neath Port Talbot 017B","W01000885",666,246,108,138,395,34,175,65,72,38,71,26,39,6,111,75,36,4,4,25,10,15
"2021","Neath Port Talbot 017C","W01000886",745,298,83,215,406,24,151,55,68,28,83,41,35,7,140,102,38,8,8,41,17,24
"2021","Neath Port Talbot 017D","W01000957",832,364,156,208,433,84,135,51,40,44,63,25,30,8,137,86,51,14,14,35,13,22
"2021","Neath Port Talbot 017E","W01000959",755,217,101,116,505,77,255,108,94,53,75,39,35,1,94,56,38,4,4,33,16,17
"2021","Neath Port Talbot 017F","W01000960",811,294,123,171,475,49,201,80,77,44,81,37,41,3,140,89,51,4,4,42,25,17
"2021","Neath Port Talbot 018A","W01000949",563,164,73,91,373,69,176,65,62,49,69,32,33,4,57,37,20,2,2,26,12,14
"2021","Neath Port Talbot 018B","W01000950",661,217,82,135,409,51,181,75,71,35,82,42,36,4,91,54,37,4,4,35,19,16
"2021","Neath Port Talbot 018C","W01000951",826,352,100,252,437,42,190,62,87,41,97,47,41,9,102,71,31,6,6,37,18,19
"2021","Neath Port Talbot 018D","W01000952",487,147,63,84,315,41,163,51,72,40,51,26,22,3,57,33,24,3,3,25,15,10
"2021","Neath Port Talbot 018E","W01000966",659,229,88,141,404,70,168,68,51,49,80,43,35,2,82,52,30,4,4,26,14,12
"2021","Neath Port Talbot 019A","W01000932",475,176,78,98,282,48,110,45,38,27,58,20,30,8,66,46,20,0,0,17,8,9
"2021","Neath Port Talbot 019B","W01000933",759,151,61,90,571,80,355,107,180,68,78,40,32,6,56,35,21,2,2,37,15,22
"2021","Neath Port Talbot 019C","W01000967",671,278,95,183,361,41,145,54,53,38,56,27,27,2,111,74,37,8,8,32,19,13
"2021","Neath Port Talbot 019D","W01000968",860,240,114,126,584,86,261,105,103,53,103,53,45,5,129,96,33,5,5,36,14,22
"2021","Neath Port Talbot 020A","W01000919",509,145,65,80,348,57,164,69,60,35,60,27,28,5,64,35,29,3,3,16,7,9
"2021","Neath Port Talbot 020B","W01000927",883,253,92,161,591,56,278,97,143,38,126,61,58,7,124,83,41,7,7,39,19,20
"2021","Neath Port Talbot 020C","W01000928",707,239,114,125,438,80,199,71,81,47,70,33,28,9,84,51,33,5,5,30,17,13
"2021","Neath Port Talbot 020D","W01000929",554,175,97,78,351,53,161,69,55,37,58,19,35,4,77,37,40,2,2,28,14,14
"2021","Neath Port Talbot 020E","W01000931",591,187,92,95,369,55,171,64,63,44,70,25,40,5,70,47,23,3,3,35,19,16
"2021","Neath Port Talbot 020F","W01000973",657,268,113,155,371,53,150,59,50,41,68,27,33,8,96,61,35,4,4,18,9,9
"2021","Neath Port Talbot 020G","W01001900",671,254,94,160,390,53,158,56,57,45,76,38,33,5,102,57,45,1,1,27,11,16
"2021","Neath Port Talbot 021C","W01000887",942,223,110,113,664,86,328,101,156,71,94,43,46,5,147,98,49,9,9,55,33,22
"2021","Neath Port Talbot 021G","W01000921",643,223,86,137,388,58,133,50,45,38,66,16,46,4,131,90,41,0,0,32,12,20
"2021","Neath Port Talbot 021F","W01000930",546,219,95,124,311,43,116,50,34,32,57,22,28,7,88,49,39,7,7,16,9,7
"2021","Neath Port Talbot 021B","W01000953",729,242,106,136,454,76,218,104,57,57,71,42,25,4,87,59,28,2,2,33,13,20
"2021","Neath Port Talbot 021A","W01000954",631,215,105,110,393,62,176,69,60,47,65,36,26,3,87,54,33,3,3,23,10,13
"2021","Neath Port Talbot 021D","W01000970",477,160,82,78,293,42,125,41,51,33,59,29,27,3,63,32,31,4,4,24,9,15
"2021","Neath Port Talbot 021E","W01001990",919,271,121,150,605,102,271,111,71,89,117,59,46,12,107,71,36,8,8,43,18,25
"2021","Bridgend 001A","W01000991",454,142,66,76,290,17,105,40,32,33,70,24,39,7,94,70,24,4,4,22,11,11
"2021","Bridgend 001B","W01000992",614,198,79,119,386,42,154,65,43,46,94,29,49,16,91,58,33,5,5,30,13,17
"2021","Bridgend 001C","W01000993",590,170,75,95,390,60,143,51,45,47,84,25,49,10,101,71,30,2,2,30,12,18
"2021","Bridgend 001D","W01000994",585,170,72,98,380,56,146,56,56,34,71,30,40,1,106,72,34,1,1,35,14,21
"2021","Bridgend 001E","W01000995",648,239,110,129,400,73,169,68,69,32,75,33,38,4,81,48,33,2,2,9,7,2
"2021","Bridgend 002A","W01001014",777,300,162,138,453,72,187,81,48,58,81,32,44,5,106,76,30,7,7,24,9,15
"2021","Bridgend 002B","W01001015",605,167,88,79,410,55,188,64,75,49,72,22,45,5,95,62,33,0,0,28,10,18
"2021","Bridgend 002C","W01001017",610,164,84,80,422,71,211,86,72,53,69,25,37,7,69,40,29,2,2,24,16,8
"2021","Bridgend 002D","W01001018",631,252,101,151,360,57,152,64,47,41,58,26,28,4,89,55,34,4,4,19,9,10
"2021","Bridgend 002E","W01001020",634,229,79,150,382,48,190,87,72,31,50,20,27,3,92,52,40,2,2,23,9,14
"2021","Bridgend 003A","W01000976",449,124,57,67,302,43,118,45,49,24,77,25,42,10,61,40,21,3,3,23,14,9
"2021","Bridgend 003B","W01000977",574,162,73,89,380,55,156,75,53,28,81,33,40,8,83,52,31,5,5,32,21,11
"2021","Bridgend 003C","W01001024",528,182,62,120,333,41,126,54,33,39,66,27,33,6,98,69,29,2,2,13,3,10
"2021","Bridgend 003D","W01001025",521,146,54,92,357,48,148,53,59,36,70,34,31,5,90,62,28,1,1,18,8,10
"2021","Bridgend 003E","W01001033",751,213,94,119,515,80,238,74,105,59,100,34,61,5,94,64,30,3,3,23,7,16
"2021","Bridgend 003F","W01001034",637,233,96,137,376,52,165,68,50,47,71,34,29,8,84,60,24,4,4,28,8,20
"2021","Bridgend 004A","W01000975",873,202,94,108,621,71,239,89,78,72,121,39,67,15,183,109,74,7,7,50,25,25
"2021","Bridgend 004B","W01000978",780,253,113,140,489,68,215,79,79,57,104,41,57,6,98,58,40,4,4,38,22,16
"2021","Bridgend 004C","W01001009",499,126,50,76,336,51,166,66,61,39,65,37,24,4,52,28,24,2,2,37,24,13
"2021","Bridgend 004D","W01001042",582,200,68,132,353,51,143,53,58,32,66,29,29,8,86,51,35,7,7,29,16,13
"2021","Bridgend 004E","W01001043",511,156,57,99,333,38,138,54,49,35,84,42,35,7,68,41,27,5,5,22,12,10
"2021","Bridgend 005A","W01001012",593,121,62,59,444,76,245,80,95,70,56,29,25,2,67,44,23,0,0,28,20,8
"2021","Bridgend 005B","W01001013",634,190,125,65,414,81,201,74,73,54,54,20,24,10,76,42,34,2,2,30,13,17
"2021","Bridgend 005C","W01001016",744,211,122,89,513,143,206,88,70,48,78,35,38,5,84,46,38,2,2,20,9,11
"2021","Bridgend 005D","W01001019",626,174,92,82,410,63,177,64,75,38,64,27,30,7,101,54,47,5,5,42,18,24
"2021","Bridgend 006A","W01000974",1049,313,141,172,688,91,341,148,125,68,145,74,61,10,109,68,41,2,2,48,17,31
"2021","Bridgend 006B","W01001057",804,269,103,166,509,54,219,98,77,44,93,41,45,7,141,100,41,2,2,26,10,16
"2021","Bridgend 006C","W01001058",783,226,90,136,525,64,262,81,119,62,88,45,36,7,109,65,44,2,2,32,22,10
"2021","Bridgend 007A","W01000986",733,210,65,145,489,49,223,87,92,44,119,71,44,4,95,60,35,3,3,34,16,18
"2021","Bridgend 007B","W01000987",1049,309,116,193,689,70,320,108,142,70,132,74,52,6,153,100,53,14,14,51,21,30
"2021","Bridgend 007C","W01001055",496,143,75,68,327,39,130,33,61,36,63,23,38,2,91,50,41,4,4,26,10,16
"2021","Bridgend 007D","W01001056",518,136,88,48,347,70,161,65,43,53,50,25,20,5,62,30,32,4,4,35,17,18
"2021","Bridgend 008A","W01000996",646,186,111,75,424,64,212,81,80,51,76,25,45,6,66,27,39,6,6,36,17,19
"2021","Bridgend 008B","W01001048",655,220,92,128,415,81,204,84,83,37,66,30,31,5,61,36,25,3,3,20,9,11
"2021","Bridgend 008C","W01001049",517,135,65,70,351,38,148,46,63,39,68,32,25,11,92,50,42,5,5,31,24,7
"2021","Bridgend 008D","W01001050",651,185,87,98,423,51,187,81,71,35,78,23,47,8,102,55,47,5,5,43,20,23
"2021","Bridgend 008E","W01001051",743,199,86,113,507,59,213,74,85,54,89,28,54,7,145,100,45,1,1,37,17,20
"2021","Bridgend 008F","W01001052",586,200,106,94,360,40,141,71,49,21,75,26,43,6,100,55,45,4,4,26,13,13
"2021","Bridgend 009A","W01001004",476,175,90,85,277,36,120,36,55,29,53,29,19,5,66,32,34,2,2,24,12,12
"2021","Bridgend 009B","W01001005",735,231,125,106,477,91,243,111,94,38,63,44,18,1,76,44,32,4,4,27,13,14
"2021","Bridgend 009C","W01001006",954,226,136,90,688,172,329,120,134,75,113,55,52,6,70,31,39,4,4,40,25,15
"2021","Bridgend 009D","W01001007",757,185,77,108,544,75,256,72,139,45,81,38,40,3,130,89,41,2,2,28,13,15
"2021","Bridgend 009E","W01001039",685,148,74,74,500,89,257,96,104,57,78,34,39,5,74,45,29,2,2,37,19,18
"2021","Bridgend 009F","W01001040",675,190,97,93,461,87,221,88,85,48,77,43,27,7,74,46,28,2,2,24,11,13
"2021","Bridgend 010A","W01000999",613,193,99,94,391,70,176,62,71,43,63,27,30,6,77,43,34,5,5,29,20,9
"2021","Bridgend 010B","W01001000",740,195,91,104,514,99,236,93,86,57,87,49,31,7,88,53,35,4,4,31,18,13
"2021","Bridgend 010C","W01001001",761,213,119,94,523,88,216,70,93,53,109,36,68,5,107,78,29,3,3,25,15,10
"2021","Bridgend 010D","W01001002",1061,339,94,245,681,50,251,89,120,42,144,57,82,5,228,161,67,8,8,41,15,26
"2021","Bridgend 011B","W01001008",1141,286,159,127,814,183,402,157,161,84,149,95,44,10,76,41,35,4,4,41,19,22
"2021","Bridgend 011C","W01001038",1141,340,147,193,751,97,332,122,163,47,175,99,71,5,140,76,64,7,7,50,14,36
"2021","Bridgend 011D","W01001981",505,78,13,65,409,5,239,62,160,17,121,63,52,6,44,38,6,0,0,18,13,5
"2021","Bridgend 011E","W01001982",541,113,30,83,404,42,192,45,125,22,126,76,45,5,40,31,9,4,4,24,9,15
"2021","Bridgend 011F","W01001983",581,122,18,104,441,31,228,60,151,17,152,97,50,5,29,18,11,1,1,18,11,7
"2021","Bridgend 011G","W01001984",488,121,14,107,351,21,136,36,77,23,128,80,45,3,64,51,13,2,2,16,8,8
"2021","Bridgend 012A","W01000997",778,255,126,129,497,117,200,88,69,43,93,51,40,2,85,39,46,2,2,26,11,15
"2021","Bridgend 012B","W01001010",504,177,67,110,307,45,139,49,56,34,52,22,28,2,67,43,24,4,4,20,12,8
"2021","Bridgend 012C","W01001011",566,170,66,104,378,56,177,68,58,51,67,28,34,5,75,47,28,3,3,18,8,10
"2021","Bridgend 012D","W01001026",868,312,161,151,514,61,213,76,90,47,107,40,57,10,129,71,58,4,4,42,19,23
"2021","Bridgend 013A","W01000989",684,178,94,84,481,97,243,109,81,53,98,59,33,6,41,28,13,2,2,25,9,16
"2021","Bridgend 013B","W01001037",746,180,107,73,540,126,261,89,114,58,82,49,24,9,63,36,27,8,8,26,9,17
"2021","Bridgend 013C","W01001041",922,196,117,79,702,152,404,138,176,90,79,35,38,6,65,36,29,2,2,24,8,16
"2021","Bridgend 014A","W01001021",761,331,123,208,387,36,160,46,76,38,93,52,34,7,88,45,43,10,10,43,17,26
"2021","Bridgend 014B","W01001022",626,202,84,118,398,63,127,43,59,25,69,29,30,10,137,89,48,2,2,26,11,15
"2021","Bridgend 014C","W01001023",820,356,131,225,435,74,171,70,66,35,95,54,37,4,89,47,42,6,6,29,16,13
"2021","Bridgend 014D","W01001028",881,280,129,151,569,107,285,115,109,61,99,62,30,7,75,37,38,3,3,32,7,25
"2021","Bridgend 014E","W01001035",818,320,102,218,451,32,152,55,70,27,106,51,51,4,154,107,47,7,7,47,18,29
"2021","Bridgend 015A","W01000979",703,206,69,137,470,38,206,71,92,43,115,61,51,3,105,68,37,6,6,27,11,16
"2021","Bridgend 015B","W01000983",668,199,63,136,450,34,232,87,111,34,103,57,41,5,75,52,23,6,6,19,5,14
"2021","Bridgend 015C","W01000985",513,101,34,67,392,36,254,107,91,56,56,34,18,4,45,25,20,1,1,20,13,7
"2021","Bridgend 015D","W01001003",578,169,108,61,379,109,188,71,68,49,45,26,17,2,34,8,26,3,3,30,8,22
"2021","Bridgend 016A","W01000980",567,156,65,91,384,37,207,75,81,51,58,27,26,5,79,53,26,3,3,27,17,10
"2021","Bridgend 016B","W01000981",502,141,47,94,334,23,108,39,52,17,67,25,37,5,131,97,34,5,5,27,8,19
"2021","Bridgend 016C","W01000982",638,178,89,89,434,111,181,75,60,46,65,38,24,3,75,35,40,2,2,26,10,16
"2021","Bridgend 016D","W01000984",960,312,93,219,616,62,300,112,140,48,129,70,50,9,114,83,31,11,11,32,13,19
"2021","Bridgend 017B","W01000990",677,229,91,138,418,49,192,60,79,53,71,28,36,7,98,58,40,8,8,30,13,17
"2021","Bridgend 017C","W01001027",713,239,143,96,449,112,205,88,76,41,64,34,26,4,64,41,23,4,4,25,11,14
"2021","Bridgend 017D","W01001036",664,186,113,73,455,83,278,92,124,62,45,25,18,2,48,24,24,1,1,23,10,13
"2021","Bridgend 017E","W01001918",664,101,23,78,534,41,360,86,235,39,74,30,43,1,58,45,13,1,1,29,15,14
"2021","Bridgend 017F","W01001919",551,130,34,96,397,37,227,77,116,34,67,40,24,3,65,40,25,1,1,24,18,6
"2021","Bridgend 017G","W01001920",460,81,22,59,362,34,217,60,116,41,57,26,28,3,54,35,19,0,0,17,9,8
"2021","Bridgend 017H","W01001921",575,119,32,87,431,38,242,71,124,47,66,32,30,4,82,55,27,3,3,25,13,12
"2021","Bridgend 018A","W01001031",633,157,104,53,466,137,239,105,75,59,48,26,22,0,41,16,25,1,1,10,5,5
"2021","Bridgend 018B","W01001032",823,257,157,100,545,140,241,89,85,67,85,40,42,3,75,35,40,4,4,21,10,11
"2021","Bridgend 018C","W01001046",978,491,270,221,439,103,176,71,52,53,62,39,20,3,92,50,42,6,6,48,18,30
"2021","Bridgend 018D","W01001047",761,257,142,115,476,119,234,82,98,54,61,28,25,8,59,39,20,3,3,28,11,17
"2021","Bridgend 018E","W01001053",468,124,90,34,325,121,140,59,46,35,32,20,11,1,32,13,19,0,0,19,8,11
"2021","Bridgend 018F","W01001054",556,172,120,52,356,109,188,75,71,42,38,14,23,1,19,14,5,2,2,28,10,18
"2021","Bridgend 019A","W01001029",817,275,164,111,516,160,246,117,74,55,58,32,18,8,52,30,22,0,0,26,9,17
"2021","Bridgend 019B","W01001030",862,236,136,100,595,140,296,115,126,55,78,42,29,7,76,45,31,5,5,31,11,20
"2021","Bridgend 019C","W01001044",756,294,163,131,430,80,174,72,60,42,79,26,40,13,92,41,51,5,5,32,7,25
"2021","Bridgend 019D","W01001045",777,278,120,158,436,72,211,87,74,50,78,41,31,6,70,40,30,5,5,63,24,39
"2021","Vale of Glamorgan 001A","W01001105",1147,236,144,92,876,188,534,197,246,91,72,38,27,7,78,42,36,4,4,35,10,25
"2021","Vale of Glamorgan 001B","W01001127",710,181,86,95,510,113,292,125,118,49,66,40,22,4,37,23,14,2,2,19,10,9
"2021","Vale of Glamorgan 001C","W01001128",716,179,96,83,508,93,284,114,116,54,67,33,31,3,62,41,21,2,2,29,9,20
"2021","Vale of Glamorgan 002A","W01001082",782,327,219,108,435,138,194,69,97,28,48,26,19,3,52,32,20,3,3,20,11,9
"2021","Vale of Glamorgan 002B","W01001083",713,169,112,57,520,156,276,96,128,52,43,20,22,1,44,23,21,1,1,24,17,7
"2021","Vale of Glamorgan 002C","W01001084",759,267,183,84,470,138,236,83,110,43,43,19,22,2,52,38,14,1,1,22,6,16
"2021","Vale of Glamorgan 002D","W01001085",631,96,54,42,513,112,311,106,149,56,44,19,22,3,44,27,17,2,2,22,7,15
"2021","Vale of Glamorgan 003A","W01001113",948,219,117,102,693,160,419,144,205,70,58,29,21,8,55,33,22,1,1,36,13,23
"2021","Vale of Glamorgan 003B","W01001119",741,157,67,90,550,97,343,124,147,72,69,35,30,4,41,19,22,0,0,34,12,22
"2021","Vale of Glamorgan 003C","W01001135",973,191,92,99,746,139,395,148,179,68,123,87,31,5,86,52,34,3,3,36,16,20
"2021","Vale of Glamorgan 003D","W01001136",695,201,128,73,472,138,211,88,87,36,78,53,24,1,44,28,16,1,1,22,13,9
"2021","Vale of Glamorgan 004A","W01001075",478,119,74,45,333,41,184,59,93,32,52,24,23,5,56,36,20,0,0,26,12,14
"2021","Vale of Glamorgan 004B","W01001076",629,211,70,141,378,33,159,55,73,31,82,51,24,7,101,64,37,3,3,40,23,17
"2021","Vale of Glamorgan 004C","W01001077",617,213,145,68,379,76,188,62,81,45,56,25,26,5,57,33,24,2,2,25,15,10
"2021","Vale of Glamorgan 004D","W01001078",509,138,96,42,340,64,193,45,105,43,42,12,27,3,39,18,21,2,2,31,14,17
"2021","Vale of Glamorgan 004E","W01001104",901,276,124,152,589,112,295,97,152,46,96,56,36,4,83,53,30,3,3,36,16,20
"2021","Vale of Glamorgan 004F","W01001129",589,116,60,56,439,33,223,39,139,45,65,18,39,8,107,66,41,11,11,34,21,13
"2021","Vale of Glamorgan 005A","W01001116",814,290,175,115,498,125,290,106,139,45,41,25,15,1,41,23,18,1,1,26,12,14
"2021","Vale of Glamorgan 005B","W01001123",785,382,214,168,376,80,175,78,65,32,62,44,17,1,56,40,16,3,3,27,6,21
"2021","Vale of Glamorgan 005C","W01001124",693,285,105,180,372,33,170,50,94,26,105,63,38,4,61,38,23,3,3,36,9,27
"2021","Vale of Glamorgan 005D","W01001125",632,243,140,103,362,56,183,44,103,36,71,43,26,2,44,26,18,8,8,27,6,21
"2021","Vale of Glamorgan 005F","W01001130",493,119,60,59,360,49,223,45,130,48,43,16,21,6,45,25,20,0,0,14,11,3
"2021","Vale of Glamorgan 005G","W01002036",772,287,86,201,465,51,176,89,75,12,134,95,38,1,100,74,26,4,4,20,4,16
"2021","Vale of Glamorgan 005H","W01002037",567,236,81,155,306,38,130,70,48,12,89,73,16,0,44,29,15,5,5,25,9,16
"2021","Vale of Glamorgan 006A","W01001086",673,200,121,79,448,114,257,95,114,48,43,25,12,6,34,17,17,0,0,25,12,13
"2021","Vale of Glamorgan 006B","W01001087",638,164,122,42,457,101,226,67,113,46,66,31,28,7,62,33,29,2,2,17,11,6
"2021","Vale of Glamorgan 006C","W01001088",964,314,185,129,608,97,258,97,109,52,112,60,46,6,140,87,53,1,1,42,27,15
"2021","Vale of Glamorgan 006D","W01001089",695,183,116,67,492,94,254,106,92,56,86,53,30,3,57,36,21,1,1,20,11,9
"2021","Vale of Glamorgan 006E","W01001090",634,173,105,68,438,83,236,93,96,47,64,38,22,4,53,28,25,2,2,23,8,15
"2021","Vale of Glamorgan 007A","W01001081",716,234,104,130,440,50,158,53,79,26,83,27,39,17,144,99,45,5,5,42,23,19
"2021","Vale of Glamorgan 007B","W01001092",829,223,100,123,558,58,279,71,141,67,108,35,63,10,109,67,42,4,4,48,28,20
"2021","Vale of Glamorgan 007C","W01001094",513,134,59,75,352,29,120,50,37,33,67,27,35,5,131,91,40,5,5,27,13,14
"2021","Vale of Glamorgan 007D","W01001095",628,242,97,145,359,24,118,45,49,24,71,25,40,6,145,104,41,1,1,27,17,10
"2021","Vale of Glamorgan 007E","W01001096",642,257,118,139,366,59,155,53,69,33,67,33,31,3,82,56,26,3,3,19,7,12
"2021","Vale of Glamorgan 007F","W01001097",586,141,59,82,401,41,137,41,63,33,74,21,48,5,146,113,33,3,3,44,26,18
"2021","Vale of Glamorgan 008A","W01001114",644,142,100,42,473,144,253,79,116,58,44,21,17,6,29,14,15,3,3,29,13,16
"2021","Vale of Glamorgan 008B","W01001115",863,226,158,68,607,97,347,91,194,62,77,32,43,2,82,44,38,4,4,30,13,17
"2021","Vale of Glamorgan 008C","W01001131",736,227,128,99,486,44,205,51,119,35,86,26,49,11,147,106,41,4,4,23,14,9
"2021","Vale of Glamorgan 008D","W01001132",580,156,84,72,406,61,227,74,108,45,53,32,18,3,63,40,23,2,2,18,9,9
"2021","Vale of Glamorgan 008E","W01001133",960,300,165,135,605,183,288,108,126,54,67,39,24,4,65,41,24,2,2,55,28,27
"2021","Vale of Glamorgan 008F","W01001134",518,180,108,72,328,64,189,68,83,38,44,31,11,2,31,20,11,0,0,10,3,7
"2021","Vale of Glamorgan 009A","W01001067",605,215,121,94,360,42,131,40,56,35,68,25,32,11,110,70,40,9,9,30,15,15
"2021","Vale of Glamorgan 009B","W01001068",711,203,60,143,469,48,204,83,85,36,95,48,44,3,117,86,31,5,5,39,16,23
"2021","Vale of Glamorgan 009C","W01001070",525,242,55,187,253,16,78,30,32,16,61,31,25,5,91,63,28,7,7,30,11,19
"2021","Vale of Glamorgan 009D","W01001071",649,201,84,117,403,54,182,79,63,40,70,24,41,5,93,63,30,4,4,45,23,22
"2021","Vale of Glamorgan 009E","W01001072",1050,200,86,114,804,92,475,161,203,111,120,46,67,7,114,76,38,3,3,46,26,20
"2021","Vale of Glamorgan 010A","W01001091",747,218,125,93,498,132,245,102,79,64,57,26,26,5,60,25,35,4,4,31,15,16
"2021","Vale of Glamorgan 010B","W01001098",457,117,81,36,321,109,143,52,57,34,26,10,16,0,40,19,21,3,3,19,9,10
"2021","Vale of Glamorgan 010C","W01001100",632,165,116,49,446,107,274,105,112,57,38,17,17,4,26,14,12,1,1,21,10,11
"2021","Vale of Glamorgan 010D","W01001103",510,127,72,55,352,81,174,70,67,37,51,30,20,1,44,24,20,2,2,31,9,22
"2021","Vale of Glamorgan 011A","W01001106",622,164,92,72,438,104,228,94,87,47,57,25,24,8,49,24,25,0,0,20,9,11
"2021","Vale of Glamorgan 011B","W01001107",725,270,180,90,428,133,212,85,80,47,40,14,22,4,40,17,23,3,3,27,8,19
"2021","Vale of Glamorgan 011C","W01001109",626,209,135,74,386,99,190,66,84,40,47,22,23,2,48,23,25,2,2,31,12,19
"2021","Vale of Glamorgan 011D","W01001110",657,200,86,114,439,81,205,81,81,43,88,51,32,5,62,37,25,3,3,18,6,12
"2021","Vale of Glamorgan 011E","W01001111",568,168,93,75,366,55,136,57,50,29,77,18,42,17,96,55,41,2,2,34,16,18
"2021","Vale of Glamorgan 011F","W01001112",592,183,73,110,391,57,207,82,88,37,58,30,27,1,67,46,21,2,2,18,8,10
"2021","Vale of Glamorgan 012A","W01001063",695,223,75,148,432,44,189,68,83,38,91,45,45,1,102,65,37,6,6,40,14,26
"2021","Vale of Glamorgan 012B","W01001065",669,218,83,135,409,44,203,75,82,46,62,31,30,1,98,65,33,2,2,42,22,20
"2021","Vale of Glamorgan 012C","W01001069",732,272,117,155,423,39,149,53,67,29,96,46,43,7,132,93,39,7,7,37,19,18
"2021","Vale of Glamorgan 012E","W01001079",670,234,76,158,398,28,140,47,64,29,96,38,50,8,130,100,30,4,4,38,11,27
"2021","Vale of Glamorgan 012F","W01001080",637,169,65,104,417,40,158,60,66,32,92,33,48,11,123,76,47,4,4,51,21,30
"2021","Vale of Glamorgan 012G","W01001910",807,341,60,281,428,15,151,60,65,26,114,62,45,7,145,115,30,3,3,38,9,29
"2021","Vale of Glamorgan 012H","W01001911",506,162,55,107,311,30,120,33,59,28,65,27,34,4,92,61,31,4,4,33,11,22
"2021","Vale of Glamorgan 013A","W01001062",581,204,75,129,348,38,177,64,83,30,70,39,30,1,63,37,26,0,0,29,13,16
"2021","Vale of Glamorgan 013B","W01001064",602,230,85,145,346,41,113,35,45,33,67,27,39,1,122,74,48,3,3,26,7,19
"2021","Vale of Glamorgan 013C","W01001093",766,300,138,162,439,48,191,66,82,43,79,32,43,4,115,67,48,6,6,27,11,16
"2021","Vale of Glamorgan 013D","W01001099",568,229,133,96,317,49,131,52,56,23,56,19,31,6,81,59,22,0,0,22,13,9
"2021","Vale of Glamorgan 013E","W01001101",680,234,66,168,412,42,169,60,84,25,107,52,43,12,91,66,25,3,3,34,14,20
"2021","Vale of Glamorgan 013F","W01001102",676,226,71,155,421,24,169,62,73,34,117,48,65,4,105,77,28,6,6,29,9,20
"2021","Vale of Glamorgan 014A","W01001108",849,318,95,223,504,70,247,97,118,32,116,66,48,2,69,46,23,2,2,27,11,16
"2021","Vale of Glamorgan 014B","W01001117",589,159,97,62,408,109,187,85,66,36,59,32,21,6,53,31,22,0,0,22,9,13
"2021","Vale of Glamorgan 014D","W01001120",593,163,87,76,401,82,217,93,76,48,63,32,25,6,37,20,17,2,2,29,13,16
"2021","Vale of Glamorgan 014E","W01001121",729,215,113,102,491,81,226,93,87,46,96,38,52,6,86,51,35,2,2,23,7,16
"2021","Vale of Glamorgan 014F","W01001122",843,204,45,159,595,46,310,95,170,45,109,51,52,6,124,90,34,6,6,44,23,21
"2021","Vale of Glamorgan 014G","W01002038",578,182,97,85,379,58,185,81,45,59,57,29,19,9,78,50,28,1,1,17,7,10
"2021","Vale of Glamorgan 014H","W01002039",668,115,31,84,530,52,275,89,151,35,124,56,63,5,79,65,14,0,0,23,14,9
"2021","Vale of Glamorgan 015A","W01001059",842,323,141,182,490,93,249,102,109,38,79,39,35,5,64,33,31,5,5,29,16,13
"2021","Vale of Glamorgan 015B","W01001060",646,207,143,64,419,111,238,90,92,56,39,24,14,1,31,14,17,0,0,20,7,13
"2021","Vale of Glamorgan 015D","W01001066",792,343,131,212,410,35,178,75,70,33,91,52,34,5,103,67,36,3,3,39,16,23
"2021","Vale of Glamorgan 015E","W01001073",1055,495,165,330,524,34,180,68,74,38,123,70,43,10,181,128,53,6,6,36,13,23
"2021","Vale of Glamorgan 015G","W01001998",963,295,116,179,612,70,296,111,135,50,102,55,41,6,137,91,46,7,7,56,23,33
"2021","Vale of Glamorgan 015F","W01002040",899,271,21,250,591,9,196,74,103,19,259,174,82,3,122,96,26,5,5,37,12,25
"2021","Cardiff 001A","W01001777",712,159,90,69,535,122,309,82,168,59,50,34,11,5,52,36,16,2,2,18,5,13
"2021","Cardiff 001B","W01001778",688,120,94,26,537,146,326,107,146,73,36,19,15,2,29,13,16,0,0,31,14,17
"2021","Cardiff 001C","W01001794",613,175,64,111,418,47,199,78,82,39,89,62,24,3,82,61,21,1,1,20,5,15
"2021","Cardiff 001D","W01001799",517,148,97,51,346,100,189,78,76,35,30,20,9,1,25,8,17,2,2,23,11,12
"2021","Cardiff 002A","W01001793",568,131,44,87,422,45,235,86,107,42,90,56,28,6,50,35,15,2,2,15,2,13
"2021","Cardiff 002B","W01001795",657,188,74,114,448,45,265,79,137,49,78,55,21,2,58,42,16,2,2,21,7,14
"2021","Cardiff 002C","W01001796",644,196,85,111,429,72,205,79,85,41,79,52,24,3,69,46,23,4,4,19,11,8
"2021","Cardiff 002D","W01001798",650,253,105,148,376,55,203,70,93,40,63,31,27,5,52,29,23,3,3,21,10,11
"2021","Cardiff 003A","W01001841",748,160,56,104,555,52,349,107,174,68,72,49,16,7,80,51,29,2,2,33,17,16
"2021","Cardiff 003B","W01001842",734,169,38,131,534,30,280,84,161,35,136,90,44,2,80,61,19,8,8,31,12,19
"2021","Cardiff 003D","W01001844",856,294,67,227,521,59,250,67,126,57,107,71,33,3,101,63,38,4,4,41,17,24
"2021","Cardiff 003E","W01002016",536,138,20,118,376,30,164,51,102,11,122,89,31,2,26,22,4,34,34,22,14,8
"2021","Cardiff 003F","W01002017",593,128,7,121,441,7,183,51,116,16,119,73,45,1,126,117,9,6,6,24,7,17
"2021","Cardiff 003G","W01002018",566,100,14,86,436,29,291,83,148,60,63,39,24,0,53,34,19,0,0,30,15,15
"2021","Cardiff 004A","W01001849",645,165,98,67,454,88,276,91,137,48,49,25,19,5,38,19,19,3,3,26,7,19
"2021","Cardiff 004B","W01001852",740,162,115,47,543,90,342,105,184,53,50,28,19,3,57,26,31,4,4,35,9,26
"2021","Cardiff 004C","W01001853",757,270,186,84,471,133,236,75,108,53,45,21,21,3,55,31,24,2,2,16,5,11
"2021","Cardiff 004D","W01001854",800,339,240,99,442,132,200,84,77,39,52,27,19,6,58,27,31,0,0,19,8,11
"2021","Cardiff 005A","W01001791",853,341,201,140,490,99,241,69,132,40,76,39,32,5,74,44,30,0,0,22,8,14
"2021","Cardiff 005B","W01001792",686,236,94,142,409,51,176,48,94,34,69,31,29,9,104,63,41,9,9,41,20,21
"2021","Cardiff 005C","W01001797",599,176,107,69,390,64,198,56,109,33,54,27,22,5,71,38,33,3,3,33,18,15
"2021","Cardiff 005D","W01001800",642,243,107,136,370,44,157,47,70,40,66,31,28,7,96,53,43,7,7,29,17,12
"2021","Cardiff 005F","W01001949",682,351,107,244,305,20,140,46,83,11,92,73,18,1,48,28,20,5,5,26,11,15
"2021","Cardiff 005G","W01001953",634,219,85,134,386,40,201,54,113,34,63,34,22,7,79,52,27,3,3,29,12,17
"2021","Cardiff 006A","W01001820",514,135,67,68,368,58,172,60,83,29,48,29,14,5,89,65,24,1,1,11,5,6
"2021","Cardiff 006C","W01001846",656,124,61,63,511,46,306,80,175,51,81,34,43,4,76,48,28,2,2,21,9,12
"2021","Cardiff 006D","W01001847",639,119,89,30,494,176,240,77,113,50,47,25,17,5,31,10,21,0,0,26,16,10
"2021","Cardiff 006E","W01001948",891,203,47,156,663,47,379,75,263,41,138,80,53,5,98,73,25,1,1,25,14,11
"2021","Cardiff 006F","W01001954",639,188,126,62,431,107,255,77,132,46,32,19,10,3,36,17,19,1,1,20,5,15
"2021","Cardiff 007A","W01001802",745,262,123,139,438,66,190,68,75,47,70,29,35,6,108,74,34,4,4,45,27,18
"2021","Cardiff 007B","W01001807",619,137,54,83,438,19,134,29,67,38,72,22,38,12,205,158,47,8,8,44,25,19
"2021","Cardiff 007C","W01001808",638,152,66,86,433,18,145,35,79,31,67,19,38,10,199,151,48,4,4,53,33,20
"2021","Cardiff 007D","W01001840",879,309,87,222,526,75,258,101,99,58,80,42,30,8,109,76,33,4,4,44,15,29
"2021","Cardiff 008A","W01001730",623,157,121,36,434,146,241,64,133,44,19,7,10,2,28,16,12,0,0,32,18,14
"2021","Cardiff 008B","W01001731",536,100,71,29,406,76,255,51,156,48,36,13,19,4,38,22,16,1,1,30,21,9
"2021","Cardiff 008C","W01001736",589,151,112,39,414,89,235,56,133,46,40,17,20,3,47,23,24,3,3,24,18,6
"2021","Cardiff 008D","W01001815",536,117,64,53,384,80,177,38,87,52,46,23,21,2,81,47,34,0,0,35,18,17
"2021","Cardiff 009A","W01001811",547,116,46,70,387,36,126,29,70,27,54,18,33,3,170,126,44,1,1,44,31,13
"2021","Cardiff 009B","W01001816",1104,349,79,270,676,41,266,67,158,41,126,61,59,6,236,181,55,7,7,79,29,50
"2021","Cardiff 009C","W01001817",582,153,85,68,395,66,158,49,74,35,65,32,28,5,104,39,65,2,2,34,19,15
"2021","Cardiff 009D","W01001818",623,170,58,112,416,49,179,49,104,26,71,22,45,4,111,85,26,6,6,37,18,19
"2021","Cardiff 010A","W01001888",688,196,78,118,465,55,252,77,128,47,78,46,26,6,79,49,30,1,1,27,12,15
"2021","Cardiff 010B","W01001893",799,244,105,139,524,54,271,92,133,46,92,46,39,7,104,68,36,3,3,31,15,16
"2021","Cardiff 010C","W01001894",645,169,98,71,453,83,248,85,112,51,65,31,30,4,55,34,21,2,2,23,7,16
"2021","Cardiff 010D","W01001895",842,425,198,227,382,50,161,41,95,25,72,34,34,4,97,61,36,2,2,35,7,28
"2021","Cardiff 011A","W01001877",813,231,87,144,550,53,282,105,122,55,107,69,31,7,102,69,33,6,6,32,10,22
"2021","Cardiff 011B","W01001878",622,187,76,111,407,41,197,60,99,38,77,46,28,3,89,62,27,3,3,28,9,19
"2021","Cardiff 011C","W01001882",757,210,57,153,509,46,240,87,108,45,116,64,47,5,105,77,28,2,2,38,17,21
"2021","Cardiff 011D","W01001885",997,285,66,219,658,35,273,84,148,41,157,84,66,7,186,141,45,7,7,54,25,29
"2021","Cardiff 012A","W01001773",1042,273,118,155,711,80,358,80,217,61,145,96,43,6,117,81,36,11,11,58,19,39
"2021","Cardiff 012B","W01001848",604,153,104,49,423,70,263,83,142,38,48,28,14,6,41,18,23,1,1,28,8,20
"2021","Cardiff 012C","W01001850",785,185,135,50,575,141,335,116,169,50,52,19,30,3,46,20,26,1,1,25,6,19
"2021","Cardiff 012D","W01001851",710,268,171,97,424,95,243,75,126,42,47,29,16,2,37,13,24,2,2,18,13,5
"2021","Cardiff 013A","W01001879",798,267,109,158,496,34,173,37,98,38,92,42,44,6,183,130,53,14,14,35,20,15
"2021","Cardiff 013B","W01001880",612,163,28,135,415,16,152,40,84,28,92,43,38,11,152,117,35,3,3,34,18,16
"2021","Cardiff 013C","W01001881",653,253,93,160,373,47,145,49,61,35,46,15,24,7,129,96,33,6,6,27,18,9
"2021","Cardiff 013D","W01001884",521,97,21,76,403,7,97,26,51,20,61,18,34,9,235,192,43,3,3,21,14,7
"2021","Cardiff 014A","W01001727",512,136,78,58,364,77,182,58,77,47,62,27,29,6,42,28,14,1,1,12,3,9
"2021","Cardiff 014B","W01001728",594,132,74,58,449,113,260,86,123,51,32,18,13,1,44,27,17,0,0,13,5,8
"2021","Cardiff 014C","W01001729",1170,227,79,148,891,107,480,162,219,99,186,113,61,12,110,77,33,8,8,52,18,34
"2021","Cardiff 014D","W01001819",967,214,128,86,716,194,367,112,179,76,81,40,31,10,73,48,25,1,1,37,15,22
"2021","Cardiff 015A","W01001803",703,223,122,101,430,33,182,59,87,36,85,32,40,13,118,75,43,12,12,50,25,25
"2021","Cardiff 015B","W01001804",633,167,68,99,412,21,169,46,80,43,86,44,34,8,124,93,31,12,12,54,28,26
"2021","Cardiff 015C","W01001805",674,192,63,129,452,35,149,58,54,37,100,43,48,9,163,130,33,5,5,30,17,13
"2021","Cardiff 015D","W01001806",812,281,145,136,497,79,207,76,92,39,75,35,31,9,133,97,36,3,3,34,15,19
"2021","Cardiff 016A","W01001866",663,212,90,122,413,60,143,44,58,41,74,31,37,6,129,87,42,7,7,38,18,20
"2021","Cardiff 016B","W01001867",547,178,68,110,324,30,129,25,67,37,48,20,23,5,113,77,36,4,4,45,29,16
"2021","Cardiff 016C","W01001883",697,274,84,190,387,31,125,40,54,31,69,37,24,8,156,111,45,6,6,36,27,9
"2021","Cardiff 016D","W01001886",524,166,39,127,327,20,106,20,47,39,48,15,27,6,135,99,36,18,18,31,12,19
"2021","Cardiff 017A","W01001809",533,193,99,94,314,54,150,36,73,41,51,18,25,8,59,33,26,0,0,26,8,18
"2021","Cardiff 017B","W01001810",629,148,82,66,445,41,171,37,90,44,59,15,36,8,170,127,43,4,4,36,19,17
"2021","Cardiff 017C","W01001812",481,103,54,49,344,44,132,34,69,29,58,14,35,9,107,59,48,3,3,34,19,15
"2021","Cardiff 017D","W01001813",784,307,95,212,438,34,169,31,103,35,72,29,36,7,159,121,38,4,4,39,25,14
"2021","Cardiff 017E","W01001814",683,278,87,191,385,56,140,43,67,30,68,34,25,9,119,81,38,2,2,20,10,10
"2021","Cardiff 018A","W01001769",617,109,72,37,490,92,303,90,156,57,59,28,29,2,33,12,21,3,3,18,5,13
"2021","Cardiff 018B","W01001770",495,188,76,112,273,42,137,53,54,30,60,45,15,0,32,23,9,2,2,34,9,25
"2021","Cardiff 018C","W01001771",675,149,85,64,495,85,289,87,140,62,68,38,27,3,46,21,25,7,7,31,9,22
"2021","Cardiff 018D","W01001774",533,94,58,36,420,82,245,65,138,42,60,31,25,4,32,15,17,1,1,19,6,13
"2021","Cardiff 019A","W01001732",673,164,101,63,488,91,294,67,172,55,51,29,20,2,52,32,20,0,0,21,10,11
"2021","Cardiff 019B","W01001733",563,190,75,115,342,67,211,60,121,30,26,10,13,3,35,21,14,3,3,31,16,15
"2021","Cardiff 019C","W01001734",588,141,95,46,414,70,269,61,157,51,36,13,20,3,37,19,18,2,2,33,14,19
"2021","Cardiff 019D","W01001735",611,153,95,58,428,78,250,61,144,45,44,19,23,2,53,32,21,3,3,30,11,19
"2021","Cardiff 020A","W01001887",615,134,77,57,455,91,289,79,153,57,41,24,16,1,30,16,14,4,4,26,13,13
"2021","Cardiff 020B","W01001889",701,250,130,120,427,102,183,64,86,33,59,43,13,3,76,41,35,7,7,24,7,17
"2021","Cardiff 020C","W01001891",735,264,147,117,447,76,229,78,107,44,74,26,36,12,64,37,27,4,4,24,8,16
"2021","Cardiff 020D","W01001892",599,151,101,50,428,101,250,68,128,54,46,27,15,4,31,12,19,0,0,20,11,9
"2021","Cardiff 020E","W01001896",604,173,91,82,412,61,252,78,121,53,52,22,25,5,44,19,25,3,3,19,7,12
"2021","Cardiff 021A","W01001772",590,150,95,55,414,101,221,74,96,51,45,19,20,6,43,20,23,4,4,26,7,19
"2021","Cardiff 021B","W01001775",706,221,86,135,459,51,234,64,131,39,91,64,23,4,81,54,27,2,2,26,6,20
"2021","Cardiff 021C","W01001776",519,110,64,46,374,59,213,64,115,34,63,35,24,4,37,23,14,2,2,35,13,22
"2021","Cardiff 021D","W01001890",602,196,89,107,378,72,170,64,78,28,72,43,27,2,57,25,32,7,7,28,15,13
"2021","Cardiff 022A","W01001863",643,192,86,106,411,68,172,53,70,49,84,37,38,9,83,43,40,4,4,40,18,22
"2021","Cardiff 022B","W01001864",632,172,102,70,412,84,210,78,73,59,61,29,24,8,54,21,33,3,3,48,21,27
"2021","Cardiff 022C","W01001865",518,112,59,53,377,53,217,86,86,45,55,31,20,4,46,19,27,6,6,29,14,15
"2021","Cardiff 022D","W01001868",595,162,94,68,397,50,175,56,85,34,50,21,28,1,120,90,30,2,2,36,19,17
"2021","Cardiff 023A","W01001785",482,158,73,85,289,26,128,40,61,27,38,10,22,6,95,66,29,2,2,35,19,16
"2021","Cardiff 023B","W01001786",625,169,63,106,419,36,188,54,97,37,103,66,34,3,82,48,34,10,10,37,18,19
"2021","Cardiff 023C","W01001787",541,152,72,80,337,39,160,50,72,38,47,22,20,5,86,64,22,5,5,52,23,29
"2021","Cardiff 023D","W01001788",627,162,70,92,413,21,189,48,99,42,70,30,36,4,128,57,71,5,5,52,32,20
"2021","Cardiff 023E","W01001789",733,269,88,181,423,48,202,77,100,25,95,62,31,2,74,49,25,4,4,41,10,31
"2021","Cardiff 023F","W01001790",483,129,68,61,315,47,131,31,69,31,53,25,25,3,83,53,30,1,1,39,18,21
"2021","Cardiff 024A","W01001821",553,225,142,83,295,52,159,41,97,21,52,44,8,0,32,16,16,0,0,33,7,26
"2021","Cardiff 024B","W01001826",547,136,90,46,381,96,187,45,100,42,45,24,21,0,53,29,24,0,0,30,13,17
"2021","Cardiff 024C","W01001827",628,144,98,46,450,92,266,79,131,56,33,15,16,2,59,28,31,0,0,34,19,15
"2021","Cardiff 024D","W01001828",632,157,105,52,450,119,246,71,109,66,54,37,15,2,31,13,18,0,0,25,13,12
"2021","Cardiff 025A","W01001755",633,173,21,152,328,18,159,59,80,20,115,100,13,2,27,11,16,9,9,132,5,127
"2021","Cardiff 025B","W01001756",624,163,53,110,388,31,185,51,103,31,62,30,25,7,105,64,41,5,5,73,26,47
"2021","Cardiff 025C","W01001757",597,176,60,116,283,32,136,45,72,19,66,53,10,3,41,22,19,8,8,138,9,129
"2021","Cardiff 025D","W01001758",656,140,42,98,301,26,153,44,97,12,70,51,16,3,42,25,17,10,10,215,14,201
"2021","Cardiff 026A","W01001779",659,224,119,105,410,74,227,84,102,41,69,44,25,0,39,25,14,1,1,25,5,20
"2021","Cardiff 026B","W01001780",607,200,97,103,392,82,203,72,90,41,57,31,23,3,45,22,23,5,5,15,5,10
"2021","Cardiff 026C","W01001781",823,376,207,169,420,72,230,69,126,35,75,56,18,1,41,23,18,2,2,27,4,23
"2021","Cardiff 026D","W01001782",588,140,78,62,416,76,229,62,123,44,78,46,31,1,33,17,16,0,0,32,7,25
"2021","Cardiff 026E","W01001783",498,133,72,61,340,63,186,56,85,45,48,32,15,1,42,25,17,1,1,25,15,10
"2021","Cardiff 026F","W01001784",578,193,94,99,375,67,194,50,94,50,58,37,17,4,54,24,30,2,2,10,5,5
"2021","Cardiff 027A","W01001747",831,336,115,221,471,55,189,58,83,48,125,92,28,5,97,62,35,5,5,24,13,11
"2021","Cardiff 027B","W01001748",647,201,85,116,403,38,177,48,83,46,66,29,29,8,118,86,32,4,4,43,20,23
"2021","Cardiff 027C","W01001749",677,232,99,133,412,32,189,57,87,45,97,46,46,5,88,60,28,6,6,33,14,19
"2021","Cardiff 027D","W01001751",819,269,75,194,510,20,134,39,64,31,89,34,50,5,262,222,40,5,5,40,21,19
"2021","Cardiff 028A","W01001718",621,158,18,140,186,7,70,25,37,8,69,55,14,0,29,21,8,11,11,277,15,262
"2021","Cardiff 028B","W01001719",567,143,48,95,233,25,99,30,49,20,79,59,16,4,25,15,10,5,5,191,3,188
"2021","Cardiff 028C","W01001720",645,145,23,122,145,4,39,14,17,8,54,45,8,1,18,10,8,30,30,355,7,348
"2021","Cardiff 028D","W01001722",529,99,26,73,127,7,39,16,17,6,41,35,6,0,23,12,11,17,17,303,6,297
"2021","Cardiff 028E","W01001726",547,109,24,85,150,9,71,21,44,6,48,40,8,0,17,12,5,5,5,288,17,271
"2021","Cardiff 029A","W01001822",808,263,124,139,502,71,275,78,155,42,69,38,26,5,85,53,32,2,2,43,15,28
"2021","Cardiff 029B","W01001823",514,118,50,68,369,39,221,72,124,25,75,50,24,1,32,16,16,2,2,27,13,14
"2021","Cardiff 029C","W01001824",725,312,78,234,329,31,146,47,84,15,103,86,14,3,44,31,13,5,5,84,16,68
"2021","Cardiff 029D","W01001825",869,299,75,224,516,45,254,82,145,27,120,86,30,4,92,58,34,5,5,54,21,33
"2021","Cardiff 030A","W01001831",655,221,32,189,287,15,100,40,46,14,123,110,12,1,37,23,14,12,12,147,12,135
"2021","Cardiff 030B","W01001836",524,176,30,146,252,10,114,38,62,14,89,65,22,2,34,23,11,5,5,96,27,69
"2021","Cardiff 030C","W01001837",514,179,42,137,204,14,76,20,44,12,67,52,15,0,37,22,15,10,10,131,20,111
"2021","Cardiff 030D","W01001838",623,177,47,130,290,9,119,32,70,17,106,78,23,5,48,21,27,8,8,156,16,140
"2021","Cardiff 030E","W01001839",603,169,43,126,255,12,106,29,61,16,92,76,16,0,38,22,16,7,7,179,13,166
"2021","Cardiff 031A","W01001750",825,430,189,241,364,40,154,56,70,28,65,34,24,7,101,65,36,4,4,31,16,15
"2021","Cardiff 031B","W01001752",661,166,99,67,466,63,261,91,107,63,73,40,27,6,66,30,36,3,3,29,15,14
"2021","Cardiff 031C","W01001753",634,191,58,133,405,30,136,32,64,40,66,32,29,5,169,106,63,4,4,38,17,21
"2021","Cardiff 031D","W01001754",790,333,146,187,429,70,203,74,90,39,88,54,32,2,68,31,37,0,0,28,13,15
"2021","Cardiff 032A","W01001721",575,219,49,170,161,16,53,22,19,12,50,45,5,0,22,14,8,20,20,195,6,189
"2021","Cardiff 032C","W01001724",611,102,21,81,89,7,24,9,12,3,33,31,2,0,14,9,5,11,11,420,8,412
"2021","Cardiff 032D","W01001725",520,95,11,84,92,3,26,11,12,3,28,25,3,0,16,9,7,19,19,333,6,327
"2021","Cardiff 032E","W01001922",407,105,9,96,71,0,19,9,6,4,27,22,5,0,6,3,3,19,19,231,5,226
"2021","Cardiff 032H","W01002019",1151,644,36,608,391,13,157,74,77,6,147,142,5,0,29,15,14,45,45,116,4,112
"2021","Cardiff 033A","W01001829",725,205,40,165,280,10,105,38,53,14,99,86,12,1,42,27,15,24,24,240,19,221
"2021","Cardiff 033B","W01001830",889,456,31,425,329,3,108,49,51,8,154,143,10,1,54,36,18,10,10,104,9,95
"2021","Cardiff 033C","W01001832",809,339,13,326,244,3,55,27,25,3,126,120,6,0,38,25,13,22,22,226,10,216
"2021","Cardiff 033D","W01001833",697,254,52,202,388,22,175,58,88,29,107,87,16,4,36,17,19,48,48,55,9,46
"2021","Cardiff 033E","W01001834",715,216,54,162,316,18,116,42,65,9,109,91,15,3,67,40,27,6,6,183,12,171
"2021","Cardiff 033F","W01001835",977,596,132,464,278,22,89,46,32,11,103,92,9,2,52,25,27,12,12,103,7,96
"2021","Cardiff 034A","W01001858",857,404,113,291,399,45,179,79,79,21,115,94,19,2,51,25,26,9,9,54,7,47
"2021","Cardiff 034B","W01001859",772,335,85,250,375,31,172,73,87,12,130,106,21,3,41,22,19,1,1,62,6,56
"2021","Cardiff 034C","W01001860",774,267,67,200,432,29,185,67,92,26,161,131,23,7,51,32,19,6,6,75,12,63
"2021","Cardiff 034D","W01001861",748,321,55,266,361,24,195,70,101,24,110,90,18,2,27,21,6,5,5,66,10,56
"2021","Cardiff 035A","W01001714",607,139,79,60,434,75,250,64,146,40,67,29,31,7,41,26,15,1,1,34,12,22
"2021","Cardiff 035B","W01001715",796,368,137,231,389,32,191,66,100,25,120,92,23,5,43,25,18,3,3,39,5,34
"2021","Cardiff 035C","W01001716",541,138,63,75,373,39,186,57,93,36,94,62,30,2,51,27,24,3,3,30,11,19
"2021","Cardiff 035D","W01001717",743,300,92,208,400,28,154,45,85,24,131,92,37,2,85,56,29,2,2,43,8,35
"2021","Cardiff 036A","W01001694",887,348,59,289,384,4,145,46,76,23,106,74,29,3,113,72,41,16,16,155,28,127
"2021","Cardiff 036B","W01001695",746,314,52,262,314,4,145,43,93,9,70,56,13,1,74,56,18,21,21,118,25,93
"2021","Cardiff 036C","W01001696",669,270,62,208,309,6,93,19,56,18,77,53,21,3,118,76,42,15,15,90,25,65
"2021","Cardiff 036D","W01001697",865,331,79,252,415,15,210,54,139,17,116,92,20,4,64,38,26,10,10,119,29,90
"2021","Cardiff 036E","W01001698",952,379,35,344,453,13,177,51,108,18,142,109,30,3,98,70,28,23,23,120,17,103
"2021","Cardiff 037A","W01001870",634,186,45,141,401,22,153,60,68,25,112,66,42,4,108,69,39,6,6,47,7,40
"2021","Cardiff 037B","W01001871",686,230,84,146,408,17,126,38,56,32,73,18,46,9,179,131,48,13,13,48,22,26
"2021","Cardiff 037D","W01001876",659,189,57,132,424,29,150,44,73,33,73,28,36,9,148,106,42,24,24,46,21,25
"2021","Cardiff 037E","W01002020",626,142,36,106,413,17,141,53,68,20,86,43,38,5,164,125,39,5,5,71,20,51
"2021","Cardiff 037F","W01002021",650,263,24,239,333,4,170,47,98,25,95,63,30,2,62,53,9,2,2,54,23,31
"2021","Cardiff 038A","W01001869",626,218,61,157,345,22,142,54,51,37,113,77,31,5,57,33,24,11,11,63,13,50
"2021","Cardiff 038B","W01001872",700,234,79,155,367,19,144,53,53,38,106,68,31,7,85,60,25,13,13,99,25,74
"2021","Cardiff 038C","W01001873",799,324,84,240,386,14,153,53,78,22,112,73,35,4,101,70,31,6,6,89,30,59
"2021","Cardiff 038D","W01001874",747,338,68,270,370,15,96,29,52,15,79,51,24,4,163,115,48,17,17,39,11,28
"2021","Cardiff 039A","W01001737",631,187,80,107,397,33,136,33,72,31,63,18,38,7,163,110,53,2,2,47,29,18
"2021","Cardiff 039B","W01001738",519,111,40,71,380,13,112,30,62,20,55,16,30,9,179,145,34,21,21,28,12,16
"2021","Cardiff 039C","W01001739",548,116,44,72,406,15,117,23,68,26,62,19,35,8,211,158,53,1,1,26,17,9
"2021","Cardiff 039D","W01001740",683,266,102,164,384,26,102,24,48,30,73,23,37,13,176,127,49,7,7,33,16,17
"2021","Cardiff 039E","W01001741",610,118,41,77,454,20,111,24,59,28,71,18,46,7,250,201,49,2,2,38,19,19
"2021","Cardiff 040B","W01001710",803,261,64,197,468,35,190,63,104,23,112,78,30,4,120,92,28,11,11,74,22,52
"2021","Cardiff 040C","W01001711",874,292,94,198,514,48,218,64,113,41,86,53,30,3,157,119,38,5,5,68,36,32
"2021","Cardiff 040D","W01001712",715,313,58,255,350,27,138,62,63,13,127,94,30,3,51,35,16,7,7,52,10,42
"2021","Cardiff 040E","W01001713",774,297,58,239,401,28,159,50,84,25,144,92,49,3,63,39,24,7,7,76,19,57
"2021","Cardiff 040F","W01002022",553,170,8,162,353,6,120,30,88,2,174,120,50,4,49,44,5,4,4,30,10,20
"2021","Cardiff 040G","W01002023",685,175,53,122,440,31,239,69,121,49,87,55,31,1,79,49,30,4,4,70,29,41
"2021","Cardiff 041A","W01001704",626,161,77,84,418,32,115,41,47,27,66,22,33,11,195,161,34,10,10,47,23,24
"2021","Cardiff 041B","W01001706",585,190,77,113,372,53,170,57,84,29,60,23,31,6,87,55,32,2,2,23,13,10
"2021","Cardiff 041C","W01001707",807,236,129,107,526,42,186,60,77,49,84,28,51,5,207,147,60,7,7,45,25,20
"2021","Cardiff 041D","W01001746",649,229,69,160,387,30,137,47,66,24,60,31,23,6,151,113,38,9,9,33,12,21
"2021","Cardiff 042A","W01001855",668,220,58,162,380,5,191,45,121,25,78,46,29,3,96,65,31,10,10,68,31,37
"2021","Cardiff 042B","W01001856",687,306,53,253,296,8,156,38,102,16,62,43,16,3,62,38,24,8,8,85,40,45
"2021","Cardiff 042C","W01001857",908,394,84,310,455,16,178,46,107,25,107,84,20,3,145,112,33,9,9,59,22,37
"2021","Cardiff 042D","W01001862",760,298,55,243,339,13,150,42,91,17,89,79,9,1,68,34,34,19,19,123,39,84
"2021","Cardiff 043A","W01001742",645,158,69,89,417,19,116,27,60,29,71,20,45,6,207,167,40,4,4,70,13,57
"2021","Cardiff 043B","W01001743",641,193,99,94,408,76,197,75,74,48,62,28,29,5,71,49,22,2,2,40,14,26
"2021","Cardiff 043C","W01001744",760,262,123,139,470,42,122,41,51,30,94,29,56,9,207,168,39,5,5,28,18,10
"2021","Cardiff 043D","W01001745",546,140,80,60,376,63,184,69,62,53,61,37,21,3,64,35,29,4,4,30,10,20
"2021","Cardiff 044A","W01001764",596,176,44,132,328,17,168,35,101,32,61,44,14,3,76,53,23,6,6,92,37,55
"2021","Cardiff 044B","W01001765",519,147,34,113,309,25,157,33,98,26,53,28,22,3,66,41,25,8,8,63,26,37
"2021","Cardiff 044C","W01001766",699,249,52,197,386,21,164,33,107,24,92,66,21,5,100,70,30,9,9,64,19,45
"2021","Cardiff 044D","W01001767",738,224,44,180,439,15,212,81,107,24,108,81,24,3,96,64,32,8,8,75,32,43
"2021","Cardiff 044E","W01001768",519,142,32,110,276,10,148,28,97,23,44,25,16,3,68,41,27,6,6,101,53,48
"2021","Cardiff 045A","W01001702",739,199,56,143,494,50,220,76,90,54,94,38,48,8,128,83,45,2,2,46,21,25
"2021","Cardiff 045B","W01001703",484,134,51,83,310,41,99,30,40,29,51,4,39,8,115,75,40,4,4,40,23,17
"2021","Cardiff 045C","W01001705",785,217,83,134,535,26,191,63,83,45,112,50,53,9,197,142,55,9,9,33,19,14
"2021","Cardiff 045D","W01001708",730,314,100,214,378,24,121,36,45,40,89,42,39,8,142,88,54,2,2,38,20,18
"2021","Cardiff 046A","W01001759",693,225,71,154,425,42,209,84,86,39,83,60,21,2,86,43,43,5,5,43,14,29
"2021","Cardiff 046B","W01001760",676,216,79,137,394,34,171,45,79,47,89,56,27,6,96,62,34,4,4,66,25,41
"2021","Cardiff 046C","W01001761",686,255,72,183,358,21,159,33,108,18,81,55,24,2,90,54,36,7,7,73,37,36
"2021","Cardiff 046D","W01001762",711,248,72,176,396,7,159,23,112,24,88,37,44,7,137,100,37,5,5,67,25,42
"2021","Cardiff 048A","W01001940",663,352,43,309,259,27,88,53,28,7,118,114,4,0,16,7,9,10,10,52,2,50
"2021","Cardiff 048B","W01001943",647,291,29,262,273,12,90,54,32,4,133,125,7,1,27,18,9,11,11,83,7,76
"2021","Cardiff 048C","W01001944",626,241,16,225,290,3,79,39,37,3,168,153,14,1,27,19,8,13,13,95,5,90
"2021","Cardiff 048E","W01001947",946,423,27,396,448,17,193,79,102,12,176,156,17,3,46,37,9,16,16,75,4,71
"2021","Cardiff 048F","W01002024",701,355,21,334,280,12,100,64,32,4,130,126,4,0,21,16,5,17,17,66,2,64
"2021","Cardiff 048G","W01002025",632,286,23,263,296,26,98,52,34,12,115,92,23,0,51,44,7,6,6,50,7,43
"2021","Cardiff 049A","W01001699",1027,419,118,301,502,11,193,41,127,25,134,113,19,2,143,79,64,21,21,106,53,53
"2021","Cardiff 049B","W01001942",775,342,67,275,353,17,123,48,63,12,120,96,19,5,85,43,42,8,8,80,14,66
"2021","Cardiff 049C","W01001946",665,324,66,258,291,12,90,31,46,13,93,64,23,6,84,49,35,12,12,50,20,30
"2021","Cardiff 049D","W01001950",596,215,48,167,311,32,131,55,66,10,106,99,6,1,29,19,10,13,13,70,3,67
"2021","Cardiff 049E","W01001951",499,187,22,165,244,7,85,39,35,11,114,109,5,0,28,16,12,10,10,68,5,63
"2021","Cardiff 049F","W01001952",643,274,20,254,276,6,86,34,46,6,135,127,8,0,29,18,11,20,20,93,11,82
"2021","Rhondda Cynon Taf 001A","W01001186",697,147,58,89,521,87,238,80,103,55,82,36,36,10,111,82,29,3,3,29,16,13
"2021","Rhondda Cynon Taf 001B","W01001187",597,158,72,86,407,73,195,98,61,36,69,28,33,8,66,37,29,4,4,32,21,11
"2021","Rhondda Cynon Taf 001C","W01001188",603,191,88,103,393,124,114,49,38,27,55,19,31,5,96,69,27,4,4,19,9,10
"2021","Rhondda Cynon Taf 001D","W01001221",613,205,109,96,384,60,134,47,45,42,69,25,37,7,117,73,44,4,4,24,15,9
"2021","Rhondda Cynon Taf 001E","W01001222",639,188,74,114,429,44,136,57,43,36,77,9,60,8,165,119,46,7,7,22,11,11
"2021","Rhondda Cynon Taf 001F","W01001233",781,230,149,81,520,94,254,107,80,67,96,31,45,20,74,44,30,2,2,31,19,12
"2021","Rhondda Cynon Taf 002A","W01001148",831,298,116,182,516,52,209,70,92,47,114,67,39,8,136,89,47,5,5,17,8,9
"2021","Rhondda Cynon Taf 002B","W01001152",834,206,119,87,598,104,284,103,112,69,101,51,46,4,106,44,62,3,3,30,11,19
"2021","Rhondda Cynon Taf 002C","W01001153",682,257,86,171,402,44,163,55,64,44,91,38,39,14,101,59,42,3,3,23,11,12
"2021","Rhondda Cynon Taf 002D","W01001155",700,265,85,180,409,62,174,83,52,39,85,38,41,6,85,52,33,3,3,26,11,15
"2021","Rhondda Cynon Taf 003A","W01001149",623,193,86,107,414,66,179,72,66,41,72,28,40,4,95,51,44,2,2,16,11,5
"2021","Rhondda Cynon Taf 003B","W01001150",869,336,104,232,503,59,155,62,66,27,157,65,88,4,125,93,32,7,7,30,11,19
"2021","Rhondda Cynon Taf 003C","W01001151",789,223,130,93,539,140,241,84,104,53,81,33,45,3,74,44,30,3,3,27,16,11
"2021","Rhondda Cynon Taf 003D","W01001154",686,268,114,154,399,60,165,66,56,43,95,43,48,4,75,50,25,4,4,19,8,11
"2021","Rhondda Cynon Taf 003E","W01001156",550,100,56,44,430,52,278,94,112,72,50,25,18,7,46,24,22,4,4,20,12,8
"2021","Rhondda Cynon Taf 004A","W01001147",868,342,134,208,505,91,244,94,84,66,93,56,29,8,77,48,29,0,0,21,7,14
"2021","Rhondda Cynon Taf 004B","W01001168",610,169,103,66,429,83,187,78,67,42,71,33,30,8,87,55,32,1,1,12,6,6
"2021","Rhondda Cynon Taf 004C","W01001169",1055,305,102,203,680,48,334,111,154,69,133,47,81,5,163,117,46,2,2,70,32,38
"2021","Rhondda Cynon Taf 004D","W01001170",528,126,75,51,386,113,190,85,65,40,47,24,20,3,35,23,12,1,1,16,11,5
"2021","Rhondda Cynon Taf 005A","W01001137",1105,377,171,206,682,91,239,99,84,56,154,73,70,11,193,129,64,5,5,46,20,26
"2021","Rhondda Cynon Taf 005B","W01001138",642,258,126,132,364,42,130,48,54,28,72,34,32,6,118,83,35,2,2,20,7,13
"2021","Rhondda Cynon Taf 005C","W01001139",596,150,61,89,421,50,189,69,74,46,87,30,50,7,95,67,28,0,0,25,9,16
"2021","Rhondda Cynon Taf 005D","W01001140",635,210,85,125,394,64,167,64,54,49,88,35,46,7,71,39,32,4,4,31,18,13
"2021","Rhondda Cynon Taf 005E","W01001141",671,242,92,150,407,51,147,66,43,38,100,30,63,7,107,82,25,2,2,22,13,9
"2021","Rhondda Cynon Taf 005F","W01001142",840,269,113,156,530,64,229,82,94,53,115,45,60,10,120,80,40,2,2,41,18,23
"2021","Rhondda Cynon Taf 006A","W01001204",681,192,74,118,469,62,183,76,64,43,130,72,49,9,92,61,31,2,2,20,13,7
"2021","Rhondda Cynon Taf 006B","W01001205",699,263,119,144,422,72,172,63,61,48,81,37,36,8,87,58,29,10,10,14,4,10
"2021","Rhondda Cynon Taf 006C","W01001206",635,212,113,99,393,48,183,66,58,59,66,15,44,7,93,58,35,3,3,30,18,12
"2021","Rhondda Cynon Taf 006D","W01001207",557,157,54,103,376,59,137,61,45,31,62,38,21,3,118,78,40,0,0,24,8,16
"2021","Rhondda Cynon Taf 006E","W01001208",733,301,130,171,408,55,170,68,71,31,76,30,42,4,106,70,36,1,1,24,13,11
"2021","Rhondda Cynon Taf 007A","W01001265",731,301,106,195,404,53,172,65,62,45,93,38,47,8,84,57,27,2,2,26,16,10
"2021","Rhondda Cynon Taf 007B","W01001266",624,258,132,126,348,40,141,54,58,29,61,21,32,8,103,65,38,3,3,18,8,10
"2021","Rhondda Cynon Taf 007C","W01001267",681,239,94,145,415,60,180,74,68,38,71,34,32,5,98,53,45,6,6,27,15,12
"2021","Rhondda Cynon Taf 007D","W01001268",587,220,110,110,341,50,141,55,47,39,66,21,36,9,81,50,31,3,3,26,12,14
"2021","Rhondda Cynon Taf 008A","W01001209",582,163,55,108,396,31,129,49,41,39,91,33,49,9,142,105,37,3,3,23,9,14
"2021","Rhondda Cynon Taf 008B","W01001210",643,202,75,127,411,62,171,72,50,49,71,20,40,11,103,65,38,4,4,30,15,15
"2021","Rhondda Cynon Taf 008C","W01001211",629,189,75,114,416,53,161,61,67,33,86,29,53,4,114,82,32,2,2,24,13,11
"2021","Rhondda Cynon Taf 008D","W01001212",579,175,75,100,383,46,155,61,59,35,66,35,30,1,111,84,27,5,5,21,8,13
"2021","Rhondda Cynon Taf 009A","W01001175",595,209,120,89,379,58,183,64,62,57,57,24,28,5,79,54,25,2,2,7,3,4
"2021","Rhondda Cynon Taf 009B","W01001177",601,221,109,112,361,65,146,55,47,44,70,24,38,8,73,45,28,7,7,19,6,13
"2021","Rhondda Cynon Taf 009C","W01001202",816,296,121,175,487,87,173,59,57,57,90,36,43,11,132,85,47,5,5,33,19,14
"2021","Rhondda Cynon Taf 009D","W01001203",586,203,98,105,343,47,108,35,44,29,75,21,47,7,106,61,45,7,7,40,19,21
"2021","Rhondda Cynon Taf 010A","W01001269",643,199,100,99,420,83,173,69,58,46,86,35,42,9,76,48,28,2,2,24,15,9
"2021","Rhondda Cynon Taf 010B","W01001270",654,224,107,117,392,64,179,79,58,42,82,40,36,6,64,40,24,3,3,38,29,9
"2021","Rhondda Cynon Taf 010C","W01001271",719,241,93,148,451,55,157,72,49,36,99,48,41,10,134,97,37,6,6,27,5,22
"2021","Rhondda Cynon Taf 010D","W01001272",614,179,88,91,404,47,184,68,73,43,67,29,31,7,103,69,34,3,3,31,12,19
"2021","Rhondda Cynon Taf 010E","W01001273",762,243,120,123,499,88,225,75,91,59,95,45,47,3,89,47,42,2,2,20,9,11
"2021","Rhondda Cynon Taf 011B","W01001214",531,118,66,52,394,72,203,86,72,45,60,30,26,4,59,40,19,0,0,19,5,14
"2021","Rhondda Cynon Taf 011D","W01001216",654,190,84,106,446,57,152,57,52,43,112,36,67,9,122,77,45,3,3,18,9,9
"2021","Rhondda Cynon Taf 011E","W01001962",1181,509,190,319,639,94,244,89,105,50,138,56,70,12,159,113,46,4,4,33,16,17
"2021","Rhondda Cynon Taf 012A","W01001143",636,171,77,94,436,54,207,88,68,51,76,30,39,7,96,57,39,3,3,29,21,8
"2021","Rhondda Cynon Taf 012B","W01001144",701,189,79,110,487,45,172,57,58,57,81,28,45,8,187,130,57,2,2,25,13,12
"2021","Rhondda Cynon Taf 012C","W01001145",779,270,102,168,478,59,174,67,67,40,119,47,60,12,125,80,45,1,1,31,12,19
"2021","Rhondda Cynon Taf 012D","W01001146",632,216,97,119,395,62,177,52,76,49,78,26,46,6,77,48,29,1,1,21,13,8
"2021","Rhondda Cynon Taf 013A","W01001176",627,193,96,97,412,61,162,53,62,47,86,26,51,9,103,68,35,0,0,22,16,6
"2021","Rhondda Cynon Taf 013B","W01001274",520,177,70,107,309,29,88,35,26,27,59,25,30,4,128,99,29,5,5,34,22,12
"2021","Rhondda Cynon Taf 013C","W01001275",794,293,95,198,465,47,182,77,57,48,111,42,57,12,123,79,44,2,2,36,20,16
"2021","Rhondda Cynon Taf 013D","W01001276",633,258,95,163,353,42,136,73,28,35,71,25,41,5,95,68,27,9,9,22,11,11
"2021","Rhondda Cynon Taf 014C","W01001260",507,122,52,70,352,36,110,43,48,19,67,29,34,4,133,110,23,6,6,33,13,20
"2021","Rhondda Cynon Taf 014D","W01001285",599,210,83,127,360,62,157,63,51,43,75,33,35,7,63,35,28,3,3,29,12,17
"2021","Rhondda Cynon Taf 014E","W01001286",623,165,72,93,425,46,160,62,59,39,86,29,57,0,131,104,27,2,2,33,9,24
"2021","Rhondda Cynon Taf 014F","W01001287",644,198,87,111,422,73,174,64,53,57,88,39,34,15,80,46,34,7,7,24,14,10
"2021","Rhondda Cynon Taf 014G","W01001288",669,253,111,142,396,57,163,50,72,41,78,37,36,5,89,62,27,9,9,20,11,9
"2021","Rhondda Cynon Taf 014H","W01001963",975,295,128,167,634,94,250,97,93,60,115,39,61,15,165,101,64,10,10,46,24,22
"2021","Rhondda Cynon Taf 015A","W01001180",669,217,70,147,432,35,143,54,55,34,66,11,45,10,152,127,25,36,36,20,11,9
"2021","Rhondda Cynon Taf 015B","W01001181",628,194,76,118,410,47,208,105,52,51,71,25,41,5,81,44,37,3,3,24,15,9
"2021","Rhondda Cynon Taf 015C","W01001282",890,283,131,152,570,76,221,79,81,61,124,47,69,8,143,99,44,6,6,37,21,16
"2021","Rhondda Cynon Taf 015D","W01001283",628,183,98,85,418,62,198,72,82,44,61,26,25,10,97,58,39,0,0,27,12,15
"2021","Rhondda Cynon Taf 015E","W01001284",436,102,39,63,313,36,179,58,65,56,66,32,27,7,29,19,10,3,3,21,10,11
"2021","Rhondda Cynon Taf 016A","W01001166",579,182,75,107,380,38,138,50,44,44,71,22,41,8,131,108,23,2,2,17,11,6
"2021","Rhondda Cynon Taf 016B","W01001167",627,198,97,101,402,56,147,67,50,30,98,34,55,9,84,61,23,17,17,27,13,14
"2021","Rhondda Cynon Taf 016C","W01001247",719,249,119,130,449,61,164,53,64,47,103,42,53,8,118,73,45,3,3,21,9,12
"2021","Rhondda Cynon Taf 016D","W01001248",859,266,120,146,556,81,243,79,101,63,120,55,53,12,109,70,39,3,3,37,14,23
"2021","Rhondda Cynon Taf 017A","W01001171",611,224,81,143,371,56,141,71,38,32,93,45,39,9,81,48,33,0,0,16,4,12
"2021","Rhondda Cynon Taf 017B","W01001229",640,210,86,124,405,56,193,88,57,48,83,34,41,8,69,45,24,4,4,25,3,22
"2021","Rhondda Cynon Taf 017C","W01001230",628,180,112,68,429,68,236,84,98,54,82,32,44,6,43,26,17,0,0,19,13,6
"2021","Rhondda Cynon Taf 017D","W01001231",678,265,84,181,389,41,172,68,50,54,82,37,43,2,90,60,30,4,4,24,9,15
"2021","Rhondda Cynon Taf 017E","W01001280",771,335,146,189,397,45,132,46,39,47,76,33,35,8,139,102,37,5,5,39,22,17
"2021","Rhondda Cynon Taf 017F","W01001281",743,231,113,118,482,80,187,66,68,53,108,36,64,8,103,70,33,4,4,30,11,19
"2021","Rhondda Cynon Taf 018A","W01001217",469,152,62,90,295,34,134,49,50,35,65,33,29,3,60,39,21,2,2,22,15,7
"2021","Rhondda Cynon Taf 018B","W01001218",636,173,75,98,422,55,198,69,67,62,78,25,44,9,84,51,33,7,7,41,20,21
"2021","Rhondda Cynon Taf 018C","W01001219",602,278,126,152,302,35,121,47,41,33,64,28,29,7,77,42,35,5,5,22,9,13
"2021","Rhondda Cynon Taf 018D","W01001220",622,175,93,82,423,60,179,64,70,45,103,36,59,8,77,46,31,4,4,24,14,10
"2021","Rhondda Cynon Taf 018E","W01001259",678,210,99,111,438,63,174,62,63,49,86,30,50,6,111,63,48,4,4,30,20,10
"2021","Rhondda Cynon Taf 018F","W01001261",558,181,82,99,351,44,147,62,52,33,58,25,30,3,99,61,38,3,3,26,18,8
"2021","Rhondda Cynon Taf 019A","W01001164",672,193,68,125,445,56,180,62,76,42,116,40,69,7,90,60,30,3,3,34,23,11
"2021","Rhondda Cynon Taf 019B","W01001165",580,150,60,90,397,47,218,105,79,34,65,32,29,4,64,40,24,3,3,33,10,23
"2021","Rhondda Cynon Taf 019C","W01001256",534,175,70,105,336,46,130,51,57,22,89,49,40,0,69,46,23,2,2,23,6,17
"2021","Rhondda Cynon Taf 019D","W01001257",531,156,80,76,358,68,193,79,78,36,47,34,12,1,47,26,21,3,3,17,8,9
"2021","Rhondda Cynon Taf 019E","W01001258",643,288,104,184,334,43,128,50,51,27,90,59,25,6,70,41,29,3,3,21,9,12
"2021","Rhondda Cynon Taf 020A","W01001172",635,218,99,119,395,58,174,64,67,43,75,30,39,6,84,54,30,4,4,22,9,13
"2021","Rhondda Cynon Taf 020B","W01001173",622,231,98,133,370,41,132,54,41,37,99,40,51,8,94,52,42,4,4,21,8,13
"2021","Rhondda Cynon Taf 020C","W01001174",630,219,85,134,385,46,153,61,58,34,72,25,39,8,108,71,37,6,6,26,13,13
"2021","Rhondda Cynon Taf 020D","W01001232",588,195,72,123,373,62,152,65,57,30,71,30,34,7,82,57,25,6,6,20,5,15
"2021","Rhondda Cynon Taf 021C","W01001227",555,134,67,67,391,82,210,75,87,48,48,24,21,3,49,27,22,2,2,30,12,18
"2021","Rhondda Cynon Taf 021D","W01001228",747,262,125,137,454,107,193,73,86,34,84,36,44,4,64,44,20,6,6,31,13,18
"2021","Rhondda Cynon Taf 021E","W01001234",660,193,83,110,442,57,190,85,71,34,115,47,40,28,75,46,29,5,5,25,12,13
"2021","Rhondda Cynon Taf 021F","W01001235",748,294,115,179,435,38,174,72,63,39,102,48,50,4,119,78,41,2,2,19,9,10
"2021","Rhondda Cynon Taf 021G","W01001236",663,174,88,86,464,67,222,72,94,56,85,35,44,6,87,43,44,3,3,25,13,12
"2021","Rhondda Cynon Taf 021H","W01001964",1076,397,122,275,614,52,229,90,91,48,193,126,52,15,128,80,48,12,12,65,23,42
"2021","Rhondda Cynon Taf 022A","W01001185",979,364,141,223,577,71,227,84,91,52,119,51,60,8,154,105,49,6,6,38,17,21
"2021","Rhondda Cynon Taf 022B","W01001237",599,160,76,84,410,54,152,51,54,47,84,35,40,9,118,70,48,2,2,29,18,11
"2021","Rhondda Cynon Taf 022C","W01001238",691,214,60,154,436,39,149,42,63,44,85,29,46,10,156,112,44,7,7,41,26,15
"2021","Rhondda Cynon Taf 022D","W01001262",623,184,50,134,322,20,118,39,67,12,88,58,24,6,82,55,27,14,14,117,14,103
"2021","Rhondda Cynon Taf 022E","W01001263",633,164,39,125,257,23,102,34,53,15,63,42,20,1,52,35,17,17,17,212,17,195
"2021","Rhondda Cynon Taf 022F","W01001264",514,156,42,114,202,26,74,27,31,16,64,39,24,1,28,12,16,10,10,156,11,145
"2021","Rhondda Cynon Taf 023A","W01001178",690,198,96,102,455,58,202,76,78,48,108,37,60,11,83,52,31,4,4,37,19,18
"2021","Rhondda Cynon Taf 023B","W01001179",738,225,117,108,469,59,208,81,75,52,82,39,36,7,114,76,38,6,6,44,27,17
"2021","Rhondda Cynon Taf 023C","W01001253",605,173,77,96,402,60,148,51,62,35,100,35,55,10,92,54,38,2,2,30,16,14
"2021","Rhondda Cynon Taf 023E","W01001255",837,226,87,139,576,53,244,82,112,50,118,47,56,15,156,99,57,5,5,35,23,12
"2021","Rhondda Cynon Taf 023F","W01001914",669,85,25,60,555,51,373,107,196,70,76,41,28,7,53,29,24,2,2,29,13,16
"2021","Rhondda Cynon Taf 023G","W01001917",618,169,87,82,422,59,193,69,65,59,86,50,31,5,83,44,39,1,1,27,15,12
"2021","Rhondda Cynon Taf 024A","W01001249",703,297,181,116,377,61,144,55,42,47,81,31,43,7,83,47,36,8,8,29,12,17
"2021","Rhondda Cynon Taf 024B","W01001250",626,142,67,75,459,98,203,68,96,39,87,45,34,8,67,34,33,4,4,25,13,12
"2021","Rhondda Cynon Taf 024C","W01001251",667,226,71,155,408,35,141,55,46,40,66,22,39,5,160,110,50,6,6,33,21,12
"2021","Rhondda Cynon Taf 024D","W01001252",663,155,68,87,489,86,250,87,100,63,90,44,40,6,59,40,19,4,4,19,8,11
"2021","Rhondda Cynon Taf 025A","W01001162",1063,307,105,202,725,60,317,80,189,48,177,80,90,7,168,115,53,3,3,31,14,17
"2021","Rhondda Cynon Taf 025B","W01001244",626,183,138,45,420,132,182,63,71,48,61,27,30,4,44,23,21,1,1,23,9,14
"2021","Rhondda Cynon Taf 025C","W01001245",512,116,84,32,378,118,180,61,74,45,46,9,34,3,33,15,18,1,1,18,10,8
"2021","Rhondda Cynon Taf 025D","W01001246",622,210,144,66,395,103,146,41,64,41,70,34,32,4,75,47,28,1,1,17,3,14
"2021","Rhondda Cynon Taf 026A","W01001184",939,305,139,166,599,105,281,112,111,58,122,62,51,9,88,47,41,3,3,35,16,19
"2021","Rhondda Cynon Taf 026B","W01001239",627,253,103,150,349,36,115,45,31,39,67,29,30,8,125,87,38,6,6,25,13,12
"2021","Rhondda Cynon Taf 026C","W01001240",863,300,119,181,527,74,259,114,93,52,121,69,45,7,71,24,47,2,2,36,15,21
"2021","Rhondda Cynon Taf 026D","W01001241",755,265,96,169,462,61,204,70,90,44,100,56,32,12,92,50,42,5,5,28,16,12
"2021","Rhondda Cynon Taf 027B","W01001196",615,161,62,99,435,64,241,85,107,49,87,49,34,4,43,24,19,0,0,19,7,12
"2021","Rhondda Cynon Taf 027C","W01001197",491,99,62,37,375,90,220,76,92,52,39,19,16,4,25,12,13,1,1,17,7,10
"2021","Rhondda Cynon Taf 027D","W01001198",662,184,97,87,461,71,219,89,82,48,97,53,36,8,72,37,35,2,2,17,6,11
"2021","Rhondda Cynon Taf 027E","W01001199",704,184,94,90,498,86,245,83,117,45,87,45,36,6,78,45,33,2,2,22,8,14
"2021","Rhondda Cynon Taf 027F","W01001915",603,109,57,52,477,41,307,82,177,48,74,35,34,5,55,38,17,0,0,17,9,8
"2021","Rhondda Cynon Taf 027G","W01001916",559,96,34,62,450,44,272,72,165,35,86,37,44,5,47,32,15,1,1,13,6,7
"2021","Rhondda Cynon Taf 028A","W01001157",591,168,76,92,401,75,181,74,63,44,82,36,41,5,61,33,28,2,2,22,8,14
"2021","Rhondda Cynon Taf 028B","W01001158",635,185,71,114,425,43,190,75,75,40,80,39,32,9,106,67,39,6,6,25,10,15
"2021","Rhondda Cynon Taf 028C","W01001159",652,136,34,102,495,33,280,108,118,54,111,57,49,5,68,53,15,3,3,21,8,13
"2021","Rhondda Cynon Taf 028D","W01001277",460,104,68,36,334,69,162,60,65,37,54,28,21,5,46,27,19,3,3,22,9,13
"2021","Rhondda Cynon Taf 028E","W01001278",437,109,49,60,293,24,124,40,54,30,77,26,44,7,64,48,16,4,4,35,12,23
"2021","Rhondda Cynon Taf 028F","W01001279",503,193,106,87,290,43,92,26,45,21,59,17,38,4,90,58,32,6,6,20,10,10
"2021","Rhondda Cynon Taf 029A","W01001160",677,150,89,61,489,96,245,100,94,51,86,43,37,6,60,41,19,2,2,38,22,16
"2021","Rhondda Cynon Taf 029C","W01001189",680,221,76,145,427,72,172,69,74,29,95,48,37,10,88,59,29,0,0,32,15,17
"2021","Rhondda Cynon Taf 029D","W01001190",1175,252,94,158,872,92,493,149,250,94,187,101,80,6,99,61,38,1,1,51,31,20
"2021","Rhondda Cynon Taf 029E","W01001965",703,192,86,106,474,63,238,78,112,48,88,39,40,9,83,51,32,2,2,37,19,18
"2021","Rhondda Cynon Taf 029F","W01001966",651,115,25,90,517,21,278,70,189,19,152,81,68,3,66,50,16,0,0,19,9,10
"2021","Rhondda Cynon Taf 030A","W01001193",478,108,67,41,359,87,190,61,82,47,41,21,17,3,41,26,15,0,0,11,5,6
"2021","Rhondda Cynon Taf 030B","W01001194",879,197,88,109,655,113,350,120,175,55,110,59,49,2,77,46,31,5,5,27,13,14
"2021","Rhondda Cynon Taf 030C","W01001195",652,227,102,125,388,50,196,90,66,40,78,46,29,3,63,40,23,1,1,37,15,22
"2021","Rhondda Cynon Taf 030D","W01001242",576,164,99,65,389,97,187,52,94,41,51,28,22,1,50,32,18,4,4,23,7,16
"2021","Rhondda Cynon Taf 030E","W01001243",682,311,144,167,356,47,152,51,71,30,75,29,35,11,77,44,33,5,5,15,5,10
"2021","Rhondda Cynon Taf 031B","W01001192",608,191,96,95,379,37,146,52,61,33,80,31,41,8,110,73,37,6,6,38,22,16
"2021","Rhondda Cynon Taf 031C","W01001223",776,220,121,99,532,107,280,100,125,55,92,60,28,4,52,33,19,1,1,24,11,13
"2021","Rhondda Cynon Taf 031D","W01001224",767,135,79,56,615,89,397,94,254,49,70,42,25,3,58,36,22,1,1,17,6,11
"2021","Rhondda Cynon Taf 031E","W01001225",653,154,82,72,466,129,242,80,117,45,61,34,25,2,34,21,13,0,0,33,12,21
"2021","Rhondda Cynon Taf 031F","W01001226",716,224,107,117,468,55,215,56,114,45,87,36,45,6,104,73,31,7,7,24,9,15
"2021","Rhondda Cynon Taf 031G","W01001967",636,163,50,113,452,54,254,82,135,37,86,61,21,4,55,37,18,3,3,21,10,11
"2021","Rhondda Cynon Taf 031H","W01001968",601,133,41,92,442,34,227,65,129,33,111,56,53,2,67,51,16,3,3,26,14,12
"2021","Caerphilly 001A","W01001374",594,164,79,85,414,56,184,56,65,63,73,17,45,11,99,56,43,2,2,16,11,5
"2021","Caerphilly 001B","W01001375",720,290,116,174,405,59,154,62,51,41,85,35,41,9,102,56,46,5,5,25,7,18
"2021","Caerphilly 001C","W01001376",648,237,115,122,389,39,123,41,38,44,77,25,47,5,142,94,48,8,8,22,9,13
"2021","Caerphilly 001D","W01001406",862,281,120,161,551,76,215,89,65,61,119,52,54,13,134,70,64,7,7,30,16,14
"2021","Caerphilly 001E","W01001428",533,162,73,89,345,32,99,38,35,26,69,19,39,11,139,75,64,6,6,26,13,13
"2021","Caerphilly 001F","W01001429",527,165,71,94,339,53,152,68,53,31,67,33,29,5,64,38,26,3,3,23,12,11
"2021","Caerphilly 002A","W01001360",562,183,99,84,348,58,157,59,55,43,73,30,34,9,57,33,24,3,3,31,17,14
"2021","Caerphilly 002B","W01001361",484,139,73,66,316,40,135,43,42,50,57,9,37,11,82,48,34,2,2,29,14,15
"2021","Caerphilly 002C","W01001384",696,235,81,154,433,56,190,85,61,44,93,34,55,4,89,58,31,5,5,28,13,15
"2021","Caerphilly 002D","W01001385",675,246,96,150,400,59,147,49,55,43,92,33,56,3,97,67,30,5,5,29,12,17
"2021","Caerphilly 002E","W01001386",691,239,107,132,418,44,156,62,52,42,80,17,55,8,135,90,45,3,3,34,15,19
"2021","Caerphilly 003A","W01001325",657,145,77,68,483,60,210,78,84,48,76,22,46,8,136,90,46,1,1,29,18,11
"2021","Caerphilly 003B","W01001326",964,316,133,183,615,64,222,92,85,45,136,62,64,10,187,136,51,6,6,33,17,16
"2021","Caerphilly 003C","W01001362",899,310,150,160,557,104,225,76,83,66,115,43,61,11,108,63,45,5,5,32,15,17
"2021","Caerphilly 004A","W01001336",615,173,87,86,424,54,167,70,53,44,87,35,42,10,114,71,43,2,2,18,7,11
"2021","Caerphilly 004B","W01001337",667,238,107,131,405,56,184,77,59,48,65,26,33,6,99,60,39,1,1,24,9,15
"2021","Caerphilly 004C","W01001338",802,299,101,198,469,59,194,74,67,53,99,38,56,5,112,76,36,5,5,34,17,17
"2021","Caerphilly 004D","W01001339",590,175,79,96,385,42,120,45,44,31,76,15,50,11,145,101,44,2,2,30,12,18
"2021","Caerphilly 005A","W01001334",596,165,76,89,397,51,147,51,56,40,84,24,49,11,112,88,24,3,3,34,12,22
"2021","Caerphilly 005B","W01001335",529,147,53,94,350,50,174,72,68,34,77,46,30,1,47,26,21,2,2,32,14,18
"2021","Caerphilly 005C","W01001347",647,186,108,78,433,75,209,74,74,61,77,35,35,7,70,42,28,2,2,28,9,19
"2021","Caerphilly 005D","W01001351",647,176,99,77,454,130,221,105,64,52,52,29,19,4,48,26,22,3,3,17,5,12
"2021","Caerphilly 006A","W01001356",478,97,66,31,374,65,187,52,80,55,72,34,31,7,49,22,27,1,1,7,2,5
"2021","Caerphilly 006B","W01001357",722,198,94,104,499,76,255,87,111,57,87,47,34,6,78,58,20,3,3,25,13,12
"2021","Caerphilly 006C","W01001358",622,173,83,90,424,71,163,65,59,39,77,21,43,13,113,71,42,0,0,25,16,9
"2021","Caerphilly 006D","W01001359",640,220,74,146,401,52,181,73,61,47,96,47,45,4,69,43,26,3,3,19,9,10
"2021","Caerphilly 006E","W01001390",801,147,67,80,631,91,361,110,188,63,92,40,51,1,84,57,27,3,3,23,12,11
"2021","Caerphilly 006F","W01001391",672,171,84,87,472,69,208,78,80,50,88,32,48,8,105,67,38,2,2,29,11,18
"2021","Caerphilly 007A","W01001352",742,221,115,106,486,50,212,72,73,67,91,31,44,16,128,63,65,5,5,35,20,15
"2021","Caerphilly 007B","W01001353",741,277,163,114,442,124,182,80,62,40,57,23,29,5,76,43,33,3,3,22,16,6
"2021","Caerphilly 007C","W01001387",530,177,76,101,330,42,142,54,57,31,69,32,29,8,77,50,27,0,0,23,13,10
"2021","Caerphilly 007D","W01001388",760,219,88,131,507,51,204,66,91,47,95,34,53,8,154,106,48,3,3,34,21,13
"2021","Caerphilly 007E","W01001389",461,132,60,72,307,53,145,49,58,38,60,28,25,7,48,32,16,1,1,22,14,8
"2021","Caerphilly 008A","W01001414",691,209,73,136,452,52,192,66,71,55,72,18,47,7,130,90,40,6,6,30,18,12
"2021","Caerphilly 008B","W01001415",721,196,80,116,487,58,236,87,100,49,105,47,50,8,82,54,28,6,6,38,21,17
"2021","Caerphilly 008C","W01001416",627,182,94,88,420,85,200,98,55,47,70,32,32,6,62,31,31,3,3,25,12,13
"2021","Caerphilly 008D","W01001417",585,142,71,71,423,74,231,81,91,59,77,37,36,4,40,24,16,1,1,20,10,10
"2021","Caerphilly 008E","W01001418",632,220,106,114,377,53,166,65,58,43,66,23,42,1,89,61,28,3,3,35,14,21
"2021","Caerphilly 009A","W01001348",727,200,119,81,489,62,164,43,81,40,106,44,58,4,150,100,50,7,7,38,21,17
"2021","Caerphilly 009B","W01001349",671,129,51,78,525,69,302,100,131,71,81,30,44,7,72,42,30,1,1,17,9,8
"2021","Caerphilly 009C","W01001350",794,264,116,148,507,85,215,80,89,46,113,53,51,9,91,54,37,3,3,23,8,15
"2021","Caerphilly 009D","W01001392",835,207,112,95,602,125,274,88,124,62,122,66,51,5,77,38,39,4,4,26,11,15
"2021","Caerphilly 010A","W01001380",769,197,98,99,543,109,236,89,93,54,92,45,40,7,100,53,47,6,6,29,13,16
"2021","Caerphilly 010B","W01001381",611,175,95,80,411,58,181,75,66,40,72,14,52,6,96,67,29,4,4,25,19,6
"2021","Caerphilly 010C","W01001382",684,228,126,102,431,85,216,81,94,41,68,32,33,3,60,33,27,2,2,25,10,15
"2021","Caerphilly 010D","W01001383",660,226,86,140,414,68,164,60,61,43,94,47,38,9,86,49,37,2,2,20,10,10
"2021","Caerphilly 011A","W01001401",889,261,142,119,589,116,242,86,99,57,118,44,61,13,109,66,43,4,4,39,19,20
"2021","Caerphilly 011B","W01001402",684,194,73,121,469,46,194,66,84,44,93,42,42,9,133,89,44,3,3,21,12,9
"2021","Caerphilly 011C","W01001403",684,229,92,137,429,49,204,79,97,28,105,52,39,14,71,49,22,0,0,26,14,12
"2021","Caerphilly 011D","W01001404",593,146,105,41,428,123,200,77,62,61,65,29,29,7,37,21,16,3,3,19,8,11
"2021","Caerphilly 011E","W01001405",747,208,120,88,508,76,230,80,93,57,98,37,49,12,98,58,40,6,6,31,13,18
"2021","Caerphilly 012A","W01001363",708,128,60,68,556,49,281,108,122,51,126,56,59,11,92,60,32,8,8,24,15,9
"2021","Caerphilly 012B","W01001364",674,160,77,83,479,30,201,58,83,60,87,31,42,14,152,114,38,9,9,35,18,17
"2021","Caerphilly 012C","W01001365",820,237,79,158,543,69,262,94,106,62,114,46,54,14,92,53,39,6,6,40,17,23
"2021","Caerphilly 012D","W01001369",1054,303,153,150,712,118,353,135,143,75,149,76,67,6,90,51,39,2,2,39,13,26
"2021","Caerphilly 013A","W01001377",672,214,106,108,435,100,199,87,61,51,63,34,23,6,70,36,34,3,3,23,15,8
"2021","Caerphilly 013B","W01001378",677,232,138,94,412,83,168,84,52,32,66,20,35,11,91,50,41,4,4,33,16,17
"2021","Caerphilly 013C","W01001379",644,162,86,76,466,87,210,69,93,48,82,34,39,9,83,55,28,4,4,16,13,3
"2021","Caerphilly 013D","W01001432",1131,337,122,215,745,79,361,104,200,57,184,93,83,8,116,78,38,5,5,49,23,26
"2021","Caerphilly 013E","W01001433",648,260,127,133,365,54,161,59,70,32,67,32,30,5,83,43,40,0,0,23,10,13
"2021","Caerphilly 013F","W01001434",544,121,66,55,404,63,236,75,115,46,59,25,30,4,46,23,23,0,0,19,6,13
"2021","Caerphilly 014A","W01001327",1092,345,115,230,710,80,334,129,139,66,164,83,71,10,128,85,43,4,4,37,18,19
"2021","Caerphilly 014B","W01001328",655,198,92,106,435,63,197,76,77,44,105,43,51,11,68,39,29,2,2,22,12,10
"2021","Caerphilly 014C","W01001329",657,225,106,119,401,56,173,68,65,40,72,30,31,11,99,64,35,1,1,31,18,13
"2021","Caerphilly 014D","W01001354",721,192,75,117,504,79,236,82,96,58,106,68,33,5,79,49,30,4,4,25,11,14
"2021","Caerphilly 015A","W01001355",751,321,171,150,413,83,194,71,82,41,80,42,35,3,54,27,27,2,2,17,8,9
"2021","Caerphilly 015B","W01001430",1012,307,104,203,657,67,332,119,139,74,130,56,61,13,123,88,35,5,5,48,24,24
"2021","Caerphilly 015C","W01001431",653,165,84,81,453,51,208,80,72,56,115,49,57,9,77,42,35,2,2,35,13,22
"2021","Caerphilly 016A","W01001407",609,200,75,125,387,62,191,88,69,34,66,41,21,4,63,46,17,5,5,22,12,10
"2021","Caerphilly 016B","W01001408",601,158,65,93,411,46,153,66,49,38,88,36,42,10,116,74,42,8,8,32,20,12
"2021","Caerphilly 016C","W01001409",700,202,91,111,472,83,225,85,80,60,78,34,39,5,81,39,42,5,5,26,12,14
"2021","Caerphilly 016D","W01001410",830,318,147,171,479,62,209,61,89,59,90,38,48,4,113,71,42,5,5,33,11,22
"2021","Caerphilly 017A","W01001411",765,286,140,146,460,76,208,87,73,48,91,52,33,6,81,46,35,4,4,19,14,5
"2021","Caerphilly 017B","W01001412",835,347,141,206,455,69,202,89,74,39,83,46,31,6,100,64,36,1,1,33,15,18
"2021","Caerphilly 017C","W01001413",762,224,117,107,500,54,242,73,103,66,97,43,44,10,102,63,39,5,5,38,20,18
"2021","Caerphilly 018A","W01001330",613,175,98,77,416,62,162,62,67,33,99,52,43,4,92,56,36,1,1,22,11,11
"2021","Caerphilly 018B","W01001331",729,213,66,147,484,44,200,73,76,51,108,52,48,8,126,88,38,6,6,32,18,14
"2021","Caerphilly 018C","W01001332",803,283,100,183,500,52,206,75,78,53,104,33,59,12,135,101,34,3,3,20,9,11
"2021","Caerphilly 018D","W01001333",628,193,52,141,411,47,151,54,65,32,88,34,45,9,122,90,32,3,3,24,13,11
"2021","Caerphilly 019A","W01001366",699,202,98,104,468,95,207,80,86,41,73,45,25,3,91,55,36,2,2,29,12,17
"2021","Caerphilly 019B","W01001367",659,230,92,138,400,46,175,61,63,51,90,47,37,6,86,58,28,3,3,29,18,11
"2021","Caerphilly 019C","W01001368",645,232,101,131,386,46,167,76,54,37,69,30,33,6,99,59,40,5,5,27,16,11
"2021","Caerphilly 019D","W01001393",538,135,76,59,368,64,149,54,68,27,74,25,43,6,71,47,24,10,10,35,20,15
"2021","Caerphilly 019E","W01001397",684,189,75,114,478,60,260,108,92,60,85,43,40,2,73,39,34,0,0,17,7,10
"2021","Caerphilly 019F","W01001400",557,149,62,87,374,23,141,35,68,38,62,19,34,9,147,100,47,1,1,34,19,15
"2021","Caerphilly 020A","W01001340",773,170,94,76,568,104,326,115,135,76,82,54,24,4,55,31,24,1,1,35,16,19
"2021","Caerphilly 020B","W01001341",761,257,126,131,468,52,194,69,72,53,92,39,42,11,123,78,45,7,7,36,19,17
"2021","Caerphilly 020C","W01001344",716,228,112,116,452,86,220,82,82,56,61,26,28,7,82,52,30,3,3,36,15,21
"2021","Caerphilly 020D","W01001346",656,213,108,105,413,65,173,53,81,39,76,25,46,5,95,64,31,4,4,30,16,14
"2021","Caerphilly 021A","W01001342",516,163,73,90,333,60,173,62,86,25,50,27,21,2,45,27,18,5,5,20,13,7
"2021","Caerphilly 021B","W01001343",482,135,72,63,332,65,171,71,71,29,55,23,26,6,37,27,10,4,4,15,9,6
"2021","Caerphilly 021C","W01001345",577,161,49,112,400,34,114,35,49,30,78,22,50,6,172,128,44,2,2,16,6,10
"2021","Caerphilly 021D","W01001419",667,152,67,85,476,69,266,112,110,44,80,50,25,5,58,27,31,3,3,39,22,17
"2021","Caerphilly 022A","W01001371",824,228,99,129,563,56,227,80,105,42,115,56,53,6,157,108,49,8,8,33,15,18
"2021","Caerphilly 022B","W01001372",814,238,101,137,546,117,235,91,83,61,103,55,40,8,90,56,34,1,1,30,14,16
"2021","Caerphilly 022C","W01001373",824,245,103,142,558,60,289,96,129,64,99,46,47,6,107,70,37,3,3,21,11,10
"2021","Caerphilly 022D","W01001420",557,139,67,72,398,92,163,77,56,30,59,36,21,2,80,57,23,4,4,20,7,13
"2021","Caerphilly 022E","W01001421",683,285,81,204,376,25,116,38,52,26,66,28,32,6,166,104,62,3,3,22,9,13
"2021","Caerphilly 022F","W01001422",658,228,112,116,408,95,129,53,50,26,69,25,35,9,110,70,40,5,5,22,9,13
"2021","Caerphilly 023A","W01001370",837,283,153,130,518,96,235,100,91,44,100,42,52,6,82,50,32,5,5,36,12,24
"2021","Caerphilly 023B","W01001394",501,84,40,44,400,73,208,62,94,52,63,27,31,5,55,28,27,1,1,17,9,8
"2021","Caerphilly 023C","W01001395",591,200,120,80,358,67,147,60,51,36,65,23,37,5,78,38,40,1,1,33,17,16
"2021","Caerphilly 023D","W01001396",643,185,82,103,426,47,156,47,73,36,82,31,39,12,136,85,51,5,5,32,20,12
"2021","Caerphilly 023E","W01001399",561,172,115,57,374,67,193,94,67,32,57,27,28,2,55,31,24,2,2,15,6,9
"2021","Caerphilly 024A","W01001398",1068,248,77,171,788,56,448,118,270,60,165,84,73,8,118,89,29,1,1,32,13,19
"2021","Caerphilly 024B","W01001423",640,205,131,74,410,121,186,78,62,46,64,27,32,5,39,15,24,0,0,25,10,15
"2021","Caerphilly 024C","W01001424",649,249,117,132,376,57,147,57,60,30,86,47,34,5,86,45,41,0,0,24,9,15
"2021","Caerphilly 024D","W01001425",786,258,113,145,497,73,240,85,106,49,103,55,45,3,76,50,26,5,5,31,15,16
"2021","Caerphilly 024E","W01001426",581,120,69,51,441,89,249,84,113,52,65,35,27,3,38,23,15,0,0,20,9,11
"2021","Caerphilly 024F","W01001427",741,164,45,119,559,43,327,102,170,55,113,66,46,1,73,55,18,3,3,18,8,10
"2021","Blaenau Gwent 001A","W01001440",604,180,89,91,397,71,172,77,55,40,62,26,34,2,90,53,37,2,2,27,11,16
"2021","Blaenau Gwent 001B","W01001441",487,139,60,79,330,35,125,58,35,32,64,18,42,4,102,77,25,4,4,18,12,6
"2021","Blaenau Gwent 001C","W01001442",478,132,55,77,322,75,150,55,60,35,59,27,31,1,37,23,14,1,1,24,13,11
"2021","Blaenau Gwent 001D","W01001470",621,156,90,66,445,101,210,87,69,54,71,35,27,9,60,29,31,3,3,20,10,10
"2021","Blaenau Gwent 001E","W01001471",737,265,118,147,437,50,153,59,53,41,82,32,43,7,149,92,57,3,3,35,17,18
"2021","Blaenau Gwent 002A","W01001446",511,156,68,88,339,56,163,62,57,44,70,28,33,9,44,30,14,6,6,16,11,5
"2021","Blaenau Gwent 002B","W01001447",612,186,77,109,391,36,158,56,57,45,78,25,47,6,111,74,37,8,8,35,18,17
"2021","Blaenau Gwent 002C","W01001448",601,263,91,172,321,58,134,56,44,34,56,30,26,0,70,47,23,3,3,17,7,10
"2021","Blaenau Gwent 002D","W01001449",698,310,120,190,380,50,163,62,55,46,81,32,38,11,86,52,34,0,0,8,5,3
"2021","Blaenau Gwent 003A","W01001472",603,165,81,84,415,69,204,79,73,52,81,39,32,10,59,27,32,2,2,23,13,10
"2021","Blaenau Gwent 003B","W01001473",570,184,87,97,368,55,116,47,33,36,65,12,49,4,126,81,45,6,6,18,9,9
"2021","Blaenau Gwent 003C","W01001474",632,186,99,87,421,81,186,74,56,56,66,20,37,9,85,54,31,3,3,25,10,15
"2021","Blaenau Gwent 003D","W01001475",485,138,51,87,329,34,164,62,66,36,66,23,33,10,62,31,31,3,3,18,3,15
"2021","Blaenau Gwent 003E","W01001480",645,196,108,88,421,48,167,63,68,36,73,22,40,11,126,67,59,7,7,28,12,16
"2021","Blaenau Gwent 004A","W01001438",682,237,124,113,425,70,188,70,61,57,83,38,38,7,80,40,40,4,4,20,12,8
"2021","Blaenau Gwent 004B","W01001439",679,178,86,92,472,84,241,86,84,71,74,23,42,9,72,43,29,1,1,29,11,18
"2021","Blaenau Gwent 004C","W01001456",557,177,79,98,347,51,137,55,42,40,60,29,29,2,96,60,36,3,3,33,19,14
"2021","Blaenau Gwent 004D","W01001457",803,276,107,169,490,44,154,50,56,48,103,35,58,10,185,116,69,4,4,37,21,16
"2021","Blaenau Gwent 004E","W01001458",720,183,88,95,521,68,217,88,73,56,128,60,63,5,104,68,36,4,4,16,8,8
"2021","Blaenau Gwent 005A","W01001443",621,254,111,143,357,58,143,69,44,30,70,39,23,8,84,53,31,2,2,10,5,5
"2021","Blaenau Gwent 005B","W01001444",844,239,120,119,576,74,266,106,108,52,115,50,52,13,115,70,45,6,6,29,20,9
"2021","Blaenau Gwent 005C","W01001445",606,191,82,109,395,51,174,67,62,45,75,31,38,6,91,50,41,4,4,20,8,12
"2021","Blaenau Gwent 005D","W01001467",804,239,121,118,546,64,248,92,108,48,115,38,68,9,115,71,44,4,4,19,9,10
"2021","Blaenau Gwent 005E","W01001468",601,187,73,114,391,63,143,64,47,32,87,33,38,16,93,51,42,5,5,23,11,12
"2021","Blaenau Gwent 005F","W01001469",551,158,74,84,369,50,160,54,64,42,66,17,40,9,87,54,33,6,6,24,8,16
"2021","Blaenau Gwent 006A","W01001462",801,262,108,154,515,60,251,89,110,52,108,44,57,7,93,59,34,3,3,24,13,11
"2021","Blaenau Gwent 006B","W01001463",860,310,114,196,531,85,220,86,86,48,116,56,50,10,107,69,38,3,3,19,11,8
"2021","Blaenau Gwent 006C","W01001478",647,218,84,134,413,64,179,72,56,51,100,48,47,5,65,38,27,5,5,16,6,10
"2021","Blaenau Gwent 006D","W01001479",676,255,114,141,393,38,106,36,37,33,91,34,50,7,149,109,40,9,9,28,17,11
"2021","Blaenau Gwent 006E","W01001481",828,384,138,246,420,49,177,69,67,41,77,41,31,5,113,67,46,4,4,24,7,17
"2021","Blaenau Gwent 007A","W01001450",532,157,92,65,354,58,150,50,52,48,70,22,34,14,74,47,27,2,2,21,8,13
"2021","Blaenau Gwent 007B","W01001451",645,261,108,153,370,50,134,57,40,37,90,32,43,15,94,66,28,2,2,14,9,5
"2021","Blaenau Gwent 007C","W01001452",632,165,58,107,441,61,230,108,66,56,77,42,31,4,71,48,23,2,2,26,14,12
"2021","Blaenau Gwent 007D","W01001459",477,138,58,80,321,29,101,27,45,29,85,27,44,14,103,77,26,3,3,18,11,7
"2021","Blaenau Gwent 007E","W01001460",788,289,93,196,467,47,201,77,83,41,141,82,55,4,76,47,29,2,2,32,13,19
"2021","Blaenau Gwent 007F","W01001461",620,254,101,153,349,40,144,50,58,36,73,35,36,2,86,54,32,6,6,17,7,10
"2021","Blaenau Gwent 008A","W01001435",618,221,79,142,370,39,165,59,62,44,76,26,39,11,87,48,39,3,3,27,12,15
"2021","Blaenau Gwent 008B","W01001436",664,274,109,165,369,45,152,67,51,34,79,35,36,8,86,58,28,7,7,21,12,9
"2021","Blaenau Gwent 008C","W01001437",644,195,97,98,432,55,218,84,81,53,80,38,37,5,78,47,31,1,1,17,8,9
"2021","Blaenau Gwent 008D","W01001453",631,204,96,108,400,46,180,53,75,52,78,28,40,10,89,59,30,7,7,27,18,9
"2021","Blaenau Gwent 008E","W01001454",582,192,80,112,377,45,177,72,55,50,69,33,30,6,83,54,29,3,3,13,4,9
"2021","Blaenau Gwent 008F","W01001455",770,274,128,146,466,61,194,68,70,56,89,40,43,6,122,75,47,0,0,30,19,11
"2021","Blaenau Gwent 009A","W01001464",665,258,91,167,380,37,163,57,63,43,74,39,29,6,101,61,40,5,5,27,11,16
"2021","Blaenau Gwent 009B","W01001465",695,211,94,117,459,62,173,73,65,35,98,45,46,7,123,75,48,3,3,25,8,17
"2021","Blaenau Gwent 009C","W01001466",734,312,112,200,406,60,148,60,48,40,104,58,39,7,86,50,36,8,8,16,7,9
"2021","Blaenau Gwent 009F","W01001973",1060,360,148,212,667,84,280,117,89,74,147,75,61,11,150,90,60,6,6,33,15,18
"2021","Torfaen 001A","W01001487",711,219,103,116,466,64,225,79,101,45,106,48,51,7,69,47,22,2,2,26,13,13
"2021","Torfaen 001B","W01001488",647,212,100,112,413,42,147,50,69,28,93,35,54,4,129,85,44,2,2,22,12,10
"2021","Torfaen 001C","W01001489",676,249,105,144,403,64,157,68,56,33,92,46,45,1,87,64,23,3,3,24,11,13
"2021","Torfaen 001D","W01001490",647,238,96,142,399,55,159,54,68,37,95,52,40,3,89,67,22,1,1,10,2,8
"2021","Torfaen 002A","W01001482",515,140,71,69,341,39,121,48,50,23,87,31,46,10,92,56,36,2,2,34,13,21
"2021","Torfaen 002B","W01001483",585,152,72,80,397,37,133,47,56,30,93,26,59,8,133,99,34,1,1,36,21,15
"2021","Torfaen 002C","W01001484",681,169,88,81,484,66,258,95,98,65,90,43,38,9,68,37,31,2,2,28,10,18
"2021","Torfaen 002D","W01001485",555,186,100,86,345,50,145,57,57,31,58,20,34,4,90,58,32,2,2,24,13,11
"2021","Torfaen 002E","W01001486",644,203,86,117,413,54,173,66,60,47,104,56,41,7,76,49,27,6,6,28,13,15
"2021","Torfaen 003A","W01001525",723,167,85,82,525,73,229,75,100,54,109,42,63,4,112,76,36,2,2,31,13,18
"2021","Torfaen 003B","W01001529",952,343,106,237,577,76,227,85,85,57,119,59,49,11,146,104,42,9,9,32,18,14
"2021","Torfaen 003C","W01001530",671,165,69,96,474,29,152,54,64,34,122,24,80,18,166,124,42,5,5,32,15,17
"2021","Torfaen 003D","W01001531",717,209,100,109,480,56,200,81,67,52,91,36,46,9,125,85,40,8,8,28,13,15
"2021","Torfaen 004A","W01001491",798,302,133,169,463,69,175,70,69,36,87,34,43,10,127,95,32,5,5,33,15,18
"2021","Torfaen 004B","W01001496",647,197,77,120,422,60,151,59,60,32,85,25,49,11,120,75,45,6,6,28,13,15
"2021","Torfaen 004C","W01001523",634,203,81,122,405,46,171,55,59,57,109,57,50,2,79,54,25,0,0,26,10,16
"2021","Torfaen 004D","W01001524",890,362,155,207,486,103,204,69,78,57,87,44,36,7,87,49,38,5,5,42,19,23
"2021","Torfaen 004E","W01001540",556,184,65,119,353,41,174,61,80,33,89,51,35,3,49,31,18,0,0,19,10,9
"2021","Torfaen 004F","W01001541",470,133,65,68,307,49,157,67,56,34,44,20,18,6,56,38,18,1,1,30,17,13
"2021","Torfaen 005A","W01001510",739,248,127,121,467,104,193,76,78,39,83,45,31,7,86,50,36,1,1,24,13,11
"2021","Torfaen 005B","W01001511",720,249,139,110,446,97,185,62,78,45,61,30,19,12,98,67,31,5,5,25,12,13
"2021","Torfaen 005C","W01001512",608,158,117,41,435,143,198,90,66,42,65,37,21,7,28,11,17,1,1,15,8,7
"2021","Torfaen 005D","W01001513",626,131,83,48,480,125,257,96,100,61,51,21,25,5,47,26,21,0,0,15,7,8
"2021","Torfaen 006A","W01001514",493,144,78,66,333,73,162,74,47,41,58,32,22,4,40,26,14,0,0,16,9,7
"2021","Torfaen 006B","W01001515",633,228,66,162,384,51,173,67,63,43,86,48,36,2,72,45,27,2,2,21,7,14
"2021","Torfaen 006C","W01001516",627,181,84,97,429,53,185,74,62,49,89,37,44,8,96,52,44,6,6,17,13,4
"2021","Torfaen 006D","W01001517",1021,287,107,180,699,91,367,107,196,64,130,76,45,9,108,74,34,3,3,35,18,17
"2021","Torfaen 006E","W01001518",483,121,86,35,351,92,174,68,76,30,40,22,16,2,41,20,21,4,4,11,3,8
"2021","Torfaen 007A","W01001519",591,216,78,138,336,22,122,52,42,28,62,28,30,4,129,76,53,1,1,39,19,20
"2021","Torfaen 007B","W01001520",1065,252,95,157,771,92,336,103,171,62,211,124,72,15,129,95,34,3,3,42,14,28
"2021","Torfaen 007C","W01001521",616,180,64,116,408,46,178,65,69,44,83,41,36,6,95,58,37,6,6,28,12,16
"2021","Torfaen 007D","W01001522",749,306,155,151,407,48,194,70,78,46,70,28,32,10,90,51,39,5,5,36,17,19
"2021","Torfaen 007E","W01001537",507,137,77,60,355,73,195,74,62,59,42,22,20,0,42,31,11,3,3,15,5,10
"2021","Torfaen 008A","W01001493",879,336,171,165,516,72,195,89,72,34,116,62,48,6,128,73,55,5,5,27,12,15
"2021","Torfaen 008B","W01001494",663,178,116,62,460,102,221,83,90,48,66,26,35,5,68,42,26,3,3,25,13,12
"2021","Torfaen 008C","W01001495",828,286,184,102,503,120,246,96,87,63,66,29,32,5,71,41,30,0,0,39,16,23
"2021","Torfaen 008D","W01001507",879,290,174,116,562,94,264,94,103,67,100,45,51,4,98,64,34,6,6,27,8,19
"2021","Torfaen 009A","W01001501",515,104,40,64,382,39,132,48,49,35,100,41,47,12,110,65,45,1,1,29,18,11
"2021","Torfaen 009B","W01001503",484,129,52,77,332,34,144,43,61,40,67,17,43,7,83,56,27,4,4,23,12,11
"2021","Torfaen 009C","W01001536",476,152,54,98,298,19,112,40,47,25,58,15,34,9,107,78,29,2,2,26,15,11
"2021","Torfaen 009D","W01001538",589,208,84,124,363,38,134,53,53,28,74,28,39,7,108,78,30,9,9,18,8,10
"2021","Torfaen 009E","W01001539",596,157,75,82,411,45,167,61,71,35,90,41,44,5,103,70,33,6,6,28,10,18
"2021","Torfaen 010A","W01001506",779,377,131,246,377,46,154,58,59,37,75,42,31,2,98,54,44,4,4,25,8,17
"2021","Torfaen 010B","W01001526",596,191,65,126,373,57,146,48,67,31,69,31,32,6,98,69,29,3,3,32,10,22
"2021","Torfaen 010C","W01001527",628,307,175,132,304,38,141,69,48,24,55,22,30,3,63,39,24,7,7,17,4,13
"2021","Torfaen 010D","W01001528",728,189,71,118,502,50,211,75,97,39,147,70,71,6,92,59,33,2,2,37,19,18
"2021","Torfaen 010E","W01001532",750,248,119,129,468,44,182,55,78,49,93,38,45,10,140,106,34,9,9,34,20,14
"2021","Torfaen 011A","W01001497",585,170,86,84,385,61,162,59,59,44,64,20,41,3,89,60,29,9,9,30,13,17
"2021","Torfaen 011B","W01001498",524,150,73,77,349,51,140,51,57,32,47,17,25,5,111,77,34,0,0,25,12,13
"2021","Torfaen 011C","W01001499",514,154,53,101,346,29,155,62,57,36,91,43,41,7,70,41,29,1,1,14,9,5
"2021","Torfaen 011D","W01001500",501,114,42,72,360,66,213,78,96,39,54,32,16,6,27,17,10,0,0,27,12,15
"2021","Torfaen 011E","W01001502",493,114,51,63,364,70,193,71,74,48,49,22,20,7,49,32,17,3,3,15,9,6
"2021","Torfaen 012A","W01001492",990,226,105,121,716,140,337,112,148,77,101,37,60,4,137,81,56,1,1,48,23,25
"2021","Torfaen 012B","W01001533",629,134,64,70,469,69,290,119,110,61,67,39,25,3,41,26,15,2,2,26,13,13
"2021","Torfaen 012C","W01001534",632,195,90,105,422,78,202,91,69,42,75,33,34,8,67,43,24,0,0,15,9,6
"2021","Torfaen 012D","W01001535",561,162,79,83,378,65,195,96,59,40,60,29,27,4,58,33,25,0,0,21,9,12
"2021","Torfaen 013A","W01001504",998,319,143,176,618,81,308,106,131,71,112,39,66,7,115,68,47,2,2,61,25,36
"2021","Torfaen 013B","W01001505",1097,260,95,165,789,106,392,142,179,71,190,109,69,12,97,58,39,4,4,48,19,29
"2021","Torfaen 013C","W01001508",513,156,98,58,340,94,160,60,53,47,48,25,20,3,37,24,13,1,1,17,12,5
"2021","Torfaen 013D","W01001509",606,141,91,50,448,109,262,108,89,65,42,20,19,3,35,19,16,0,0,17,4,13
"2021","Monmouthshire 001A","W01001545",671,217,156,61,427,153,204,86,89,29,34,18,15,1,35,19,16,1,1,27,15,12
"2021","Monmouthshire 001B","W01001548",900,215,112,103,625,149,336,159,114,63,82,45,26,11,54,21,33,4,4,60,21,39
"2021","Monmouthshire 001C","W01001557",943,445,197,248,458,68,201,79,78,44,93,54,33,6,91,64,27,5,5,40,9,31
"2021","Monmouthshire 001D","W01001571",639,172,84,88,442,87,222,86,84,52,68,42,25,1,63,31,32,2,2,25,11,14
"2021","Monmouthshire 001E","W01001579",849,379,201,178,444,138,174,80,61,33,74,48,23,3,53,35,18,5,5,26,7,19
"2021","Monmouthshire 002A","W01001546",689,245,91,154,417,46,165,56,79,30,78,27,43,8,127,81,46,1,1,27,10,17
"2021","Monmouthshire 002C","W01001558",735,289,176,113,423,81,189,68,77,44,68,26,35,7,82,55,27,3,3,23,11,12
"2021","Monmouthshire 002E","W01001580",827,325,206,119,466,85,217,85,97,35,68,38,24,6,95,57,38,1,1,36,13,23
"2021","Monmouthshire 002G","W01001974",636,201,97,104,414,50,159,67,60,32,81,34,41,6,118,90,28,6,6,21,11,10
"2021","Monmouthshire 002H","W01001975",626,213,105,108,399,78,157,47,74,36,60,31,26,3,103,69,34,1,1,14,4,10
"2021","Monmouthshire 003A","W01001561",691,179,125,54,489,158,247,103,99,45,51,25,22,4,31,17,14,2,2,23,9,14
"2021","Monmouthshire 003B","W01001562",599,164,69,95,412,55,218,97,85,36,90,50,31,9,47,23,24,2,2,23,11,12
"2021","Monmouthshire 003C","W01001563",515,176,99,77,318,56,140,55,53,32,66,31,33,2,55,35,20,1,1,21,4,17
"2021","Monmouthshire 003E","W01001569",606,167,110,57,419,111,203,92,67,44,56,25,24,7,45,25,20,4,4,20,7,13
"2021","Monmouthshire 003F","W01001976",695,180,112,68,482,115,250,101,92,57,56,29,26,1,56,30,26,5,5,33,12,21
"2021","Monmouthshire 003G","W01001977",606,168,80,88,430,75,194,59,99,36,78,32,38,8,82,62,20,1,1,8,3,5
"2021","Monmouthshire 004A","W01001552",632,148,106,42,464,144,259,90,115,54,26,11,14,1,34,18,16,1,1,20,9,11
"2021","Monmouthshire 004C","W01001554",768,390,214,176,351,99,136,58,54,24,52,39,11,2,62,36,26,2,2,27,10,17
"2021","Monmouthshire 004D","W01001576",496,179,78,101,302,46,114,42,44,28,73,41,26,6,67,43,24,2,2,15,6,9
"2021","Monmouthshire 004E","W01001577",625,287,149,138,322,58,104,37,47,20,65,29,33,3,90,63,27,5,5,16,8,8
"2021","Monmouthshire 004F","W01001599",997,362,223,139,601,138,280,108,116,56,78,44,30,4,102,69,33,3,3,34,13,21
"2021","Monmouthshire 004G","W01001978",686,240,128,112,431,85,206,66,89,51,66,28,34,4,68,38,30,6,6,15,2,13
"2021","Monmouthshire 004H","W01001979",809,163,63,100,615,71,334,126,158,50,119,56,59,4,88,61,27,3,3,31,18,13
"2021","Monmouthshire 005C","W01001568",730,148,85,63,540,125,320,137,117,66,52,29,19,4,39,16,23,4,4,42,19,23
"2021","Monmouthshire 005D","W01001575",512,113,64,49,370,98,178,72,70,36,54,31,21,2,39,20,19,1,1,29,13,16
"2021","Monmouthshire 005E","W01001581",862,247,173,74,586,161,290,119,106,65,75,43,26,6,56,31,25,4,4,29,14,15
"2021","Monmouthshire 005F","W01001980",926,222,123,99,654,150,350,163,106,81,82,55,25,2,65,38,27,7,7,50,23,27
"2021","Monmouthshire 006A","W01001555",500,109,74,35,369,106,210,101,67,42,33,20,12,1,19,8,11,1,1,22,9,13
"2021","Monmouthshire 006B","W01001556",596,171,96,75,404,67,221,82,90,49,66,35,24,7,49,27,22,1,1,21,8,13
"2021","Monmouthshire 006C","W01001560",543,107,63,44,400,105,223,100,78,45,44,25,18,1,27,16,11,1,1,36,13,23
"2021","Monmouthshire 006D","W01001565",751,170,113,57,536,137,295,125,98,72,64,35,26,3,38,17,21,2,2,45,18,27
"2021","Monmouthshire 006E","W01001596",491,230,168,62,256,86,102,47,29,26,38,28,10,0,30,21,9,0,0,5,4,1
"2021","Monmouthshire 006F","W01001597",678,225,109,116,430,106,196,76,81,39,67,44,20,3,59,33,26,2,2,23,8,15
"2021","Monmouthshire 007A","W01001549",607,146,71,75,433,111,232,108,75,49,48,30,16,2,41,16,25,1,1,28,14,14
"2021","Monmouthshire 007B","W01001583",665,186,117,69,434,108,243,104,94,45,52,32,15,5,31,18,13,0,0,45,17,28
"2021","Monmouthshire 007C","W01001585",537,132,71,61,398,97,208,71,98,39,57,26,30,1,36,23,13,0,0,7,2,5
"2021","Monmouthshire 007D","W01001586",1009,233,115,118,739,145,416,145,212,59,99,48,46,5,75,50,25,4,4,37,11,26
"2021","Monmouthshire 007E","W01001594",565,109,68,41,424,89,238,121,83,34,58,27,28,3,39,17,22,0,0,32,19,13
"2021","Monmouthshire 007F","W01001595",545,111,82,29,413,112,238,103,84,51,46,31,12,3,17,9,8,0,0,21,8,13
"2021","Monmouthshire 008A","W01001559",559,167,93,74,367,97,162,67,59,36,48,23,25,0,57,35,22,3,3,25,16,9
"2021","Monmouthshire 008B","W01001584",792,254,109,145,511,67,216,82,77,57,97,52,35,10,120,72,48,11,11,27,17,10
"2021","Monmouthshire 008C","W01001587",1052,546,198,348,479,55,190,87,76,27,128,89,34,5,102,71,31,4,4,27,8,19
"2021","Monmouthshire 008D","W01001592",685,222,91,131,418,34,180,59,86,35,82,39,41,2,119,77,42,3,3,45,25,20
"2021","Monmouthshire 008E","W01001593",754,233,85,148,484,51,229,96,90,43,111,73,34,4,92,51,41,1,1,37,8,29
"2021","Monmouthshire 009A","W01001542",883,231,115,116,614,112,345,139,158,48,92,51,35,6,60,34,26,5,5,38,15,23
"2021","Monmouthshire 009B","W01001543",710,149,84,65,542,113,298,90,154,54,75,39,31,5,53,27,26,3,3,19,13,6
"2021","Monmouthshire 009C","W01001578",1086,292,155,137,746,141,392,160,157,75,137,89,39,9,74,40,34,2,2,48,19,29
"2021","Monmouthshire 009D","W01001590",887,175,102,73,670,175,369,160,128,81,81,50,28,3,44,19,25,1,1,42,18,24
"2021","Monmouthshire 010C","W01001551",464,113,63,50,329,34,153,53,69,31,66,27,33,6,73,39,34,3,3,22,12,10
"2021","Monmouthshire 010D","W01001588",739,222,144,78,489,145,232,90,83,59,59,34,20,5,52,26,26,1,1,28,9,19
"2021","Monmouthshire 010E","W01001589",662,231,90,141,403,82,171,70,60,41,62,26,33,3,83,57,26,5,5,28,13,15
"2021","Monmouthshire 010F","W01001598",717,221,102,119,461,58,183,61,83,39,97,46,45,6,118,69,49,5,5,35,16,19
"2021","Monmouthshire 010G","W01001908",932,269,149,120,622,104,257,94,108,55,118,49,59,10,137,99,38,6,6,41,17,24
"2021","Monmouthshire 011A","W01001572",708,215,106,109,475,102,255,95,103,57,64,32,31,1,53,33,20,1,1,18,12,6
"2021","Monmouthshire 011B","W01001573",568,101,59,42,442,80,278,117,112,49,41,24,15,2,39,18,21,4,4,25,11,14
"2021","Monmouthshire 011C","W01001574",602,181,82,99,402,71,203,73,90,40,72,43,28,1,53,31,22,3,3,19,6,13
"2021","Monmouthshire 011D","W01001582",745,176,83,93,539,66,283,97,126,60,95,51,41,3,92,56,36,3,3,30,14,16
"2021","Monmouthshire 011E","W01001591",624,121,47,74,486,41,310,101,144,65,96,62,33,1,38,24,14,1,1,17,9,8
"2021","Newport 001A","W01001623",646,245,125,120,378,72,188,65,91,32,62,39,16,7,53,38,15,3,3,23,9,14
"2021","Newport 001B","W01001624",503,131,70,61,364,64,199,67,94,38,44,21,18,5,55,39,16,2,2,8,5,3
"2021","Newport 001C","W01001625",570,197,112,85,360,79,194,90,63,41,43,25,14,4,42,19,23,2,2,13,5,8
"2021","Newport 001D","W01001626",605,136,74,62,438,88,219,64,108,47,59,29,24,6,68,41,27,4,4,31,12,19
"2021","Newport 001E","W01001627",682,163,90,73,490,112,264,91,115,58,65,44,19,2,47,24,23,2,2,29,15,14
"2021","Newport 001F","W01001628",515,205,110,95,295,37,114,42,41,31,56,28,23,5,87,61,26,1,1,15,6,9
"2021","Newport 002A","W01001651",618,163,99,64,429,114,201,71,82,48,69,36,27,6,41,19,22,4,4,26,10,16
"2021","Newport 002B","W01001652",724,248,104,144,434,47,121,33,54,34,77,27,38,12,182,116,66,7,7,42,22,20
"2021","Newport 002C","W01001653",604,154,97,57,429,102,207,72,74,61,54,26,25,3,64,28,36,2,2,21,9,12
"2021","Newport 002D","W01001654",684,195,112,83,456,68,220,90,86,44,89,41,39,9,74,39,35,5,5,33,22,11
"2021","Newport 002E","W01001655",646,164,95,69,462,111,212,69,95,48,78,26,46,6,61,34,27,0,0,20,13,7
"2021","Newport 003A","W01001617",580,190,91,99,334,42,99,39,39,21,52,22,26,4,115,93,22,26,26,56,46,10
"2021","Newport 003B","W01001618",490,149,76,73,311,40,102,35,43,24,57,23,26,8,110,62,48,2,2,30,12,18
"2021","Newport 003C","W01001619",585,193,73,120,355,31,115,26,52,37,83,23,55,5,122,86,36,4,4,37,18,19
"2021","Newport 003D","W01001620",692,190,68,122,461,44,188,55,86,47,90,37,45,8,138,108,30,1,1,41,25,16
"2021","Newport 003E","W01001621",597,181,94,87,388,60,126,37,53,36,94,29,61,4,105,60,45,3,3,28,13,15
"2021","Newport 003F","W01001622",515,156,60,96,340,34,141,49,47,45,62,24,31,7,99,51,48,4,4,19,9,10
"2021","Newport 004A","W01001639",855,156,69,87,666,86,405,136,200,69,85,39,39,7,87,49,38,3,3,33,11,22
"2021","Newport 004B","W01001640",485,109,79,30,349,95,193,99,55,39,35,21,10,4,20,6,14,6,6,27,12,15
"2021","Newport 004C","W01001641",541,116,74,42,388,99,234,97,93,44,27,9,17,1,23,10,13,5,5,37,13,24
"2021","Newport 004E","W01001650",651,189,61,128,429,39,210,75,92,43,90,44,40,6,83,56,27,7,7,33,15,18
"2021","Newport 004F","W01002026",752,152,22,130,568,12,273,100,152,21,211,140,70,1,70,56,14,2,2,32,17,15
"2021","Newport 004G","W01002027",736,163,91,72,524,85,264,105,101,58,102,62,34,6,66,39,27,7,7,49,16,33
"2021","Newport 005A","W01001614",764,351,156,195,384,46,149,41,84,24,86,26,52,8,101,73,28,2,2,29,15,14
"2021","Newport 005B","W01001615",612,129,76,53,457,57,212,53,113,46,92,35,50,7,92,62,30,4,4,26,16,10
"2021","Newport 005C","W01001616",631,194,102,92,405,74,191,70,71,50,67,41,22,4,70,43,27,3,3,32,11,21
"2021","Newport 005D","W01001678",692,214,84,130,449,63,181,65,77,39,86,37,43,6,117,75,42,2,2,29,16,13
"2021","Newport 006A","W01001601",650,237,82,155,373,32,138,39,68,31,63,35,21,7,137,97,40,3,3,40,26,14
"2021","Newport 006B","W01001681",634,258,81,177,342,15,116,41,52,23,69,37,31,1,133,100,33,9,9,34,14,20
"2021","Newport 006C","W01001682",582,194,89,105,365,39,157,66,64,27,68,32,28,8,96,56,40,5,5,23,7,16
"2021","Newport 006D","W01001683",465,121,50,71,329,35,158,64,64,30,69,35,33,1,63,39,24,4,4,15,8,7
"2021","Newport 006E","W01001684",635,206,70,136,397,28,178,83,66,29,106,63,36,7,80,47,33,5,5,32,10,22
"2021","Newport 007A","W01001675",659,213,87,126,397,39,187,64,78,45,73,35,36,2,93,68,25,5,5,49,20,29
"2021","Newport 007B","W01001676",832,329,61,268,444,26,182,46,100,36,111,63,45,3,117,72,45,8,8,59,27,32
"2021","Newport 007C","W01001677",650,210,108,102,402,55,171,64,73,34,94,50,40,4,81,50,31,1,1,38,6,32
"2021","Newport 007D","W01001679",448,90,53,37,342,56,183,63,75,45,52,31,16,5,51,29,22,0,0,16,11,5
"2021","Newport 007E","W01001680",509,124,38,86,351,29,170,56,81,33,86,43,39,4,65,44,21,1,1,34,17,17
"2021","Newport 008A","W01001606",517,120,73,47,371,59,196,68,75,53,61,32,28,1,55,33,22,0,0,26,12,14
"2021","Newport 008B","W01001608",636,177,90,87,435,56,221,65,99,57,74,45,20,9,84,41,43,0,0,24,10,14
"2021","Newport 008C","W01001663",676,290,185,105,351,55,143,55,54,34,58,25,24,9,95,55,40,0,0,35,13,22
"2021","Newport 008D","W01001665",747,282,164,118,427,85,183,70,75,38,79,41,34,4,79,39,40,1,1,38,21,17
"2021","Newport 009A","W01001669",528,110,64,46,405,104,247,91,81,75,28,14,10,4,23,13,10,3,3,13,6,7
"2021","Newport 009B","W01001670",857,152,92,60,666,101,400,118,210,72,102,48,48,6,60,39,21,3,3,39,18,21
"2021","Newport 009D","W01001673",642,185,122,63,435,121,227,88,88,51,35,22,11,2,51,29,22,1,1,22,12,10
"2021","Newport 009E","W01001674",604,134,77,57,442,59,213,54,104,55,83,34,44,5,82,47,35,5,5,28,14,14
"2021","Newport 009F","W01002028",777,216,119,97,530,72,271,79,144,48,104,61,38,5,81,58,23,2,2,31,19,12
"2021","Newport 009G","W01002029",612,74,13,61,526,7,323,65,244,14,152,76,74,2,44,33,11,0,0,12,9,3
"2021","Newport 010A","W01001664",550,219,112,107,294,33,131,58,45,28,61,19,34,8,67,46,21,2,2,37,28,9
"2021","Newport 010B","W01001666",597,183,82,101,349,32,120,37,59,24,74,26,41,7,117,86,31,6,6,65,41,24
"2021","Newport 010C","W01001667",500,137,60,77,340,28,122,27,64,31,67,19,38,10,119,75,44,4,4,23,18,5
"2021","Newport 010D","W01001668",484,134,64,70,323,26,146,40,70,36,56,17,30,9,90,58,32,5,5,27,10,17
"2021","Newport 011A","W01001611",520,183,64,119,309,35,158,45,72,41,56,34,18,4,57,41,16,3,3,28,17,11
"2021","Newport 011B","W01001612",677,247,123,124,381,49,192,75,73,44,79,34,29,16,59,33,26,2,2,49,17,32
"2021","Newport 011C","W01001613",593,145,60,85,416,36,217,59,110,48,94,44,39,11,63,42,21,6,6,32,14,18
"2021","Newport 011D","W01001691",707,228,79,149,426,34,179,48,77,54,139,110,21,8,66,39,27,8,8,53,30,23
"2021","Newport 011E","W01001692",836,259,61,198,472,27,185,49,95,41,137,70,59,8,115,90,25,8,8,105,68,37
"2021","Newport 012A","W01001600",766,173,101,72,558,119,293,109,139,45,99,60,33,6,46,20,26,1,1,35,13,22
"2021","Newport 012B","W01001602",686,205,143,62,441,102,233,79,112,42,57,28,24,5,46,21,25,3,3,40,7,33
"2021","Newport 012C","W01001603",608,206,54,152,352,38,186,56,98,32,75,48,22,5,43,27,16,10,10,50,17,33
"2021","Newport 012D","W01001604",614,144,95,49,446,94,252,88,117,47,55,27,25,3,44,23,21,1,1,24,12,12
"2021","Newport 013A","W01001642",790,282,92,190,478,33,163,64,64,35,105,51,48,6,167,86,81,10,10,30,15,15
"2021","Newport 013B","W01001643",731,188,44,144,489,18,179,54,103,22,117,41,71,5,166,124,42,9,9,54,36,18
"2021","Newport 013D","W01001690",845,212,45,167,564,24,253,79,138,36,132,72,51,9,141,100,41,14,14,69,33,36
"2021","Newport 013E","W01001693",948,328,49,279,450,19,231,66,122,43,122,79,34,9,58,28,30,20,20,170,126,44
"2021","Newport 013F","W01002030",595,185,39,146,377,46,165,49,97,19,82,40,33,9,77,53,24,7,7,33,17,16
"2021","Newport 013G","W01002031",706,203,27,176,455,29,199,62,110,27,130,80,49,1,83,63,20,14,14,48,30,18
"2021","Newport 014A","W01001605",660,312,172,140,287,28,155,64,69,22,51,30,20,1,51,31,20,2,2,61,21,40
"2021","Newport 014B","W01001685",858,367,99,268,445,33,146,60,69,17,153,101,42,10,96,65,31,17,17,46,19,27
"2021","Newport 014C","W01001686",536,185,53,132,309,31,172,59,69,44,69,45,18,6,34,17,17,3,3,42,19,23
"2021","Newport 014D","W01001687",1084,580,184,396,393,28,170,78,79,13,116,78,32,6,67,47,20,12,12,111,32,79
"2021","Newport 015A","W01001607",503,119,35,84,339,16,127,34,66,27,60,17,36,7,130,98,32,6,6,45,24,21
"2021","Newport 015B","W01001609",713,141,39,102,514,21,178,53,84,41,104,35,49,20,204,154,50,7,7,58,28,30
"2021","Newport 015C","W01001610",511,121,65,56,367,50,162,57,65,40,53,17,29,7,74,47,27,28,28,23,13,10
"2021","Newport 015D","W01001645",511,103,44,59,380,39,171,68,66,37,73,37,19,17,95,64,31,2,2,28,13,15
"2021","Newport 015E","W01001646",604,160,90,70,381,72,122,47,46,29,60,15,23,22,121,79,42,6,6,63,45,18
"2021","Newport 015G","W01001648",646,179,83,96,435,76,188,67,76,45,87,34,38,15,76,51,25,8,8,32,11,21
"2021","Newport 015H","W01002032",570,173,98,75,362,84,146,56,52,38,59,26,30,3,73,42,31,0,0,35,18,17
"2021","Newport 015I","W01002033",651,235,23,212,384,24,147,55,77,15,142,95,46,1,71,49,22,0,0,32,15,17
"2021","Newport 016A","W01001635",593,186,86,100,392,79,235,83,104,48,51,23,21,7,26,16,10,1,1,15,4,11
"2021","Newport 016B","W01001637",901,260,146,114,611,92,315,91,172,52,91,48,40,3,112,74,38,1,1,30,20,10
"2021","Newport 016C","W01001638",470,99,73,26,354,57,210,56,105,49,50,26,22,2,34,23,11,3,3,17,11,6
"2021","Newport 016D","W01001671",1049,343,146,197,667,73,293,91,155,47,160,106,52,2,134,86,48,7,7,39,21,18
"2021","Newport 017A","W01001629",624,209,117,92,385,84,164,73,60,31,69,32,26,11,66,35,31,2,2,30,12,18
"2021","Newport 017B","W01001630",813,393,212,181,394,68,138,57,53,28,96,28,58,10,91,48,43,1,1,26,13,13
"2021","Newport 017C","W01001631",599,176,80,96,411,66,217,85,81,51,77,38,36,3,50,24,26,1,1,12,7,5
"2021","Newport 017D","W01001632",569,167,78,89,370,37,157,42,75,40,86,28,37,21,88,59,29,2,2,32,12,20
"2021","Newport 018A","W01001659",676,256,105,151,348,12,158,37,98,23,45,18,19,8,127,84,43,6,6,72,45,27
"2021","Newport 018B","W01001660",1006,231,81,150,703,42,414,139,211,64,132,75,51,6,103,65,38,12,12,72,38,34
"2021","Newport 018C","W01001661",1105,469,72,397,537,14,222,49,148,25,123,84,35,4,168,106,62,10,10,99,55,44
"2021","Newport 018D","W01001662",627,246,99,147,319,17,147,41,90,16,51,16,30,5,97,63,34,7,7,62,39,23
"2021","Newport 019A","W01001633",695,212,83,129,447,31,163,46,67,50,82,30,44,8,167,117,50,4,4,36,25,11
"2021","Newport 019B","W01001634",629,202,73,129,393,49,171,51,68,52,62,27,32,3,106,68,38,5,5,34,17,17
"2021","Newport 019D","W01001689",782,291,183,108,443,49,181,65,85,31,63,21,35,7,146,107,39,4,4,48,24,24
"2021","Newport 019E","W01002034",744,213,55,158,509,47,266,95,136,35,137,79,55,3,55,37,18,4,4,22,9,13
"2021","Newport 019F","W01002035",604,127,25,102,446,9,188,63,101,24,117,46,63,8,129,93,36,3,3,31,21,10
"2021","Newport 020A","W01001636",737,145,55,90,574,52,365,97,196,72,81,46,32,3,74,45,29,2,2,18,13,5
"2021","Newport 020C","W01001657",532,101,60,41,403,66,253,79,126,48,54,36,16,2,30,16,14,0,0,28,13,15
"2021","Newport 020D","W01001658",779,184,66,118,553,70,345,89,200,56,68,35,28,5,66,42,24,4,4,42,21,21
"2021","Newport 020E","W01001912",664,193,98,95,422,88,223,95,96,32,69,39,27,3,41,22,19,1,1,49,20,29
"2021","Newport 020F","W01001913",615,194,31,163,389,20,218,77,105,36,93,65,24,4,55,37,18,3,3,32,20,12
"2021","Powys 001A","W01000461",694,236,123,113,428,86,182,70,74,38,89,46,40,3,68,44,24,3,3,30,9,21
"2021","Powys 001D","W01000470",873,268,160,108,570,134,276,127,104,45,87,47,35,5,71,39,32,2,2,35,17,18
"2021","Powys 001E","W01000475",1029,276,177,99,688,156,366,169,120,77,114,52,51,11,49,22,27,3,3,65,24,41
"2021","Powys 001F","W01001906",887,271,161,110,577,143,270,121,86,63,100,46,45,9,60,31,29,4,4,39,19,20
"2021","Powys 001G","W01001907",573,146,82,64,394,88,205,84,91,30,56,32,17,7,45,29,16,0,0,33,17,16
"2021","Powys 002A","W01000444",1019,323,217,106,655,154,339,135,138,66,100,50,41,9,60,29,31,2,2,41,11,30
"2021","Powys 002B","W01000457",893,208,121,87,649,132,364,157,135,72,104,59,39,6,44,26,18,5,5,36,14,22
"2021","Powys 002C","W01000458",821,230,113,117,560,121,262,107,106,49,100,59,35,6,74,40,34,3,3,31,10,21
"2021","Powys 003A","W01000498",704,301,129,172,365,45,135,64,45,26,92,37,43,12,88,62,26,5,5,38,13,25
"2021","Powys 003B","W01000499",553,228,110,118,289,46,114,47,51,16,74,40,33,1,54,34,20,1,1,36,12,24
"2021","Powys 003C","W01000500",725,198,92,106,496,87,192,79,67,46,116,51,57,8,98,66,32,3,3,31,18,13
"2021","Powys 003D","W01000501",1064,424,200,224,585,108,226,83,78,65,127,64,59,4,113,68,45,11,11,55,12,43
"2021","Powys 004A","W01000442",903,251,134,117,612,120,317,138,110,69,120,67,45,8,53,26,27,2,2,40,13,27
"2021","Powys 004B","W01000452",873,248,136,112,584,150,293,121,109,63,82,43,33,6,53,17,36,6,6,41,12,29
"2021","Powys 004C","W01000473",1030,413,200,213,582,110,234,104,91,39,139,59,74,6,98,62,36,1,1,35,9,26
"2021","Powys 005A","W01000428",610,185,110,75,397,89,195,90,66,39,70,43,22,5,39,23,16,4,4,28,13,15
"2021","Powys 005B","W01000441",662,165,85,80,472,116,235,98,93,44,81,40,38,3,38,24,14,2,2,25,6,19
"2021","Powys 005C","W01000476",619,227,124,103,371,96,164,76,63,25,72,36,32,4,37,21,16,2,2,21,6,15
"2021","Powys 005D","W01000497",581,150,85,65,401,89,194,82,80,32,69,36,29,4,45,27,18,4,4,30,11,19
"2021","Powys 006A","W01000433",1036,336,183,153,667,151,333,145,136,52,118,62,51,5,62,29,33,3,3,33,8,25
"2021","Powys 006B","W01000460",723,216,116,100,473,101,246,98,91,57,68,36,30,2,55,30,25,3,3,34,12,22
"2021","Powys 006C","W01000488",925,213,111,102,671,148,334,141,126,67,115,65,38,12,67,32,35,7,7,41,14,27
"2021","Powys 007A","W01000434",735,187,117,70,511,127,255,122,81,52,80,41,36,3,45,25,20,4,4,37,15,22
"2021","Powys 007B","W01000439",858,222,121,101,591,127,314,131,123,60,104,49,46,9,43,18,25,3,3,45,16,29
"2021","Powys 007C","W01000447",879,241,152,89,610,133,318,137,118,63,109,56,50,3,50,27,23,0,0,28,13,15
"2021","Powys 008A","W01000480",1007,456,165,291,504,63,210,78,97,35,103,45,51,7,119,70,49,9,9,47,18,29
"2021","Powys 008B","W01000481",1103,430,178,252,640,153,281,136,89,56,139,76,59,4,60,38,22,7,7,33,12,21
"2021","Powys 008C","W01000482",891,337,175,162,520,109,240,92,92,56,101,57,40,4,68,47,21,2,2,34,7,27
"2021","Powys 009A","W01000478",772,259,65,194,480,40,182,59,89,34,129,50,70,9,123,86,37,6,6,33,18,15
"2021","Powys 009B","W01000479",600,189,83,106,384,39,152,58,69,25,82,25,51,6,107,68,39,4,4,27,11,16
"2021","Powys 009C","W01000483",778,248,100,148,493,52,194,66,95,33,96,37,54,5,146,86,60,5,5,37,20,17
"2021","Powys 010A","W01000429",999,253,150,103,680,144,357,185,105,67,121,67,48,6,53,28,25,5,5,66,28,38
"2021","Powys 010B","W01000453",584,147,85,62,408,107,214,97,67,50,62,33,27,2,25,10,15,0,0,29,13,16
"2021","Powys 010C","W01000466",611,225,133,92,374,84,160,57,63,40,74,27,47,0,56,43,13,0,0,12,6,6
"2021","Powys 010D","W01000467",811,425,190,235,366,71,144,71,48,25,83,54,24,5,64,34,30,4,4,20,8,12
"2021","Powys 011A","W01000427",594,160,96,64,399,95,191,95,57,39,64,32,29,3,46,24,22,3,3,35,8,27
"2021","Powys 011B","W01000448",625,205,121,84,397,96,173,70,65,38,72,30,39,3,55,25,30,1,1,23,11,12
"2021","Powys 011C","W01000449",754,308,146,162,423,104,190,88,60,42,69,39,27,3,54,26,28,6,6,23,9,14
"2021","Powys 011D","W01000464",537,145,85,60,363,97,198,101,68,29,45,28,13,4,22,9,13,1,1,29,9,20
"2021","Powys 011E","W01000484",727,193,103,90,498,134,242,115,80,47,73,39,28,6,42,17,25,7,7,36,15,21
"2021","Powys 011F","W01000485",762,241,153,88,496,164,201,97,66,38,80,50,24,6,45,21,24,6,6,25,11,14
"2021","Powys 011G","W01000486",513,192,128,64,300,67,126,55,49,22,59,30,26,3,45,26,19,3,3,21,7,14
"2021","Powys 012A","W01000438",627,230,144,86,369,136,149,92,34,23,51,29,21,1,33,23,10,0,0,28,10,18
"2021","Powys 012B","W01000451",496,127,81,46,340,90,162,66,60,36,56,30,26,0,31,17,14,1,1,29,20,9
"2021","Powys 012C","W01000472",541,161,101,60,362,102,160,72,55,33,63,29,30,4,36,22,14,1,1,18,8,10
"2021","Powys 012D","W01000477",660,177,102,75,435,99,227,108,77,42,66,35,23,8,40,18,22,3,3,48,24,24
"2021","Powys 012E","W01000487",987,371,204,167,588,126,252,126,86,40,107,50,50,7,96,54,42,7,7,28,6,22
"2021","Powys 013A","W01000454",719,413,167,246,290,46,118,55,43,20,67,44,21,2,55,33,22,4,4,16,3,13
"2021","Powys 013B","W01000455",969,323,162,161,619,101,255,105,111,39,133,53,71,9,126,85,41,4,4,27,10,17
"2021","Powys 013C","W01000456",1107,475,228,247,590,171,250,134,77,39,109,72,31,6,57,36,21,3,3,42,15,27
"2021","Powys 014A","W01000431",603,251,89,162,328,42,139,55,61,23,81,40,35,6,61,39,22,5,5,24,6,18
"2021","Powys 014B","W01000432",554,195,121,74,342,81,162,64,66,32,52,28,22,2,47,30,17,0,0,17,10,7
"2021","Powys 014C","W01000450",606,161,98,63,426,104,225,106,76,43,60,24,31,5,36,17,19,1,1,19,8,11
"2021","Powys 014D","W01000459",533,146,74,72,370,90,178,76,64,38,56,32,19,5,43,25,18,3,3,17,5,12
"2021","Powys 014E","W01000471",847,292,165,127,515,125,252,135,79,38,80,52,21,7,55,30,25,3,3,40,14,26
"2021","Powys 015A","W01000430",630,220,116,104,386,90,161,72,57,32,73,42,27,4,58,34,24,4,4,24,6,18
"2021","Powys 015B","W01000443",1033,309,205,104,683,163,337,161,124,52,117,59,49,9,65,26,39,1,1,41,11,30
"2021","Powys 015C","W01000445",643,182,108,74,429,96,214,93,74,47,71,37,28,6,47,20,27,1,1,32,11,21
"2021","Powys 015D","W01000446",898,415,217,198,459,105,162,72,64,26,96,54,38,4,90,49,41,6,6,24,5,19
"2021","Powys 015E","W01000494",754,255,131,124,474,83,212,80,84,48,95,48,43,4,81,50,31,3,3,25,10,15
"2021","Powys 017A","W01000489",807,325,150,175,457,67,197,69,93,35,111,66,39,6,79,61,18,3,3,25,7,18
"2021","Powys 017D","W01000492",846,433,190,243,381,77,155,65,55,35,82,58,19,5,63,42,21,4,4,32,9,23
"2021","Powys 017E","W01000493",617,166,101,65,423,103,232,87,112,33,52,33,16,3,36,19,17,0,0,28,13,15
"2021","Powys 017F","W01001901",858,307,201,106,525,123,230,92,89,49,83,30,48,5,85,51,34,4,4,26,7,19
"2021","Powys 017G","W01001902",585,177,74,103,376,42,132,54,44,34,73,18,50,5,128,85,43,1,1,32,14,18
"2021","Powys 018E","W01000465",449,118,78,40,318,99,161,71,68,22,27,15,12,0,29,16,13,2,2,13,5,8
"2021","Powys 018F","W01001903",967,290,180,110,642,177,301,126,110,65,79,45,31,3,81,42,39,4,4,35,17,18
"2021","Powys 018G","W01001904",741,215,138,77,495,130,266,115,97,54,49,29,15,5,46,20,26,4,4,31,17,14
"2021","Powys 018H","W01001905",917,250,142,108,617,142,317,131,110,76,98,49,41,8,57,22,35,3,3,50,25,25
"2021","Powys 020A","W01000440",566,146,72,74,398,95,206,90,66,50,59,32,21,6,33,14,19,5,5,22,11,11
"2021","Powys 020B","W01000474",772,213,103,110,523,103,294,150,90,54,77,41,34,2,48,28,20,1,1,36,15,21
"2021","Powys 020C","W01000503",448,106,52,54,309,72,186,81,56,49,30,17,10,3,18,7,11,3,3,33,20,13
"2021","Powys 020D","W01001897",828,236,135,101,554,124,284,136,102,46,81,46,31,4,64,22,42,1,1,38,16,22
"2021","Powys 021A","W01000426",642,215,110,105,398,75,195,78,72,45,66,29,31,6,61,39,22,1,1,29,13,16
"2021","Powys 021B","W01000496",902,288,149,139,572,120,281,114,78,89,100,46,41,13,67,37,30,4,4,42,17,25
"2021","Powys 021C","W01000502",960,346,207,139,583,149,279,101,116,62,85,43,35,7,65,32,33,5,5,31,13,18
"2021","Powys 021D","W01000504",535,214,85,129,303,34,115,45,43,27,60,20,33,7,91,58,33,3,3,18,6,12
"2021","Powys 021E","W01000505",660,212,115,97,429,80,220,101,65,54,57,31,24,2,70,46,24,2,2,19,7,12
"2021","Powys 021F","W01001899",932,307,159,148,597,81,270,96,122,52,106,40,60,6,136,82,54,4,4,28,12,16
"2021","Merthyr Tydfil 002A","W01001295",713,254,103,151,438,45,152,51,53,48,78,32,39,7,158,100,58,5,5,21,7,14
"2021","Merthyr Tydfil 002B","W01001296",654,160,83,77,469,88,221,76,79,66,88,41,38,9,68,45,23,4,4,25,16,9
"2021","Merthyr Tydfil 002C","W01001297",830,265,78,187,526,52,208,93,72,43,128,61,53,14,131,79,52,7,7,39,18,21
"2021","Merthyr Tydfil 002D","W01001298",852,357,140,217,467,50,178,70,63,45,90,29,48,13,145,112,33,4,4,28,10,18
"2021","Merthyr Tydfil 002E","W01001310",672,180,96,84,456,72,216,81,78,57,67,25,38,4,89,59,30,12,12,36,20,16
"2021","Merthyr Tydfil 002F","W01001311",519,163,71,92,343,32,119,44,46,29,94,36,53,5,77,61,16,21,21,13,11,2
"2021","Merthyr Tydfil 003A","W01001291",796,174,65,109,584,63,300,110,137,53,100,43,49,8,119,81,38,2,2,38,20,18
"2021","Merthyr Tydfil 003B","W01001294",699,174,90,84,501,112,274,87,131,56,61,33,27,1,53,36,17,1,1,24,16,8
"2021","Merthyr Tydfil 003C","W01001305",509,159,80,79,324,47,162,59,64,39,55,27,24,4,57,33,24,3,3,26,15,11
"2021","Merthyr Tydfil 003D","W01001306",649,207,90,117,422,62,220,90,74,56,77,39,35,3,60,31,29,3,3,20,9,11
"2021","Merthyr Tydfil 003E","W01001324",873,295,140,155,540,103,243,87,88,68,81,38,36,7,98,61,37,15,15,38,19,19
"2021","Merthyr Tydfil 004A","W01001292",760,219,71,148,507,31,178,54,91,33,96,28,55,13,189,153,36,13,13,34,19,15
"2021","Merthyr Tydfil 004B","W01001293",795,298,142,156,479,65,215,81,92,42,72,25,43,4,126,84,42,1,1,18,10,8
"2021","Merthyr Tydfil 004C","W01001307",810,424,131,293,368,54,139,51,54,34,56,30,20,6,112,79,33,7,7,18,8,10
"2021","Merthyr Tydfil 004D","W01001315",898,456,145,311,405,46,182,72,68,42,95,59,29,7,71,41,30,11,11,37,15,22
"2021","Merthyr Tydfil 005A","W01001314",930,299,126,173,598,90,252,91,97,64,115,47,58,10,134,90,44,7,7,33,20,13
"2021","Merthyr Tydfil 005C","W01001317",751,243,127,116,483,60,219,66,90,63,91,34,49,8,105,62,43,8,8,25,13,12
"2021","Merthyr Tydfil 005D","W01001318",673,228,107,121,424,57,201,75,74,52,80,38,38,4,82,45,37,4,4,21,11,10
"2021","Merthyr Tydfil 005E","W01001959",608,133,48,85,446,52,248,80,113,55,82,35,45,2,61,43,18,3,3,29,12,17
"2021","Merthyr Tydfil 005F","W01001960",689,279,113,166,381,51,169,66,68,35,81,31,44,6,78,54,24,2,2,29,16,13
"2021","Merthyr Tydfil 006A","W01001289",618,206,88,118,389,64,167,72,62,33,61,29,29,3,88,51,37,9,9,23,16,7
"2021","Merthyr Tydfil 006B","W01001302",623,195,66,129,402,39,133,46,48,39,126,70,51,5,99,70,29,5,5,26,16,10
"2021","Merthyr Tydfil 006E","W01001312",655,263,154,109,371,55,148,58,42,48,88,28,53,7,76,45,31,4,4,21,11,10
"2021","Merthyr Tydfil 006F","W01001313",692,254,99,155,411,64,176,65,54,57,84,36,43,5,82,52,30,5,5,27,12,15
"2021","Merthyr Tydfil 006G","W01001961",1012,327,140,187,645,75,274,98,83,93,134,44,76,14,155,90,65,7,7,40,24,16
"2021","Merthyr Tydfil 007A","W01001290",977,231,106,125,697,74,328,127,145,56,152,60,80,12,138,96,42,5,5,49,27,22
"2021","Merthyr Tydfil 007B","W01001319",673,145,66,79,504,91,287,124,93,70,68,31,30,7,57,21,36,1,1,24,10,14
"2021","Merthyr Tydfil 007C","W01001320",669,232,105,127,415,63,204,89,67,48,74,37,31,6,70,34,36,4,4,22,13,9
"2021","Merthyr Tydfil 007D","W01001321",651,166,72,94,458,43,195,71,77,47,99,42,49,8,115,85,30,6,6,27,14,13
"2021","Merthyr Tydfil 007E","W01001322",733,237,100,137,463,77,199,77,74,48,98,43,51,4,87,58,29,2,2,33,15,18
"2021","Merthyr Tydfil 008A","W01001299",697,213,80,133,448,30,145,53,49,43,78,18,51,9,163,122,41,32,32,36,20,16
"2021","Merthyr Tydfil 008B","W01001300",694,172,60,112,487,54,189,68,72,49,63,15,45,3,167,122,45,14,14,35,18,17
"2021","Merthyr Tydfil 008C","W01001301",766,208,73,135,514,51,174,60,76,38,91,17,64,10,188,134,54,10,10,44,25,19
"2021","Merthyr Tydfil 008D","W01001308",483,124,59,65,314,19,103,35,34,34,58,15,34,9,126,85,41,8,8,45,30,15
"2021","Merthyr Tydfil 008E","W01001309",515,129,62,67,368,40,131,32,57,42,64,19,38,7,131,82,49,2,2,18,12,6
"2021","Merthyr Tydfil 008F","W01001898",647,197,94,103,419,63,201,76,70,55,62,25,29,8,90,52,38,3,3,31,16,15
