"date","geography","geography code","Marital and civil partnership status: Total; measures: Value","Marital and civil partnership status: Never married and never registered a civil partnership; measures: Value","Marital and civil partnership status: Married or in a registered civil partnership; measures: Value","Marital and civil partnership status: Married or in a registered civil partnership: Married; measures: Value","Marital and civil partnership status: Married or in a registered civil partnership: Married: Opposite sex; measures: Value","Marital and civil partnership status: Married or in a registered civil partnership: Married: Same sex; measures: Value","Marital and civil partnership status: Married or in a registered civil partnership: In a registered civil partnership; measures: Value","Marital and civil partnership status: Married or in a registered civil partnership: In a registered civil partnership: Opposite sex; measures: Value","Marital and civil partnership status: Married or in a registered civil partnership: In a registered civil partnership: Same sex; measures: Value","Marital and civil partnership status: Separated, but still legally married or still legally in a civil partnership; measures: Value","Marital and civil partnership status: Separated, but still legally married or still legally in a civil partnership: Separated, but still married; measures: Value","Marital and civil partnership status: Separated, but still legally married or still legally in a civil partnership: Separated, but still in a registered civil partnership; measures: Value","Marital and civil partnership status: Divorced or civil partnership dissolved; measures: Value","Marital and civil partnership status: Divorced or civil partnership dissolved: Divorced; measures: Value","Marital and civil partnership status: Divorced or civil partnership dissolved: Formerly in a civil partnership now legally dissolved; measures: Value","Marital and civil partnership status: Widowed or surviving civil partnership partner; measures: Value","Marital and civil partnership status: Widowed or surviving civil partnership partner: Widowed; measures: Value","Marital and civil partnership status: Widowed or surviving civil partnership partner: Surviving partner from civil partnership; measures: Value"
"2021","Hartlepool 001","E02002483",8176,2921,3891,3884,3872,12,7,0,7,174,172,2,679,677,2,511,511,0
"2021","Hartlepool 002","E02002484",8121,3544,2790,2782,2756,26,8,0,8,280,280,0,869,865,4,638,638,0
"2021","Hartlepool 003","E02002485",6230,2662,2250,2238,2213,25,12,8,4,171,170,1,680,679,1,467,467,0
"2021","Hartlepool 007","E02002489",5759,2674,1876,1868,1851,17,8,0,8,192,190,2,619,617,2,398,398,0
"2021","Hartlepool 008","E02002490",4615,2019,1699,1690,1673,17,9,2,7,137,137,0,500,500,0,260,259,1
"2021","Hartlepool 009","E02002491",5123,2122,1988,1984,1975,9,4,2,2,128,128,0,447,447,0,438,438,0
"2021","Hartlepool 010","E02002492",5476,2097,2283,2274,2259,15,9,6,3,125,124,1,544,542,2,427,427,0
"2021","Hartlepool 011","E02002493",5687,1644,2970,2965,2948,17,5,2,3,97,97,0,494,493,1,482,480,2
"2021","Hartlepool 012","E02002494",5838,2768,1921,1909,1895,14,12,10,2,168,167,1,588,587,1,393,392,1
"2021","Hartlepool 014","E02006909",10828,2854,6129,6120,6094,26,9,2,7,200,199,1,827,825,2,818,817,1
"2021","Hartlepool 015","E02007059",8830,3344,3763,3745,3734,11,18,4,14,229,228,1,920,917,3,574,571,3
"2021","Middlesbrough 001","E02002496",9750,5786,2790,2772,2742,30,18,10,8,231,231,0,601,598,3,342,341,1
"2021","Middlesbrough 002","E02002497",4640,2500,1273,1263,1250,13,10,6,4,171,168,3,416,414,2,280,278,2
"2021","Middlesbrough 003","E02002498",6675,3571,1963,1948,1932,16,15,12,3,286,284,2,577,576,1,278,278,0
"2021","Middlesbrough 004","E02002499",5639,2988,1687,1682,1667,15,5,2,3,126,126,0,488,488,0,350,350,0
"2021","Middlesbrough 005","E02002500",4670,2015,1828,1818,1805,13,10,6,4,117,116,1,426,424,2,284,284,0
"2021","Middlesbrough 006","E02002501",4718,2164,1715,1701,1685,16,14,2,12,130,130,0,442,442,0,267,265,2
"2021","Middlesbrough 007","E02002502",7517,3733,2260,2237,2226,11,23,10,13,253,249,4,733,730,3,538,536,2
"2021","Middlesbrough 008","E02002503",5076,2363,1838,1823,1816,7,15,6,9,142,142,0,455,454,1,278,278,0
"2021","Middlesbrough 009","E02002504",7701,2939,3530,3511,3497,14,19,2,17,159,157,2,657,657,0,416,416,0
"2021","Middlesbrough 010","E02002505",4680,2500,1326,1313,1311,2,13,9,4,158,158,0,429,428,1,267,267,0
"2021","Middlesbrough 011","E02002506",4404,2304,1246,1238,1234,4,8,6,2,112,109,3,400,398,2,342,342,0
"2021","Middlesbrough 012","E02002507",5063,1694,2557,2551,2544,7,6,4,2,101,101,0,351,350,1,360,360,0
"2021","Middlesbrough 013","E02002508",4468,1411,2245,2241,2225,16,4,0,4,92,91,1,304,304,0,416,415,1
"2021","Middlesbrough 014","E02002509",4119,1680,1654,1650,1641,9,4,2,2,104,102,2,380,379,1,301,301,0
"2021","Middlesbrough 015","E02002510",5859,1806,3023,3015,2999,16,8,2,6,108,106,2,453,451,2,469,469,0
"2021","Middlesbrough 017","E02002512",4473,1230,2518,2514,2506,8,4,4,0,82,82,0,329,329,0,314,314,0
"2021","Middlesbrough 018","E02002513",8250,3370,3188,3178,3160,18,10,4,6,207,207,0,886,884,2,599,599,0
"2021","Middlesbrough 019","E02002514",6943,2415,3041,3041,3031,10,0,0,0,178,178,0,757,754,3,552,552,0
"2021","Middlesbrough 020","E02006811",9296,2646,5259,5250,5231,19,9,0,9,134,133,1,600,600,0,657,657,0
"2021","Redcar and Cleveland 001","E02002515",5464,2400,1636,1622,1608,14,14,4,10,199,198,1,759,753,6,470,470,0
"2021","Redcar and Cleveland 002","E02002516",4656,1797,1895,1892,1884,8,3,0,3,107,105,2,514,510,4,343,343,0
"2021","Redcar and Cleveland 003","E02002517",4284,1673,1692,1687,1673,14,5,0,5,105,104,1,470,470,0,344,343,1
"2021","Redcar and Cleveland 004","E02002518",9100,2760,4674,4663,4647,16,11,0,11,176,176,0,850,845,5,640,640,0
"2021","Redcar and Cleveland 005","E02002519",5981,2186,2351,2332,2322,10,19,8,11,153,153,0,748,748,0,543,541,2
"2021","Redcar and Cleveland 006","E02002520",11073,3256,5550,5543,5526,17,7,0,7,227,227,0,1093,1091,2,947,946,1
"2021","Redcar and Cleveland 007","E02002521",5110,1537,2280,2268,2252,16,12,0,12,112,112,0,625,625,0,556,556,0
"2021","Redcar and Cleveland 009","E02002523",4603,2416,1287,1270,1262,8,17,10,7,161,157,4,472,470,2,267,267,0
"2021","Redcar and Cleveland 010","E02002524",4426,1473,2172,2164,2158,6,8,6,2,112,108,4,382,382,0,287,287,0
"2021","Redcar and Cleveland 011","E02002525",6734,2531,2642,2631,2627,4,11,8,3,175,174,1,725,723,2,661,661,0
"2021","Redcar and Cleveland 012","E02002526",6313,2159,2981,2966,2947,19,15,9,6,143,142,1,638,635,3,392,392,0
"2021","Redcar and Cleveland 013","E02002527",4003,1671,1504,1495,1491,4,9,4,5,98,97,1,433,433,0,297,297,0
"2021","Redcar and Cleveland 015","E02002529",4755,1707,2175,2172,2165,7,3,2,1,112,112,0,445,442,3,316,316,0
"2021","Redcar and Cleveland 016","E02002530",5225,1763,2411,2403,2394,9,8,2,6,109,109,0,548,547,1,394,394,0
"2021","Redcar and Cleveland 018","E02002532",5557,2062,2135,2117,2106,11,18,6,12,193,192,1,720,717,3,447,447,0
"2021","Redcar and Cleveland 019","E02002533",5412,1521,2945,2942,2933,9,3,2,1,103,103,0,478,478,0,365,365,0
"2021","Redcar and Cleveland 020","E02002534",4862,1099,2918,2916,2903,13,2,0,2,66,66,0,372,372,0,407,407,0
"2021","Redcar and Cleveland 021","E02006812",6244,2353,2654,2650,2641,9,4,4,0,117,117,0,591,588,3,529,529,0
"2021","Redcar and Cleveland 022","E02006910",8540,3463,3521,3501,3487,14,20,6,14,221,217,4,729,728,1,606,606,0
"2021","Stockton-on-Tees 001","E02002535",7737,2180,4205,4199,4182,17,6,0,6,130,129,1,686,686,0,536,536,0
"2021","Stockton-on-Tees 002","E02002536",7579,2713,3229,3215,3202,13,14,4,10,213,212,1,824,821,3,600,599,1
"2021","Stockton-on-Tees 003","E02002537",6469,2810,2262,2248,2227,21,14,8,6,213,212,1,718,717,1,466,466,0
"2021","Stockton-on-Tees 004","E02002538",4571,1576,1999,1983,1954,29,16,6,10,127,127,0,522,519,3,347,347,0
"2021","Stockton-on-Tees 005","E02002539",8673,2194,5215,5207,5175,32,8,6,2,136,135,1,632,631,1,496,496,0
"2021","Stockton-on-Tees 006","E02002540",5153,1337,2807,2795,2782,13,12,6,6,78,78,0,459,459,0,472,472,0
"2021","Stockton-on-Tees 007","E02002541",5022,1983,1886,1882,1868,14,4,1,3,156,156,0,604,604,0,393,393,0
"2021","Stockton-on-Tees 008","E02002542",6259,2805,2117,2108,2102,6,9,4,5,191,188,3,655,655,0,491,490,1
"2021","Stockton-on-Tees 009","E02002543",6977,3095,2503,2484,2460,24,19,4,15,199,196,3,744,741,3,436,436,0
"2021","Stockton-on-Tees 010","E02002544",7415,3815,2180,2166,2150,16,14,4,10,297,295,2,712,710,2,411,411,0
"2021","Stockton-on-Tees 011","E02002545",4273,1266,2190,2190,2185,5,0,0,0,80,80,0,385,385,0,352,352,0
"2021","Stockton-on-Tees 012","E02002546",5819,2599,2141,2129,2107,22,12,3,9,168,166,2,589,589,0,322,322,0
"2021","Stockton-on-Tees 013","E02002547",5173,1394,2804,2801,2792,9,3,0,3,84,84,0,427,427,0,464,464,0
"2021","Stockton-on-Tees 015","E02002549",6297,1751,3316,3310,3300,10,6,2,4,112,111,1,530,530,0,588,588,0
"2021","Stockton-on-Tees 016","E02002550",4953,1625,2396,2390,2377,13,6,2,4,103,101,2,453,453,0,376,376,0
"2021","Stockton-on-Tees 017","E02002551",4345,2111,1292,1290,1276,14,2,0,2,182,180,2,502,501,1,258,258,0
"2021","Stockton-on-Tees 018","E02002552",5548,2296,2316,2310,2306,4,6,2,4,152,152,0,464,464,0,320,320,0
"2021","Stockton-on-Tees 019","E02002553",4629,1733,2026,2022,2011,11,4,0,4,102,100,2,426,426,0,342,342,0
"2021","Stockton-on-Tees 020","E02002554",4108,1663,1542,1541,1536,5,1,0,1,111,111,0,403,402,1,389,389,0
"2021","Stockton-on-Tees 021","E02002555",8301,2341,4399,4395,4381,14,4,2,2,169,169,0,792,792,0,600,600,0
"2021","Stockton-on-Tees 022","E02002556",6005,1695,3428,3416,3404,12,12,2,10,121,121,0,487,485,2,274,274,0
"2021","Stockton-on-Tees 024","E02002558",9139,2500,4993,4983,4970,13,10,6,4,191,191,0,827,826,1,628,628,0
"2021","Stockton-on-Tees 025","E02007060",4836,2381,1503,1490,1466,24,13,8,5,183,182,1,533,532,1,236,236,0
"2021","Stockton-on-Tees 026","E02007061",6183,2804,2431,2412,2393,19,19,2,17,189,188,1,577,570,7,182,178,4
"2021","Stockton-on-Tees 027","E02007062",5599,1975,2754,2751,2740,11,3,2,1,152,151,1,508,507,1,210,209,1
"2021","Stockton-on-Tees 028","E02007063",6946,2083,4064,4062,4053,9,2,0,2,138,138,0,510,510,0,151,151,0
"2021","Darlington 001","E02002559",7870,2286,4203,4190,4177,13,13,2,11,181,181,0,771,770,1,429,428,1
"2021","Darlington 002","E02002560",5057,1772,2350,2340,2320,20,10,6,4,123,123,0,515,515,0,297,296,1
"2021","Darlington 003","E02002561",4600,1369,2402,2402,2395,7,0,0,0,88,88,0,440,439,1,301,300,1
"2021","Darlington 004","E02002562",4638,1976,1533,1532,1512,20,1,0,1,180,178,2,617,616,1,332,332,0
"2021","Darlington 005","E02002563",4604,1516,2014,2005,1996,9,9,2,7,125,125,0,539,537,2,410,410,0
"2021","Darlington 006","E02002564",7819,2832,3227,3219,3200,19,8,2,6,265,265,0,957,951,6,538,538,0
"2021","Darlington 009","E02002567",7309,3105,2728,2716,2701,15,12,2,10,223,223,0,788,785,3,465,465,0
"2021","Darlington 010","E02002568",5060,1349,2755,2747,2735,12,8,2,6,105,105,0,462,460,2,389,389,0
"2021","Darlington 011","E02002569",7746,1640,4625,4623,4608,15,2,0,2,104,104,0,618,617,1,759,758,1
"2021","Darlington 012","E02002570",6196,2630,2109,2096,2073,23,13,0,13,202,200,2,788,787,1,467,467,0
"2021","Darlington 013","E02002571",4987,2049,2020,1998,1986,12,22,7,15,139,137,2,478,478,0,301,301,0
"2021","Darlington 014","E02002572",4912,2096,1801,1794,1776,18,7,2,5,161,160,1,587,586,1,267,264,3
"2021","Darlington 015","E02002573",7679,2106,4190,4181,4156,25,9,2,7,156,156,0,670,667,3,557,555,2
"2021","Darlington 016","E02007058",9629,4522,3008,3000,2967,33,8,4,4,356,355,1,1241,1238,3,502,499,3
"2021","County Durham 002","E02004290",4911,1395,2676,2672,2667,5,4,0,4,99,99,0,396,396,0,345,343,2
"2021","County Durham 005","E02004291",5873,2237,2436,2429,2416,13,7,4,3,182,181,1,628,628,0,390,389,1
"2021","County Durham 007","E02004292",6775,1989,3439,3428,3417,11,11,2,9,123,123,0,621,618,3,603,603,0
"2021","County Durham 011","E02004293",7837,3114,2903,2890,2876,14,13,4,9,255,255,0,958,954,4,607,607,0
"2021","County Durham 013","E02004294",6792,1771,3780,3758,3745,13,22,8,14,130,130,0,584,583,1,527,524,3
"2021","County Durham 015","E02004295",6085,1901,3051,3048,3036,12,3,0,3,129,128,1,552,552,0,452,452,0
"2021","County Durham 019","E02004296",6974,2692,2984,2968,2944,24,16,4,12,206,205,1,703,699,4,389,389,0
"2021","County Durham 001","E02004297",6625,2106,3213,3202,3191,11,11,4,7,162,160,2,671,670,1,473,472,1
"2021","County Durham 003","E02004298",8351,2393,4329,4313,4289,24,16,4,12,214,210,4,785,780,5,630,630,0
"2021","County Durham 004","E02004299",6819,2280,3112,3101,3091,10,11,0,11,178,178,0,757,757,0,492,491,1
"2021","County Durham 006","E02004300",6265,2282,2592,2577,2561,16,15,6,9,186,184,2,687,683,4,518,517,1
"2021","County Durham 008","E02004301",7601,3115,2814,2803,2793,10,11,4,7,291,288,3,878,878,0,503,502,1
"2021","County Durham 009","E02004302",6404,2585,2477,2470,2450,20,7,0,7,225,223,2,692,690,2,425,425,0
"2021","County Durham 010","E02004303",9335,3364,3850,3846,3824,22,4,0,4,291,291,0,1130,1124,6,700,700,0
"2021","County Durham 012","E02004304",7229,2590,3161,3148,3122,26,13,6,7,193,188,5,716,716,0,569,569,0
"2021","County Durham 014","E02004305",8062,3067,3528,3514,3495,19,14,8,6,170,169,1,845,842,3,452,451,1
"2021","County Durham 020","E02004306",4938,1306,2595,2589,2582,7,6,0,6,104,104,0,527,526,1,406,406,0
"2021","County Durham 024","E02004307",5391,1850,2541,2541,2524,17,0,0,0,124,124,0,551,551,0,325,325,0
"2021","County Durham 022","E02004308",6703,2005,3440,3425,3404,21,15,2,13,138,134,4,653,652,1,467,465,2
"2021","County Durham 023","E02004309",5110,1763,2335,2332,2323,9,3,0,3,113,111,2,523,522,1,376,375,1
"2021","County Durham 026","E02004310",6434,2352,2872,2854,2838,16,18,8,10,143,143,0,631,630,1,436,434,2
"2021","County Durham 027","E02004311",7655,2579,3565,3546,3521,25,19,5,14,207,205,2,762,762,0,542,542,0
"2021","County Durham 028","E02004312",6347,1692,3451,3442,3426,16,9,2,7,104,103,1,551,549,2,549,548,1
"2021","County Durham 029","E02004313",5716,3273,1553,1547,1530,17,6,4,2,136,136,0,435,435,0,319,318,1
"2021","County Durham 030","E02004314",12394,10927,923,907,890,17,16,4,12,61,60,1,258,255,3,225,224,1
"2021","County Durham 033","E02004315",11162,5496,4491,4480,4454,26,11,8,3,139,139,0,599,596,3,437,437,0
"2021","County Durham 031","E02004316",5264,1956,2289,2280,2268,12,9,2,7,154,154,0,527,527,0,338,338,0
"2021","County Durham 038","E02004317",6150,2126,2643,2635,2624,11,8,2,6,181,180,1,694,693,1,506,506,0
"2021","County Durham 041","E02004318",5486,1767,2600,2588,2573,15,12,4,8,119,119,0,631,628,3,369,367,2
"2021","County Durham 044","E02004319",6586,2348,3036,3025,3006,19,11,3,8,177,176,1,599,598,1,426,425,1
"2021","County Durham 016","E02004320",7101,2164,3624,3607,3594,13,17,8,9,141,141,0,684,683,1,488,488,0
"2021","County Durham 017","E02004321",6728,2560,2754,2747,2738,9,7,4,3,181,181,0,674,671,3,559,558,1
"2021","County Durham 018","E02004322",6852,2879,2575,2563,2544,19,12,2,10,192,192,0,686,684,2,520,520,0
"2021","County Durham 021","E02004323",6091,2253,2652,2646,2638,8,6,4,2,130,130,0,620,617,3,436,436,0
"2021","County Durham 025","E02004324",4781,1751,2071,2065,2052,13,6,2,4,116,115,1,512,512,0,331,331,0
"2021","County Durham 032","E02004325",7091,3228,2272,2259,2236,23,13,6,7,218,217,1,775,773,2,598,598,0
"2021","County Durham 034","E02004326",5467,2094,2215,2211,2194,17,4,2,2,173,172,1,580,577,3,405,405,0
"2021","County Durham 036","E02004327",4657,1796,1742,1736,1726,10,6,2,4,147,144,3,532,532,0,440,440,0
"2021","County Durham 035","E02004328",5778,2383,2175,2174,2162,12,1,0,1,165,165,0,627,626,1,428,428,0
"2021","County Durham 037","E02004329",5502,1804,2698,2694,2690,4,4,4,0,117,114,3,525,524,1,358,358,0
"2021","County Durham 039","E02004330",5043,1755,2105,2091,2083,8,14,4,10,137,136,1,540,540,0,506,506,0
"2021","County Durham 040","E02004331",5927,2207,2533,2524,2514,10,9,4,5,164,164,0,591,589,2,432,432,0
"2021","County Durham 043","E02004332",6011,2200,2680,2673,2656,17,7,2,5,155,155,0,584,584,0,392,392,0
"2021","County Durham 047","E02004333",5739,1673,2916,2902,2888,14,14,6,8,124,124,0,579,579,0,447,446,1
"2021","County Durham 048","E02004334",5755,2066,2497,2488,2479,9,9,4,5,140,140,0,621,621,0,431,431,0
"2021","County Durham 049","E02004335",6254,2585,2389,2382,2366,16,7,0,7,162,160,2,748,748,0,370,370,0
"2021","County Durham 050","E02004336",5624,1961,2382,2377,2366,11,5,0,5,171,171,0,618,616,2,492,489,3
"2021","County Durham 052","E02004337",8621,3082,3873,3858,3829,29,15,4,11,250,250,0,835,834,1,581,580,1
"2021","County Durham 053","E02004338",6115,2282,2600,2592,2580,12,8,4,4,178,177,1,637,637,0,418,418,0
"2021","County Durham 054","E02004339",5901,1545,3233,3227,3208,19,6,0,6,111,110,1,557,556,1,455,455,0
"2021","County Durham 059","E02004340",8511,3356,3260,3248,3231,17,12,6,6,286,286,0,928,927,1,681,681,0
"2021","County Durham 060","E02004341",7359,2046,3982,3969,3940,29,13,3,10,146,146,0,708,708,0,477,475,2
"2021","County Durham 061","E02004342",4247,1897,1347,1338,1328,10,9,0,9,163,161,2,546,545,1,294,294,0
"2021","County Durham 062","E02004343",4554,1546,1935,1932,1924,8,3,0,3,142,142,0,546,546,0,385,385,0
"2021","County Durham 063","E02004344",5760,1873,2529,2522,2515,7,7,0,7,134,132,2,665,665,0,559,559,0
"2021","County Durham 064","E02004345",10733,3060,5459,5439,5415,24,20,4,16,238,238,0,1147,1143,4,829,829,0
"2021","County Durham 042","E02004348",6775,1798,3577,3564,3546,18,13,0,13,117,117,0,722,722,0,561,561,0
"2021","County Durham 045","E02004349",7511,2888,3022,3011,2996,15,11,4,7,225,223,2,835,831,4,541,541,0
"2021","County Durham 046","E02004350",8158,2644,3816,3801,3775,26,15,4,11,194,192,2,874,871,3,630,630,0
"2021","County Durham 051","E02004351",5861,2240,2397,2387,2381,6,10,4,6,168,168,0,642,642,0,414,413,1
"2021","County Durham 055","E02004352",6712,2626,2603,2589,2568,21,14,8,6,253,252,1,742,742,0,488,486,2
"2021","County Durham 056","E02004353",6072,1845,2995,2991,2984,7,4,0,4,116,116,0,570,569,1,546,546,0
"2021","County Durham 057","E02004354",7363,2572,3344,3330,3314,16,14,10,4,236,236,0,752,749,3,459,458,1
"2021","County Durham 058","E02004355",5594,2236,2107,2103,2096,7,4,0,4,176,175,1,655,655,0,420,420,0
"2021","County Durham 067","E02007022",10437,2928,5376,5359,5334,25,17,4,13,207,206,1,1055,1054,1,871,868,3
"2021","Northumberland 004","E02005702",5753,1289,3455,3447,3417,30,8,4,4,114,112,2,442,442,0,453,453,0
"2021","Northumberland 005","E02005703",5845,2028,2452,2443,2429,14,9,4,5,178,177,1,694,694,0,493,493,0
"2021","Northumberland 006","E02005704",10883,2903,5895,5859,5832,27,36,14,22,241,239,2,1005,1004,1,839,839,0
"2021","Northumberland 007","E02005705",6614,1422,3973,3954,3939,15,19,10,9,110,110,0,582,581,1,527,526,1
"2021","Northumberland 001","E02005706",7595,2590,3127,3111,3103,8,16,4,12,251,249,2,875,875,0,752,752,0
"2021","Northumberland 002","E02005707",6115,1518,3455,3438,3426,12,17,0,17,108,108,0,517,517,0,517,517,0
"2021","Northumberland 003","E02005708",8808,2143,4865,4824,4809,15,41,15,26,218,218,0,821,818,3,761,759,2
"2021","Northumberland 022","E02005709",5318,2390,1661,1648,1626,22,13,4,9,178,176,2,690,688,2,399,399,0
"2021","Northumberland 023","E02005710",7810,2955,2953,2939,2896,43,14,4,10,268,265,3,948,944,4,686,686,0
"2021","Northumberland 024","E02005711",6283,2383,2487,2481,2475,6,6,4,2,193,192,1,714,712,2,506,506,0
"2021","Northumberland 025","E02005712",7412,2818,3321,3311,3286,25,10,4,6,228,228,0,654,654,0,391,391,0
"2021","Northumberland 026","E02005713",5321,1306,3126,3122,3106,16,4,0,4,85,85,0,435,435,0,369,369,0
"2021","Northumberland 029","E02005715",7444,2855,2889,2885,2868,17,4,0,4,262,262,0,830,829,1,608,608,0
"2021","Northumberland 030","E02005717",6353,1662,3290,3275,3263,12,15,10,5,149,148,1,660,658,2,592,592,0
"2021","Northumberland 031","E02005718",5453,1411,2883,2878,2867,11,5,1,4,125,125,0,525,525,0,509,509,0
"2021","Northumberland 032","E02005719",6912,2488,3003,2993,2983,10,10,0,10,190,188,2,764,763,1,467,466,1
"2021","Northumberland 008","E02005720",10446,3756,4543,4526,4494,32,17,4,13,317,312,5,1139,1137,2,691,691,0
"2021","Northumberland 011","E02005721",4541,1328,2236,2232,2212,20,4,2,2,133,131,2,490,490,0,354,354,0
"2021","Northumberland 015","E02005722",7897,2018,4669,4661,4645,16,8,2,6,161,160,1,653,653,0,396,396,0
"2021","Northumberland 016","E02005723",5153,1570,2196,2189,2183,6,7,2,5,138,138,0,698,698,0,551,551,0
"2021","Northumberland 018","E02005724",5507,1103,3497,3485,3470,15,12,8,4,74,74,0,371,370,1,462,462,0
"2021","Northumberland 033","E02005725",5891,1392,3376,3373,3359,14,3,0,3,103,103,0,432,432,0,588,588,0
"2021","Northumberland 034","E02005726",6639,1550,4175,4161,4147,14,14,6,8,97,97,0,383,383,0,434,433,1
"2021","Northumberland 019","E02005727",5209,1315,2962,2940,2929,11,22,4,18,100,100,0,457,455,2,375,375,0
"2021","Northumberland 037","E02005728",5751,1690,2910,2899,2887,12,11,2,9,113,112,1,596,595,1,442,441,1
"2021","Northumberland 036","E02005729",4718,1232,2606,2602,2588,14,4,0,4,113,113,0,410,410,0,357,357,0
"2021","Northumberland 035","E02005730",10757,3172,5287,5267,5255,12,20,4,16,254,250,4,1061,1058,3,983,983,0
"2021","Northumberland 038","E02005731",8859,2787,4296,4285,4267,18,11,8,3,218,218,0,928,928,0,630,629,1
"2021","Northumberland 040","E02005733",7033,1831,3908,3884,3869,15,24,8,16,135,135,0,673,672,1,486,486,0
"2021","Northumberland 009","E02005734",4940,1707,1998,1992,1982,10,6,0,6,186,185,1,600,598,2,449,449,0
"2021","Northumberland 010","E02005735",5675,2516,1863,1858,1848,10,5,0,5,206,206,0,723,722,1,367,367,0
"2021","Northumberland 013","E02005736",6927,2618,2941,2932,2910,22,9,4,5,257,255,2,721,715,6,390,390,0
"2021","Northumberland 017","E02005739",7592,2394,3578,3574,3555,19,4,0,4,193,192,1,810,810,0,617,616,1
"2021","Northumberland 020","E02005740",8283,3131,3303,3299,3278,21,4,1,3,284,284,0,955,949,6,610,610,0
"2021","Northumberland 021","E02005741",7128,1970,3752,3747,3727,20,5,0,5,195,195,0,649,646,3,562,562,0
"2021","Northumberland 041","E02007105",10448,3395,4944,4937,4928,9,7,2,5,290,287,3,1063,1060,3,756,754,2
"2021","Northumberland 042","E02007106",12045,3766,6307,6283,6246,37,24,6,18,253,251,2,1087,1085,2,632,632,0
"2021","Northumberland 043","E02007107",7497,1649,4409,4394,4380,14,15,4,11,121,121,0,639,638,1,679,679,0
"2021","Newcastle upon Tyne 002","E02001709",8469,2515,4702,4688,4665,23,14,2,12,119,119,0,555,553,2,578,578,0
"2021","Newcastle upon Tyne 003","E02001710",8198,3561,2981,2969,2945,24,12,6,6,223,221,2,891,886,5,542,542,0
"2021","Newcastle upon Tyne 004","E02001711",7907,3314,3032,3008,2986,22,24,8,16,232,226,6,793,791,2,536,535,1
"2021","Newcastle upon Tyne 005","E02001712",7815,3119,3535,3502,3480,22,33,12,21,122,121,1,549,547,2,490,490,0
"2021","Newcastle upon Tyne 006","E02001713",8236,2730,4254,4230,4209,21,24,6,18,142,140,2,618,616,2,492,492,0
"2021","Newcastle upon Tyne 007","E02001714",7906,2536,4280,4261,4245,16,19,8,11,125,125,0,510,509,1,455,454,1
"2021","Newcastle upon Tyne 008","E02001715",9039,3741,3614,3598,3564,34,16,10,6,288,286,2,901,899,2,495,493,2
"2021","Newcastle upon Tyne 011","E02001718",5275,2261,1957,1951,1940,11,6,4,2,154,154,0,555,554,1,348,348,0
"2021","Newcastle upon Tyne 012","E02001719",7247,2902,3304,3266,3240,26,38,18,20,124,124,0,518,515,3,399,399,0
"2021","Newcastle upon Tyne 013","E02001720",9031,7051,1454,1450,1435,15,4,0,4,67,67,0,270,270,0,189,187,2
"2021","Newcastle upon Tyne 014","E02001721",8858,3411,3678,3652,3617,35,26,6,20,256,256,0,853,850,3,660,658,2
"2021","Newcastle upon Tyne 015","E02001722",7517,2995,3055,3001,2978,23,54,46,8,199,196,3,680,680,0,588,588,0
"2021","Newcastle upon Tyne 016","E02001723",5473,2287,2335,2325,2302,23,10,6,4,139,138,1,441,438,3,271,271,0
"2021","Newcastle upon Tyne 017","E02001724",8517,6543,1331,1308,1291,17,23,8,15,73,73,0,353,353,0,217,217,0
"2021","Newcastle upon Tyne 018","E02001725",8363,6004,1438,1423,1393,30,15,6,9,165,162,3,504,503,1,252,252,0
"2021","Newcastle upon Tyne 019","E02001726",9324,3729,4037,4027,4003,24,10,4,6,199,199,0,806,805,1,553,552,1
"2021","Newcastle upon Tyne 020","E02001727",7265,2805,3248,3235,3216,19,13,6,7,168,166,2,564,562,2,480,480,0
"2021","Newcastle upon Tyne 021","E02001728",7714,3055,3207,3200,3168,32,7,4,3,242,241,1,730,730,0,480,480,0
"2021","Newcastle upon Tyne 022","E02001729",9770,5282,3460,3441,3421,20,19,4,15,247,243,4,457,455,2,324,324,0
"2021","Newcastle upon Tyne 025","E02001732",4472,1869,1754,1742,1726,16,12,4,8,116,114,2,445,445,0,288,288,0
"2021","Newcastle upon Tyne 027","E02001734",6291,2726,2436,2423,2406,17,13,8,5,177,175,2,547,544,3,405,400,5
"2021","Newcastle upon Tyne 028","E02001735",5090,2521,1516,1509,1504,5,7,4,3,186,186,0,514,514,0,353,353,0
"2021","Newcastle upon Tyne 030","E02001737",4817,2359,1414,1406,1398,8,8,0,8,201,201,0,555,554,1,288,288,0
"2021","Newcastle upon Tyne 031","E02006893",9214,2753,4713,4697,4680,17,16,10,6,180,180,0,769,768,1,799,798,1
"2021","Newcastle upon Tyne 032","E02007095",7628,2880,3582,3573,3550,23,9,4,5,177,176,1,629,627,2,360,360,0
"2021","Newcastle upon Tyne 033","E02007096",4819,1529,2539,2537,2531,6,2,0,2,86,85,1,414,413,1,251,251,0
"2021","Newcastle upon Tyne 034","E02007097",8160,6790,859,845,836,9,14,4,10,85,85,0,315,311,4,111,110,1
"2021","Newcastle upon Tyne 035","E02007098",5270,2649,1635,1619,1610,9,16,8,8,148,146,2,488,485,3,350,350,0
"2021","Newcastle upon Tyne 036","E02007099",9947,8439,957,944,924,20,13,0,13,106,103,3,311,308,3,134,131,3
"2021","Newcastle upon Tyne 037","E02007100",8130,7042,591,581,567,14,10,6,4,111,110,1,307,305,2,79,79,0
"2021","Newcastle upon Tyne 038","E02007101",6692,2929,2976,2963,2954,9,13,8,5,201,199,2,333,333,0,253,252,1
"2021","Newcastle upon Tyne 039","E02007102",6619,4741,1231,1225,1209,16,6,0,6,160,159,1,320,319,1,167,167,0
"2021","Newcastle upon Tyne 040","E02007103",5188,3137,1147,1140,1124,16,7,4,3,171,169,2,524,524,0,209,208,1
"2021","Newcastle upon Tyne 041","E02007104",4202,2054,1452,1446,1433,13,6,2,4,144,144,0,335,334,1,217,214,3
"2021","North Tyneside 001","E02001738",5092,1023,3259,3250,3246,4,9,2,7,57,57,0,301,301,0,452,452,0
"2021","North Tyneside 002","E02001739",6141,2082,2786,2773,2759,14,13,6,7,174,173,1,649,647,2,450,450,0
"2021","North Tyneside 003","E02001740",4650,1096,2878,2866,2852,14,12,2,10,61,61,0,324,321,3,291,291,0
"2021","North Tyneside 004","E02001741",6552,1902,3234,3221,3205,16,13,4,9,141,140,1,629,628,1,646,646,0
"2021","North Tyneside 005","E02001742",4847,1237,2634,2624,2613,11,10,8,2,88,88,0,501,501,0,387,387,0
"2021","North Tyneside 006","E02001743",6201,2179,2817,2800,2768,32,17,4,13,175,171,4,658,656,2,372,371,1
"2021","North Tyneside 007","E02001744",6595,2310,2966,2954,2919,35,12,2,10,174,173,1,732,727,5,413,413,0
"2021","North Tyneside 008","E02001745",5392,2047,2290,2286,2265,21,4,0,4,153,153,0,555,555,0,347,347,0
"2021","North Tyneside 009","E02001746",6671,2275,3044,3026,3017,9,18,8,10,146,146,0,734,731,3,472,472,0
"2021","North Tyneside 010","E02001747",5269,1336,2867,2863,2853,10,4,4,0,77,76,1,453,452,1,536,536,0
"2021","North Tyneside 011","E02001748",6841,2451,3149,3140,3114,26,9,0,9,183,183,0,698,698,0,360,360,0
"2021","North Tyneside 012","E02001749",5293,1656,2567,2561,2536,25,6,2,4,140,140,0,552,552,0,378,378,0
"2021","North Tyneside 013","E02001750",5618,1520,2997,2976,2965,11,21,10,11,98,98,0,514,513,1,489,489,0
"2021","North Tyneside 014","E02001751",5445,1948,2397,2390,2377,13,7,2,5,129,128,1,545,544,1,426,426,0
"2021","North Tyneside 015","E02001752",5042,2044,1937,1932,1920,12,5,0,5,160,159,1,561,556,5,340,340,0
"2021","North Tyneside 016","E02001753",5240,1758,2302,2285,2247,38,17,0,17,160,160,0,627,627,0,393,393,0
"2021","North Tyneside 017","E02001754",4909,1600,2426,2406,2388,18,20,6,14,102,101,1,420,419,1,361,359,2
"2021","North Tyneside 018","E02001755",8051,2740,4039,4020,3987,33,19,6,13,129,128,1,648,648,0,495,495,0
"2021","North Tyneside 019","E02001756",7571,3342,2733,2721,2687,34,12,8,4,211,209,2,818,814,4,467,465,2
"2021","North Tyneside 020","E02001757",4948,1595,2363,2355,2347,8,8,2,6,115,114,1,485,485,0,390,390,0
"2021","North Tyneside 021","E02001758",4566,1546,2216,2210,2202,8,6,2,4,95,95,0,416,416,0,293,293,0
"2021","North Tyneside 022","E02001759",5337,2254,1848,1832,1810,22,16,2,14,163,162,1,688,685,3,384,383,1
"2021","North Tyneside 023","E02001760",5929,2890,1814,1802,1791,11,12,4,8,220,220,0,638,635,3,367,367,0
"2021","North Tyneside 024","E02001761",4613,1631,2048,2038,2030,8,10,8,2,122,121,1,438,438,0,374,374,0
"2021","North Tyneside 025","E02001762",5537,2027,2607,2598,2574,24,9,2,7,115,115,0,488,488,0,300,300,0
"2021","North Tyneside 026","E02001763",5279,2274,1883,1871,1863,8,12,8,4,179,178,1,591,591,0,352,352,0
"2021","North Tyneside 027","E02001764",6245,2780,2011,1999,1971,28,12,6,6,236,235,1,830,829,1,388,388,0
"2021","North Tyneside 028","E02001765",6053,2671,2094,2087,2048,39,7,4,3,206,202,4,652,648,4,430,429,1
"2021","North Tyneside 029","E02001766",5842,2730,2055,2046,2028,18,9,2,7,169,168,1,617,614,3,271,271,0
"2021","North Tyneside 030","E02001767",5758,2481,2034,2026,2011,15,8,0,8,169,169,0,672,672,0,402,401,1
"2021","South Tyneside 001","E02001768",6662,2559,2696,2679,2665,14,17,6,11,196,194,2,760,760,0,451,450,1
"2021","South Tyneside 002","E02001769",6211,2906,1934,1920,1910,10,14,10,4,240,235,5,762,761,1,369,367,2
"2021","South Tyneside 003","E02001770",5189,2031,2038,2032,2025,7,6,2,4,153,152,1,578,573,5,389,389,0
"2021","South Tyneside 004","E02001771",5019,1725,2273,2263,2257,6,10,4,6,127,127,0,424,424,0,470,470,0
"2021","South Tyneside 005","E02001772",4220,1523,1782,1782,1767,15,0,0,0,129,128,1,437,435,2,349,349,0
"2021","South Tyneside 006","E02001773",4484,1180,2549,2544,2536,8,5,1,4,81,81,0,305,305,0,369,367,2
"2021","South Tyneside 007","E02001774",4336,1831,1486,1482,1472,10,4,0,4,145,145,0,550,550,0,324,324,0
"2021","South Tyneside 008","E02001775",4363,1712,1694,1689,1685,4,5,2,3,117,117,0,472,470,2,368,368,0
"2021","South Tyneside 009","E02001776",7285,3113,2738,2723,2708,15,15,9,6,225,225,0,712,710,2,497,497,0
"2021","South Tyneside 010","E02001777",5642,2269,2403,2389,2375,14,14,4,10,114,113,1,526,526,0,330,330,0
"2021","South Tyneside 011","E02001778",4733,2104,1490,1487,1474,13,3,0,3,156,156,0,628,626,2,355,354,1
"2021","South Tyneside 012","E02001779",4395,1821,1624,1616,1609,7,8,0,8,138,138,0,469,468,1,343,343,0
"2021","South Tyneside 013","E02001780",4892,1767,2182,2169,2160,9,13,6,7,134,133,1,464,460,4,345,345,0
"2021","South Tyneside 014","E02001781",4248,1948,1389,1385,1375,10,4,4,0,136,136,0,491,491,0,284,284,0
"2021","South Tyneside 015","E02001782",8100,3153,3317,3309,3289,20,8,6,2,227,227,0,782,781,1,621,621,0
"2021","South Tyneside 016","E02001783",5422,2470,1899,1889,1877,12,10,8,2,177,177,0,555,553,2,321,321,0
"2021","South Tyneside 017","E02001784",5356,2070,2110,2104,2098,6,6,2,4,162,161,1,580,580,0,434,433,1
"2021","South Tyneside 018","E02001785",6356,1959,3046,3038,3020,18,8,3,5,138,138,0,683,683,0,530,530,0
"2021","South Tyneside 019","E02001786",5440,2069,2241,2228,2219,9,13,4,9,121,120,1,590,589,1,419,419,0
"2021","South Tyneside 020","E02001787",4395,1526,2008,2000,1991,9,8,1,7,104,104,0,457,457,0,300,298,2
"2021","South Tyneside 021","E02001788",4778,1718,2125,2119,2096,23,6,4,2,139,136,3,508,505,3,288,287,1
"2021","South Tyneside 022","E02001789",4885,1119,2942,2936,2917,19,6,0,6,66,66,0,346,346,0,412,411,1
"2021","South Tyneside 023","E02001790",4879,1499,2432,2428,2415,13,4,0,4,94,92,2,458,458,0,396,396,0
"2021","Sunderland 001","E02001791",4701,1353,2608,2604,2600,4,4,4,0,66,65,1,310,310,0,364,364,0
"2021","Sunderland 002","E02001792",5975,1645,3276,3269,3254,15,7,0,7,89,89,0,446,446,0,519,519,0
"2021","Sunderland 003","E02001793",6543,3223,1988,1977,1968,9,11,6,5,198,198,0,638,638,0,496,495,1
"2021","Sunderland 004","E02001794",7052,3234,2422,2406,2394,12,16,4,12,175,175,0,624,623,1,597,597,0
"2021","Sunderland 005","E02001795",6014,2557,2151,2142,2133,9,9,4,5,176,175,1,664,662,2,466,466,0
"2021","Sunderland 006","E02001796",7440,2873,2957,2947,2932,15,10,6,4,224,222,2,785,785,0,601,601,0
"2021","Sunderland 007","E02001797",4986,1540,2638,2629,2627,2,9,6,3,85,85,0,403,401,2,320,320,0
"2021","Sunderland 008","E02001798",6678,2788,2733,2726,2714,12,7,2,5,180,179,1,537,536,1,440,439,1
"2021","Sunderland 009","E02001799",7416,3263,2505,2498,2481,17,7,4,3,237,232,5,854,853,1,557,556,1
"2021","Sunderland 010","E02001800",5540,1931,2447,2442,2424,18,5,0,5,159,158,1,604,603,1,399,399,0
"2021","Sunderland 011","E02001801",4778,2201,1795,1791,1778,13,4,2,2,124,123,1,383,378,5,275,275,0
"2021","Sunderland 012","E02001802",5681,2757,1885,1878,1853,25,7,0,7,144,143,1,495,494,1,400,400,0
"2021","Sunderland 013","E02001803",7468,4373,1912,1900,1883,17,12,8,4,190,189,1,676,674,2,317,317,0
"2021","Sunderland 014","E02001804",5110,2027,2073,2066,2058,8,7,2,5,155,153,2,453,453,0,402,402,0
"2021","Sunderland 015","E02001805",4723,1603,2255,2250,2243,7,5,0,5,97,97,0,374,374,0,394,394,0
"2021","Sunderland 016","E02001806",6305,2998,1882,1869,1851,18,13,8,5,258,254,4,724,723,1,443,442,1
"2021","Sunderland 017","E02001807",6813,2407,3242,3232,3220,12,10,2,8,165,164,1,603,603,0,396,396,0
"2021","Sunderland 018","E02001808",4489,1755,2014,2001,1994,7,13,6,7,96,96,0,333,332,1,291,291,0
"2021","Sunderland 019","E02001809",5416,1690,2611,2605,2599,6,6,4,2,123,123,0,585,585,0,407,407,0
"2021","Sunderland 020","E02001810",6871,2433,3167,3161,3144,17,6,4,2,167,165,2,710,710,0,394,394,0
"2021","Sunderland 021","E02001811",7048,3171,2552,2541,2530,11,11,6,5,183,182,1,637,637,0,505,505,0
"2021","Sunderland 022","E02001812",8562,2390,4860,4848,4833,15,12,2,10,133,132,1,510,509,1,669,669,0
"2021","Sunderland 023","E02001813",7600,3666,2520,2502,2493,9,18,14,4,217,217,0,699,695,4,498,498,0
"2021","Sunderland 024","E02001814",5078,2015,2122,2114,2106,8,8,8,0,124,124,0,413,411,2,404,404,0
"2021","Sunderland 025","E02001815",8259,2251,4577,4567,4549,18,10,6,4,157,154,3,710,709,1,564,564,0
"2021","Sunderland 026","E02001816",5699,2355,2024,2013,2002,11,11,6,5,169,168,1,661,660,1,490,490,0
"2021","Sunderland 027","E02001817",5465,2099,2281,2279,2266,13,2,2,0,142,142,0,489,489,0,454,454,0
"2021","Sunderland 028","E02001818",7596,3061,3216,3210,3184,26,6,4,2,189,188,1,637,635,2,493,493,0
"2021","Sunderland 029","E02001819",5964,1683,3310,3306,3300,6,4,4,0,92,92,0,401,398,3,478,478,0
"2021","Sunderland 030","E02001820",7805,2777,3690,3680,3659,21,10,6,4,151,150,1,687,685,2,500,500,0
"2021","Sunderland 031","E02001821",4748,1582,2414,2411,2402,9,3,2,1,104,104,0,366,366,0,282,282,0
"2021","Sunderland 032","E02001822",6441,2252,3027,3012,2987,25,15,2,13,143,142,1,556,554,2,463,463,0
"2021","Sunderland 033","E02001823",6481,2511,2775,2772,2748,24,3,0,3,186,185,1,599,599,0,410,409,1
"2021","Sunderland 034","E02001824",7004,2417,3163,3155,3142,13,8,0,8,166,166,0,675,674,1,583,583,0
"2021","Sunderland 035","E02001825",6509,2275,2888,2885,2873,12,3,0,3,156,155,1,619,617,2,571,571,0
"2021","Sunderland 036","E02001826",5810,2295,2427,2421,2411,10,6,4,2,164,163,1,546,545,1,378,377,1
"2021","Gateshead 001","E02001682",7031,2338,3401,3389,3356,33,12,2,10,170,170,0,629,629,0,493,493,0
"2021","Gateshead 002","E02001683",7855,2574,3877,3859,3833,26,18,10,8,182,180,2,750,748,2,472,472,0
"2021","Gateshead 003","E02001684",5390,2496,1872,1866,1851,15,6,2,4,156,156,0,542,541,1,324,322,2
"2021","Gateshead 004","E02001685",6457,2755,2380,2366,2343,23,14,6,8,186,185,1,694,693,1,442,442,0
"2021","Gateshead 005","E02001686",5743,1861,2747,2737,2723,14,10,2,8,132,129,3,526,525,1,477,477,0
"2021","Gateshead 007","E02001688",6289,3165,1966,1954,1932,22,12,8,4,199,198,1,618,615,3,341,339,2
"2021","Gateshead 008","E02001689",5834,2656,2113,2109,2080,29,4,4,0,165,163,2,522,521,1,378,378,0
"2021","Gateshead 009","E02001690",5896,2130,2670,2661,2647,14,9,2,7,148,148,0,557,556,1,391,387,4
"2021","Gateshead 010","E02001691",6730,3364,2279,2259,2223,36,20,6,14,172,171,1,609,605,4,306,306,0
"2021","Gateshead 011","E02001692",4892,2378,1675,1669,1654,15,6,4,2,145,145,0,446,445,1,248,248,0
"2021","Gateshead 012","E02001693",4369,1783,1611,1602,1588,14,9,4,5,107,106,1,497,495,2,371,371,0
"2021","Gateshead 013","E02001694",5208,1873,2380,2370,2356,14,10,5,5,133,132,1,477,476,1,345,345,0
"2021","Gateshead 014","E02001695",4897,1520,2493,2487,2478,9,6,2,4,85,84,1,426,425,1,373,373,0
"2021","Gateshead 015","E02001696",7382,2920,2949,2929,2912,17,20,10,10,212,212,0,729,727,2,572,572,0
"2021","Gateshead 016","E02001697",6215,2037,3089,3083,3071,12,6,2,4,127,125,2,543,539,4,419,419,0
"2021","Gateshead 017","E02001698",5977,1332,3551,3545,3534,11,6,2,4,89,89,0,420,420,0,585,585,0
"2021","Gateshead 018","E02001699",5447,1984,2310,2302,2290,12,8,4,4,149,149,0,555,553,2,449,449,0
"2021","Gateshead 019","E02001700",8461,2891,4009,3991,3972,19,18,6,12,195,195,0,785,784,1,581,581,0
"2021","Gateshead 020","E02001701",5268,1617,2722,2714,2703,11,8,2,6,97,97,0,407,407,0,425,425,0
"2021","Gateshead 021","E02001702",6212,2781,2129,2124,2101,23,5,3,2,178,178,0,660,660,0,464,464,0
"2021","Gateshead 022","E02001703",4712,1306,2524,2515,2509,6,9,0,9,77,77,0,390,389,1,415,415,0
"2021","Gateshead 023","E02001704",5684,2301,2136,2128,2121,7,8,2,6,150,146,4,624,624,0,473,473,0
"2021","Gateshead 025","E02001706",6251,2233,2843,2832,2811,21,11,2,9,160,158,2,635,631,4,380,380,0
"2021","Gateshead 026","E02001707",6925,2313,3117,3106,3087,19,11,4,7,170,170,0,705,703,2,620,620,0
"2021","Gateshead 027","E02006841",6841,4294,1618,1592,1573,19,26,8,18,147,146,1,513,511,2,269,269,0
"2021","Gateshead 028","E02006842",4033,1804,1536,1524,1519,5,12,4,8,76,76,0,345,343,2,272,271,1
"2021","Gateshead 029","E02007094",5748,2116,2408,2396,2384,12,12,8,4,165,162,3,617,615,2,442,442,0
"2021","Halton 001","E02002574",7147,2152,3943,3933,3914,19,10,4,6,110,110,0,500,500,0,442,441,1
"2021","Halton 002","E02002575",7804,2349,4400,4380,4356,24,20,6,14,130,130,0,558,557,1,367,366,1
"2021","Halton 003","E02002576",6164,2548,2351,2343,2328,15,8,2,6,146,143,3,650,648,2,469,468,1
"2021","Halton 004","E02002577",5744,2544,2016,2006,1991,15,10,8,2,149,149,0,624,623,1,411,411,0
"2021","Halton 005","E02002578",6718,2721,2827,2820,2799,21,7,5,2,137,136,1,585,585,0,448,448,0
"2021","Halton 006","E02002579",6212,2574,2377,2372,2362,10,5,2,3,155,155,0,632,630,2,474,473,1
"2021","Halton 007","E02002580",6224,3173,1721,1702,1689,13,19,10,9,246,242,4,714,712,2,370,370,0
"2021","Halton 008","E02002581",5986,2118,2846,2838,2821,17,8,6,2,115,112,3,446,444,2,461,461,0
"2021","Halton 009","E02002582",7651,2291,4339,4326,4301,25,13,2,11,76,74,2,622,621,1,323,323,0
"2021","Halton 010","E02002583",5872,2685,1897,1884,1875,9,13,4,9,200,198,2,701,700,1,389,387,2
"2021","Halton 011","E02002584",5929,2326,2550,2547,2540,7,3,0,3,139,139,0,504,504,0,410,410,0
"2021","Halton 012","E02002585",8817,4009,3069,3045,3022,23,24,6,18,260,258,2,961,957,4,518,518,0
"2021","Halton 013","E02002586",7460,3430,2406,2401,2384,17,5,2,3,265,263,2,822,822,0,537,537,0
"2021","Halton 014","E02002587",5144,2154,1898,1890,1883,7,8,4,4,142,141,1,624,624,0,326,326,0
"2021","Halton 015","E02002588",5745,2403,2098,2092,2089,3,6,2,4,188,188,0,643,643,0,413,413,0
"2021","Halton 016","E02002589",5336,1383,3105,3100,3091,9,5,0,5,67,67,0,377,376,1,404,404,0
"2021","Warrington 001","E02002590",6239,2059,3124,3124,3101,23,0,0,0,109,109,0,551,549,2,396,396,0
"2021","Warrington 002","E02002591",5393,1507,2812,2808,2799,9,4,2,2,90,90,0,509,509,0,475,474,1
"2021","Warrington 003","E02002592",5241,1550,2652,2647,2633,14,5,3,2,83,82,1,424,424,0,532,532,0
"2021","Warrington 004","E02002593",4242,1410,1960,1954,1937,17,6,4,2,97,95,2,482,482,0,293,291,2
"2021","Warrington 005","E02002594",4548,1809,1835,1821,1812,9,14,4,10,141,140,1,523,520,3,240,240,0
"2021","Warrington 006","E02002595",6245,2959,2076,2067,2061,6,9,4,5,158,158,0,703,702,1,349,349,0
"2021","Warrington 007","E02002596",6822,2166,3447,3442,3424,18,5,0,5,108,108,0,634,634,0,467,467,0
"2021","Warrington 008","E02002597",7120,3106,2563,2557,2539,18,6,4,2,198,198,0,833,831,2,420,420,0
"2021","Warrington 009","E02002598",8723,2898,4737,4729,4702,27,8,5,3,157,154,3,646,646,0,285,285,0
"2021","Warrington 010","E02002599",8996,2715,4877,4863,4847,16,14,6,8,138,138,0,766,765,1,500,499,1
"2021","Warrington 011","E02002600",7538,3250,2745,2733,2720,13,12,6,6,186,186,0,838,837,1,519,519,0
"2021","Warrington 012","E02002601",7443,2369,3734,3730,3706,24,4,2,2,129,129,0,688,687,1,523,523,0
"2021","Warrington 013","E02002602",6266,2933,2234,2227,2207,20,7,3,4,217,214,3,639,638,1,243,243,0
"2021","Warrington 014","E02002603",5838,1585,3277,3269,3258,11,8,5,3,89,89,0,448,447,1,439,439,0
"2021","Warrington 015","E02002604",6506,1877,3551,3551,3541,10,0,0,0,104,104,0,513,512,1,461,461,0
"2021","Warrington 016","E02002605",7269,2483,3527,3505,3489,16,22,8,14,143,143,0,682,681,1,434,434,0
"2021","Warrington 017","E02002606",9303,4606,2794,2780,2749,31,14,4,10,268,264,4,1123,1122,1,512,512,0
"2021","Warrington 018","E02002607",9515,4263,3225,3210,3195,15,15,4,11,265,264,1,1132,1130,2,630,629,1
"2021","Warrington 019","E02002608",7046,1904,3756,3751,3740,11,5,0,5,98,98,0,571,571,0,717,717,0
"2021","Warrington 020","E02002609",7630,3614,2514,2509,2479,30,5,0,5,215,214,1,882,879,3,405,405,0
"2021","Warrington 021","E02002610",10146,2676,5615,5605,5584,21,10,0,10,176,175,1,961,958,3,718,717,1
"2021","Warrington 022","E02002611",6427,1730,3567,3557,3539,18,10,4,6,85,82,3,512,512,0,533,533,0
"2021","Warrington 023","E02002612",7550,2237,3820,3810,3777,33,10,2,8,122,121,1,759,759,0,612,612,0
"2021","Warrington 024","E02002613",5745,1676,3231,3221,3214,7,10,2,8,58,58,0,451,451,0,329,328,1
"2021","Warrington 025","E02002614",4919,964,3306,3302,3294,8,4,2,2,47,47,0,287,284,3,315,315,0
"2021","Blackburn with Darwen 001","E02002615",8253,2746,4095,4089,4076,13,6,6,0,178,178,0,692,689,3,542,542,0
"2021","Blackburn with Darwen 002","E02002616",7074,2121,4165,4155,4143,12,10,6,4,99,98,1,344,344,0,345,345,0
"2021","Blackburn with Darwen 003","E02002617",7064,2418,3795,3789,3781,8,6,2,4,160,159,1,347,346,1,344,342,2
"2021","Blackburn with Darwen 004","E02002618",5916,1947,3309,3307,3299,8,2,2,0,123,123,0,238,238,0,299,299,0
"2021","Blackburn with Darwen 005","E02002619",6992,2565,3430,3419,3408,11,11,6,5,183,180,3,467,466,1,347,347,0
"2021","Blackburn with Darwen 006","E02002620",6946,2874,2882,2875,2857,18,7,2,5,216,216,0,602,602,0,372,372,0
"2021","Blackburn with Darwen 007","E02002621",6311,2216,3290,3284,3277,7,6,6,0,158,158,0,350,350,0,297,297,0
"2021","Blackburn with Darwen 008","E02002622",7955,3492,3026,3020,3002,18,6,4,2,235,232,3,768,766,2,434,432,2
"2021","Blackburn with Darwen 009","E02002623",8032,3969,2394,2381,2355,26,13,4,9,247,247,0,958,956,2,464,462,2
"2021","Blackburn with Darwen 010","E02002624",7268,2159,3905,3898,3886,12,7,0,7,116,116,0,517,515,2,571,571,0
"2021","Blackburn with Darwen 011","E02002625",7674,3265,2956,2942,2919,23,14,7,7,220,219,1,795,794,1,438,438,0
"2021","Blackburn with Darwen 012","E02002626",5798,2440,2181,2167,2154,13,14,6,8,150,150,0,586,586,0,441,441,0
"2021","Blackburn with Darwen 013","E02002627",5945,2177,2904,2901,2887,14,3,2,1,112,112,0,488,488,0,264,264,0
"2021","Blackburn with Darwen 014","E02002628",5635,2346,2057,2051,2034,17,6,2,4,184,183,1,643,643,0,405,404,1
"2021","Blackburn with Darwen 015","E02002629",4715,2121,1629,1622,1607,15,7,2,5,152,151,1,511,511,0,302,301,1
"2021","Blackburn with Darwen 016","E02002630",5137,2197,1817,1812,1789,23,5,0,5,160,159,1,607,605,2,356,355,1
"2021","Blackburn with Darwen 017","E02002631",7458,2663,3361,3347,3316,31,14,0,14,168,167,1,799,798,1,467,467,0
"2021","Blackburn with Darwen 018","E02002632",5337,1425,3060,3054,3036,18,6,4,2,92,91,1,489,488,1,271,271,0
"2021","Blackpool 001","E02002633",6515,2007,2883,2866,2841,25,17,4,13,138,137,1,778,777,1,709,707,2
"2021","Blackpool 002","E02002634",6902,2256,2878,2867,2835,32,11,4,7,152,152,0,922,921,1,694,694,0
"2021","Blackpool 003","E02002635",6675,2103,2918,2890,2850,40,28,4,24,149,144,5,797,794,3,708,706,2
"2021","Blackpool 004","E02002636",6594,2546,2598,2584,2548,36,14,6,8,183,182,1,828,823,5,439,437,2
"2021","Blackpool 005","E02002637",5155,1960,2162,2146,2102,44,16,0,16,110,108,2,571,568,3,352,352,0
"2021","Blackpool 006","E02002638",5530,2687,1547,1516,1431,85,31,2,29,192,187,5,793,785,8,311,307,4
"2021","Blackpool 007","E02002639",4667,2274,1241,1225,1211,14,16,6,10,169,167,2,691,690,1,292,288,4
"2021","Blackpool 008","E02002640",5497,2910,1328,1305,1261,44,23,4,19,218,208,10,744,740,4,297,296,1
"2021","Blackpool 009","E02002641",6632,2773,2465,2435,2397,38,30,4,26,168,166,2,758,755,3,468,466,2
"2021","Blackpool 010","E02002642",5833,2831,1596,1557,1504,53,39,4,35,273,269,4,781,775,6,352,350,2
"2021","Blackpool 011","E02002643",6122,2978,1787,1772,1750,22,15,2,13,237,235,2,776,774,2,344,343,1
"2021","Blackpool 012","E02002644",6486,2508,2639,2623,2592,31,16,8,8,176,174,2,733,733,0,430,430,0
"2021","Blackpool 013","E02002645",5235,2508,1432,1412,1381,31,20,4,16,222,219,3,786,781,5,287,287,0
"2021","Blackpool 014","E02002646",5852,2375,2125,2108,2094,14,17,4,13,165,164,1,735,732,3,452,450,2
"2021","Blackpool 015","E02002647",6398,3005,1972,1956,1925,31,16,6,10,218,214,4,774,766,8,429,427,2
"2021","Blackpool 016","E02002648",5628,2422,1887,1878,1853,25,9,2,7,167,165,2,743,742,1,409,408,1
"2021","Blackpool 017","E02002649",7001,2784,2608,2598,2569,29,10,2,8,173,172,1,827,824,3,609,608,1
"2021","Blackpool 018","E02002650",7035,2360,3136,3122,3086,36,14,4,10,169,169,0,788,787,1,582,581,1
"2021","Blackpool 019","E02002651",6588,2286,2740,2730,2682,48,10,4,6,157,156,1,758,757,1,647,646,1
"2021","Cheshire East 022","E02003811",6286,1551,3774,3769,3754,15,5,2,3,86,86,0,539,539,0,336,336,0
"2021","Cheshire East 023","E02003812",5456,1354,3099,3098,3093,5,1,0,1,83,83,0,488,488,0,432,432,0
"2021","Cheshire East 024","E02003813",5238,1504,2681,2676,2669,7,5,2,3,97,97,0,513,513,0,443,443,0
"2021","Cheshire East 025","E02003814",6701,2301,3241,3234,3222,12,7,2,5,132,131,1,678,678,0,349,349,0
"2021","Cheshire East 026","E02003815",5969,2206,2564,2554,2538,16,10,2,8,164,162,2,666,664,2,369,369,0
"2021","Cheshire East 027","E02003816",6346,2288,2677,2675,2655,20,2,0,2,162,161,1,762,760,2,457,457,0
"2021","Cheshire East 028","E02003817",6419,1705,3429,3427,3418,9,2,0,2,117,116,1,597,597,0,571,570,1
"2021","Cheshire East 029","E02003818",4870,1145,2906,2902,2892,10,4,0,4,60,59,1,358,358,0,401,400,1
"2021","Cheshire East 030","E02003819",5575,1474,2977,2972,2962,10,5,0,5,86,86,0,522,521,1,516,516,0
"2021","Cheshire East 031","E02003820",7750,2595,3846,3832,3801,31,14,0,14,183,180,3,778,777,1,348,348,0
"2021","Cheshire East 032","E02003821",4753,1441,2294,2288,2279,9,6,2,4,106,105,1,499,498,1,413,412,1
"2021","Cheshire East 033","E02003822",9812,2621,5419,5401,5373,28,18,6,12,183,181,2,930,926,4,659,659,0
"2021","Cheshire East 040","E02003823",5715,1533,2993,2985,2983,2,8,8,0,98,98,0,566,565,1,525,525,0
"2021","Cheshire East 042","E02003824",5246,1515,2774,2768,2752,16,6,2,4,99,99,0,497,495,2,361,361,0
"2021","Cheshire East 034","E02003825",5192,1729,2709,2703,2683,20,6,2,4,102,102,0,463,463,0,189,189,0
"2021","Cheshire East 035","E02003826",6899,2966,2570,2553,2533,20,17,4,13,177,175,2,710,709,1,476,476,0
"2021","Cheshire East 036","E02003827",7540,3338,2602,2578,2560,18,24,12,12,217,217,0,932,931,1,451,451,0
"2021","Cheshire East 037","E02003828",5034,2059,2048,2022,2018,4,26,18,8,140,140,0,488,484,4,299,299,0
"2021","Cheshire East 038","E02003829",4883,1580,2304,2292,2285,7,12,2,10,75,75,0,472,468,4,452,452,0
"2021","Cheshire East 039","E02003830",6399,3033,2094,2081,2075,6,13,6,7,240,240,0,705,701,4,327,327,0
"2021","Cheshire East 041","E02003831",8494,2317,4715,4685,4664,21,30,6,24,139,138,1,779,776,3,544,544,0
"2021","Cheshire East 043","E02003832",5479,2658,1877,1851,1840,11,26,22,4,231,229,2,502,502,0,211,208,3
"2021","Cheshire East 044","E02003833",5125,1806,2305,2295,2286,9,10,1,9,136,136,0,537,536,1,341,340,1
"2021","Cheshire East 045","E02003834",5728,2644,2016,2006,1991,15,10,5,5,151,151,0,651,649,2,266,266,0
"2021","Cheshire East 046","E02003835",7095,1654,4304,4290,4276,14,14,2,12,87,85,2,539,537,2,511,511,0
"2021","Cheshire East 047","E02003836",6047,1955,2602,2593,2581,12,9,2,7,141,140,1,716,716,0,633,633,0
"2021","Cheshire East 048","E02003838",6694,2158,3244,3232,3209,23,12,4,8,142,141,1,655,653,2,495,495,0
"2021","Cheshire East 050","E02003839",6061,1951,2681,2671,2663,8,10,2,8,131,128,3,719,718,1,579,579,0
"2021","Cheshire East 051","E02003840",9211,2151,5507,5479,5444,35,28,8,20,145,143,2,750,748,2,658,658,0
"2021","Cheshire East 001","E02003853",5148,1350,2917,2914,2896,18,3,0,3,78,77,1,448,448,0,355,355,0
"2021","Cheshire East 002","E02003854",5265,1302,3013,3010,3002,8,3,0,3,86,86,0,464,463,1,400,400,0
"2021","Cheshire East 003","E02003855",5401,1096,3263,3261,3249,12,2,2,0,62,62,0,456,455,1,524,524,0
"2021","Cheshire East 004","E02003856",9278,3477,4029,4012,3989,23,17,6,11,193,192,1,994,993,1,585,585,0
"2021","Cheshire East 005","E02003857",5435,1793,2717,2706,2692,14,11,4,7,94,94,0,549,549,0,282,282,0
"2021","Cheshire East 006","E02003858",5738,1608,3095,3076,3060,16,19,3,16,115,115,0,476,476,0,444,443,1
"2021","Cheshire East 007","E02003859",10506,2729,5980,5949,5912,37,31,12,19,166,164,2,888,882,6,743,740,3
"2021","Cheshire East 008","E02003860",5716,1395,3390,3385,3372,13,5,2,3,82,80,2,471,471,0,378,378,0
"2021","Cheshire East 009","E02003861",5189,1739,2386,2380,2363,17,6,4,2,130,129,1,571,570,1,363,363,0
"2021","Cheshire East 011","E02003862",4499,927,2788,2780,2773,7,8,0,8,62,62,0,318,317,1,404,404,0
"2021","Cheshire East 010","E02003863",5578,1370,3219,3216,3207,9,3,2,1,86,84,2,436,435,1,467,467,0
"2021","Cheshire East 012","E02003864",7342,2028,3770,3755,3729,26,15,2,13,137,136,1,740,738,2,667,667,0
"2021","Cheshire East 013","E02003865",6571,1956,3235,3222,3207,15,13,4,9,154,154,0,788,788,0,438,438,0
"2021","Cheshire East 014","E02003866",5184,1271,3088,3080,3078,2,8,2,6,75,75,0,425,423,2,325,324,1
"2021","Cheshire East 015","E02003867",6169,1934,3023,3016,3010,6,7,0,7,132,130,2,686,686,0,394,394,0
"2021","Cheshire East 016","E02003868",6948,2634,2803,2790,2772,18,13,6,7,172,172,0,838,837,1,501,501,0
"2021","Cheshire East 017","E02003869",6153,1849,3136,3128,3119,9,8,2,6,114,113,1,581,580,1,473,472,1
"2021","Cheshire East 018","E02003870",8938,3978,3160,3140,3122,18,20,6,14,255,255,0,1089,1088,1,456,456,0
"2021","Cheshire East 019","E02003871",5596,1910,2538,2530,2520,10,8,2,6,128,128,0,624,623,1,396,396,0
"2021","Cheshire East 020","E02003872",8759,2110,5180,5166,5145,21,14,4,10,135,134,1,747,747,0,587,587,0
"2021","Cheshire East 021","E02003873",4981,2115,1804,1791,1783,8,13,4,9,132,131,1,647,646,1,283,283,0
"2021","Cheshire East 052","E02007030",6142,2317,2995,2980,2959,21,15,2,13,81,80,1,487,486,1,262,262,0
"2021","Cheshire East 053","E02007031",6917,1884,4016,3997,3979,18,19,6,13,100,100,0,595,595,0,322,322,0
"2021","Cheshire West and Chester 022","E02003794",7148,2108,3798,3788,3771,17,10,5,5,140,140,0,661,657,4,441,440,1
"2021","Cheshire West and Chester 025","E02003795",5359,1713,2720,2714,2703,11,6,0,6,108,108,0,407,406,1,411,411,0
"2021","Cheshire West and Chester 027","E02003796",5974,1926,2829,2813,2801,12,16,8,8,110,109,1,591,591,0,518,517,1
"2021","Cheshire West and Chester 028","E02003797",8338,2861,4192,4178,4151,27,14,6,8,114,114,0,622,622,0,549,547,2
"2021","Cheshire West and Chester 029","E02003798",4891,2156,1749,1738,1723,15,11,2,9,126,126,0,558,556,2,302,302,0
"2021","Cheshire West and Chester 031","E02003799",5797,2432,2203,2193,2167,26,10,0,10,134,131,3,637,635,2,391,390,1
"2021","Cheshire West and Chester 030","E02003800",5862,1390,3459,3455,3444,11,4,2,2,94,92,2,457,457,0,462,462,0
"2021","Cheshire West and Chester 032","E02003801",5774,1831,2899,2893,2879,14,6,2,4,94,93,1,506,505,1,444,442,2
"2021","Cheshire West and Chester 033","E02003802",7827,4444,1875,1865,1842,23,10,2,8,180,180,0,922,916,6,406,406,0
"2021","Cheshire West and Chester 034","E02003803",9643,6661,1799,1782,1741,41,17,1,16,165,165,0,667,667,0,351,350,1
"2021","Cheshire West and Chester 036","E02003804",5799,2399,2237,2232,2212,20,5,0,5,121,119,2,700,699,1,342,342,0
"2021","Cheshire West and Chester 039","E02003805",5248,1345,3057,3045,3043,2,12,2,10,72,71,1,382,382,0,392,391,1
"2021","Cheshire West and Chester 041","E02003806",6543,1884,3509,3491,3483,8,18,0,18,100,100,0,600,598,2,450,450,0
"2021","Cheshire West and Chester 043","E02003807",7550,2308,3811,3788,3765,23,23,8,15,102,101,1,698,698,0,631,631,0
"2021","Cheshire West and Chester 044","E02003808",5162,2155,2074,2070,2059,11,4,2,2,129,128,1,599,599,0,205,205,0
"2021","Cheshire West and Chester 046","E02003809",6925,1827,3884,3872,3862,10,12,0,12,103,102,1,598,598,0,513,513,0
"2021","Cheshire West and Chester 047","E02003810",8069,2247,4352,4343,4333,10,9,3,6,149,149,0,777,776,1,544,544,0
"2021","Cheshire West and Chester 001","E02003841",6702,2020,3289,3276,3253,23,13,5,8,123,123,0,708,706,2,562,561,1
"2021","Cheshire West and Chester 004","E02003842",4849,1100,2924,2913,2895,18,11,8,3,76,76,0,344,344,0,405,405,0
"2021","Cheshire West and Chester 005","E02003843",5392,1909,2396,2390,2379,11,6,2,4,101,101,0,544,543,1,442,442,0
"2021","Cheshire West and Chester 006","E02003844",5682,1618,2995,2986,2978,8,9,3,6,90,88,2,540,537,3,439,439,0
"2021","Cheshire West and Chester 007","E02003845",8658,4318,2581,2550,2530,20,31,6,25,258,256,2,1053,1051,2,448,443,5
"2021","Cheshire West and Chester 008","E02003846",5307,2273,1911,1902,1886,16,9,8,1,153,153,0,604,604,0,366,365,1
"2021","Cheshire West and Chester 009","E02003847",8278,2446,4595,4583,4564,19,12,8,4,129,128,1,607,607,0,501,500,1
"2021","Cheshire West and Chester 010","E02003848",4249,1721,1670,1667,1653,14,3,2,1,69,69,0,464,463,1,325,323,2
"2021","Cheshire West and Chester 011","E02003849",6585,3001,2160,2151,2129,22,9,0,9,244,244,0,829,828,1,351,350,1
"2021","Cheshire West and Chester 013","E02003850",4254,1359,2046,2041,2033,8,5,2,3,93,92,1,424,424,0,332,332,0
"2021","Cheshire West and Chester 014","E02003851",4871,1352,2740,2735,2719,16,5,0,5,55,55,0,364,363,1,360,360,0
"2021","Cheshire West and Chester 016","E02003852",5493,1517,3003,3001,2990,11,2,2,0,68,68,0,464,462,2,441,441,0
"2021","Cheshire West and Chester 002","E02003874",7682,2165,3989,3973,3966,7,16,6,10,127,126,1,758,755,3,643,642,1
"2021","Cheshire West and Chester 003","E02003875",5561,1226,3443,3426,3422,4,17,0,17,61,61,0,428,428,0,403,401,2
"2021","Cheshire West and Chester 012","E02003876",4604,1575,2139,2133,2123,10,6,2,4,107,107,0,477,476,1,306,306,0
"2021","Cheshire West and Chester 015","E02003877",8179,2112,4532,4526,4505,21,6,4,2,135,135,0,734,731,3,666,666,0
"2021","Cheshire West and Chester 017","E02003878",7730,2147,4083,4059,4034,25,24,14,10,113,111,2,706,706,0,681,681,0
"2021","Cheshire West and Chester 018","E02003879",7339,3266,2797,2787,2747,40,10,4,6,181,178,3,724,724,0,371,371,0
"2021","Cheshire West and Chester 019","E02003880",5416,1767,2560,2550,2535,15,10,0,10,113,113,0,574,571,3,402,402,0
"2021","Cheshire West and Chester 020","E02003881",4809,1901,1921,1919,1902,17,2,0,2,129,128,1,598,597,1,260,260,0
"2021","Cheshire West and Chester 021","E02003882",7677,2894,3248,3236,3219,17,12,1,11,157,157,0,870,869,1,508,508,0
"2021","Cheshire West and Chester 023","E02003883",9249,2516,5262,5251,5235,16,11,2,9,164,163,1,792,790,2,515,515,0
"2021","Cheshire West and Chester 024","E02003884",7391,1769,4363,4355,4332,23,8,4,4,120,120,0,621,617,4,518,518,0
"2021","Cheshire West and Chester 026","E02003885",5319,1530,2881,2871,2859,12,10,2,8,101,101,0,460,460,0,347,347,0
"2021","Cheshire West and Chester 035","E02003886",5239,2056,2197,2188,2179,9,9,6,3,140,139,1,494,494,0,352,352,0
"2021","Cheshire West and Chester 037","E02003887",5635,2005,2728,2720,2683,37,8,2,6,148,148,0,470,469,1,284,284,0
"2021","Cheshire West and Chester 038","E02003888",5299,2257,1986,1976,1968,8,10,2,8,152,152,0,540,540,0,364,363,1
"2021","Cheshire West and Chester 040","E02003889",4939,2089,1875,1867,1853,14,8,0,8,139,137,2,523,521,2,313,313,0
"2021","Cheshire West and Chester 042","E02003890",5677,2169,2529,2523,2495,28,6,0,6,130,129,1,536,534,2,313,313,0
"2021","Cheshire West and Chester 045","E02003891",5368,1286,3115,3105,3101,4,10,2,8,91,90,1,454,453,1,422,422,0
"2021","Allerdale 001","E02003965",9308,2870,4555,4547,4537,10,8,2,6,197,195,2,853,850,3,833,830,3
"2021","Allerdale 002","E02003966",6025,1598,3458,3447,3438,9,11,6,5,75,75,0,461,459,2,433,432,1
"2021","Allerdale 003","E02003967",6737,2020,3428,3418,3404,14,10,4,6,139,139,0,648,648,0,502,502,0
"2021","Allerdale 004","E02003968",7455,2392,3640,3628,3616,12,12,2,10,133,133,0,714,714,0,576,575,1
"2021","Allerdale 005","E02003969",5252,2166,2015,2008,2001,7,7,2,5,136,136,0,526,525,1,409,409,0
"2021","Allerdale 006","E02003970",6944,1930,3655,3649,3633,16,6,0,6,130,130,0,711,711,0,518,518,0
"2021","Allerdale 007","E02003971",6618,1706,3657,3654,3642,12,3,0,3,110,110,0,589,588,1,556,555,1
"2021","Allerdale 008","E02003972",7465,2593,3427,3423,3413,10,4,0,4,134,133,1,772,769,3,539,539,0
"2021","Allerdale 009","E02003973",6970,2904,2484,2476,2456,20,8,2,6,183,183,0,908,906,2,491,490,1
"2021","Allerdale 010","E02003974",6222,2261,2756,2747,2723,24,9,4,5,103,103,0,603,602,1,499,498,1
"2021","Allerdale 011","E02003975",6006,1798,3113,3100,3084,16,13,5,8,77,77,0,499,497,2,519,519,0
"2021","Allerdale 012","E02003976",5501,1645,2778,2757,2736,21,21,4,17,86,86,0,516,515,1,476,475,1
"2021","Barrow-in-Furness 001","E02003977",5221,1687,2573,2569,2561,8,4,0,4,106,106,0,504,503,1,351,351,0
"2021","Barrow-in-Furness 002","E02003978",4870,1678,2184,2176,2171,5,8,0,8,108,108,0,507,507,0,393,393,0
"2021","Barrow-in-Furness 003","E02003979",6692,1684,3827,3820,3814,6,7,4,3,73,73,0,445,445,0,663,663,0
"2021","Barrow-in-Furness 004","E02003980",5390,2380,1802,1794,1781,13,8,0,8,165,164,1,690,690,0,353,352,1
"2021","Barrow-in-Furness 005","E02003981",5398,2039,2344,2335,2320,15,9,3,6,83,83,0,589,587,2,343,343,0
"2021","Barrow-in-Furness 006","E02003982",6561,1981,3503,3497,3487,10,6,2,4,91,91,0,553,552,1,433,433,0
"2021","Barrow-in-Furness 007","E02003983",5849,2576,2014,2000,1992,8,14,4,10,134,134,0,689,688,1,436,435,1
"2021","Barrow-in-Furness 008","E02003984",5183,2628,1287,1282,1278,4,5,2,3,185,181,4,730,721,9,353,353,0
"2021","Barrow-in-Furness 009","E02003985",5590,1899,2517,2505,2489,16,12,0,12,117,116,1,593,592,1,464,463,1
"2021","Barrow-in-Furness 010","E02003986",5077,1903,2155,2149,2140,9,6,2,4,108,107,1,533,531,2,378,378,0
"2021","Carlisle 001","E02003987",5096,1548,2599,2593,2589,4,6,4,2,126,126,0,441,441,0,382,382,0
"2021","Carlisle 002","E02003988",5547,1586,2752,2736,2721,15,16,3,13,170,170,0,583,581,2,456,454,2
"2021","Carlisle 003","E02003989",6306,1922,3196,3188,3178,10,8,6,2,114,114,0,570,569,1,504,503,1
"2021","Carlisle 004","E02003990",9033,2545,4886,4876,4863,13,10,2,8,151,150,1,807,805,2,644,644,0
"2021","Carlisle 005","E02003991",6401,1606,3759,3751,3736,15,8,2,6,70,70,0,477,477,0,489,489,0
"2021","Carlisle 006","E02003992",7058,3410,2242,2234,2214,20,8,3,5,195,195,0,839,837,2,372,372,0
"2021","Carlisle 007","E02003993",7536,1868,4342,4322,4315,7,20,6,14,122,122,0,634,633,1,570,570,0
"2021","Carlisle 008","E02003994",6048,2648,2146,2125,2113,12,21,10,11,167,161,6,645,643,2,442,442,0
"2021","Carlisle 009","E02003995",8085,3336,2979,2966,2950,16,13,13,0,234,232,2,961,960,1,575,572,3
"2021","Carlisle 010","E02003996",7949,3844,2567,2555,2523,32,12,0,12,235,234,1,886,886,0,417,415,2
"2021","Carlisle 011","E02003997",7372,3061,2676,2652,2641,11,24,8,16,235,228,7,896,895,1,504,504,0
"2021","Carlisle 012","E02003998",5138,2073,1966,1966,1953,13,0,0,0,131,131,0,560,559,1,408,408,0
"2021","Carlisle 013","E02003999",9770,2810,5333,5311,5275,36,22,7,15,166,166,0,774,774,0,687,687,0
"2021","Copeland 001","E02004000",4328,1405,2146,2142,2130,12,4,2,2,80,80,0,381,380,1,316,316,0
"2021","Copeland 002","E02004001",4503,1728,1793,1788,1781,7,5,0,5,94,93,1,553,552,1,335,335,0
"2021","Copeland 003","E02004002",7983,2500,4107,4101,4093,8,6,0,6,131,131,0,696,695,1,549,549,0
"2021","Copeland 004","E02004003",9694,3339,4556,4532,4498,34,24,9,15,181,181,0,910,905,5,708,708,0
"2021","Copeland 005","E02004004",7797,3000,3273,3267,3252,15,6,2,4,167,164,3,769,769,0,588,587,1
"2021","Copeland 006","E02004005",6341,2194,2911,2904,2884,20,7,5,2,143,143,0,608,608,0,485,485,0
"2021","Copeland 007","E02004006",7160,1798,4016,3990,3977,13,26,6,20,141,141,0,613,611,2,592,591,1
"2021","Copeland 008","E02004007",8210,2674,3847,3845,3831,14,2,0,2,171,169,2,819,817,2,699,699,0
"2021","Eden 001","E02004008",5495,1503,3076,3067,3060,7,9,4,5,86,85,1,455,455,0,375,375,0
"2021","Eden 002","E02004009",5342,1419,3061,3049,3031,18,12,4,8,91,91,0,415,415,0,356,355,1
"2021","Eden 003","E02004010",6452,2555,2530,2520,2515,5,10,4,6,138,132,6,714,711,3,515,514,1
"2021","Eden 004","E02004011",9245,2741,4798,4771,4759,12,27,8,19,140,140,0,806,806,0,760,760,0
"2021","Eden 005","E02004012",4776,1305,2686,2674,2665,9,12,6,6,62,62,0,399,398,1,324,324,0
"2021","Eden 006","E02004013",8718,2518,4677,4658,4648,10,19,6,13,148,147,1,738,735,3,637,637,0
"2021","Eden 007","E02004014",6608,1788,3665,3645,3636,9,20,2,18,115,115,0,575,575,0,465,464,1
"2021","South Lakeland 001","E02004015",5483,1954,2463,2450,2415,35,13,6,7,94,94,0,486,484,2,486,483,3
"2021","South Lakeland 002","E02004016",6935,2313,3387,3371,3353,18,16,8,8,123,122,1,629,628,1,483,482,1
"2021","South Lakeland 003","E02004017",7474,2621,3414,3402,3383,19,12,8,4,158,157,1,773,773,0,508,506,2
"2021","South Lakeland 004","E02004018",6915,2772,2716,2703,2685,18,13,5,8,158,156,2,830,827,3,439,438,1
"2021","South Lakeland 005","E02004019",6651,1799,3725,3703,3688,15,22,10,12,93,92,1,551,550,1,483,483,0
"2021","South Lakeland 006","E02004020",7569,2265,3842,3830,3815,15,12,0,12,110,110,0,755,752,3,597,596,1
"2021","South Lakeland 007","E02004021",4658,1199,2644,2639,2625,14,5,2,3,74,74,0,419,417,2,322,322,0
"2021","South Lakeland 008","E02004022",4801,1258,2718,2707,2691,16,11,2,9,78,75,3,403,401,2,344,344,0
"2021","South Lakeland 009","E02004023",5250,1457,2737,2724,2719,5,13,8,5,91,91,0,503,502,1,462,461,1
"2021","South Lakeland 010","E02004024",6376,1446,3854,3842,3827,15,12,6,6,95,95,0,520,518,2,461,460,1
"2021","South Lakeland 011","E02004025",6831,1706,3695,3671,3657,14,24,9,15,114,114,0,632,632,0,684,681,3
"2021","South Lakeland 012","E02004026",6835,2439,2955,2943,2920,23,12,2,10,151,151,0,792,792,0,498,497,1
"2021","South Lakeland 013","E02004027",7109,1697,3878,3858,3841,17,20,0,20,89,89,0,655,654,1,790,788,2
"2021","South Lakeland 014","E02004028",6815,1572,3972,3965,3942,23,7,4,3,83,83,0,598,596,2,590,590,0
"2021","Burnley 001","E02005176",7277,2460,3459,3454,3444,10,5,2,3,190,189,1,683,683,0,485,484,1
"2021","Burnley 002","E02005177",5233,1908,2289,2285,2277,8,4,0,4,147,147,0,490,488,2,399,399,0
"2021","Burnley 003","E02005178",8524,3270,4119,4109,4103,6,10,8,2,229,229,0,513,512,1,393,392,1
"2021","Burnley 004","E02005179",7405,3070,2615,2609,2594,15,6,6,0,272,266,6,936,935,1,512,512,0
"2021","Burnley 005","E02005180",5885,1808,2977,2969,2958,11,8,4,4,113,112,1,557,557,0,430,430,0
"2021","Burnley 006","E02005181",5343,2282,1856,1847,1828,19,9,5,4,155,155,0,689,689,0,361,361,0
"2021","Burnley 007","E02005182",4961,2217,1598,1596,1586,10,2,0,2,174,172,2,610,610,0,362,362,0
"2021","Burnley 008","E02005183",5025,1824,2063,2056,2043,13,7,3,4,144,144,0,580,579,1,414,413,1
"2021","Burnley 009","E02005184",4396,1176,2409,2404,2396,8,5,2,3,62,62,0,410,410,0,339,339,0
"2021","Burnley 010","E02005185",7443,3622,2252,2237,2221,16,15,10,5,243,242,1,899,897,2,427,427,0
"2021","Burnley 011","E02005186",5125,1724,2504,2495,2475,20,9,7,2,102,102,0,485,483,2,310,309,1
"2021","Burnley 014","E02006881",8583,3417,3486,3470,3448,22,16,8,8,233,231,2,848,846,2,599,597,2
"2021","Chorley 001","E02005189",4281,1612,1639,1631,1622,9,8,4,4,121,120,1,571,569,2,338,337,1
"2021","Chorley 002","E02005190",5108,1428,2785,2777,2761,16,8,4,4,97,97,0,500,496,4,298,298,0
"2021","Chorley 003","E02005191",7937,2321,4303,4293,4271,22,10,2,8,162,162,0,740,740,0,411,411,0
"2021","Chorley 004","E02005192",7130,2251,3663,3659,3649,10,4,2,2,144,142,2,720,720,0,352,352,0
"2021","Chorley 005","E02005193",7227,1984,3969,3960,3936,24,9,2,7,142,141,1,653,651,2,479,477,2
"2021","Chorley 006","E02005194",6608,2463,2835,2831,2816,15,4,0,4,142,141,1,696,695,1,472,471,1
"2021","Chorley 007","E02005195",6833,2557,2954,2954,2944,10,0,0,0,165,165,0,764,762,2,393,391,2
"2021","Chorley 008","E02005196",8935,2928,4343,4337,4309,28,6,2,4,212,212,0,882,870,12,570,570,0
"2021","Chorley 009","E02005197",5770,2334,2251,2240,2230,10,11,8,3,145,145,0,711,709,2,329,329,0
"2021","Chorley 010","E02005198",7832,3034,3309,3294,3270,24,15,2,13,179,174,5,854,850,4,456,455,1
"2021","Chorley 011","E02005199",6340,1562,3655,3645,3638,7,10,6,4,109,108,1,544,542,2,470,470,0
"2021","Chorley 012","E02005200",7199,2796,2960,2954,2940,14,6,2,4,168,167,1,897,894,3,378,378,0
"2021","Chorley 013","E02005201",6805,2380,3141,3131,3116,15,10,2,8,153,153,0,669,669,0,462,462,0
"2021","Chorley 014","E02005202",8370,2539,4300,4282,4248,34,18,6,12,170,170,0,784,781,3,577,576,1
"2021","Fylde 001","E02005203",7027,1916,3877,3850,3829,21,27,11,16,142,142,0,660,659,1,432,431,1
"2021","Fylde 002","E02005204",10353,3439,4861,4835,4809,26,26,8,18,231,227,4,1138,1137,1,684,684,0
"2021","Fylde 003","E02005205",5649,1804,2828,2825,2809,16,3,0,3,96,96,0,565,562,3,356,355,1
"2021","Fylde 004","E02005206",6280,2041,2809,2787,2762,25,22,0,22,126,126,0,805,805,0,499,497,2
"2021","Fylde 005","E02005207",7313,1858,3879,3862,3836,26,17,2,15,150,147,3,763,760,3,663,663,0
"2021","Fylde 006","E02005208",8897,2939,3569,3541,3493,48,28,6,22,248,243,5,1157,1155,2,984,979,5
"2021","Fylde 007","E02005209",7393,2203,3627,3601,3579,22,26,5,21,156,156,0,832,832,0,575,575,0
"2021","Fylde 008","E02005210",8907,2097,4666,4649,4632,17,17,2,15,157,156,1,1020,1020,0,967,966,1
"2021","Fylde 009","E02005211",7436,1969,3709,3690,3679,11,19,6,13,156,154,2,902,901,1,700,699,1
"2021","Hyndburn 001","E02005212",8992,3301,3869,3856,3842,14,13,6,7,256,256,0,913,910,3,653,652,1
"2021","Hyndburn 002","E02005213",9242,3387,4150,4137,4115,22,13,4,9,251,250,1,921,921,0,533,531,2
"2021","Hyndburn 003","E02005214",5468,2131,2255,2253,2240,13,2,0,2,164,164,0,548,547,1,370,370,0
"2021","Hyndburn 004","E02005215",10016,4139,3723,3707,3682,25,16,2,14,340,339,1,1146,1145,1,668,668,0
"2021","Hyndburn 005","E02005216",4239,1721,1626,1620,1613,7,6,0,6,121,120,1,456,456,0,315,315,0
"2021","Hyndburn 006","E02005217",9535,3751,4323,4306,4286,20,17,4,13,317,316,1,655,655,0,489,489,0
"2021","Hyndburn 007","E02005218",5932,2359,2223,2217,2213,4,6,2,4,192,192,0,693,693,0,465,465,0
"2021","Hyndburn 008","E02005219",7160,2617,3171,3154,3147,7,17,4,13,177,177,0,747,746,1,448,448,0
"2021","Hyndburn 009","E02005220",5047,1561,2430,2420,2410,10,10,2,8,102,101,1,540,539,1,414,414,0
"2021","Lancaster 001","E02005221",8409,2303,4354,4325,4306,19,29,2,27,162,160,2,916,916,0,674,673,1
"2021","Lancaster 002","E02005222",5120,1159,3041,3023,3018,5,18,6,12,110,110,0,414,414,0,396,395,1
"2021","Lancaster 003","E02005223",6240,1459,3604,3590,3578,12,14,8,6,83,83,0,546,545,1,548,548,0
"2021","Lancaster 004","E02005224",4576,1106,2254,2233,2224,9,21,9,12,74,74,0,514,513,1,628,627,1
"2021","Lancaster 005","E02005225",4994,1402,2668,2653,2643,10,15,6,9,79,78,1,470,468,2,375,375,0
"2021","Lancaster 006","E02005226",5946,2542,1898,1878,1872,6,20,6,14,232,231,1,825,823,2,449,449,0
"2021","Lancaster 008","E02005228",4630,1668,1986,1976,1963,13,10,6,4,109,108,1,521,520,1,346,346,0
"2021","Lancaster 009","E02005229",4638,2119,1390,1383,1370,13,7,0,7,192,189,3,691,690,1,246,244,2
"2021","Lancaster 010","E02005230",5439,1874,2220,2208,2194,14,12,4,8,192,192,0,690,689,1,463,462,1
"2021","Lancaster 011","E02005231",6658,2973,2387,2373,2352,21,14,4,10,192,192,0,746,741,5,360,359,1
"2021","Lancaster 013","E02005233",6497,2835,2635,2619,2588,31,16,6,10,127,127,0,613,610,3,287,286,1
"2021","Lancaster 014","E02005234",8190,5821,1473,1449,1428,21,24,6,18,162,162,0,525,523,2,209,208,1
"2021","Lancaster 015","E02005235",4581,3010,1064,1060,1045,15,4,4,0,63,63,0,307,306,1,137,137,0
"2021","Lancaster 016","E02005236",10874,3450,5301,5269,5226,43,32,10,22,257,253,4,1080,1079,1,786,786,0
"2021","Lancaster 017","E02005237",8521,3632,3604,3590,3554,36,14,8,6,162,162,0,685,684,1,438,438,0
"2021","Lancaster 018","E02005238",4546,1690,2066,2043,2030,13,23,4,19,78,78,0,385,385,0,327,326,1
"2021","Lancaster 019","E02005239",9815,6008,2890,2876,2862,14,14,2,12,83,83,0,450,450,0,384,382,2
"2021","Lancaster 020","E02006871",9969,3258,4718,4708,4688,20,10,2,8,191,191,0,1029,1029,0,773,773,0
"2021","Pendle 001","E02005240",4474,1523,2022,2020,2009,11,2,0,2,133,133,0,483,481,2,313,313,0
"2021","Pendle 002","E02005241",4653,1542,2151,2149,2137,12,2,2,0,117,117,0,530,530,0,313,312,1
"2021","Pendle 003","E02005242",5109,1613,2444,2444,2434,10,0,0,0,139,139,0,556,556,0,357,357,0
"2021","Pendle 006","E02005245",5799,1698,2995,2978,2969,9,17,6,11,122,122,0,596,596,0,388,387,1
"2021","Pendle 007","E02005246",4372,1921,1548,1544,1529,15,4,2,2,124,123,1,513,511,2,266,266,0
"2021","Pendle 008","E02005247",8321,2273,4430,4416,4400,16,14,7,7,163,163,0,878,876,2,577,576,1
"2021","Pendle 009","E02005248",5665,2017,2631,2619,2606,13,12,8,4,186,184,2,511,511,0,320,320,0
"2021","Pendle 010","E02005249",7791,2937,3460,3450,3428,22,10,4,6,213,212,1,747,747,0,434,434,0
"2021","Pendle 011","E02005250",6836,2251,3660,3651,3633,18,9,4,5,165,165,0,411,410,1,349,349,0
"2021","Pendle 012","E02005251",5616,1781,2848,2842,2823,19,6,0,6,130,130,0,444,444,0,413,413,0
"2021","Pendle 013","E02005252",7963,2394,4291,4285,4235,50,6,2,4,198,198,0,579,578,1,501,499,2
"2021","Pendle 014","E02007003",8628,3451,3293,3280,3257,23,13,6,7,235,233,2,1014,1011,3,635,633,2
"2021","Preston 001","E02005253",5853,1748,3205,3199,3189,10,6,0,6,81,81,0,443,443,0,376,375,1
"2021","Preston 002","E02005254",7684,2190,4460,4458,4436,22,2,0,2,95,95,0,524,523,1,415,415,0
"2021","Preston 003","E02005255",7712,2132,4298,4288,4274,14,10,4,6,140,138,2,573,573,0,569,567,2
"2021","Preston 004","E02005256",5626,1738,2864,2856,2832,24,8,4,4,98,97,1,531,531,0,395,395,0
"2021","Preston 005","E02005257",4660,1979,1581,1574,1562,12,7,4,3,130,130,0,612,611,1,358,358,0
"2021","Preston 006","E02005258",6821,2109,3579,3573,3561,12,6,4,2,116,115,1,490,488,2,527,527,0
"2021","Preston 007","E02005259",8108,3324,3303,3299,3293,6,4,0,4,194,193,1,732,730,2,555,555,0
"2021","Preston 008","E02005260",5528,1761,2765,2763,2756,7,2,0,2,88,88,0,458,458,0,456,456,0
"2021","Preston 009","E02005261",7666,3549,2758,2754,2743,11,4,2,2,204,203,1,729,728,1,426,426,0
"2021","Preston 010","E02005262",5977,2351,2688,2674,2649,25,14,6,8,139,138,1,556,556,0,243,242,1
"2021","Preston 011","E02005263",5711,2829,2152,2144,2129,15,8,0,8,116,116,0,383,381,2,231,229,2
"2021","Preston 012","E02005264",10513,6639,2443,2437,2415,22,6,2,4,221,219,2,873,867,6,337,335,2
"2021","Preston 013","E02005265",8677,3697,3313,3304,3281,23,9,0,9,224,221,3,894,889,5,549,548,1
"2021","Preston 014","E02005266",6745,3326,2346,2343,2338,5,3,2,1,205,203,2,600,600,0,268,267,1
"2021","Preston 015","E02005267",5318,3147,1633,1628,1616,12,5,4,1,88,87,1,255,255,0,195,195,0
"2021","Preston 016","E02005268",7055,2878,3080,3077,3067,10,3,2,1,179,179,0,523,523,0,395,395,0
"2021","Preston 017","E02005269",9014,5615,2219,2201,2186,15,18,6,12,202,198,4,674,670,4,304,302,2
"2021","Ribble Valley 001","E02005270",6251,1603,3576,3558,3552,6,18,12,6,105,105,0,547,547,0,420,419,1
"2021","Ribble Valley 002","E02005271",6749,2140,3235,3233,3226,7,2,0,2,136,136,0,703,701,2,535,535,0
"2021","Ribble Valley 003","E02005272",7325,2556,3225,3219,3200,19,6,2,4,167,167,0,846,844,2,531,531,0
"2021","Ribble Valley 004","E02005273",5040,1413,2720,2713,2707,6,7,2,5,100,97,3,405,404,1,402,402,0
"2021","Ribble Valley 005","E02005274",6537,1763,3624,3616,3592,24,8,3,5,109,109,0,643,642,1,398,398,0
"2021","Ribble Valley 006","E02005275",4768,1564,2300,2295,2290,5,5,0,5,94,94,0,460,459,1,350,349,1
"2021","Ribble Valley 007","E02005276",7359,2003,3988,3984,3969,15,4,0,4,146,146,0,687,686,1,535,533,2
"2021","Ribble Valley 008","E02005277",7433,1812,4351,4341,4329,12,10,4,6,100,99,1,575,573,2,595,595,0
"2021","Rossendale 001","E02005278",6450,1995,3288,3275,3244,31,13,6,7,126,126,0,635,633,2,406,406,0
"2021","Rossendale 002","E02005279",8186,3126,3503,3496,3468,28,7,4,3,226,226,0,817,813,4,514,512,2
"2021","Rossendale 003","E02005280",8744,3393,3779,3762,3747,15,17,10,7,238,236,2,864,863,1,470,470,0
"2021","Rossendale 004","E02005281",7134,2629,3121,3115,3074,41,6,2,4,187,185,2,719,717,2,478,478,0
"2021","Rossendale 007","E02005284",5031,1480,2571,2559,2548,11,12,6,6,97,97,0,485,482,3,398,398,0
"2021","Rossendale 008","E02005285",5275,1645,2571,2562,2548,14,9,4,5,127,127,0,561,558,3,371,371,0
"2021","Rossendale 009","E02005286",6400,2384,2723,2712,2691,21,11,1,10,176,170,6,677,677,0,440,440,0
"2021","Rossendale 010","E02006884",10085,3936,3947,3938,3887,51,9,0,9,297,293,4,1248,1242,6,657,654,3
"2021","South Ribble 001","E02005287",4379,1129,2526,2523,2513,10,3,0,3,59,58,1,352,352,0,313,311,2
"2021","South Ribble 002","E02005288",5068,1470,2616,2609,2596,13,7,0,7,81,80,1,476,475,1,425,425,0
"2021","South Ribble 003","E02005289",4978,1260,2838,2834,2825,9,4,2,2,78,77,1,423,422,1,379,379,0
"2021","South Ribble 004","E02005290",5937,1942,2977,2970,2954,16,7,6,1,113,112,1,560,559,1,345,345,0
"2021","South Ribble 005","E02005291",4686,1625,2155,2152,2136,16,3,0,3,70,69,1,519,518,1,317,317,0
"2021","South Ribble 006","E02005292",4541,1720,1807,1803,1796,7,4,4,0,118,117,1,560,560,0,336,336,0
"2021","South Ribble 007","E02005293",4539,1646,1825,1820,1815,5,5,2,3,117,117,0,526,525,1,425,423,2
"2021","South Ribble 008","E02005294",5674,2200,2472,2458,2443,15,14,8,6,124,124,0,564,564,0,314,314,0
"2021","South Ribble 009","E02005295",6271,2156,2961,2942,2922,20,19,5,14,108,107,1,615,615,0,431,431,0
"2021","South Ribble 010","E02005296",5067,1218,2939,2929,2917,12,10,0,10,73,73,0,436,436,0,401,400,1
"2021","South Ribble 011","E02005297",7059,1882,3818,3808,3788,20,10,8,2,140,139,1,626,626,0,593,593,0
"2021","South Ribble 012","E02005298",6819,2256,3350,3346,3322,24,4,2,2,112,111,1,665,664,1,436,436,0
"2021","South Ribble 013","E02005299",6029,2391,2430,2419,2397,22,11,7,4,169,168,1,719,718,1,320,320,0
"2021","South Ribble 014","E02005300",4138,1266,2113,2105,2098,7,8,2,6,94,91,3,399,398,1,266,265,1
"2021","South Ribble 015","E02005301",5099,1855,2079,2073,2061,12,6,4,2,119,119,0,628,627,1,418,417,1
"2021","South Ribble 016","E02005302",6209,1797,3303,3298,3264,34,5,2,3,120,118,2,568,566,2,421,420,1
"2021","South Ribble 017","E02005303",5007,2085,1830,1819,1813,6,11,6,5,152,152,0,589,586,3,351,351,0
"2021","West Lancashire 001","E02005304",7571,2132,4146,4142,4129,13,4,4,0,110,109,1,659,659,0,524,524,0
"2021","West Lancashire 002","E02005305",6852,1903,3659,3643,3630,13,16,2,14,113,113,0,692,691,1,485,484,1
"2021","West Lancashire 003","E02005306",6454,1776,3444,3434,3418,16,10,0,10,99,98,1,634,633,1,501,501,0
"2021","West Lancashire 004","E02005307",7924,2598,3842,3830,3813,17,12,0,12,147,147,0,762,760,2,575,575,0
"2021","West Lancashire 005","E02005308",5539,1397,3139,3132,3122,10,7,4,3,80,80,0,462,462,0,461,461,0
"2021","West Lancashire 006","E02005309",7374,2515,3602,3600,3590,10,2,0,2,108,108,0,590,590,0,559,558,1
"2021","West Lancashire 007","E02005310",9211,5630,2379,2377,2369,8,2,0,2,105,105,0,590,587,3,507,506,1
"2021","West Lancashire 008","E02005311",6041,2619,2623,2605,2596,9,18,6,12,53,53,0,383,383,0,363,363,0
"2021","West Lancashire 009","E02005312",5302,1888,2507,2507,2492,15,0,0,0,129,129,0,463,463,0,315,314,1
"2021","West Lancashire 010","E02005313",6876,3185,2332,2323,2306,17,9,6,3,209,207,2,747,747,0,403,403,0
"2021","West Lancashire 011","E02005314",5324,2227,1954,1943,1934,9,11,4,7,140,138,2,600,600,0,403,401,2
"2021","West Lancashire 012","E02005315",6781,1661,3933,3925,3911,14,8,2,6,74,74,0,470,470,0,643,642,1
"2021","West Lancashire 013","E02005316",5104,2306,1875,1873,1864,9,2,0,2,129,129,0,504,504,0,290,290,0
"2021","West Lancashire 014","E02005317",5647,2836,1719,1710,1706,4,9,6,3,173,173,0,601,597,4,318,318,0
"2021","West Lancashire 015","E02005318",6333,1907,3287,3274,3258,16,13,4,9,110,110,0,556,556,0,473,473,0
"2021","Wyre 001","E02005319",6778,2879,2170,2156,2137,19,14,4,10,218,214,4,979,978,1,532,532,0
"2021","Wyre 002","E02005320",4736,1566,2179,2169,2159,10,10,0,10,107,107,0,448,448,0,436,436,0
"2021","Wyre 003","E02005321",5062,1754,2221,2216,2204,12,5,0,5,105,105,0,488,485,3,494,494,0
"2021","Wyre 004","E02005322",8902,2162,4696,4690,4662,28,6,2,4,175,174,1,931,929,2,938,937,1
"2021","Wyre 005","E02005323",6068,2154,2624,2608,2590,18,16,2,14,158,155,3,701,701,0,431,430,1
"2021","Wyre 006","E02005324",6155,1959,3156,3146,3130,16,10,4,6,94,94,0,533,528,5,413,409,4
"2021","Wyre 007","E02005325",8008,1935,4353,4333,4326,7,20,6,14,170,169,1,712,711,1,838,836,2
"2021","Wyre 008","E02005326",7214,2216,3147,3129,3110,19,18,4,14,163,161,2,954,954,0,734,733,1
"2021","Wyre 009","E02005327",5604,1481,3122,3116,3089,27,6,0,6,76,75,1,528,528,0,397,397,0
"2021","Wyre 010","E02005328",6570,1620,3542,3527,3500,27,15,6,9,126,125,1,649,648,1,633,631,2
"2021","Wyre 011","E02005329",7604,2587,3236,3219,3173,46,17,0,17,185,182,3,959,958,1,637,637,0
"2021","Wyre 012","E02005330",7510,1824,4142,4118,4093,25,24,4,20,113,113,0,808,806,2,623,623,0
"2021","Wyre 013","E02005331",7021,2102,3231,3217,3192,25,14,2,12,145,145,0,891,889,2,652,651,1
"2021","Wyre 014","E02005332",7122,1922,3763,3759,3739,20,4,0,4,101,97,4,697,691,6,639,637,2
"2021","Bolton 001","E02000984",6371,1808,3604,3585,3574,11,19,4,15,109,109,0,491,489,2,359,359,0
"2021","Bolton 002","E02000985",6211,1677,3421,3412,3397,15,9,2,7,100,99,1,538,537,1,475,475,0
"2021","Bolton 003","E02000986",6879,2219,3328,3316,3305,11,12,6,6,148,147,1,686,684,2,498,497,1
"2021","Bolton 004","E02000987",6128,2412,2305,2299,2278,21,6,0,6,154,152,2,777,776,1,480,478,2
"2021","Bolton 005","E02000988",7144,2790,3087,3075,3058,17,12,2,10,165,164,1,618,616,2,484,484,0
"2021","Bolton 006","E02000989",7072,1921,3757,3753,3733,20,4,0,4,120,118,2,631,630,1,643,642,1
"2021","Bolton 007","E02000990",6918,2435,3285,3281,3264,17,4,0,4,155,155,0,640,640,0,403,403,0
"2021","Bolton 008","E02000991",6222,2118,3049,3042,3029,13,7,2,5,134,134,0,539,539,0,382,382,0
"2021","Bolton 009","E02000992",5196,1683,2495,2486,2477,9,9,2,7,103,103,0,511,510,1,404,404,0
"2021","Bolton 010","E02000993",6246,2999,2042,2032,2022,10,10,8,2,169,168,1,723,723,0,313,313,0
"2021","Bolton 011","E02000994",6646,2539,3024,3019,3008,11,5,2,3,182,179,3,575,575,0,326,325,1
"2021","Bolton 012","E02000995",6542,2206,3066,3055,3038,17,11,4,7,131,131,0,683,681,2,456,456,0
"2021","Bolton 013","E02000996",6368,3006,2061,2046,2039,7,15,10,5,182,181,1,684,683,1,435,434,1
"2021","Bolton 014","E02000997",5306,1726,2613,2603,2590,13,10,4,6,115,112,3,484,482,2,368,368,0
"2021","Bolton 015","E02000998",7744,3152,3440,3417,3395,22,23,20,3,208,206,2,589,588,1,355,355,0
"2021","Bolton 016","E02000999",6750,3166,2290,2276,2263,13,14,6,8,201,201,0,654,654,0,439,439,0
"2021","Bolton 017","E02001000",7440,3132,2801,2796,2782,14,5,0,5,225,224,1,753,751,2,529,529,0
"2021","Bolton 018","E02001001",6674,2299,3297,3290,3278,12,7,4,3,163,163,0,526,526,0,389,389,0
"2021","Bolton 019","E02001002",7670,2990,3281,3263,3246,17,18,4,14,178,177,1,746,744,2,475,475,0
"2021","Bolton 020","E02001003",6033,1482,3658,3647,3641,6,11,2,9,93,92,1,346,346,0,454,454,0
"2021","Bolton 021","E02001004",6765,2462,3296,3286,3279,7,10,8,2,152,152,0,470,468,2,385,384,1
"2021","Bolton 022","E02001005",7258,2861,3367,3360,3341,19,7,6,1,156,155,1,457,457,0,417,416,1
"2021","Bolton 023","E02001006",6209,2162,3270,3262,3259,3,8,4,4,121,121,0,360,360,0,296,296,0
"2021","Bolton 024","E02001007",8351,2714,3931,3914,3902,12,17,10,7,221,219,2,811,810,1,674,673,1
"2021","Bolton 025","E02001008",6348,2308,3099,3090,3082,8,9,6,3,161,161,0,426,426,0,354,354,0
"2021","Bolton 026","E02001009",5673,2031,2668,2653,2643,10,15,6,9,138,134,4,497,496,1,339,339,0
"2021","Bolton 027","E02001010",4921,2142,1958,1954,1944,10,4,0,4,149,147,2,423,423,0,249,249,0
"2021","Bolton 028","E02001011",8086,2476,4140,4126,4111,15,14,2,12,160,160,0,814,813,1,496,496,0
"2021","Bolton 029","E02001012",7077,2494,3570,3560,3542,18,10,10,0,143,143,0,498,498,0,372,372,0
"2021","Bolton 030","E02001013",4990,1417,2719,2711,2711,0,8,4,4,104,104,0,382,381,1,368,367,1
"2021","Bolton 031","E02001014",6886,2625,2798,2790,2761,29,8,6,2,169,169,0,845,844,1,449,449,0
"2021","Bolton 032","E02001015",6732,2934,2163,2148,2126,22,15,4,11,223,220,3,894,894,0,518,518,0
"2021","Bolton 033","E02001016",6503,3040,2307,2298,2277,21,9,4,5,205,203,2,614,614,0,337,335,2
"2021","Bolton 034","E02001017",8686,3540,3469,3461,3437,24,8,4,4,213,213,0,874,874,0,590,589,1
"2021","Bolton 035","E02001018",6242,2041,3209,3202,3189,13,7,2,5,115,115,0,572,570,2,305,305,0
"2021","Bury 001","E02001019",7392,2725,3208,3194,3186,8,14,4,10,166,165,1,857,855,2,436,436,0
"2021","Bury 002","E02001020",4980,1155,2977,2974,2968,6,3,0,3,56,56,0,365,362,3,427,426,1
"2021","Bury 003","E02001021",6322,1803,3424,3412,3388,24,12,4,8,118,118,0,541,540,1,436,436,0
"2021","Bury 004","E02001022",6612,2323,2996,2988,2952,36,8,4,4,155,152,3,601,599,2,537,537,0
"2021","Bury 005","E02001023",4560,1448,2307,2303,2296,7,4,0,4,89,89,0,411,411,0,305,305,0
"2021","Bury 006","E02001024",6609,2140,3281,3271,3262,9,10,4,6,138,138,0,635,634,1,415,415,0
"2021","Bury 007","E02001025",6278,2607,2429,2411,2395,16,18,8,10,198,195,3,676,674,2,368,368,0
"2021","Bury 008","E02001026",8594,3656,3578,3563,3544,19,15,11,4,256,256,0,715,714,1,389,388,1
"2021","Bury 009","E02001027",5787,2505,2067,2064,2046,18,3,1,2,151,151,0,720,719,1,344,344,0
"2021","Bury 010","E02001028",6180,1380,3747,3735,3725,10,12,10,2,89,88,1,409,409,0,555,555,0
"2021","Bury 011","E02001029",5999,2274,2679,2671,2658,13,8,4,4,159,155,4,555,552,3,332,332,0
"2021","Bury 012","E02001030",5126,1671,2650,2641,2629,12,9,1,8,87,87,0,445,444,1,273,273,0
"2021","Bury 013","E02001031",5476,2006,2398,2392,2374,18,6,2,4,159,159,0,559,556,3,354,354,0
"2021","Bury 014","E02001032",6235,2375,2668,2666,2646,20,2,0,2,128,128,0,606,605,1,458,458,0
"2021","Bury 015","E02001033",4848,2052,1842,1833,1818,15,9,6,3,162,161,1,566,566,0,226,226,0
"2021","Bury 016","E02001034",6813,3253,2029,2019,2007,12,10,2,8,230,227,3,864,862,2,437,437,0
"2021","Bury 017","E02001035",5982,1848,3129,3121,3110,11,8,6,2,92,92,0,455,455,0,458,458,0
"2021","Bury 018","E02001036",5873,2401,2445,2442,2418,24,3,2,1,164,163,1,571,570,1,292,290,2
"2021","Bury 019","E02001037",5970,1680,3277,3263,3257,6,14,10,4,87,87,0,441,440,1,485,485,0
"2021","Bury 020","E02001038",4705,1914,1811,1792,1773,19,19,8,11,115,115,0,539,536,3,326,326,0
"2021","Bury 021","E02001039",6587,2950,2420,2407,2396,11,13,7,6,188,185,3,634,634,0,395,395,0
"2021","Bury 022","E02001040",5278,1939,2446,2434,2408,26,12,0,12,116,115,1,432,430,2,345,345,0
"2021","Bury 023","E02001041",6351,2814,2325,2304,2279,25,21,10,11,170,169,1,592,589,3,450,447,3
"2021","Bury 024","E02001042",5316,1958,2483,2461,2436,25,22,8,14,101,101,0,458,455,3,316,314,2
"2021","Bury 025","E02001043",4600,1807,1934,1925,1901,24,9,2,7,106,106,0,413,412,1,340,340,0
"2021","Bury 026","E02001044",6398,2034,3672,3656,3645,11,16,8,8,82,81,1,329,329,0,281,281,0
"2021","Manchester 001","E02001045",6462,3125,2052,2045,2020,25,7,2,5,222,220,2,651,651,0,412,412,0
"2021","Manchester 002","E02001046",8419,4064,3082,3064,3021,43,18,4,14,229,228,1,694,691,3,350,350,0
"2021","Manchester 003","E02001047",8093,3851,2777,2768,2755,13,9,6,3,262,260,2,740,739,1,463,462,1
"2021","Manchester 004","E02001048",7017,2700,3261,3248,3226,22,13,0,13,187,185,2,537,537,0,332,332,0
"2021","Manchester 005","E02001049",8171,3626,3089,3085,3063,22,4,0,4,213,211,2,667,666,1,576,576,0
"2021","Manchester 006","E02001050",6014,2752,2202,2179,2155,24,23,14,9,208,201,7,558,554,4,294,291,3
"2021","Manchester 007","E02001051",6795,3092,2581,2564,2540,24,17,12,5,259,257,2,522,520,2,341,341,0
"2021","Manchester 008","E02001052",10538,3808,5384,5363,5348,15,21,8,13,290,289,1,583,583,0,473,472,1
"2021","Manchester 009","E02001053",8454,4399,2643,2627,2601,26,16,8,8,341,341,0,725,724,1,346,345,1
"2021","Manchester 011","E02001055",7214,3603,2218,2203,2172,31,15,6,9,270,269,1,709,706,3,414,414,0
"2021","Manchester 012","E02001056",6471,3311,1938,1931,1924,7,7,2,5,258,258,0,597,595,2,367,365,2
"2021","Manchester 015","E02001059",8879,4604,2927,2900,2858,42,27,10,17,320,318,2,696,694,2,332,331,1
"2021","Manchester 017","E02001061",8087,3916,2752,2738,2717,21,14,4,10,280,279,1,742,738,4,397,395,2
"2021","Manchester 018","E02001062",7878,4641,2351,2339,2312,27,12,4,8,218,217,1,473,470,3,195,193,2
"2021","Manchester 019","E02001063",9688,7479,1599,1568,1524,44,31,5,26,142,141,1,348,346,2,120,119,1
"2021","Manchester 020","E02001064",7858,3464,3179,3167,3152,15,12,8,4,230,229,1,625,625,0,360,360,0
"2021","Manchester 021","E02001065",7066,3398,2565,2557,2548,9,8,6,2,218,218,0,568,568,0,317,316,1
"2021","Manchester 022","E02001066",9719,6170,2808,2798,2785,13,10,6,4,169,168,1,344,342,2,228,227,1
"2021","Manchester 023","E02001067",8110,3838,2967,2954,2936,18,13,6,7,305,304,1,673,673,0,327,326,1
"2021","Manchester 024","E02001068",8374,4386,2758,2733,2694,39,25,6,19,282,282,0,619,615,4,329,327,2
"2021","Manchester 025","E02001069",9705,6017,2765,2756,2706,50,9,4,5,234,231,3,443,441,2,246,246,0
"2021","Manchester 026","E02001070",10448,7133,2597,2570,2544,26,27,8,19,160,159,1,336,335,1,222,222,0
"2021","Manchester 028","E02001072",7362,4082,2399,2364,2326,38,35,4,31,144,143,1,528,522,6,209,209,0
"2021","Manchester 029","E02001073",7903,4176,2768,2699,2633,66,69,18,51,154,149,5,507,504,3,298,297,1
"2021","Manchester 030","E02001074",9179,4580,3306,3286,3246,40,20,4,16,211,211,0,608,605,3,474,474,0
"2021","Manchester 031","E02001075",6933,3494,2623,2605,2583,22,18,2,16,191,191,0,409,406,3,216,216,0
"2021","Manchester 032","E02001076",10394,8607,1397,1388,1369,19,9,3,6,59,58,1,199,199,0,132,132,0
"2021","Manchester 033","E02001077",6128,3118,2301,2253,2206,47,48,4,44,98,97,1,368,362,6,243,243,0
"2021","Manchester 034","E02001078",8416,3580,3727,3696,3666,30,31,4,27,175,173,2,487,484,3,447,447,0
"2021","Manchester 035","E02001079",7693,4695,2106,2099,2078,21,7,4,3,151,149,2,444,443,1,297,295,2
"2021","Manchester 036","E02001080",8795,6712,1435,1432,1418,14,3,2,1,116,115,1,309,309,0,223,222,1
"2021","Manchester 037","E02001081",5135,2509,1936,1897,1845,52,39,8,31,90,89,1,382,379,3,218,217,1
"2021","Manchester 038","E02001082",5889,3860,1524,1506,1484,22,18,4,14,79,75,4,265,264,1,161,161,0
"2021","Manchester 039","E02001083",7149,4800,1685,1672,1638,34,13,4,9,100,100,0,417,412,5,147,147,0
"2021","Manchester 040","E02001084",7238,4235,2239,2190,2172,18,49,4,45,111,111,0,373,373,0,280,280,0
"2021","Manchester 041","E02001085",6616,3226,2319,2313,2292,21,6,4,2,204,202,2,535,534,1,332,332,0
"2021","Manchester 042","E02001086",5630,3043,1704,1692,1659,33,12,2,10,140,136,4,438,437,1,305,304,1
"2021","Manchester 043","E02001087",7767,3617,3188,3153,3120,33,35,14,21,104,103,1,510,505,5,348,347,1
"2021","Manchester 044","E02001088",6945,3370,2364,2353,2335,18,11,7,4,190,190,0,649,647,2,372,369,3
"2021","Manchester 045","E02001089",6509,2630,3035,3017,2986,31,18,4,14,95,95,0,413,412,1,336,336,0
"2021","Manchester 046","E02001090",5804,2533,2285,2276,2246,30,9,1,8,130,127,3,521,521,0,335,334,1
"2021","Manchester 047","E02001091",6789,2977,2490,2480,2460,20,10,4,6,147,147,0,769,765,4,406,406,0
"2021","Manchester 048","E02001092",7063,3440,2497,2492,2452,40,5,2,3,198,196,2,599,597,2,329,328,1
"2021","Manchester 049","E02001093",7356,3768,2273,2266,2254,12,7,4,3,269,266,3,669,669,0,377,377,0
"2021","Manchester 050","E02001094",7154,3796,2052,2038,2026,12,14,8,6,257,255,2,723,720,3,326,325,1
"2021","Manchester 051","E02001095",6992,3548,2126,2099,2082,17,27,12,15,196,194,2,735,732,3,387,386,1
"2021","Manchester 052","E02001096",6397,3065,2220,2216,2194,22,4,0,4,152,151,1,622,620,2,338,335,3
"2021","Manchester 053","E02001097",6628,3419,1975,1961,1942,19,14,10,4,189,189,0,696,694,2,349,349,0
"2021","Manchester 054","E02006902",7325,5691,1131,1077,1032,45,54,13,41,121,119,2,299,295,4,83,82,1
"2021","Manchester 055","E02006912",9981,8422,1022,964,885,79,58,8,50,117,110,7,291,283,8,129,128,1
"2021","Manchester 056","E02006913",6277,3663,2076,2058,2041,17,18,4,14,104,103,1,271,268,3,163,162,1
"2021","Manchester 057","E02006914",7569,6845,509,491,458,33,18,0,18,45,42,3,146,139,7,24,24,0
"2021","Manchester 058","E02006915",6935,3511,2533,2509,2484,25,24,4,20,221,216,5,442,439,3,228,227,1
"2021","Manchester 059","E02006916",6291,4935,876,860,815,45,16,8,8,131,129,2,253,247,6,96,93,3
"2021","Manchester 060","E02006917",6262,5109,868,842,808,34,26,6,20,51,50,1,197,188,9,37,37,0
"2021","Manchester 061","E02006983",5831,3808,1328,1306,1259,47,22,4,18,162,159,3,361,355,6,172,171,1
"2021","Manchester 062","E02006984",5108,3844,865,849,816,33,16,2,14,77,75,2,239,236,3,83,83,0
"2021","Manchester 063","E02006985",6474,2457,3412,3398,3379,19,14,10,4,149,148,1,273,273,0,183,183,0
"2021","Manchester 064","E02006986",4568,2024,1981,1976,1960,16,5,0,5,120,120,0,295,294,1,148,148,0
"2021","Oldham 001","E02001098",4975,1591,2351,2347,2345,2,4,2,2,97,97,0,473,472,1,463,463,0
"2021","Oldham 002","E02001099",4663,1840,1807,1804,1793,11,3,0,3,127,127,0,554,554,0,335,335,0
"2021","Oldham 003","E02001100",4999,1648,2357,2347,2334,13,10,4,6,103,103,0,456,452,4,435,435,0
"2021","Oldham 004","E02001101",4703,1467,2348,2343,2339,4,5,2,3,104,104,0,430,430,0,354,354,0
"2021","Oldham 005","E02001102",4862,1780,2217,2207,2191,16,10,4,6,137,137,0,452,451,1,276,274,2
"2021","Oldham 006","E02001103",4650,1244,2526,2518,2498,20,8,0,8,86,85,1,414,414,0,380,380,0
"2021","Oldham 007","E02001104",5681,2269,2542,2534,2521,13,8,6,2,134,134,0,479,478,1,257,257,0
"2021","Oldham 008","E02001105",4952,1757,2150,2146,2138,8,4,2,2,106,106,0,509,509,0,430,430,0
"2021","Oldham 009","E02001106",4994,1924,1960,1958,1943,15,2,0,2,128,128,0,553,553,0,429,429,0
"2021","Oldham 010","E02001107",5227,1828,2578,2575,2564,11,3,2,1,126,126,0,386,385,1,309,309,0
"2021","Oldham 011","E02001108",4336,2181,1341,1334,1324,10,7,6,1,142,141,1,435,433,2,237,237,0
"2021","Oldham 012","E02001109",6072,2625,2264,2255,2243,12,9,6,3,174,173,1,642,642,0,367,367,0
"2021","Oldham 013","E02001110",5439,1515,2863,2850,2836,14,13,4,9,112,109,3,553,553,0,396,395,1
"2021","Oldham 014","E02001111",6370,3003,2187,2172,2161,11,15,8,7,275,274,1,579,579,0,326,326,0
"2021","Oldham 015","E02001112",5005,1535,2720,2710,2703,7,10,2,8,86,86,0,371,371,0,293,293,0
"2021","Oldham 016","E02001113",6713,2614,3302,3292,3274,18,10,4,6,161,161,0,276,275,1,360,360,0
"2021","Oldham 017","E02001114",6902,2638,2999,2991,2983,8,8,4,4,178,178,0,598,598,0,489,489,0
"2021","Oldham 018","E02001115",4854,1889,1973,1970,1965,5,3,0,3,117,117,0,530,526,4,345,345,0
"2021","Oldham 019","E02001116",5456,1796,2944,2940,2927,13,4,4,0,158,158,0,321,321,0,237,237,0
"2021","Oldham 020","E02001117",5012,1428,2685,2681,2668,13,4,0,4,83,82,1,433,432,1,383,383,0
"2021","Oldham 021","E02001118",5056,1557,2582,2582,2571,11,0,0,0,92,91,1,447,447,0,378,376,2
"2021","Oldham 022","E02001119",8656,2843,4763,4759,4747,12,4,4,0,334,333,1,319,319,0,397,396,1
"2021","Oldham 024","E02001121",6031,2309,2980,2971,2959,12,9,2,7,185,185,0,322,322,0,235,235,0
"2021","Oldham 026","E02001123",5196,2251,1960,1950,1934,16,10,2,8,183,183,0,513,513,0,289,289,0
"2021","Oldham 027","E02001124",5266,2484,1848,1846,1836,10,2,2,0,166,165,1,508,508,0,260,260,0
"2021","Oldham 028","E02001125",6359,2626,2618,2610,2597,13,8,2,6,143,140,3,521,520,1,451,451,0
"2021","Oldham 029","E02001126",6646,2930,2566,2545,2530,15,21,10,11,202,201,1,615,614,1,333,333,0
"2021","Oldham 030","E02001127",5755,2649,2140,2128,2117,11,12,8,4,173,171,2,486,486,0,307,305,2
"2021","Oldham 031","E02001128",5985,2594,2247,2243,2234,9,4,4,0,173,173,0,560,559,1,411,410,1
"2021","Oldham 032","E02001129",5439,2621,1713,1701,1681,20,12,4,8,157,156,1,546,546,0,402,402,0
"2021","Oldham 033","E02001130",4909,1751,2239,2234,2223,11,5,0,5,96,96,0,440,440,0,383,383,0
"2021","Oldham 034","E02001131",4417,1760,1899,1896,1886,10,3,2,1,79,77,2,306,306,0,373,373,0
"2021","Oldham 036","E02007000",5309,1900,2692,2682,2671,11,10,8,2,157,157,0,328,328,0,232,232,0
"2021","Oldham 037","E02007001",6154,2102,3335,3334,3318,16,1,0,1,146,146,0,276,276,0,295,295,0
"2021","Rochdale 001","E02001132",5459,2105,2152,2149,2135,14,3,2,1,175,175,0,644,643,1,383,383,0
"2021","Rochdale 002","E02001133",5282,1797,2577,2575,2561,14,2,2,0,107,106,1,497,494,3,304,304,0
"2021","Rochdale 003","E02001134",5258,1554,2770,2764,2747,17,6,2,4,124,122,2,451,451,0,359,359,0
"2021","Rochdale 004","E02001135",6116,2505,2413,2406,2392,14,7,4,3,217,217,0,624,621,3,357,357,0
"2021","Rochdale 005","E02001136",7728,2889,3493,3483,3467,16,10,4,6,176,176,0,689,685,4,481,478,3
"2021","Rochdale 006","E02001137",5183,1610,2697,2686,2669,17,11,0,11,120,119,1,478,478,0,278,278,0
"2021","Rochdale 007","E02001138",7213,1984,3903,3893,3875,18,10,2,8,132,131,1,633,630,3,561,561,0
"2021","Rochdale 008","E02001139",7519,2830,3639,3633,3628,5,6,4,2,226,225,1,462,462,0,362,362,0
"2021","Rochdale 009","E02001140",6099,2471,2566,2565,2555,10,1,0,1,168,167,1,561,560,1,333,333,0
"2021","Rochdale 010","E02001141",8997,3664,3719,3700,3685,15,19,12,7,310,307,3,818,818,0,486,486,0
"2021","Rochdale 011","E02001142",5043,1310,2838,2832,2827,5,6,4,2,88,88,0,383,383,0,424,424,0
"2021","Rochdale 012","E02001143",8499,3501,3599,3583,3570,13,16,4,12,252,251,1,716,715,1,431,430,1
"2021","Rochdale 013","E02001144",5206,1996,2208,2202,2193,9,6,6,0,146,144,2,529,529,0,327,327,0
"2021","Rochdale 014","E02001145",5778,1976,2657,2650,2640,10,7,3,4,143,143,0,611,611,0,391,389,2
"2021","Rochdale 015","E02001146",7557,2746,3716,3711,3698,13,5,2,3,204,204,0,478,478,0,413,413,0
"2021","Rochdale 016","E02001147",7799,3327,3074,3054,3027,27,20,10,10,242,242,0,713,709,4,443,443,0
"2021","Rochdale 017","E02001148",8337,3196,3474,3464,3449,15,10,4,6,216,215,1,829,823,6,622,622,0
"2021","Rochdale 018","E02001149",8150,3612,2707,2699,2680,19,8,0,8,300,300,0,981,980,1,550,550,0
"2021","Rochdale 019","E02001150",6888,2895,2633,2631,2602,29,2,0,2,208,204,4,695,694,1,457,457,0
"2021","Rochdale 020","E02001151",8078,3046,3617,3608,3591,17,9,6,3,196,196,0,737,735,2,482,481,1
"2021","Rochdale 021","E02001152",7679,3373,2941,2936,2918,18,5,1,4,216,213,3,718,714,4,431,431,0
"2021","Rochdale 022","E02001153",9079,4258,3041,3014,2999,15,27,14,13,313,311,2,918,918,0,549,549,0
"2021","Rochdale 023","E02001154",8075,3557,2971,2964,2953,11,7,2,5,250,248,2,810,808,2,487,487,0
"2021","Rochdale 024","E02001155",5884,2515,2047,2036,2024,12,11,2,9,214,213,1,669,668,1,439,439,0
"2021","Rochdale 025","E02001156",8036,2676,4063,4050,4029,21,13,2,11,140,140,0,588,586,2,569,569,0
"2021","Salford 001","E02001157",6345,3303,1770,1755,1730,25,15,12,3,237,234,3,681,678,3,354,354,0
"2021","Salford 002","E02001158",4744,2255,1551,1541,1532,9,10,5,5,119,118,1,514,514,0,305,305,0
"2021","Salford 003","E02001159",5842,2790,2031,2013,1981,32,18,9,9,181,181,0,564,561,3,276,276,0
"2021","Salford 004","E02001160",5373,2387,2079,2066,2042,24,13,4,9,124,123,1,492,488,4,291,291,0
"2021","Salford 005","E02001161",4866,1985,2040,2029,2018,11,11,8,3,94,93,1,455,453,2,292,291,1
"2021","Salford 006","E02001162",4844,2049,1823,1823,1812,11,0,0,0,121,121,0,492,491,1,359,358,1
"2021","Salford 007","E02001163",8150,3337,3463,3450,3420,30,13,2,11,141,138,3,712,708,4,497,496,1
"2021","Salford 008","E02001164",6032,3301,1828,1817,1793,24,11,2,9,199,199,0,477,476,1,227,227,0
"2021","Salford 009","E02001165",4962,2226,1867,1861,1834,27,6,0,6,90,90,0,464,463,1,315,315,0
"2021","Salford 010","E02001166",5400,1838,2991,2978,2942,36,13,0,13,70,68,2,277,277,0,224,224,0
"2021","Salford 011","E02001167",5341,2342,2201,2183,2165,18,18,8,10,126,125,1,405,402,3,267,267,0
"2021","Salford 012","E02001168",7853,3404,3021,3009,2988,21,12,4,8,192,191,1,718,715,3,518,518,0
"2021","Salford 013","E02001169",8920,2770,4791,4780,4756,24,11,2,9,126,126,0,703,703,0,530,530,0
"2021","Salford 014","E02001170",7971,2301,4324,4313,4278,35,11,6,5,125,124,1,624,623,1,597,596,1
"2021","Salford 015","E02001171",5073,1895,2390,2386,2368,18,4,2,2,97,95,2,362,361,1,329,329,0
"2021","Salford 017","E02001173",7666,5042,1626,1607,1575,32,19,4,15,216,215,1,505,505,0,277,277,0
"2021","Salford 018","E02001174",4853,2311,1789,1778,1758,20,11,6,5,101,101,0,348,343,5,304,304,0
"2021","Salford 019","E02001175",5937,2880,2065,2053,2035,18,12,3,9,149,149,0,515,515,0,328,327,1
"2021","Salford 020","E02001176",9864,4304,3646,3621,3568,53,25,10,15,223,219,4,977,969,8,714,713,1
"2021","Salford 021","E02001177",10876,5721,3390,3372,3331,41,18,4,14,285,282,3,904,899,5,576,576,0
"2021","Salford 023","E02001179",5882,3499,1515,1500,1475,25,15,2,13,150,149,1,405,405,0,313,313,0
"2021","Salford 024","E02001180",4643,2743,1096,1091,1076,15,5,2,3,144,143,1,459,457,2,201,199,2
"2021","Salford 025","E02001181",4679,2325,1425,1414,1400,14,11,7,4,148,148,0,540,540,0,241,241,0
"2021","Salford 026","E02001182",5806,3001,1746,1737,1705,32,9,2,7,168,167,1,590,588,2,301,301,0
"2021","Salford 027","E02001183",5888,3190,1752,1742,1733,9,10,4,6,180,178,2,512,510,2,254,253,1
"2021","Salford 029","E02001185",7761,3039,3179,3171,3159,12,8,0,8,191,191,0,768,768,0,584,583,1
"2021","Salford 030","E02001186",8265,3549,3219,3215,3196,19,4,2,2,178,175,3,845,845,0,474,474,0
"2021","Salford 031","E02006957",5058,2214,2186,2182,2178,4,4,0,4,128,127,1,363,361,2,167,167,0
"2021","Salford 032","E02006958",6136,3529,1806,1800,1764,36,6,0,6,153,147,6,371,371,0,277,276,1
"2021","Salford 033","E02006959",7590,6171,998,975,936,39,23,4,19,104,98,6,254,247,7,63,58,5
"2021","Salford 034","E02006960",8400,6525,1276,1257,1221,36,19,10,9,140,135,5,336,329,7,123,123,0
"2021","Salford 035","E02006961",5558,3762,1143,1131,1109,22,12,4,8,159,153,6,332,331,1,162,161,1
"2021","Salford 036","E02006962",4648,3636,722,709,696,13,13,3,10,58,57,1,162,162,0,70,69,1
"2021","Salford 037","E02006963",5695,4050,1317,1297,1243,54,20,8,12,62,58,4,221,219,2,45,44,1
"2021","Stockport 001","E02001187",5704,2425,2248,2230,2218,12,18,8,10,120,120,0,517,515,2,394,392,2
"2021","Stockport 002","E02001188",6821,3573,2136,2132,2122,10,4,0,4,187,187,0,628,626,2,297,297,0
"2021","Stockport 003","E02001189",6806,2693,2974,2966,2948,18,8,6,2,152,152,0,573,571,2,414,414,0
"2021","Stockport 004","E02001190",5971,3399,1522,1507,1497,10,15,4,11,160,159,1,529,528,1,361,361,0
"2021","Stockport 005","E02001191",4867,1612,2347,2336,2326,10,11,2,9,91,90,1,457,457,0,360,360,0
"2021","Stockport 006","E02001192",5445,2048,2506,2488,2463,25,18,2,16,114,114,0,383,380,3,394,394,0
"2021","Stockport 007","E02001193",5262,2607,1718,1711,1685,26,7,4,3,108,108,0,574,573,1,255,255,0
"2021","Stockport 008","E02001194",5112,1619,2691,2675,2650,25,16,3,13,79,79,0,389,389,0,334,332,2
"2021","Stockport 009","E02001195",6178,2353,2639,2631,2611,20,8,4,4,139,139,0,585,583,2,462,462,0
"2021","Stockport 010","E02001196",6510,2095,3159,3152,3146,6,7,3,4,134,134,0,580,579,1,542,542,0
"2021","Stockport 011","E02001197",5000,1720,2494,2489,2464,25,5,0,5,85,85,0,449,446,3,252,252,0
"2021","Stockport 012","E02001198",6098,2281,2481,2465,2448,17,16,7,9,138,136,2,604,601,3,594,593,1
"2021","Stockport 013","E02001199",6459,2201,3220,3202,3176,26,18,4,14,135,134,1,522,519,3,381,379,2
"2021","Stockport 014","E02001200",6345,3412,1596,1573,1555,18,23,8,15,194,192,2,828,828,0,315,315,0
"2021","Stockport 015","E02001201",4642,1918,1927,1913,1902,11,14,8,6,94,94,0,428,425,3,275,275,0
"2021","Stockport 016","E02001202",5300,2843,1522,1509,1476,33,13,2,11,149,149,0,559,555,4,227,227,0
"2021","Stockport 017","E02001203",4841,1065,3050,3039,3019,20,11,2,9,59,59,0,353,353,0,314,314,0
"2021","Stockport 018","E02001204",7157,3021,2988,2971,2940,31,17,4,13,142,142,0,614,610,4,392,390,2
"2021","Stockport 019","E02001205",6900,3189,2519,2513,2489,24,6,4,2,165,162,3,718,716,2,309,306,3
"2021","Stockport 020","E02001206",5923,1795,2992,2989,2983,6,3,1,2,122,122,0,526,526,0,488,488,0
"2021","Stockport 021","E02001207",5661,1753,2901,2893,2888,5,8,2,6,114,114,0,502,502,0,391,391,0
"2021","Stockport 022","E02001208",6205,2603,2462,2452,2418,34,10,0,10,125,124,1,599,597,2,416,416,0
"2021","Stockport 023","E02001209",6228,2758,2383,2365,2339,26,18,6,12,152,152,0,623,620,3,312,311,1
"2021","Stockport 024","E02001210",5822,2342,2273,2264,2254,10,9,3,6,146,146,0,659,657,2,402,402,0
"2021","Stockport 025","E02001211",5267,1472,2950,2945,2928,17,5,2,3,100,100,0,382,382,0,363,363,0
"2021","Stockport 026","E02001212",5196,2497,1820,1813,1792,21,7,1,6,151,151,0,477,477,0,251,251,0
"2021","Stockport 027","E02001213",8041,2833,3704,3686,3660,26,18,5,13,161,160,1,818,816,2,525,524,1
"2021","Stockport 028","E02001214",6503,1919,3502,3498,3493,5,4,2,2,121,119,2,455,452,3,506,505,1
"2021","Stockport 029","E02001215",4964,1410,2574,2565,2559,6,9,4,5,91,91,0,463,463,0,426,426,0
"2021","Stockport 030","E02001216",6355,1859,3438,3432,3409,23,6,4,2,99,99,0,443,441,2,516,515,1
"2021","Stockport 031","E02001217",5526,2123,2211,2202,2188,14,9,4,5,129,129,0,620,619,1,443,443,0
"2021","Stockport 032","E02001218",4870,1254,2852,2847,2834,13,5,4,1,78,77,1,347,347,0,339,339,0
"2021","Stockport 033","E02001219",4406,1203,2454,2450,2442,8,4,0,4,53,53,0,354,354,0,342,342,0
"2021","Stockport 034","E02001220",4527,1298,2418,2416,2396,20,2,0,2,100,100,0,430,428,2,281,281,0
"2021","Stockport 035","E02001221",4886,1303,2838,2834,2827,7,4,0,4,64,64,0,310,310,0,371,370,1
"2021","Stockport 036","E02001222",5253,1490,2957,2953,2949,4,4,0,4,54,54,0,334,334,0,418,418,0
"2021","Stockport 037","E02001223",5510,1307,3217,3211,3203,8,6,2,4,68,68,0,457,456,1,461,457,4
"2021","Stockport 038","E02001224",5035,1154,2957,2950,2932,18,7,2,5,61,60,1,385,385,0,478,478,0
"2021","Stockport 039","E02001225",5916,1644,3260,3252,3242,10,8,1,7,100,99,1,481,477,4,431,431,0
"2021","Stockport 040","E02001226",5690,1835,2909,2898,2882,16,11,6,5,114,114,0,428,427,1,404,403,1
"2021","Stockport 041","E02001227",4596,940,2884,2882,2877,5,2,2,0,48,48,0,306,305,1,418,418,0
"2021","Stockport 042","E02001228",5140,1197,3149,3149,3129,20,0,0,0,55,55,0,304,304,0,435,435,0
"2021","Tameside 001","E02001229",8413,3316,3481,3467,3433,34,14,7,7,186,180,6,925,924,1,505,504,1
"2021","Tameside 002","E02001230",4888,1445,2672,2670,2637,33,2,0,2,94,94,0,329,329,0,348,348,0
"2021","Tameside 003","E02001231",5575,2065,2591,2587,2565,22,4,2,2,125,125,0,487,487,0,307,305,2
"2021","Tameside 004","E02001232",6753,2797,2716,2710,2695,15,6,0,6,166,166,0,641,640,1,433,432,1
"2021","Tameside 005","E02001233",6341,2340,2625,2622,2607,15,3,0,3,190,189,1,652,652,0,534,534,0
"2021","Tameside 006","E02001234",6109,2665,2301,2285,2263,22,16,6,10,164,163,1,583,582,1,396,396,0
"2021","Tameside 007","E02001235",5749,2355,2393,2378,2348,30,15,2,13,144,139,5,554,551,3,303,303,0
"2021","Tameside 008","E02001236",4678,2139,1532,1516,1496,20,16,2,14,185,179,6,480,480,0,342,341,1
"2021","Tameside 009","E02001237",5720,2344,2263,2255,2238,17,8,6,2,160,159,1,639,637,2,314,314,0
"2021","Tameside 010","E02001238",6551,2606,2697,2691,2677,14,6,4,2,153,152,1,621,618,3,474,472,2
"2021","Tameside 011","E02001239",7597,3325,2916,2904,2858,46,12,4,8,203,199,4,679,672,7,474,473,1
"2021","Tameside 012","E02001240",5189,2185,2106,2102,2086,16,4,2,2,132,127,5,463,463,0,303,302,1
"2021","Tameside 013","E02001241",8443,3832,3035,3022,3001,21,13,6,7,300,300,0,819,804,15,457,455,2
"2021","Tameside 014","E02001242",5708,2053,2714,2709,2695,14,5,2,3,100,100,0,418,417,1,423,421,2
"2021","Tameside 015","E02001243",6937,2472,3161,3155,3133,22,6,4,2,188,175,13,706,703,3,410,410,0
"2021","Tameside 016","E02001244",4486,1466,2179,2176,2166,10,3,0,3,101,94,7,387,386,1,353,353,0
"2021","Tameside 017","E02001245",6488,2815,2418,2413,2394,19,5,2,3,184,183,1,685,683,2,386,386,0
"2021","Tameside 018","E02001246",5967,2465,2221,2214,2201,13,7,0,7,160,153,7,648,646,2,473,473,0
"2021","Tameside 019","E02001247",5985,2561,2236,2229,2217,12,7,3,4,153,149,4,671,669,2,364,364,0
"2021","Tameside 020","E02001248",9328,4231,3276,3256,3218,38,20,2,18,320,316,4,993,993,0,508,508,0
"2021","Tameside 021","E02001249",5183,2236,1943,1935,1919,16,8,2,6,134,133,1,544,542,2,326,326,0
"2021","Tameside 022","E02001250",5427,1808,2649,2637,2615,22,12,4,8,89,89,0,517,517,0,364,364,0
"2021","Tameside 023","E02001251",5120,1863,2266,2258,2237,21,8,0,8,133,131,2,498,496,2,360,360,0
"2021","Tameside 024","E02001252",6301,2152,2979,2970,2945,25,9,6,3,122,121,1,516,513,3,532,532,0
"2021","Tameside 025","E02001253",4143,1600,1749,1744,1736,8,5,0,5,100,100,0,423,422,1,271,271,0
"2021","Tameside 026","E02001254",4611,1849,1789,1777,1768,9,12,6,6,131,129,2,478,478,0,364,364,0
"2021","Tameside 027","E02001255",5669,2825,1748,1741,1720,21,7,2,5,185,182,3,577,576,1,334,334,0
"2021","Tameside 028","E02001256",8152,3384,3241,3236,3214,22,5,2,3,235,231,4,717,716,1,575,569,6
"2021","Tameside 029","E02001257",7479,2901,2791,2781,2764,17,10,0,10,239,238,1,803,803,0,745,744,1
"2021","Tameside 030","E02001258",6152,2032,2940,2936,2916,20,4,0,4,124,122,2,575,574,1,481,481,0
"2021","Trafford 001","E02001259",9222,4993,2996,2989,2939,50,7,1,6,258,254,4,616,611,5,359,359,0
"2021","Trafford 002","E02001260",6154,2000,3178,3164,3152,12,14,6,8,94,93,1,514,513,1,368,368,0
"2021","Trafford 003","E02001261",6918,3460,2478,2467,2449,18,11,4,7,167,165,2,526,518,8,287,287,0
"2021","Trafford 004","E02001262",6861,2913,3004,2978,2942,36,26,6,20,136,136,0,442,441,1,366,365,1
"2021","Trafford 005","E02001263",6859,1988,3733,3720,3709,11,13,2,11,96,95,1,519,519,0,523,523,0
"2021","Trafford 006","E02001264",6736,2555,3190,3184,3154,30,6,2,4,114,113,1,512,510,2,365,364,1
"2021","Trafford 007","E02001265",6636,2313,3076,3066,3048,18,10,2,8,136,136,0,676,676,0,435,435,0
"2021","Trafford 008","E02001266",5578,2273,2271,2265,2248,17,6,2,4,151,151,0,567,565,2,316,313,3
"2021","Trafford 009","E02001267",6050,2291,2491,2481,2458,23,10,0,10,137,135,2,638,633,5,493,493,0
"2021","Trafford 010","E02001268",5817,1746,3096,3087,3068,19,9,2,7,84,84,0,454,454,0,437,437,0
"2021","Trafford 011","E02001269",6713,2918,2666,2652,2612,40,14,0,14,167,165,2,550,549,1,412,411,1
"2021","Trafford 012","E02001270",6722,2437,3141,3132,3122,10,9,4,5,132,131,1,583,581,2,429,427,2
"2021","Trafford 013","E02001271",5218,1887,2323,2313,2296,17,10,2,8,126,126,0,535,533,2,347,346,1
"2021","Trafford 014","E02001272",6367,1948,3355,3342,3312,30,13,8,5,141,140,1,508,508,0,415,415,0
"2021","Trafford 015","E02001273",7602,2635,3666,3649,3632,17,17,1,16,151,151,0,718,716,2,432,431,1
"2021","Trafford 016","E02001274",6541,1624,3948,3937,3920,17,11,0,11,84,83,1,386,384,2,499,498,1
"2021","Trafford 017","E02001275",6214,2813,2109,2104,2087,17,5,2,3,182,182,0,650,649,1,460,460,0
"2021","Trafford 018","E02001276",6241,2338,2796,2782,2764,18,14,10,4,141,141,0,575,570,5,391,391,0
"2021","Trafford 019","E02001277",7083,2985,2882,2874,2857,17,8,2,6,182,182,0,721,718,3,313,310,3
"2021","Trafford 020","E02001278",6757,1904,3933,3925,3907,18,8,5,3,88,88,0,450,449,1,382,379,3
"2021","Trafford 021","E02001279",6536,1672,4038,4024,4014,10,14,2,12,73,73,0,397,395,2,356,355,1
"2021","Trafford 022","E02001280",6609,2374,2888,2879,2872,7,9,6,3,143,143,0,697,697,0,507,507,0
"2021","Trafford 023","E02001281",6177,1523,3690,3672,3660,12,18,10,8,72,70,2,443,442,1,449,449,0
"2021","Trafford 024","E02001282",7827,2925,3685,3674,3639,35,11,9,2,123,121,2,699,699,0,395,395,0
"2021","Trafford 025","E02001283",7666,2414,4000,3981,3964,17,19,4,15,156,155,1,628,626,2,468,468,0
"2021","Trafford 026","E02001284",6268,1692,3712,3705,3666,39,7,4,3,96,94,2,458,456,2,310,310,0
"2021","Trafford 027","E02001285",6314,1783,3424,3415,3406,9,9,3,6,103,103,0,543,541,2,461,460,1
"2021","Trafford 028","E02001286",6468,1511,3990,3980,3977,3,10,2,8,86,85,1,374,373,1,507,506,1
"2021","Wigan 001","E02001287",5435,1823,2733,2727,2704,23,6,0,6,82,82,0,486,483,3,311,311,0
"2021","Wigan 002","E02001288",6958,2165,3582,3569,3551,18,13,4,9,130,130,0,597,597,0,484,484,0
"2021","Wigan 003","E02001289",8492,2312,4581,4577,4556,21,4,2,2,144,144,0,783,783,0,672,672,0
"2021","Wigan 004","E02001290",5142,1623,2539,2518,2510,8,21,10,11,95,95,0,468,467,1,417,417,0
"2021","Wigan 005","E02001291",6330,2442,2726,2720,2703,17,6,0,6,157,157,0,596,596,0,409,408,1
"2021","Wigan 006","E02001292",6764,2247,3287,3278,3264,14,9,4,5,145,145,0,597,596,1,488,488,0
"2021","Wigan 007","E02001293",5221,1730,2584,2565,2555,10,19,10,9,88,87,1,435,433,2,384,384,0
"2021","Wigan 008","E02001294",6670,2905,2549,2541,2524,17,8,6,2,175,173,2,631,628,3,410,410,0
"2021","Wigan 009","E02001295",5940,2682,1821,1803,1781,22,18,10,8,193,188,5,830,828,2,414,414,0
"2021","Wigan 010","E02001296",6643,3357,1929,1918,1908,10,11,5,6,193,190,3,740,739,1,424,424,0
"2021","Wigan 011","E02001297",5420,2101,2244,2236,2226,10,8,0,8,133,132,1,552,551,1,390,390,0
"2021","Wigan 012","E02001298",6340,2867,2231,2224,2213,11,7,4,3,175,173,2,677,674,3,390,390,0
"2021","Wigan 013","E02001299",7213,2747,3080,3061,3044,17,19,10,9,177,175,2,690,689,1,519,519,0
"2021","Wigan 014","E02001300",6473,2608,2518,2507,2492,15,11,10,1,170,168,2,665,665,0,512,511,1
"2021","Wigan 015","E02001301",7258,3261,2474,2468,2448,20,6,4,2,201,196,5,834,834,0,488,488,0
"2021","Wigan 016","E02001302",6403,2434,2650,2646,2641,5,4,2,2,139,139,0,622,619,3,558,558,0
"2021","Wigan 017","E02001303",6989,3181,2448,2436,2407,29,12,2,10,230,228,2,749,744,5,381,380,1
"2021","Wigan 018","E02001304",10563,3166,5448,5431,5411,20,17,6,11,207,207,0,946,946,0,796,795,1
"2021","Wigan 019","E02001305",7093,2309,3576,3566,3541,25,10,4,6,102,100,2,597,597,0,509,508,1
"2021","Wigan 020","E02001306",6000,1889,3073,3063,3056,7,10,0,10,98,98,0,544,544,0,396,396,0
"2021","Wigan 021","E02001307",9497,2722,5381,5375,5363,12,6,2,4,144,142,2,727,726,1,523,523,0
"2021","Wigan 022","E02001308",4996,1757,2198,2196,2192,4,2,0,2,110,110,0,543,543,0,388,388,0
"2021","Wigan 023","E02001309",6888,2681,2740,2734,2718,16,6,4,2,180,180,0,787,784,3,500,500,0
"2021","Wigan 024","E02001310",7257,3094,2822,2806,2791,15,16,6,10,167,166,1,725,723,2,449,448,1
"2021","Wigan 025","E02001311",6728,2615,2803,2793,2783,10,10,6,4,165,165,0,738,737,1,407,406,1
"2021","Wigan 026","E02001312",7005,3081,2767,2760,2739,21,7,0,7,178,177,1,626,625,1,353,353,0
"2021","Wigan 027","E02001313",6472,2594,2533,2522,2502,20,11,3,8,182,178,4,702,701,1,461,461,0
"2021","Wigan 028","E02001314",6334,2062,3264,3260,3248,12,4,4,0,115,115,0,557,555,2,336,335,1
"2021","Wigan 029","E02001315",7680,2738,3676,3668,3636,32,8,4,4,134,134,0,679,677,2,453,451,2
"2021","Wigan 030","E02001316",5933,2871,1834,1824,1809,15,10,4,6,219,217,2,695,694,1,314,313,1
"2021","Wigan 031","E02001317",7387,2872,3130,3124,3112,12,6,1,5,194,193,1,667,667,0,524,523,1
"2021","Wigan 032","E02001318",6496,2309,2905,2895,2887,8,10,6,4,142,138,4,623,622,1,517,517,0
"2021","Wigan 033","E02001319",6734,2951,2372,2356,2342,14,16,10,6,181,180,1,762,760,2,468,468,0
"2021","Wigan 034","E02001320",6091,2394,2415,2410,2396,14,5,2,3,148,147,1,677,675,2,457,457,0
"2021","Wigan 035","E02001321",6587,2111,3260,3256,3230,26,4,2,2,152,152,0,583,583,0,481,480,1
"2021","Wigan 036","E02001322",6086,1936,2881,2876,2872,4,5,0,5,140,140,0,604,604,0,525,525,0
"2021","Wigan 037","E02001323",6343,2131,2941,2930,2918,12,11,8,3,143,141,2,663,659,4,465,464,1
"2021","Wigan 038","E02001324",6669,2647,2690,2674,2655,19,16,6,10,161,161,0,696,693,3,475,475,0
"2021","Wigan 039","E02001325",7463,2421,3743,3735,3717,18,8,2,6,146,146,0,659,658,1,494,493,1
"2021","Wigan 040","E02001326",6701,2235,3288,3284,3262,22,4,2,2,119,119,0,595,593,2,464,461,3
"2021","Knowsley 001","E02001327",6958,3709,2170,2164,2141,23,6,2,4,235,234,1,501,501,0,343,342,1
"2021","Knowsley 002","E02001328",8552,3633,3560,3552,3537,15,8,2,6,195,192,3,634,632,2,530,529,1
"2021","Knowsley 003","E02001329",5977,3131,1774,1763,1750,13,11,2,9,184,184,0,515,513,2,373,373,0
"2021","Knowsley 004","E02001330",7238,3667,2303,2293,2276,17,10,3,7,222,221,1,596,594,2,450,450,0
"2021","Knowsley 005","E02001331",8127,4075,2667,2660,2653,7,7,0,7,202,202,0,651,649,2,532,531,1
"2021","Knowsley 006","E02001332",5943,2958,1825,1815,1799,16,10,0,10,184,183,1,569,568,1,407,407,0
"2021","Knowsley 007","E02001333",7678,3622,2551,2540,2518,22,11,0,11,227,227,0,778,777,1,500,500,0
"2021","Knowsley 008","E02001334",5066,2781,1383,1378,1362,16,5,3,2,166,166,0,434,434,0,302,301,1
"2021","Knowsley 009","E02001335",6743,2609,3113,3107,3097,10,6,0,6,136,136,0,512,512,0,373,373,0
"2021","Knowsley 010","E02001336",5424,2876,1517,1514,1504,10,3,2,1,166,165,1,488,488,0,377,376,1
"2021","Knowsley 011","E02001337",4747,2064,1845,1843,1835,8,2,0,2,99,99,0,370,369,1,369,368,1
"2021","Knowsley 012","E02001338",4899,2315,1686,1676,1663,13,10,8,2,142,141,1,421,421,0,335,335,0
"2021","Knowsley 013","E02001339",5074,2304,1804,1799,1779,20,5,1,4,143,143,0,463,463,0,360,360,0
"2021","Knowsley 014","E02001340",7963,3031,3773,3756,3741,15,17,10,7,136,136,0,511,511,0,512,511,1
"2021","Knowsley 015","E02001341",6012,3018,1889,1881,1871,10,8,0,8,176,176,0,531,528,3,398,398,0
"2021","Knowsley 016","E02001342",6661,2203,3400,3384,3373,11,16,10,6,91,89,2,432,431,1,535,533,2
"2021","Knowsley 017","E02001343",6080,2045,3138,3132,3107,25,6,4,2,104,104,0,421,421,0,372,371,1
"2021","Knowsley 018","E02001344",4618,1991,1739,1736,1723,13,3,2,1,90,89,1,463,460,3,335,335,0
"2021","Knowsley 019","E02001345",4593,1639,2163,2159,2152,7,4,4,0,98,98,0,341,341,0,352,352,0
"2021","Knowsley 020","E02001346",5933,2976,1903,1895,1877,18,8,4,4,159,159,0,498,498,0,397,397,0
"2021","Liverpool 001","E02001347",6465,3092,2276,2268,2252,16,8,6,2,189,189,0,519,518,1,389,389,0
"2021","Liverpool 002","E02001348",5489,2601,1906,1898,1888,10,8,2,6,154,153,1,477,477,0,351,351,0
"2021","Liverpool 003","E02001349",6798,3253,2469,2453,2432,21,16,2,14,136,136,0,556,556,0,384,383,1
"2021","Liverpool 004","E02001350",6344,2943,2185,2169,2164,5,16,12,4,158,157,1,560,560,0,498,498,0
"2021","Liverpool 005","E02001351",7235,3835,2086,2070,2052,18,16,6,10,198,198,0,664,664,0,452,452,0
"2021","Liverpool 006","E02001352",5188,2812,1485,1479,1464,15,6,0,6,149,149,0,446,444,2,296,296,0
"2021","Liverpool 007","E02001353",5964,2323,2746,2737,2729,8,9,0,9,100,100,0,435,433,2,360,360,0
"2021","Liverpool 008","E02001354",6312,3209,2042,2036,2029,7,6,6,0,143,142,1,477,476,1,441,441,0
"2021","Liverpool 009","E02001355",5176,2579,1597,1582,1575,7,15,10,5,155,153,2,477,477,0,368,367,1
"2021","Liverpool 010","E02001356",6548,3412,2136,2123,2111,12,13,6,7,157,155,2,549,548,1,294,294,0
"2021","Liverpool 011","E02001357",5593,2876,1715,1709,1702,7,6,6,0,157,157,0,444,442,2,401,401,0
"2021","Liverpool 012","E02001358",5572,3091,1508,1489,1484,5,19,10,9,140,140,0,493,493,0,340,340,0
"2021","Liverpool 013","E02001359",4636,1814,2108,2108,2103,5,0,0,0,87,86,1,318,318,0,309,309,0
"2021","Liverpool 014","E02001360",7080,3937,1881,1874,1861,13,7,2,5,248,246,2,614,613,1,400,399,1
"2021","Liverpool 015","E02001361",5979,2776,2130,2124,2117,7,6,4,2,156,155,1,502,501,1,415,414,1
"2021","Liverpool 016","E02001362",6245,2705,2385,2371,2361,10,14,4,10,145,143,2,543,543,0,467,465,2
"2021","Liverpool 017","E02001363",6193,3149,1944,1940,1937,3,4,2,2,209,206,3,507,506,1,384,383,1
"2021","Liverpool 018","E02001364",4932,2628,1393,1387,1381,6,6,4,2,150,150,0,441,441,0,320,320,0
"2021","Liverpool 019","E02001365",7384,4033,2118,2109,2092,17,9,4,5,241,239,2,596,595,1,396,396,0
"2021","Liverpool 020","E02001366",7189,3634,2288,2278,2260,18,10,4,6,215,215,0,669,667,2,383,383,0
"2021","Liverpool 021","E02001367",8027,2951,3820,3815,3795,20,5,0,5,134,134,0,555,554,1,567,566,1
"2021","Liverpool 022","E02001368",5867,3362,1498,1485,1473,12,13,2,11,162,162,0,496,494,2,349,349,0
"2021","Liverpool 023","E02001369",6800,4035,1721,1714,1696,18,7,2,5,172,171,1,477,476,1,395,394,1
"2021","Liverpool 024","E02001370",5657,3017,1575,1575,1549,26,0,0,0,163,163,0,567,566,1,335,335,0
"2021","Liverpool 025","E02001371",5981,2991,1937,1925,1909,16,12,6,6,145,140,5,485,485,0,423,423,0
"2021","Liverpool 026","E02001372",5055,2165,1891,1885,1871,14,6,2,4,108,108,0,461,461,0,430,430,0
"2021","Liverpool 027","E02001373",7309,3633,2485,2475,2457,18,10,4,6,188,188,0,640,631,9,363,363,0
"2021","Liverpool 028","E02001374",7112,4157,1913,1902,1884,18,11,4,7,200,199,1,588,586,2,254,253,1
"2021","Liverpool 029","E02001375",5694,2718,1855,1848,1836,12,7,0,7,177,177,0,518,518,0,426,423,3
"2021","Liverpool 030","E02001376",7691,4923,1835,1829,1811,18,6,2,4,204,204,0,419,416,3,310,310,0
"2021","Liverpool 031","E02001377",11363,8997,1520,1520,1503,17,0,0,0,127,125,2,403,403,0,316,316,0
"2021","Liverpool 032","E02001378",6205,2920,2134,2127,2110,17,7,0,7,145,144,1,600,599,1,406,406,0
"2021","Liverpool 034","E02001380",6200,2229,3102,3088,3063,25,14,8,6,98,98,0,397,397,0,374,374,0
"2021","Liverpool 035","E02001381",7887,4596,2244,2228,2203,25,16,6,10,192,191,1,553,552,1,302,300,2
"2021","Liverpool 036","E02001382",5631,1881,2995,2985,2977,8,10,2,8,70,69,1,362,361,1,323,323,0
"2021","Liverpool 037","E02001383",8645,6665,1145,1128,1097,31,17,0,17,136,135,1,476,475,1,223,220,3
"2021","Liverpool 038","E02001384",9749,7629,1371,1362,1343,19,9,1,8,115,112,3,367,363,4,267,267,0
"2021","Liverpool 039","E02001385",6693,3641,2140,2122,2109,13,18,5,13,171,168,3,449,449,0,292,291,1
"2021","Liverpool 040","E02001386",6708,3101,2092,2088,2072,16,4,0,4,201,201,0,739,739,0,575,573,2
"2021","Liverpool 041","E02001387",6520,2334,3282,3277,3251,26,5,0,5,79,79,0,393,393,0,432,431,1
"2021","Liverpool 042","E02001388",7167,4642,1765,1750,1707,43,15,4,11,111,111,0,391,390,1,258,258,0
"2021","Liverpool 043","E02001389",5725,3780,1145,1128,1116,12,17,4,13,154,153,1,493,491,2,153,153,0
"2021","Liverpool 044","E02001390",7692,4295,2081,2065,2036,29,16,4,12,234,231,3,605,604,1,477,477,0
"2021","Liverpool 045","E02001391",4750,2314,1450,1443,1436,7,7,4,3,102,102,0,429,429,0,455,455,0
"2021","Liverpool 046","E02001392",5280,1694,2751,2739,2725,14,12,6,6,64,64,0,354,353,1,417,417,0
"2021","Liverpool 047","E02001393",6308,1997,3597,3582,3566,16,15,2,13,51,51,0,281,281,0,382,382,0
"2021","Liverpool 048","E02001394",7661,4375,2069,2055,2023,32,14,4,10,155,154,1,649,647,2,413,411,2
"2021","Liverpool 049","E02001395",4861,1719,2417,2402,2365,37,15,0,15,66,65,1,349,349,0,310,310,0
"2021","Liverpool 050","E02001396",6578,3783,1801,1793,1771,22,8,4,4,152,151,1,525,525,0,317,317,0
"2021","Liverpool 051","E02001397",6136,2295,2524,2520,2502,18,4,4,0,147,147,0,651,647,4,519,519,0
"2021","Liverpool 052","E02001398",6494,3449,2062,2039,1993,46,23,6,17,131,131,0,509,507,2,343,342,1
"2021","Liverpool 053","E02001399",5729,1781,3120,3114,3097,17,6,1,5,88,88,0,371,369,2,369,366,3
"2021","Liverpool 054","E02001400",5645,2264,2417,2399,2383,16,18,8,10,124,123,1,455,455,0,385,385,0
"2021","Liverpool 055","E02001401",6609,2521,3009,2998,2985,13,11,4,7,106,105,1,453,452,1,520,520,0
"2021","Liverpool 056","E02001402",7400,2719,3529,3505,3487,18,24,8,16,147,146,1,537,535,2,468,467,1
"2021","Liverpool 057","E02001403",5124,2728,1522,1512,1490,22,10,10,0,139,138,1,488,486,2,247,247,0
"2021","Liverpool 058","E02001404",6215,3268,1956,1944,1933,11,12,4,8,158,155,3,517,516,1,316,316,0
"2021","Liverpool 059","E02001405",7515,4002,2120,2113,2104,9,7,0,7,275,274,1,709,708,1,409,409,0
"2021","Liverpool 060","E02006932",13856,12798,759,753,734,19,6,0,6,57,56,1,197,194,3,45,45,0
"2021","Liverpool 061","E02006933",6742,4923,1180,1164,1137,27,16,9,7,92,90,2,379,377,2,168,168,0
"2021","Liverpool 062","E02006934",6439,5220,771,763,733,30,8,2,6,120,113,7,283,283,0,45,44,1
"2021","St. Helens 001","E02001406",6677,1693,3633,3625,3616,9,8,2,6,121,121,0,582,580,2,648,648,0
"2021","St. Helens 002","E02001407",5064,1309,2813,2807,2800,7,6,2,4,86,86,0,398,398,0,458,458,0
"2021","St. Helens 003","E02001408",4643,1403,2399,2395,2386,9,4,2,2,83,83,0,433,433,0,325,325,0
"2021","St. Helens 004","E02001409",8483,3112,3737,3732,3710,22,5,2,3,188,187,1,876,874,2,570,570,0
"2021","St. Helens 005","E02001410",4699,1747,2005,2000,1985,15,5,2,3,125,125,0,460,460,0,362,362,0
"2021","St. Helens 006","E02001411",4874,1651,2235,2233,2219,14,2,2,0,89,88,1,433,430,3,466,466,0
"2021","St. Helens 007","E02001412",7399,2582,3490,3479,3456,23,11,4,7,156,156,0,673,670,3,498,497,1
"2021","St. Helens 008","E02001413",7739,2692,3591,3582,3564,18,9,6,3,155,154,1,741,741,0,560,560,0
"2021","St. Helens 009","E02001414",4612,1106,2776,2776,2774,2,0,0,0,63,63,0,269,265,4,398,398,0
"2021","St. Helens 010","E02001415",5507,2201,2299,2282,2257,25,17,4,13,130,130,0,556,555,1,321,321,0
"2021","St. Helens 011","E02001416",5014,2262,1738,1728,1709,19,10,6,4,150,149,1,534,532,2,330,330,0
"2021","St. Helens 012","E02001417",6166,3075,1638,1627,1599,28,11,8,3,231,230,1,829,829,0,393,391,2
"2021","St. Helens 013","E02001418",5335,2442,1844,1836,1804,32,8,4,4,148,147,1,571,568,3,330,330,0
"2021","St. Helens 014","E02001419",6183,3176,1660,1651,1624,27,9,4,5,230,227,3,727,724,3,390,389,1
"2021","St. Helens 015","E02001420",9498,3741,3978,3962,3921,41,16,10,6,252,249,3,914,911,3,613,613,0
"2021","St. Helens 016","E02001421",8753,3713,3312,3299,3268,31,13,6,7,241,240,1,909,906,3,578,578,0
"2021","St. Helens 017","E02001422",5190,2402,1777,1765,1750,15,12,8,4,155,155,0,522,519,3,334,334,0
"2021","St. Helens 018","E02001423",5545,1662,2970,2963,2955,8,7,6,1,93,92,1,407,407,0,413,413,0
"2021","St. Helens 020","E02001425",8944,3333,3968,3945,3917,28,23,8,15,209,209,0,787,786,1,647,647,0
"2021","St. Helens 021","E02001426",4590,1564,2081,2077,2069,8,4,0,4,102,101,1,431,431,0,412,412,0
"2021","St. Helens 022","E02001427",8707,3463,3637,3623,3593,30,14,10,4,203,202,1,868,867,1,536,534,2
"2021","St. Helens 023","E02001428",4787,1284,2603,2597,2589,8,6,2,4,91,91,0,300,300,0,509,509,0
"2021","St. Helens 024","E02006935",6051,2495,2299,2292,2273,19,7,2,5,183,182,1,619,619,0,455,455,0
"2021","St. Helens 025","E02006936",6116,2345,2709,2695,2676,19,14,6,8,166,166,0,518,517,1,378,378,0
"2021","Sefton 001","E02001429",5686,1671,2756,2745,2742,3,11,0,11,99,99,0,596,596,0,564,564,0
"2021","Sefton 002","E02001430",5860,1525,3163,3155,3147,8,8,0,8,86,86,0,553,553,0,533,533,0
"2021","Sefton 003","E02001431",6665,1752,2947,2940,2921,19,7,2,5,132,131,1,899,871,28,935,933,2
"2021","Sefton 004","E02001432",8500,3869,2387,2374,2354,20,13,4,9,291,288,3,1246,1245,1,707,705,2
"2021","Sefton 005","E02001433",5885,2223,2555,2541,2517,24,14,4,10,102,102,0,641,641,0,364,364,0
"2021","Sefton 006","E02001434",5908,2213,2648,2632,2623,9,16,6,10,135,135,0,634,632,2,278,278,0
"2021","Sefton 007","E02001435",7239,3094,2409,2392,2373,19,17,6,11,169,169,0,1166,1166,0,401,401,0
"2021","Sefton 008","E02001436",7786,2860,3380,3374,3354,20,6,0,6,186,184,2,867,866,1,493,493,0
"2021","Sefton 009","E02001437",8212,2209,4012,3993,3966,27,19,2,17,130,130,0,884,884,0,977,977,0
"2021","Sefton 010","E02001438",5908,2022,2794,2789,2777,12,5,0,5,100,99,1,616,613,3,376,376,0
"2021","Sefton 011","E02001439",5384,1932,2224,2222,2213,9,2,0,2,128,127,1,641,640,1,459,458,1
"2021","Sefton 012","E02001440",5258,1176,3164,3153,3144,9,11,4,7,60,60,0,360,357,3,498,498,0
"2021","Sefton 013","E02001441",5426,1281,3262,3258,3238,20,4,2,2,70,70,0,319,319,0,494,491,3
"2021","Sefton 014","E02001442",5097,1375,2593,2588,2578,10,5,2,3,67,66,1,472,471,1,590,589,1
"2021","Sefton 015","E02001443",4760,1248,2698,2697,2688,9,1,0,1,64,64,0,328,327,1,422,422,0
"2021","Sefton 016","E02001444",4713,1441,2333,2329,2315,14,4,0,4,73,73,0,414,414,0,452,452,0
"2021","Sefton 017","E02001445",5797,1691,3024,3024,3011,13,0,0,0,104,104,0,455,455,0,523,523,0
"2021","Sefton 018","E02001446",6118,2138,2867,2867,2851,16,0,0,0,90,90,0,466,465,1,557,557,0
"2021","Sefton 019","E02001447",5175,1669,2509,2503,2487,16,6,6,0,76,76,0,423,423,0,498,498,0
"2021","Sefton 020","E02001448",5679,1753,2995,2987,2978,9,8,2,6,76,76,0,382,382,0,473,473,0
"2021","Sefton 021","E02001449",7822,2521,3920,3909,3889,20,11,1,10,120,120,0,657,657,0,604,603,1
"2021","Sefton 022","E02001450",7118,2071,3787,3772,3766,6,15,2,13,125,125,0,524,524,0,611,609,2
"2021","Sefton 023","E02001451",4821,2150,1638,1630,1618,12,8,6,2,121,121,0,483,483,0,429,429,0
"2021","Sefton 024","E02001452",5121,2403,1508,1500,1493,7,8,6,2,168,167,1,620,620,0,422,421,1
"2021","Sefton 025","E02001453",7295,2420,3686,3668,3660,8,18,6,12,108,106,2,572,572,0,509,509,0
"2021","Sefton 026","E02001454",6054,2091,2982,2980,2971,9,2,0,2,90,90,0,406,406,0,485,485,0
"2021","Sefton 027","E02001455",5936,2220,2799,2793,2787,6,6,0,6,79,79,0,459,459,0,379,379,0
"2021","Sefton 028","E02001456",6219,2251,2837,2828,2806,22,9,2,7,130,130,0,531,530,1,470,470,0
"2021","Sefton 029","E02001457",5489,2709,1753,1743,1736,7,10,4,6,145,145,0,512,511,1,370,370,0
"2021","Sefton 030","E02001458",6356,2786,2417,2404,2382,22,13,1,12,161,159,2,671,671,0,321,320,1
"2021","Sefton 031","E02001459",5547,2455,2122,2113,2103,10,9,4,5,123,122,1,486,485,1,361,361,0
"2021","Sefton 032","E02001460",6670,3231,2050,2020,2002,18,30,4,26,173,173,0,706,705,1,510,510,0
"2021","Sefton 033","E02001461",5687,2274,2446,2442,2428,14,4,0,4,106,106,0,423,422,1,438,438,0
"2021","Sefton 034","E02001462",6029,3205,1539,1537,1521,16,2,0,2,222,221,1,719,718,1,344,343,1
"2021","Sefton 035","E02001463",5926,2815,2115,2108,2102,6,7,4,3,150,150,0,460,460,0,386,386,0
"2021","Sefton 036","E02001464",5591,3005,1499,1491,1483,8,8,0,8,189,187,2,548,548,0,350,350,0
"2021","Sefton 037","E02001465",6406,3492,1531,1516,1501,15,15,6,9,298,297,1,726,724,2,359,359,0
"2021","Sefton 038","E02001466",7243,3484,2534,2525,2507,18,9,6,3,187,187,0,637,637,0,401,401,0
"2021","Wirral 001","E02001467",6570,2652,2330,2310,2286,24,20,2,18,184,182,2,869,865,4,535,533,2
"2021","Wirral 002","E02001468",6327,2721,2257,2237,2205,32,20,2,18,170,167,3,758,756,2,421,421,0
"2021","Wirral 003","E02001469",6436,2113,3018,3010,3000,10,8,0,8,125,124,1,652,650,2,528,528,0
"2021","Wirral 004","E02001470",6821,2255,3406,3400,3384,16,6,1,5,120,119,1,575,573,2,465,464,1
"2021","Wirral 005","E02001471",5819,2676,1819,1812,1788,24,7,6,1,207,205,2,754,751,3,363,363,0
"2021","Wirral 006","E02001472",5634,2110,2448,2438,2425,13,10,10,0,132,132,0,584,583,1,360,359,1
"2021","Wirral 007","E02001473",6255,2633,2366,2357,2346,11,9,6,3,160,159,1,662,662,0,434,434,0
"2021","Wirral 008","E02001474",5202,2694,1323,1318,1307,11,5,2,3,183,183,0,675,675,0,327,327,0
"2021","Wirral 009","E02001475",4900,2184,1564,1554,1546,8,10,0,10,138,137,1,658,657,1,356,356,0
"2021","Wirral 010","E02001476",6143,3171,1725,1717,1701,16,8,2,6,216,214,2,668,667,1,363,363,0
"2021","Wirral 011","E02001477",5705,3023,1408,1397,1382,15,11,4,7,167,167,0,718,717,1,389,387,2
"2021","Wirral 012","E02001478",6750,2453,2848,2835,2816,19,13,4,9,175,174,1,728,725,3,546,546,0
"2021","Wirral 013","E02001479",5021,1458,2688,2682,2664,18,6,0,6,81,81,0,456,453,3,338,337,1
"2021","Wirral 014","E02001480",6413,1943,3018,3002,2981,21,16,7,9,133,133,0,653,653,0,666,665,1
"2021","Wirral 015","E02001481",6758,2573,2920,2903,2886,17,17,4,13,133,133,0,693,690,3,439,439,0
"2021","Wirral 016","E02001482",6627,3672,1382,1372,1356,16,10,5,5,275,274,1,934,934,0,364,362,2
"2021","Wirral 017","E02001483",6084,1870,3056,3046,3037,9,10,4,6,101,101,0,597,596,1,460,460,0
"2021","Wirral 018","E02001484",6656,2142,3139,3127,3121,6,12,4,8,115,114,1,638,637,1,622,622,0
"2021","Wirral 019","E02001485",5294,2414,1879,1870,1849,21,9,2,7,137,136,1,465,465,0,399,399,0
"2021","Wirral 020","E02001486",7054,2629,2564,2548,2525,23,16,0,16,312,312,0,882,881,1,667,667,0
"2021","Wirral 021","E02001487",7176,3776,1947,1933,1914,19,14,6,8,249,246,3,866,863,3,338,338,0
"2021","Wirral 022","E02001488",6803,3115,2375,2359,2345,14,16,2,14,176,175,1,748,747,1,389,387,2
"2021","Wirral 023","E02001489",6901,1725,3936,3934,3922,12,2,0,2,97,97,0,563,563,0,580,580,0
"2021","Wirral 024","E02001490",6803,2168,3433,3428,3411,17,5,0,5,144,144,0,598,598,0,460,460,0
"2021","Wirral 025","E02001491",5320,2432,1631,1626,1618,8,5,0,5,166,166,0,688,686,2,403,403,0
"2021","Wirral 026","E02001492",6300,2015,2881,2863,2847,16,18,6,12,154,154,0,714,713,1,536,536,0
"2021","Wirral 027","E02001493",7018,3815,1659,1641,1616,25,18,8,10,278,278,0,830,829,1,436,435,1
"2021","Wirral 028","E02001494",5882,1283,3577,3568,3565,3,9,2,7,80,80,0,478,478,0,464,464,0
"2021","Wirral 029","E02001495",6433,2714,2422,2410,2406,4,12,8,4,166,166,0,616,616,0,515,515,0
"2021","Wirral 030","E02001496",5016,1697,2509,2501,2494,7,8,0,8,93,92,1,384,383,1,333,333,0
"2021","Wirral 031","E02001497",6430,2882,2115,2106,2089,17,9,0,9,225,225,0,771,770,1,437,437,0
"2021","Wirral 032","E02001498",5902,1974,2948,2936,2922,14,12,2,10,125,125,0,480,480,0,375,375,0
"2021","Wirral 033","E02001499",5562,1435,3009,3000,2992,8,9,4,5,94,94,0,496,495,1,528,528,0
"2021","Wirral 034","E02001500",6148,1719,3252,3238,3215,23,14,6,8,108,108,0,555,554,1,514,514,0
"2021","Wirral 035","E02001501",6354,2031,3267,3261,3245,16,6,4,2,99,97,2,520,520,0,437,436,1
"2021","Wirral 036","E02001502",7932,3105,3303,3292,3270,22,11,3,8,175,174,1,795,795,0,554,554,0
"2021","Wirral 037","E02001503",6383,1860,3034,3025,3016,9,9,1,8,132,130,2,713,713,0,644,644,0
"2021","Wirral 038","E02001504",5975,1437,3541,3531,3520,11,10,2,8,77,77,0,390,389,1,530,530,0
"2021","Wirral 039","E02001505",5348,1956,2355,2346,2338,8,9,7,2,134,134,0,524,523,1,379,379,0
"2021","Wirral 040","E02001506",7541,1497,4863,4855,4845,10,8,2,6,75,73,2,446,446,0,660,659,1
"2021","Wirral 041","E02001507",5843,1486,3343,3335,3325,10,8,0,8,85,85,0,407,407,0,522,522,0
"2021","Wirral 042","E02001508",6585,2302,2998,2990,2972,18,8,4,4,168,166,2,622,621,1,495,495,0
"2021","Kingston upon Hull 002","E02002653",6148,2916,2013,1994,1971,23,19,8,11,191,190,1,626,624,2,402,402,0
"2021","Kingston upon Hull 003","E02002654",5743,3028,1658,1636,1624,12,22,14,8,192,190,2,553,552,1,312,312,0
"2021","Kingston upon Hull 004","E02002655",6588,3051,2261,2250,2232,18,11,4,7,184,182,2,706,705,1,386,386,0
"2021","Kingston upon Hull 005","E02002656",4491,1389,2150,2143,2126,17,7,4,3,79,79,0,451,451,0,422,422,0
"2021","Kingston upon Hull 006","E02002657",6192,2033,2987,2978,2959,19,9,1,8,147,147,0,593,593,0,432,431,1
"2021","Kingston upon Hull 007","E02002658",5590,1888,2637,2625,2607,18,12,2,10,103,103,0,529,527,2,433,433,0
"2021","Kingston upon Hull 008","E02002659",8538,4179,2766,2748,2737,11,18,6,12,231,229,2,839,838,1,523,522,1
"2021","Kingston upon Hull 009","E02002660",5531,2304,2147,2140,2132,8,7,2,5,151,150,1,507,505,2,422,421,1
"2021","Kingston upon Hull 010","E02002661",6575,2694,2605,2589,2578,11,16,8,8,166,164,2,604,604,0,506,506,0
"2021","Kingston upon Hull 011","E02002662",6009,2315,2349,2331,2303,28,18,10,8,187,186,1,643,643,0,515,513,2
"2021","Kingston upon Hull 012","E02002663",7280,5059,1596,1586,1574,12,10,4,6,87,87,0,370,369,1,168,167,1
"2021","Kingston upon Hull 013","E02002664",5960,1863,3207,3202,3199,3,5,0,5,89,89,0,443,442,1,358,358,0
"2021","Kingston upon Hull 014","E02002665",6498,2281,3111,3091,3068,23,20,8,12,128,126,2,562,562,0,416,416,0
"2021","Kingston upon Hull 015","E02002666",6964,4109,1650,1633,1616,17,17,10,7,215,215,0,730,729,1,260,258,2
"2021","Kingston upon Hull 016","E02002667",6024,2550,2400,2388,2362,26,12,4,8,140,140,0,624,623,1,310,310,0
"2021","Kingston upon Hull 017","E02002668",6310,2989,1938,1925,1905,20,13,6,7,184,183,1,709,704,5,490,490,0
"2021","Kingston upon Hull 018","E02002669",6828,3825,2024,2000,1973,27,24,14,10,196,193,3,616,615,1,167,167,0
"2021","Kingston upon Hull 019","E02002670",6402,2541,2457,2445,2423,22,12,6,6,159,159,0,790,790,0,455,453,2
"2021","Kingston upon Hull 020","E02002671",7343,3397,2598,2573,2558,15,25,12,13,186,184,2,770,767,3,392,390,2
"2021","Kingston upon Hull 021","E02002672",5283,2600,1697,1673,1662,11,24,8,16,177,177,0,469,469,0,340,339,1
"2021","Kingston upon Hull 022","E02002673",6138,2697,2271,2253,2241,12,18,4,14,178,175,3,627,627,0,365,364,1
"2021","Kingston upon Hull 023","E02002674",5494,2437,1902,1893,1884,9,9,2,7,164,163,1,641,639,2,350,350,0
"2021","Kingston upon Hull 024","E02002675",6789,3403,2035,2023,2013,10,12,8,4,185,185,0,836,835,1,330,329,1
"2021","Kingston upon Hull 025","E02002676",6029,3011,1883,1873,1844,29,10,8,2,188,188,0,645,645,0,302,302,0
"2021","Kingston upon Hull 026","E02002677",6878,3149,2318,2288,2264,24,30,9,21,244,242,2,811,810,1,356,356,0
"2021","Kingston upon Hull 027","E02002678",6831,3155,2442,2425,2384,41,17,12,5,218,218,0,715,715,0,301,300,1
"2021","Kingston upon Hull 028","E02002679",6363,2251,2905,2900,2880,20,5,2,3,147,147,0,658,657,1,402,401,1
"2021","Kingston upon Hull 029","E02002680",8300,4762,1805,1785,1757,28,20,10,10,314,310,4,1016,1014,2,403,402,1
"2021","Kingston upon Hull 030","E02002681",7123,3691,1982,1959,1955,4,23,7,16,290,288,2,800,799,1,360,360,0
"2021","Kingston upon Hull 031","E02002682",8287,3945,2828,2803,2790,13,25,4,21,255,253,2,852,850,2,407,407,0
"2021","Kingston upon Hull 033","E02006813",6715,2627,2515,2502,2492,10,13,4,9,176,175,1,775,770,5,622,622,0
"2021","Kingston upon Hull 034","E02007079",6255,3131,2223,2210,2180,30,13,6,7,150,148,2,508,508,0,243,243,0
"2021","Kingston upon Hull 035","E02007080",6382,2781,2868,2857,2827,30,11,6,5,153,153,0,483,480,3,97,97,0
"2021","East Riding of Yorkshire 001","E02002684",8937,2097,4890,4864,4846,18,26,10,16,130,129,1,894,893,1,926,925,1
"2021","East Riding of Yorkshire 002","E02002685",6826,1575,3724,3718,3695,23,6,2,4,121,121,0,699,698,1,707,706,1
"2021","East Riding of Yorkshire 003","E02002686",6194,2356,2155,2147,2132,15,8,6,2,180,179,1,846,846,0,657,657,0
"2021","East Riding of Yorkshire 004","E02002687",5035,1805,1972,1960,1949,11,12,6,6,165,165,0,632,632,0,461,461,0
"2021","East Riding of Yorkshire 005","E02002688",4586,1628,1725,1712,1705,7,13,4,9,168,167,1,645,645,0,420,418,2
"2021","East Riding of Yorkshire 006","E02002689",4944,1186,2769,2745,2736,9,24,10,14,114,114,0,483,482,1,392,392,0
"2021","East Riding of Yorkshire 008","E02002691",6997,1722,3914,3897,3888,9,17,8,9,131,130,1,674,672,2,556,555,1
"2021","East Riding of Yorkshire 009","E02002692",8157,2249,4436,4420,4395,25,16,6,10,142,141,1,743,741,2,587,587,0
"2021","East Riding of Yorkshire 010","E02002693",6063,1454,3529,3512,3499,13,17,4,13,120,118,2,556,554,2,404,404,0
"2021","East Riding of Yorkshire 011","E02002694",10758,3252,5360,5346,5321,25,14,6,8,249,246,3,1111,1108,3,786,786,0
"2021","East Riding of Yorkshire 012","E02002695",7097,1850,3584,3574,3559,15,10,2,8,157,157,0,792,792,0,714,712,2
"2021","East Riding of Yorkshire 013","E02002696",5374,1615,2929,2915,2899,16,14,4,10,97,97,0,421,421,0,312,310,2
"2021","East Riding of Yorkshire 014","E02002697",6391,1515,3703,3690,3677,13,13,6,7,109,109,0,598,598,0,466,466,0
"2021","East Riding of Yorkshire 015","E02002698",7018,1977,3598,3587,3564,23,11,2,9,163,163,0,783,783,0,497,497,0
"2021","East Riding of Yorkshire 016","E02002699",8242,1963,4770,4761,4749,12,9,0,9,150,146,4,703,703,0,656,655,1
"2021","East Riding of Yorkshire 017","E02002700",4831,1915,1754,1747,1737,10,7,4,3,172,168,4,623,621,2,367,367,0
"2021","East Riding of Yorkshire 018","E02002701",7284,1699,4371,4346,4335,11,25,14,11,131,131,0,623,623,0,460,460,0
"2021","East Riding of Yorkshire 019","E02002702",8560,2727,3675,3649,3620,29,26,2,24,247,247,0,1171,1169,2,740,740,0
"2021","East Riding of Yorkshire 020","E02002703",7918,2267,4273,4267,4253,14,6,0,6,135,135,0,743,743,0,500,500,0
"2021","East Riding of Yorkshire 021","E02002704",6177,1476,3625,3616,3605,11,9,2,7,101,99,2,527,526,1,448,448,0
"2021","East Riding of Yorkshire 022","E02002705",5959,1584,3277,3273,3259,14,4,2,2,93,93,0,512,511,1,493,493,0
"2021","East Riding of Yorkshire 023","E02002706",6118,1760,3187,3176,3158,18,11,4,7,110,110,0,576,575,1,485,484,1
"2021","East Riding of Yorkshire 024","E02002707",5734,1308,3401,3400,3386,14,1,0,1,98,98,0,496,496,0,431,431,0
"2021","East Riding of Yorkshire 025","E02002708",5036,1333,2421,2411,2406,5,10,2,8,101,101,0,560,560,0,621,621,0
"2021","East Riding of Yorkshire 026","E02002709",7166,2496,3422,3417,3411,6,5,2,3,139,139,0,627,627,0,482,482,0
"2021","East Riding of Yorkshire 027","E02002710",6043,1679,3250,3247,3233,14,3,2,1,119,118,1,519,517,2,476,474,2
"2021","East Riding of Yorkshire 028","E02002711",6657,1434,4055,4050,4034,16,5,2,3,87,86,1,459,458,1,622,622,0
"2021","East Riding of Yorkshire 029","E02002712",6325,1767,3171,3164,3146,18,7,5,2,123,123,0,678,675,3,586,586,0
"2021","East Riding of Yorkshire 031","E02002714",6678,1709,3759,3751,3733,18,8,2,6,125,125,0,595,595,0,490,489,1
"2021","East Riding of Yorkshire 032","E02002715",10854,3113,5881,5872,5853,19,9,4,5,221,218,3,1044,1042,2,595,594,1
"2021","East Riding of Yorkshire 033","E02002716",7068,2001,3685,3679,3669,10,6,2,4,137,137,0,689,688,1,556,555,1
"2021","East Riding of Yorkshire 034","E02002717",6546,2498,2595,2590,2570,20,5,0,5,153,150,3,836,835,1,464,463,1
"2021","East Riding of Yorkshire 035","E02002718",6721,1501,4098,4090,4078,12,8,0,8,90,88,2,520,520,0,512,512,0
"2021","East Riding of Yorkshire 036","E02002719",5656,1690,2925,2919,2900,19,6,0,6,104,104,0,466,463,3,471,471,0
"2021","East Riding of Yorkshire 037","E02002720",6433,1785,3496,3488,3472,16,8,0,8,107,107,0,565,565,0,480,480,0
"2021","East Riding of Yorkshire 038","E02002721",5627,1640,2909,2899,2876,23,10,2,8,101,100,1,567,564,3,410,410,0
"2021","East Riding of Yorkshire 039","E02002722",7089,2138,3350,3335,3322,13,15,2,13,184,184,0,770,769,1,647,646,1
"2021","East Riding of Yorkshire 040","E02002723",6967,2599,2947,2935,2922,13,12,4,8,160,160,0,755,754,1,506,506,0
"2021","East Riding of Yorkshire 041","E02002724",7497,3303,2716,2682,2672,10,34,28,6,200,200,0,853,853,0,425,423,2
"2021","East Riding of Yorkshire 042","E02002725",5765,1585,3087,3078,3068,10,9,4,5,110,109,1,548,545,3,435,434,1
"2021","East Riding of Yorkshire 043","E02006814",6680,2259,3186,3175,3161,14,11,6,5,119,119,0,652,647,5,464,463,1
"2021","East Riding of Yorkshire 044","E02006891",6878,1799,3792,3778,3762,16,14,4,10,127,127,0,665,661,4,495,495,0
"2021","East Riding of Yorkshire 045","E02006892",5244,1734,2135,2126,2118,8,9,6,3,138,138,0,664,664,0,573,573,0
"2021","North East Lincolnshire 001","E02002726",8435,2814,3850,3834,3814,20,16,6,10,200,200,0,911,911,0,660,658,2
"2021","North East Lincolnshire 002","E02002727",3958,2069,848,836,824,12,12,4,8,141,139,2,620,616,4,280,278,2
"2021","North East Lincolnshire 003","E02002728",5980,2953,1677,1665,1660,5,12,6,6,235,233,2,812,810,2,303,303,0
"2021","North East Lincolnshire 004","E02002729",4632,1556,2145,2135,2128,7,10,6,4,118,118,0,516,516,0,297,297,0
"2021","North East Lincolnshire 005","E02002730",5343,2622,1586,1567,1548,19,19,8,11,216,213,3,684,681,3,235,235,0
"2021","North East Lincolnshire 006","E02002731",4188,2138,1196,1184,1171,13,12,10,2,126,126,0,513,513,0,215,215,0
"2021","North East Lincolnshire 007","E02002732",6571,1790,3679,3669,3663,6,10,6,4,116,116,0,529,527,2,457,457,0
"2021","North East Lincolnshire 008","E02002733",4806,1904,1776,1774,1763,11,2,0,2,160,159,1,652,650,2,314,314,0
"2021","North East Lincolnshire 009","E02002734",4459,1665,1811,1803,1791,12,8,4,4,122,120,2,498,498,0,363,363,0
"2021","North East Lincolnshire 011","E02002736",4245,2181,1209,1200,1184,16,9,4,5,165,162,3,524,522,2,166,166,0
"2021","North East Lincolnshire 012","E02002737",5834,2139,2559,2552,2527,25,7,0,7,132,132,0,589,587,2,415,415,0
"2021","North East Lincolnshire 013","E02002738",5598,1908,2683,2676,2661,15,7,6,1,129,126,3,547,547,0,331,331,0
"2021","North East Lincolnshire 014","E02002739",4718,1797,1696,1688,1680,8,8,4,4,140,137,3,714,712,2,371,371,0
"2021","North East Lincolnshire 015","E02002740",4352,1778,1654,1643,1637,6,11,2,9,125,122,3,487,487,0,308,308,0
"2021","North East Lincolnshire 016","E02002741",7250,2652,3174,3161,3127,34,13,4,9,183,183,0,781,777,4,460,459,1
"2021","North East Lincolnshire 018","E02002743",4662,1262,2153,2146,2141,5,7,0,7,97,96,1,586,586,0,564,564,0
"2021","North East Lincolnshire 019","E02002744",5145,2369,1738,1732,1726,6,6,0,6,174,172,2,557,557,0,307,307,0
"2021","North East Lincolnshire 020","E02002745",6310,1461,3438,3425,3416,9,13,8,5,92,91,1,673,673,0,646,646,0
"2021","North East Lincolnshire 021","E02002746",7997,2373,3998,3993,3975,18,5,0,5,186,186,0,849,848,1,591,591,0
"2021","North East Lincolnshire 022","E02002747",7726,2121,4179,4169,4160,9,10,2,8,143,143,0,688,686,2,595,595,0
"2021","North East Lincolnshire 023","E02002748",6872,1697,3774,3771,3766,5,3,0,3,98,98,0,634,634,0,669,669,0
"2021","North East Lincolnshire 024","E02007081",8435,2880,3778,3757,3736,21,21,7,14,226,223,3,978,975,3,573,573,0
"2021","North Lincolnshire 001","E02002749",9888,3208,4610,4592,4556,36,18,6,12,220,220,0,1109,1108,1,741,741,0
"2021","North Lincolnshire 002","E02002750",5328,1457,2887,2873,2852,21,14,4,10,96,95,1,506,506,0,382,381,1
"2021","North Lincolnshire 003","E02002751",5258,1621,2603,2597,2583,14,6,4,2,116,115,1,524,523,1,394,394,0
"2021","North Lincolnshire 004","E02002752",5828,1603,3114,3093,3078,15,21,6,15,124,122,2,589,589,0,398,396,2
"2021","North Lincolnshire 005","E02002753",7297,2043,3570,3557,3529,28,13,2,11,153,153,0,800,800,0,731,731,0
"2021","North Lincolnshire 006","E02002754",6825,2053,3371,3360,3344,16,11,2,9,164,162,2,751,750,1,486,486,0
"2021","North Lincolnshire 007","E02002755",6041,2422,2407,2396,2384,12,11,4,7,150,150,0,661,661,0,401,400,1
"2021","North Lincolnshire 008","E02002756",7070,3254,2521,2500,2493,7,21,15,6,191,188,3,742,742,0,362,360,2
"2021","North Lincolnshire 009","E02002757",5051,1703,2431,2425,2411,14,6,0,6,113,113,0,479,477,2,325,325,0
"2021","North Lincolnshire 010","E02002758",5130,2191,1920,1914,1895,19,6,2,4,140,140,0,597,595,2,282,282,0
"2021","North Lincolnshire 011","E02002759",8126,2287,4085,4074,4046,28,11,6,5,177,175,2,892,889,3,685,685,0
"2021","North Lincolnshire 012","E02002760",4790,1594,2257,2247,2236,11,10,2,8,103,102,1,493,492,1,343,343,0
"2021","North Lincolnshire 013","E02002761",5459,1586,2744,2734,2727,7,10,0,10,126,124,2,589,589,0,414,414,0
"2021","North Lincolnshire 014","E02002762",5211,1978,2032,2017,1994,23,15,6,9,153,152,1,621,621,0,427,427,0
"2021","North Lincolnshire 015","E02002763",6801,2890,2458,2453,2441,12,5,0,5,164,162,2,849,848,1,440,439,1
"2021","North Lincolnshire 016","E02002764",4455,1888,1676,1671,1660,11,5,5,0,146,146,0,486,485,1,259,259,0
"2021","North Lincolnshire 017","E02002765",4929,1857,1951,1939,1923,16,12,8,4,120,119,1,614,614,0,387,386,1
"2021","North Lincolnshire 018","E02002766",7192,2255,3468,3456,3443,13,12,6,6,151,150,1,746,746,0,572,572,0
"2021","North Lincolnshire 019","E02002767",5693,1553,3016,3014,3007,7,2,2,0,106,105,1,539,539,0,479,479,0
"2021","North Lincolnshire 020","E02002768",6260,1693,3396,3389,3372,17,7,4,3,115,114,1,608,606,2,448,448,0
"2021","North Lincolnshire 021","E02002769",4844,1102,2823,2816,2810,6,7,4,3,88,87,1,462,462,0,369,369,0
"2021","North Lincolnshire 022","E02002770",5929,1599,3185,3174,3155,19,11,5,6,110,108,2,605,604,1,430,430,0
"2021","North Lincolnshire 023","E02002771",6056,1478,3438,3432,3425,7,6,2,4,95,95,0,548,548,0,497,496,1
"2021","York 001","E02002772",5622,1516,3228,3219,3196,23,9,0,9,87,86,1,465,464,1,326,326,0
"2021","York 002","E02002773",4834,1071,2749,2743,2729,14,6,0,6,83,83,0,483,483,0,448,448,0
"2021","York 003","E02002774",5118,1142,2993,2973,2955,18,20,8,12,75,74,1,428,428,0,480,480,0
"2021","York 004","E02002775",4818,1416,2349,2346,2336,10,3,0,3,75,75,0,534,533,1,444,442,2
"2021","York 005","E02002776",5621,1862,2688,2681,2663,18,7,3,4,90,90,0,522,522,0,459,459,0
"2021","York 006","E02002777",7375,2675,3608,3598,3582,16,10,6,4,119,118,1,639,636,3,334,334,0
"2021","York 007","E02002778",6730,2259,3288,3265,3235,30,23,10,13,95,95,0,599,595,4,489,489,0
"2021","York 008","E02002779",8155,2717,4007,3986,3966,20,21,3,18,146,145,1,693,692,1,592,591,1
"2021","York 009","E02002780",6737,3728,1978,1958,1939,19,20,8,12,135,134,1,579,576,3,317,317,0
"2021","York 010","E02002781",8773,5443,2219,2199,2180,19,20,6,14,165,162,3,680,678,2,266,265,1
"2021","York 011","E02002782",5391,1434,3096,3080,3065,15,16,6,10,69,66,3,363,363,0,429,428,1
"2021","York 012","E02002783",8392,2845,4033,4023,3991,32,10,0,10,152,151,1,783,782,1,579,578,1
"2021","York 013","E02002784",10442,6734,2216,2173,2133,40,43,16,27,210,207,3,923,923,0,359,359,0
"2021","York 014","E02002785",6856,2760,3062,3055,3023,32,7,6,1,102,102,0,501,500,1,431,431,0
"2021","York 015","E02002786",8778,5756,2055,2033,2018,15,22,10,12,139,138,1,578,577,1,250,250,0
"2021","York 016","E02002787",7446,3153,2845,2836,2809,27,9,4,5,158,153,5,806,802,4,484,484,0
"2021","York 017","E02002788",7024,3199,2821,2808,2786,22,13,4,9,129,126,3,593,592,1,282,281,1
"2021","York 018","E02002789",7192,3214,2534,2517,2503,14,17,0,17,186,186,0,826,823,3,432,432,0
"2021","York 019","E02002790",10478,6227,2975,2944,2910,34,31,4,27,149,147,2,742,737,5,385,384,1
"2021","York 020","E02002791",5480,1338,3161,3151,3130,21,10,4,6,81,79,2,384,384,0,516,516,0
"2021","York 021","E02002792",6516,2415,3034,3013,2967,46,21,12,9,117,116,1,583,580,3,367,367,0
"2021","York 022","E02002793",7778,2588,3746,3735,3714,21,11,2,9,135,135,0,778,778,0,531,531,0
"2021","York 023","E02002794",9649,6585,2267,2248,2234,14,19,4,15,81,81,0,374,374,0,342,341,1
"2021","York 024","E02002795",6874,1507,4144,4132,4117,15,12,8,4,82,80,2,598,597,1,543,543,0
"2021","Craven 001","E02005742",6376,1644,3482,3461,3444,17,21,10,11,118,118,0,615,615,0,517,517,0
"2021","Craven 003","E02005744",6890,1775,3716,3702,3673,29,14,2,12,122,122,0,714,712,2,563,563,0
"2021","Craven 005","E02005746",5631,1703,2802,2782,2774,8,20,4,16,123,123,0,613,610,3,390,390,0
"2021","Craven 006","E02005747",5737,2286,2169,2155,2137,18,14,6,8,184,183,1,693,692,1,405,404,1
"2021","Craven 007","E02005748",6537,1823,3468,3449,3419,30,19,8,11,122,122,0,708,701,7,416,416,0
"2021","Craven 008","E02005749",8346,2308,4349,4334,4316,18,15,8,7,165,165,0,871,871,0,653,653,0
"2021","Craven 009","E02007041",8765,1927,5171,5141,5124,17,30,12,18,159,158,1,772,772,0,736,736,0
"2021","Hambleton 001","E02005750",6640,1830,3423,3413,3399,14,10,2,8,139,139,0,650,650,0,598,598,0
"2021","Hambleton 002","E02005751",7543,1562,4647,4635,4622,13,12,4,8,109,109,0,590,590,0,635,635,0
"2021","Hambleton 003","E02005752",5961,1664,3324,3313,3304,9,11,3,8,103,103,0,510,509,1,360,360,0
"2021","Hambleton 005","E02005754",6455,1328,4015,4004,3992,12,11,2,9,86,85,1,516,516,0,510,509,1
"2021","Hambleton 006","E02005755",5732,1482,3031,3026,3016,10,5,0,5,124,124,0,601,598,3,494,494,0
"2021","Hambleton 007","E02005756",5339,1547,3009,2993,2990,3,16,6,10,91,90,1,417,417,0,275,275,0
"2021","Hambleton 008","E02005757",7406,2149,3712,3696,3678,18,16,4,12,182,181,1,776,775,1,587,587,0
"2021","Hambleton 009","E02005758",7855,2199,4199,4183,4168,15,16,8,8,175,173,2,746,745,1,536,535,1
"2021","Hambleton 010","E02005759",7900,2057,4229,4221,4199,22,8,4,4,162,159,3,817,816,1,635,635,0
"2021","Hambleton 011","E02005760",5202,1350,3012,3004,2989,15,8,0,8,78,78,0,448,446,2,314,314,0
"2021","Hambleton 012","E02007042",5804,1666,2930,2929,2911,18,1,0,1,123,122,1,575,575,0,510,508,2
"2021","Hambleton 013","E02007043",5151,1849,2071,2063,2054,9,8,0,8,149,149,0,668,668,0,414,414,0
"2021","Harrogate 001","E02005761",4618,1049,2800,2783,2781,2,17,4,13,87,86,1,378,377,1,304,304,0
"2021","Harrogate 002","E02005762",5189,1607,2576,2569,2557,12,7,4,3,118,118,0,477,477,0,411,411,0
"2021","Harrogate 003","E02005763",5328,1242,3166,3162,3152,10,4,4,0,87,87,0,502,502,0,331,328,3
"2021","Harrogate 004","E02005764",8674,2618,4074,4059,4051,8,15,4,11,204,202,2,1051,1048,3,727,726,1
"2021","Harrogate 005","E02005765",6041,1523,3416,3400,3383,17,16,8,8,112,112,0,534,533,1,456,456,0
"2021","Harrogate 006","E02005766",5137,1266,2934,2918,2906,12,16,6,10,111,111,0,485,485,0,341,341,0
"2021","Harrogate 007","E02005767",6068,1376,3730,3714,3702,12,16,4,12,65,63,2,502,502,0,395,394,1
"2021","Harrogate 008","E02005768",6669,2634,3144,3138,3120,18,6,0,6,107,107,0,471,471,0,313,313,0
"2021","Harrogate 009","E02005769",5832,1967,2454,2444,2425,19,10,0,10,129,129,0,740,738,2,542,542,0
"2021","Harrogate 010","E02005770",7522,2334,3653,3645,3616,29,8,2,6,142,142,0,861,861,0,532,532,0
"2021","Harrogate 011","E02005771",6137,2238,2610,2602,2585,17,8,2,6,175,175,0,801,799,2,313,313,0
"2021","Harrogate 012","E02005772",4996,1028,3100,3096,3088,8,4,0,4,59,58,1,397,397,0,412,411,1
"2021","Harrogate 013","E02005773",7526,3070,2668,2660,2635,25,8,0,8,242,241,1,1057,1055,2,489,488,1
"2021","Harrogate 014","E02005774",7790,2749,3391,3378,3362,16,13,4,9,181,178,3,899,898,1,570,570,0
"2021","Harrogate 015","E02005775",8188,3476,2978,2941,2913,28,37,10,27,219,219,0,989,986,3,526,524,2
"2021","Harrogate 016","E02005776",7439,2095,4222,4215,4199,16,7,2,5,114,114,0,605,603,2,403,401,2
"2021","Harrogate 017","E02005777",6708,1686,3879,3869,3861,8,10,4,6,104,104,0,535,535,0,504,503,1
"2021","Harrogate 018","E02005778",5195,1193,3231,3219,3204,15,12,2,10,60,60,0,425,425,0,286,286,0
"2021","Harrogate 019","E02005779",6319,1873,3107,3072,3055,17,35,8,27,144,144,0,667,667,0,528,526,2
"2021","Harrogate 020","E02005780",8938,2254,5159,5144,5128,16,15,4,11,131,131,0,766,766,0,628,628,0
"2021","Harrogate 021","E02005781",4995,1084,3098,3088,3074,14,10,0,10,64,64,0,378,378,0,371,371,0
"2021","Richmondshire 001","E02005782",6525,1429,3951,3935,3922,13,16,6,10,122,118,4,588,588,0,435,435,0
"2021","Richmondshire 002","E02005783",6895,1804,3415,3395,3382,13,20,6,14,174,173,1,888,886,2,614,613,1
"2021","Richmondshire 003","E02005784",4860,1454,2469,2455,2440,15,14,1,13,124,124,0,466,466,0,347,347,0
"2021","Richmondshire 004","E02005785",10991,4517,4849,4837,4817,20,12,4,8,373,367,6,856,855,1,396,396,0
"2021","Richmondshire 005","E02005786",5120,1222,2948,2935,2922,13,13,4,9,82,82,0,468,468,0,400,395,5
"2021","Richmondshire 006","E02005787",7351,1799,4164,4140,4120,20,24,6,18,141,139,2,660,660,0,587,585,2
"2021","Ryedale 001","E02005788",5508,1420,3035,3025,3011,14,10,4,6,109,109,0,539,539,0,405,404,1
"2021","Ryedale 002","E02005789",9234,2377,4889,4874,4859,15,15,4,11,169,169,0,919,919,0,880,879,1
"2021","Ryedale 003","E02005790",6020,1596,3291,3282,3269,13,9,2,7,105,105,0,551,549,2,477,476,1
"2021","Ryedale 004","E02005791",5719,1620,3099,3093,3074,19,6,2,4,124,124,0,532,530,2,344,342,2
"2021","Ryedale 007","E02005794",7921,1944,4557,4535,4517,18,22,10,12,129,129,0,759,757,2,532,530,2
"2021","Ryedale 009","E02007044",6211,2462,2401,2392,2367,25,9,4,5,177,177,0,716,715,1,455,454,1
"2021","Ryedale 010","E02007045",5711,1655,2939,2930,2914,16,9,2,7,128,128,0,532,531,1,457,457,0
"2021","Scarborough 001","E02005795",6043,1863,2737,2726,2713,13,11,2,9,152,152,0,745,745,0,546,544,2
"2021","Scarborough 002","E02005796",5679,1594,3020,3011,2984,27,9,2,7,109,107,2,512,512,0,444,444,0
"2021","Scarborough 003","E02005797",5204,1683,2456,2439,2426,13,17,6,11,112,110,2,586,586,0,367,367,0
"2021","Scarborough 004","E02005798",7116,1694,4031,4004,3987,17,27,12,15,113,112,1,682,682,0,596,596,0
"2021","Scarborough 005","E02005799",7912,1959,4298,4289,4276,13,9,0,9,125,124,1,737,737,0,793,792,1
"2021","Scarborough 006","E02005800",6289,2694,2043,2019,2004,15,24,0,24,234,233,1,910,908,2,408,405,3
"2021","Scarborough 007","E02005801",4396,1727,1635,1626,1620,6,9,2,7,103,103,0,572,572,0,359,359,0
"2021","Scarborough 008","E02005802",6296,2759,2094,2077,2051,26,17,4,13,206,205,1,860,860,0,377,377,0
"2021","Scarborough 009","E02005803",7779,2531,3403,3390,3368,22,13,4,9,204,202,2,1004,1002,2,637,636,1
"2021","Scarborough 010","E02005804",6992,2682,2311,2272,2250,22,39,10,29,251,251,0,1108,1098,10,640,640,0
"2021","Scarborough 011","E02005805",6599,1682,3528,3518,3497,21,10,1,9,127,126,1,714,713,1,548,547,1
"2021","Scarborough 012","E02005806",6247,2469,2507,2496,2477,19,11,4,7,186,184,2,675,673,2,410,408,2
"2021","Scarborough 013","E02005807",5488,1314,3180,3177,3168,9,3,2,1,75,75,0,520,518,2,399,399,0
"2021","Scarborough 014","E02005808",10075,2476,5248,5239,5225,14,9,2,7,263,263,0,1043,1040,3,1045,1045,0
"2021","Selby 001","E02005809",6244,1786,3201,3192,3178,14,9,2,7,123,123,0,678,677,1,456,456,0
"2021","Selby 002","E02005810",7660,1965,4547,4537,4520,17,10,2,8,143,143,0,619,616,3,386,386,0
"2021","Selby 003","E02005811",8099,2287,4488,4469,4448,21,19,0,19,151,151,0,665,665,0,508,508,0
"2021","Selby 004","E02005812",9180,3034,4494,4482,4466,16,12,6,6,205,204,1,908,908,0,539,539,0
"2021","Selby 005","E02005813",10534,4557,3809,3788,3762,26,21,8,13,318,316,2,1300,1296,4,550,550,0
"2021","Selby 006","E02005814",5804,1679,2941,2923,2905,18,18,4,14,119,119,0,571,570,1,494,494,0
"2021","Selby 007","E02005815",7224,1858,4111,4101,4092,9,10,2,8,122,122,0,603,603,0,530,530,0
"2021","Selby 008","E02005816",7210,1961,4085,4081,4061,20,4,2,2,146,145,1,612,608,4,406,406,0
"2021","Selby 009","E02005817",6172,1683,3333,3326,3304,22,7,4,3,121,120,1,654,654,0,381,381,0
"2021","Selby 010","E02005818",7308,2035,4052,4045,4039,6,7,4,3,148,148,0,669,666,3,404,404,0
"2021","Barnsley 001","E02001509",5661,1939,2619,2613,2598,15,6,0,6,116,114,2,604,604,0,383,383,0
"2021","Barnsley 002","E02001510",4813,1723,2134,2119,2114,5,15,8,7,133,133,0,527,524,3,296,296,0
"2021","Barnsley 003","E02001511",5054,1662,2374,2362,2348,14,12,4,8,110,108,2,509,508,1,399,399,0
"2021","Barnsley 004","E02001512",7099,2358,3333,3327,3291,36,6,2,4,137,137,0,755,753,2,516,515,1
"2021","Barnsley 005","E02001513",6372,2034,3100,3094,3076,18,6,3,3,109,109,0,678,675,3,451,451,0
"2021","Barnsley 006","E02001514",6101,2490,2455,2445,2413,32,10,4,6,151,151,0,636,635,1,369,369,0
"2021","Barnsley 007","E02001515",7495,3181,2732,2713,2704,9,19,8,11,207,206,1,892,891,1,483,483,0
"2021","Barnsley 008","E02001516",5003,1979,2060,2041,2020,21,19,5,14,125,125,0,543,540,3,296,296,0
"2021","Barnsley 009","E02001517",6694,2052,3317,3313,3299,14,4,2,2,124,124,0,697,695,2,504,504,0
"2021","Barnsley 010","E02001518",8424,3243,3509,3503,3477,26,6,6,0,213,213,0,945,943,2,514,513,1
"2021","Barnsley 011","E02001519",6268,2551,2604,2595,2578,17,9,6,3,156,156,0,547,546,1,410,410,0
"2021","Barnsley 012","E02001520",9823,2969,4961,4951,4933,18,10,2,8,167,166,1,1001,1001,0,725,723,2
"2021","Barnsley 013","E02001521",10036,4822,3252,3230,3196,34,22,14,8,301,298,3,1229,1226,3,432,431,1
"2021","Barnsley 014","E02001522",7562,3085,2916,2897,2883,14,19,12,7,273,272,1,721,716,5,567,567,0
"2021","Barnsley 015","E02001523",5737,2179,2476,2471,2450,21,5,2,3,134,132,2,571,569,2,377,377,0
"2021","Barnsley 016","E02001524",5223,1115,3178,3164,3159,5,14,0,14,73,73,0,477,477,0,380,380,0
"2021","Barnsley 017","E02001525",5568,2550,1691,1681,1664,17,10,5,5,180,179,1,782,780,2,365,365,0
"2021","Barnsley 018","E02001526",4767,2003,1795,1782,1770,12,13,5,8,113,113,0,511,510,1,345,345,0
"2021","Barnsley 019","E02001527",5013,1567,2414,2411,2401,10,3,2,1,91,90,1,541,540,1,400,400,0
"2021","Barnsley 020","E02001528",8713,3106,3863,3855,3834,21,8,4,4,231,230,1,837,836,1,676,676,0
"2021","Barnsley 021","E02001529",7754,3001,3121,3110,3098,12,11,4,7,201,201,0,823,821,2,608,607,1
"2021","Barnsley 022","E02001530",5715,2399,2213,2199,2182,17,14,0,14,150,150,0,597,593,4,356,356,0
"2021","Barnsley 023","E02001531",6362,2646,2458,2451,2435,16,7,2,5,163,161,2,688,687,1,407,406,1
"2021","Barnsley 024","E02001532",8492,2492,4395,4385,4363,22,10,2,8,196,196,0,858,857,1,551,551,0
"2021","Barnsley 025","E02001533",6198,2336,2626,2615,2594,21,11,2,9,143,141,2,703,702,1,390,390,0
"2021","Barnsley 026","E02001534",7727,2985,3252,3238,3223,15,14,10,4,159,159,0,848,847,1,483,483,0
"2021","Barnsley 027","E02001535",5432,1373,3117,3099,3084,15,18,4,14,101,100,1,492,492,0,349,348,1
"2021","Barnsley 028","E02001536",7308,2485,3256,3251,3247,4,5,4,1,167,164,3,807,804,3,593,593,0
"2021","Barnsley 029","E02001537",6914,2515,3015,3004,2981,23,11,4,7,210,208,2,761,758,3,413,413,0
"2021","Barnsley 030","E02001538",6474,2261,2957,2945,2934,11,12,4,8,163,160,3,603,603,0,490,489,1
"2021","Doncaster 001","E02001539",5175,2003,2251,2243,2235,8,8,4,4,118,118,0,498,496,2,305,305,0
"2021","Doncaster 002","E02001540",9692,3378,4437,4420,4390,30,17,4,13,241,241,0,994,990,4,642,641,1
"2021","Doncaster 003","E02001541",9479,3238,4202,4190,4165,25,12,4,8,226,225,1,1043,1042,1,770,770,0
"2021","Doncaster 004","E02001542",5862,2251,2371,2365,2350,15,6,4,2,192,192,0,616,615,1,432,432,0
"2021","Doncaster 005","E02001543",6323,2261,2698,2685,2682,3,13,4,9,152,151,1,683,681,2,529,527,2
"2021","Doncaster 006","E02001544",6651,2356,2959,2949,2931,18,10,8,2,180,178,2,684,684,0,472,472,0
"2021","Doncaster 007","E02001545",7113,1917,3694,3688,3672,16,6,4,2,143,140,3,780,780,0,579,579,0
"2021","Doncaster 008","E02001546",7778,3084,3249,3236,3221,15,13,4,9,185,184,1,770,770,0,490,490,0
"2021","Doncaster 009","E02001547",8573,3517,3351,3331,3313,18,20,8,12,247,247,0,947,945,2,511,511,0
"2021","Doncaster 010","E02001548",6204,2753,2059,2051,2032,19,8,2,6,227,223,4,753,750,3,412,411,1
"2021","Doncaster 011","E02001549",5085,1570,2517,2513,2502,11,4,2,2,110,110,0,546,546,0,342,340,2
"2021","Doncaster 012","E02001550",6230,2304,2630,2615,2588,27,15,4,11,177,177,0,678,676,2,441,441,0
"2021","Doncaster 013","E02001551",4853,1980,1876,1869,1858,11,7,4,3,143,143,0,577,576,1,277,276,1
"2021","Doncaster 014","E02001552",6088,2289,2458,2453,2441,12,5,2,3,160,158,2,765,763,2,416,414,2
"2021","Doncaster 015","E02001553",8127,3058,3478,3460,3435,25,18,12,6,226,225,1,854,854,0,511,511,0
"2021","Doncaster 016","E02001554",5062,1584,2508,2501,2491,10,7,4,3,102,100,2,509,508,1,359,359,0
"2021","Doncaster 017","E02001555",4510,1184,2412,2403,2399,4,9,6,3,57,57,0,438,438,0,419,419,0
"2021","Doncaster 018","E02001556",7248,2862,2959,2945,2933,12,14,12,2,189,188,1,768,767,1,470,469,1
"2021","Doncaster 019","E02001557",8476,3535,3184,3166,3127,39,18,6,12,245,243,2,982,981,1,530,530,0
"2021","Doncaster 020","E02001558",5192,1358,2801,2795,2787,8,6,4,2,78,76,2,535,533,2,420,420,0
"2021","Doncaster 021","E02001559",6307,1799,3350,3344,3338,6,6,2,4,109,108,1,558,558,0,491,490,1
"2021","Doncaster 022","E02001560",9581,5123,2718,2691,2650,41,27,15,12,301,297,4,1037,1036,1,402,399,3
"2021","Doncaster 023","E02001561",5021,2273,1713,1696,1666,30,17,10,7,168,166,2,612,610,2,255,254,1
"2021","Doncaster 024","E02001562",4699,1629,1936,1917,1906,11,19,16,3,135,135,0,583,582,1,416,416,0
"2021","Doncaster 025","E02001563",6681,1874,3477,3470,3457,13,7,3,4,126,126,0,628,627,1,576,576,0
"2021","Doncaster 026","E02001564",6833,1660,3946,3934,3924,10,12,4,8,116,116,0,619,619,0,492,492,0
"2021","Doncaster 027","E02001565",6586,1770,3813,3796,3788,8,17,4,13,82,81,1,509,506,3,412,411,1
"2021","Doncaster 028","E02001566",6755,2936,2569,2556,2532,24,13,4,9,221,217,4,767,765,2,262,261,1
"2021","Doncaster 029","E02001567",6910,2705,2753,2737,2725,12,16,9,7,175,172,3,806,806,0,471,469,2
"2021","Doncaster 030","E02001568",5469,2137,2219,2204,2192,12,15,8,7,146,145,1,592,591,1,375,375,0
"2021","Doncaster 031","E02001569",7008,3003,2525,2508,2501,7,17,4,13,201,199,2,806,803,3,473,472,1
"2021","Doncaster 032","E02001570",5637,2302,2015,1999,1982,17,16,12,4,186,185,1,680,675,5,454,454,0
"2021","Doncaster 033","E02001571",4993,1549,2542,2532,2522,10,10,2,8,111,111,0,464,464,0,327,326,1
"2021","Doncaster 034","E02001572",6220,2439,2467,2458,2434,24,9,2,7,192,190,2,658,658,0,464,464,0
"2021","Doncaster 035","E02001573",6096,2359,2596,2584,2566,18,12,6,6,175,173,2,522,520,2,444,443,1
"2021","Doncaster 036","E02001574",5017,1399,2668,2657,2632,25,11,5,6,101,100,1,514,513,1,335,334,1
"2021","Doncaster 037","E02001575",6156,2520,2217,2207,2194,13,10,4,6,208,206,2,750,750,0,461,461,0
"2021","Doncaster 038","E02001576",5620,1840,2663,2653,2632,21,10,4,6,135,135,0,627,627,0,355,354,1
"2021","Doncaster 039","E02001577",5607,1337,3069,3051,3037,14,18,9,9,114,113,1,557,556,1,530,530,0
"2021","Rotherham 001","E02001578",9121,3463,3959,3950,3930,20,9,2,7,253,252,1,972,968,4,474,473,1
"2021","Rotherham 002","E02001579",8051,2882,3524,3514,3497,17,10,4,6,206,205,1,768,767,1,671,671,0
"2021","Rotherham 003","E02001580",7134,2556,3187,3178,3161,17,9,4,5,145,144,1,700,698,2,546,546,0
"2021","Rotherham 004","E02001581",5057,1801,2341,2339,2333,6,2,0,2,100,98,2,495,493,2,320,320,0
"2021","Rotherham 005","E02001582",6313,2377,2753,2749,2736,13,4,2,2,147,146,1,615,614,1,421,421,0
"2021","Rotherham 006","E02001583",4419,1771,1852,1845,1833,12,7,2,5,137,135,2,390,389,1,269,269,0
"2021","Rotherham 007","E02001584",5754,1643,3079,3069,3049,20,10,4,6,89,89,0,546,546,0,397,397,0
"2021","Rotherham 008","E02001585",5046,2136,1810,1806,1792,14,4,2,2,144,143,1,581,581,0,375,375,0
"2021","Rotherham 009","E02001586",6693,2736,2393,2368,2355,13,25,8,17,170,169,1,808,804,4,586,586,0
"2021","Rotherham 010","E02001587",4786,2015,1792,1778,1765,13,14,4,10,110,110,0,500,500,0,369,369,0
"2021","Rotherham 011","E02001588",5683,2372,2135,2122,2112,10,13,3,10,130,130,0,598,597,1,448,448,0
"2021","Rotherham 012","E02001589",6559,1984,3378,3369,3356,13,9,2,7,138,137,1,662,661,1,397,397,0
"2021","Rotherham 013","E02001590",5665,2720,1887,1876,1868,8,11,6,5,158,158,0,567,565,2,333,333,0
"2021","Rotherham 014","E02001591",6287,2677,2479,2467,2442,25,12,2,10,199,199,0,580,577,3,352,352,0
"2021","Rotherham 015","E02001592",7166,2560,3357,3346,3337,9,11,4,7,126,123,3,630,629,1,493,493,0
"2021","Rotherham 016","E02001593",5573,2557,1994,1974,1958,16,20,10,10,179,178,1,566,566,0,277,274,3
"2021","Rotherham 017","E02001594",5751,2780,2013,1990,1968,22,23,14,9,177,175,2,496,495,1,285,282,3
"2021","Rotherham 018","E02001595",7012,2185,3554,3549,3538,11,5,0,5,122,122,0,638,638,0,513,513,0
"2021","Rotherham 019","E02001596",6931,2026,3392,3382,3357,25,10,8,2,156,155,1,696,696,0,661,661,0
"2021","Rotherham 020","E02001597",7478,3167,2770,2761,2747,14,9,2,7,203,203,0,809,809,0,529,529,0
"2021","Rotherham 021","E02001598",7827,2537,3823,3821,3803,18,2,1,1,128,127,1,711,711,0,628,627,1
"2021","Rotherham 023","E02001600",8933,2742,4726,4720,4699,21,6,4,2,164,164,0,692,692,0,609,609,0
"2021","Rotherham 025","E02001602",7458,2530,3581,3574,3557,17,7,4,3,149,146,3,629,629,0,569,569,0
"2021","Rotherham 026","E02001603",5970,2174,2698,2683,2661,22,15,6,9,133,131,2,556,556,0,409,409,0
"2021","Rotherham 027","E02001604",9287,3639,4311,4296,4265,31,15,6,9,181,180,1,694,692,2,462,462,0
"2021","Rotherham 028","E02001605",6203,2103,2944,2934,2899,35,10,0,10,120,120,0,637,634,3,399,399,0
"2021","Rotherham 029","E02001606",6545,2354,2855,2852,2839,13,3,0,3,149,149,0,686,683,3,501,501,0
"2021","Rotherham 030","E02001607",7209,2478,3395,3389,3365,24,6,4,2,122,122,0,671,670,1,543,543,0
"2021","Rotherham 031","E02001608",5718,1821,2957,2948,2934,14,9,0,9,109,109,0,469,468,1,362,361,1
"2021","Rotherham 032","E02001609",7145,1958,3855,3845,3830,15,10,2,8,129,129,0,610,609,1,593,593,0
"2021","Rotherham 033","E02001610",7158,2068,3781,3770,3749,21,11,6,5,142,139,3,683,680,3,484,482,2
"2021","Rotherham 034","E02007002",9647,2834,4983,4967,4943,24,16,8,8,171,170,1,962,960,2,697,697,0
"2021","Sheffield 001","E02001611",6383,2211,2949,2932,2921,11,17,4,13,139,139,0,597,596,1,487,487,0
"2021","Sheffield 002","E02001612",4758,1523,2393,2386,2379,7,7,0,7,76,76,0,460,459,1,306,306,0
"2021","Sheffield 003","E02001613",8418,2759,4075,4066,4048,18,9,0,9,164,163,1,781,781,0,639,639,0
"2021","Sheffield 004","E02001614",9373,2868,4830,4820,4812,8,10,2,8,136,136,0,817,817,0,722,722,0
"2021","Sheffield 005","E02001615",6212,1707,3379,3359,3350,9,20,6,14,77,77,0,511,509,2,538,538,0
"2021","Sheffield 006","E02001616",5999,2298,2520,2511,2503,8,9,2,7,116,116,0,565,562,3,500,500,0
"2021","Sheffield 007","E02001617",4338,2024,1491,1483,1467,16,8,4,4,121,121,0,441,441,0,261,261,0
"2021","Sheffield 008","E02001618",7956,2443,4307,4283,4254,29,24,12,12,125,124,1,656,655,1,425,422,3
"2021","Sheffield 009","E02001619",7901,3665,2755,2737,2716,21,18,6,12,197,197,0,775,775,0,509,509,0
"2021","Sheffield 010","E02001620",5238,2286,2009,2003,1997,6,6,0,6,157,157,0,486,484,2,300,300,0
"2021","Sheffield 011","E02001621",4578,2070,1719,1710,1698,12,9,2,7,135,134,1,384,378,6,270,268,2
"2021","Sheffield 012","E02001622",7103,3252,2428,2417,2403,14,11,6,5,174,174,0,730,728,2,519,519,0
"2021","Sheffield 013","E02001623",6247,2734,2314,2295,2287,8,19,6,13,204,201,3,582,581,1,413,413,0
"2021","Sheffield 014","E02001624",7610,3105,3256,3241,3215,26,15,8,7,171,170,1,616,615,1,462,462,0
"2021","Sheffield 015","E02001625",6050,2831,2108,2094,2079,15,14,4,10,161,160,1,572,570,2,378,378,0
"2021","Sheffield 016","E02001626",4817,1722,2328,2315,2299,16,13,0,13,72,72,0,387,387,0,308,308,0
"2021","Sheffield 017","E02001627",5019,2378,1750,1729,1712,17,21,4,17,150,147,3,486,486,0,255,255,0
"2021","Sheffield 018","E02001628",4759,1680,2346,2340,2305,35,6,4,2,128,128,0,306,306,0,299,299,0
"2021","Sheffield 019","E02001629",5063,2309,1830,1824,1815,9,6,0,6,140,140,0,441,440,1,343,343,0
"2021","Sheffield 020","E02001630",6784,2731,3104,3087,3059,28,17,10,7,154,152,2,395,395,0,400,398,2
"2021","Sheffield 021","E02001631",6282,2449,2727,2707,2684,23,20,8,12,136,134,2,575,570,5,395,395,0
"2021","Sheffield 022","E02001632",8870,4214,3422,3406,3377,29,16,10,6,350,346,4,554,553,1,330,328,2
"2021","Sheffield 023","E02001633",6386,1756,3563,3556,3542,14,7,2,5,65,65,0,506,503,3,496,493,3
"2021","Sheffield 024","E02001634",7721,3691,2897,2883,2846,37,14,10,4,148,146,2,618,618,0,367,367,0
"2021","Sheffield 025","E02001635",4999,1793,2198,2194,2180,14,4,2,2,107,106,1,481,479,2,420,420,0
"2021","Sheffield 026","E02001636",7755,4124,2342,2332,2313,19,10,4,6,209,209,0,700,699,1,380,380,0
"2021","Sheffield 027","E02001637",6069,2456,2820,2815,2806,9,5,2,3,168,168,0,325,323,2,300,300,0
"2021","Sheffield 028","E02001638",5194,3833,1021,1006,990,16,15,4,11,45,45,0,179,178,1,116,116,0
"2021","Sheffield 029","E02001639",5099,2642,1699,1691,1674,17,8,8,0,80,80,0,383,383,0,295,295,0
"2021","Sheffield 030","E02001640",7571,5491,1490,1472,1459,13,18,8,10,79,77,2,299,299,0,212,211,1
"2021","Sheffield 032","E02001642",8386,3304,3788,3773,3757,16,15,8,7,183,183,0,616,615,1,495,495,0
"2021","Sheffield 033","E02001643",5044,1272,3012,3000,2990,10,12,6,6,62,61,1,348,348,0,350,350,0
"2021","Sheffield 036","E02001646",7037,5020,1472,1457,1443,14,15,8,7,62,61,1,281,281,0,202,200,2
"2021","Sheffield 037","E02001647",5088,1787,2355,2354,2348,6,1,0,1,117,117,0,447,447,0,382,382,0
"2021","Sheffield 038","E02001648",7300,4079,2401,2376,2360,16,25,6,19,95,95,0,441,439,2,284,282,2
"2021","Sheffield 039","E02001649",8376,4158,2719,2688,2665,23,31,22,9,272,270,2,817,815,2,410,410,0
"2021","Sheffield 040","E02001650",8507,6234,1557,1544,1529,15,13,0,13,134,133,1,378,376,2,204,204,0
"2021","Sheffield 041","E02001651",6514,1429,4181,4165,4154,11,16,6,10,86,86,0,374,373,1,444,443,1
"2021","Sheffield 042","E02001652",11533,8754,2104,2093,2064,29,11,4,7,141,139,2,330,328,2,204,203,1
"2021","Sheffield 043","E02001653",5948,3149,1847,1834,1821,13,13,5,8,171,170,1,492,491,1,289,289,0
"2021","Sheffield 044","E02001654",5206,1847,2388,2381,2363,18,7,2,5,95,95,0,386,385,1,490,490,0
"2021","Sheffield 045","E02001655",6079,2555,2433,2430,2419,11,3,0,3,150,146,4,555,552,3,386,385,1
"2021","Sheffield 046","E02001656",6456,3161,2582,2562,2550,12,20,7,13,80,77,3,394,394,0,239,239,0
"2021","Sheffield 047","E02001657",7159,2412,3842,3822,3794,28,20,14,6,97,94,3,505,504,1,303,303,0
"2021","Sheffield 048","E02001658",3978,1940,1284,1276,1270,6,8,6,2,147,146,1,362,361,1,245,245,0
"2021","Sheffield 049","E02001659",4867,2076,1706,1700,1692,8,6,0,6,129,128,1,541,540,1,415,415,0
"2021","Sheffield 050","E02001660",8114,3672,3300,3274,3242,32,26,6,20,137,137,0,628,627,1,377,376,1
"2021","Sheffield 051","E02001661",6146,2900,1989,1971,1958,13,18,4,14,232,231,1,652,650,2,373,371,2
"2021","Sheffield 052","E02001662",6232,2442,2535,2534,2525,9,1,0,1,129,128,1,596,596,0,530,530,0
"2021","Sheffield 053","E02001663",6049,2969,2225,2184,2162,22,41,10,31,124,124,0,503,501,2,228,227,1
"2021","Sheffield 054","E02001664",5157,1852,2371,2364,2355,9,7,2,5,112,112,0,428,428,0,394,394,0
"2021","Sheffield 055","E02001665",7887,1825,4945,4922,4905,17,23,10,13,84,83,1,477,476,1,556,555,1
"2021","Sheffield 056","E02001666",4813,1924,2026,2021,2013,8,5,0,5,90,89,1,482,482,0,291,291,0
"2021","Sheffield 059","E02001669",6464,2792,2545,2524,2491,33,21,8,13,161,160,1,606,602,4,360,359,1
"2021","Sheffield 060","E02001670",4658,2214,1493,1480,1475,5,13,8,5,129,129,0,468,467,1,354,354,0
"2021","Sheffield 061","E02001671",4925,1420,2578,2569,2561,8,9,7,2,84,84,0,436,434,2,407,406,1
"2021","Sheffield 062","E02001672",5022,1878,2185,2183,2165,18,2,0,2,99,95,4,467,466,1,393,393,0
"2021","Sheffield 063","E02001673",4318,1313,2365,2363,2359,4,2,2,0,79,79,0,311,311,0,250,250,0
"2021","Sheffield 064","E02001674",7606,2286,4060,4042,4024,18,18,8,10,105,105,0,566,565,1,589,588,1
"2021","Sheffield 065","E02001675",7121,2502,3098,3083,3069,14,15,6,9,165,164,1,797,796,1,559,558,1
"2021","Sheffield 066","E02001676",4921,1295,2813,2793,2777,16,20,6,14,61,61,0,397,394,3,355,355,0
"2021","Sheffield 068","E02001678",8546,1896,5123,5107,5088,19,16,4,12,127,127,0,691,690,1,709,708,1
"2021","Sheffield 069","E02001679",4970,2103,1823,1818,1814,4,5,2,3,128,126,2,566,564,2,350,350,0
"2021","Sheffield 070","E02001680",4901,2390,1409,1403,1387,16,6,4,2,166,164,2,610,609,1,326,326,0
"2021","Sheffield 071","E02001681",6251,1712,3444,3434,3424,10,10,4,6,90,90,0,551,551,0,454,454,0
"2021","Sheffield 072","E02006803",7730,2473,4044,4024,4014,10,20,4,16,112,110,2,650,649,1,451,451,0
"2021","Sheffield 073","E02006843",10168,8655,1169,1151,1136,15,18,2,16,94,93,1,204,202,2,46,46,0
"2021","Sheffield 074","E02006844",7270,5957,922,917,910,7,5,2,3,97,97,0,196,196,0,98,97,1
"2021","Sheffield 075","E02006868",9861,5461,2992,2977,2935,42,15,2,13,232,229,3,725,724,1,451,449,2
"2021","Sheffield 076","E02006869",9087,3604,3786,3776,3749,27,10,6,4,174,171,3,886,886,0,637,637,0
"2021","Bradford 001","E02002183",4973,1088,2728,2718,2694,24,10,6,4,79,79,0,556,556,0,522,521,1
"2021","Bradford 002","E02002184",10923,2816,5913,5892,5874,18,21,5,16,196,195,1,932,932,0,1066,1065,1
"2021","Bradford 003","E02002185",4750,1254,2666,2656,2647,9,10,6,4,79,78,1,443,442,1,308,308,0
"2021","Bradford 005","E02002187",5018,1163,3045,3041,3031,10,4,0,4,95,95,0,378,377,1,337,336,1
"2021","Bradford 006","E02002188",6303,1874,3319,3297,3287,10,22,0,22,130,129,1,567,567,0,413,413,0
"2021","Bradford 007","E02002189",5467,1772,2805,2801,2791,10,4,0,4,112,112,0,405,405,0,373,373,0
"2021","Bradford 008","E02002190",8975,3410,4038,4033,4008,25,5,1,4,249,246,3,796,793,3,482,481,1
"2021","Bradford 009","E02002191",7130,2880,2884,2870,2862,8,14,6,8,276,272,4,710,709,1,380,380,0
"2021","Bradford 010","E02002192",7640,1898,4336,4330,4313,17,6,2,4,128,128,0,688,685,3,590,590,0
"2021","Bradford 011","E02002193",5124,2267,1686,1679,1658,21,7,2,5,171,170,1,689,689,0,311,310,1
"2021","Bradford 012","E02002194",5914,2211,2627,2624,2608,16,3,2,1,113,111,2,582,580,2,381,381,0
"2021","Bradford 013","E02002195",5387,1294,3054,3047,3039,8,7,0,7,117,116,1,535,534,1,387,386,1
"2021","Bradford 014","E02002196",5176,1723,2541,2532,2517,15,9,2,7,112,112,0,513,512,1,287,286,1
"2021","Bradford 015","E02002197",7197,2743,2724,2715,2697,18,9,4,5,208,206,2,943,942,1,579,579,0
"2021","Bradford 016","E02002198",6911,2379,3046,3040,3029,11,6,2,4,166,165,1,772,771,1,548,546,2
"2021","Bradford 017","E02002199",6014,1882,3030,3020,2992,28,10,2,8,114,113,1,603,600,3,385,384,1
"2021","Bradford 018","E02002200",7460,2533,3556,3542,3516,26,14,8,6,192,189,3,650,647,3,529,529,0
"2021","Bradford 019","E02002201",9913,3872,4161,4144,4116,28,17,4,13,257,256,1,1043,1040,3,580,580,0
"2021","Bradford 020","E02002202",6196,2946,2072,2050,2030,20,22,6,16,185,184,1,633,631,2,360,359,1
"2021","Bradford 021","E02002203",6132,2684,2249,2243,2237,6,6,0,6,183,180,3,658,658,0,358,358,0
"2021","Bradford 022","E02002204",9492,2791,4839,4823,4791,32,16,6,10,176,175,1,929,928,1,757,757,0
"2021","Bradford 023","E02002205",8312,2638,4020,4005,3985,20,15,7,8,168,168,0,930,925,5,556,555,1
"2021","Bradford 024","E02002206",6973,2552,3144,3126,3102,24,18,6,12,181,181,0,620,620,0,476,476,0
"2021","Bradford 025","E02002207",5685,2166,2711,2699,2680,19,12,6,6,169,165,4,366,366,0,273,273,0
"2021","Bradford 026","E02002208",6328,2665,2376,2369,2349,20,7,3,4,170,170,0,657,656,1,460,460,0
"2021","Bradford 027","E02002209",4966,2264,1854,1842,1824,18,12,6,6,160,160,0,498,497,1,190,190,0
"2021","Bradford 028","E02002210",5959,2062,2890,2886,2876,10,4,2,2,154,154,0,471,471,0,382,382,0
"2021","Bradford 029","E02002211",5911,2147,2981,2977,2966,11,4,0,4,118,118,0,350,350,0,315,314,1
"2021","Bradford 030","E02002212",6381,2174,3410,3405,3392,13,5,2,3,195,195,0,356,356,0,246,245,1
"2021","Bradford 031","E02002213",6232,2021,3005,2998,2965,33,7,2,5,157,157,0,695,695,0,354,354,0
"2021","Bradford 032","E02002214",4958,1826,2321,2319,2304,15,2,2,0,134,134,0,416,415,1,261,260,1
"2021","Bradford 033","E02002215",8044,2959,4071,4065,4056,9,6,6,0,216,216,0,417,417,0,381,381,0
"2021","Bradford 034","E02002216",7626,2922,3602,3600,3575,25,2,0,2,245,244,1,516,515,1,341,340,1
"2021","Bradford 035","E02002217",7434,2975,3310,3294,3280,14,16,10,6,241,239,2,544,544,0,364,363,1
"2021","Bradford 036","E02002218",7606,2824,3487,3473,3460,13,14,12,2,212,212,0,658,658,0,425,424,1
"2021","Bradford 037","E02002219",5856,2067,3130,3115,3108,7,15,12,3,189,189,0,248,248,0,222,222,0
"2021","Bradford 038","E02002220",6820,2456,3529,3524,3513,11,5,2,3,188,185,3,366,366,0,281,281,0
"2021","Bradford 040","E02002222",6607,2377,3092,3079,3069,10,13,10,3,270,270,0,481,481,0,387,387,0
"2021","Bradford 041","E02002223",5587,2185,2672,2664,2656,8,8,6,2,183,183,0,300,300,0,247,245,2
"2021","Bradford 042","E02002224",7700,2693,4058,4046,4040,6,12,0,12,215,214,1,364,364,0,370,370,0
"2021","Bradford 043","E02002225",6857,2390,3092,3076,3060,16,16,4,12,166,164,2,782,778,4,427,426,1
"2021","Bradford 044","E02002226",10695,4982,4630,4626,4596,30,4,0,4,263,263,0,452,452,0,368,367,1
"2021","Bradford 045","E02002227",4593,2050,1758,1754,1726,28,4,2,2,156,156,0,377,374,3,252,251,1
"2021","Bradford 046","E02002228",5605,2632,1869,1852,1843,9,17,14,3,210,209,1,597,597,0,297,297,0
"2021","Bradford 047","E02002229",6476,2545,2747,2737,2715,22,10,4,6,184,184,0,591,590,1,409,408,1
"2021","Bradford 048","E02002230",6052,2514,2685,2680,2652,28,5,1,4,167,167,0,426,425,1,260,260,0
"2021","Bradford 049","E02002231",9992,3631,4813,4806,4786,20,7,4,3,285,285,0,708,706,2,555,554,1
"2021","Bradford 050","E02002232",5264,2053,2293,2280,2270,10,13,4,9,193,193,0,440,440,0,285,285,0
"2021","Bradford 051","E02002233",6827,2754,3234,3233,3230,3,1,0,1,214,214,0,354,354,0,271,271,0
"2021","Bradford 052","E02002234",5467,2876,1470,1455,1448,7,15,10,5,219,219,0,590,590,0,312,311,1
"2021","Bradford 053","E02002235",5095,2028,2331,2319,2309,10,12,6,6,169,169,0,368,368,0,199,199,0
"2021","Bradford 054","E02002236",5010,1748,2380,2364,2358,6,16,9,7,126,124,2,437,436,1,319,318,1
"2021","Bradford 055","E02002237",6640,2735,2817,2805,2793,12,12,6,6,154,152,2,585,585,0,349,348,1
"2021","Bradford 056","E02002238",4858,2056,1822,1818,1810,8,4,2,2,154,154,0,504,503,1,322,322,0
"2021","Bradford 057","E02002239",8281,3357,3440,3412,3392,20,28,10,18,287,286,1,753,753,0,444,444,0
"2021","Bradford 058","E02002240",9357,3308,4390,4373,4355,18,17,4,13,247,246,1,868,868,0,544,544,0
"2021","Bradford 059","E02002241",9356,3968,3556,3537,3476,61,19,8,11,267,266,1,928,927,1,637,637,0
"2021","Bradford 060","E02002242",6538,2322,2964,2952,2941,11,12,1,11,133,133,0,639,636,3,480,480,0
"2021","Bradford 061","E02002243",7631,3053,3072,3064,3056,8,8,2,6,168,166,2,828,825,3,510,510,0
"2021","Bradford 062","E02006945",7288,2142,3856,3843,3824,19,13,2,11,130,127,3,657,657,0,503,502,1
"2021","Bradford 063","E02006946",4342,1515,1881,1863,1857,6,18,6,12,120,120,0,508,508,0,318,318,0
"2021","Bradford 064","E02006947",7277,3085,3224,3212,3203,9,12,8,4,245,243,2,418,416,2,305,305,0
"2021","Bradford 065","E02006948",4983,2456,1888,1886,1878,8,2,0,2,198,197,1,300,300,0,141,140,1
"2021","Calderdale 001","E02002244",5003,1663,2380,2376,2366,10,4,0,4,107,106,1,480,480,0,373,373,0
"2021","Calderdale 002","E02002245",4063,1945,1353,1346,1333,13,7,2,5,120,120,0,440,436,4,205,204,1
"2021","Calderdale 003","E02002246",8037,2397,4127,4119,4113,6,8,3,5,172,170,2,764,762,2,577,575,2
"2021","Calderdale 004","E02002247",7507,2773,3210,3118,3031,87,92,12,80,158,157,1,939,919,20,427,424,3
"2021","Calderdale 005","E02002248",6088,2688,2194,2184,2175,9,10,10,0,166,165,1,670,670,0,370,369,1
"2021","Calderdale 006","E02002249",4234,2030,1363,1358,1346,12,5,0,5,129,128,1,462,462,0,250,250,0
"2021","Calderdale 007","E02002250",6907,2271,3208,3167,3113,54,41,6,35,175,173,2,791,789,2,462,461,1
"2021","Calderdale 008","E02002251",6722,3024,2139,2121,2090,31,18,6,12,207,207,0,856,851,5,496,496,0
"2021","Calderdale 009","E02002252",5379,1698,2764,2752,2725,27,12,0,12,98,97,1,456,455,1,363,362,1
"2021","Calderdale 010","E02002253",6168,2386,2742,2729,2716,13,13,7,6,203,203,0,510,510,0,327,327,0
"2021","Calderdale 011","E02002254",5129,1566,2567,2559,2544,15,8,2,6,99,98,1,520,519,1,377,375,2
"2021","Calderdale 012","E02002255",5677,2007,2752,2743,2731,12,9,7,2,215,214,1,375,375,0,328,328,0
"2021","Calderdale 013","E02002256",7617,3169,2914,2865,2825,40,49,10,39,186,181,5,881,864,17,467,466,1
"2021","Calderdale 014","E02002257",4717,1736,2306,2297,2286,11,9,6,3,164,163,1,324,321,3,187,187,0
"2021","Calderdale 015","E02002258",7291,2528,3359,3345,3316,29,14,4,10,193,193,0,746,743,3,465,465,0
"2021","Calderdale 016","E02002259",5794,2030,2546,2538,2523,15,8,3,5,163,161,2,663,663,0,392,391,1
"2021","Calderdale 017","E02002260",7532,3043,2896,2880,2863,17,16,3,13,214,213,1,952,950,2,427,426,1
"2021","Calderdale 018","E02002261",6482,2452,2702,2692,2683,9,10,4,6,151,150,1,773,770,3,404,402,2
"2021","Calderdale 019","E02002262",6440,2266,2797,2791,2779,12,6,2,4,159,159,0,671,668,3,547,547,0
"2021","Calderdale 020","E02002263",5198,1813,2311,2297,2281,16,14,2,12,128,126,2,623,623,0,323,323,0
"2021","Calderdale 021","E02002264",5734,1663,2955,2936,2924,12,19,6,13,111,111,0,553,551,2,452,452,0
"2021","Calderdale 022","E02002265",4663,1719,1923,1902,1886,16,21,2,19,118,115,3,549,544,5,354,354,0
"2021","Calderdale 023","E02002266",4784,1537,2333,2328,2318,10,5,0,5,114,113,1,451,450,1,349,349,0
"2021","Calderdale 024","E02002267",6547,2236,2984,2972,2957,15,12,2,10,159,157,2,703,697,6,465,465,0
"2021","Calderdale 025","E02002268",8309,3131,3362,3349,3321,28,13,2,11,226,223,3,984,978,6,606,605,1
"2021","Calderdale 026","E02002269",7696,2552,3707,3692,3666,26,15,4,11,176,175,1,805,801,4,456,456,0
"2021","Calderdale 027","E02002270",6935,2001,3770,3760,3738,22,10,2,8,140,139,1,678,676,2,346,346,0
"2021","Kirklees 001","E02002271",6102,1945,3038,3030,3015,15,8,2,6,108,108,0,582,580,2,429,429,0
"2021","Kirklees 002","E02002272",7719,2843,3374,3366,3351,15,8,0,8,210,208,2,821,817,4,471,471,0
"2021","Kirklees 003","E02002273",5389,1828,2603,2599,2583,16,4,2,2,100,100,0,507,507,0,351,350,1
"2021","Kirklees 004","E02002274",5530,1804,2736,2733,2725,8,3,0,3,120,120,0,483,481,2,387,387,0
"2021","Kirklees 005","E02002275",7008,2665,2758,2748,2739,9,10,4,6,221,218,3,849,848,1,515,515,0
"2021","Kirklees 006","E02002276",6064,2247,2805,2797,2791,6,8,6,2,131,129,2,542,540,2,339,339,0
"2021","Kirklees 007","E02002277",5371,1878,2693,2690,2678,12,3,0,3,107,106,1,378,377,1,315,315,0
"2021","Kirklees 008","E02002278",5315,1932,2374,2367,2352,15,7,1,6,121,120,1,543,543,0,345,345,0
"2021","Kirklees 009","E02002279",4998,1981,1967,1963,1949,14,4,2,2,143,143,0,574,572,2,333,332,1
"2021","Kirklees 010","E02002280",5288,2078,2321,2317,2309,8,4,4,0,144,144,0,461,461,0,284,284,0
"2021","Kirklees 011","E02002281",9017,3039,4410,4396,4381,15,14,12,2,233,232,1,773,773,0,562,561,1
"2021","Kirklees 012","E02002282",5581,1974,2878,2869,2858,11,9,6,3,136,136,0,355,355,0,238,238,0
"2021","Kirklees 013","E02002283",5621,1988,2924,2924,2911,13,0,0,0,121,121,0,307,307,0,281,279,2
"2021","Kirklees 014","E02002284",5068,1747,2398,2387,2380,7,11,6,5,113,109,4,470,470,0,340,340,0
"2021","Kirklees 015","E02002285",6533,2054,3222,3222,3208,14,0,0,0,136,135,1,654,653,1,467,467,0
"2021","Kirklees 016","E02002286",4715,1730,2190,2178,2159,19,12,4,8,132,130,2,405,404,1,258,258,0
"2021","Kirklees 017","E02002287",5617,2232,2445,2432,2420,12,13,10,3,190,187,3,455,455,0,295,294,1
"2021","Kirklees 018","E02002288",7885,3133,3244,3240,3218,22,4,0,4,209,207,2,800,797,3,499,499,0
"2021","Kirklees 019","E02002289",5056,1885,2532,2521,2515,6,11,8,3,140,138,2,308,308,0,191,191,0
"2021","Kirklees 020","E02002290",5224,1489,2733,2729,2713,16,4,2,2,114,113,1,491,490,1,397,397,0
"2021","Kirklees 021","E02002291",5316,1746,2602,2599,2590,9,3,0,3,114,113,1,481,481,0,373,373,0
"2021","Kirklees 022","E02002292",4620,1493,2340,2332,2318,14,8,4,4,115,115,0,359,358,1,313,312,1
"2021","Kirklees 023","E02002293",6281,2315,3169,3162,3155,7,7,4,3,181,180,1,390,390,0,226,226,0
"2021","Kirklees 024","E02002294",8407,2901,4503,4498,4491,7,5,2,3,165,161,4,434,434,0,404,404,0
"2021","Kirklees 025","E02002295",5410,2569,1809,1806,1787,19,3,0,3,175,174,1,571,568,3,286,284,2
"2021","Kirklees 026","E02002296",5825,1867,2700,2698,2678,20,2,2,0,147,145,2,611,610,1,500,500,0
"2021","Kirklees 027","E02002297",5705,1743,3050,3040,3038,2,10,2,8,95,93,2,494,494,0,323,322,1
"2021","Kirklees 028","E02002298",5412,1921,2418,2411,2406,5,7,1,6,105,104,1,573,570,3,395,395,0
"2021","Kirklees 029","E02002299",5563,2992,1675,1672,1658,14,3,0,3,184,183,1,454,453,1,258,257,1
"2021","Kirklees 030","E02002300",6871,2114,3509,3498,3483,15,11,4,7,110,110,0,629,626,3,509,509,0
"2021","Kirklees 031","E02002301",6113,2453,2764,2761,2743,18,3,0,3,152,147,5,475,475,0,269,269,0
"2021","Kirklees 032","E02002302",5026,1499,2608,2600,2586,14,8,0,8,98,97,1,475,474,1,346,345,1
"2021","Kirklees 033","E02002303",5358,1936,2389,2381,2369,12,8,4,4,132,130,2,496,495,1,405,404,1
"2021","Kirklees 034","E02002304",5560,2735,1918,1900,1894,6,18,4,14,138,135,3,471,466,5,298,298,0
"2021","Kirklees 035","E02002305",4840,2210,1706,1696,1680,16,10,4,6,129,127,2,512,507,5,283,283,0
"2021","Kirklees 036","E02002306",5210,1555,2672,2666,2653,13,6,0,6,101,99,2,506,506,0,376,376,0
"2021","Kirklees 037","E02002307",4792,1827,1963,1957,1945,12,6,4,2,131,129,2,534,534,0,337,337,0
"2021","Kirklees 038","E02002308",5528,2193,2317,2303,2295,8,14,0,14,146,146,0,597,597,0,275,275,0
"2021","Kirklees 039","E02002309",5405,2461,2086,2071,2057,14,15,8,7,128,128,0,464,463,1,266,266,0
"2021","Kirklees 040","E02002310",4692,2043,1713,1698,1676,22,15,8,7,133,133,0,473,473,0,330,330,0
"2021","Kirklees 041","E02002311",5270,2067,2106,2085,2078,7,21,4,17,143,140,3,624,622,2,330,329,1
"2021","Kirklees 042","E02002312",6910,4376,1658,1648,1635,13,10,4,6,125,123,2,514,513,1,237,236,1
"2021","Kirklees 043","E02002313",5772,2292,2689,2684,2667,17,5,0,5,144,144,0,391,390,1,256,256,0
"2021","Kirklees 044","E02002314",4835,1615,2224,2217,2200,17,7,3,4,113,112,1,465,463,2,418,418,0
"2021","Kirklees 045","E02002315",5422,2373,1972,1964,1950,14,8,4,4,172,172,0,630,630,0,275,275,0
"2021","Kirklees 046","E02002316",5603,1729,2848,2838,2830,8,10,0,10,92,91,1,557,556,1,377,377,0
"2021","Kirklees 047","E02002317",5673,2207,2483,2477,2468,9,6,2,4,163,162,1,479,477,2,341,341,0
"2021","Kirklees 048","E02002318",5101,2054,1942,1934,1913,21,8,2,6,131,131,0,578,577,1,396,394,2
"2021","Kirklees 049","E02002319",5664,2132,2440,2425,2403,22,15,2,13,137,136,1,613,610,3,342,341,1
"2021","Kirklees 050","E02002320",5110,1693,2364,2356,2344,12,8,2,6,107,104,3,558,558,0,388,387,1
"2021","Kirklees 051","E02002321",5736,1999,2825,2814,2785,29,11,0,11,90,88,2,476,474,2,346,346,0
"2021","Kirklees 052","E02002322",5258,1681,2605,2583,2563,20,22,8,14,120,120,0,519,518,1,333,333,0
"2021","Kirklees 053","E02002323",6822,1947,3523,3506,3488,18,17,5,12,140,139,1,705,705,0,507,505,2
"2021","Kirklees 054","E02002324",5477,1564,2855,2837,2822,15,18,6,12,104,104,0,506,506,0,448,448,0
"2021","Kirklees 055","E02002325",7437,2300,3661,3654,3635,19,7,4,3,134,132,2,775,774,1,567,567,0
"2021","Kirklees 056","E02002326",4890,1285,2819,2809,2799,10,10,4,6,76,76,0,432,432,0,278,278,0
"2021","Kirklees 057","E02002327",8328,2299,4523,4498,4483,15,25,12,13,142,142,0,749,748,1,615,615,0
"2021","Kirklees 058","E02002328",5858,1628,3153,3145,3125,20,8,2,6,99,98,1,582,580,2,396,394,2
"2021","Kirklees 059","E02002329",10061,3005,5179,5154,5131,23,25,4,21,192,190,2,1099,1095,4,586,585,1
"2021","Leeds 001","E02002330",5878,1302,3641,3638,3633,5,3,2,1,79,79,0,449,449,0,407,407,0
"2021","Leeds 002","E02002331",6366,2343,2615,2603,2582,21,12,0,12,159,159,0,678,675,3,571,571,0
"2021","Leeds 003","E02002332",5298,1650,2667,2663,2656,7,4,2,2,99,99,0,498,497,1,384,384,0
"2021","Leeds 004","E02002333",6596,2140,3074,3068,3050,18,6,1,5,115,115,0,752,752,0,515,514,1
"2021","Leeds 005","E02002334",6213,1563,3471,3452,3439,13,19,10,9,117,116,1,561,560,1,501,501,0
"2021","Leeds 006","E02002335",6160,1298,3980,3963,3941,22,17,2,15,93,93,0,420,419,1,369,368,1
"2021","Leeds 007","E02002336",5684,1382,3404,3393,3386,7,11,6,5,77,76,1,416,414,2,405,404,1
"2021","Leeds 008","E02002337",6254,1718,3597,3583,3574,9,14,3,11,111,111,0,467,466,1,361,361,0
"2021","Leeds 009","E02002338",5850,1834,2932,2920,2897,23,12,2,10,97,97,0,567,567,0,420,418,2
"2021","Leeds 010","E02002339",4571,1847,1751,1751,1739,12,0,0,0,114,113,1,551,551,0,308,306,2
"2021","Leeds 011","E02002340",4965,1627,2288,2285,2267,18,3,0,3,114,112,2,515,512,3,421,421,0
"2021","Leeds 012","E02002341",5980,1372,3714,3705,3696,9,9,5,4,72,70,2,398,398,0,424,422,2
"2021","Leeds 013","E02002342",4983,1558,2550,2544,2530,14,6,0,6,73,73,0,422,418,4,380,379,1
"2021","Leeds 014","E02002343",4806,1528,2530,2524,2499,25,6,0,6,68,67,1,401,401,0,279,278,1
"2021","Leeds 015","E02002344",6338,1693,3506,3500,3488,12,6,0,6,107,105,2,554,553,1,478,478,0
"2021","Leeds 016","E02002345",5093,1411,2990,2980,2964,16,10,4,6,58,58,0,307,307,0,327,326,1
"2021","Leeds 017","E02002346",4912,1973,2095,2085,2068,17,10,2,8,117,117,0,428,427,1,299,299,0
"2021","Leeds 018","E02002347",4888,1859,2103,2096,2090,6,7,0,7,133,132,1,502,500,2,291,291,0
"2021","Leeds 019","E02002348",5259,1954,2355,2344,2317,27,11,2,9,116,113,3,487,487,0,347,347,0
"2021","Leeds 020","E02002349",4743,1681,2330,2287,2265,22,43,2,41,72,72,0,400,400,0,260,260,0
"2021","Leeds 021","E02002350",5423,1849,2867,2860,2851,9,7,0,7,41,41,0,296,295,1,370,370,0
"2021","Leeds 022","E02002351",4637,1132,2772,2763,2754,9,9,3,6,55,55,0,365,365,0,313,312,1
"2021","Leeds 023","E02002352",6325,2128,3223,3213,3191,22,10,4,6,104,102,2,449,448,1,421,421,0
"2021","Leeds 024","E02002353",4736,1627,2484,2467,2448,19,17,2,15,81,81,0,316,315,1,228,227,1
"2021","Leeds 025","E02002354",6499,2209,3175,3167,3153,14,8,4,4,158,158,0,508,508,0,449,449,0
"2021","Leeds 027","E02002356",7269,2380,3847,3840,3814,26,7,0,7,119,119,0,548,548,0,375,375,0
"2021","Leeds 028","E02002357",6717,2840,2687,2674,2659,15,13,4,9,152,152,0,624,624,0,414,414,0
"2021","Leeds 029","E02002358",6803,2577,3064,3059,3037,22,5,2,3,136,136,0,609,609,0,417,417,0
"2021","Leeds 030","E02002359",5392,1383,2990,2978,2964,14,12,4,8,104,104,0,497,496,1,418,418,0
"2021","Leeds 031","E02002360",5620,2554,2177,2170,2142,28,7,4,3,116,115,1,496,495,1,277,277,0
"2021","Leeds 032","E02002361",4707,1866,2169,2151,2127,24,18,6,12,82,82,0,346,344,2,244,243,1
"2021","Leeds 033","E02002362",6419,3065,2183,2180,2165,15,3,0,3,166,166,0,685,684,1,320,320,0
"2021","Leeds 034","E02002363",6154,3200,2097,2074,2032,42,23,8,15,125,123,2,448,447,1,284,284,0
"2021","Leeds 035","E02002364",4709,2295,1297,1287,1283,4,10,8,2,182,181,1,599,599,0,336,336,0
"2021","Leeds 037","E02002366",6616,2349,3265,3256,3243,13,9,2,7,120,119,1,416,415,1,466,465,1
"2021","Leeds 038","E02002367",4959,2546,1520,1514,1495,19,6,2,4,164,164,0,486,484,2,243,243,0
"2021","Leeds 039","E02002368",6950,2288,3521,3498,3473,25,23,4,19,124,124,0,599,591,8,418,418,0
"2021","Leeds 040","E02002369",6012,2817,2100,2082,2069,13,18,6,12,204,204,0,579,579,0,312,312,0
"2021","Leeds 041","E02002370",5460,2643,1759,1754,1739,15,5,4,1,139,139,0,577,577,0,342,341,1
"2021","Leeds 042","E02002371",8421,4571,2575,2559,2531,28,16,11,5,246,245,1,645,644,1,384,384,0
"2021","Leeds 044","E02002373",8145,7133,700,677,665,12,23,10,13,45,45,0,161,160,1,106,106,0
"2021","Leeds 045","E02002374",5822,3369,1721,1703,1682,21,18,8,10,102,99,3,375,375,0,255,255,0
"2021","Leeds 046","E02002375",5084,2789,1479,1469,1456,13,10,6,4,138,137,1,461,457,4,217,217,0
"2021","Leeds 047","E02002376",5605,2473,2342,2336,2334,2,6,2,4,169,167,2,395,395,0,226,225,1
"2021","Leeds 048","E02002377",5589,2598,2355,2349,2339,10,6,4,2,159,158,1,249,249,0,228,228,0
"2021","Leeds 050","E02002379",4365,2247,1391,1386,1372,14,5,4,1,116,115,1,385,385,0,226,226,0
"2021","Leeds 051","E02002380",4585,1846,1911,1904,1902,2,7,2,5,114,114,0,421,421,0,293,292,1
"2021","Leeds 052","E02002381",5201,2352,1868,1861,1843,18,7,2,5,168,168,0,551,551,0,262,262,0
"2021","Leeds 053","E02002382",4900,2173,1997,1983,1969,14,14,10,4,214,211,3,327,327,0,189,188,1
"2021","Leeds 054","E02002383",7686,6878,577,577,570,7,0,0,0,43,42,1,129,129,0,59,59,0
"2021","Leeds 055","E02002384",10253,7238,2056,2032,2013,19,24,6,18,245,245,0,508,507,1,206,206,0
"2021","Leeds 056","E02002385",7727,6031,1096,1079,1058,21,17,8,9,116,113,3,331,328,3,153,153,0
"2021","Leeds 057","E02002386",7768,2513,3819,3814,3791,23,5,0,5,123,122,1,674,673,1,639,639,0
"2021","Leeds 058","E02002387",4797,2433,1401,1392,1367,25,9,6,3,139,138,1,536,534,2,288,287,1
"2021","Leeds 059","E02002388",6287,3161,2080,2058,2052,6,22,10,12,166,166,0,588,583,5,292,292,0
"2021","Leeds 060","E02002389",5675,2522,2093,2074,2060,14,19,4,15,187,187,0,531,528,3,342,342,0
"2021","Leeds 061","E02002390",5729,2623,2135,2116,2101,15,19,4,15,143,141,2,523,523,0,305,305,0
"2021","Leeds 062","E02002391",6476,2534,2783,2775,2756,19,8,2,6,129,127,2,648,646,2,382,381,1
"2021","Leeds 063","E02002392",9491,8411,755,751,744,7,4,4,0,70,70,0,174,174,0,81,80,1
"2021","Leeds 064","E02002393",6672,3242,2358,2339,2323,16,19,10,9,311,311,0,543,542,1,218,217,1
"2021","Leeds 065","E02002394",5576,2893,1718,1703,1688,15,15,14,1,245,243,2,518,516,2,202,200,2
"2021","Leeds 066","E02002395",5810,1907,2967,2960,2948,12,7,2,5,118,118,0,396,395,1,422,422,0
"2021","Leeds 067","E02002396",7521,3494,2748,2729,2707,22,19,10,9,191,189,2,666,664,2,422,421,1
"2021","Leeds 068","E02002397",6246,2508,2551,2543,2519,24,8,2,6,170,170,0,649,648,1,368,368,0
"2021","Leeds 069","E02002398",6351,2074,3190,3186,3168,18,4,2,2,110,110,0,513,513,0,464,464,0
"2021","Leeds 070","E02002399",4911,2422,1692,1683,1672,11,9,4,5,139,139,0,406,405,1,252,252,0
"2021","Leeds 071","E02002400",7713,4381,1972,1956,1929,27,16,6,10,276,274,2,777,775,2,307,305,2
"2021","Leeds 072","E02002401",4819,2452,1555,1539,1532,7,16,10,6,160,159,1,405,405,0,247,247,0
"2021","Leeds 073","E02002402",4895,1536,2599,2597,2587,10,2,0,2,85,84,1,362,361,1,313,312,1
"2021","Leeds 074","E02002403",5329,1796,2366,2366,2357,9,0,0,0,104,103,1,564,564,0,499,499,0
"2021","Leeds 075","E02002404",9066,5943,2060,2045,2017,28,15,8,7,199,199,0,568,565,3,296,296,0
"2021","Leeds 076","E02002405",7256,2464,3478,3469,3451,18,9,2,7,159,159,0,607,607,0,548,548,0
"2021","Leeds 077","E02002406",5982,1645,3400,3397,3385,12,3,0,3,73,73,0,479,478,1,385,385,0
"2021","Leeds 078","E02002407",4904,2573,1313,1308,1299,9,5,0,5,184,183,1,561,558,3,273,272,1
"2021","Leeds 079","E02002408",6217,2390,2571,2562,2549,13,9,2,7,178,176,2,635,634,1,443,443,0
"2021","Leeds 080","E02002409",4918,2021,1927,1909,1892,17,18,8,10,126,125,1,540,540,0,304,303,1
"2021","Leeds 081","E02002410",5739,2455,2233,2218,2197,21,15,2,13,123,121,2,564,562,2,364,363,1
"2021","Leeds 082","E02002411",7278,4363,1930,1905,1898,7,25,14,11,186,182,4,569,566,3,230,229,1
"2021","Leeds 083","E02002412",5878,2466,2421,2412,2395,17,9,6,3,132,129,3,523,521,2,336,336,0
"2021","Leeds 085","E02002414",5048,2391,1702,1689,1680,9,13,8,5,192,192,0,528,528,0,235,235,0
"2021","Leeds 086","E02002415",5589,2765,2042,2029,2019,10,13,8,5,204,203,1,430,429,1,148,148,0
"2021","Leeds 087","E02002416",5750,1761,2834,2827,2817,10,7,4,3,93,93,0,569,569,0,493,493,0
"2021","Leeds 088","E02002417",5914,2099,2763,2763,2740,23,0,0,0,122,120,2,498,496,2,432,429,3
"2021","Leeds 089","E02002418",5811,1930,2856,2843,2831,12,13,4,9,105,105,0,559,559,0,361,361,0
"2021","Leeds 090","E02002419",6312,2733,2340,2331,2311,20,9,4,5,239,235,4,640,639,1,360,360,0
"2021","Leeds 091","E02002420",6405,2613,2728,2722,2702,20,6,4,2,191,188,3,535,534,1,338,338,0
"2021","Leeds 092","E02002421",4786,2360,1473,1466,1449,17,7,2,5,170,169,1,492,491,1,291,290,1
"2021","Leeds 093","E02002422",5368,1794,2726,2724,2702,22,2,0,2,91,90,1,401,400,1,356,356,0
"2021","Leeds 094","E02002423",4536,2015,1621,1617,1609,8,4,2,2,126,125,1,455,455,0,319,319,0
"2021","Leeds 095","E02002424",6211,2292,2800,2779,2760,19,21,10,11,115,115,0,601,600,1,403,403,0
"2021","Leeds 096","E02002425",7166,2353,3443,3432,3397,35,11,1,10,182,182,0,655,653,2,533,530,3
"2021","Leeds 097","E02002426",6406,2092,3166,3163,3146,17,3,0,3,107,107,0,587,584,3,454,454,0
"2021","Leeds 098","E02002427",5495,1903,2460,2454,2437,17,6,6,0,154,153,1,544,543,1,434,434,0
"2021","Leeds 099","E02002428",6290,2557,2740,2720,2684,36,20,6,14,149,147,2,533,533,0,311,311,0
"2021","Leeds 100","E02002429",6890,2381,3269,3260,3232,28,9,4,5,141,139,2,636,634,2,463,463,0
"2021","Leeds 101","E02002430",5935,2963,1866,1854,1845,9,12,4,8,196,193,3,600,600,0,310,309,1
"2021","Leeds 102","E02002431",7141,3210,2736,2718,2698,20,18,6,12,210,208,2,671,670,1,314,314,0
"2021","Leeds 103","E02002432",6185,2124,2912,2898,2875,23,14,0,14,127,127,0,584,582,2,438,438,0
"2021","Leeds 104","E02002433",5813,2654,1975,1965,1939,26,10,0,10,151,151,0,657,654,3,376,374,2
"2021","Leeds 105","E02002434",7903,3049,3679,3663,3635,28,16,6,10,155,153,2,694,694,0,326,326,0
"2021","Leeds 106","E02002435",6688,2406,3116,3112,3078,34,4,0,4,142,142,0,631,629,2,393,393,0
"2021","Leeds 107","E02002436",5573,2092,2363,2353,2326,27,10,2,8,143,142,1,610,609,1,365,365,0
"2021","Leeds 108","E02002437",5103,1450,2896,2891,2881,10,5,2,3,83,83,0,381,381,0,293,293,0
"2021","Leeds 109","E02006852",10143,5336,3716,3680,3652,28,36,12,24,127,127,0,573,572,1,391,391,0
"2021","Leeds 110","E02006861",12982,11246,1158,1145,1137,8,13,6,7,94,94,0,258,257,1,226,225,1
"2021","Leeds 111","E02006875",9393,8396,717,709,684,25,8,2,6,74,71,3,166,163,3,40,40,0
"2021","Leeds 112","E02006876",6733,4207,1679,1665,1635,30,14,6,8,130,130,0,444,442,2,273,272,1
"2021","Wakefield 001","E02002438",6869,2890,2632,2623,2605,18,9,6,3,209,209,0,727,727,0,411,411,0
"2021","Wakefield 002","E02002439",7256,3078,2523,2514,2477,37,9,0,9,212,211,1,926,924,2,517,517,0
"2021","Wakefield 003","E02002440",6358,2258,2930,2913,2900,13,17,8,9,151,147,4,603,599,4,416,416,0
"2021","Wakefield 004","E02002441",7916,3160,3153,3146,3125,21,7,4,3,216,213,3,862,857,5,525,525,0
"2021","Wakefield 005","E02002442",6075,2238,2828,2820,2818,2,8,0,8,135,134,1,549,547,2,325,325,0
"2021","Wakefield 006","E02002443",5066,1695,2511,2505,2487,18,6,0,6,108,108,0,473,472,1,279,279,0
"2021","Wakefield 007","E02002444",5658,2021,2623,2623,2599,24,0,0,0,135,135,0,587,585,2,292,291,1
"2021","Wakefield 008","E02002445",6933,2265,3246,3241,3223,18,5,0,5,143,143,0,733,731,2,546,546,0
"2021","Wakefield 009","E02002446",5041,1505,2559,2547,2532,15,12,4,8,100,100,0,485,485,0,392,392,0
"2021","Wakefield 010","E02002447",4973,1833,2079,2067,2054,13,12,5,7,135,135,0,505,503,2,421,421,0
"2021","Wakefield 011","E02002448",6466,2634,2462,2447,2429,18,15,6,9,170,169,1,714,712,2,486,486,0
"2021","Wakefield 012","E02002449",7913,2782,3810,3797,3763,34,13,6,7,149,147,2,693,690,3,479,479,0
"2021","Wakefield 013","E02002450",6453,2359,2957,2950,2945,5,7,2,5,169,167,2,672,670,2,296,296,0
"2021","Wakefield 014","E02002451",6661,1961,3413,3411,3395,16,2,0,2,130,130,0,666,666,0,491,491,0
"2021","Wakefield 015","E02002452",7550,3090,2816,2796,2776,20,20,10,10,230,230,0,952,948,4,462,462,0
"2021","Wakefield 016","E02002453",7858,3115,3019,3014,2990,24,5,4,1,193,191,2,1012,1012,0,519,517,2
"2021","Wakefield 017","E02002454",7518,3265,2865,2835,2800,35,30,8,22,231,231,0,755,751,4,402,400,2
"2021","Wakefield 018","E02002455",5046,2022,2009,2004,1996,8,5,2,3,116,114,2,556,555,1,343,343,0
"2021","Wakefield 019","E02002456",6680,2969,2480,2458,2429,29,22,3,19,205,205,0,757,752,5,269,266,3
"2021","Wakefield 020","E02002457",6152,2368,2587,2555,2538,17,32,16,16,186,184,2,656,655,1,355,355,0
"2021","Wakefield 021","E02002458",7394,2452,3501,3485,3469,16,16,6,10,143,142,1,781,779,2,517,517,0
"2021","Wakefield 022","E02002459",7938,3060,3404,3394,3378,16,10,0,10,190,188,2,831,827,4,453,453,0
"2021","Wakefield 023","E02002460",6259,1683,3340,3332,3312,20,8,1,7,119,117,2,601,598,3,516,516,0
"2021","Wakefield 024","E02002461",9556,3494,4277,4257,4228,29,20,6,14,229,229,0,970,969,1,586,585,1
"2021","Wakefield 025","E02002462",6129,2020,2828,2822,2810,12,6,4,2,156,155,1,643,642,1,482,482,0
"2021","Wakefield 026","E02002463",7759,3227,2947,2938,2899,39,9,6,3,219,217,2,925,925,0,441,441,0
"2021","Wakefield 027","E02002464",7262,2943,2893,2874,2859,15,19,8,11,190,190,0,761,760,1,475,474,1
"2021","Wakefield 028","E02002465",5277,1718,2483,2473,2454,19,10,2,8,116,115,1,554,553,1,406,404,2
"2021","Wakefield 029","E02002466",7473,2361,3497,3488,3476,12,9,0,9,178,177,1,883,880,3,554,553,1
"2021","Wakefield 030","E02002467",7173,3354,2498,2485,2466,19,13,6,7,219,218,1,792,789,3,310,309,1
"2021","Wakefield 031","E02002468",5108,1635,2476,2472,2465,7,4,0,4,106,106,0,521,520,1,370,368,2
"2021","Wakefield 032","E02002469",5347,1604,2770,2763,2746,17,7,4,3,110,109,1,507,506,1,356,355,1
"2021","Wakefield 033","E02002470",5179,1043,3264,3250,3234,16,14,2,12,71,71,0,361,361,0,440,440,0
"2021","Wakefield 034","E02002471",9569,2671,5190,5179,5168,11,11,4,7,155,154,1,912,907,5,641,641,0
"2021","Wakefield 035","E02002472",4910,1513,2460,2437,2423,14,23,8,15,101,101,0,485,485,0,351,351,0
"2021","Wakefield 036","E02002473",5676,1660,2922,2912,2899,13,10,4,6,122,122,0,605,602,3,367,366,1
"2021","Wakefield 037","E02002474",5534,1993,2380,2367,2334,33,13,1,12,153,152,1,651,650,1,357,356,1
"2021","Wakefield 038","E02002475",5247,1256,3012,2998,2984,14,14,4,10,90,88,2,493,491,2,396,396,0
"2021","Wakefield 039","E02002476",5217,2222,1992,1981,1963,18,11,4,7,152,149,3,504,502,2,347,347,0
"2021","Wakefield 040","E02002477",5113,1809,2302,2292,2280,12,10,2,8,131,131,0,528,528,0,343,343,0
"2021","Wakefield 041","E02002478",5025,1839,2281,2269,2261,8,12,4,8,130,126,4,503,501,2,272,272,0
"2021","Wakefield 042","E02002479",6816,2356,3013,3010,2995,15,3,0,3,157,157,0,718,717,1,572,572,0
"2021","Wakefield 043","E02002480",4638,1690,1905,1891,1886,5,14,10,4,131,129,2,524,524,0,388,388,0
"2021","Wakefield 044","E02002481",5936,2240,2495,2486,2472,14,9,4,5,143,142,1,605,605,0,453,453,0
"2021","Wakefield 045","E02002482",5549,2132,2322,2315,2299,16,7,1,6,133,132,1,570,570,0,392,392,0
"2021","Derby 001","E02002796",5045,1214,2927,2920,2914,6,7,4,3,94,94,0,450,448,2,360,359,1
"2021","Derby 002","E02002797",6256,1555,3534,3526,3522,4,8,4,4,85,85,0,456,455,1,626,626,0
"2021","Derby 003","E02002798",8736,3108,4278,4261,4231,30,17,4,13,142,142,0,824,824,0,384,383,1
"2021","Derby 004","E02002799",4977,2302,1820,1811,1797,14,9,2,7,102,102,0,476,476,0,277,277,0
"2021","Derby 005","E02002800",5821,2056,2634,2616,2602,14,18,8,10,115,113,2,569,567,2,447,446,1
"2021","Derby 006","E02002801",6082,2256,2662,2654,2648,6,8,2,6,130,127,3,564,563,1,470,470,0
"2021","Derby 007","E02002802",6090,2850,2036,2018,1995,23,18,8,10,186,183,3,672,670,2,346,343,3
"2021","Derby 008","E02002803",7486,5143,1269,1250,1235,15,19,8,11,137,133,4,685,684,1,252,252,0
"2021","Derby 009","E02002804",7058,2852,2905,2890,2861,29,15,4,11,160,159,1,681,680,1,460,460,0
"2021","Derby 010","E02002805",4740,1242,2507,2503,2495,8,4,0,4,90,90,0,453,452,1,448,448,0
"2021","Derby 011","E02002806",5559,3660,1154,1148,1129,19,6,2,4,112,110,2,468,462,6,165,165,0
"2021","Derby 012","E02002807",7252,2694,3198,3178,3162,16,20,6,14,159,158,1,744,742,2,457,457,0
"2021","Derby 013","E02002808",10522,6706,2230,2203,2181,22,27,10,17,279,274,5,990,962,28,317,316,1
"2021","Derby 014","E02002809",5696,2090,2359,2353,2346,7,6,4,2,137,135,2,624,623,1,486,485,1
"2021","Derby 015","E02002810",7508,2222,4084,4076,4065,11,8,6,2,119,118,1,539,537,2,544,544,0
"2021","Derby 016","E02002811",8301,3668,3546,3520,3496,24,26,18,8,233,229,4,565,563,2,289,288,1
"2021","Derby 017","E02002812",6415,2287,3052,3048,3026,22,4,2,2,140,139,1,477,477,0,459,459,0
"2021","Derby 018","E02002813",8591,3716,3604,3576,3557,19,28,16,12,266,264,2,620,619,1,385,384,1
"2021","Derby 019","E02002814",6085,1521,3384,3378,3371,7,6,4,2,91,91,0,572,569,3,517,517,0
"2021","Derby 020","E02002815",6377,2329,3247,3195,3153,42,52,14,38,161,158,3,378,378,0,262,262,0
"2021","Derby 021","E02002816",7373,2103,4256,4250,4240,10,6,4,2,142,141,1,498,498,0,374,374,0
"2021","Derby 022","E02002817",5151,1438,2851,2844,2832,12,7,0,7,100,99,1,369,367,2,393,393,0
"2021","Derby 023","E02002818",6288,2565,2710,2691,2639,52,19,12,7,177,171,6,473,473,0,363,363,0
"2021","Derby 024","E02002819",6216,2695,2265,2254,2232,22,11,2,9,173,170,3,712,710,2,371,370,1
"2021","Derby 025","E02002820",7755,3354,2896,2887,2863,24,9,6,3,198,197,1,820,820,0,487,487,0
"2021","Derby 026","E02002821",9138,4450,3124,3104,3087,17,20,14,6,278,276,2,796,795,1,490,490,0
"2021","Derby 027","E02002822",5489,1868,2584,2581,2569,12,3,0,3,131,131,0,478,476,2,428,428,0
"2021","Derby 028","E02002823",6259,2287,2602,2597,2591,6,5,0,5,130,127,3,727,727,0,513,513,0
"2021","Derby 029","E02002824",8249,3186,3585,3572,3557,15,13,6,7,224,223,1,784,784,0,470,469,1
"2021","Derby 030","E02002825",7018,2312,3319,3303,3292,11,16,6,10,163,162,1,660,658,2,564,564,0
"2021","Derby 031","E02002826",5656,1920,2816,2808,2798,10,8,6,2,122,122,0,501,501,0,297,297,0
"2021","Leicester 001","E02002827",5315,2200,2292,2286,2281,5,6,2,4,141,141,0,444,442,2,238,238,0
"2021","Leicester 002","E02002828",6780,1997,3789,3785,3769,16,4,4,0,126,126,0,389,388,1,479,479,0
"2021","Leicester 003","E02002829",8787,3909,3345,3324,3304,20,21,13,8,243,242,1,798,798,0,492,492,0
"2021","Leicester 004","E02002830",8161,3523,3415,3404,3392,12,11,8,3,209,208,1,696,694,2,318,317,1
"2021","Leicester 005","E02002831",5810,1687,3324,3313,3308,5,11,7,4,103,103,0,288,288,0,408,408,0
"2021","Leicester 006","E02002832",8442,2386,4819,4788,4754,34,31,26,5,132,132,0,440,440,0,665,665,0
"2021","Leicester 007","E02002833",7279,2166,4193,4168,4145,23,25,20,5,125,124,1,299,298,1,496,496,0
"2021","Leicester 008","E02002834",9709,3856,4520,4503,4491,12,17,8,9,170,170,0,632,632,0,531,528,3
"2021","Leicester 010","E02002836",9183,2602,5384,5352,5315,37,32,30,2,107,107,0,377,377,0,713,713,0
"2021","Leicester 011","E02002837",7436,2816,3756,3730,3702,28,26,22,4,140,140,0,390,388,2,334,333,1
"2021","Leicester 012","E02002838",6189,2945,2121,2107,2100,7,14,8,6,167,167,0,609,607,2,347,347,0
"2021","Leicester 013","E02002839",6581,2222,3283,3275,3271,4,8,4,4,125,125,0,514,513,1,437,436,1
"2021","Leicester 016","E02002842",6760,3625,2174,2164,2148,16,10,4,6,182,182,0,600,596,4,179,179,0
"2021","Leicester 017","E02002843",12112,3546,7410,7383,7338,45,27,25,2,162,162,0,409,409,0,585,585,0
"2021","Leicester 018","E02002844",9103,3120,4893,4874,4856,18,19,16,3,157,156,1,451,451,0,482,482,0
"2021","Leicester 019","E02002845",8517,2936,4246,4223,4208,15,23,20,3,214,213,1,624,622,2,497,497,0
"2021","Leicester 020","E02002846",6207,2332,2925,2909,2882,27,16,6,10,109,108,1,499,497,2,342,338,4
"2021","Leicester 021","E02002847",8201,2590,4778,4770,4750,20,8,6,2,117,116,1,285,285,0,431,431,0
"2021","Leicester 022","E02002848",8415,3100,4369,4338,4321,17,31,30,1,170,169,1,363,361,2,413,413,0
"2021","Leicester 023","E02002849",11990,7886,2708,2679,2652,27,29,16,13,236,235,1,844,844,0,316,315,1
"2021","Leicester 025","E02002851",7057,1965,4084,4082,4077,5,2,0,2,116,116,0,362,361,1,530,530,0
"2021","Leicester 026","E02002852",5316,2783,1644,1639,1623,16,5,0,5,135,134,1,481,481,0,273,273,0
"2021","Leicester 027","E02002853",10379,3896,5486,5474,5458,16,12,5,7,114,114,0,429,429,0,454,454,0
"2021","Leicester 028","E02002854",6467,3084,2251,2228,2201,27,23,10,13,180,180,0,615,614,1,337,337,0
"2021","Leicester 029","E02002855",6731,3387,2574,2556,2540,16,18,12,6,108,108,0,423,421,2,239,239,0
"2021","Leicester 030","E02002856",9983,5644,3012,2985,2942,43,27,8,19,154,154,0,711,709,2,462,461,1
"2021","Leicester 031","E02002857",5784,3261,1614,1600,1573,27,14,8,6,161,160,1,554,551,3,194,194,0
"2021","Leicester 032","E02002858",6013,1873,3228,3201,3184,17,27,10,17,104,103,1,413,412,1,395,395,0
"2021","Leicester 034","E02002860",6780,2727,2878,2867,2851,16,11,5,6,129,125,4,620,620,0,426,426,0
"2021","Leicester 035","E02002861",6044,3110,1949,1937,1927,10,12,4,8,184,184,0,501,500,1,300,300,0
"2021","Leicester 036","E02002862",6524,3007,2083,2072,2048,24,11,8,3,254,248,6,736,735,1,444,444,0
"2021","Leicester 037","E02006815",8712,3178,4019,4002,3991,11,17,12,5,190,187,3,736,736,0,589,589,0
"2021","Leicester 038","E02006817",7456,3645,2927,2915,2899,16,12,8,4,130,130,0,418,417,1,336,336,0
"2021","Leicester 039","E02006819",6381,3086,2243,2232,2221,11,11,6,5,187,186,1,563,562,1,302,302,0
"2021","Leicester 040","E02006850",9357,7468,1222,1213,1212,1,9,6,3,125,125,0,394,393,1,148,147,1
"2021","Leicester 041","E02006851",9595,8035,1072,1058,1043,15,14,4,10,146,142,4,289,288,1,53,53,0
"2021","Leicester 042","E02006964",4910,1611,2729,2725,2714,11,4,2,2,93,93,0,303,303,0,174,174,0
"2021","Leicester 043","E02006965",6537,2189,3439,3434,3417,17,5,2,3,115,115,0,441,441,0,353,353,0
"2021","Rutland 001","E02002863",7652,2951,3580,3570,3545,25,10,0,10,181,179,2,574,570,4,366,365,1
"2021","Rutland 002","E02002864",6782,1931,3579,3573,3550,23,6,0,6,157,157,0,673,671,2,442,442,0
"2021","Rutland 003","E02002865",6587,1850,3414,3399,3390,9,15,10,5,152,152,0,610,607,3,561,561,0
"2021","Rutland 004","E02002866",6233,1435,3624,3614,3603,11,10,8,2,102,102,0,602,600,2,470,470,0
"2021","Rutland 005","E02002867",7045,1971,3695,3668,3646,22,27,6,21,157,155,2,695,695,0,527,523,4
"2021","Nottingham 001","E02002868",4907,1709,2338,2335,2324,11,3,0,3,88,87,1,396,396,0,376,376,0
"2021","Nottingham 002","E02002869",5792,2714,1901,1889,1870,19,12,4,8,171,170,1,647,647,0,359,359,0
"2021","Nottingham 004","E02002871",6407,2797,2417,2414,2401,13,3,2,1,160,159,1,653,652,1,380,380,0
"2021","Nottingham 005","E02002872",6728,3183,2267,2250,2233,17,17,4,13,188,188,0,697,693,4,393,393,0
"2021","Nottingham 006","E02002873",7125,3530,2412,2399,2382,17,13,3,10,194,192,2,650,648,2,339,338,1
"2021","Nottingham 007","E02002874",6511,3182,2258,2251,2217,34,7,0,7,151,151,0,534,530,4,386,386,0
"2021","Nottingham 008","E02002875",6495,3144,2090,2068,2052,16,22,16,6,223,222,1,677,673,4,361,360,1
"2021","Nottingham 009","E02002876",6468,2869,2426,2412,2385,27,14,8,6,170,170,0,646,645,1,357,355,2
"2021","Nottingham 010","E02002877",6514,3139,2254,2215,2181,34,39,8,31,131,129,2,670,667,3,320,317,3
"2021","Nottingham 011","E02002878",6339,3356,2074,2052,2042,10,22,10,12,195,195,0,507,507,0,207,207,0
"2021","Nottingham 012","E02002879",7868,3808,2969,2940,2913,27,29,16,13,202,200,2,611,605,6,278,277,1
"2021","Nottingham 013","E02002880",6278,3060,2172,2157,2141,16,15,8,7,189,189,0,612,612,0,245,245,0
"2021","Nottingham 014","E02002881",5231,2462,1866,1856,1840,16,10,2,8,134,133,1,494,494,0,275,275,0
"2021","Nottingham 015","E02002882",7566,4202,2283,2245,2216,29,38,8,30,167,167,0,627,627,0,287,287,0
"2021","Nottingham 016","E02002883",6142,3027,1994,1979,1958,21,15,4,11,216,216,0,672,672,0,233,233,0
"2021","Nottingham 017","E02002884",5867,3087,2093,2079,2070,9,14,4,10,134,134,0,338,337,1,215,215,0
"2021","Nottingham 018","E02002885",6581,3512,2284,2266,2261,5,18,10,8,170,170,0,400,395,5,215,213,2
"2021","Nottingham 019","E02002886",7803,2884,3817,3802,3767,35,15,6,9,172,172,0,509,509,0,421,421,0
"2021","Nottingham 020","E02002887",5370,2072,2128,2108,2104,4,20,8,12,145,134,11,525,524,1,500,499,1
"2021","Nottingham 021","E02002888",5844,2899,1859,1840,1827,13,19,4,15,214,214,0,619,618,1,253,253,0
"2021","Nottingham 022","E02002889",10829,9736,706,694,675,19,12,7,5,78,78,0,236,236,0,73,71,2
"2021","Nottingham 023","E02002890",10373,8104,1349,1341,1327,14,8,0,8,182,180,2,533,530,3,205,204,1
"2021","Nottingham 024","E02002891",6665,2688,2870,2861,2848,13,9,2,7,149,149,0,551,551,0,407,406,1
"2021","Nottingham 025","E02002892",4899,2132,1861,1857,1844,13,4,2,2,102,102,0,456,456,0,348,348,0
"2021","Nottingham 026","E02002893",12199,9087,2267,2253,2239,14,14,6,8,194,194,0,472,472,0,179,179,0
"2021","Nottingham 028","E02002895",9121,7185,1369,1341,1317,24,28,7,21,86,85,1,348,347,1,133,132,1
"2021","Nottingham 029","E02002896",7896,4499,2277,2245,2228,17,32,12,20,232,230,2,619,617,2,269,268,1
"2021","Nottingham 030","E02002897",6348,1698,3667,3663,3655,8,4,2,2,94,94,0,410,410,0,479,478,1
"2021","Nottingham 031","E02002898",10270,8696,1091,1084,1066,18,7,2,5,53,53,0,286,286,0,144,144,0
"2021","Nottingham 034","E02002901",5084,1816,2372,2361,2342,19,11,4,7,87,87,0,426,425,1,383,383,0
"2021","Nottingham 035","E02002902",7765,4154,2434,2428,2404,24,6,0,6,129,128,1,606,605,1,442,442,0
"2021","Nottingham 036","E02002903",4771,1928,1845,1840,1835,5,5,2,3,109,109,0,449,449,0,440,440,0
"2021","Nottingham 037","E02002904",5011,2226,1825,1821,1814,7,4,0,4,126,123,3,462,462,0,372,372,0
"2021","Nottingham 038","E02006834",6027,2752,1856,1840,1825,15,16,6,10,145,145,0,741,738,3,533,533,0
"2021","Nottingham 039","E02006904",8563,6722,1280,1268,1243,25,12,4,8,125,125,0,342,338,4,94,93,1
"2021","Nottingham 040","E02006905",6017,3159,1857,1843,1830,13,14,8,6,202,202,0,554,553,1,245,245,0
"2021","Nottingham 041","E02007082",14641,8642,4611,4593,4557,36,18,2,16,141,140,1,635,632,3,612,610,2
"2021","North Northamptonshire 002","E02005612",6018,2029,2846,2834,2823,11,12,0,12,159,159,0,592,592,0,392,392,0
"2021","North Northamptonshire 003","E02005613",7523,2929,3024,3009,2994,15,15,9,6,228,225,3,841,838,3,501,501,0
"2021","North Northamptonshire 006","E02005614",10682,4119,4759,4740,4699,41,19,4,15,289,286,3,1066,1063,3,449,449,0
"2021","North Northamptonshire 004","E02005615",7606,2842,3164,3152,3139,13,12,6,6,228,228,0,806,806,0,566,566,0
"2021","North Northamptonshire 005","E02005616",4722,1948,1823,1805,1792,13,18,8,10,157,156,1,532,532,0,262,262,0
"2021","North Northamptonshire 007","E02005617",8749,3889,3170,3149,3137,12,21,14,7,273,272,1,956,955,1,461,461,0
"2021","North Northamptonshire 001","E02005629",5382,1305,3082,3075,3063,12,7,4,3,106,106,0,518,516,2,371,369,2
"2021","North Northamptonshire 010","E02005630",8571,2382,4692,4674,4649,25,18,2,16,160,160,0,755,754,1,582,580,2
"2021","North Northamptonshire 011","E02005631",9150,2733,4716,4705,4683,22,11,4,7,234,234,0,932,930,2,535,533,2
"2021","North Northamptonshire 024","E02005632",5441,1446,3050,3042,3031,11,8,2,6,120,118,2,473,471,2,352,352,0
"2021","North Northamptonshire 025","E02005633",8038,2660,3793,3784,3771,13,9,2,7,226,224,2,826,826,0,533,533,0
"2021","North Northamptonshire 027","E02005634",7501,2763,3247,3242,3224,18,5,4,1,260,257,3,802,801,1,429,429,0
"2021","North Northamptonshire 035","E02005635",7616,2366,3729,3719,3689,30,10,0,10,195,194,1,841,841,0,485,485,0
"2021","North Northamptonshire 034","E02005636",9857,3437,4438,4430,4408,22,8,0,8,263,262,1,1103,1100,3,616,616,0
"2021","North Northamptonshire 037","E02005637",7578,3178,2563,2550,2537,13,13,0,13,304,300,4,1012,1008,4,521,521,0
"2021","North Northamptonshire 039","E02005638",8293,2386,4531,4521,4512,9,10,4,6,147,147,0,714,712,2,515,515,0
"2021","North Northamptonshire 012","E02005639",4775,1164,2691,2681,2664,17,10,2,8,95,93,2,479,477,2,346,346,0
"2021","North Northamptonshire 013","E02005640",9550,3012,4687,4669,4643,26,18,6,12,264,263,1,967,964,3,620,620,0
"2021","North Northamptonshire 014","E02005641",7017,2472,3168,3156,3146,10,12,0,12,192,192,0,775,770,5,410,410,0
"2021","North Northamptonshire 015","E02005642",6941,2199,3543,3538,3526,12,5,0,5,148,146,2,605,602,3,446,446,0
"2021","North Northamptonshire 016","E02005643",6627,2902,2388,2379,2367,12,9,5,4,243,241,2,778,775,3,316,316,0
"2021","North Northamptonshire 017","E02005644",7302,3596,2389,2376,2363,13,13,8,5,263,262,1,832,829,3,222,222,0
"2021","North Northamptonshire 018","E02005645",10279,3859,4233,4219,4193,26,14,2,12,287,286,1,1159,1159,0,741,741,0
"2021","North Northamptonshire 019","E02005646",5347,1472,2874,2865,2846,19,9,0,9,116,114,2,494,494,0,391,391,0
"2021","North Northamptonshire 022","E02005647",6155,2252,2605,2593,2585,8,12,8,4,179,177,2,678,674,4,441,441,0
"2021","North Northamptonshire 021","E02005648",7757,2399,4194,4177,4151,26,17,5,12,120,118,2,606,606,0,438,438,0
"2021","North Northamptonshire 026","E02005692",5883,1829,2882,2878,2856,22,4,0,4,172,170,2,600,597,3,400,398,2
"2021","North Northamptonshire 028","E02005693",6760,2444,3129,3118,3109,9,11,2,9,175,174,1,619,619,0,393,392,1
"2021","North Northamptonshire 029","E02005694",6333,1798,3441,3435,3426,9,6,2,4,126,126,0,569,569,0,399,399,0
"2021","North Northamptonshire 030","E02005695",8065,3552,3049,3037,3019,18,12,12,0,231,230,1,830,829,1,403,401,2
"2021","North Northamptonshire 031","E02005696",4871,2056,1709,1700,1696,4,9,4,5,170,170,0,603,599,4,333,333,0
"2021","North Northamptonshire 032","E02005697",6087,2592,2124,2114,2100,14,10,5,5,182,182,0,746,746,0,443,442,1
"2021","North Northamptonshire 033","E02005698",4803,1667,2146,2140,2130,10,6,2,4,136,135,1,495,493,2,359,359,0
"2021","North Northamptonshire 036","E02005699",6607,2579,2851,2842,2817,25,9,6,3,192,189,3,655,652,3,330,329,1
"2021","North Northamptonshire 038","E02005700",8553,2388,4495,4482,4458,24,13,4,9,172,172,0,870,867,3,628,628,0
"2021","North Northamptonshire 040","E02005701",9260,2738,4653,4647,4624,23,6,2,4,235,234,1,988,988,0,646,646,0
"2021","North Northamptonshire 009","E02006862",5365,1869,2521,2508,2493,15,13,6,7,137,137,0,524,520,4,314,313,1
"2021","North Northamptonshire 008","E02006863",8883,3201,4413,4395,4364,31,18,4,14,246,244,2,768,762,6,255,255,0
"2021","North Northamptonshire 020","E02007070",5107,1397,2904,2888,2863,25,16,4,12,105,104,1,422,421,1,279,279,0
"2021","North Northamptonshire 023","E02007071",8139,2790,3835,3834,3810,24,1,0,1,210,210,0,841,839,2,463,463,0
"2021","West Northamptonshire 001","E02005619",5297,1345,3042,3025,3017,8,17,3,14,101,101,0,436,435,1,373,373,0
"2021","West Northamptonshire 002","E02005620",6990,2002,3782,3778,3754,24,4,0,4,175,175,0,648,647,1,383,383,0
"2021","West Northamptonshire 004","E02005621",7809,2485,3833,3814,3796,18,19,0,19,196,196,0,801,800,1,494,494,0
"2021","West Northamptonshire 005","E02005622",8094,2161,4608,4592,4578,14,16,0,16,179,178,1,688,688,0,458,458,0
"2021","West Northamptonshire 003","E02005623",9313,2932,4793,4775,4743,32,18,2,16,214,214,0,771,771,0,603,602,1
"2021","West Northamptonshire 010","E02005624",9269,3222,4486,4480,4454,26,6,1,5,212,212,0,947,947,0,402,399,3
"2021","West Northamptonshire 016","E02005625",7774,2678,3503,3491,3475,16,12,4,8,244,242,2,750,749,1,599,598,1
"2021","West Northamptonshire 022","E02005626",5611,2177,2365,2356,2346,10,9,0,9,151,150,1,639,638,1,279,279,0
"2021","West Northamptonshire 027","E02005627",6323,1813,3266,3252,3217,35,14,2,12,154,154,0,702,702,0,388,388,0
"2021","West Northamptonshire 042","E02005628",7090,2073,3732,3714,3694,20,18,4,14,142,142,0,731,731,0,412,412,0
"2021","West Northamptonshire 006","E02005650",5755,2292,2547,2545,2529,16,2,2,0,110,110,0,479,479,0,327,327,0
"2021","West Northamptonshire 007","E02005651",5433,1566,2818,2809,2806,3,9,1,8,91,90,1,497,497,0,461,461,0
"2021","West Northamptonshire 008","E02005652",5585,1828,2753,2747,2732,15,6,6,0,125,125,0,469,468,1,410,410,0
"2021","West Northamptonshire 011","E02005653",6694,2939,2662,2658,2647,11,4,4,0,198,196,2,643,643,0,252,252,0
"2021","West Northamptonshire 009","E02005654",6628,2767,2699,2695,2669,26,4,4,0,190,187,3,704,702,2,268,267,1
"2021","West Northamptonshire 012","E02005655",5256,1592,2634,2631,2620,11,3,3,0,95,95,0,515,511,4,420,420,0
"2021","West Northamptonshire 014","E02005656",4976,2085,2016,2011,2008,3,5,4,1,146,146,0,496,495,1,233,233,0
"2021","West Northamptonshire 013","E02005657",5551,1901,2533,2521,2515,6,12,3,9,126,125,1,603,603,0,388,387,1
"2021","West Northamptonshire 015","E02005658",5375,2578,1861,1855,1837,18,6,4,2,181,178,3,546,544,2,209,209,0
"2021","West Northamptonshire 018","E02005659",4805,1531,2326,2320,2309,11,6,0,6,109,109,0,469,468,1,370,368,2
"2021","West Northamptonshire 026","E02005660",5213,1967,2156,2149,2134,15,7,0,7,182,180,2,623,623,0,285,285,0
"2021","West Northamptonshire 017","E02005661",5319,2335,2069,2061,2041,20,8,2,6,164,162,2,499,498,1,252,252,0
"2021","West Northamptonshire 019","E02005662",5493,2174,2334,2324,2312,12,10,6,4,128,127,1,543,542,1,314,314,0
"2021","West Northamptonshire 023","E02005663",4581,1441,2390,2389,2375,14,1,0,1,88,87,1,405,403,2,257,257,0
"2021","West Northamptonshire 025","E02005664",5180,2416,1776,1766,1743,23,10,5,5,138,137,1,538,535,3,312,312,0
"2021","West Northamptonshire 024","E02005665",6920,2354,3480,3476,3457,19,4,2,2,143,143,0,636,633,3,307,306,1
"2021","West Northamptonshire 021","E02005666",6767,3068,2470,2459,2438,21,11,6,5,226,226,0,664,664,0,339,337,2
"2021","West Northamptonshire 020","E02005667",5365,1805,2433,2419,2400,19,14,6,8,144,141,3,606,606,0,377,377,0
"2021","West Northamptonshire 028","E02005668",5395,1593,2743,2737,2730,7,6,0,6,104,104,0,469,469,0,486,484,2
"2021","West Northamptonshire 029","E02005669",4987,1284,2953,2945,2940,5,8,4,4,72,72,0,314,313,1,364,364,0
"2021","West Northamptonshire 032","E02005670",7769,4126,2368,2349,2323,26,19,16,3,236,233,3,815,812,3,224,224,0
"2021","West Northamptonshire 030","E02005671",6553,3269,2207,2199,2176,23,8,6,2,176,174,2,629,629,0,272,272,0
"2021","West Northamptonshire 031","E02005672",7115,3894,2258,2237,2206,31,21,20,1,176,175,1,591,589,2,196,196,0
"2021","West Northamptonshire 033","E02005673",6381,2733,2439,2428,2420,8,11,2,9,195,195,0,619,619,0,395,394,1
"2021","West Northamptonshire 034","E02005674",7895,4043,2549,2541,2524,17,8,8,0,191,189,2,715,715,0,397,395,2
"2021","West Northamptonshire 036","E02005675",4837,1942,1992,1987,1976,11,5,2,3,125,125,0,568,568,0,210,210,0
"2021","West Northamptonshire 038","E02005676",4927,1936,2142,2138,2125,13,4,3,1,126,125,1,496,496,0,227,227,0
"2021","West Northamptonshire 037","E02005677",8237,3962,3064,3058,3036,22,6,6,0,206,203,3,660,659,1,345,344,1
"2021","West Northamptonshire 041","E02005679",7271,2300,3841,3837,3813,24,4,0,4,140,140,0,682,682,0,308,308,0
"2021","West Northamptonshire 044","E02005680",6679,1997,3718,3714,3707,7,4,2,2,155,155,0,526,525,1,283,283,0
"2021","West Northamptonshire 040","E02005681",7077,1882,3875,3868,3857,11,7,2,5,155,155,0,668,665,3,497,497,0
"2021","West Northamptonshire 043","E02005682",6147,1590,3483,3477,3466,11,6,0,6,137,137,0,560,560,0,377,377,0
"2021","West Northamptonshire 046","E02005683",11939,3645,6253,6238,6201,37,15,4,11,280,280,0,1101,1100,1,660,660,0
"2021","West Northamptonshire 045","E02005684",7169,1906,4065,4052,4038,14,13,1,12,130,130,0,653,652,1,415,415,0
"2021","West Northamptonshire 047","E02005685",8197,2806,3945,3932,3903,29,13,2,11,179,179,0,795,795,0,472,472,0
"2021","West Northamptonshire 048","E02005686",6697,1738,3784,3771,3748,23,13,4,9,118,118,0,598,598,0,459,458,1
"2021","West Northamptonshire 049","E02005687",5541,1515,3191,3181,3168,13,10,3,7,86,85,1,459,459,0,290,290,0
"2021","West Northamptonshire 050","E02005688",7882,2224,4404,4392,4377,15,12,2,10,165,163,2,669,665,4,420,419,1
"2021","West Northamptonshire 051","E02005689",8486,2762,4471,4465,4443,22,6,2,4,130,130,0,729,727,2,394,394,0
"2021","West Northamptonshire 053","E02005690",4541,1541,2014,2002,1993,9,12,6,6,91,90,1,601,601,0,294,294,0
"2021","West Northamptonshire 052","E02005691",5724,1702,3035,3025,2996,29,10,6,4,103,103,0,549,547,2,335,335,0
"2021","West Northamptonshire 035","E02007072",5544,2249,2379,2376,2362,14,3,0,3,162,162,0,488,487,1,266,266,0
"2021","West Northamptonshire 039","E02007073",6053,2017,3188,3184,3164,20,4,2,2,112,112,0,483,481,2,253,252,1
"2021","Amber Valley 001","E02004029",6073,2289,2511,2500,2478,22,11,4,7,169,169,0,678,677,1,426,426,0
"2021","Amber Valley 002","E02004030",5159,1223,2884,2874,2856,18,10,4,6,122,121,1,518,517,1,412,412,0
"2021","Amber Valley 003","E02004031",5899,2575,2045,2032,2020,12,13,5,8,172,171,1,734,734,0,373,371,2
"2021","Amber Valley 004","E02004032",7174,2086,3719,3708,3689,19,11,6,5,147,145,2,672,672,0,550,549,1
"2021","Amber Valley 005","E02004033",7528,2703,3193,3178,3155,23,15,8,7,175,171,4,929,929,0,528,528,0
"2021","Amber Valley 006","E02004034",5889,1566,3135,3127,3111,16,8,2,6,107,105,2,584,583,1,497,497,0
"2021","Amber Valley 007","E02004035",5570,1374,3191,3178,3171,7,13,4,9,88,88,0,492,491,1,425,424,1
"2021","Amber Valley 008","E02004036",8464,2972,3737,3723,3713,10,14,6,8,201,199,2,960,958,2,594,594,0
"2021","Amber Valley 009","E02004037",6562,1946,3526,3522,3495,27,4,0,4,106,103,3,595,594,1,389,389,0
"2021","Amber Valley 010","E02004038",6467,2167,2776,2742,2713,29,34,14,20,161,161,0,849,849,0,514,514,0
"2021","Amber Valley 011","E02004039",6501,2000,3246,3232,3219,13,14,4,10,137,137,0,686,684,2,432,431,1
"2021","Amber Valley 012","E02004040",7768,2641,3779,3764,3734,30,15,2,13,166,166,0,729,727,2,453,453,0
"2021","Amber Valley 013","E02004041",6129,2243,2730,2718,2692,26,12,4,8,174,174,0,582,582,0,400,400,0
"2021","Amber Valley 015","E02004043",6075,1855,3045,3042,3029,13,3,0,3,140,139,1,612,609,3,423,423,0
"2021","Amber Valley 016","E02004044",7351,1959,4192,4180,4172,8,12,10,2,119,119,0,582,581,1,499,499,0
"2021","Amber Valley 017","E02006827",6459,2628,2380,2364,2338,26,16,4,12,187,187,0,788,785,3,476,476,0
"2021","Bolsover 001","E02004045",8180,2399,4221,4208,4193,15,13,0,13,167,167,0,837,837,0,556,556,0
"2021","Bolsover 002","E02004046",5188,1582,2496,2492,2475,17,4,2,2,133,132,1,556,555,1,421,421,0
"2021","Bolsover 003","E02004047",4928,2001,1888,1870,1851,19,18,8,10,150,148,2,548,546,2,341,341,0
"2021","Bolsover 004","E02004048",5664,2044,2441,2427,2410,17,14,4,10,156,156,0,640,639,1,383,383,0
"2021","Bolsover 005","E02004049",6716,2054,3223,3208,3195,13,15,4,11,113,113,0,728,727,1,598,597,1
"2021","Bolsover 006","E02004050",6243,2446,2569,2558,2544,14,11,4,7,138,138,0,608,606,2,482,482,0
"2021","Bolsover 007","E02004051",8050,3032,3418,3402,3373,29,16,8,8,214,211,3,838,835,3,548,548,0
"2021","Bolsover 008","E02004052",7200,2404,3452,3429,3403,26,23,12,11,185,185,0,697,693,4,462,461,1
"2021","Bolsover 009","E02004053",6391,2409,2722,2715,2699,16,7,0,7,156,155,1,714,711,3,390,390,0
"2021","Bolsover 010","E02004054",7716,2648,3602,3591,3564,27,11,4,7,172,170,2,807,806,1,487,486,1
"2021","Chesterfield 001","E02004055",5794,2093,2454,2442,2437,5,12,4,8,128,127,1,688,686,2,431,430,1
"2021","Chesterfield 002","E02004056",6278,2537,2452,2442,2431,11,10,4,6,155,154,1,729,729,0,405,404,1
"2021","Chesterfield 003","E02004057",6305,2650,2461,2459,2426,33,2,0,2,172,172,0,714,711,3,308,308,0
"2021","Chesterfield 004","E02004058",6539,2586,2510,2499,2483,16,11,2,9,202,202,0,780,780,0,461,461,0
"2021","Chesterfield 005","E02004059",6165,1915,2974,2956,2939,17,18,4,14,110,107,3,624,623,1,542,540,2
"2021","Chesterfield 006","E02004060",6113,2001,2873,2869,2853,16,4,2,2,141,140,1,590,590,0,508,507,1
"2021","Chesterfield 007","E02004061",6223,2258,2565,2543,2534,9,22,8,14,160,159,1,747,747,0,493,492,1
"2021","Chesterfield 008","E02004062",6466,2066,3003,2998,2984,14,5,1,4,116,116,0,812,811,1,469,469,0
"2021","Chesterfield 009","E02004063",6568,2019,3226,3216,3203,13,10,4,6,109,108,1,686,686,0,528,527,1
"2021","Chesterfield 010","E02004064",7896,3693,2435,2422,2392,30,13,2,11,299,298,1,1069,1061,8,400,399,1
"2021","Chesterfield 011","E02004065",6915,1595,4024,4017,3994,23,7,0,7,89,89,0,595,594,1,612,612,0
"2021","Chesterfield 012","E02004066",9585,3241,4408,4395,4379,16,13,2,11,213,210,3,1028,1025,3,695,695,0
"2021","Chesterfield 013","E02004067",5151,2067,2035,2023,2015,8,12,6,6,118,118,0,594,593,1,337,336,1
"2021","Derbyshire Dales 001","E02004068",6198,1662,3382,3351,3333,18,31,8,23,115,115,0,546,544,2,493,491,2
"2021","Derbyshire Dales 002","E02004069",5518,1258,3215,3195,3187,8,20,6,14,86,86,0,509,509,0,450,450,0
"2021","Derbyshire Dales 005","E02004072",7987,2155,4358,4344,4326,18,14,4,10,158,158,0,680,678,2,636,635,1
"2021","Derbyshire Dales 006","E02004073",7518,2296,3601,3571,3555,16,30,2,28,196,192,4,828,828,0,597,595,2
"2021","Derbyshire Dales 007","E02004074",4937,1488,2421,2396,2380,16,25,7,18,105,103,2,538,538,0,385,384,1
"2021","Derbyshire Dales 008","E02004075",6167,1528,3584,3571,3557,14,13,9,4,119,118,1,517,517,0,419,419,0
"2021","Derbyshire Dales 009","E02004076",6121,1951,2858,2850,2838,12,8,6,2,145,144,1,673,673,0,494,494,0
"2021","Derbyshire Dales 010","E02004077",7050,1994,3870,3857,3851,6,13,4,9,125,125,0,635,635,0,426,426,0
"2021","Derbyshire Dales 011","E02007029",9563,2452,5132,5104,5088,16,28,6,22,155,155,0,975,971,4,849,847,2
"2021","Erewash 001","E02004078",5620,2343,2029,2020,2007,13,9,4,5,168,167,1,702,698,4,378,378,0
"2021","Erewash 003","E02004080",8067,3453,2900,2878,2847,31,22,8,14,251,250,1,953,952,1,510,509,1
"2021","Erewash 004","E02004081",4899,1306,2684,2674,2661,13,10,6,4,71,71,0,468,468,0,370,370,0
"2021","Erewash 005","E02004082",5188,1329,2876,2873,2865,8,3,0,3,76,76,0,473,472,1,434,434,0
"2021","Erewash 006","E02004083",6748,2733,2897,2886,2873,13,11,0,11,142,142,0,656,656,0,320,320,0
"2021","Erewash 007","E02004084",4862,1814,2031,2023,2010,13,8,2,6,108,108,0,483,480,3,426,426,0
"2021","Erewash 008","E02004085",7321,2436,3420,3407,3391,16,13,6,7,149,149,0,731,730,1,585,584,1
"2021","Erewash 009","E02004086",5977,1752,3064,3055,3039,16,9,0,9,110,109,1,573,571,2,478,478,0
"2021","Erewash 010","E02004087",6293,2469,2597,2586,2574,12,11,4,7,144,142,2,700,699,1,383,383,0
"2021","Erewash 011","E02004088",6392,1809,3542,3530,3516,14,12,2,10,91,90,1,535,534,1,415,415,0
"2021","Erewash 012","E02004089",5679,2787,1672,1671,1653,18,1,0,1,181,179,2,737,737,0,302,302,0
"2021","Erewash 013","E02004090",5070,1593,2423,2418,2404,14,5,1,4,136,134,2,519,519,0,399,398,1
"2021","Erewash 014","E02004091",7824,2662,3621,3611,3594,17,10,0,10,154,154,0,864,862,2,523,522,1
"2021","Erewash 015","E02004092",7703,2587,3548,3538,3511,27,10,6,4,178,178,0,854,853,1,536,536,0
"2021","Erewash 016","E02006828",5875,2079,2770,2757,2751,6,13,6,7,132,131,1,585,585,0,309,309,0
"2021","High Peak 001","E02004093",5229,1925,2283,2272,2255,17,11,2,9,121,120,1,602,598,4,298,298,0
"2021","High Peak 002","E02004094",5562,2231,2172,2168,2160,8,4,4,0,148,147,1,622,622,0,389,388,1
"2021","High Peak 003","E02004095",8506,3300,3429,3416,3383,33,13,5,8,264,257,7,981,977,4,532,532,0
"2021","High Peak 004","E02004096",8164,2251,4649,4634,4615,19,15,1,14,93,93,0,628,625,3,543,543,0
"2021","High Peak 005","E02004097",6373,2056,3124,3112,3093,19,12,4,8,140,140,0,682,678,4,371,371,0
"2021","High Peak 006","E02004098",6121,2081,2732,2716,2702,14,16,6,10,155,153,2,731,729,2,422,422,0
"2021","High Peak 008","E02004100",6796,2023,3527,3509,3485,24,18,2,16,130,127,3,676,675,1,440,440,0
"2021","High Peak 010","E02004102",6683,2496,2533,2518,2498,20,15,2,13,183,183,0,879,879,0,592,591,1
"2021","High Peak 011","E02004103",5433,2125,2188,2174,2157,17,14,6,8,147,144,3,588,587,1,385,384,1
"2021","High Peak 012","E02004104",5967,1702,3259,3246,3235,11,13,4,9,121,120,1,494,494,0,391,388,3
"2021","High Peak 013","E02006872",10828,3197,5540,5501,5483,18,39,14,25,229,225,4,1120,1116,4,742,741,1
"2021","North East Derbyshire 001","E02004105",7699,2474,3773,3763,3737,26,10,7,3,148,148,0,764,764,0,540,539,1
"2021","North East Derbyshire 002","E02004106",5902,1493,3174,3168,3164,4,6,2,4,94,94,0,576,573,3,565,565,0
"2021","North East Derbyshire 004","E02004108",6298,2068,2779,2774,2759,15,5,1,4,150,150,0,758,756,2,543,543,0
"2021","North East Derbyshire 005","E02004109",5712,1199,3512,3505,3498,7,7,0,7,74,73,1,470,470,0,457,457,0
"2021","North East Derbyshire 006","E02004110",6072,1491,3505,3497,3492,5,8,4,4,111,111,0,525,525,0,440,440,0
"2021","North East Derbyshire 007","E02004111",4719,1437,2315,2303,2292,11,12,0,12,96,95,1,506,503,3,365,365,0
"2021","North East Derbyshire 008","E02004112",5494,1150,3302,3295,3279,16,7,5,2,78,78,0,450,449,1,514,514,0
"2021","North East Derbyshire 009","E02004113",8228,3280,3186,3173,3145,28,13,6,7,245,245,0,931,929,2,586,586,0
"2021","North East Derbyshire 010","E02004114",7218,1954,3926,3915,3908,7,11,4,7,129,129,0,664,661,3,545,543,2
"2021","North East Derbyshire 011","E02004115",7526,2423,3617,3604,3585,19,13,8,5,155,154,1,824,823,1,507,507,0
"2021","North East Derbyshire 012","E02004116",7002,2494,2878,2857,2835,22,21,4,17,244,241,3,857,854,3,529,528,1
"2021","North East Derbyshire 013","E02004117",6640,2042,3341,3323,3307,16,18,2,16,147,143,4,644,644,0,466,466,0
"2021","North East Derbyshire 014","E02006804",6760,2502,2833,2820,2804,16,13,6,7,159,158,1,794,791,3,472,472,0
"2021","South Derbyshire 001","E02004118",6328,2102,3210,3203,3187,16,7,0,7,120,120,0,527,527,0,369,368,1
"2021","South Derbyshire 002","E02004119",9424,3059,4788,4782,4746,36,6,4,2,239,237,2,881,880,1,457,456,1
"2021","South Derbyshire 003","E02004120",8758,2949,4459,4454,4429,25,5,0,5,203,203,0,713,711,2,434,434,0
"2021","South Derbyshire 004","E02004121",7508,2325,3973,3962,3938,24,11,7,4,171,171,0,605,604,1,434,433,1
"2021","South Derbyshire 005","E02004122",5719,1668,3122,3117,3095,22,5,0,5,87,87,0,485,485,0,357,357,0
"2021","South Derbyshire 006","E02004123",5657,1512,2927,2921,2912,9,6,0,6,122,122,0,631,631,0,465,464,1
"2021","South Derbyshire 007","E02004124",6146,1980,2996,2985,2968,17,11,4,7,145,143,2,593,590,3,432,431,1
"2021","South Derbyshire 008","E02004125",7141,2455,3251,3235,3221,14,16,0,16,184,179,5,787,785,2,464,464,0
"2021","South Derbyshire 009","E02004126",6130,2000,2806,2793,2779,14,13,4,9,152,152,0,691,689,2,481,481,0
"2021","South Derbyshire 011","E02004128",9530,2949,4785,4760,4735,25,25,8,17,212,211,1,902,900,2,682,682,0
"2021","South Derbyshire 012","E02006919",8225,3114,3640,3630,3595,35,10,4,6,221,220,1,883,877,6,367,367,0
"2021","South Derbyshire 013","E02006920",6383,2435,2811,2801,2783,18,10,4,6,166,163,3,676,675,1,295,295,0
"2021","Blaby 002","E02005334",4887,1590,2510,2492,2477,15,18,4,14,92,91,1,380,380,0,315,315,0
"2021","Blaby 003","E02005335",6206,1669,3436,3418,3410,8,18,4,14,97,96,1,515,513,2,489,487,2
"2021","Blaby 004","E02005336",5724,2222,2554,2530,2514,16,24,10,14,154,153,1,520,518,2,274,274,0
"2021","Blaby 005","E02005337",8109,2733,3986,3980,3969,11,6,1,5,161,161,0,623,623,0,606,605,1
"2021","Blaby 006","E02005338",9185,3266,4286,4269,4240,29,17,4,13,211,211,0,834,833,1,588,583,5
"2021","Blaby 007","E02005339",7108,2306,3511,3503,3488,15,8,5,3,156,156,0,695,694,1,440,440,0
"2021","Blaby 008","E02005340",7369,2502,3374,3358,3332,26,16,4,12,166,165,1,776,774,2,551,550,1
"2021","Blaby 009","E02005341",6116,2067,3038,3031,3020,11,7,4,3,114,113,1,597,597,0,300,300,0
"2021","Blaby 010","E02005342",6031,1877,3106,3094,3073,21,12,2,10,113,110,3,531,526,5,404,404,0
"2021","Blaby 011","E02005343",6483,1972,3422,3408,3394,14,14,6,8,107,107,0,565,564,1,417,417,0
"2021","Blaby 012","E02005344",7522,2295,3886,3878,3854,24,8,0,8,161,161,0,715,713,2,465,465,0
"2021","Blaby 013","E02006820",8923,2797,4628,4619,4602,17,9,5,4,148,148,0,690,688,2,660,659,1
"2021","Charnwood 001","E02005345",5346,1690,2708,2694,2674,20,14,6,8,126,126,0,503,502,1,319,319,0
"2021","Charnwood 002","E02005346",10468,5376,3373,3359,3316,43,14,0,14,271,269,2,982,981,1,466,465,1
"2021","Charnwood 003","E02005347",10259,7383,1913,1897,1877,20,16,4,12,123,123,0,528,526,2,312,312,0
"2021","Charnwood 004","E02005348",4822,1505,2461,2455,2448,7,6,4,2,85,85,0,435,434,1,336,336,0
"2021","Charnwood 005","E02005349",6497,2203,3118,3099,3087,12,19,6,13,160,160,0,595,592,3,421,421,0
"2021","Charnwood 006","E02005350",5839,2037,2695,2677,2661,16,18,0,18,132,131,1,559,559,0,416,415,1
"2021","Charnwood 007","E02005351",10181,7417,2037,2028,2018,10,9,4,5,101,101,0,341,340,1,285,285,0
"2021","Charnwood 008","E02005352",5211,1340,3092,3078,3065,13,14,2,12,76,76,0,393,393,0,310,309,1
"2021","Charnwood 009","E02005353",8545,3795,3377,3359,3336,23,18,6,12,179,178,1,770,769,1,424,424,0
"2021","Charnwood 010","E02005354",8440,2499,4727,4714,4709,5,13,2,11,115,114,1,540,540,0,559,559,0
"2021","Charnwood 011","E02005355",6016,1851,3036,3023,3009,14,13,2,11,141,138,3,627,626,1,361,361,0
"2021","Charnwood 012","E02005356",6041,1682,3178,3172,3151,21,6,2,4,149,149,0,640,638,2,392,391,1
"2021","Charnwood 013","E02005357",6719,2593,2914,2903,2890,13,11,4,7,178,177,1,688,685,3,346,346,0
"2021","Charnwood 014","E02005358",9820,3436,4638,4615,4591,24,23,8,15,211,210,1,987,986,1,548,548,0
"2021","Charnwood 015","E02005359",6271,1796,3468,3457,3449,8,11,0,11,116,116,0,488,487,1,403,403,0
"2021","Charnwood 016","E02005360",5378,1397,3164,3153,3134,19,11,4,7,63,63,0,388,388,0,366,364,2
"2021","Charnwood 017","E02005361",5290,1833,2407,2393,2385,8,14,4,10,133,133,0,548,547,1,369,368,1
"2021","Charnwood 018","E02005362",5868,1910,2866,2859,2848,11,7,2,5,128,127,1,551,551,0,413,413,0
"2021","Charnwood 019","E02005363",7371,2001,4180,4165,4142,23,15,8,7,129,129,0,493,493,0,568,568,0
"2021","Charnwood 020","E02005364",4353,1428,2253,2249,2247,2,4,4,0,70,70,0,325,325,0,277,277,0
"2021","Charnwood 021","E02005365",8093,2592,4011,4005,3998,7,6,2,4,173,171,2,666,666,0,651,651,0
"2021","Charnwood 022","E02005366",6262,2118,2993,2978,2966,12,15,4,11,141,141,0,599,597,2,411,411,0
"2021","Harborough 002","E02005368",5402,1383,3170,3159,3154,5,11,0,11,89,88,1,435,434,1,325,324,1
"2021","Harborough 003","E02005369",10272,2898,5566,5546,5511,35,20,6,14,227,227,0,937,936,1,644,643,1
"2021","Harborough 004","E02005370",7813,2521,4028,4020,3995,25,8,6,2,174,172,2,702,702,0,388,387,1
"2021","Harborough 005","E02005371",8953,2577,4902,4884,4864,20,18,10,8,166,165,1,782,779,3,526,526,0
"2021","Harborough 006","E02005372",8590,2235,4988,4968,4954,14,20,8,12,140,138,2,719,719,0,508,507,1
"2021","Harborough 007","E02005373",10119,3040,5370,5336,5306,30,34,10,24,170,167,3,914,911,3,625,623,2
"2021","Harborough 008","E02005374",5519,2117,2048,2040,2031,9,8,2,6,154,153,1,710,710,0,490,489,1
"2021","Harborough 009","E02005375",7678,2272,3866,3861,3853,8,5,0,5,163,163,0,790,789,1,587,587,0
"2021","Harborough 010","E02005376",8852,2696,4545,4526,4495,31,19,14,5,184,183,1,849,847,2,578,577,1
"2021","Harborough 011","E02006816",7230,2039,4136,4124,4108,16,12,0,12,89,88,1,498,497,1,468,468,0
"2021","Hinckley and Bosworth 001","E02005377",7417,2276,3723,3708,3693,15,15,1,14,147,147,0,746,746,0,525,525,0
"2021","Hinckley and Bosworth 002","E02005378",4348,1234,2369,2363,2354,9,6,0,6,79,79,0,401,400,1,265,265,0
"2021","Hinckley and Bosworth 003","E02005379",5006,1472,2616,2614,2612,2,2,2,0,99,99,0,493,490,3,326,326,0
"2021","Hinckley and Bosworth 004","E02005380",7287,1818,4208,4204,4180,24,4,0,4,137,137,0,626,623,3,498,498,0
"2021","Hinckley and Bosworth 005","E02005381",7275,1993,4028,4022,3993,29,6,3,3,121,120,1,587,587,0,546,545,1
"2021","Hinckley and Bosworth 006","E02005382",8755,3017,3948,3927,3898,29,21,2,19,236,236,0,970,966,4,584,584,0
"2021","Hinckley and Bosworth 007","E02005383",7579,2611,3335,3324,3308,16,11,4,7,209,209,0,919,917,2,505,504,1
"2021","Hinckley and Bosworth 008","E02005384",6177,1648,3471,3461,3453,8,10,6,4,120,120,0,547,546,1,391,391,0
"2021","Hinckley and Bosworth 009","E02005385",5610,1575,3136,3121,3109,12,15,2,13,81,80,1,450,450,0,368,368,0
"2021","Hinckley and Bosworth 010","E02005386",7613,3222,2750,2743,2723,20,7,3,4,212,209,3,948,947,1,481,479,2
"2021","Hinckley and Bosworth 011","E02005387",8073,2908,3685,3672,3661,11,13,6,7,191,190,1,896,892,4,393,393,0
"2021","Hinckley and Bosworth 012","E02005388",5090,1869,2202,2193,2181,12,9,5,4,133,132,1,582,582,0,304,304,0
"2021","Hinckley and Bosworth 013","E02005389",5062,1531,2391,2385,2374,11,6,4,2,118,118,0,544,542,2,478,478,0
"2021","Hinckley and Bosworth 014","E02005390",8624,2357,4774,4760,4740,20,14,2,12,154,146,8,809,795,14,530,529,1
"2021","Melton 001","E02005391",8145,2013,4619,4610,4592,18,9,3,6,160,160,0,770,770,0,583,582,1
"2021","Melton 002","E02005392",7666,2281,3964,3952,3940,12,12,10,2,159,159,0,725,724,1,537,537,0
"2021","Melton 003","E02005393",6205,1862,3251,3239,3228,11,12,6,6,113,112,1,602,601,1,377,377,0
"2021","Melton 004","E02005394",7665,2775,3272,3265,3252,13,7,1,6,203,202,1,884,883,1,531,531,0
"2021","Melton 005","E02005395",7402,2408,3493,3482,3465,17,11,4,7,174,171,3,789,789,0,538,535,3
"2021","Melton 006","E02005396",5859,1428,3374,3358,3342,16,16,8,8,116,116,0,514,513,1,427,427,0
"2021","North West Leicestershire 001","E02005397",7748,2468,3818,3803,3779,24,15,4,11,190,190,0,841,837,4,431,431,0
"2021","North West Leicestershire 002","E02005398",5886,2407,2492,2484,2465,19,8,2,6,120,119,1,530,530,0,337,336,1
"2021","North West Leicestershire 003","E02005399",6708,2217,3252,3241,3224,17,11,8,3,144,144,0,741,741,0,354,354,0
"2021","North West Leicestershire 004","E02005400",4886,1496,2468,2463,2441,22,5,2,3,107,107,0,430,427,3,385,384,1
"2021","North West Leicestershire 005","E02005401",5392,1479,3046,3038,3025,13,8,4,4,70,70,0,480,479,1,317,317,0
"2021","North West Leicestershire 006","E02005402",5588,1529,2969,2959,2942,17,10,5,5,121,121,0,495,495,0,474,474,0
"2021","North West Leicestershire 007","E02005403",5608,1749,2748,2741,2730,11,7,2,5,108,106,2,567,567,0,436,436,0
"2021","North West Leicestershire 008","E02005404",7128,2318,3503,3481,3467,14,22,10,12,179,179,0,707,704,3,421,421,0
"2021","North West Leicestershire 009","E02005405",5855,2088,2624,2615,2602,13,9,2,7,117,117,0,594,594,0,432,431,1
"2021","North West Leicestershire 010","E02005406",6318,2637,2422,2409,2391,18,13,10,3,165,163,2,722,721,1,372,372,0
"2021","North West Leicestershire 011","E02005407",8883,3165,4264,4250,4227,23,14,1,13,172,170,2,882,879,3,400,399,1
"2021","North West Leicestershire 012","E02005408",6466,1965,3273,3269,3237,32,4,4,0,184,183,1,640,638,2,404,404,0
"2021","North West Leicestershire 013","E02005409",9706,3343,4574,4553,4536,17,21,6,15,247,245,2,971,970,1,571,570,1
"2021","Oadby and Wigston 003","E02005412",7079,1937,3778,3772,3764,8,6,4,2,140,140,0,564,564,0,660,660,0
"2021","Oadby and Wigston 005","E02005414",6639,2549,2629,2620,2593,27,9,6,3,156,156,0,737,737,0,568,568,0
"2021","Oadby and Wigston 006","E02005415",6530,2667,2561,2547,2535,12,14,10,4,188,187,1,648,647,1,466,466,0
"2021","Oadby and Wigston 007","E02005416",7587,2251,4035,4025,4011,14,10,2,8,151,151,0,570,569,1,580,580,0
"2021","Oadby and Wigston 008","E02006818",6853,1947,3731,3727,3713,14,4,2,2,109,109,0,537,535,2,529,529,0
"2021","Oadby and Wigston 010","E02006966",6373,2699,2996,2994,2990,4,2,0,2,78,77,1,239,239,0,361,361,0
"2021","Oadby and Wigston 011","E02006967",6149,1630,3675,3671,3661,10,4,2,2,113,113,0,362,361,1,369,369,0
"2021","Boston 001","E02005417",6468,1787,3402,3396,3379,17,6,0,6,116,116,0,686,685,1,477,477,0
"2021","Boston 002","E02005418",8628,3762,2917,2880,2863,17,37,20,17,255,255,0,1122,1119,3,572,569,3
"2021","Boston 003","E02005419",7128,3162,2444,2418,2406,12,26,20,6,208,206,2,944,943,1,370,369,1
"2021","Boston 004","E02005420",7115,2621,2834,2822,2812,10,12,6,6,191,190,1,934,934,0,535,535,0
"2021","Boston 006","E02005422",5585,1596,2830,2812,2789,23,18,6,12,146,145,1,574,570,4,439,439,0
"2021","Boston 007","E02005423",8496,2654,3993,3967,3944,23,26,10,16,202,199,3,944,941,3,703,703,0
"2021","Boston 008","E02006864",7279,2077,3818,3808,3792,16,10,4,6,126,126,0,706,705,1,552,552,0
"2021","Boston 009","E02006865",6885,2099,3492,3478,3463,15,14,6,8,124,123,1,666,666,0,504,504,0
"2021","East Lindsey 001","E02005424",8743,2124,5011,4994,4974,20,17,4,13,152,152,0,801,801,0,655,655,0
"2021","East Lindsey 002","E02005425",5575,1341,3159,3149,3136,13,10,6,4,94,94,0,518,518,0,463,463,0
"2021","East Lindsey 003","E02005426",8434,2697,3850,3834,3812,22,16,8,8,203,202,1,976,976,0,708,708,0
"2021","East Lindsey 004","E02005427",5868,2027,2390,2374,2353,21,16,7,9,187,184,3,765,762,3,499,499,0
"2021","East Lindsey 005","E02005428",7339,2000,3545,3532,3521,11,13,6,7,179,179,0,859,854,5,756,756,0
"2021","East Lindsey 006","E02005429",5754,1023,3271,3245,3235,10,26,10,16,102,102,0,570,566,4,788,787,1
"2021","East Lindsey 007","E02005430",6137,1522,3437,3429,3425,4,8,0,8,115,115,0,587,585,2,476,476,0
"2021","East Lindsey 008","E02005431",7609,2006,3959,3936,3916,20,23,6,17,164,164,0,786,785,1,694,693,1
"2021","East Lindsey 009","E02005432",6747,1552,3920,3904,3883,21,16,6,10,159,157,2,625,624,1,491,491,0
"2021","East Lindsey 010","E02005433",6311,1524,3198,3178,3158,20,20,4,16,149,147,2,701,697,4,739,738,1
"2021","East Lindsey 011","E02005434",6311,1878,2998,2984,2962,22,14,6,8,167,165,2,734,734,0,534,534,0
"2021","East Lindsey 012","E02005435",6683,2104,3022,3006,2993,13,16,9,7,160,160,0,792,790,2,605,605,0
"2021","East Lindsey 013","E02005436",6900,1938,3518,3495,3480,15,23,6,17,160,157,3,696,696,0,588,586,2
"2021","East Lindsey 014","E02005437",5236,2099,1839,1826,1807,19,13,4,9,183,180,3,709,708,1,406,405,1
"2021","East Lindsey 015","E02005438",5732,1920,2446,2437,2414,23,9,4,5,124,124,0,689,687,2,553,553,0
"2021","East Lindsey 016","E02005439",10020,2750,5229,5214,5205,9,15,2,13,218,218,0,965,963,2,858,858,0
"2021","East Lindsey 017","E02005440",4714,1364,2390,2386,2375,11,4,2,2,94,94,0,469,468,1,397,396,1
"2021","East Lindsey 018","E02005441",7308,1818,3995,3977,3949,28,18,4,14,129,129,0,758,757,1,608,608,0
"2021","Lincoln 001","E02005442",5141,2429,1626,1616,1598,18,10,10,0,131,131,0,632,630,2,323,322,1
"2021","Lincoln 002","E02005443",6099,2346,2495,2474,2441,33,21,8,13,142,142,0,684,683,1,432,430,2
"2021","Lincoln 003","E02005444",11809,5860,3954,3942,3908,34,12,2,10,258,257,1,1141,1138,3,596,596,0
"2021","Lincoln 004","E02005445",10163,5608,2901,2873,2843,30,28,20,8,276,274,2,1018,1015,3,360,359,1
"2021","Lincoln 005","E02005446",9951,8115,1109,1098,1088,10,11,2,9,94,93,1,442,441,1,191,191,0
"2021","Lincoln 006","E02005447",7233,4617,1485,1470,1444,26,15,4,11,170,169,1,707,706,1,254,249,5
"2021","Lincoln 007","E02005448",5707,2485,2034,2026,2018,8,8,3,5,157,156,1,730,728,2,301,301,0
"2021","Lincoln 008","E02005449",8194,4738,2341,2329,2310,19,12,6,6,135,134,1,637,634,3,343,343,0
"2021","Lincoln 009","E02005450",7135,2287,3454,3438,3424,14,16,4,12,167,167,0,685,683,2,542,542,0
"2021","Lincoln 010","E02005451",6273,2996,1996,1987,1974,13,9,6,3,166,162,4,761,760,1,354,354,0
"2021","Lincoln 011","E02005452",9359,3049,4589,4576,4552,24,13,6,7,184,184,0,887,887,0,650,649,1
"2021","North Kesteven 001","E02005453",9116,2247,5193,5175,5166,9,18,0,18,145,145,0,848,845,3,683,683,0
"2021","North Kesteven 003","E02005455",11787,3320,6428,6401,6369,32,27,15,12,270,267,3,1109,1105,4,660,659,1
"2021","North Kesteven 004","E02005456",8883,2847,4343,4325,4295,30,18,2,16,202,200,2,899,896,3,592,591,1
"2021","North Kesteven 005","E02005457",7214,1898,3838,3832,3801,31,6,2,4,122,122,0,788,788,0,568,568,0
"2021","North Kesteven 006","E02005458",5766,1334,3324,3300,3293,7,24,10,14,85,84,1,566,564,2,457,457,0
"2021","North Kesteven 007","E02005459",7057,1977,3672,3666,3647,19,6,4,2,183,181,2,682,681,1,543,542,1
"2021","North Kesteven 008","E02005460",5305,1668,2796,2785,2772,13,11,6,5,137,136,1,461,461,0,243,243,0
"2021","North Kesteven 009","E02005461",5570,1252,3206,3198,3180,18,8,4,4,95,95,0,541,540,1,476,476,0
"2021","North Kesteven 010","E02005462",7971,2790,3324,3309,3297,12,15,6,9,256,254,2,1057,1057,0,544,543,1
"2021","North Kesteven 011","E02005463",8032,2285,4316,4309,4291,18,7,4,3,217,216,1,761,761,0,453,453,0
"2021","North Kesteven 012","E02005464",7425,1802,4130,4115,4081,34,15,4,11,186,186,0,717,714,3,590,587,3
"2021","North Kesteven 013","E02006866",7037,2215,3511,3499,3478,21,12,0,12,155,155,0,688,687,1,468,468,0
"2021","North Kesteven 014","E02006867",6840,1977,3460,3453,3436,17,7,2,5,141,141,0,666,665,1,596,594,2
"2021","South Holland 001","E02005465",7371,1884,3957,3939,3923,16,18,2,16,163,162,1,714,714,0,653,653,0
"2021","South Holland 002","E02005466",5728,1530,3079,3073,3063,10,6,0,6,109,109,0,534,533,1,476,475,1
"2021","South Holland 003","E02005467",6420,2021,2928,2919,2908,11,9,0,9,159,159,0,682,681,1,630,630,0
"2021","South Holland 004","E02005468",6411,1621,3569,3566,3561,5,3,2,1,124,124,0,588,587,1,509,508,1
"2021","South Holland 005","E02005469",6541,1913,3410,3396,3380,16,14,8,6,132,131,1,655,653,2,431,431,0
"2021","South Holland 006","E02005470",10570,3776,4568,4542,4520,22,26,12,14,229,227,2,1226,1223,3,771,769,2
"2021","South Holland 007","E02005471",7536,2603,3241,3222,3215,7,19,14,5,175,175,0,959,955,4,558,558,0
"2021","South Holland 008","E02005472",8343,2412,3961,3945,3925,20,16,8,8,210,209,1,968,966,2,792,792,0
"2021","South Holland 009","E02005473",8063,2655,3837,3833,3825,8,4,0,4,193,191,2,805,805,0,573,573,0
"2021","South Holland 010","E02005474",6126,1671,3266,3254,3247,7,12,2,10,110,109,1,614,614,0,465,465,0
"2021","South Holland 011","E02005475",5886,1770,3033,3015,2991,24,18,10,8,119,119,0,615,615,0,349,349,0
"2021","South Kesteven 001","E02005476",6067,1429,3519,3506,3493,13,13,4,9,121,120,1,561,561,0,437,434,3
"2021","South Kesteven 002","E02005477",7707,1625,4600,4590,4576,14,10,2,8,127,122,5,726,725,1,629,629,0
"2021","South Kesteven 003","E02005478",8127,2493,3869,3861,3849,12,8,4,4,171,168,3,881,879,2,713,710,3
"2021","South Kesteven 004","E02005479",8150,2484,4079,4065,4045,20,14,8,6,170,170,0,882,858,24,535,535,0
"2021","South Kesteven 005","E02005480",5561,2228,2221,2211,2204,7,10,2,8,174,172,2,600,599,1,338,337,1
"2021","South Kesteven 006","E02005481",9957,4129,3672,3655,3642,13,17,6,11,330,326,4,1248,1244,4,578,578,0
"2021","South Kesteven 007","E02005482",8073,2115,4510,4490,4475,15,20,10,10,163,160,3,822,822,0,463,463,0
"2021","South Kesteven 008","E02005483",6664,1707,3724,3709,3699,10,15,2,13,139,139,0,628,624,4,466,466,0
"2021","South Kesteven 009","E02005484",5999,1622,3155,3145,3129,16,10,6,4,137,137,0,692,689,3,393,393,0
"2021","South Kesteven 010","E02005485",6751,1972,3419,3413,3395,18,6,0,6,175,175,0,707,707,0,478,478,0
"2021","South Kesteven 011","E02005486",7711,2324,3644,3638,3630,8,6,2,4,207,201,6,897,897,0,639,639,0
"2021","South Kesteven 012","E02005487",8246,1774,5024,5009,4980,29,15,10,5,136,136,0,740,737,3,572,572,0
"2021","South Kesteven 013","E02005488",5874,1586,3056,3049,3040,9,7,2,5,151,151,0,641,640,1,440,440,0
"2021","South Kesteven 014","E02005489",6018,1712,3184,3179,3163,16,5,0,5,121,120,1,644,644,0,357,357,0
"2021","South Kesteven 015","E02005490",7579,2672,3253,3246,3232,14,7,2,5,177,175,2,949,949,0,528,528,0
"2021","South Kesteven 016","E02005491",9532,2942,4530,4517,4486,31,13,4,9,211,207,4,1121,1120,1,728,725,3
"2021","West Lindsey 001","E02005492",8281,2135,4448,4441,4434,7,7,4,3,211,209,2,849,849,0,638,638,0
"2021","West Lindsey 002","E02005493",8458,2403,4444,4430,4408,22,14,0,14,181,180,1,799,796,3,631,630,1
"2021","West Lindsey 003","E02005494",8245,2326,4093,4067,4048,19,26,10,16,178,178,0,939,937,2,709,709,0
"2021","West Lindsey 004","E02005495",8515,3510,2880,2870,2853,17,10,0,10,342,335,7,1204,1202,2,579,578,1
"2021","West Lindsey 005","E02005496",5352,1345,2968,2948,2935,13,20,2,18,128,126,2,579,576,3,332,332,0
"2021","West Lindsey 006","E02005497",5693,2263,2174,2158,2143,15,16,6,10,183,179,4,646,646,0,427,427,0
"2021","West Lindsey 007","E02005498",6452,1425,3743,3731,3712,19,12,4,8,131,131,0,623,620,3,530,530,0
"2021","West Lindsey 008","E02005499",7004,1857,3841,3837,3821,16,4,2,2,130,127,3,675,673,2,501,501,0
"2021","West Lindsey 009","E02005500",6211,1686,3302,3294,3284,10,8,2,6,149,149,0,658,658,0,416,416,0
"2021","West Lindsey 010","E02005501",6767,1639,3869,3855,3842,13,14,2,12,104,104,0,607,606,1,548,547,1
"2021","West Lindsey 011","E02005502",8142,2189,4356,4347,4317,30,9,0,9,155,153,2,800,796,4,642,642,0
"2021","Ashfield 001","E02005819",5208,1710,2439,2430,2417,13,9,2,7,136,135,1,547,545,2,376,376,0
"2021","Ashfield 002","E02005820",4709,1443,2347,2345,2341,4,2,0,2,93,92,1,465,464,1,361,361,0
"2021","Ashfield 003","E02005821",5370,2006,2202,2189,2168,21,13,1,12,151,150,1,651,650,1,360,360,0
"2021","Ashfield 004","E02005822",8111,3415,3013,3006,2995,11,7,2,5,252,249,3,968,965,3,463,463,0
"2021","Ashfield 005","E02005823",6156,2487,2140,2133,2121,12,7,2,5,171,171,0,750,749,1,608,604,4
"2021","Ashfield 006","E02005824",8135,2708,3923,3906,3883,23,17,6,11,152,152,0,822,821,1,530,530,0
"2021","Ashfield 007","E02005825",6270,2221,2927,2920,2906,14,7,3,4,137,137,0,593,592,1,392,392,0
"2021","Ashfield 008","E02005826",4767,1967,1725,1718,1708,10,7,0,7,155,154,1,543,543,0,377,375,2
"2021","Ashfield 009","E02005827",7719,2619,3694,3691,3664,27,3,0,3,173,172,1,758,755,3,475,473,2
"2021","Ashfield 010","E02005828",6380,2010,3136,3128,3100,28,8,0,8,142,140,2,632,629,3,460,460,0
"2021","Ashfield 011","E02005829",5475,1750,2613,2604,2593,11,9,4,5,113,112,1,543,543,0,456,455,1
"2021","Ashfield 012","E02005830",5051,1523,2507,2496,2486,10,11,4,7,107,105,2,499,498,1,415,414,1
"2021","Ashfield 013","E02005831",8516,2932,4171,4158,4127,31,13,0,13,151,150,1,751,748,3,511,509,2
"2021","Ashfield 014","E02005832",7601,3297,2620,2599,2574,25,21,10,11,237,235,2,964,960,4,483,483,0
"2021","Ashfield 015","E02005833",6338,1950,3368,3366,3356,10,2,2,0,101,101,0,501,499,2,418,416,2
"2021","Ashfield 016","E02005834",7027,2927,2789,2775,2752,23,14,2,12,193,192,1,666,666,0,452,452,0
"2021","Bassetlaw 001","E02005835",9118,3106,4109,4089,4069,20,20,5,15,242,242,0,970,970,0,691,691,0
"2021","Bassetlaw 002","E02005836",7767,1987,4254,4244,4216,28,10,0,10,125,125,0,798,797,1,603,603,0
"2021","Bassetlaw 003","E02005837",6772,2215,3372,3358,3338,20,14,6,8,122,121,1,652,652,0,411,410,1
"2021","Bassetlaw 004","E02005838",6802,2102,3318,3303,3292,11,15,6,9,155,152,3,701,701,0,526,526,0
"2021","Bassetlaw 005","E02005839",5391,1609,2469,2469,2453,16,0,0,0,111,111,0,661,661,0,541,541,0
"2021","Bassetlaw 006","E02005840",7736,2591,3829,3823,3807,16,6,6,0,169,168,1,769,768,1,378,376,2
"2021","Bassetlaw 008","E02005842",7274,2405,3261,3254,3236,18,7,4,3,187,185,2,848,846,2,573,573,0
"2021","Bassetlaw 009","E02005843",5679,1939,2708,2703,2690,13,5,2,3,122,122,0,579,579,0,331,330,1
"2021","Bassetlaw 010","E02005844",7063,2482,3026,3011,2992,19,15,2,13,196,195,1,872,867,5,487,487,0
"2021","Bassetlaw 012","E02005846",5320,2459,1705,1689,1671,18,16,6,10,174,174,0,642,642,0,340,340,0
"2021","Bassetlaw 013","E02005847",5838,2039,2708,2693,2676,17,15,2,13,119,117,2,584,583,1,388,387,1
"2021","Bassetlaw 014","E02005848",5390,1565,2784,2780,2765,15,4,0,4,139,139,0,468,466,2,434,434,0
"2021","Bassetlaw 015","E02005849",7944,2160,4251,4243,4224,19,8,6,2,160,160,0,822,822,0,551,551,0
"2021","Bassetlaw 016","E02006903",9267,2823,4437,4429,4407,22,8,0,8,202,202,0,988,988,0,817,817,0
"2021","Broxtowe 001","E02005850",5621,1667,2831,2821,2806,15,10,4,6,115,115,0,562,562,0,446,442,4
"2021","Broxtowe 002","E02005851",4993,1959,1960,1953,1937,16,7,6,1,133,133,0,573,570,3,368,367,1
"2021","Broxtowe 003","E02005852",7019,2047,3717,3706,3695,11,11,6,5,124,124,0,600,598,2,531,531,0
"2021","Broxtowe 004","E02005853",7599,2382,3798,3780,3769,11,18,10,8,162,161,1,750,748,2,507,507,0
"2021","Broxtowe 007","E02005856",6104,1546,3540,3527,3510,17,13,3,10,78,78,0,455,454,1,485,485,0
"2021","Broxtowe 008","E02005857",4954,1972,1978,1972,1968,4,6,4,2,115,115,0,532,531,1,357,356,1
"2021","Broxtowe 009","E02005858",6850,3349,2662,2646,2625,21,16,4,12,108,106,2,455,454,1,276,276,0
"2021","Broxtowe 010","E02005859",7531,2763,3272,3258,3239,19,14,8,6,208,206,2,821,819,2,467,467,0
"2021","Broxtowe 011","E02005860",8053,4251,2620,2604,2578,26,16,8,8,122,122,0,591,589,2,469,469,0
"2021","Broxtowe 012","E02005861",4559,2074,1710,1699,1691,8,11,4,7,85,85,0,438,438,0,252,251,1
"2021","Broxtowe 013","E02005862",6165,2145,2888,2878,2853,25,10,2,8,127,123,4,543,543,0,462,460,2
"2021","Broxtowe 014","E02005863",6229,1797,3344,3332,3323,9,12,6,6,96,96,0,481,478,3,511,508,3
"2021","Broxtowe 015","E02005864",6633,1902,3579,3562,3562,0,17,6,11,149,149,0,574,573,1,429,429,0
"2021","Broxtowe 016","E02006906",10228,3116,5290,5286,5273,13,4,0,4,212,210,2,893,892,1,717,717,0
"2021","Gedling 001","E02005865",7196,1868,4172,4160,4138,22,12,4,8,98,95,3,525,524,1,533,533,0
"2021","Gedling 002","E02005866",7618,2191,3926,3916,3902,14,10,0,10,160,159,1,782,777,5,559,559,0
"2021","Gedling 004","E02005868",5957,2058,2886,2878,2870,8,8,4,4,91,91,0,530,528,2,392,392,0
"2021","Gedling 005","E02005869",4625,1901,1734,1727,1714,13,7,0,7,120,120,0,528,524,4,342,342,0
"2021","Gedling 006","E02005870",5384,2299,1898,1879,1860,19,19,8,11,163,163,0,668,666,2,356,356,0
"2021","Gedling 007","E02005871",5965,1944,2931,2926,2916,10,5,2,3,91,90,1,573,570,3,426,426,0
"2021","Gedling 008","E02005872",5461,1539,2940,2926,2909,17,14,6,8,84,84,0,461,461,0,437,437,0
"2021","Gedling 009","E02005873",8335,2413,4557,4530,4505,25,27,6,21,129,126,3,656,656,0,580,577,3
"2021","Gedling 010","E02005874",7024,2401,3379,3366,3331,35,13,2,11,139,139,0,648,647,1,457,456,1
"2021","Gedling 011","E02005875",6605,2557,2947,2933,2920,13,14,2,12,136,136,0,564,562,2,401,401,0
"2021","Gedling 012","E02005876",7222,2569,3334,3320,3292,28,14,2,12,165,163,2,670,670,0,484,483,1
"2021","Gedling 013","E02005877",6000,2427,2504,2482,2456,26,22,10,12,124,124,0,542,540,2,403,403,0
"2021","Gedling 014","E02005878",8117,3148,3236,3213,3191,22,23,8,15,206,205,1,928,926,2,599,599,0
"2021","Gedling 015","E02005879",5928,2814,1963,1953,1927,26,10,2,8,182,182,0,690,690,0,279,279,0
"2021","Gedling 016","E02006835",5016,1802,2383,2379,2360,19,4,0,4,123,121,2,456,455,1,252,251,1
"2021","Mansfield 001","E02005880",5093,1769,2295,2289,2280,9,6,4,2,116,115,1,506,502,4,407,407,0
"2021","Mansfield 002","E02005881",5066,1667,2355,2351,2330,21,4,2,2,113,111,2,563,561,2,368,368,0
"2021","Mansfield 003","E02005882",6545,1821,3454,3445,3433,12,9,6,3,111,111,0,625,621,4,534,532,2
"2021","Mansfield 004","E02005883",6625,2537,2670,2661,2649,12,9,2,7,180,178,2,799,797,2,439,439,0
"2021","Mansfield 005","E02005884",5160,1710,2383,2369,2364,5,14,2,12,137,137,0,579,579,0,351,351,0
"2021","Mansfield 006","E02005885",7305,2640,3125,3110,3099,11,15,10,5,164,161,3,806,806,0,570,570,0
"2021","Mansfield 007","E02005886",9259,2877,4678,4667,4641,26,11,2,9,177,176,1,878,878,0,649,649,0
"2021","Mansfield 008","E02005887",8353,3886,2659,2645,2628,17,14,6,8,269,268,1,1009,1008,1,530,530,0
"2021","Mansfield 009","E02005888",6802,3092,2237,2219,2200,19,18,16,2,219,218,1,877,875,2,377,375,2
"2021","Mansfield 010","E02005889",8653,3048,3868,3855,3829,26,13,5,8,197,194,3,894,893,1,646,645,1
"2021","Mansfield 011","E02005890",5544,1589,2927,2917,2907,10,10,0,10,96,96,0,562,561,1,370,370,0
"2021","Mansfield 012","E02005891",5049,2194,1785,1778,1761,17,7,0,7,149,147,2,635,633,2,286,285,1
"2021","Mansfield 013","E02005892",10720,3120,5750,5740,5713,27,10,4,6,218,217,1,927,926,1,705,704,1
"2021","Newark and Sherwood 001","E02005893",9220,3358,3941,3937,3918,19,4,2,2,307,304,3,983,980,3,631,630,1
"2021","Newark and Sherwood 002","E02005894",9454,3155,4478,4462,4443,19,16,7,9,198,198,0,947,946,1,676,676,0
"2021","Newark and Sherwood 003","E02005895",6905,1594,4058,4034,4020,14,24,8,16,127,127,0,601,600,1,525,525,0
"2021","Newark and Sherwood 004","E02005896",6507,1591,3672,3644,3632,12,28,18,10,110,110,0,609,607,2,525,524,1
"2021","Newark and Sherwood 005","E02005897",7710,2081,4191,4181,4169,12,10,0,10,138,137,1,759,758,1,541,540,1
"2021","Newark and Sherwood 006","E02005898",9298,3321,4050,4024,3993,31,26,4,22,227,226,1,1044,1040,4,656,656,0
"2021","Newark and Sherwood 007","E02005899",9667,4181,3278,3269,3249,20,9,2,7,326,323,3,1291,1284,7,591,591,0
"2021","Newark and Sherwood 008","E02005900",6491,1976,3310,3302,3293,9,8,4,4,87,87,0,544,544,0,574,574,0
"2021","Newark and Sherwood 009","E02005901",7835,2871,3453,3434,3423,11,19,4,15,186,184,2,864,860,4,461,460,1
"2021","Newark and Sherwood 010","E02005902",6634,2395,2815,2792,2770,22,23,6,17,194,192,2,733,732,1,497,496,1
"2021","Newark and Sherwood 011","E02005903",8631,2730,4077,4063,4037,26,14,8,6,195,195,0,942,940,2,687,686,1
"2021","Newark and Sherwood 012","E02005904",7734,2120,4232,4220,4197,23,12,4,8,137,137,0,734,731,3,511,511,0
"2021","Newark and Sherwood 013","E02005905",5880,1832,3109,3099,3089,10,10,2,8,80,80,0,512,512,0,347,347,0
"2021","Rushcliffe 001","E02005906",6249,1841,3230,3216,3209,7,14,8,6,127,127,0,636,636,0,415,415,0
"2021","Rushcliffe 002","E02005907",8066,2388,4089,4083,4073,10,6,4,2,201,200,1,834,833,1,554,553,1
"2021","Rushcliffe 003","E02005908",7716,2065,4108,4084,4049,35,24,8,16,168,165,3,692,692,0,683,683,0
"2021","Rushcliffe 004","E02005909",6605,2465,3348,3316,3283,33,32,12,20,88,86,2,454,453,1,250,250,0
"2021","Rushcliffe 005","E02005910",7468,3811,2622,2606,2592,14,16,10,6,145,144,1,576,571,5,314,314,0
"2021","Rushcliffe 006","E02005911",6871,2170,3673,3663,3642,21,10,6,4,111,111,0,559,558,1,358,358,0
"2021","Rushcliffe 007","E02005912",7648,2183,4135,4125,4115,10,10,4,6,128,128,0,621,619,2,581,581,0
"2021","Rushcliffe 008","E02005913",6800,1982,3785,3774,3760,14,11,4,7,111,108,3,490,487,3,432,432,0
"2021","Rushcliffe 009","E02005914",6591,2353,3081,3065,3046,19,16,2,14,106,105,1,647,643,4,404,404,0
"2021","Rushcliffe 010","E02005915",4846,1225,2807,2799,2790,9,8,2,6,92,92,0,409,409,0,313,312,1
"2021","Rushcliffe 011","E02005916",6193,1997,3061,3059,3036,23,2,0,2,131,131,0,566,566,0,438,436,2
"2021","Rushcliffe 012","E02005917",5035,983,3232,3224,3218,6,8,0,8,68,67,1,346,346,0,406,406,0
"2021","Rushcliffe 013","E02005918",4296,1205,2239,2229,2220,9,10,4,6,78,78,0,385,385,0,389,389,0
"2021","Rushcliffe 014","E02005919",6106,2384,2781,2770,2744,26,11,4,7,115,115,0,483,481,2,343,343,0
"2021","Rushcliffe 015","E02005920",7236,1966,4114,4094,4081,13,20,4,16,103,103,0,573,572,1,480,480,0
"2021","Herefordshire 001","E02002905",5419,1362,3090,3070,3048,22,20,0,20,85,83,2,499,498,1,383,382,1
"2021","Herefordshire 002","E02002906",4613,1605,2041,2036,2033,3,5,3,2,110,110,0,488,488,0,369,369,0
"2021","Herefordshire 003","E02002907",5261,1853,2169,2158,2144,14,11,4,7,126,126,0,652,652,0,461,459,2
"2021","Herefordshire 004","E02002908",7595,1899,4325,4307,4275,32,18,4,14,115,114,1,679,679,0,577,577,0
"2021","Herefordshire 005","E02002909",9217,2508,4885,4853,4825,28,32,16,16,210,207,3,891,891,0,723,720,3
"2021","Herefordshire 006","E02002910",6754,1857,3567,3534,3522,12,33,12,21,137,136,1,676,675,1,517,515,2
"2021","Herefordshire 007","E02002911",8038,2095,4465,4443,4424,19,22,6,16,157,157,0,709,709,0,612,612,0
"2021","Herefordshire 008","E02002912",6317,1830,3385,3376,3361,15,9,0,9,139,138,1,564,564,0,399,396,3
"2021","Herefordshire 009","E02002913",5055,1210,2997,2975,2962,13,22,0,22,80,80,0,442,442,0,326,326,0
"2021","Herefordshire 010","E02002914",7449,2597,3291,3272,3262,10,19,12,7,153,153,0,872,872,0,536,536,0
"2021","Herefordshire 011","E02002915",6665,2083,3233,3221,3218,3,12,6,6,129,128,1,652,650,2,568,568,0
"2021","Herefordshire 012","E02002916",8196,3534,2867,2862,2847,15,5,0,5,230,228,2,1078,1077,1,487,487,0
"2021","Herefordshire 013","E02002917",5772,2209,2327,2317,2304,13,10,6,4,134,134,0,688,688,0,414,414,0
"2021","Herefordshire 014","E02002918",4794,1271,2631,2624,2619,5,7,4,3,81,80,1,401,400,1,410,410,0
"2021","Herefordshire 015","E02002919",7219,2636,3063,3050,3037,13,13,6,7,206,205,1,833,832,1,481,480,1
"2021","Herefordshire 016","E02002920",5449,1680,2787,2771,2755,16,16,8,8,121,121,0,519,518,1,342,342,0
"2021","Herefordshire 017","E02002921",6000,2501,2255,2238,2217,21,17,7,10,185,185,0,747,746,1,312,312,0
"2021","Herefordshire 018","E02002922",5626,1454,3181,3170,3150,20,11,6,5,94,94,0,503,502,1,394,391,3
"2021","Herefordshire 019","E02002923",8086,2298,3972,3957,3942,15,15,6,9,169,169,0,876,874,2,771,768,3
"2021","Herefordshire 020","E02002924",5086,1306,2845,2820,2806,14,25,8,17,80,80,0,456,455,1,399,399,0
"2021","Herefordshire 021","E02002925",9039,2616,4882,4859,4839,20,23,12,11,157,157,0,852,850,2,532,532,0
"2021","Herefordshire 022","E02002926",9282,2906,4244,4226,4207,19,18,8,10,206,205,1,1088,1088,0,838,838,0
"2021","Herefordshire 023","E02002927",10190,2447,5925,5893,5869,24,32,2,30,167,164,3,904,903,1,747,745,2
"2021","Telford and Wrekin 001","E02002928",5079,1591,2517,2515,2505,10,2,2,0,95,95,0,517,517,0,359,359,0
"2021","Telford and Wrekin 002","E02002929",5732,1896,2970,2960,2951,9,10,4,6,74,74,0,401,399,2,391,389,2
"2021","Telford and Wrekin 003","E02002930",5732,2036,2463,2459,2447,12,4,0,4,124,124,0,644,643,1,465,464,1
"2021","Telford and Wrekin 004","E02002931",5468,1500,3117,3114,3100,14,3,0,3,98,98,0,460,459,1,293,293,0
"2021","Telford and Wrekin 005","E02002932",6965,2938,2639,2629,2614,15,10,8,2,223,223,0,781,777,4,384,384,0
"2021","Telford and Wrekin 006","E02002933",6716,2142,3273,3269,3253,16,4,0,4,128,126,2,676,676,0,497,497,0
"2021","Telford and Wrekin 007","E02002934",5064,1624,2483,2481,2471,10,2,0,2,118,118,0,544,544,0,295,295,0
"2021","Telford and Wrekin 008","E02002935",5558,1903,2573,2565,2552,13,8,2,6,113,113,0,566,564,2,403,403,0
"2021","Telford and Wrekin 009","E02002936",8476,3527,3535,3526,3508,18,9,3,6,239,236,3,821,820,1,354,354,0
"2021","Telford and Wrekin 010","E02002937",9148,2582,4908,4891,4865,26,17,4,13,187,184,3,889,883,6,582,580,2
"2021","Telford and Wrekin 011","E02002938",5757,2157,2592,2588,2570,18,4,0,4,139,136,3,601,600,1,268,268,0
"2021","Telford and Wrekin 012","E02002939",6308,2288,2653,2643,2626,17,10,2,8,158,156,2,706,702,4,503,503,0
"2021","Telford and Wrekin 013","E02002940",4888,1840,1994,1988,1974,14,6,3,3,129,128,1,570,568,2,355,354,1
"2021","Telford and Wrekin 014","E02002941",8576,3040,3769,3761,3736,25,8,4,4,200,199,1,983,980,3,584,583,1
"2021","Telford and Wrekin 015","E02002942",6293,1956,3473,3467,3455,12,6,4,2,119,119,0,482,480,2,263,263,0
"2021","Telford and Wrekin 017","E02002944",6497,2869,2304,2297,2269,28,7,4,3,192,191,1,758,752,6,374,372,2
"2021","Telford and Wrekin 018","E02002945",7482,2870,3238,3224,3204,20,14,12,2,211,211,0,779,778,1,384,384,0
"2021","Telford and Wrekin 019","E02002946",6285,2256,2689,2675,2658,17,14,8,6,173,173,0,761,759,2,406,406,0
"2021","Telford and Wrekin 020","E02002947",5383,2142,2189,2169,2160,9,20,4,16,168,166,2,591,590,1,293,293,0
"2021","Telford and Wrekin 021","E02002948",5467,2622,1794,1783,1750,33,11,8,3,193,193,0,599,595,4,259,256,3
"2021","Telford and Wrekin 022","E02002949",4564,1573,1927,1917,1903,14,10,4,6,143,143,0,565,563,2,356,355,1
"2021","Telford and Wrekin 023","E02002950",4494,1774,1795,1784,1780,4,11,2,9,136,136,0,497,496,1,292,292,0
"2021","Telford and Wrekin 024","E02007050",6320,2648,2702,2685,2663,22,17,6,11,152,150,2,579,575,4,239,238,1
"2021","Telford and Wrekin 025","E02007051",6428,2431,3017,3007,2990,17,10,2,8,141,139,2,603,601,2,236,236,0
"2021","Stoke-on-Trent 001","E02002951",6424,2165,3008,2997,2979,18,11,4,7,125,124,1,613,612,1,513,512,1
"2021","Stoke-on-Trent 002","E02002952",5850,2258,2475,2463,2446,17,12,4,8,157,157,0,575,575,0,385,385,0
"2021","Stoke-on-Trent 003","E02002953",5877,2209,2488,2476,2472,4,12,6,6,134,134,0,522,520,2,524,524,0
"2021","Stoke-on-Trent 004","E02002954",6578,2422,2808,2793,2776,17,15,6,9,167,167,0,685,682,3,496,496,0
"2021","Stoke-on-Trent 005","E02002955",5570,2296,2218,2197,2187,10,21,8,13,173,169,4,592,588,4,291,291,0
"2021","Stoke-on-Trent 006","E02002956",7258,2967,2935,2918,2899,19,17,8,9,210,209,1,683,682,1,463,463,0
"2021","Stoke-on-Trent 007","E02002957",8008,2381,4085,4080,4073,7,5,0,5,150,150,0,751,750,1,641,640,1
"2021","Stoke-on-Trent 008","E02002958",6710,2636,2697,2688,2667,21,9,0,9,160,159,1,708,707,1,509,509,0
"2021","Stoke-on-Trent 009","E02002959",7002,3175,2394,2387,2364,23,7,0,7,253,252,1,760,758,2,420,420,0
"2021","Stoke-on-Trent 010","E02002960",4767,1591,2347,2338,2332,6,9,2,7,93,93,0,423,421,2,313,313,0
"2021","Stoke-on-Trent 011","E02002961",5623,2350,2371,2361,2349,12,10,8,2,173,171,2,464,464,0,265,264,1
"2021","Stoke-on-Trent 012","E02002962",5984,2682,2037,2020,2011,9,17,8,9,178,172,6,608,606,2,479,478,1
"2021","Stoke-on-Trent 013","E02002963",5773,2639,1987,1976,1967,9,11,3,8,169,168,1,654,652,2,324,323,1
"2021","Stoke-on-Trent 014","E02002964",7110,2539,3067,3062,3053,9,5,2,3,166,166,0,702,698,4,636,634,2
"2021","Stoke-on-Trent 015","E02002965",6401,3145,2418,2402,2379,23,16,8,8,169,168,1,445,444,1,224,223,1
"2021","Stoke-on-Trent 016","E02002966",8575,5083,2364,2354,2334,20,10,2,8,233,232,1,603,601,2,292,290,2
"2021","Stoke-on-Trent 017","E02002967",7651,3484,2481,2464,2457,7,17,6,11,325,324,1,866,866,0,495,494,1
"2021","Stoke-on-Trent 018","E02002968",7890,3529,3023,3015,2991,24,8,6,2,199,199,0,728,727,1,411,411,0
"2021","Stoke-on-Trent 019","E02002969",7763,3951,2431,2428,2407,21,3,0,3,228,227,1,774,769,5,379,378,1
"2021","Stoke-on-Trent 020","E02002970",6363,2868,2020,2012,2008,4,8,2,6,225,223,2,810,810,0,440,440,0
"2021","Stoke-on-Trent 023","E02002973",6451,2674,2617,2608,2590,18,9,4,5,166,165,1,644,642,2,350,349,1
"2021","Stoke-on-Trent 024","E02002974",5035,1601,2469,2461,2447,14,8,4,4,98,98,0,416,414,2,451,451,0
"2021","Stoke-on-Trent 025","E02002975",6031,1982,3017,3017,3000,17,0,0,0,118,118,0,530,529,1,384,384,0
"2021","Stoke-on-Trent 026","E02002976",4726,1730,2146,2134,2117,17,12,4,8,118,117,1,423,422,1,309,309,0
"2021","Stoke-on-Trent 027","E02002977",4705,1553,1955,1943,1928,15,12,2,10,142,142,0,551,551,0,504,504,0
"2021","Stoke-on-Trent 028","E02002978",5160,2141,1888,1876,1865,11,12,4,8,256,255,1,537,537,0,338,338,0
"2021","Stoke-on-Trent 029","E02002979",4507,1652,2146,2139,2128,11,7,6,1,122,122,0,349,349,0,238,235,3
"2021","Stoke-on-Trent 030","E02002980",5035,1372,2654,2650,2638,12,4,0,4,84,84,0,465,463,2,460,460,0
"2021","Stoke-on-Trent 031","E02002981",6484,2407,2930,2912,2901,11,18,4,14,189,189,0,604,603,1,354,352,2
"2021","Stoke-on-Trent 032","E02002982",6636,2950,2465,2451,2421,30,14,0,14,202,201,1,671,668,3,348,348,0
"2021","Stoke-on-Trent 033","E02002983",4424,1215,2472,2467,2465,2,5,0,5,76,76,0,351,350,1,310,310,0
"2021","Stoke-on-Trent 034","E02002984",4649,1198,2668,2662,2660,2,6,4,2,59,59,0,384,383,1,340,339,1
"2021","Stoke-on-Trent 035","E02006974",8889,3444,3594,3580,3552,28,14,4,10,246,243,3,975,972,3,630,629,1
"2021","Shropshire 025","E02006008",8572,2794,4191,4183,4170,13,8,0,8,208,208,0,853,852,1,526,525,1
"2021","Shropshire 027","E02006009",6963,2678,2989,2986,2965,21,3,2,1,167,166,1,619,612,7,510,510,0
"2021","Shropshire 029","E02006010",9948,2829,5223,5205,5163,42,18,6,12,185,183,2,993,992,1,718,715,3
"2021","Shropshire 031","E02006011",4828,1299,2489,2479,2473,6,10,3,7,101,101,0,471,471,0,468,467,1
"2021","Shropshire 033","E02006012",5384,1541,2626,2614,2604,10,12,3,9,108,108,0,641,641,0,468,467,1
"2021","Shropshire 034","E02006013",6788,1666,3929,3892,3883,9,37,10,27,115,113,2,583,582,1,495,494,1
"2021","Shropshire 035","E02006014",8479,2315,4588,4577,4560,17,11,2,9,135,135,0,768,767,1,673,672,1
"2021","Shropshire 001","E02006015",8469,2802,3916,3902,3868,34,14,8,6,203,203,0,870,869,1,678,678,0
"2021","Shropshire 002","E02006016",6963,1804,3966,3955,3930,25,11,4,7,138,137,1,583,583,0,472,472,0
"2021","Shropshire 004","E02006017",6802,1912,3568,3555,3543,12,13,0,13,108,106,2,703,702,1,511,511,0
"2021","Shropshire 005","E02006018",10281,3310,4921,4897,4883,14,24,10,14,189,189,0,1023,1022,1,838,838,0
"2021","Shropshire 008","E02006019",5346,1757,2483,2465,2451,14,18,0,18,105,103,2,536,536,0,465,465,0
"2021","Shropshire 009","E02006020",6582,2423,3114,3098,3086,12,16,10,6,146,146,0,547,547,0,352,352,0
"2021","Shropshire 010","E02006021",7304,1926,4196,4183,4174,9,13,4,9,127,127,0,606,604,2,449,447,2
"2021","Shropshire 013","E02006022",5048,1404,2818,2810,2793,17,8,2,6,75,75,0,412,411,1,339,338,1
"2021","Shropshire 003","E02006023",8305,2554,4129,4112,4086,26,17,2,15,192,191,1,796,795,1,634,634,0
"2021","Shropshire 006","E02006024",8110,2811,3604,3589,3570,19,15,4,11,151,149,2,900,897,3,644,642,2
"2021","Shropshire 007","E02006025",8173,2875,3414,3405,3393,12,9,5,4,272,272,0,962,962,0,650,650,0
"2021","Shropshire 011","E02006026",6154,1699,3428,3413,3403,10,15,4,11,83,83,0,532,529,3,412,411,1
"2021","Shropshire 012","E02006027",4653,1265,2594,2584,2569,15,10,6,4,67,67,0,403,403,0,324,322,2
"2021","Shropshire 014","E02006028",8276,2333,4465,4462,4447,15,3,2,1,126,121,5,730,728,2,622,622,0
"2021","Shropshire 015","E02006029",6413,2616,2612,2608,2598,10,4,0,4,150,149,1,650,649,1,385,385,0
"2021","Shropshire 016","E02006030",7387,3179,2826,2809,2790,19,17,2,15,260,258,2,763,763,0,359,359,0
"2021","Shropshire 017","E02006031",6776,2909,2421,2400,2380,20,21,8,13,184,183,1,864,863,1,398,398,0
"2021","Shropshire 018","E02006032",6969,2637,2927,2902,2889,13,25,16,9,136,131,5,834,834,0,435,434,1
"2021","Shropshire 019","E02006033",7462,2901,2823,2793,2777,16,30,12,18,185,184,1,927,923,4,626,621,5
"2021","Shropshire 020","E02006034",8695,2776,4369,4334,4321,13,35,12,23,188,186,2,862,856,6,500,500,0
"2021","Shropshire 021","E02006035",5027,1293,2613,2607,2594,13,6,0,6,72,72,0,571,569,2,478,478,0
"2021","Shropshire 022","E02006036",5651,2074,2274,2260,2237,23,14,4,10,144,144,0,711,710,1,448,448,0
"2021","Shropshire 023","E02006037",8137,2658,4031,4014,3997,17,17,2,15,130,129,1,775,775,0,543,543,0
"2021","Shropshire 024","E02006038",6961,2051,3639,3621,3612,9,18,8,10,133,133,0,618,618,0,520,520,0
"2021","Shropshire 026","E02006039",6873,1852,3723,3706,3679,27,17,4,13,114,111,3,645,643,2,539,538,1
"2021","Shropshire 028","E02006040",6605,1746,3774,3752,3731,21,22,5,17,114,112,2,584,583,1,387,387,0
"2021","Shropshire 030","E02006041",4889,1417,2514,2500,2483,17,14,6,8,84,84,0,519,518,1,355,355,0
"2021","Shropshire 032","E02006042",5126,1189,2851,2842,2832,10,9,1,8,87,87,0,477,477,0,522,521,1
"2021","Shropshire 036","E02006043",5709,1657,2996,2979,2970,9,17,2,15,115,113,2,549,549,0,392,392,0
"2021","Shropshire 037","E02006044",5361,1299,3132,3109,3083,26,23,4,19,91,91,0,461,460,1,378,378,0
"2021","Shropshire 038","E02006045",9190,2878,4196,4168,4143,25,28,12,16,175,174,1,1031,1027,4,910,906,4
"2021","Shropshire 039","E02006046",7583,1947,4245,4229,4211,18,16,12,4,163,163,0,684,683,1,544,544,0
"2021","Cannock Chase 001","E02006118",6310,1728,3448,3436,3429,7,12,6,6,108,108,0,552,552,0,474,474,0
"2021","Cannock Chase 002","E02006119",6675,2535,2644,2628,2612,16,16,4,12,168,168,0,815,815,0,513,513,0
"2021","Cannock Chase 003","E02006120",7486,2602,3384,3382,3370,12,2,0,2,163,162,1,807,804,3,530,529,1
"2021","Cannock Chase 004","E02006121",4842,1687,2280,2267,2251,16,13,2,11,105,104,1,466,464,2,304,304,0
"2021","Cannock Chase 005","E02006122",6573,2538,2897,2887,2860,27,10,8,2,153,153,0,629,629,0,356,356,0
"2021","Cannock Chase 006","E02006123",5294,1735,2674,2669,2662,7,5,0,5,111,110,1,469,469,0,305,305,0
"2021","Cannock Chase 007","E02006124",5831,2287,2336,2323,2316,7,13,4,9,141,140,1,644,643,1,423,422,1
"2021","Cannock Chase 008","E02006125",6060,2315,2461,2457,2442,15,4,0,4,165,163,2,666,665,1,453,453,0
"2021","Cannock Chase 009","E02006126",6927,2297,3333,3325,3301,24,8,4,4,170,169,1,646,646,0,481,481,0
"2021","Cannock Chase 010","E02006127",5710,1979,2935,2926,2914,12,9,0,9,93,92,1,523,522,1,180,180,0
"2021","Cannock Chase 011","E02006128",7242,2129,3614,3600,3592,8,14,2,12,174,173,1,698,697,1,627,627,0
"2021","Cannock Chase 012","E02006129",6757,2912,2414,2402,2381,21,12,4,8,200,196,4,787,786,1,444,442,2
"2021","Cannock Chase 013","E02006130",6771,2361,3178,3165,3142,23,13,4,9,155,155,0,625,622,3,452,452,0
"2021","East Staffordshire 001","E02006131",6535,1887,3578,3564,3546,18,14,4,10,105,104,1,539,536,3,426,426,0
"2021","East Staffordshire 002","E02006132",5638,1971,2593,2583,2572,11,10,2,8,110,109,1,557,554,3,407,407,0
"2021","East Staffordshire 003","E02006133",5821,2012,2617,2617,2601,16,0,0,0,144,143,1,624,622,2,424,424,0
"2021","East Staffordshire 004","E02006134",8671,2397,4743,4730,4724,6,13,2,11,154,153,1,767,764,3,610,610,0
"2021","East Staffordshire 005","E02006135",6533,1742,3618,3606,3593,13,12,10,2,116,115,1,559,559,0,498,498,0
"2021","East Staffordshire 006","E02006136",7845,2316,4148,4130,4113,17,18,4,14,124,124,0,647,646,1,610,609,1
"2021","East Staffordshire 007","E02006137",7186,2681,3002,2987,2966,21,15,2,13,207,207,0,748,745,3,548,548,0
"2021","East Staffordshire 008","E02006138",6097,2547,2514,2494,2477,17,20,8,12,174,172,2,594,593,1,268,266,2
"2021","East Staffordshire 009","E02006139",6473,2707,2706,2697,2682,15,9,5,4,193,191,2,540,539,1,327,327,0
"2021","East Staffordshire 010","E02006140",6728,2342,3092,3077,3054,23,15,6,9,186,183,3,665,664,1,443,443,0
"2021","East Staffordshire 011","E02006141",9491,4353,3561,3541,3518,23,20,10,10,281,280,1,893,892,1,403,403,0
"2021","East Staffordshire 012","E02006142",4439,1291,2372,2366,2359,7,6,6,0,73,73,0,398,397,1,305,305,0
"2021","East Staffordshire 013","E02006143",7511,2581,3726,3712,3688,24,14,6,8,157,157,0,641,640,1,406,406,0
"2021","East Staffordshire 014","E02006144",6643,2709,2448,2438,2427,11,10,2,8,195,193,2,780,779,1,511,511,0
"2021","East Staffordshire 015","E02006145",4899,1084,2881,2873,2867,6,8,6,2,80,80,0,501,500,1,353,353,0
"2021","Lichfield 001","E02006146",7222,2206,3679,3673,3648,25,6,4,2,165,165,0,686,686,0,486,486,0
"2021","Lichfield 002","E02006147",6919,1896,3881,3874,3865,9,7,2,5,123,123,0,581,580,1,438,438,0
"2021","Lichfield 003","E02006148",6098,1496,3652,3645,3632,13,7,4,3,76,75,1,463,462,1,411,411,0
"2021","Lichfield 004","E02006149",8781,3261,3491,3478,3445,33,13,2,11,252,251,1,999,996,3,778,777,1
"2021","Lichfield 005","E02006150",9776,2662,5371,5361,5346,15,10,0,10,164,162,2,813,813,0,766,766,0
"2021","Lichfield 006","E02006151",8071,2758,3794,3784,3762,22,10,10,0,159,158,1,785,784,1,575,575,0
"2021","Lichfield 007","E02006152",8512,2646,4248,4236,4222,14,12,2,10,194,194,0,851,850,1,573,572,1
"2021","Lichfield 008","E02006153",7525,2340,4048,4038,4004,34,10,6,4,114,113,1,587,586,1,436,436,0
"2021","Lichfield 009","E02006154",8334,2179,4481,4477,4457,20,4,0,4,143,142,1,739,735,4,792,789,3
"2021","Lichfield 010","E02006155",4500,1722,1854,1845,1833,12,9,4,5,133,133,0,518,516,2,273,270,3
"2021","Lichfield 011","E02006156",6764,1597,4163,4155,4138,17,8,2,6,62,61,1,434,434,0,508,508,0
"2021","Lichfield 012","E02006157",6089,2350,2710,2705,2703,2,5,2,3,105,104,1,538,538,0,386,385,1
"2021","Newcastle-under-Lyme 001","E02006158",6961,2015,3816,3813,3807,6,3,1,2,105,104,1,563,562,1,462,462,0
"2021","Newcastle-under-Lyme 002","E02006159",4665,1644,1988,1978,1972,6,10,4,6,127,126,1,493,492,1,413,413,0
"2021","Newcastle-under-Lyme 003","E02006160",7054,2509,3106,3102,3090,12,4,0,4,188,183,5,727,726,1,524,524,0
"2021","Newcastle-under-Lyme 004","E02006161",5538,1605,2990,2976,2956,20,14,6,8,77,77,0,444,443,1,422,422,0
"2021","Newcastle-under-Lyme 005","E02006162",7018,2256,3398,3385,3368,17,13,2,11,143,143,0,664,662,2,557,556,1
"2021","Newcastle-under-Lyme 006","E02006163",6329,2410,2764,2757,2742,15,7,2,5,138,136,2,587,585,2,430,430,0
"2021","Newcastle-under-Lyme 007","E02006164",5746,2429,2053,2044,2030,14,9,4,5,194,193,1,637,635,2,433,433,0
"2021","Newcastle-under-Lyme 008","E02006165",6204,2466,2439,2428,2416,12,11,4,7,161,159,2,718,714,4,420,418,2
"2021","Newcastle-under-Lyme 009","E02006166",5922,1964,2851,2849,2840,9,2,2,0,141,141,0,552,551,1,414,413,1
"2021","Newcastle-under-Lyme 010","E02006167",8005,3716,2785,2775,2762,13,10,4,6,210,209,1,828,827,1,466,464,2
"2021","Newcastle-under-Lyme 011","E02006168",7372,3747,2143,2133,2113,20,10,4,6,170,168,2,737,735,2,575,575,0
"2021","Newcastle-under-Lyme 012","E02006169",6515,3681,1972,1955,1941,14,17,6,11,115,115,0,435,433,2,312,312,0
"2021","Newcastle-under-Lyme 013","E02006170",4385,1230,2236,2233,2224,9,3,0,3,88,88,0,470,470,0,361,361,0
"2021","Newcastle-under-Lyme 014","E02006171",7467,2562,3480,3473,3461,12,7,4,3,149,149,0,724,720,4,552,552,0
"2021","Newcastle-under-Lyme 015","E02006172",7980,2016,4610,4606,4590,16,4,0,4,121,121,0,607,607,0,626,626,0
"2021","Newcastle-under-Lyme 016","E02006173",6013,1431,3615,3603,3589,14,12,4,8,73,72,1,501,501,0,393,393,0
"2021","South Staffordshire 001","E02006174",9189,2549,4948,4938,4912,26,10,2,8,179,179,0,820,817,3,693,693,0
"2021","South Staffordshire 002","E02006175",5531,1964,2596,2589,2580,9,7,2,5,122,122,0,505,504,1,344,344,0
"2021","South Staffordshire 003","E02006176",6223,1472,3633,3619,3607,12,14,4,10,118,118,0,500,500,0,500,500,0
"2021","South Staffordshire 004","E02006177",8225,2352,4456,4443,4434,9,13,4,9,134,133,1,680,678,2,603,602,1
"2021","South Staffordshire 005","E02006178",6352,2000,3185,3180,3161,19,5,2,3,129,124,5,569,569,0,469,469,0
"2021","South Staffordshire 006","E02006179",8617,3971,3267,3250,3229,21,17,4,13,189,185,4,735,732,3,455,454,1
"2021","South Staffordshire 007","E02006180",5713,1818,2784,2778,2769,9,6,0,6,131,131,0,508,508,0,472,472,0
"2021","South Staffordshire 008","E02006181",4609,1555,2063,2057,2047,10,6,3,3,96,96,0,495,494,1,400,400,0
"2021","South Staffordshire 009","E02006182",5923,1532,3335,3331,3319,12,4,2,2,82,82,0,458,458,0,516,516,0
"2021","South Staffordshire 012","E02006185",5961,1835,2834,2827,2807,20,7,2,5,128,128,0,573,572,1,591,590,1
"2021","South Staffordshire 013","E02006186",10685,2711,6086,6061,6040,21,25,14,11,161,161,0,813,812,1,914,914,0
"2021","South Staffordshire 014","E02006187",6137,1493,3473,3472,3456,16,1,0,1,90,90,0,541,541,0,540,540,0
"2021","South Staffordshire 015","E02006982",10207,3005,5329,5315,5301,14,14,4,10,193,191,2,995,994,1,685,685,0
"2021","Stafford 001","E02006188",5067,1372,2797,2791,2777,14,6,0,6,68,67,1,437,435,2,393,393,0
"2021","Stafford 002","E02006189",6139,1509,3448,3434,3416,18,14,2,12,123,122,1,517,514,3,542,542,0
"2021","Stafford 003","E02006190",9125,3084,3949,3939,3915,24,10,0,10,248,243,5,1113,1112,1,731,729,2
"2021","Stafford 004","E02006191",6826,1645,4051,4040,4023,17,11,3,8,116,116,0,576,576,0,438,438,0
"2021","Stafford 005","E02006192",7724,2124,4216,4211,4196,15,5,2,3,166,164,2,772,772,0,446,446,0
"2021","Stafford 006","E02006193",6203,1814,3292,3275,3254,21,17,6,11,108,106,2,574,574,0,415,413,2
"2021","Stafford 007","E02006194",6696,2559,2756,2748,2724,24,8,3,5,159,159,0,745,744,1,477,477,0
"2021","Stafford 008","E02006195",7413,1671,4342,4329,4310,19,13,4,9,133,133,0,728,726,2,539,538,1
"2021","Stafford 009","E02006196",5917,2561,2095,2086,2073,13,9,4,5,214,212,2,769,766,3,278,278,0
"2021","Stafford 010","E02006197",7804,3681,2412,2403,2366,37,9,6,3,270,268,2,989,980,9,452,451,1
"2021","Stafford 011","E02006198",7393,2317,3810,3805,3771,34,5,0,5,141,141,0,719,716,3,406,404,2
"2021","Stafford 012","E02006199",7124,1937,3981,3968,3949,19,13,6,7,105,104,1,564,564,0,537,537,0
"2021","Stafford 013","E02006200",6151,2437,2325,2315,2298,17,10,6,4,191,190,1,760,759,1,438,437,1
"2021","Stafford 014","E02006201",9943,2225,6009,6004,5987,17,5,0,5,170,170,0,807,807,0,732,732,0
"2021","Stafford 015","E02006202",7902,2042,4458,4447,4432,15,11,6,5,113,112,1,731,729,2,558,558,0
"2021","Stafford 016","E02006203",6187,2296,2608,2598,2588,10,10,0,10,163,163,0,730,728,2,390,390,0
"2021","Staffordshire Moorlands 001","E02006204",6089,2059,2776,2769,2752,17,7,2,5,144,143,1,617,614,3,493,493,0
"2021","Staffordshire Moorlands 002","E02006205",6300,1459,3748,3738,3725,13,10,2,8,76,76,0,514,513,1,503,503,0
"2021","Staffordshire Moorlands 003","E02006206",6357,2416,2551,2543,2531,12,8,2,6,201,200,1,739,739,0,450,449,1
"2021","Staffordshire Moorlands 004","E02006207",5404,1359,3004,3002,2996,6,2,2,0,82,82,0,436,436,0,523,520,3
"2021","Staffordshire Moorlands 005","E02006208",6681,2675,2413,2390,2373,17,23,6,17,218,217,1,892,890,2,483,483,0
"2021","Staffordshire Moorlands 006","E02006209",8959,2474,4819,4811,4801,10,8,4,4,134,133,1,801,800,1,731,730,1
"2021","Staffordshire Moorlands 007","E02006210",4457,1099,2607,2593,2589,4,14,7,7,69,69,0,375,375,0,307,307,0
"2021","Staffordshire Moorlands 008","E02006211",5446,1356,3115,3107,3096,11,8,0,8,78,77,1,402,401,1,495,495,0
"2021","Staffordshire Moorlands 009","E02006212",6607,1759,3631,3627,3614,13,4,0,4,98,98,0,517,517,0,602,601,1
"2021","Staffordshire Moorlands 010","E02006213",5535,1741,2712,2702,2689,13,10,0,10,113,113,0,577,575,2,392,392,0
"2021","Staffordshire Moorlands 011","E02006214",5199,1689,2382,2376,2361,15,6,2,4,132,132,0,567,567,0,429,427,2
"2021","Staffordshire Moorlands 012","E02006215",6724,1830,3680,3670,3664,6,10,6,4,97,97,0,572,572,0,545,545,0
"2021","Staffordshire Moorlands 013","E02006216",7102,1861,4074,4064,4044,20,10,2,8,130,129,1,528,527,1,509,507,2
"2021","Tamworth 001","E02006217",8377,2555,4260,4246,4221,25,14,12,2,148,147,1,763,760,3,651,651,0
"2021","Tamworth 002","E02006218",7038,2824,2463,2458,2439,19,5,2,3,214,214,0,938,937,1,599,599,0
"2021","Tamworth 003","E02006219",6746,2368,3264,3255,3243,12,9,6,3,129,127,2,638,635,3,347,346,1
"2021","Tamworth 004","E02006220",6104,1983,2992,2989,2975,14,3,2,1,125,123,2,580,579,1,424,424,0
"2021","Tamworth 005","E02006221",4852,1690,2341,2338,2332,6,3,2,1,132,131,1,467,465,2,222,222,0
"2021","Tamworth 006","E02006222",5549,2034,2363,2355,2342,13,8,2,6,154,153,1,593,592,1,405,405,0
"2021","Tamworth 007","E02006223",5099,2258,1792,1775,1771,4,17,4,13,155,153,2,615,615,0,279,279,0
"2021","Tamworth 008","E02006224",6101,2162,3025,3017,3007,10,8,2,6,105,105,0,565,564,1,244,244,0
"2021","Tamworth 009","E02006225",6068,1801,3293,3278,3265,13,15,2,13,110,110,0,482,482,0,382,382,0
"2021","Tamworth 010","E02006226",7849,2978,3507,3495,3483,12,12,6,6,192,191,1,776,773,3,396,396,0
"2021","North Warwickshire 001","E02006468",9102,2858,4649,4639,4611,28,10,4,6,167,166,1,797,795,2,631,630,1
"2021","North Warwickshire 002","E02006469",7074,2530,3206,3196,3178,18,10,4,6,183,181,2,689,687,2,466,466,0
"2021","North Warwickshire 003","E02006470",9671,3496,4086,4069,4036,33,17,5,12,276,276,0,1099,1097,2,714,714,0
"2021","North Warwickshire 004","E02006471",5907,1741,3163,3157,3145,12,6,0,6,103,103,0,511,511,0,389,389,0
"2021","North Warwickshire 005","E02006472",8079,2850,3668,3646,3631,15,22,10,12,166,165,1,878,877,1,517,515,2
"2021","North Warwickshire 006","E02006473",8713,2939,4085,4071,4059,12,14,0,14,201,201,0,794,793,1,694,693,1
"2021","North Warwickshire 007","E02006474",5354,1658,2733,2719,2703,16,14,0,14,98,98,0,520,517,3,345,345,0
"2021","Nuneaton and Bedworth 001","E02006475",7667,2371,4018,4001,3985,16,17,8,9,133,133,0,659,659,0,486,486,0
"2021","Nuneaton and Bedworth 002","E02006476",7342,3148,2795,2784,2763,21,11,8,3,216,215,1,757,752,5,426,425,1
"2021","Nuneaton and Bedworth 003","E02006477",7084,2111,3893,3877,3866,11,16,6,10,135,134,1,518,515,3,427,427,0
"2021","Nuneaton and Bedworth 004","E02006478",6727,2420,3238,3234,3218,16,4,0,4,164,163,1,584,583,1,321,320,1
"2021","Nuneaton and Bedworth 005","E02006479",7513,3096,2966,2954,2936,18,12,7,5,240,238,2,794,792,2,417,417,0
"2021","Nuneaton and Bedworth 006","E02006480",6027,2321,2566,2564,2537,27,2,0,2,149,149,0,647,647,0,344,343,1
"2021","Nuneaton and Bedworth 007","E02006481",5691,2175,2374,2366,2358,8,8,2,6,175,173,2,588,587,1,379,379,0
"2021","Nuneaton and Bedworth 008","E02006482",5843,2051,2733,2715,2696,19,18,6,12,153,149,4,562,560,2,344,344,0
"2021","Nuneaton and Bedworth 009","E02006483",6340,2431,2658,2652,2625,27,6,2,4,156,155,1,609,607,2,486,485,1
"2021","Nuneaton and Bedworth 010","E02006484",6281,2351,2645,2635,2619,16,10,6,4,169,168,1,673,673,0,443,443,0
"2021","Nuneaton and Bedworth 011","E02006485",5752,1350,3464,3460,3445,15,4,2,2,61,61,0,437,437,0,440,440,0
"2021","Nuneaton and Bedworth 012","E02006486",5881,1935,2819,2810,2804,6,9,4,5,130,130,0,563,563,0,434,434,0
"2021","Nuneaton and Bedworth 013","E02006487",5677,2112,2334,2321,2316,5,13,4,9,167,167,0,621,621,0,443,443,0
"2021","Nuneaton and Bedworth 014","E02006488",5252,1338,2839,2832,2815,17,7,2,5,99,99,0,417,417,0,559,559,0
"2021","Nuneaton and Bedworth 015","E02006489",6374,2341,2741,2730,2723,7,11,4,7,183,182,1,729,727,2,380,380,0
"2021","Nuneaton and Bedworth 016","E02006490",6197,2154,2873,2864,2853,11,9,4,5,152,152,0,554,552,2,464,462,2
"2021","Nuneaton and Bedworth 018","E02006806",6935,2491,3117,3106,3087,19,11,2,9,177,177,0,653,652,1,497,497,0
"2021","Rugby 002","E02006493",8549,3203,4047,4015,3981,34,32,14,18,194,194,0,789,785,4,316,316,0
"2021","Rugby 003","E02006494",6013,2705,2010,1990,1976,14,20,12,8,162,162,0,701,700,1,435,435,0
"2021","Rugby 004","E02006495",6530,1923,3504,3495,3490,5,9,2,7,98,98,0,558,555,3,447,447,0
"2021","Rugby 005","E02006496",5880,2711,2120,2116,2106,10,4,0,4,180,180,0,623,622,1,246,245,1
"2021","Rugby 006","E02006497",6547,2937,2409,2403,2396,7,6,2,4,171,171,0,728,727,1,302,301,1
"2021","Rugby 007","E02006498",10668,3435,5589,5584,5572,12,5,2,3,218,218,0,938,935,3,488,488,0
"2021","Rugby 008","E02006499",5135,1450,2847,2839,2825,14,8,4,4,87,87,0,406,406,0,345,345,0
"2021","Rugby 009","E02006500",4958,1875,2072,2070,2063,7,2,2,0,128,128,0,502,501,1,381,380,1
"2021","Rugby 010","E02006501",8128,2456,4236,4230,4217,13,6,2,4,160,160,0,712,712,0,564,564,0
"2021","Rugby 011","E02006502",9195,2472,4804,4781,4764,17,23,10,13,159,158,1,890,890,0,870,868,2
"2021","Rugby 012","E02006503",8157,2131,4587,4576,4565,11,11,6,5,168,167,1,705,701,4,566,566,0
"2021","Rugby 013","E02007048",6373,1844,3484,3471,3455,16,13,4,9,114,114,0,509,507,2,422,422,0
"2021","Rugby 014","E02007049",6051,2130,3064,3054,3028,26,10,6,4,125,125,0,528,524,4,204,204,0
"2021","Stratford-on-Avon 001","E02006504",5013,1172,3052,3044,3033,11,8,0,8,80,80,0,416,416,0,293,291,2
"2021","Stratford-on-Avon 002","E02006505",5958,1465,3212,3203,3196,7,9,4,5,97,97,0,592,591,1,592,592,0
"2021","Stratford-on-Avon 003","E02006506",4954,1484,2397,2392,2391,1,5,2,3,94,94,0,563,562,1,416,416,0
"2021","Stratford-on-Avon 004","E02006507",9100,2996,4497,4489,4467,22,8,8,0,210,208,2,777,777,0,620,620,0
"2021","Stratford-on-Avon 005","E02006508",9131,2521,5083,5068,5043,25,15,4,11,176,175,1,807,805,2,544,543,1
"2021","Stratford-on-Avon 006","E02006509",4998,1461,2332,2326,2320,6,6,2,4,138,138,0,595,594,1,472,472,0
"2021","Stratford-on-Avon 007","E02006510",5841,1364,3402,3392,3376,16,10,2,8,99,99,0,537,536,1,439,439,0
"2021","Stratford-on-Avon 008","E02006511",8744,2402,4810,4789,4777,12,21,18,3,163,162,1,775,771,4,594,594,0
"2021","Stratford-on-Avon 009","E02006512",10417,3856,4504,4483,4449,34,21,12,9,249,249,0,1158,1156,2,650,649,1
"2021","Stratford-on-Avon 010","E02006513",6886,1835,3735,3717,3703,14,18,2,16,135,135,0,648,648,0,533,533,0
"2021","Stratford-on-Avon 011","E02006514",7659,2210,3727,3707,3698,9,20,10,10,154,154,0,839,839,0,729,726,3
"2021","Stratford-on-Avon 012","E02006515",9209,2494,5038,5023,5005,18,15,4,11,164,161,3,909,909,0,604,602,2
"2021","Stratford-on-Avon 013","E02006516",8111,2183,4495,4476,4455,21,19,0,19,178,178,0,772,769,3,483,481,2
"2021","Stratford-on-Avon 014","E02006517",7922,2219,4304,4291,4274,17,13,6,7,194,193,1,746,744,2,459,458,1
"2021","Stratford-on-Avon 015","E02006518",8694,2357,4541,4525,4509,16,16,2,14,173,171,2,924,924,0,699,698,1
"2021","Warwick 001","E02006519",6712,2023,3438,3428,3403,25,10,8,2,130,129,1,601,601,0,520,520,0
"2021","Warwick 002","E02006520",6995,1928,3831,3814,3807,7,17,6,11,130,130,0,645,643,2,461,461,0
"2021","Warwick 003","E02006521",6129,1549,3465,3459,3454,5,6,4,2,80,79,1,499,499,0,536,535,1
"2021","Warwick 004","E02006522",4885,1191,2893,2884,2866,18,9,4,5,78,78,0,423,421,2,300,300,0
"2021","Warwick 005","E02006523",11073,4721,4894,4887,4867,20,7,2,5,134,134,0,722,721,1,602,600,2
"2021","Warwick 006","E02006524",4448,1798,1834,1828,1824,4,6,4,2,98,97,1,429,428,1,289,289,0
"2021","Warwick 007","E02006525",11168,4625,4830,4804,4768,36,26,13,13,158,158,0,856,853,3,699,698,1
"2021","Warwick 008","E02006526",7196,2561,3364,3351,3339,12,13,2,11,139,138,1,682,680,2,450,450,0
"2021","Warwick 009","E02006527",7951,3302,3369,3351,3327,24,18,7,11,116,115,1,725,724,1,439,437,2
"2021","Warwick 010","E02006528",9554,4920,3336,3304,3280,24,32,10,22,153,150,3,743,743,0,402,399,3
"2021","Warwick 011","E02006529",10224,3981,4288,4268,4251,17,20,4,16,272,272,0,1106,1102,4,577,577,0
"2021","Warwick 012","E02006530",10665,3680,5343,5323,5287,36,20,10,10,164,161,3,916,915,1,562,561,1
"2021","Warwick 013","E02006531",8769,4884,2726,2701,2690,11,25,12,13,177,176,1,638,638,0,344,344,0
"2021","Warwick 014","E02006532",9116,2829,4906,4878,4846,32,28,18,10,178,178,0,765,763,2,438,437,1
"2021","Warwick 015","E02006533",8363,2776,4243,4239,4222,17,4,4,0,153,153,0,679,679,0,512,512,0
"2021","Bromsgrove 001","E02006696",5768,1437,3335,3324,3310,14,11,6,5,98,98,0,445,443,2,453,453,0
"2021","Bromsgrove 002","E02006697",6280,1643,3510,3500,3487,13,10,4,6,103,103,0,520,520,0,504,504,0
"2021","Bromsgrove 003","E02006698",5309,1722,2649,2636,2627,9,13,3,10,95,95,0,424,423,1,419,419,0
"2021","Bromsgrove 004","E02006699",4804,1318,2595,2591,2587,4,4,2,2,76,76,0,402,402,0,413,413,0
"2021","Bromsgrove 005","E02006700",5332,1366,3039,3028,3023,5,11,4,7,67,67,0,338,335,3,522,522,0
"2021","Bromsgrove 006","E02006701",5962,1519,3608,3599,3571,28,9,4,5,89,89,0,385,384,1,361,361,0
"2021","Bromsgrove 007","E02006702",4842,1644,2204,2204,2194,10,0,0,0,99,99,0,548,547,1,347,347,0
"2021","Bromsgrove 008","E02006703",6553,1791,3692,3690,3676,14,2,2,0,116,114,2,503,498,5,451,450,1
"2021","Bromsgrove 009","E02006704",5711,1579,3087,3073,3065,8,14,2,12,123,122,1,488,488,0,434,434,0
"2021","Bromsgrove 010","E02006705",5940,2062,2647,2633,2617,16,14,8,6,144,144,0,691,690,1,396,395,1
"2021","Bromsgrove 011","E02006706",5864,2000,2414,2411,2401,10,3,2,1,166,166,0,716,715,1,568,568,0
"2021","Bromsgrove 012","E02006707",5423,1377,3218,3216,3206,10,2,2,0,96,96,0,422,422,0,310,310,0
"2021","Bromsgrove 013","E02006708",6307,2562,2474,2461,2448,13,13,4,9,162,162,0,754,749,5,355,355,0
"2021","Bromsgrove 014","E02006709",7012,2278,3543,3536,3522,14,7,4,3,169,167,2,660,660,0,362,361,1
"2021","Malvern Hills 001","E02006710",7116,1832,3948,3923,3896,27,25,12,13,120,118,2,700,697,3,516,516,0
"2021","Malvern Hills 002","E02006711",7169,1823,4164,4147,4132,15,17,2,15,113,113,0,573,572,1,496,495,1
"2021","Malvern Hills 003","E02006712",6461,1627,3697,3688,3665,23,9,1,8,87,87,0,543,543,0,507,507,0
"2021","Malvern Hills 004","E02006713",5408,1703,2391,2388,2377,11,3,2,1,148,147,1,628,628,0,538,537,1
"2021","Malvern Hills 005","E02006714",5000,1228,2862,2851,2836,15,11,2,9,81,81,0,409,407,2,420,419,1
"2021","Malvern Hills 006","E02006715",7195,2373,3520,3505,3482,23,15,4,11,163,163,0,743,743,0,396,396,0
"2021","Malvern Hills 007","E02006716",5092,1968,2005,1997,1985,12,8,3,5,146,145,1,634,634,0,339,339,0
"2021","Malvern Hills 008","E02006717",5785,1454,3257,3239,3223,16,18,6,12,88,88,0,501,501,0,485,485,0
"2021","Malvern Hills 009","E02006718",5173,1593,2427,2407,2398,9,20,10,10,96,96,0,554,553,1,503,503,0
"2021","Malvern Hills 010","E02006719",6467,1952,3141,3123,3108,15,18,2,16,145,142,3,640,640,0,589,587,2
"2021","Malvern Hills 011","E02006720",6253,1617,3360,3347,3333,14,13,6,7,130,129,1,647,645,2,499,498,1
"2021","Redditch 001","E02006721",5438,1639,2944,2932,2922,10,12,2,10,106,106,0,427,427,0,322,322,0
"2021","Redditch 002","E02006722",4210,1812,1530,1519,1512,7,11,6,5,147,147,0,529,527,2,192,192,0
"2021","Redditch 003","E02006723",7249,2923,2918,2898,2875,23,20,6,14,202,198,4,783,781,2,423,422,1
"2021","Redditch 004","E02006724",5537,2463,2112,2106,2099,7,6,4,2,142,141,1,561,558,3,259,259,0
"2021","Redditch 005","E02006725",4480,1658,1978,1974,1968,6,4,0,4,91,91,0,523,521,2,230,230,0
"2021","Redditch 006","E02006726",5200,1965,2285,2277,2272,5,8,6,2,132,132,0,514,514,0,304,302,2
"2021","Redditch 007","E02006727",4923,1481,2565,2562,2560,2,3,0,3,95,95,0,440,439,1,342,341,1
"2021","Redditch 008","E02006728",6409,1861,3351,3337,3319,18,14,10,4,128,128,0,603,603,0,466,465,1
"2021","Redditch 009","E02006729",6155,2134,2987,2971,2948,23,16,0,16,139,139,0,603,603,0,292,292,0
"2021","Redditch 010","E02006730",5121,2254,1942,1927,1919,8,15,8,7,155,155,0,547,546,1,223,223,0
"2021","Redditch 011","E02006731",4642,1571,2096,2087,2076,11,9,6,3,105,105,0,572,571,1,298,298,0
"2021","Redditch 012","E02006732",5827,1732,3049,3040,3029,11,9,4,5,104,104,0,556,554,2,386,386,0
"2021","Redditch 013","E02006733",5053,1470,2625,2597,2588,9,28,10,18,94,94,0,528,528,0,336,335,1
"2021","Worcester 001","E02006734",6772,1911,3648,3636,3616,20,12,8,4,100,100,0,585,585,0,528,527,1
"2021","Worcester 002","E02006735",4183,1919,1391,1384,1364,20,7,2,5,103,103,0,511,510,1,259,259,0
"2021","Worcester 003","E02006736",5355,1902,2555,2545,2533,12,10,6,4,92,92,0,593,592,1,213,212,1
"2021","Worcester 004","E02006737",6891,2490,3031,3017,3001,16,14,6,8,159,153,6,780,778,2,431,430,1
"2021","Worcester 005","E02006738",7116,3132,2647,2626,2601,25,21,12,9,186,186,0,760,760,0,391,391,0
"2021","Worcester 006","E02006739",5151,2529,1897,1893,1889,4,4,0,4,62,59,3,353,352,1,310,310,0
"2021","Worcester 007","E02006740",6605,3565,1844,1835,1816,19,9,2,7,169,169,0,695,693,2,332,331,1
"2021","Worcester 008","E02006741",4992,1626,2598,2594,2578,16,4,4,0,87,87,0,430,429,1,251,249,2
"2021","Worcester 009","E02006742",7364,3458,2527,2520,2513,7,7,4,3,143,143,0,837,836,1,399,399,0
"2021","Worcester 010","E02006743",5412,2081,2413,2408,2401,7,5,2,3,129,128,1,518,518,0,271,271,0
"2021","Worcester 011","E02006744",6248,2918,2214,2206,2179,27,8,2,6,177,176,1,673,669,4,266,266,0
"2021","Worcester 012","E02006745",7313,2388,3523,3512,3494,18,11,2,9,136,135,1,714,714,0,552,552,0
"2021","Worcester 013","E02006746",7464,2743,3432,3422,3389,33,10,2,8,155,154,1,676,675,1,458,458,0
"2021","Worcester 014","E02006747",4738,1575,2362,2356,2343,13,6,4,2,77,77,0,456,455,1,268,268,0
"2021","Wychavon 001","E02006748",7154,2093,3786,3773,3752,21,13,4,9,134,133,1,674,674,0,467,467,0
"2021","Wychavon 002","E02006749",4264,1644,1743,1735,1720,15,8,8,0,113,113,0,496,496,0,268,268,0
"2021","Wychavon 003","E02006750",4631,1392,2110,2102,2089,13,8,2,6,98,97,1,496,495,1,535,535,0
"2021","Wychavon 004","E02006751",4872,1578,2238,2232,2222,10,6,0,6,104,103,1,536,534,2,416,416,0
"2021","Wychavon 005","E02006752",6834,2020,3788,3782,3766,16,6,2,4,87,87,0,573,570,3,366,366,0
"2021","Wychavon 006","E02006753",6095,1600,3432,3422,3400,22,10,6,4,110,108,2,546,546,0,407,405,2
"2021","Wychavon 007","E02006754",4912,1168,3003,2992,2980,12,11,5,6,44,43,1,402,402,0,295,295,0
"2021","Wychavon 008","E02006755",5048,1127,3139,3129,3119,10,10,0,10,67,67,0,371,371,0,344,344,0
"2021","Wychavon 009","E02006756",5445,1647,2935,2908,2891,17,27,10,17,111,111,0,494,493,1,258,258,0
"2021","Wychavon 010","E02006757",6299,1518,3565,3557,3548,9,8,2,6,112,112,0,596,595,1,508,508,0
"2021","Wychavon 011","E02006758",5458,1696,2760,2752,2742,10,8,4,4,123,123,0,561,560,1,318,317,1
"2021","Wychavon 012","E02006759",7044,2128,3300,3283,3270,13,17,0,17,146,145,1,810,809,1,660,660,0
"2021","Wychavon 013","E02006760",7594,1966,4122,4105,4086,19,17,6,11,161,160,1,757,757,0,588,588,0
"2021","Wychavon 014","E02006761",5284,2222,1762,1739,1728,11,23,12,11,174,174,0,754,751,3,372,372,0
"2021","Wychavon 015","E02006762",5911,1871,2919,2905,2898,7,14,8,6,119,119,0,613,609,4,389,389,0
"2021","Wychavon 016","E02006763",6890,2210,3440,3432,3406,26,8,4,4,155,153,2,667,667,0,418,418,0
"2021","Wychavon 017","E02006764",4729,1672,2172,2163,2153,10,9,4,5,93,93,0,520,520,0,272,272,0
"2021","Wychavon 018","E02006765",5526,1292,3102,3089,3077,12,13,2,11,92,91,1,545,542,3,495,494,1
"2021","Wychavon 019","E02006766",6732,1445,4151,4146,4128,18,5,1,4,101,99,2,577,577,0,458,458,0
"2021","Wyre Forest 001","E02006767",8023,2239,4189,4172,4156,16,17,12,5,147,147,0,816,812,4,632,632,0
"2021","Wyre Forest 002","E02006768",5791,1783,2905,2893,2882,11,12,6,6,116,115,1,563,561,2,424,423,1
"2021","Wyre Forest 003","E02006769",5926,1944,2841,2829,2806,23,12,4,8,122,121,1,586,586,0,433,431,2
"2021","Wyre Forest 004","E02006770",6579,3041,2206,2204,2168,36,2,0,2,202,201,1,768,766,2,362,356,6
"2021","Wyre Forest 005","E02006771",5780,1538,2953,2938,2924,14,15,6,9,139,139,0,688,685,3,462,462,0
"2021","Wyre Forest 006","E02006772",5563,1822,2632,2627,2623,4,5,2,3,93,93,0,549,547,2,467,467,0
"2021","Wyre Forest 007","E02006773",6861,2300,2929,2915,2903,12,14,4,10,179,179,0,857,856,1,596,596,0
"2021","Wyre Forest 008","E02006774",6179,2324,2472,2465,2450,15,7,6,1,180,178,2,812,811,1,391,391,0
"2021","Wyre Forest 009","E02006775",4725,2023,1711,1701,1695,6,10,4,6,159,159,0,534,531,3,298,298,0
"2021","Wyre Forest 010","E02006776",5369,1687,2714,2695,2686,9,19,8,11,102,102,0,538,538,0,328,328,0
"2021","Wyre Forest 011","E02006777",6343,1622,3348,3341,3330,11,7,4,3,118,118,0,691,689,2,564,563,1
"2021","Wyre Forest 012","E02006778",5907,1708,3023,3017,3011,6,6,2,4,102,102,0,572,572,0,502,501,1
"2021","Wyre Forest 013","E02006779",6491,1985,2956,2953,2942,11,3,2,1,188,188,0,812,812,0,550,550,0
"2021","Wyre Forest 014","E02006780",5021,1452,2390,2373,2358,15,17,2,15,144,144,0,533,533,0,502,499,3
"2021","Birmingham 001","E02001827",5183,1441,2809,2805,2798,7,4,4,0,86,86,0,430,429,1,417,417,0
"2021","Birmingham 002","E02001828",5859,1649,3084,3079,3068,11,5,2,3,110,110,0,506,506,0,510,510,0
"2021","Birmingham 003","E02001829",7135,1865,4208,4203,4185,18,5,2,3,81,81,0,516,516,0,465,465,0
"2021","Birmingham 004","E02001830",8124,2152,4788,4777,4767,10,11,2,9,106,106,0,489,489,0,589,589,0
"2021","Birmingham 005","E02001831",8332,3252,3461,3445,3432,13,16,6,10,215,214,1,863,863,0,541,541,0
"2021","Birmingham 006","E02001832",6586,1994,3522,3502,3491,11,20,5,15,108,106,2,509,509,0,453,452,1
"2021","Birmingham 007","E02001833",4814,1571,2542,2536,2529,7,6,4,2,83,83,0,324,323,1,294,292,2
"2021","Birmingham 008","E02001834",4645,2116,1692,1677,1671,6,15,8,7,130,126,4,443,443,0,264,264,0
"2021","Birmingham 009","E02001835",6969,2507,3236,3221,3203,18,15,4,11,116,116,0,607,606,1,503,502,1
"2021","Birmingham 010","E02001836",7458,2265,4086,4066,4041,25,20,1,19,139,138,1,486,486,0,482,480,2
"2021","Birmingham 011","E02001837",8001,3983,2577,2573,2562,11,4,4,0,271,267,4,734,734,0,436,436,0
"2021","Birmingham 012","E02001838",6334,1794,3512,3506,3492,14,6,2,4,91,91,0,469,469,0,468,467,1
"2021","Birmingham 013","E02001839",5182,2111,2043,2031,2023,8,12,6,6,129,128,1,485,483,2,414,414,0
"2021","Birmingham 014","E02001840",7270,3493,2381,2362,2352,10,19,8,11,244,241,3,724,724,0,428,428,0
"2021","Birmingham 015","E02001841",5014,1274,2981,2975,2969,6,6,0,6,79,78,1,280,278,2,400,400,0
"2021","Birmingham 016","E02001842",6420,2455,2921,2917,2906,11,4,2,2,162,160,2,485,483,2,397,396,1
"2021","Birmingham 017","E02001843",5306,2269,2150,2142,2124,18,8,4,4,117,117,0,427,426,1,343,343,0
"2021","Birmingham 018","E02001844",8175,3040,3425,3405,3370,35,20,2,18,192,192,0,782,781,1,736,736,0
"2021","Birmingham 019","E02001845",5190,2178,2142,2136,2126,10,6,4,2,114,113,1,487,487,0,269,269,0
"2021","Birmingham 020","E02001846",6316,2945,2189,2174,2162,12,15,5,10,202,201,1,624,624,0,356,356,0
"2021","Birmingham 021","E02001847",4571,1477,2341,2337,2332,5,4,0,4,69,69,0,388,388,0,296,296,0
"2021","Birmingham 022","E02001848",5373,2519,1933,1918,1913,5,15,10,5,167,165,2,413,412,1,341,340,1
"2021","Birmingham 023","E02001849",6492,3405,1926,1899,1887,12,27,14,13,221,219,2,685,682,3,255,255,0
"2021","Birmingham 024","E02001850",6634,2620,3061,3057,3045,12,4,0,4,161,161,0,412,411,1,380,380,0
"2021","Birmingham 025","E02001851",7242,3127,2780,2746,2731,15,34,4,30,201,200,1,668,667,1,466,466,0
"2021","Birmingham 026","E02001852",5592,2563,2059,2043,2032,11,16,10,6,161,161,0,477,477,0,332,332,0
"2021","Birmingham 029","E02001855",7730,3949,2188,2182,2175,7,6,3,3,234,234,0,794,793,1,565,564,1
"2021","Birmingham 030","E02001856",7343,3550,2752,2713,2700,13,39,0,39,227,227,0,529,527,2,285,284,1
"2021","Birmingham 031","E02001857",11134,5945,3359,3324,3303,21,35,20,15,374,370,4,1005,1002,3,451,451,0
"2021","Birmingham 032","E02001858",7382,3668,2604,2598,2587,11,6,4,2,229,226,3,567,566,1,314,313,1
"2021","Birmingham 033","E02001859",7666,3038,3657,3648,3632,16,9,7,2,221,221,0,399,399,0,351,351,0
"2021","Birmingham 034","E02001860",6342,2572,2837,2814,2809,5,23,20,3,186,186,0,419,416,3,328,328,0
"2021","Birmingham 035","E02001861",8297,3780,3449,3434,3422,12,15,8,7,240,239,1,481,481,0,347,347,0
"2021","Birmingham 036","E02001862",7506,3075,3232,3223,3217,6,9,6,3,278,276,2,496,496,0,425,425,0
"2021","Birmingham 037","E02001863",6173,2644,2693,2685,2680,5,8,4,4,188,188,0,349,347,2,299,299,0
"2021","Birmingham 039","E02001865",8593,3533,3871,3863,3854,9,8,4,4,281,280,1,464,464,0,444,442,2
"2021","Birmingham 040","E02001866",7161,3214,2985,2979,2972,7,6,3,3,219,218,1,388,388,0,355,355,0
"2021","Birmingham 041","E02001867",6221,2838,2528,2522,2510,12,6,4,2,220,220,0,332,332,0,303,303,0
"2021","Birmingham 042","E02001868",7197,2692,3738,3728,3719,9,10,6,4,149,149,0,279,279,0,339,339,0
"2021","Birmingham 043","E02001869",4650,2282,1572,1565,1555,10,7,6,1,217,216,1,382,382,0,197,197,0
"2021","Birmingham 044","E02001870",9172,3501,4516,4515,4500,15,1,0,1,291,291,0,441,441,0,423,423,0
"2021","Birmingham 045","E02001871",6386,2926,2179,2155,2138,17,24,8,16,192,192,0,606,606,0,483,483,0
"2021","Birmingham 046","E02001872",5638,2818,1744,1737,1726,11,7,2,5,149,149,0,550,548,2,377,377,0
"2021","Birmingham 047","E02001873",8420,4184,2938,2916,2902,14,22,18,4,360,359,1,599,598,1,339,339,0
"2021","Birmingham 048","E02001874",7036,2809,3327,3323,3310,13,4,4,0,248,247,1,330,330,0,322,322,0
"2021","Birmingham 049","E02001875",6477,3461,2133,2117,2103,14,16,6,10,258,257,1,388,388,0,237,236,1
"2021","Birmingham 050","E02001876",13701,10845,2005,1988,1977,11,17,8,9,228,225,3,424,422,2,199,199,0
"2021","Birmingham 051","E02001877",8741,3503,4165,4157,4143,14,8,6,2,293,292,1,389,389,0,391,391,0
"2021","Birmingham 052","E02001878",6812,2876,3032,3017,3003,14,15,8,7,216,216,0,393,392,1,295,295,0
"2021","Birmingham 053","E02001879",7679,3805,2814,2806,2785,21,8,4,4,221,221,0,469,467,2,370,370,0
"2021","Birmingham 054","E02001880",7085,3436,2481,2471,2464,7,10,10,0,226,225,1,590,588,2,352,352,0
"2021","Birmingham 055","E02001881",7331,2951,3462,3451,3436,15,11,8,3,237,237,0,365,365,0,316,315,1
"2021","Birmingham 056","E02001882",6678,2778,2808,2806,2786,20,2,2,0,193,192,1,491,491,0,408,408,0
"2021","Birmingham 057","E02001883",6389,3169,2010,2000,1977,23,10,0,10,208,207,1,606,606,0,396,396,0
"2021","Birmingham 058","E02001884",6910,2673,3467,3459,3451,8,8,6,2,207,207,0,281,281,0,282,282,0
"2021","Birmingham 060","E02001886",8069,3819,3308,3297,3264,33,11,0,11,201,201,0,434,434,0,307,307,0
"2021","Birmingham 062","E02001888",5319,2358,2021,2004,1997,7,17,10,7,148,145,3,409,407,2,383,382,1
"2021","Birmingham 063","E02001889",6473,2470,3290,3286,3277,9,4,2,2,174,174,0,245,245,0,294,294,0
"2021","Birmingham 064","E02001890",8503,4373,2997,2968,2935,33,29,4,25,217,217,0,578,575,3,338,337,1
"2021","Birmingham 066","E02001892",7975,3189,3705,3694,3684,10,11,10,1,233,233,0,493,493,0,355,355,0
"2021","Birmingham 067","E02001893",6880,2590,3142,3133,3123,10,9,2,7,138,136,2,559,557,2,451,451,0
"2021","Birmingham 069","E02001895",6910,3179,2380,2368,2358,10,12,6,6,198,196,2,647,644,3,506,504,2
"2021","Birmingham 070","E02001896",7211,2688,3641,3635,3627,8,6,6,0,210,210,0,288,288,0,384,384,0
"2021","Birmingham 071","E02001897",6262,2847,2437,2427,2416,11,10,3,7,282,281,1,427,427,0,269,268,1
"2021","Birmingham 072","E02001898",5331,1961,2523,2515,2502,13,8,6,2,116,115,1,386,384,2,345,344,1
"2021","Birmingham 073","E02001899",6953,2136,3684,3665,3642,23,19,4,15,122,122,0,476,476,0,535,535,0
"2021","Birmingham 074","E02001900",5393,2503,1980,1960,1937,23,20,2,18,163,163,0,471,469,2,276,274,2
"2021","Birmingham 075","E02001901",6804,3108,2765,2739,2701,38,26,8,18,126,122,4,505,501,4,300,300,0
"2021","Birmingham 076","E02001902",4889,1962,2160,2151,2149,2,9,4,5,110,110,0,369,369,0,288,288,0
"2021","Birmingham 077","E02001903",5842,2175,2828,2825,2800,25,3,3,0,198,198,0,324,324,0,317,317,0
"2021","Birmingham 078","E02001904",5615,2365,2404,2392,2387,5,12,6,6,166,165,1,394,394,0,286,286,0
"2021","Birmingham 079","E02001905",9185,6088,2413,2390,2371,19,23,4,19,73,72,1,305,296,9,306,306,0
"2021","Birmingham 080","E02001906",7667,3070,3363,3358,3338,20,5,0,5,190,190,0,609,608,1,435,435,0
"2021","Birmingham 081","E02001907",8449,3413,3554,3547,3526,21,7,0,7,192,191,1,740,738,2,550,547,3
"2021","Birmingham 082","E02001908",6526,2428,3305,3303,3285,18,2,2,0,206,205,1,257,257,0,330,330,0
"2021","Birmingham 083","E02001909",6015,2514,2755,2751,2734,17,4,4,0,182,180,2,313,313,0,251,251,0
"2021","Birmingham 084","E02001910",5432,2431,2221,2214,2186,28,7,4,3,178,178,0,318,318,0,284,284,0
"2021","Birmingham 085","E02001911",6388,3046,2221,2212,2201,11,9,2,7,213,213,0,590,588,2,318,317,1
"2021","Birmingham 087","E02001913",6277,3496,1875,1864,1848,16,11,2,9,122,120,2,461,461,0,323,321,2
"2021","Birmingham 088","E02001914",5583,2349,2473,2457,2434,23,16,1,15,131,131,0,323,322,1,307,307,0
"2021","Birmingham 089","E02001915",9532,4146,3680,3662,3608,54,18,14,4,256,255,1,864,860,4,586,584,2
"2021","Birmingham 090","E02001916",7267,3014,3233,3217,3212,5,16,6,10,216,216,0,477,477,0,327,327,0
"2021","Birmingham 092","E02001918",7256,3651,2472,2425,2392,33,47,18,29,171,170,1,627,627,0,335,335,0
"2021","Birmingham 093","E02001919",5720,2555,2345,2329,2319,10,16,5,11,126,126,0,373,370,3,321,318,3
"2021","Birmingham 094","E02001920",5933,2729,2151,2147,2134,13,4,4,0,164,164,0,561,561,0,328,328,0
"2021","Birmingham 095","E02001921",6024,2672,2366,2356,2342,14,10,2,8,156,153,3,510,510,0,320,319,1
"2021","Birmingham 096","E02001922",15228,13984,846,843,823,20,3,2,1,94,92,2,178,178,0,126,126,0
"2021","Birmingham 097","E02001923",8514,3130,4230,4226,4211,15,4,2,2,183,183,0,462,462,0,509,508,1
"2021","Birmingham 098","E02001924",5443,2024,2575,2566,2559,7,9,2,7,145,145,0,425,425,0,274,274,0
"2021","Birmingham 099","E02001925",5493,2394,2205,2199,2178,21,6,2,4,113,113,0,405,401,4,376,376,0
"2021","Birmingham 100","E02001926",6546,3360,2330,2310,2286,24,20,2,18,119,118,1,412,411,1,325,325,0
"2021","Birmingham 101","E02001927",5817,2667,2073,2068,2062,6,5,1,4,173,172,1,523,521,2,381,381,0
"2021","Birmingham 102","E02001928",5385,2363,1956,1947,1933,14,9,0,9,150,150,0,577,576,1,339,339,0
"2021","Birmingham 103","E02001929",7521,3420,2911,2905,2889,16,6,2,4,254,254,0,572,570,2,364,364,0
"2021","Birmingham 104","E02001930",6232,2744,2576,2534,2512,22,42,8,34,124,121,3,501,494,7,287,286,1
"2021","Birmingham 105","E02001931",6834,2373,3427,3422,3407,15,5,4,1,155,154,1,469,468,1,410,410,0
"2021","Birmingham 106","E02001932",5567,2663,1888,1872,1859,13,16,6,10,174,174,0,537,537,0,305,305,0
"2021","Birmingham 107","E02001933",6061,2799,2223,2207,2183,24,16,8,8,169,169,0,537,535,2,333,332,1
"2021","Birmingham 108","E02001934",5551,1967,2838,2833,2827,6,5,2,3,93,93,0,303,303,0,350,350,0
"2021","Birmingham 109","E02001935",6347,2356,2834,2821,2797,24,13,4,9,166,166,0,514,513,1,477,477,0
"2021","Birmingham 110","E02001936",5118,1668,2692,2673,2650,23,19,5,14,76,76,0,333,333,0,349,349,0
"2021","Birmingham 111","E02001937",6352,2808,2494,2475,2463,12,19,6,13,168,168,0,530,529,1,352,351,1
"2021","Birmingham 112","E02001938",6452,3128,2346,2330,2302,28,16,4,12,148,143,5,539,536,3,291,291,0
"2021","Birmingham 113","E02001939",5192,1918,2135,2132,2124,8,3,0,3,143,142,1,524,522,2,472,472,0
"2021","Birmingham 115","E02001941",4886,2204,1741,1723,1718,5,18,8,10,165,165,0,453,453,0,323,323,0
"2021","Birmingham 116","E02001942",5444,2360,2062,2048,2028,20,14,6,8,149,148,1,518,516,2,355,355,0
"2021","Birmingham 117","E02001943",5127,2250,2011,1999,1980,19,12,6,6,120,119,1,452,450,2,294,294,0
"2021","Birmingham 118","E02001944",6477,2850,2523,2508,2487,21,15,0,15,132,130,2,638,636,2,334,334,0
"2021","Birmingham 119","E02001945",5906,2970,1889,1881,1868,13,8,8,0,171,171,0,615,615,0,261,261,0
"2021","Birmingham 120","E02001946",6219,2229,2932,2913,2901,12,19,7,12,127,127,0,545,543,2,386,386,0
"2021","Birmingham 121","E02001947",4652,2338,1355,1349,1345,4,6,4,2,142,141,1,524,523,1,293,292,1
"2021","Birmingham 122","E02001948",5903,2429,2384,2375,2361,14,9,0,9,188,188,0,516,514,2,386,386,0
"2021","Birmingham 123","E02001949",4734,2206,1648,1637,1628,9,11,6,5,129,128,1,461,460,1,290,290,0
"2021","Birmingham 124","E02001950",6967,2739,2961,2949,2929,20,12,6,6,167,164,3,623,621,2,477,476,1
"2021","Birmingham 125","E02001951",7123,3562,2167,2150,2126,24,17,12,5,219,219,0,799,796,3,376,376,0
"2021","Birmingham 126","E02001952",6954,3447,2016,1997,1979,18,19,8,11,235,234,1,862,861,1,394,393,1
"2021","Birmingham 127","E02001953",5785,2134,2674,2665,2639,26,9,0,9,113,113,0,451,451,0,413,413,0
"2021","Birmingham 128","E02001954",5689,2788,1716,1713,1703,10,3,2,1,194,193,1,679,679,0,312,312,0
"2021","Birmingham 129","E02001955",6327,2932,2099,2091,2069,22,8,4,4,191,190,1,689,688,1,416,416,0
"2021","Birmingham 130","E02001956",5404,2323,2090,2088,2067,21,2,0,2,151,149,2,550,550,0,290,290,0
"2021","Birmingham 131","E02001957",6338,2634,2628,2618,2611,7,10,4,6,115,115,0,556,556,0,405,405,0
"2021","Birmingham 132","E02006807",6439,2167,3395,3391,3379,12,4,2,2,125,125,0,379,378,1,373,373,0
"2021","Birmingham 133","E02006809",8256,2759,4423,4415,4398,17,8,8,0,157,156,1,408,408,0,509,509,0
"2021","Birmingham 134","E02006895",7735,5237,1773,1751,1737,14,22,12,10,159,156,3,410,410,0,156,154,2
"2021","Birmingham 135","E02006896",5398,3768,1151,1139,1102,37,12,4,8,122,121,1,263,259,4,94,94,0
"2021","Birmingham 136","E02006897",7107,4911,1464,1452,1438,14,12,5,7,211,210,1,390,390,0,131,131,0
"2021","Birmingham 137","E02006898",6928,4834,1453,1426,1395,31,27,8,19,162,159,3,379,378,1,100,99,1
"2021","Birmingham 138","E02006899",5844,4359,1022,1020,984,36,2,0,2,121,121,0,287,286,1,55,54,1
"2021","Birmingham 139","E02006900",11095,4399,5416,5407,5389,18,9,8,1,335,335,0,459,459,0,486,486,0
"2021","Birmingham 141","E02007038",10292,4489,4011,4000,3972,28,11,4,7,310,309,1,881,880,1,601,599,2
"2021","Birmingham 142","E02007039",5995,2216,3049,3043,3032,11,6,6,0,154,153,1,276,276,0,300,300,0
"2021","Birmingham 143","E02007040",5195,1864,2701,2698,2689,9,3,3,0,175,175,0,264,264,0,191,191,0
"2021","Coventry 001","E02001958",6428,2772,2471,2462,2447,15,9,2,7,151,151,0,675,674,1,359,359,0
"2021","Coventry 002","E02001959",5461,2028,2525,2523,2508,15,2,0,2,115,115,0,438,438,0,355,355,0
"2021","Coventry 004","E02001961",6085,2696,2247,2243,2237,6,4,0,4,174,174,0,609,609,0,359,358,1
"2021","Coventry 005","E02001962",5403,2216,2361,2359,2347,12,2,0,2,155,154,1,406,405,1,265,265,0
"2021","Coventry 006","E02001963",5050,1813,2306,2304,2280,24,2,0,2,98,98,0,485,483,2,348,348,0
"2021","Coventry 007","E02001964",7825,3661,2779,2754,2740,14,25,14,11,291,291,0,732,729,3,362,360,2
"2021","Coventry 008","E02001965",6542,2285,3061,3036,3026,10,25,20,5,165,165,0,592,591,1,439,439,0
"2021","Coventry 009","E02001966",5418,2245,2533,2525,2519,6,8,6,2,145,144,1,275,275,0,220,220,0
"2021","Coventry 010","E02001967",5762,1742,2962,2949,2935,14,13,4,9,83,82,1,523,523,0,452,452,0
"2021","Coventry 011","E02001968",6007,2404,2676,2653,2638,15,23,10,13,170,170,0,463,463,0,294,294,0
"2021","Coventry 012","E02001969",5315,2253,2023,2017,2009,8,6,2,4,147,144,3,545,544,1,347,347,0
"2021","Coventry 013","E02001970",4694,1674,2056,2049,2040,9,7,6,1,115,115,0,430,430,0,419,419,0
"2021","Coventry 014","E02001971",4924,1756,2330,2322,2299,23,8,7,1,109,109,0,462,462,0,267,267,0
"2021","Coventry 015","E02001972",8506,3524,3735,3720,3708,12,15,8,7,326,324,2,592,590,2,329,329,0
"2021","Coventry 016","E02001973",6634,2970,2502,2477,2471,6,25,16,9,192,190,2,653,652,1,317,317,0
"2021","Coventry 017","E02001974",7693,2776,3596,3588,3567,21,8,6,2,149,148,1,697,694,3,475,475,0
"2021","Coventry 018","E02001975",5997,2197,2758,2749,2742,7,9,8,1,133,133,0,550,548,2,359,359,0
"2021","Coventry 019","E02001976",5960,2153,2675,2665,2657,8,10,10,0,159,159,0,592,592,0,381,381,0
"2021","Coventry 020","E02001977",8171,4439,2456,2451,2429,22,5,2,3,211,208,3,709,708,1,356,356,0
"2021","Coventry 021","E02001978",5327,2027,2471,2459,2447,12,12,12,0,118,117,1,418,418,0,293,293,0
"2021","Coventry 022","E02001979",4634,1500,2251,2242,2232,10,9,4,5,85,85,0,387,385,2,411,411,0
"2021","Coventry 023","E02001980",4927,1336,2687,2676,2671,5,11,4,7,91,89,2,401,401,0,412,411,1
"2021","Coventry 024","E02001981",10421,6091,3200,3165,3152,13,35,22,13,261,261,0,546,546,0,323,323,0
"2021","Coventry 025","E02001982",6816,2536,3117,3109,3093,16,8,4,4,167,167,0,610,607,3,386,386,0
"2021","Coventry 026","E02001983",6252,2578,2589,2581,2562,19,8,2,6,123,122,1,613,613,0,349,349,0
"2021","Coventry 027","E02001984",8289,3365,3639,3608,3590,18,31,20,11,155,154,1,709,706,3,421,421,0
"2021","Coventry 028","E02001985",8217,6324,1298,1293,1291,2,5,4,1,121,121,0,321,320,1,153,153,0
"2021","Coventry 029","E02001986",6362,2899,2224,2207,2188,19,17,10,7,168,167,1,709,707,2,362,361,1
"2021","Coventry 030","E02001987",5210,3238,1183,1170,1157,13,13,2,11,99,96,3,438,436,2,252,252,0
"2021","Coventry 031","E02001988",10342,8088,1336,1326,1309,17,10,6,4,137,137,0,572,572,0,209,207,2
"2021","Coventry 032","E02001989",5040,2232,2026,2016,1996,20,10,8,2,114,111,3,407,407,0,261,261,0
"2021","Coventry 033","E02001990",7541,2326,3942,3925,3907,18,17,16,1,141,141,0,585,584,1,547,547,0
"2021","Coventry 034","E02001991",7273,2637,3408,3399,3375,24,9,8,1,113,112,1,577,577,0,538,538,0
"2021","Coventry 035","E02001992",8116,3477,3182,3158,3145,13,24,16,8,246,244,2,744,743,1,467,467,0
"2021","Coventry 036","E02001993",7399,3925,2457,2448,2436,12,9,4,5,147,146,1,536,536,0,334,334,0
"2021","Coventry 037","E02001994",6450,2225,3201,3192,3184,8,9,2,7,118,114,4,492,491,1,414,414,0
"2021","Coventry 038","E02001995",7605,3254,3078,3059,3021,38,19,8,11,182,181,1,621,621,0,470,470,0
"2021","Coventry 039","E02001996",5744,2745,1888,1853,1846,7,35,25,10,197,197,0,585,583,2,329,328,1
"2021","Coventry 040","E02001997",7013,1832,4096,4091,4083,8,5,0,5,88,88,0,447,446,1,550,550,0
"2021","Coventry 041","E02001998",4895,1428,2701,2699,2695,4,2,0,2,72,67,5,352,352,0,342,342,0
"2021","Coventry 042","E02001999",8239,5210,2402,2393,2384,9,9,2,7,60,60,0,267,267,0,300,299,1
"2021","Coventry 043","E02006805",6895,2865,2889,2877,2853,24,12,10,2,192,189,3,596,595,1,353,353,0
"2021","Dudley 001","E02002000",6811,2867,2723,2715,2708,7,8,2,6,208,207,1,560,558,2,453,452,1
"2021","Dudley 002","E02002001",5018,1907,2145,2136,2125,11,9,4,5,127,126,1,479,476,3,360,360,0
"2021","Dudley 003","E02002002",5947,1484,3449,3445,3437,8,4,2,2,69,69,0,401,399,2,544,544,0
"2021","Dudley 004","E02002003",7432,2574,3497,3494,3474,20,3,3,0,155,154,1,630,629,1,576,576,0
"2021","Dudley 005","E02002004",6038,2395,2508,2502,2490,12,6,2,4,167,167,0,493,490,3,475,475,0
"2021","Dudley 006","E02002005",7281,3244,2900,2858,2840,18,42,36,6,195,195,0,545,545,0,397,397,0
"2021","Dudley 007","E02002006",5195,2062,2109,2101,2096,5,8,2,6,149,148,1,541,539,2,334,334,0
"2021","Dudley 008","E02002007",7511,2444,3663,3654,3636,18,9,2,7,150,150,0,575,572,3,679,679,0
"2021","Dudley 009","E02002008",6732,2279,3521,3511,3505,6,10,8,2,140,140,0,452,452,0,340,340,0
"2021","Dudley 010","E02002009",5304,2224,2270,2267,2258,9,3,2,1,143,143,0,401,401,0,266,265,1
"2021","Dudley 011","E02002010",6583,2898,2296,2291,2277,14,5,2,3,206,206,0,711,710,1,472,472,0
"2021","Dudley 012","E02002011",4982,1414,2622,2619,2607,12,3,0,3,97,97,0,440,438,2,409,409,0
"2021","Dudley 013","E02002012",6720,2720,2539,2523,2514,9,16,6,10,215,215,0,681,680,1,565,564,1
"2021","Dudley 014","E02002013",5632,1468,3099,3088,3081,7,11,4,7,101,101,0,428,428,0,536,536,0
"2021","Dudley 015","E02002014",6308,2750,2605,2594,2576,18,11,6,5,177,177,0,440,438,2,336,336,0
"2021","Dudley 016","E02002015",5703,2072,2694,2686,2674,12,8,2,6,102,102,0,463,463,0,372,372,0
"2021","Dudley 017","E02002016",6198,2746,2300,2285,2272,13,15,4,11,172,172,0,569,569,0,411,411,0
"2021","Dudley 018","E02002017",6445,2541,2645,2641,2634,7,4,4,0,156,152,4,652,652,0,451,450,1
"2021","Dudley 019","E02002018",7496,2017,4189,4189,4169,20,0,0,0,113,113,0,514,514,0,663,663,0
"2021","Dudley 020","E02002019",6055,2502,2577,2563,2549,14,14,4,10,153,153,0,459,459,0,364,364,0
"2021","Dudley 021","E02002020",7970,2521,3908,3900,3869,31,8,0,8,155,155,0,726,724,2,660,660,0
"2021","Dudley 022","E02002021",6236,2968,1966,1956,1940,16,10,4,6,197,193,4,697,691,6,408,408,0
"2021","Dudley 023","E02002022",6940,2837,2719,2708,2688,20,11,4,7,245,244,1,758,756,2,381,381,0
"2021","Dudley 024","E02002023",4485,1493,2165,2156,2135,21,9,0,9,93,93,0,419,418,1,315,315,0
"2021","Dudley 025","E02002024",7052,2684,3207,3189,3175,14,18,10,8,147,146,1,582,581,1,432,432,0
"2021","Dudley 026","E02002025",7059,2741,3070,3059,3001,58,11,2,9,192,189,3,634,633,1,422,422,0
"2021","Dudley 027","E02002026",5669,1751,2936,2931,2920,11,5,2,3,91,91,0,492,492,0,399,399,0
"2021","Dudley 028","E02002027",4574,1299,2616,2610,2599,11,6,2,4,97,97,0,369,369,0,193,193,0
"2021","Dudley 029","E02002028",4841,1457,2362,2356,2352,4,6,4,2,84,84,0,473,473,0,465,465,0
"2021","Dudley 030","E02002029",5118,1658,2579,2579,2565,14,0,0,0,79,78,1,388,388,0,414,414,0
"2021","Dudley 031","E02002030",5502,2163,2205,2194,2186,8,11,4,7,140,140,0,586,586,0,408,407,1
"2021","Dudley 032","E02002031",5106,1859,2367,2358,2345,13,9,4,5,131,129,2,451,451,0,298,298,0
"2021","Dudley 033","E02002032",8107,3288,3287,3261,3237,24,26,6,20,188,187,1,855,853,2,489,489,0
"2021","Dudley 034","E02002033",6373,2258,3015,3010,2992,18,5,0,5,110,110,0,549,548,1,441,440,1
"2021","Dudley 035","E02002034",6811,2656,2668,2654,2640,14,14,4,10,182,181,1,854,852,2,451,450,1
"2021","Dudley 036","E02002035",5075,1394,2869,2856,2848,8,13,5,8,79,79,0,351,351,0,382,381,1
"2021","Dudley 037","E02002036",5310,2158,2091,2087,2076,11,4,0,4,169,169,0,564,563,1,328,327,1
"2021","Dudley 038","E02002037",4906,1575,2427,2425,2413,12,2,2,0,83,82,1,487,484,3,334,334,0
"2021","Dudley 039","E02002038",7940,2964,3299,3294,3266,28,5,2,3,227,223,4,862,862,0,588,588,0
"2021","Dudley 040","E02002039",5136,1631,2461,2456,2438,18,5,2,3,170,170,0,442,439,3,432,432,0
"2021","Dudley 041","E02002040",5028,1170,3004,2997,2986,11,7,3,4,62,62,0,349,349,0,443,443,0
"2021","Dudley 042","E02002041",5205,1312,2888,2880,2875,5,8,2,6,82,82,0,417,417,0,506,506,0
"2021","Dudley 043","E02002042",6646,1783,3682,3678,3665,13,4,0,4,113,112,1,535,535,0,533,533,0
"2021","Sandwell 001","E02002043",6807,2789,2907,2901,2887,14,6,3,3,160,160,0,513,509,4,438,437,1
"2021","Sandwell 002","E02002044",6186,2464,2752,2746,2737,9,6,2,4,154,154,0,475,475,0,341,341,0
"2021","Sandwell 003","E02002045",6129,2412,2616,2611,2601,10,5,0,5,155,154,1,502,502,0,444,444,0
"2021","Sandwell 004","E02002046",4150,1795,1635,1633,1623,10,2,2,0,129,129,0,309,308,1,282,281,1
"2021","Sandwell 005","E02002047",6157,2328,2632,2625,2611,14,7,1,6,165,164,1,524,523,1,508,506,2
"2021","Sandwell 006","E02002048",5715,1756,2951,2944,2937,7,7,0,7,123,123,0,434,434,0,451,450,1
"2021","Sandwell 007","E02002049",4978,1996,2212,2205,2201,4,7,4,3,115,115,0,356,356,0,299,299,0
"2021","Sandwell 009","E02002051",4503,2011,1736,1728,1721,7,8,4,4,137,137,0,335,335,0,284,284,0
"2021","Sandwell 010","E02002052",8802,3634,3659,3654,3638,16,5,2,3,203,202,1,687,687,0,619,619,0
"2021","Sandwell 011","E02002053",5066,1844,2286,2282,2278,4,4,2,2,138,138,0,421,419,2,377,377,0
"2021","Sandwell 012","E02002054",4732,1767,2142,2135,2129,6,7,5,2,108,108,0,365,365,0,350,350,0
"2021","Sandwell 013","E02002055",8638,3320,3881,3868,3851,17,13,11,2,231,229,2,642,641,1,564,564,0
"2021","Sandwell 014","E02002056",7462,3341,2825,2799,2793,6,26,16,10,207,206,1,601,598,3,488,488,0
"2021","Sandwell 015","E02002057",8406,3332,3525,3520,3501,19,5,0,5,273,272,1,713,710,3,563,563,0
"2021","Sandwell 016","E02002058",10591,4219,4631,4616,4596,20,15,10,5,300,298,2,851,849,2,590,589,1
"2021","Sandwell 017","E02002059",9410,3601,4147,4133,4114,19,14,2,12,252,252,0,765,764,1,645,644,1
"2021","Sandwell 018","E02002060",5486,2180,2460,2452,2441,11,8,7,1,127,127,0,378,377,1,341,341,0
"2021","Sandwell 019","E02002061",5479,2116,2520,2518,2514,4,2,2,0,128,128,0,366,365,1,349,349,0
"2021","Sandwell 020","E02002062",7048,2960,2900,2895,2876,19,5,4,1,183,183,0,566,566,0,439,439,0
"2021","Sandwell 021","E02002063",7946,3112,3505,3489,3464,25,16,8,8,219,218,1,682,682,0,428,428,0
"2021","Sandwell 022","E02002064",9664,3813,4316,4307,4298,9,9,4,5,220,218,2,806,805,1,509,509,0
"2021","Sandwell 023","E02002065",10569,3772,5444,5431,5406,25,13,4,9,278,278,0,519,516,3,556,556,0
"2021","Sandwell 024","E02002066",6258,2514,2750,2744,2728,16,6,4,2,158,158,0,518,518,0,318,318,0
"2021","Sandwell 025","E02002067",5019,1856,2338,2330,2316,14,8,2,6,99,98,1,337,337,0,389,387,2
"2021","Sandwell 027","E02002069",5675,2307,2233,2223,2209,14,10,8,2,158,158,0,551,551,0,426,426,0
"2021","Sandwell 028","E02002070",7720,3125,3301,3294,3278,16,7,4,3,220,220,0,557,551,6,517,517,0
"2021","Sandwell 029","E02002071",5254,2127,2114,2109,2096,13,5,1,4,167,164,3,454,454,0,392,392,0
"2021","Sandwell 030","E02002072",7155,2711,3038,3030,3015,15,8,6,2,214,214,0,742,742,0,450,449,1
"2021","Sandwell 031","E02002073",6381,2513,2748,2741,2736,5,7,2,5,149,148,1,539,538,1,432,432,0
"2021","Sandwell 032","E02002074",6508,2463,2873,2866,2861,5,7,6,1,182,182,0,506,506,0,484,484,0
"2021","Sandwell 033","E02002075",7082,2751,2941,2933,2912,21,8,2,6,180,180,0,680,679,1,530,530,0
"2021","Sandwell 034","E02002076",8496,3900,3238,3216,3165,51,22,6,16,259,258,1,702,698,4,397,393,4
"2021","Sandwell 035","E02002077",8671,3503,3533,3517,3503,14,16,6,10,228,227,1,828,825,3,579,579,0
"2021","Sandwell 036","E02002078",5290,1753,2683,2682,2670,12,1,0,1,97,97,0,360,359,1,397,396,1
"2021","Sandwell 037","E02002079",6849,2675,2899,2894,2883,11,5,3,2,173,171,2,637,636,1,465,465,0
"2021","Sandwell 038","E02002080",5786,2307,2380,2371,2363,8,9,6,3,153,153,0,565,565,0,381,381,0
"2021","Sandwell 039","E02006810",8780,3184,4148,4136,4122,14,12,8,4,245,245,0,617,615,2,586,586,0
"2021","Sandwell 040","E02006943",5491,2405,2291,2283,2251,32,8,4,4,183,183,0,360,360,0,252,252,0
"2021","Sandwell 041","E02006944",5696,2201,2714,2707,2700,7,7,2,5,247,247,0,355,355,0,179,179,0
"2021","Solihull 001","E02002081",4602,1530,2237,2235,2225,10,2,0,2,92,90,2,361,358,3,382,382,0
"2021","Solihull 002","E02002082",4403,2149,1428,1425,1416,9,3,0,3,132,131,1,437,435,2,257,257,0
"2021","Solihull 003","E02002083",5044,1584,2684,2681,2671,10,3,2,1,81,80,1,292,291,1,403,403,0
"2021","Solihull 004","E02002084",5107,2442,1775,1765,1750,15,10,6,4,143,141,2,450,448,2,297,297,0
"2021","Solihull 005","E02002085",5080,2279,1870,1850,1836,14,20,7,13,134,133,1,447,445,2,350,348,2
"2021","Solihull 006","E02002086",4599,2250,1399,1395,1380,15,4,2,2,131,128,3,527,527,0,292,292,0
"2021","Solihull 007","E02002087",4744,2333,1475,1468,1461,7,7,2,5,148,147,1,467,467,0,321,321,0
"2021","Solihull 008","E02002088",7327,3566,2262,2252,2230,22,10,8,2,240,238,2,771,769,2,488,488,0
"2021","Solihull 009","E02002089",6665,2601,2962,2950,2937,13,12,4,8,126,126,0,529,527,2,447,447,0
"2021","Solihull 010","E02002090",4800,1649,2452,2449,2441,8,3,0,3,90,90,0,326,325,1,283,283,0
"2021","Solihull 011","E02002091",6243,2120,2984,2974,2958,16,10,6,4,117,117,0,514,514,0,508,508,0
"2021","Solihull 012","E02002092",5916,2109,2666,2659,2646,13,7,6,1,121,121,0,568,568,0,452,451,1
"2021","Solihull 013","E02002093",5586,2004,2564,2552,2541,11,12,6,6,115,115,0,485,484,1,418,418,0
"2021","Solihull 014","E02002094",4989,1327,2877,2875,2871,4,2,2,0,59,59,0,307,307,0,419,419,0
"2021","Solihull 015","E02002095",7077,2337,3530,3518,3511,7,12,6,6,131,131,0,623,621,2,456,456,0
"2021","Solihull 016","E02002096",8447,2299,4618,4609,4587,22,9,6,3,133,133,0,650,648,2,747,747,0
"2021","Solihull 017","E02002097",6110,1735,3341,3329,3310,19,12,10,2,96,96,0,528,527,1,410,410,0
"2021","Solihull 018","E02002098",7768,2322,4155,4148,4130,18,7,0,7,146,146,0,565,565,0,580,580,0
"2021","Solihull 019","E02002099",5705,1278,3597,3587,3580,7,10,4,6,79,79,0,303,303,0,448,448,0
"2021","Solihull 021","E02002101",5190,1782,2354,2350,2334,16,4,2,2,108,105,3,532,531,1,414,414,0
"2021","Solihull 022","E02002102",7027,2127,3605,3596,3587,9,9,6,3,155,155,0,604,602,2,536,536,0
"2021","Solihull 023","E02002103",5108,1369,2830,2828,2823,5,2,2,0,86,86,0,395,395,0,428,428,0
"2021","Solihull 024","E02002104",4879,1183,2925,2921,2915,6,4,2,2,67,67,0,381,381,0,323,323,0
"2021","Solihull 025","E02002105",6791,1709,3989,3979,3965,14,10,6,4,104,104,0,475,475,0,514,514,0
"2021","Solihull 026","E02002106",7983,1824,4772,4768,4753,15,4,0,4,128,126,2,580,579,1,679,679,0
"2021","Solihull 027","E02002107",4489,1121,2658,2652,2642,10,6,2,4,77,77,0,359,359,0,274,274,0
"2021","Solihull 028","E02002108",7850,1836,4805,4793,4788,5,12,4,8,89,88,1,558,558,0,562,562,0
"2021","Solihull 029","E02002109",9634,3366,4906,4896,4882,14,10,4,6,177,176,1,801,799,2,384,384,0
"2021","Solihull 030","E02006808",5347,1812,2708,2693,2684,9,15,8,7,92,92,0,370,370,0,365,365,0
"2021","Walsall 001","E02002110",5635,2043,2576,2571,2563,8,5,2,3,127,125,2,528,528,0,361,360,1
"2021","Walsall 002","E02002111",5118,2004,2015,2006,1988,18,9,4,5,115,115,0,538,536,2,446,446,0
"2021","Walsall 003","E02002112",4372,1385,2199,2188,2183,5,11,2,9,71,71,0,381,381,0,336,336,0
"2021","Walsall 004","E02002113",5169,1928,2245,2234,2215,19,11,6,5,121,121,0,515,513,2,360,360,0
"2021","Walsall 005","E02002114",5099,1569,2408,2401,2387,14,7,3,4,96,96,0,523,523,0,503,503,0
"2021","Walsall 006","E02002115",5465,2146,2277,2275,2266,9,2,0,2,108,108,0,451,451,0,483,481,2
"2021","Walsall 007","E02002116",5717,1715,2948,2946,2934,12,2,2,0,96,96,0,478,478,0,480,480,0
"2021","Walsall 008","E02002117",5218,1940,2293,2276,2266,10,17,7,10,120,110,10,513,513,0,352,351,1
"2021","Walsall 009","E02002118",5741,2487,2109,2094,2086,8,15,6,9,171,157,14,510,509,1,464,464,0
"2021","Walsall 010","E02002119",4900,1714,2329,2325,2320,5,4,0,4,97,97,0,375,375,0,385,385,0
"2021","Walsall 011","E02002120",4950,1673,2568,2559,2550,9,9,0,9,74,74,0,373,370,3,262,262,0
"2021","Walsall 012","E02002121",5045,2191,1885,1875,1868,7,10,8,2,144,133,11,415,413,2,410,410,0
"2021","Walsall 013","E02002122",5046,2423,1929,1914,1905,9,15,6,9,137,137,0,315,313,2,242,242,0
"2021","Walsall 014","E02002123",5207,2050,2210,2201,2191,10,9,4,5,108,107,1,449,449,0,390,390,0
"2021","Walsall 015","E02002124",5781,2031,2398,2392,2386,6,6,6,0,124,123,1,595,594,1,633,632,1
"2021","Walsall 016","E02002125",5134,2047,2090,2078,2073,5,12,4,8,125,125,0,524,524,0,348,348,0
"2021","Walsall 017","E02002126",4970,2352,1624,1609,1590,19,15,10,5,158,158,0,523,520,3,313,313,0
"2021","Walsall 018","E02002127",7135,2949,3023,3000,2990,10,23,12,11,231,231,0,543,543,0,389,389,0
"2021","Walsall 019","E02002128",4636,1584,2133,2123,2117,6,10,4,6,88,87,1,391,388,3,440,440,0
"2021","Walsall 020","E02002129",5008,1748,2346,2342,2339,3,4,2,2,103,102,1,397,396,1,414,414,0
"2021","Walsall 021","E02002130",5143,2151,2117,2108,2094,14,9,6,3,129,126,3,444,444,0,302,301,1
"2021","Walsall 022","E02002131",6524,1774,3678,3666,3653,13,12,8,4,95,95,0,466,466,0,511,511,0
"2021","Walsall 023","E02002132",4936,1949,2057,2048,2038,10,9,4,5,111,110,1,458,457,1,361,361,0
"2021","Walsall 024","E02002133",5716,2145,2501,2488,2468,20,13,2,11,138,138,0,565,565,0,367,367,0
"2021","Walsall 025","E02002134",7101,3041,2754,2738,2715,23,16,8,8,197,194,3,665,664,1,444,444,0
"2021","Walsall 026","E02002135",5981,2542,2475,2470,2457,13,5,4,1,168,166,2,504,503,1,292,291,1
"2021","Walsall 027","E02002136",6273,2457,2738,2728,2717,11,10,7,3,178,176,2,586,583,3,314,314,0
"2021","Walsall 028","E02002137",5102,1239,2947,2938,2928,10,9,6,3,77,77,0,324,324,0,515,515,0
"2021","Walsall 029","E02002138",5061,1725,2559,2553,2547,6,6,6,0,112,111,1,348,347,1,317,317,0
"2021","Walsall 030","E02002139",8429,3903,3069,3063,3041,22,6,2,4,338,334,4,660,656,4,459,459,0
"2021","Walsall 031","E02002140",6357,2312,3004,2994,2980,14,10,4,6,204,203,1,422,420,2,415,415,0
"2021","Walsall 032","E02002141",5293,1457,2986,2979,2973,6,7,2,5,90,90,0,377,375,2,383,383,0
"2021","Walsall 033","E02002142",5544,2371,2264,2251,2236,15,13,8,5,171,169,2,444,443,1,294,294,0
"2021","Walsall 034","E02002143",7363,2636,3731,3721,3704,17,10,8,2,218,218,0,400,399,1,378,378,0
"2021","Walsall 035","E02002144",5665,1382,3452,3448,3439,9,4,2,2,81,81,0,264,264,0,486,486,0
"2021","Walsall 036","E02002145",6169,2636,2448,2429,2421,8,19,12,7,204,204,0,569,567,2,312,311,1
"2021","Walsall 037","E02002146",4970,1828,2353,2340,2334,6,13,8,5,83,83,0,389,388,1,317,317,0
"2021","Walsall 038","E02002147",6814,3009,2676,2663,2642,21,13,10,3,168,168,0,558,558,0,403,403,0
"2021","Walsall 039","E02002148",9318,3125,4561,4550,4535,15,11,2,9,162,159,3,702,702,0,768,768,0
"2021","Wolverhampton 001","E02002149",8182,3067,3534,3523,3494,29,11,4,7,196,196,0,679,679,0,706,705,1
"2021","Wolverhampton 002","E02002150",4577,1769,2023,2016,2010,6,7,3,4,93,93,0,375,374,1,317,317,0
"2021","Wolverhampton 003","E02002151",4418,1896,1609,1597,1586,11,12,6,6,126,126,0,537,537,0,250,250,0
"2021","Wolverhampton 004","E02002152",4677,2106,1701,1696,1694,2,5,2,3,130,130,0,412,409,3,328,328,0
"2021","Wolverhampton 005","E02002153",6110,2416,2452,2448,2439,9,4,0,4,115,114,1,585,585,0,542,542,0
"2021","Wolverhampton 006","E02002154",5725,2415,2414,2401,2375,26,13,4,9,141,141,0,461,460,1,294,294,0
"2021","Wolverhampton 007","E02002155",4518,2209,1498,1480,1467,13,18,8,10,184,183,1,351,351,0,276,276,0
"2021","Wolverhampton 008","E02002156",6664,2392,3043,3037,3026,11,6,1,5,144,144,0,604,604,0,481,480,1
"2021","Wolverhampton 009","E02002157",6377,2172,3136,3127,3114,13,9,0,9,116,116,0,534,534,0,419,419,0
"2021","Wolverhampton 010","E02002158",6140,2225,2640,2635,2622,13,5,0,5,138,138,0,590,588,2,547,547,0
"2021","Wolverhampton 011","E02002159",4530,2068,1738,1732,1726,6,6,4,2,132,131,1,338,336,2,254,254,0
"2021","Wolverhampton 012","E02002160",6089,2124,3000,2990,2977,13,10,4,6,99,99,0,443,442,1,423,423,0
"2021","Wolverhampton 013","E02002161",5261,2252,2201,2194,2179,15,7,2,5,134,133,1,470,468,2,204,204,0
"2021","Wolverhampton 014","E02002162",6569,1875,3345,3334,3308,26,11,2,9,133,130,3,545,542,3,671,671,0
"2021","Wolverhampton 015","E02002163",8948,4135,3207,3184,3175,9,23,16,7,258,256,2,848,848,0,500,498,2
"2021","Wolverhampton 016","E02002164",5291,2897,1691,1687,1674,13,4,4,0,148,148,0,329,326,3,226,224,2
"2021","Wolverhampton 017","E02002165",6559,3213,2204,2198,2182,16,6,0,6,187,185,2,634,633,1,321,321,0
"2021","Wolverhampton 018","E02002166",7256,3186,2664,2650,2630,20,14,6,8,191,188,3,702,701,1,513,513,0
"2021","Wolverhampton 019","E02002167",5526,1810,2633,2624,2620,4,9,2,7,140,137,3,580,580,0,363,363,0
"2021","Wolverhampton 020","E02002168",9262,4933,2942,2926,2914,12,16,6,10,267,267,0,741,738,3,379,379,0
"2021","Wolverhampton 021","E02002169",7324,2075,3976,3959,3940,19,17,2,15,115,115,0,550,550,0,608,608,0
"2021","Wolverhampton 022","E02002170",4984,1925,2257,2253,2240,13,4,2,2,99,99,0,375,375,0,328,327,1
"2021","Wolverhampton 023","E02002171",6027,2444,2474,2463,2451,12,11,8,3,153,153,0,512,511,1,444,444,0
"2021","Wolverhampton 026","E02002174",6351,2179,2989,2983,2967,16,6,2,4,137,136,1,571,568,3,475,475,0
"2021","Wolverhampton 027","E02002175",6074,2552,2448,2438,2426,12,10,7,3,172,169,3,495,494,1,407,405,2
"2021","Wolverhampton 028","E02002176",6243,2422,2700,2693,2677,16,7,2,5,142,142,0,598,597,1,381,381,0
"2021","Wolverhampton 029","E02002177",8790,3753,3552,3541,3500,41,11,2,9,244,242,2,729,729,0,512,512,0
"2021","Wolverhampton 030","E02002178",6746,1989,3749,3745,3733,12,4,2,2,112,112,0,388,388,0,508,508,0
"2021","Wolverhampton 031","E02002179",5328,1623,2821,2819,2803,16,2,0,2,93,93,0,404,403,1,387,387,0
"2021","Wolverhampton 032","E02002180",5247,1810,2497,2496,2479,17,1,0,1,117,117,0,398,398,0,425,425,0
"2021","Wolverhampton 033","E02002181",6442,2780,2585,2578,2561,17,7,4,3,170,170,0,527,526,1,380,380,0
"2021","Wolverhampton 034","E02002182",5341,2110,2301,2296,2283,13,5,4,1,121,120,1,428,428,0,381,381,0
"2021","Wolverhampton 035","E02006894",10866,4233,4958,4942,4912,30,16,10,6,280,277,3,737,737,0,658,656,2
"2021","Peterborough 001","E02003237",5223,1394,2901,2893,2885,8,8,6,2,88,87,1,490,490,0,350,350,0
"2021","Peterborough 002","E02003238",4667,1635,2097,2088,2082,6,9,8,1,110,110,0,609,607,2,216,216,0
"2021","Peterborough 003","E02003239",6918,2032,3604,3596,3591,5,8,2,6,143,141,2,659,656,3,480,480,0
"2021","Peterborough 004","E02003240",5444,1589,2937,2932,2919,13,5,0,5,164,164,0,504,504,0,250,250,0
"2021","Peterborough 005","E02003241",5824,1827,2877,2870,2855,15,7,2,5,155,154,1,585,584,1,380,378,2
"2021","Peterborough 006","E02003242",7002,2200,3300,3292,3279,13,8,6,2,163,163,0,737,737,0,602,602,0
"2021","Peterborough 007","E02003243",8937,4018,3100,3089,3067,22,11,8,3,297,294,3,1134,1134,0,388,386,2
"2021","Peterborough 008","E02003244",7411,2885,3058,3042,3026,16,16,8,8,215,215,0,787,787,0,466,466,0
"2021","Peterborough 009","E02003245",6080,2761,2105,2102,2096,6,3,2,1,203,203,0,731,729,2,280,280,0
"2021","Peterborough 010","E02003246",7704,3476,2950,2930,2897,33,20,14,6,241,238,3,694,690,4,343,342,1
"2021","Peterborough 011","E02003247",6853,2707,2719,2701,2691,10,18,6,12,239,237,2,786,783,3,402,401,1
"2021","Peterborough 012","E02003248",8722,3392,3990,3979,3960,19,11,10,1,204,204,0,689,689,0,447,445,2
"2021","Peterborough 013","E02003249",9673,4035,3817,3803,3781,22,14,8,6,286,285,1,1017,1012,5,518,516,2
"2021","Peterborough 014","E02003250",9538,4296,3551,3521,3510,11,30,22,8,271,270,1,971,970,1,449,449,0
"2021","Peterborough 015","E02003251",6501,1607,3757,3749,3740,9,8,4,4,116,116,0,515,515,0,506,506,0
"2021","Peterborough 016","E02003252",9499,3867,4029,4008,3991,17,21,10,11,272,270,2,957,955,2,374,373,1
"2021","Peterborough 017","E02003253",8200,3717,2945,2928,2914,14,17,8,9,238,237,1,924,923,1,376,376,0
"2021","Peterborough 018","E02003254",7681,2095,4226,4208,4187,21,18,6,12,143,142,1,696,695,1,521,521,0
"2021","Peterborough 019","E02003255",10634,3875,4849,4836,4813,23,13,6,7,252,251,1,1062,1060,2,596,595,1
"2021","Peterborough 021","E02003257",7231,3112,2519,2505,2491,14,14,6,8,251,251,0,977,975,2,372,371,1
"2021","Peterborough 022","E02006877",8453,3251,3827,3813,3791,22,14,2,12,208,205,3,775,775,0,392,392,0
"2021","Peterborough 023","E02006878",9372,3795,4222,4204,4182,22,18,8,10,250,249,1,841,840,1,264,263,1
"2021","Luton 001","E02003258",7095,2192,3732,3725,3713,12,7,4,3,119,119,0,583,583,0,469,469,0
"2021","Luton 002","E02003259",5245,1926,2418,2418,2415,3,0,0,0,136,135,1,466,466,0,299,299,0
"2021","Luton 003","E02003260",6537,2846,2497,2487,2479,8,10,8,2,224,224,0,653,652,1,317,317,0
"2021","Luton 004","E02003261",5230,1700,2531,2524,2516,8,7,1,6,93,93,0,417,417,0,489,488,1
"2021","Luton 005","E02003262",8500,3282,3676,3669,3656,13,7,4,3,240,238,2,787,787,0,515,514,1
"2021","Luton 006","E02003263",9921,3469,4916,4901,4892,9,15,10,5,241,240,1,686,684,2,609,607,2
"2021","Luton 007","E02003264",7606,2368,4257,4244,4237,7,13,4,9,118,118,0,456,456,0,407,407,0
"2021","Luton 008","E02003265",6802,2276,3291,3291,3280,11,0,0,0,131,131,0,623,623,0,481,480,1
"2021","Luton 009","E02003266",7539,3036,3156,3155,3149,6,1,0,1,197,196,1,743,742,1,407,407,0
"2021","Luton 010","E02003267",10565,3585,5993,5987,5965,22,6,4,2,211,211,0,388,388,0,388,388,0
"2021","Luton 011","E02003268",9325,3387,4665,4644,4631,13,21,12,9,216,215,1,564,563,1,493,492,1
"2021","Luton 012","E02003269",8503,3241,3845,3830,3817,13,15,4,11,235,233,2,703,703,0,479,479,0
"2021","Luton 013","E02003270",6949,2364,3488,3485,3477,8,3,3,0,131,130,1,462,460,2,504,504,0
"2021","Luton 014","E02003271",8207,3093,3900,3891,3873,18,9,4,5,173,173,0,678,678,0,363,363,0
"2021","Luton 015","E02003272",8213,2873,4475,4472,4457,15,3,3,0,174,173,1,332,332,0,359,359,0
"2021","Luton 016","E02003273",9283,3846,4006,3997,3980,17,9,2,7,226,223,3,745,745,0,460,459,1
"2021","Luton 017","E02003274",8363,3042,4226,4222,4183,39,4,2,2,225,224,1,511,511,0,359,357,2
"2021","Luton 019","E02003276",6789,2784,3173,3161,3150,11,12,8,4,165,165,0,452,451,1,215,215,0
"2021","Luton 020","E02003277",8691,3736,3608,3595,3582,13,13,6,7,247,244,3,679,679,0,421,420,1
"2021","Luton 021","E02003278",10567,5253,3746,3734,3717,17,12,4,8,385,383,2,839,834,5,344,344,0
"2021","Luton 022","E02006937",7447,3903,2334,2309,2293,16,25,10,15,271,269,2,731,730,1,208,205,3
"2021","Luton 023","E02006938",5314,3018,1477,1470,1459,11,7,4,3,207,206,1,452,451,1,160,160,0
"2021","Southend-on-Sea 001","E02003279",7931,2345,3959,3954,3938,16,5,2,3,134,134,0,802,800,2,691,691,0
"2021","Southend-on-Sea 002","E02003280",8566,2947,3883,3868,3845,23,15,10,5,181,181,0,945,943,2,610,609,1
"2021","Southend-on-Sea 003","E02003281",7912,2321,3862,3847,3841,6,15,1,14,153,153,0,845,843,2,731,730,1
"2021","Southend-on-Sea 004","E02003282",8582,2936,4129,4116,4097,19,13,1,12,188,188,0,786,783,3,543,542,1
"2021","Southend-on-Sea 005","E02003283",8777,3195,3879,3869,3843,26,10,4,6,236,235,1,871,867,4,596,595,1
"2021","Southend-on-Sea 006","E02003284",8865,3603,3592,3562,3526,36,30,10,20,226,226,0,986,985,1,458,458,0
"2021","Southend-on-Sea 007","E02003285",8767,4087,3208,3193,3160,33,15,6,9,229,229,0,952,949,3,291,290,1
"2021","Southend-on-Sea 008","E02003286",7538,2123,4226,4204,4185,19,22,14,8,120,118,2,632,632,0,437,437,0
"2021","Southend-on-Sea 009","E02003287",8145,2720,3861,3845,3833,12,16,8,8,193,193,0,752,751,1,619,619,0
"2021","Southend-on-Sea 010","E02003288",10259,5082,3115,3099,3065,34,16,10,6,375,373,2,1216,1211,5,471,471,0
"2021","Southend-on-Sea 011","E02003289",8152,3324,3195,3175,3140,35,20,1,19,210,210,0,977,973,4,446,446,0
"2021","Southend-on-Sea 012","E02003290",8314,3231,3303,3292,3275,17,11,6,5,235,233,2,892,891,1,653,653,0
"2021","Southend-on-Sea 013","E02003291",9444,3645,3725,3712,3690,22,13,6,7,283,280,3,1223,1219,4,568,567,1
"2021","Southend-on-Sea 014","E02003292",9544,4803,2640,2629,2610,19,11,2,9,347,344,3,1310,1304,6,444,443,1
"2021","Southend-on-Sea 015","E02003293",9822,4954,2649,2624,2582,42,25,5,20,335,332,3,1317,1315,2,567,565,2
"2021","Southend-on-Sea 016","E02003294",7699,2130,4036,4009,3991,18,27,8,19,151,150,1,713,712,1,669,669,0
"2021","Southend-on-Sea 017","E02003295",8090,2895,3735,3717,3703,14,18,10,8,177,174,3,758,757,1,525,524,1
"2021","Thurrock 001","E02003296",5918,1795,3215,3207,3205,2,8,8,0,96,96,0,450,449,1,362,362,0
"2021","Thurrock 002","E02003297",5888,2092,2678,2676,2665,11,2,2,0,129,127,2,543,543,0,446,446,0
"2021","Thurrock 003","E02003298",5816,1975,2761,2755,2751,4,6,4,2,107,107,0,516,516,0,457,457,0
"2021","Thurrock 004","E02003299",5379,1703,2750,2746,2739,7,4,0,4,104,103,1,463,462,1,359,359,0
"2021","Thurrock 005","E02003300",7101,2753,3181,3165,3150,15,16,6,10,157,155,2,625,624,1,385,385,0
"2021","Thurrock 006","E02003301",9202,3648,4115,4105,4092,13,10,2,8,254,254,0,760,760,0,425,425,0
"2021","Thurrock 007","E02003302",7935,3485,3111,3104,3084,20,7,6,1,219,216,3,739,737,2,381,379,2
"2021","Thurrock 008","E02003303",7325,2951,3187,3178,3174,4,9,6,3,168,166,2,657,656,1,362,362,0
"2021","Thurrock 009","E02003304",7673,2527,3699,3689,3681,8,10,4,6,180,179,1,723,723,0,544,544,0
"2021","Thurrock 010","E02003305",5580,1788,2931,2925,2917,8,6,6,0,103,103,0,403,402,1,355,355,0
"2021","Thurrock 012","E02003307",8140,3151,3404,3393,3381,12,11,10,1,189,188,1,727,725,2,669,668,1
"2021","Thurrock 013","E02003308",5853,2278,2726,2714,2695,19,12,4,8,129,128,1,456,455,1,264,264,0
"2021","Thurrock 014","E02003309",6326,2212,3091,3077,3068,9,14,14,0,123,122,1,518,517,1,382,381,1
"2021","Thurrock 016","E02003311",7416,2898,3290,3271,3255,16,19,9,10,184,184,0,681,679,2,363,363,0
"2021","Thurrock 017","E02003312",6932,3133,2682,2672,2663,9,10,8,2,236,236,0,691,691,0,190,190,0
"2021","Thurrock 018","E02003313",10700,4777,4047,4021,4016,5,26,22,4,372,371,1,979,979,0,525,523,2
"2021","Thurrock 019","E02006859",5735,2182,2915,2903,2888,15,12,4,8,141,140,1,393,393,0,104,104,0
"2021","Thurrock 020","E02006926",6182,2315,3072,3067,3054,13,5,2,3,164,163,1,446,446,0,185,184,1
"2021","Thurrock 021","E02007004",4956,2237,1908,1898,1884,14,10,7,3,184,184,0,490,489,1,137,137,0
"2021","Thurrock 022","E02007005",6299,2770,2641,2628,2619,9,13,8,5,183,182,1,522,520,2,183,182,1
"2021","Bedford 001","E02003616",4744,1180,2772,2772,2756,16,0,0,0,87,87,0,381,380,1,324,324,0
"2021","Bedford 002","E02003617",7531,2044,4098,4081,4051,30,17,5,12,164,163,1,708,707,1,517,517,0
"2021","Bedford 003","E02003618",7063,2100,3619,3609,3585,24,10,6,4,135,135,0,721,721,0,488,488,0
"2021","Bedford 004","E02003619",9577,2760,5190,5180,5144,36,10,0,10,203,202,1,891,891,0,533,532,1
"2021","Bedford 005","E02003620",6723,1946,3472,3463,3453,10,9,3,6,128,128,0,630,630,0,547,546,1
"2021","Bedford 006","E02003621",6731,1798,3745,3739,3723,16,6,2,4,118,117,1,524,523,1,546,546,0
"2021","Bedford 007","E02003622",7260,2884,2904,2895,2886,9,9,6,3,186,183,3,819,819,0,467,466,1
"2021","Bedford 008","E02003623",10081,3129,5482,5464,5445,19,18,10,8,184,184,0,806,804,2,480,479,1
"2021","Bedford 009","E02003624",5053,2264,1832,1819,1810,9,13,2,11,121,121,0,469,467,2,367,367,0
"2021","Bedford 010","E02003625",7577,3578,2333,2306,2288,18,27,8,19,245,242,3,892,887,5,529,527,2
"2021","Bedford 011","E02003626",4596,1677,2134,2123,2113,10,11,8,3,112,110,2,443,442,1,230,230,0
"2021","Bedford 012","E02003627",8913,4075,3140,3124,3105,19,16,8,8,279,275,4,968,965,3,451,450,1
"2021","Bedford 013","E02003628",7151,2669,3458,3444,3420,24,14,4,10,185,185,0,480,479,1,359,359,0
"2021","Bedford 014","E02003629",8328,3468,3244,3231,3214,17,13,10,3,260,257,3,906,901,5,450,448,2
"2021","Bedford 015","E02003630",8900,3902,3513,3502,3487,15,11,2,9,289,288,1,749,748,1,447,446,1
"2021","Bedford 016","E02003631",4561,1664,1978,1971,1966,5,7,3,4,117,117,0,507,507,0,295,295,0
"2021","Bedford 017","E02003632",5007,1849,2221,2219,2216,3,2,0,2,126,126,0,526,526,0,285,285,0
"2021","Bedford 018","E02003633",8273,3087,3834,3817,3783,34,17,12,5,225,225,0,721,720,1,406,406,0
"2021","Bedford 020","E02003635",7773,2782,3817,3809,3784,25,8,3,5,149,147,2,663,658,5,362,361,1
"2021","Bedford 021","E02007010",6715,2307,3235,3227,3217,10,8,4,4,159,158,1,676,676,0,338,337,1
"2021","Bedford 022","E02007011",5575,1980,2751,2741,2702,39,10,4,6,127,126,1,467,467,0,250,250,0
"2021","Central Bedfordshire 001","E02003599",4546,1553,2182,2171,2161,10,11,0,11,121,121,0,445,445,0,245,245,0
"2021","Central Bedfordshire 002","E02003600",5277,1764,2510,2506,2490,16,4,2,2,147,146,1,513,513,0,343,341,2
"2021","Central Bedfordshire 003","E02003601",6671,2012,3489,3483,3478,5,6,4,2,154,154,0,644,642,2,372,372,0
"2021","Central Bedfordshire 004","E02003602",5516,1489,3034,3020,3005,15,14,4,10,102,101,1,526,525,1,365,365,0
"2021","Central Bedfordshire 005","E02003603",9126,3432,4000,3988,3958,30,12,6,6,230,229,1,940,938,2,524,524,0
"2021","Central Bedfordshire 006","E02003604",8864,3105,4392,4373,4335,38,19,6,13,190,190,0,716,714,2,461,461,0
"2021","Central Bedfordshire 007","E02003605",8335,3181,3932,3922,3901,21,10,4,6,142,141,1,689,686,3,391,390,1
"2021","Central Bedfordshire 008","E02003606",7665,2299,4129,4114,4092,22,15,5,10,149,149,0,643,639,4,445,445,0
"2021","Central Bedfordshire 009","E02003607",8824,2729,4610,4593,4551,42,17,8,9,190,188,2,840,840,0,455,455,0
"2021","Central Bedfordshire 010","E02003608",9880,3236,4850,4830,4799,31,20,8,12,216,215,1,1026,1023,3,552,551,1
"2021","Central Bedfordshire 011","E02003609",9398,3205,4543,4528,4505,23,15,8,7,253,249,4,910,906,4,487,487,0
"2021","Central Bedfordshire 012","E02003610",7190,2157,3762,3751,3729,22,11,7,4,169,165,4,685,684,1,417,417,0
"2021","Central Bedfordshire 013","E02003611",7945,2361,4253,4242,4215,27,11,4,7,161,161,0,744,740,4,426,425,1
"2021","Central Bedfordshire 014","E02003612",9571,2847,5170,5158,5126,32,12,8,4,239,237,2,845,842,3,470,469,1
"2021","Central Bedfordshire 015","E02003613",4735,1636,2220,2218,2209,9,2,0,2,107,106,1,462,462,0,310,310,0
"2021","Central Bedfordshire 016","E02003614",6657,2201,3416,3412,3398,14,4,2,2,133,133,0,608,606,2,299,299,0
"2021","Central Bedfordshire 017","E02003615",8462,2355,4824,4808,4788,20,16,8,8,147,147,0,672,671,1,464,464,0
"2021","Central Bedfordshire 018","E02003636",6045,1945,3063,3050,3046,4,13,8,5,121,121,0,539,538,1,377,377,0
"2021","Central Bedfordshire 019","E02003637",8841,2561,4740,4732,4710,22,8,2,6,183,183,0,844,841,3,513,513,0
"2021","Central Bedfordshire 020","E02003638",6266,1766,3477,3469,3460,9,8,2,6,117,117,0,543,542,1,363,363,0
"2021","Central Bedfordshire 021","E02003639",7720,3039,3040,3028,3008,20,12,6,6,219,219,0,892,889,3,530,530,0
"2021","Central Bedfordshire 022","E02003640",5041,1664,2495,2487,2470,17,8,6,2,129,129,0,463,460,3,290,290,0
"2021","Central Bedfordshire 023","E02003641",4360,1336,2436,2430,2420,10,6,0,6,62,62,0,331,330,1,195,195,0
"2021","Central Bedfordshire 025","E02003642",7278,2951,3048,3031,3012,19,17,10,7,207,207,0,733,733,0,339,337,2
"2021","Central Bedfordshire 024","E02003643",10398,3891,4915,4904,4871,33,11,6,5,251,251,0,929,929,0,412,411,1
"2021","Central Bedfordshire 026","E02003644",7955,3018,3568,3558,3528,30,10,4,6,173,169,4,744,740,4,452,452,0
"2021","Central Bedfordshire 027","E02003645",5700,1851,2896,2891,2887,4,5,3,2,109,109,0,472,472,0,372,372,0
"2021","Central Bedfordshire 028","E02003646",8299,3076,3874,3862,3847,15,12,2,10,222,222,0,733,731,2,394,394,0
"2021","Central Bedfordshire 029","E02003647",8571,3413,3517,3505,3487,18,12,6,6,214,214,0,912,910,2,515,515,0
"2021","Central Bedfordshire 030","E02003648",4338,1738,1774,1765,1754,11,9,6,3,101,98,3,468,468,0,257,256,1
"2021","Central Bedfordshire 031","E02003649",5551,1688,2917,2910,2896,14,7,2,5,110,109,1,474,474,0,362,362,0
"2021","Central Bedfordshire 032","E02003650",5925,1555,3258,3253,3242,11,5,4,1,116,116,0,565,565,0,431,431,0
"2021","Central Bedfordshire 033","E02003651",5819,1755,2932,2924,2904,20,8,4,4,115,114,1,562,561,1,455,455,0
"2021","Cambridge 001","E02003719",8469,4394,2764,2743,2724,19,21,6,15,177,176,1,753,753,0,381,381,0
"2021","Cambridge 002","E02003720",7961,3812,3073,3047,3014,33,26,20,6,131,130,1,583,581,2,362,361,1
"2021","Cambridge 003","E02003721",8100,4016,2750,2734,2715,19,16,10,6,145,145,0,738,732,6,451,450,1
"2021","Cambridge 004","E02003722",7287,3340,3003,2969,2941,28,34,15,19,99,99,0,521,518,3,324,323,1
"2021","Cambridge 005","E02003723",12071,8976,2515,2482,2405,77,33,15,18,50,50,0,343,341,2,187,186,1
"2021","Cambridge 006","E02003724",8552,4443,2951,2931,2910,21,20,6,14,162,161,1,706,703,3,290,290,0
"2021","Cambridge 007","E02003725",15193,11495,2851,2814,2788,26,37,6,31,117,116,1,442,441,1,288,286,2
"2021","Cambridge 008","E02003726",7283,4496,2122,2082,2058,24,40,16,24,78,78,0,416,415,1,171,171,0
"2021","Cambridge 009","E02003727",8906,5446,2598,2572,2531,41,26,10,16,134,134,0,483,475,8,245,244,1
"2021","Cambridge 010","E02003728",9424,5180,3230,3204,3193,11,26,8,18,126,125,1,617,616,1,271,270,1
"2021","Cambridge 011","E02003729",7478,2774,3703,3684,3672,12,19,10,9,114,114,0,552,550,2,335,334,1
"2021","Cambridge 013","E02003731",10316,5329,3956,3931,3900,31,25,16,9,136,134,2,522,522,0,373,373,0
"2021","Cambridge 015","E02007086",8239,3430,3868,3832,3820,12,36,24,12,156,156,0,559,557,2,226,225,1
"2021","Cambridge 014","E02007087",5494,3305,1653,1630,1612,18,23,6,17,74,74,0,281,281,0,181,181,0
"2021","East Cambridgeshire 001","E02003732",7934,2739,3769,3760,3734,26,9,2,7,191,191,0,760,758,2,475,475,0
"2021","East Cambridgeshire 002","E02003733",6948,1924,3852,3838,3813,25,14,4,10,138,136,2,602,601,1,432,432,0
"2021","East Cambridgeshire 003","E02003734",9698,3152,4779,4763,4724,39,16,8,8,196,194,2,903,902,1,668,668,0
"2021","East Cambridgeshire 004","E02003735",7060,2282,3553,3542,3512,30,11,2,9,126,126,0,672,672,0,427,426,1
"2021","East Cambridgeshire 005","E02003736",8435,2210,4734,4710,4691,19,24,6,18,180,179,1,794,793,1,517,516,1
"2021","East Cambridgeshire 006","E02003737",10542,3582,4964,4942,4918,24,22,8,14,288,285,3,1061,1060,1,647,645,2
"2021","East Cambridgeshire 007","E02003738",5203,1423,2864,2858,2851,7,6,4,2,98,97,1,506,503,3,312,312,0
"2021","East Cambridgeshire 008","E02003739",5268,1507,2797,2787,2778,9,10,2,8,92,91,1,504,503,1,368,367,1
"2021","East Cambridgeshire 009","E02003740",5159,1401,2802,2792,2779,13,10,6,4,103,103,0,478,478,0,375,375,0
"2021","East Cambridgeshire 011","E02006825",5190,1380,2928,2916,2898,18,12,8,4,99,99,0,478,476,2,305,305,0
"2021","Fenland 001","E02003742",5791,1583,2991,2986,2971,15,5,0,5,118,114,4,625,625,0,474,472,2
"2021","Fenland 002","E02003743",8914,3628,3291,3270,3250,20,21,14,7,230,229,1,1087,1084,3,678,678,0
"2021","Fenland 003","E02003744",11415,4335,4418,4382,4364,18,36,16,20,275,273,2,1435,1433,2,952,951,1
"2021","Fenland 004","E02003745",8628,2632,4248,4236,4211,25,12,4,8,233,231,2,872,871,1,643,642,1
"2021","Fenland 005","E02003746",6446,2348,2822,2811,2802,9,11,4,7,141,138,3,664,663,1,471,469,2
"2021","Fenland 006","E02003747",10438,3342,4848,4834,4815,19,14,4,10,287,283,4,1113,1112,1,848,846,2
"2021","Fenland 007","E02003748",6321,2072,2744,2736,2723,13,8,4,4,181,181,0,805,801,4,519,519,0
"2021","Fenland 008","E02003749",5116,1484,2680,2672,2666,6,8,2,6,117,115,2,503,501,2,332,330,2
"2021","Fenland 009","E02003750",6311,1960,2987,2975,2962,13,12,8,4,147,147,0,627,626,1,590,589,1
"2021","Fenland 010","E02003751",6243,1756,3318,3310,3298,12,8,2,6,127,125,2,600,599,1,442,442,0
"2021","Fenland 011","E02003752",9207,3130,4161,4139,4123,16,22,1,21,234,232,2,1036,1034,2,646,644,2
"2021","Huntingdonshire 001","E02003753",9006,2818,4528,4516,4497,19,12,2,10,192,192,0,965,965,0,503,503,0
"2021","Huntingdonshire 002","E02003754",4750,1214,2705,2695,2684,11,10,0,10,114,113,1,432,432,0,285,285,0
"2021","Huntingdonshire 003","E02003755",7077,2284,3406,3397,3383,14,9,0,9,184,184,0,755,755,0,448,448,0
"2021","Huntingdonshire 004","E02003756",5873,1714,3074,3057,3049,8,17,9,8,122,121,1,577,577,0,386,386,0
"2021","Huntingdonshire 005","E02003757",5711,1600,3068,3061,3050,11,7,2,5,106,101,5,548,546,2,389,389,0
"2021","Huntingdonshire 006","E02003758",7980,2371,4278,4267,4238,29,11,0,11,180,180,0,689,685,4,462,460,2
"2021","Huntingdonshire 007","E02003759",4977,1220,2925,2915,2902,13,10,4,6,82,82,0,409,409,0,341,341,0
"2021","Huntingdonshire 008","E02003760",6941,2984,2639,2635,2615,20,4,4,0,225,225,0,743,742,1,350,348,2
"2021","Huntingdonshire 009","E02003761",5055,1450,2709,2704,2692,12,5,2,3,90,89,1,436,434,2,370,369,1
"2021","Huntingdonshire 010","E02003762",9133,2802,4707,4689,4643,46,18,2,16,187,185,2,881,880,1,556,556,0
"2021","Huntingdonshire 011","E02003763",7880,2721,3817,3802,3793,9,15,10,5,149,149,0,778,778,0,415,415,0
"2021","Huntingdonshire 012","E02003764",8510,3230,3734,3725,3700,25,9,4,5,266,263,3,844,842,2,436,435,1
"2021","Huntingdonshire 013","E02003765",6043,2013,2735,2730,2721,9,5,0,5,172,171,1,644,642,2,479,479,0
"2021","Huntingdonshire 014","E02003766",6293,2193,2966,2952,2941,11,14,4,10,117,117,0,660,658,2,357,357,0
"2021","Huntingdonshire 015","E02003767",5400,1322,3226,3219,3205,14,7,0,7,82,82,0,459,457,2,311,310,1
"2021","Huntingdonshire 016","E02003768",8325,2097,4667,4660,4646,14,7,0,7,176,174,2,784,783,1,601,601,0
"2021","Huntingdonshire 017","E02003769",6477,1872,3164,3150,3133,17,14,2,12,186,186,0,832,832,0,423,422,1
"2021","Huntingdonshire 018","E02003770",8449,2659,4503,4489,4459,30,14,2,12,177,176,1,689,686,3,421,421,0
"2021","Huntingdonshire 019","E02003771",5292,1851,2270,2254,2238,16,16,2,14,135,135,0,634,634,0,402,402,0
"2021","Huntingdonshire 020","E02003772",5686,1570,3163,3157,3148,9,6,4,2,91,91,0,513,512,1,349,349,0
"2021","Huntingdonshire 021","E02003773",8650,3205,3750,3744,3720,24,6,4,2,221,221,0,996,994,2,478,477,1
"2021","Huntingdonshire 022","E02003774",4747,1608,2095,2095,2076,19,0,0,0,116,116,0,527,527,0,401,401,0
"2021","South Cambridgeshire 001","E02003775",5851,1684,3222,3212,3202,10,10,4,6,122,121,1,510,509,1,313,313,0
"2021","South Cambridgeshire 002","E02003776",5570,1678,2838,2823,2817,6,15,4,11,163,163,0,523,522,1,368,368,0
"2021","South Cambridgeshire 003","E02003777",7715,2537,4017,3999,3982,17,18,2,16,166,166,0,691,691,0,304,304,0
"2021","South Cambridgeshire 004","E02003778",5284,1802,2643,2639,2618,21,4,2,2,104,104,0,436,435,1,299,298,1
"2021","South Cambridgeshire 006","E02003780",9237,3411,4415,4382,4353,29,33,8,25,163,163,0,721,715,6,527,525,2
"2021","South Cambridgeshire 007","E02003781",5135,1795,2560,2539,2526,13,21,6,15,154,153,1,373,373,0,253,253,0
"2021","South Cambridgeshire 010","E02003784",7265,2044,4175,4158,4144,14,17,4,13,104,104,0,545,545,0,397,397,0
"2021","South Cambridgeshire 011","E02003785",7253,2393,3786,3769,3761,8,17,8,9,133,133,0,519,519,0,422,422,0
"2021","South Cambridgeshire 012","E02003786",5365,1482,3032,3013,2999,14,19,5,14,79,79,0,378,377,1,394,393,1
"2021","South Cambridgeshire 013","E02003787",6343,1560,3544,3531,3520,11,13,0,13,122,122,0,663,663,0,454,454,0
"2021","South Cambridgeshire 014","E02003788",6444,1752,3712,3695,3670,25,17,8,9,126,126,0,502,502,0,352,352,0
"2021","South Cambridgeshire 015","E02003789",5853,1664,3089,3078,3069,9,11,3,8,123,123,0,533,531,2,444,442,2
"2021","South Cambridgeshire 016","E02003790",7739,2123,4326,4310,4291,19,16,4,12,133,133,0,651,649,2,506,506,0
"2021","South Cambridgeshire 017","E02003791",6673,1790,3811,3786,3771,15,25,8,17,122,121,1,570,567,3,380,379,1
"2021","South Cambridgeshire 018","E02003792",8023,2163,4504,4485,4472,13,19,4,15,124,124,0,675,675,0,557,556,1
"2021","South Cambridgeshire 019","E02003793",5871,1717,3213,3201,3195,6,12,4,8,119,119,0,504,504,0,318,318,0
"2021","South Cambridgeshire 020","E02006873",6962,2402,3695,3691,3668,23,4,0,4,161,158,3,536,534,2,168,168,0
"2021","South Cambridgeshire 021","E02006874",7980,2351,4504,4494,4468,26,10,4,6,151,148,3,659,653,6,315,313,2
"2021","South Cambridgeshire 022","E02007085",9790,2984,5154,5126,5091,35,28,14,14,197,196,1,830,829,1,625,622,3
"2021","Basildon 001","E02004424",5700,1462,3479,3474,3463,11,5,0,5,66,66,0,378,377,1,315,315,0
"2021","Basildon 002","E02004425",5938,1884,3008,3001,2992,9,7,0,7,137,137,0,539,538,1,370,370,0
"2021","Basildon 003","E02004426",6587,2058,3366,3361,3356,5,5,0,5,128,126,2,568,568,0,467,466,1
"2021","Basildon 004","E02004427",6593,1771,3645,3637,3630,7,8,4,4,92,92,0,514,514,0,571,571,0
"2021","Basildon 005","E02004428",5749,1936,2689,2685,2675,10,4,2,2,112,111,1,504,504,0,508,508,0
"2021","Basildon 006","E02004429",6402,1823,3434,3427,3420,7,7,6,1,109,108,1,508,508,0,528,527,1
"2021","Basildon 007","E02004430",6768,2112,3514,3508,3495,13,6,6,0,117,117,0,614,614,0,411,411,0
"2021","Basildon 008","E02004431",7734,2947,3467,3465,3450,15,2,2,0,181,181,0,769,768,1,370,370,0
"2021","Basildon 009","E02004432",5333,1565,2906,2896,2886,10,10,4,6,99,99,0,443,443,0,320,320,0
"2021","Basildon 010","E02004433",7071,2691,2961,2958,2938,20,3,2,1,227,227,0,767,764,3,425,425,0
"2021","Basildon 011","E02004434",6861,2678,2851,2839,2826,13,12,6,6,197,196,1,754,752,2,381,381,0
"2021","Basildon 012","E02004435",7458,3081,3001,2999,2989,10,2,0,2,223,221,2,756,756,0,397,397,0
"2021","Basildon 013","E02004436",5952,2610,2066,2058,2047,11,8,2,6,244,243,1,695,691,4,337,337,0
"2021","Basildon 014","E02004437",7952,3051,3324,3313,3297,16,11,4,7,211,210,1,884,881,3,482,482,0
"2021","Basildon 015","E02004438",7376,3190,2736,2729,2717,12,7,0,7,213,210,3,749,748,1,488,487,1
"2021","Basildon 016","E02004439",7153,3365,2527,2524,2516,8,3,0,3,258,255,3,692,689,3,311,310,1
"2021","Basildon 017","E02004440",7096,2867,2961,2945,2931,14,16,12,4,210,210,0,666,661,5,392,392,0
"2021","Basildon 018","E02004441",6230,2294,2603,2597,2590,7,6,2,4,154,154,0,740,740,0,439,439,0
"2021","Basildon 019","E02004442",6407,2831,2287,2277,2270,7,10,4,6,220,216,4,729,727,2,340,338,2
"2021","Basildon 020","E02004443",8363,3219,3841,3827,3808,19,14,2,12,205,205,0,661,658,3,437,435,2
"2021","Basildon 021","E02004444",7367,2501,3746,3740,3722,18,6,2,4,138,138,0,619,619,0,363,361,2
"2021","Basildon 022","E02004445",6574,2667,2674,2667,2655,12,7,5,2,173,173,0,683,679,4,377,376,1
"2021","Braintree 001","E02004446",5880,1584,3345,3337,3333,4,8,0,8,96,96,0,546,545,1,309,309,0
"2021","Braintree 002","E02004447",5148,1292,2950,2927,2919,8,23,7,16,100,100,0,502,501,1,304,302,2
"2021","Braintree 003","E02004448",6405,1979,3232,3222,3204,18,10,4,6,106,106,0,651,650,1,437,437,0
"2021","Braintree 004","E02004449",7170,2598,2959,2951,2939,12,8,0,8,189,189,0,913,913,0,511,509,2
"2021","Braintree 005","E02004450",5365,1395,3112,3102,3091,11,10,0,10,81,79,2,470,470,0,307,306,1
"2021","Braintree 006","E02004451",7835,2297,4080,4072,4056,16,8,2,6,118,116,2,800,799,1,540,540,0
"2021","Braintree 007","E02004452",7623,2146,4028,4020,3998,22,8,2,6,150,150,0,721,721,0,578,578,0
"2021","Braintree 008","E02004453",5867,2306,2383,2374,2353,21,9,6,3,137,134,3,687,686,1,354,352,2
"2021","Braintree 009","E02004454",7807,3146,3030,3016,2983,33,14,4,10,198,196,2,959,958,1,474,474,0
"2021","Braintree 010","E02004455",6468,1877,3615,3604,3592,12,11,4,7,106,106,0,531,530,1,339,339,0
"2021","Braintree 011","E02004456",7841,3091,3233,3219,3209,10,14,2,12,181,181,0,873,869,4,463,462,1
"2021","Braintree 012","E02004457",8442,2929,4002,3986,3969,17,16,4,12,167,165,2,843,842,1,501,500,1
"2021","Braintree 013","E02004458",7581,2209,4042,4030,4017,13,12,2,10,133,133,0,744,744,0,453,453,0
"2021","Braintree 014","E02004459",8631,2491,4510,4493,4468,25,17,4,13,179,176,3,807,804,3,644,643,1
"2021","Braintree 015","E02004460",7881,2885,3659,3647,3621,26,12,4,8,144,144,0,720,719,1,473,472,1
"2021","Braintree 016","E02004461",4454,1773,1836,1832,1826,6,4,2,2,111,109,2,522,522,0,212,212,0
"2021","Braintree 017","E02004462",9457,3687,3894,3874,3861,13,20,13,7,222,221,1,1049,1047,2,605,605,0
"2021","Braintree 018","E02004463",6716,1948,3599,3584,3568,16,15,2,13,150,150,0,562,561,1,457,456,1
"2021","Brentwood 001","E02004464",8234,2269,4688,4678,4670,8,10,1,9,125,123,2,565,563,2,587,587,0
"2021","Brentwood 002","E02004465",5288,1626,2621,2616,2607,9,5,0,5,130,130,0,480,479,1,431,431,0
"2021","Brentwood 003","E02004466",6579,2247,3125,3117,3104,13,8,6,2,140,140,0,633,633,0,434,432,2
"2021","Brentwood 004","E02004467",6478,2491,2834,2824,2814,10,10,2,8,147,145,2,633,633,0,373,373,0
"2021","Brentwood 005","E02004468",8621,2163,5174,5172,5161,11,2,2,0,129,128,1,524,521,3,631,629,2
"2021","Brentwood 006","E02004469",5832,1848,3048,3042,3031,11,6,0,6,101,99,2,490,490,0,345,345,0
"2021","Brentwood 007","E02004470",9768,4435,3515,3493,3456,37,22,8,14,275,272,3,991,986,5,552,550,2
"2021","Brentwood 008","E02004471",6923,2623,3060,3057,3047,10,3,0,3,165,165,0,653,650,3,422,422,0
"2021","Brentwood 009","E02004472",5148,1579,2652,2648,2637,11,4,2,2,99,97,2,456,456,0,362,362,0
"2021","Castle Point 001","E02004473",6348,2020,3224,3212,3202,10,12,2,10,111,111,0,530,529,1,463,463,0
"2021","Castle Point 002","E02004474",6672,2050,3393,3385,3379,6,8,6,2,104,104,0,572,572,0,553,553,0
"2021","Castle Point 003","E02004475",5486,1654,2943,2939,2937,2,4,4,0,83,83,0,399,399,0,407,407,0
"2021","Castle Point 004","E02004476",6737,1941,3732,3725,3717,8,7,2,5,84,83,1,508,508,0,472,472,0
"2021","Castle Point 005","E02004477",5160,1285,2877,2873,2863,10,4,2,2,72,71,1,459,456,3,467,466,1
"2021","Castle Point 006","E02004478",5586,1969,2369,2363,2348,15,6,2,4,141,141,0,594,592,2,513,513,0
"2021","Castle Point 007","E02004479",6719,2144,3377,3364,3354,10,13,8,5,122,122,0,553,553,0,523,523,0
"2021","Castle Point 008","E02004480",5537,1911,2703,2693,2685,8,10,5,5,111,111,0,487,487,0,325,325,0
"2021","Castle Point 009","E02004481",5782,1607,2708,2691,2685,6,17,6,11,125,125,0,638,638,0,704,704,0
"2021","Castle Point 010","E02004482",6582,2640,2624,2609,2597,12,15,6,9,158,158,0,645,644,1,515,515,0
"2021","Castle Point 011","E02004483",6749,2033,3350,3337,3327,10,13,4,9,138,138,0,647,647,0,581,580,1
"2021","Castle Point 012","E02004484",7055,2240,3280,3267,3257,10,13,6,7,175,173,2,732,731,1,628,628,0
"2021","Chelmsford 001","E02004485",7601,2437,3904,3892,3869,23,12,4,8,166,166,0,690,689,1,404,403,1
"2021","Chelmsford 002","E02004486",7071,2004,3887,3875,3869,6,12,6,6,110,110,0,554,553,1,516,516,0
"2021","Chelmsford 003","E02004487",5990,2007,2922,2912,2908,4,10,6,4,133,132,1,583,581,2,345,344,1
"2021","Chelmsford 004","E02004488",7923,2624,4093,4080,4072,8,13,5,8,125,124,1,652,651,1,429,429,0
"2021","Chelmsford 005","E02004489",7460,2389,3945,3931,3916,15,14,4,10,151,150,1,622,621,1,353,353,0
"2021","Chelmsford 006","E02004490",6195,2576,2267,2255,2245,10,12,4,8,184,184,0,790,790,0,378,376,2
"2021","Chelmsford 007","E02004491",6027,1890,3258,3252,3245,7,6,6,0,73,73,0,486,486,0,320,320,0
"2021","Chelmsford 008","E02004492",7575,2891,3464,3454,3433,21,10,2,8,165,164,1,743,742,1,312,312,0
"2021","Chelmsford 009","E02004493",8364,3528,3545,3528,3511,17,17,8,9,146,144,2,717,717,0,428,428,0
"2021","Chelmsford 011","E02004495",7013,2045,3664,3655,3630,25,9,2,7,119,119,0,638,637,1,547,547,0
"2021","Chelmsford 012","E02004496",6530,2142,3347,3343,3316,27,4,0,4,116,114,2,522,522,0,403,403,0
"2021","Chelmsford 013","E02004497",6564,1763,3558,3554,3540,14,4,2,2,101,99,2,581,581,0,561,561,0
"2021","Chelmsford 014","E02004498",7975,2864,3574,3567,3547,20,7,4,3,185,183,2,880,878,2,472,471,1
"2021","Chelmsford 015","E02004499",5556,1730,2903,2895,2892,3,8,4,4,98,98,0,509,509,0,316,316,0
"2021","Chelmsford 016","E02004500",7614,1899,4465,4459,4447,12,6,2,4,124,123,1,630,629,1,496,496,0
"2021","Chelmsford 017","E02004501",5762,1750,3038,3032,3028,4,6,0,6,90,89,1,493,491,2,391,391,0
"2021","Chelmsford 018","E02004502",6183,1501,3570,3562,3553,9,8,4,4,112,112,0,570,570,0,430,430,0
"2021","Chelmsford 019","E02004503",6485,1942,3386,3383,3377,6,3,0,3,156,156,0,606,606,0,395,395,0
"2021","Chelmsford 020","E02004504",6577,2116,3380,3374,3370,4,6,2,4,112,112,0,623,622,1,346,346,0
"2021","Chelmsford 021","E02004505",5452,1471,2934,2924,2913,11,10,0,10,90,90,0,493,492,1,464,464,0
"2021","Chelmsford 022","E02006978",6322,3644,1752,1745,1726,19,7,3,4,126,125,1,527,523,4,273,272,1
"2021","Chelmsford 023","E02006979",5500,2982,1620,1608,1587,21,12,8,4,128,127,1,508,507,1,262,262,0
"2021","Colchester 001","E02004506",5878,1566,3324,3302,3281,21,22,5,17,106,106,0,483,481,2,399,398,1
"2021","Colchester 002","E02004507",7626,2949,3346,3336,3326,10,10,0,10,224,223,1,812,811,1,295,295,0
"2021","Colchester 003","E02004508",5431,1422,3072,3062,3055,7,10,0,10,104,102,2,497,494,3,336,336,0
"2021","Colchester 007","E02004512",9483,4282,3218,3184,3141,43,34,16,18,284,282,2,1104,1099,5,595,592,3
"2021","Colchester 008","E02004513",9553,6024,2171,2159,2147,12,12,3,9,185,183,2,806,805,1,367,367,0
"2021","Colchester 009","E02004514",4744,1408,2416,2408,2396,12,8,2,6,102,102,0,500,498,2,318,318,0
"2021","Colchester 010","E02004515",7758,2367,4163,4151,4125,26,12,6,6,129,126,3,672,671,1,427,427,0
"2021","Colchester 011","E02004516",10603,5693,3188,3171,3144,27,17,6,11,325,324,1,1083,1079,4,314,314,0
"2021","Colchester 012","E02004517",7743,2444,3751,3748,3724,24,3,2,1,139,139,0,801,801,0,608,608,0
"2021","Colchester 013","E02004518",6344,2412,2898,2890,2865,25,8,4,4,170,168,2,596,592,4,268,266,2
"2021","Colchester 014","E02004519",6250,1723,3349,3339,3322,17,10,0,10,85,85,0,597,597,0,496,496,0
"2021","Colchester 015","E02004520",7143,2683,3310,3292,3272,20,18,6,12,222,219,3,668,666,2,260,260,0
"2021","Colchester 016","E02004521",7672,3042,3091,3082,3065,17,9,5,4,216,214,2,905,903,2,418,417,1
"2021","Colchester 017","E02004522",7746,3286,3239,3214,3188,26,25,4,21,157,154,3,644,641,3,420,416,4
"2021","Colchester 018","E02004523",8124,3152,3397,3387,3370,17,10,6,4,231,231,0,934,933,1,410,410,0
"2021","Colchester 019","E02004524",6956,1738,4097,4093,4087,6,4,4,0,112,112,0,581,581,0,428,428,0
"2021","Colchester 020","E02004525",6810,1945,3469,3457,3449,8,12,10,2,123,123,0,663,661,2,610,610,0
"2021","Colchester 021","E02004526",6348,1470,3454,3443,3435,8,11,8,3,136,136,0,674,674,0,614,614,0
"2021","Colchester 022","E02006922",11707,4043,5443,5419,5400,19,24,6,18,253,252,1,1116,1113,3,852,850,2
"2021","Colchester 023","E02007056",6498,2517,3116,3104,3077,27,12,4,8,105,104,1,552,547,5,208,207,1
"2021","Colchester 024","E02007057",5932,2519,2543,2530,2511,19,13,1,12,162,162,0,528,526,2,180,180,0
"2021","Epping Forest 001","E02004527",7711,2658,3627,3614,3599,15,13,3,10,162,159,3,754,751,3,510,509,1
"2021","Epping Forest 002","E02004528",7446,2212,3997,3976,3951,25,21,7,14,120,120,0,564,564,0,553,553,0
"2021","Epping Forest 003","E02004529",6177,1875,3356,3350,3329,21,6,2,4,110,110,0,493,492,1,343,343,0
"2021","Epping Forest 004","E02004530",5656,1861,2801,2795,2789,6,6,4,2,94,94,0,461,458,3,439,439,0
"2021","Epping Forest 005","E02004531",5765,1913,2782,2767,2742,25,15,2,13,111,111,0,538,536,2,421,421,0
"2021","Epping Forest 006","E02004532",5309,1867,2473,2465,2451,14,8,2,6,111,110,1,499,499,0,359,358,1
"2021","Epping Forest 007","E02004533",6239,2419,2587,2576,2567,9,11,2,9,166,163,3,583,582,1,484,484,0
"2021","Epping Forest 008","E02004534",7190,2902,3044,3023,3009,14,21,10,11,176,176,0,686,686,0,382,382,0
"2021","Epping Forest 009","E02004535",5113,1954,2011,2007,1995,12,4,0,4,147,147,0,631,630,1,370,369,1
"2021","Epping Forest 010","E02004536",5192,1599,2676,2673,2664,9,3,2,1,81,81,0,404,404,0,432,432,0
"2021","Epping Forest 011","E02004537",7573,3396,2852,2845,2836,9,7,2,5,183,182,1,787,787,0,355,355,0
"2021","Epping Forest 012","E02004538",8072,2758,4151,4132,4115,17,19,12,7,119,119,0,559,559,0,485,485,0
"2021","Epping Forest 013","E02004539",6380,2547,2790,2780,2772,8,10,2,8,128,128,0,577,575,2,338,338,0
"2021","Epping Forest 014","E02004540",4896,1622,2516,2510,2492,18,6,2,4,93,92,1,381,379,2,284,283,1
"2021","Epping Forest 015","E02004541",9503,3338,4602,4583,4549,34,19,6,13,173,173,0,822,818,4,568,566,2
"2021","Epping Forest 016","E02004542",5722,1669,3243,3233,3225,8,10,2,8,88,87,1,392,391,1,330,330,0
"2021","Epping Forest 017","E02004543",5987,2004,3080,3078,3070,8,2,2,0,104,102,2,434,434,0,365,365,0
"2021","Harlow 001","E02004544",8792,3386,3857,3836,3805,31,21,10,11,198,196,2,919,919,0,432,432,0
"2021","Harlow 002","E02004545",6196,2613,2341,2324,2312,12,17,12,5,184,184,0,697,697,0,361,361,0
"2021","Harlow 003","E02004546",6651,2851,2544,2533,2522,11,11,2,9,154,152,2,718,717,1,384,384,0
"2021","Harlow 004","E02004547",7757,3217,3236,3230,3215,15,6,0,6,210,210,0,692,690,2,402,402,0
"2021","Harlow 005","E02004548",7035,2585,3374,3358,3344,14,16,8,8,138,137,1,661,660,1,277,276,1
"2021","Harlow 006","E02004549",6342,2489,2607,2605,2589,16,2,2,0,139,138,1,684,683,1,423,423,0
"2021","Harlow 007","E02004550",6874,2790,2720,2704,2688,16,16,12,4,174,174,0,732,732,0,458,458,0
"2021","Harlow 008","E02004551",5981,2331,2418,2410,2393,17,8,2,6,148,148,0,685,685,0,399,399,0
"2021","Harlow 009","E02004552",5376,1809,2568,2561,2553,8,7,2,5,113,113,0,561,558,3,325,325,0
"2021","Harlow 010","E02004553",6013,2466,2457,2450,2429,21,7,4,3,142,142,0,587,586,1,361,361,0
"2021","Harlow 011","E02004554",6079,2390,2554,2547,2537,10,7,4,3,148,145,3,663,663,0,324,324,0
"2021","Maldon 001","E02004555",5487,1459,3039,3033,3022,11,6,4,2,85,85,0,518,517,1,386,386,0
"2021","Maldon 002","E02004556",6310,1463,3824,3809,3799,10,15,2,13,94,94,0,484,484,0,445,442,3
"2021","Maldon 003","E02004557",7283,2394,3479,3465,3452,13,14,5,9,135,135,0,816,815,1,459,459,0
"2021","Maldon 004","E02004558",5815,1963,2362,2359,2349,10,3,0,3,172,169,3,748,748,0,570,570,0
"2021","Maldon 005","E02004559",6763,2016,3496,3494,3481,13,2,2,0,123,122,1,649,646,3,479,479,0
"2021","Maldon 006","E02004560",7525,2333,3722,3717,3699,18,5,0,5,160,158,2,753,753,0,557,556,1
"2021","Maldon 007","E02004561",8843,2328,5031,5014,4997,17,17,6,11,139,139,0,780,780,0,565,565,0
"2021","Maldon 008","E02004562",7402,2150,3760,3743,3728,15,17,4,13,179,178,1,776,773,3,537,536,1
"2021","Rochford 001","E02004563",5697,1426,3139,3127,3115,12,12,2,10,92,91,1,537,537,0,503,503,0
"2021","Rochford 002","E02004564",6646,1788,3681,3671,3664,7,10,4,6,95,93,2,563,563,0,519,519,0
"2021","Rochford 004","E02004566",4541,1802,1754,1753,1744,9,1,0,1,134,134,0,532,532,0,319,319,0
"2021","Rochford 005","E02004567",6811,1832,3782,3773,3753,20,9,0,9,112,112,0,551,551,0,534,534,0
"2021","Rochford 006","E02004568",7070,2505,3338,3328,3318,10,10,4,6,128,127,1,709,709,0,390,390,0
"2021","Rochford 007","E02004569",7026,2554,3073,3055,3040,15,18,2,16,164,163,1,739,738,1,496,495,1
"2021","Rochford 008","E02004570",7138,2062,3651,3642,3632,10,9,6,3,155,155,0,670,670,0,600,600,0
"2021","Rochford 009","E02004571",6439,1658,3736,3727,3724,3,9,2,7,88,88,0,477,477,0,480,480,0
"2021","Rochford 010","E02004572",6522,2120,3165,3155,3142,13,10,6,4,129,129,0,665,665,0,443,443,0
"2021","Rochford 011","E02006980",6247,1676,3628,3618,3612,6,10,4,6,70,70,0,454,454,0,419,419,0
"2021","Rochford 012","E02006981",6572,1910,3486,3479,3473,6,7,4,3,132,130,2,554,554,0,490,490,0
"2021","Tendring 001","E02004573",5239,2104,1844,1834,1816,18,10,0,10,260,259,1,687,687,0,344,343,1
"2021","Tendring 002","E02004574",6197,2281,2559,2553,2544,9,6,4,2,180,179,1,707,706,1,470,470,0
"2021","Tendring 003","E02004575",10133,3196,4978,4948,4926,22,30,9,21,178,178,0,1035,1034,1,746,746,0
"2021","Tendring 004","E02004576",7726,2090,4134,4116,4088,28,18,4,14,149,149,0,700,699,1,653,653,0
"2021","Tendring 005","E02004577",5062,1429,2802,2793,2776,17,9,2,7,84,84,0,448,447,1,299,299,0
"2021","Tendring 006","E02004578",6582,1800,3090,3078,3061,17,12,0,12,139,136,3,785,784,1,768,768,0
"2021","Tendring 007","E02004579",6758,1807,3512,3500,3489,11,12,4,8,139,139,0,738,737,1,562,560,2
"2021","Tendring 008","E02004580",10766,2483,5751,5740,5719,21,11,8,3,211,210,1,1132,1132,0,1189,1189,0
"2021","Tendring 009","E02004581",7139,1935,3916,3906,3882,24,10,4,6,114,113,1,620,620,0,554,554,0
"2021","Tendring 010","E02004582",6076,1675,2888,2866,2849,17,22,8,14,100,100,0,748,747,1,665,662,3
"2021","Tendring 011","E02004583",7495,2191,3565,3558,3541,17,7,2,5,169,167,2,958,956,2,612,611,1
"2021","Tendring 012","E02004584",5980,1279,3169,3160,3142,18,9,3,6,115,113,2,625,624,1,792,792,0
"2021","Tendring 013","E02004585",7449,2506,3402,3395,3385,10,7,0,7,153,153,0,779,779,0,609,608,1
"2021","Tendring 014","E02004586",6899,2243,2920,2908,2893,15,12,6,6,173,173,0,871,871,0,692,691,1
"2021","Tendring 015","E02004587",6151,2396,2302,2296,2284,12,6,0,6,171,170,1,776,774,2,506,505,1
"2021","Tendring 016","E02004588",5845,2708,1468,1461,1449,12,7,4,3,215,211,4,897,894,3,557,556,1
"2021","Tendring 017","E02004589",6123,2175,2432,2422,2403,19,10,3,7,160,160,0,746,744,2,610,607,3
"2021","Tendring 018","E02004590",7274,2146,2924,2902,2889,13,22,6,16,322,322,0,1005,1002,3,877,875,2
"2021","Uttlesford 001","E02004591",6147,1676,3471,3456,3450,6,15,6,9,123,123,0,519,519,0,358,358,0
"2021","Uttlesford 002","E02004592",10601,3336,5036,4995,4984,11,41,16,25,245,244,1,1174,1171,3,810,810,0
"2021","Uttlesford 003","E02004593",7346,1876,4330,4312,4306,6,18,4,14,135,132,3,578,576,2,427,427,0
"2021","Uttlesford 004","E02004594",6768,1826,3802,3788,3768,20,14,4,10,134,133,1,585,585,0,421,420,1
"2021","Uttlesford 005","E02004595",11895,3552,6313,6302,6272,30,11,7,4,249,249,0,1111,1107,4,670,669,1
"2021","Uttlesford 006","E02004596",8266,2666,4246,4232,4206,26,14,4,10,144,143,1,793,790,3,417,417,0
"2021","Uttlesford 007","E02004597",7272,2370,3546,3534,3526,8,12,6,6,172,172,0,767,766,1,417,417,0
"2021","Uttlesford 008","E02004598",8862,2556,4843,4831,4812,19,12,1,11,182,181,1,709,708,1,572,572,0
"2021","Uttlesford 009","E02004599",6360,1775,3553,3547,3536,11,6,4,2,124,120,4,508,507,1,400,400,0
"2021","Broxbourne 001","E02004843",5869,1822,3085,3077,3073,4,8,6,2,110,109,1,480,479,1,372,372,0
"2021","Broxbourne 002","E02004844",5964,2374,2548,2536,2528,8,12,2,10,167,167,0,542,542,0,333,333,0
"2021","Broxbourne 003","E02004845",6448,2463,2650,2633,2620,13,17,10,7,151,150,1,730,729,1,454,454,0
"2021","Broxbourne 004","E02004846",5254,1491,3014,3004,2997,7,10,3,7,77,77,0,311,311,0,361,361,0
"2021","Broxbourne 005","E02004847",7992,3188,3345,3333,3324,9,12,6,6,225,225,0,846,846,0,388,388,0
"2021","Broxbourne 006","E02004848",6135,2240,2972,2966,2964,2,6,4,2,110,109,1,487,487,0,326,326,0
"2021","Broxbourne 007","E02004849",5647,1734,3162,3156,3150,6,6,6,0,64,64,0,365,365,0,322,322,0
"2021","Broxbourne 008","E02004850",6015,2201,2732,2722,2708,14,10,4,6,138,138,0,556,555,1,388,388,0
"2021","Broxbourne 009","E02004851",4757,1788,2062,2058,2054,4,4,0,4,104,103,1,470,469,1,333,333,0
"2021","Broxbourne 010","E02004852",6451,2502,2774,2768,2762,6,6,4,2,151,151,0,563,562,1,461,461,0
"2021","Broxbourne 011","E02004853",5553,2090,2419,2410,2402,8,9,4,5,120,120,0,537,537,0,387,387,0
"2021","Broxbourne 012","E02004854",6579,2545,2867,2860,2847,13,7,2,5,151,151,0,534,534,0,482,481,1
"2021","Broxbourne 013","E02004855",6767,3077,2440,2415,2406,9,25,12,13,203,203,0,699,699,0,348,348,0
"2021","Dacorum 001","E02004856",4664,1510,2332,2325,2317,8,7,2,5,108,108,0,487,486,1,227,227,0
"2021","Dacorum 002","E02004857",4922,1560,2501,2482,2468,14,19,4,15,112,111,1,413,413,0,336,336,0
"2021","Dacorum 003","E02004858",4008,1349,1950,1943,1935,8,7,2,5,71,71,0,401,399,2,237,237,0
"2021","Dacorum 004","E02004859",4324,1103,2466,2462,2458,4,4,2,2,76,76,0,390,388,2,289,288,1
"2021","Dacorum 005","E02004860",4538,1756,2025,2013,2008,5,12,6,6,150,149,1,441,439,2,166,165,1
"2021","Dacorum 006","E02004861",4568,1063,2635,2628,2611,17,7,1,6,64,64,0,420,419,1,386,386,0
"2021","Dacorum 007","E02004862",6086,2276,2666,2655,2646,9,11,6,5,174,174,0,670,667,3,300,300,0
"2021","Dacorum 008","E02004863",6080,2412,2386,2372,2355,17,14,8,6,209,208,1,651,648,3,422,422,0
"2021","Dacorum 009","E02004864",5239,1487,2858,2836,2828,8,22,4,18,98,98,0,463,463,0,333,332,1
"2021","Dacorum 010","E02004865",4474,1745,1871,1859,1852,7,12,6,6,97,97,0,522,521,1,239,237,2
"2021","Dacorum 011","E02004866",5349,1912,2366,2360,2353,7,6,2,4,161,160,1,580,579,1,330,330,0
"2021","Dacorum 012","E02004867",4991,1372,2815,2813,2802,11,2,0,2,71,71,0,447,447,0,286,284,2
"2021","Dacorum 013","E02004868",5895,2267,2579,2572,2564,8,7,4,3,159,159,0,525,524,1,365,365,0
"2021","Dacorum 014","E02004869",4625,1430,2458,2448,2438,10,10,4,6,84,83,1,364,364,0,289,289,0
"2021","Dacorum 015","E02004870",9271,3885,3728,3712,3700,12,16,6,10,225,222,3,931,929,2,502,500,2
"2021","Dacorum 016","E02004871",4012,1494,1823,1812,1804,8,11,2,9,62,62,0,394,394,0,239,239,0
"2021","Dacorum 017","E02004872",5976,1789,3214,3208,3194,14,6,2,4,124,124,0,474,471,3,375,375,0
"2021","Dacorum 018","E02004873",9476,3549,4383,4369,4347,22,14,4,10,262,260,2,876,874,2,406,406,0
"2021","Dacorum 019","E02004874",4846,1752,2290,2288,2274,14,2,2,0,111,111,0,423,423,0,270,270,0
"2021","Dacorum 020","E02004875",8127,3134,3598,3584,3574,10,14,10,4,191,191,0,756,754,2,448,448,0
"2021","Dacorum 021","E02004876",7974,2724,3974,3956,3927,29,18,10,8,154,154,0,684,679,5,438,438,0
"2021","Dacorum 022","E02004877",4339,1265,2275,2267,2262,5,8,0,8,84,84,0,391,391,0,324,324,0
"2021","Hertsmere 001","E02004896",6836,2139,3450,3443,3438,5,7,4,3,113,113,0,532,532,0,602,602,0
"2021","Hertsmere 002","E02004897",5482,1791,2802,2795,2788,7,7,4,3,86,86,0,429,429,0,374,374,0
"2021","Hertsmere 003","E02004898",6302,2418,2710,2699,2685,14,11,7,4,114,114,0,619,619,0,441,441,0
"2021","Hertsmere 004","E02004899",4305,1384,2247,2241,2231,10,6,2,4,83,83,0,367,367,0,224,224,0
"2021","Hertsmere 005","E02004900",6612,1749,3938,3927,3914,13,11,2,9,107,106,1,431,431,0,387,386,1
"2021","Hertsmere 006","E02004901",7956,3260,3312,3304,3291,13,8,2,6,188,187,1,771,767,4,425,425,0
"2021","Hertsmere 007","E02004902",6247,2299,2894,2890,2875,15,4,4,0,151,150,1,602,601,1,301,301,0
"2021","Hertsmere 008","E02004903",5918,2141,2886,2875,2860,15,11,3,8,122,122,0,461,460,1,308,307,1
"2021","Hertsmere 009","E02004904",5467,2246,2294,2290,2278,12,4,2,2,135,134,1,539,537,2,253,253,0
"2021","Hertsmere 010","E02004905",5255,1513,2972,2969,2964,5,3,3,0,88,88,0,374,374,0,308,307,1
"2021","Hertsmere 011","E02004906",8605,3182,4118,4094,4085,9,24,6,18,153,153,0,766,764,2,386,385,1
"2021","Hertsmere 012","E02004907",8639,2869,4312,4295,4273,22,17,5,12,168,168,0,764,763,1,526,526,0
"2021","Hertsmere 013","E02004908",8565,2118,4998,4986,4976,10,12,4,8,113,113,0,645,645,0,691,691,0
"2021","North Hertfordshire 001","E02004909",4699,1742,2156,2146,2138,8,10,5,5,106,106,0,430,429,1,265,265,0
"2021","North Hertfordshire 002","E02004910",9365,2858,5102,5085,5065,20,17,10,7,159,159,0,716,715,1,530,530,0
"2021","North Hertfordshire 003","E02004911",5464,2009,2419,2411,2387,24,8,4,4,120,119,1,540,538,2,376,376,0
"2021","North Hertfordshire 004","E02004912",8737,3134,3864,3855,3835,20,9,4,5,218,218,0,904,902,2,617,617,0
"2021","North Hertfordshire 006","E02004914",6413,2528,2767,2757,2747,10,10,4,6,157,157,0,597,593,4,364,364,0
"2021","North Hertfordshire 007","E02004915",4542,1768,1894,1888,1874,14,6,2,4,124,124,0,483,483,0,273,273,0
"2021","North Hertfordshire 008","E02004916",6055,1781,3208,3192,3184,8,16,6,10,116,116,0,500,497,3,450,450,0
"2021","North Hertfordshire 009","E02004917",5256,1767,2495,2491,2481,10,4,0,4,98,97,1,510,509,1,386,386,0
"2021","North Hertfordshire 010","E02004918",6631,2795,2826,2811,2784,27,15,10,5,163,162,1,565,562,3,282,282,0
"2021","North Hertfordshire 011","E02004919",6131,2235,2946,2928,2916,12,18,6,12,118,117,1,518,517,1,314,314,0
"2021","North Hertfordshire 012","E02004920",9351,3333,4255,4232,4200,32,23,6,17,202,201,1,800,797,3,761,760,1
"2021","North Hertfordshire 013","E02004921",6260,1945,3305,3294,3281,13,11,8,3,137,136,1,471,470,1,402,400,2
"2021","North Hertfordshire 014","E02004922",8236,2434,4359,4336,4321,15,23,8,15,156,154,2,777,773,4,510,510,0
"2021","North Hertfordshire 015","E02004923",8528,2486,4562,4549,4526,23,13,8,5,151,150,1,718,713,5,611,610,1
"2021","North Hertfordshire 016","E02007088",6331,1670,3592,3582,3559,23,10,6,4,124,123,1,542,539,3,403,403,0
"2021","North Hertfordshire 017","E02007089",5742,2036,2814,2808,2786,22,6,2,4,127,126,1,508,505,3,257,256,1
"2021","Three Rivers 001","E02004956",7410,2614,3521,3513,3502,11,8,0,8,153,153,0,661,655,6,461,460,1
"2021","Three Rivers 002","E02004957",8315,2999,3981,3966,3948,18,15,5,10,167,165,2,787,786,1,381,381,0
"2021","Three Rivers 003","E02004958",6306,1791,3557,3551,3543,8,6,2,4,85,85,0,495,494,1,378,378,0
"2021","Three Rivers 004","E02004959",5149,1409,2954,2945,2933,12,9,6,3,79,79,0,282,281,1,425,425,0
"2021","Three Rivers 005","E02004960",4556,1211,2738,2728,2723,5,10,6,4,49,49,0,281,280,1,277,277,0
"2021","Three Rivers 006","E02004961",7688,2208,4239,4229,4206,23,10,4,6,126,126,0,640,639,1,475,475,0
"2021","Three Rivers 007","E02004962",7225,2554,3596,3592,3577,15,4,2,2,124,122,2,587,587,0,364,364,0
"2021","Three Rivers 008","E02004963",5889,2046,2924,2913,2908,5,11,8,3,117,117,0,510,509,1,292,292,0
"2021","Three Rivers 009","E02004964",4507,1681,2025,2010,2005,5,15,3,12,111,110,1,435,433,2,255,255,0
"2021","Three Rivers 010","E02004965",5647,1665,3011,3009,3006,3,2,2,0,82,82,0,438,438,0,451,450,1
"2021","Three Rivers 011","E02004966",6139,1556,3811,3803,3788,15,8,4,4,91,91,0,290,290,0,391,391,0
"2021","Three Rivers 012","E02004967",6170,2551,2654,2650,2639,11,4,4,0,142,138,4,544,543,1,279,279,0
"2021","Watford 001","E02004968",6002,2262,2694,2688,2681,7,6,6,0,133,133,0,563,560,3,350,350,0
"2021","Watford 002","E02004969",5773,1965,2940,2937,2930,7,3,2,1,128,128,0,425,423,2,315,315,0
"2021","Watford 003","E02004970",6519,2488,2917,2913,2903,10,4,2,2,144,144,0,532,532,0,438,438,0
"2021","Watford 004","E02004971",6677,2569,3152,3139,3125,14,13,10,3,141,141,0,498,497,1,317,317,0
"2021","Watford 005","E02004972",4989,1581,2776,2766,2761,5,10,4,6,81,81,0,290,289,1,261,261,0
"2021","Watford 006","E02004973",6848,3005,2934,2905,2882,23,29,22,7,151,151,0,576,576,0,182,181,1
"2021","Watford 007","E02004974",7318,2441,3770,3755,3731,24,15,13,2,121,119,2,531,529,2,455,455,0
"2021","Watford 008","E02004975",6536,1940,3817,3810,3799,11,7,4,3,96,96,0,328,328,0,355,354,1
"2021","Watford 009","E02004976",9347,4562,3444,3415,3379,36,29,7,22,256,254,2,798,794,4,287,287,0
"2021","Watford 010","E02004977",7134,2823,3468,3457,3434,23,11,9,2,136,136,0,486,486,0,221,221,0
"2021","Watford 011","E02004978",7984,3233,3620,3615,3603,12,5,3,2,219,217,2,570,568,2,342,342,0
"2021","Watford 012","E02004979",5831,2099,2829,2814,2793,21,15,6,9,146,146,0,496,493,3,261,261,0
"2021","Breckland 001","E02005503",6258,1688,3385,3360,3346,14,25,4,21,106,106,0,599,599,0,480,480,0
"2021","Breckland 002","E02005504",7851,1948,4396,4371,4346,25,25,8,17,158,156,2,748,747,1,601,599,2
"2021","Breckland 003","E02005505",6309,1911,3110,3096,3080,16,14,0,14,154,153,1,616,616,0,518,518,0
"2021","Breckland 004","E02005506",5913,1571,3173,3163,3156,7,10,2,8,109,109,0,625,625,0,435,435,0
"2021","Breckland 005","E02005507",9595,3293,4179,4161,4155,6,18,3,15,254,253,1,1170,1170,0,699,699,0
"2021","Breckland 006","E02005508",6175,1605,3410,3387,3374,13,23,6,17,108,108,0,618,617,1,434,434,0
"2021","Breckland 007","E02005509",7255,2009,3512,3497,3480,17,15,0,15,162,162,0,816,814,2,756,755,1
"2021","Breckland 008","E02005510",6321,1527,3448,3436,3419,17,12,2,10,129,128,1,676,676,0,541,541,0
"2021","Breckland 009","E02005511",7652,2211,3769,3750,3735,15,19,4,15,144,142,2,865,865,0,663,661,2
"2021","Breckland 010","E02005512",8474,3014,4031,4008,3984,24,23,4,19,191,191,0,837,836,1,401,401,0
"2021","Breckland 011","E02005513",8776,2862,4049,4042,4022,20,7,1,6,225,224,1,955,954,1,685,685,0
"2021","Breckland 012","E02005514",5815,1458,3181,3167,3148,19,14,4,10,120,120,0,638,636,2,418,415,3
"2021","Breckland 013","E02005515",5407,1484,2925,2907,2888,19,18,10,8,105,103,2,528,524,4,365,365,0
"2021","Breckland 014","E02005516",5917,1594,3256,3233,3223,10,23,9,14,124,122,2,556,556,0,387,384,3
"2021","Breckland 015","E02005517",4559,1933,1635,1624,1618,6,11,8,3,156,153,3,620,620,0,215,215,0
"2021","Breckland 016","E02005518",8834,3089,3991,3972,3951,21,19,4,15,217,215,2,998,997,1,539,539,0
"2021","Breckland 017","E02005519",6745,2649,2721,2704,2697,7,17,11,6,195,194,1,770,767,3,410,410,0
"2021","Broadland 001","E02005520",7472,2004,3848,3830,3813,17,18,4,14,166,165,1,810,808,2,644,644,0
"2021","Broadland 002","E02005521",7322,2045,3778,3771,3761,10,7,4,3,164,163,1,839,835,4,496,495,1
"2021","Broadland 003","E02005522",4655,1267,2496,2486,2466,20,10,6,4,84,84,0,502,501,1,306,305,1
"2021","Broadland 004","E02005523",7031,2195,3631,3616,3599,17,15,6,9,120,120,0,707,704,3,378,378,0
"2021","Broadland 005","E02005524",4523,1192,2457,2450,2437,13,7,0,7,86,86,0,432,431,1,356,356,0
"2021","Broadland 006","E02005525",8192,2340,4352,4344,4313,31,8,2,6,157,155,2,786,784,2,557,557,0
"2021","Broadland 007","E02005526",4475,1255,2299,2292,2279,13,7,4,3,88,88,0,461,460,1,372,369,3
"2021","Broadland 008","E02005527",7559,2065,4124,4114,4090,24,10,2,8,133,130,3,745,742,3,492,490,2
"2021","Broadland 009","E02005528",7143,2130,3630,3612,3589,23,18,8,10,147,146,1,732,731,1,504,504,0
"2021","Broadland 010","E02005529",4898,1276,2520,2515,2509,6,5,0,5,87,86,1,499,499,0,516,516,0
"2021","Broadland 011","E02005530",4591,1312,2346,2335,2329,6,11,2,9,74,74,0,448,447,1,411,410,1
"2021","Broadland 012","E02005531",4477,1435,2177,2169,2164,5,8,4,4,89,89,0,467,463,4,309,309,0
"2021","Broadland 013","E02005532",7976,2622,3902,3895,3873,22,7,4,3,143,142,1,723,721,2,586,586,0
"2021","Broadland 014","E02005533",7594,1949,4189,4170,4159,11,19,4,15,164,163,1,736,736,0,556,555,1
"2021","Broadland 015","E02005534",6271,1797,3215,3209,3195,14,6,2,4,100,100,0,662,662,0,497,497,0
"2021","Broadland 016","E02005535",5935,1982,2806,2788,2760,28,18,4,14,127,127,0,661,660,1,359,358,1
"2021","Broadland 017","E02005536",5275,1325,2857,2847,2827,20,10,0,10,105,105,0,585,585,0,403,403,0
"2021","Broadland 018","E02005537",5120,1465,2549,2539,2531,8,10,4,6,107,107,0,563,563,0,436,434,2
"2021","Great Yarmouth 001","E02005538",8490,2295,4419,4398,4385,13,21,6,15,139,138,1,899,896,3,738,737,1
"2021","Great Yarmouth 002","E02005539",6811,1904,3636,3628,3621,7,8,4,4,112,112,0,644,638,6,515,515,0
"2021","Great Yarmouth 003","E02005540",7672,2106,3697,3683,3663,20,14,8,6,134,134,0,948,947,1,787,787,0
"2021","Great Yarmouth 004","E02005541",4847,1769,1956,1933,1923,10,23,12,11,132,131,1,641,640,1,349,349,0
"2021","Great Yarmouth 005","E02005542",5789,2814,1625,1602,1589,13,23,8,15,181,180,1,860,860,0,309,309,0
"2021","Great Yarmouth 006","E02005543",7265,3760,1768,1736,1733,3,32,18,14,280,276,4,1063,1062,1,394,394,0
"2021","Great Yarmouth 007","E02005544",5599,2562,1794,1774,1761,13,20,4,16,196,192,4,768,764,4,279,279,0
"2021","Great Yarmouth 008","E02005545",5479,1506,2980,2966,2956,10,14,6,8,63,63,0,527,525,2,403,403,0
"2021","Great Yarmouth 009","E02005546",6463,2687,2226,2211,2201,10,15,6,9,212,212,0,877,877,0,461,461,0
"2021","Great Yarmouth 010","E02005547",7139,2406,3175,3154,3136,18,21,8,13,168,164,4,843,842,1,547,544,3
"2021","Great Yarmouth 011","E02005548",5915,2158,2487,2474,2456,18,13,0,13,122,118,4,628,627,1,520,519,1
"2021","Great Yarmouth 012","E02005549",4809,1348,2454,2448,2439,9,6,2,4,98,98,0,550,550,0,359,359,0
"2021","Great Yarmouth 013","E02005550",6436,2044,3039,3030,3012,18,9,4,5,117,117,0,695,694,1,541,540,1
"2021","King's Lynn and West Norfolk 001","E02005551",4728,1118,2306,2290,2278,12,16,0,16,103,103,0,575,573,2,626,625,1
"2021","King's Lynn and West Norfolk 002","E02005552",5725,1472,3024,2996,2979,17,28,2,26,132,132,0,567,567,0,530,529,1
"2021","King's Lynn and West Norfolk 003","E02005553",7755,1745,4162,4149,4136,13,13,2,11,132,131,1,874,873,1,842,841,1
"2021","King's Lynn and West Norfolk 004","E02005554",6116,1487,3203,3195,3183,12,8,2,6,109,109,0,701,701,0,616,616,0
"2021","King's Lynn and West Norfolk 005","E02005555",5768,1352,3394,3387,3379,8,7,5,2,82,81,1,485,483,2,455,454,1
"2021","King's Lynn and West Norfolk 006","E02005556",6411,2059,3087,3079,3067,12,8,2,6,118,118,0,659,658,1,488,488,0
"2021","King's Lynn and West Norfolk 007","E02005557",5254,2334,1815,1789,1780,9,26,10,16,156,155,1,639,639,0,310,310,0
"2021","King's Lynn and West Norfolk 008","E02005558",6175,1730,3238,3222,3214,8,16,2,14,97,95,2,593,593,0,517,516,1
"2021","King's Lynn and West Norfolk 009","E02005559",5975,2191,2486,2468,2454,14,18,12,6,138,135,3,739,739,0,421,421,0
"2021","King's Lynn and West Norfolk 010","E02005560",7039,2733,3033,3015,3001,14,18,6,12,177,175,2,769,769,0,327,327,0
"2021","King's Lynn and West Norfolk 011","E02005561",8869,4045,2743,2722,2700,22,21,8,13,286,280,6,1229,1226,3,566,565,1
"2021","King's Lynn and West Norfolk 012","E02005562",6320,1735,3311,3294,3280,14,17,0,17,115,113,2,676,676,0,483,480,3
"2021","King's Lynn and West Norfolk 013","E02005563",6727,1994,3390,3376,3360,16,14,6,8,139,136,3,697,696,1,507,506,1
"2021","King's Lynn and West Norfolk 014","E02005564",8102,2338,4374,4361,4348,13,13,6,7,163,161,2,660,659,1,567,567,0
"2021","King's Lynn and West Norfolk 015","E02005565",6148,1934,3066,3058,3047,11,8,2,6,132,129,3,604,604,0,412,412,0
"2021","King's Lynn and West Norfolk 016","E02005566",8707,2618,4440,4421,4404,17,19,2,17,187,187,0,849,847,2,613,612,1
"2021","King's Lynn and West Norfolk 017","E02005567",9502,2736,4505,4487,4469,18,18,8,10,216,215,1,1023,1023,0,1022,1021,1
"2021","King's Lynn and West Norfolk 018","E02005568",6445,1645,3570,3561,3538,23,9,6,3,131,128,3,608,607,1,491,491,0
"2021","King's Lynn and West Norfolk 019","E02005569",7133,2074,3804,3787,3767,20,17,3,14,151,151,0,631,631,0,473,472,1
"2021","North Norfolk 001","E02005570",6230,1519,3277,3237,3223,14,40,2,38,110,110,0,643,643,0,681,681,0
"2021","North Norfolk 002","E02005571",5100,1296,2646,2626,2614,12,20,6,14,105,102,3,548,544,4,505,504,1
"2021","North Norfolk 003","E02005572",6628,2001,2915,2897,2878,19,18,0,18,157,156,1,873,873,0,682,682,0
"2021","North Norfolk 004","E02005573",4999,1221,2576,2554,2541,13,22,0,22,91,91,0,516,516,0,595,594,1
"2021","North Norfolk 005","E02005574",6118,1448,3366,3345,3324,21,21,4,17,124,124,0,665,665,0,515,513,2
"2021","North Norfolk 006","E02005575",6080,1581,3365,3342,3321,21,23,6,17,113,113,0,553,552,1,468,468,0
"2021","North Norfolk 007","E02005576",5797,1382,3060,3045,3028,17,15,0,15,129,128,1,707,707,0,519,518,1
"2021","North Norfolk 008","E02005577",5127,1453,2661,2637,2625,12,24,2,22,95,95,0,535,535,0,383,383,0
"2021","North Norfolk 009","E02005578",4991,1508,2436,2427,2414,13,9,2,7,110,109,1,600,598,2,337,334,3
"2021","North Norfolk 011","E02005580",6782,2068,3112,3099,3075,24,13,2,11,142,141,1,811,810,1,649,647,2
"2021","North Norfolk 012","E02005581",6761,1974,3376,3346,3322,24,30,2,28,204,204,0,812,809,3,395,394,1
"2021","North Norfolk 013","E02005582",5861,1705,2773,2765,2746,19,8,0,8,199,199,0,648,647,1,536,535,1
"2021","North Norfolk 014","E02005583",7633,1715,4231,4208,4188,20,23,4,19,136,135,1,747,745,2,804,802,2
"2021","North Norfolk 015","E02007032",5784,1715,2644,2625,2613,12,19,0,19,138,138,0,692,692,0,595,595,0
"2021","North Norfolk 016","E02007033",5252,1620,2293,2278,2257,21,15,4,11,127,126,1,703,702,1,509,507,2
"2021","Norwich 001","E02005584",8936,3965,3235,3215,3199,16,20,8,12,271,270,1,1055,1054,1,410,409,1
"2021","Norwich 002","E02005585",8852,4405,2758,2737,2711,26,21,3,18,274,273,1,1035,1031,4,380,378,2
"2021","Norwich 003","E02005586",8759,4883,2443,2410,2379,31,33,10,23,222,220,2,934,933,1,277,277,0
"2021","Norwich 004","E02005587",8283,3581,3023,2995,2966,29,28,6,22,209,209,0,932,932,0,538,536,2
"2021","Norwich 005","E02005588",10504,5464,3350,3323,3297,26,27,14,13,228,226,2,962,955,7,500,499,1
"2021","Norwich 006","E02005589",9773,5300,2937,2919,2895,24,18,10,8,238,235,3,888,886,2,410,410,0
"2021","Norwich 009","E02005592",7938,4409,2501,2474,2450,24,27,10,17,163,163,0,652,649,3,213,212,1
"2021","Norwich 010","E02005593",9578,6870,1719,1709,1689,20,10,6,4,115,115,0,522,521,1,352,350,2
"2021","Norwich 011","E02005594",9554,4779,2891,2855,2821,34,36,8,28,233,230,3,1112,1105,7,539,537,2
"2021","Norwich 012","E02005595",7954,2627,3933,3910,3878,32,23,6,17,100,98,2,665,663,2,629,628,1
"2021","Norwich 013","E02005596",7952,3644,2640,2623,2594,29,17,0,17,215,214,1,952,950,2,501,501,0
"2021","Norwich 014","E02006907",6528,3817,1514,1495,1471,24,19,2,17,187,185,2,749,745,4,261,260,1
"2021","Norwich 015","E02006908",4802,2515,1335,1321,1302,19,14,0,14,161,161,0,602,602,0,189,189,0
"2021","Norwich 016","E02007052",5617,3111,1200,1186,1172,14,14,10,4,182,178,4,811,802,9,313,313,0
"2021","Norwich 017","E02007053",5734,3947,949,930,905,25,19,2,17,122,121,1,533,530,3,183,183,0
"2021","South Norfolk 002","E02005598",8014,2267,4409,4390,4361,29,19,8,11,137,137,0,725,723,2,476,475,1
"2021","South Norfolk 003","E02005599",5802,1691,3012,2999,2986,13,13,6,7,111,111,0,599,598,1,389,389,0
"2021","South Norfolk 004","E02005600",5136,1484,2728,2707,2683,24,21,2,19,98,98,0,456,454,2,370,366,4
"2021","South Norfolk 005","E02005601",4753,1322,2256,2248,2233,15,8,2,6,122,122,0,558,558,0,495,494,1
"2021","South Norfolk 006","E02005602",10533,2886,5636,5601,5568,33,35,8,27,193,189,4,1087,1085,2,731,728,3
"2021","South Norfolk 007","E02005603",9983,3191,4990,4970,4939,31,20,8,12,255,253,2,1016,1013,3,531,531,0
"2021","South Norfolk 008","E02005604",7465,2120,3934,3914,3892,22,20,0,20,127,126,1,722,721,1,562,561,1
"2021","South Norfolk 009","E02005605",8802,2333,4928,4912,4890,22,16,2,14,138,138,0,837,837,0,566,566,0
"2021","South Norfolk 010","E02005606",4998,1380,2707,2702,2685,17,5,0,5,86,86,0,515,512,3,310,309,1
"2021","South Norfolk 011","E02005607",9591,2659,5191,5176,5136,40,15,2,13,204,203,1,914,912,2,623,616,7
"2021","South Norfolk 012","E02005608",6559,1755,3557,3549,3534,15,8,0,8,107,107,0,644,643,1,496,495,1
"2021","South Norfolk 013","E02005609",6302,1776,3124,3114,3100,14,10,6,4,153,152,1,772,772,0,477,475,2
"2021","South Norfolk 014","E02005610",6988,1859,3774,3741,3733,8,33,6,27,117,116,1,726,726,0,512,510,2
"2021","South Norfolk 015","E02005611",9263,2999,4153,4121,4104,17,32,6,26,224,222,2,1115,1112,3,772,772,0
"2021","South Norfolk 016","E02007054",6657,2456,3177,3149,3129,20,28,6,22,176,174,2,630,626,4,218,218,0
"2021","South Norfolk 017","E02007055",6378,2014,3074,3063,3055,8,11,6,5,118,117,1,693,693,0,479,479,0
"2021","Babergh 001","E02006227",5566,1381,3032,3021,3004,17,11,0,11,132,131,1,585,583,2,436,436,0
"2021","Babergh 002","E02006228",5146,1500,2752,2740,2735,5,12,10,2,97,97,0,475,475,0,322,322,0
"2021","Babergh 003","E02006229",5313,1389,2879,2869,2850,19,10,7,3,106,103,3,509,508,1,430,430,0
"2021","Babergh 004","E02006230",9087,2313,4967,4950,4934,16,17,4,13,198,197,1,830,829,1,779,778,1
"2021","Babergh 005","E02006231",7210,2318,3620,3597,3576,21,23,2,21,118,118,0,767,765,2,387,386,1
"2021","Babergh 006","E02006232",5166,1350,2867,2860,2845,15,7,2,5,91,90,1,502,500,2,356,355,1
"2021","Babergh 007","E02006233",9846,3482,3947,3922,3903,19,25,6,19,302,302,0,1273,1271,2,842,841,1
"2021","Babergh 008","E02006234",7975,2798,3591,3581,3561,20,10,0,10,199,199,0,918,917,1,469,468,1
"2021","Babergh 009","E02006235",6948,1729,3959,3936,3919,17,23,6,17,125,125,0,588,587,1,547,546,1
"2021","Babergh 010","E02006236",8803,2175,5117,5108,5094,14,9,4,5,145,145,0,751,751,0,615,615,0
"2021","Babergh 011","E02006237",6318,1733,3313,3282,3260,22,31,12,19,150,149,1,636,636,0,486,484,2
"2021","Ipswich 001","E02006245",6533,2271,2992,2981,2973,8,11,4,7,125,124,1,658,657,1,487,486,1
"2021","Ipswich 002","E02006246",6137,1894,3177,3171,3154,17,6,0,6,102,102,0,507,506,1,457,457,0
"2021","Ipswich 003","E02006247",7136,3045,2785,2773,2760,13,12,2,10,186,184,2,790,789,1,330,329,1
"2021","Ipswich 004","E02006248",6661,2237,3190,3172,3156,16,18,8,10,121,120,1,690,689,1,423,423,0
"2021","Ipswich 005","E02006249",6910,2298,3320,3293,3275,18,27,4,23,165,164,1,663,661,2,464,464,0
"2021","Ipswich 006","E02006250",8116,3962,2659,2647,2620,27,12,6,6,283,278,5,956,953,3,256,255,1
"2021","Ipswich 007","E02006251",8935,4636,2740,2723,2695,28,17,6,11,282,281,1,993,991,2,284,284,0
"2021","Ipswich 008","E02006252",7734,3020,3289,3279,3260,19,10,6,4,195,192,3,826,826,0,404,403,1
"2021","Ipswich 009","E02006253",6194,1728,3389,3375,3367,8,14,5,9,93,93,0,495,494,1,489,489,0
"2021","Ipswich 010","E02006254",7453,3438,2623,2605,2593,12,18,6,12,196,196,0,827,822,5,369,369,0
"2021","Ipswich 011","E02006255",6777,2971,2690,2665,2638,27,25,5,20,179,179,0,633,629,4,304,304,0
"2021","Ipswich 012","E02006256",7771,3674,2662,2645,2611,34,17,12,5,217,216,1,837,829,8,381,380,1
"2021","Ipswich 013","E02006257",5460,1900,2429,2416,2404,12,13,8,5,138,138,0,575,573,2,418,418,0
"2021","Ipswich 014","E02006258",7510,3080,2987,2978,2963,15,9,0,9,196,195,1,828,821,7,419,419,0
"2021","Ipswich 015","E02006259",5701,2166,2375,2372,2358,14,3,0,3,165,165,0,636,636,0,359,359,0
"2021","Ipswich 016","E02006260",6803,2682,2841,2837,2821,16,4,2,2,204,202,2,681,681,0,395,395,0
"2021","Mid Suffolk 001","E02006261",6828,1776,3689,3672,3659,13,17,1,16,147,146,1,668,667,1,548,548,0
"2021","Mid Suffolk 002","E02006262",7639,1880,4325,4307,4283,24,18,8,10,149,149,0,759,756,3,526,526,0
"2021","Mid Suffolk 003","E02006263",6466,1648,3679,3655,3631,24,24,2,22,129,129,0,594,593,1,416,413,3
"2021","Mid Suffolk 004","E02006264",7345,1946,4120,4106,4100,6,14,8,6,127,127,0,689,687,2,463,462,1
"2021","Mid Suffolk 005","E02006265",6242,1686,3427,3421,3410,11,6,3,3,117,116,1,553,550,3,459,458,1
"2021","Mid Suffolk 006","E02006266",8000,2038,4557,4527,4515,12,30,8,22,168,159,9,706,706,0,531,531,0
"2021","Mid Suffolk 007","E02006267",7079,1788,4112,4096,4080,16,16,10,6,119,119,0,636,634,2,424,424,0
"2021","Mid Suffolk 008","E02006268",5100,1674,2238,2226,2214,12,12,0,12,121,121,0,619,619,0,448,447,1
"2021","Mid Suffolk 009","E02006269",6442,1904,3349,3335,3323,12,14,2,12,124,124,0,610,609,1,455,455,0
"2021","Mid Suffolk 010","E02006270",10373,3751,4609,4597,4568,29,12,1,11,276,273,3,1196,1193,3,541,541,0
"2021","Mid Suffolk 011","E02006271",8271,2898,3819,3811,3778,33,8,4,4,191,188,3,822,821,1,541,540,1
"2021","Mid Suffolk 012","E02006272",6519,1753,3455,3441,3424,17,14,5,9,130,130,0,655,655,0,526,526,0
"2021","St Albans 001","E02004924",5779,1478,3550,3534,3528,6,16,8,8,95,95,0,380,380,0,276,276,0
"2021","St Albans 002","E02004925",5877,1668,3346,3342,3333,9,4,0,4,115,115,0,445,445,0,303,303,0
"2021","St Albans 003","E02004926",6258,1512,3769,3764,3760,4,5,2,3,108,108,0,433,431,2,436,436,0
"2021","St Albans 004","E02004927",5230,1405,2981,2959,2952,7,22,14,8,95,95,0,440,440,0,309,309,0
"2021","St Albans 005","E02004928",5365,1227,3414,3405,3391,14,9,2,7,72,71,1,362,361,1,290,290,0
"2021","St Albans 006","E02004929",5094,1366,2812,2802,2795,7,10,10,0,89,89,0,440,440,0,387,386,1
"2021","St Albans 007","E02004930",5534,1799,2874,2870,2861,9,4,4,0,97,96,1,423,422,1,341,340,1
"2021","St Albans 008","E02004931",5368,1571,3016,3010,3003,7,6,6,0,85,84,1,388,386,2,308,308,0
"2021","St Albans 009","E02004932",5903,2069,2903,2890,2881,9,13,4,9,131,131,0,488,488,0,312,312,0
"2021","St Albans 010","E02004933",5298,1370,3401,3392,3377,15,9,6,3,67,67,0,231,231,0,229,229,0
"2021","St Albans 011","E02004934",6226,2506,2908,2886,2858,28,22,7,15,129,129,0,410,408,2,273,273,0
"2021","St Albans 012","E02004935",7499,3575,2853,2832,2801,31,21,13,8,177,176,1,629,626,3,265,264,1
"2021","St Albans 013","E02004936",4932,1601,2759,2751,2737,14,8,0,8,71,71,0,307,305,2,194,194,0
"2021","St Albans 014","E02004937",5895,1565,3396,3379,3373,6,17,4,13,85,85,0,380,380,0,469,469,0
"2021","St Albans 016","E02004939",5203,1731,2576,2569,2553,16,7,6,1,120,120,0,422,422,0,354,354,0
"2021","St Albans 017","E02004940",5888,2226,2728,2717,2697,20,11,6,5,112,112,0,496,495,1,326,326,0
"2021","St Albans 018","E02004941",7835,2963,3579,3572,3555,17,7,4,3,169,168,1,751,751,0,373,373,0
"2021","St Albans 019","E02004942",5200,1670,2621,2612,2600,12,9,5,4,100,100,0,462,462,0,347,345,2
"2021","St Albans 020","E02004943",6762,1823,3857,3841,3830,11,16,6,10,104,103,1,486,485,1,492,489,3
"2021","St Albans 021","E02007090",4931,1725,2486,2477,2471,6,9,4,5,94,94,0,392,391,1,234,234,0
"2021","Welwyn Hatfield 001","E02004980",5174,1300,3145,3132,3118,14,13,6,7,78,76,2,309,309,0,342,341,1
"2021","Welwyn Hatfield 002","E02004981",6514,2044,3377,3360,3344,16,17,8,9,124,124,0,588,588,0,381,381,0
"2021","Welwyn Hatfield 003","E02004982",4687,1415,2503,2500,2493,7,3,0,3,108,108,0,366,366,0,295,295,0
"2021","Welwyn Hatfield 004","E02004983",4837,1763,2133,2130,2127,3,3,0,3,108,107,1,498,498,0,335,335,0
"2021","Welwyn Hatfield 005","E02004984",5235,1882,2342,2335,2326,9,7,6,1,114,113,1,522,521,1,375,375,0
"2021","Welwyn Hatfield 006","E02004985",5751,1693,2990,2974,2962,12,16,6,10,102,102,0,483,482,1,483,483,0
"2021","Welwyn Hatfield 007","E02004986",6814,3261,2430,2417,2404,13,13,6,7,219,215,4,621,621,0,283,282,1
"2021","Welwyn Hatfield 008","E02004987",5991,2214,2796,2784,2774,10,12,2,10,138,137,1,521,521,0,322,322,0
"2021","Welwyn Hatfield 009","E02004988",6030,2353,2658,2647,2634,13,11,0,11,149,148,1,566,566,0,304,304,0
"2021","Welwyn Hatfield 010","E02004989",10622,6121,3276,3270,3255,15,6,0,6,195,193,2,658,652,6,372,369,3
"2021","Welwyn Hatfield 011","E02004990",6027,2352,2664,2645,2622,23,19,7,12,148,147,1,534,532,2,329,329,0
"2021","Welwyn Hatfield 012","E02004991",6625,3368,2305,2293,2284,9,12,8,4,133,132,1,550,548,2,269,269,0
"2021","Welwyn Hatfield 013","E02004992",8823,5583,2311,2297,2280,17,14,12,2,157,153,4,490,490,0,282,282,0
"2021","Welwyn Hatfield 015","E02004994",5041,1473,2869,2847,2835,12,22,10,12,69,69,0,331,331,0,299,299,0
"2021","Welwyn Hatfield 016","E02004995",4710,1259,2760,2760,2750,10,0,0,0,70,70,0,305,305,0,316,315,1
"2021","Welwyn Hatfield 017","E02007092",4590,1768,1975,1967,1959,8,8,4,4,97,96,1,453,453,0,297,297,0
"2021","East Hertfordshire 001","E02004878",7382,2251,3945,3939,3927,12,6,4,2,140,138,2,597,596,1,449,449,0
"2021","East Hertfordshire 003","E02004880",8559,2530,4851,4841,4829,12,10,2,8,131,131,0,650,645,5,397,396,1
"2021","East Hertfordshire 004","E02004881",5589,2006,2670,2666,2655,11,4,2,2,93,92,1,435,435,0,385,385,0
"2021","East Hertfordshire 005","E02004882",6705,2521,3204,3193,3182,11,11,7,4,132,131,1,507,504,3,341,341,0
"2021","East Hertfordshire 006","E02004883",5035,1532,2690,2680,2665,15,10,4,6,87,85,2,429,429,0,297,297,0
"2021","East Hertfordshire 007","E02004884",8507,3481,3572,3561,3545,16,11,5,6,175,174,1,834,834,0,445,445,0
"2021","East Hertfordshire 008","E02004885",6843,2018,3863,3853,3838,15,10,6,4,95,94,1,530,530,0,337,336,1
"2021","East Hertfordshire 009","E02004886",5385,1690,2869,2863,2847,16,6,4,2,90,90,0,435,433,2,301,300,1
"2021","East Hertfordshire 010","E02004887",6222,1733,3489,3477,3468,9,12,4,8,124,124,0,528,528,0,348,348,0
"2021","East Hertfordshire 011","E02004888",7126,2088,3821,3801,3790,11,20,6,14,111,111,0,648,647,1,458,458,0
"2021","East Hertfordshire 012","E02004889",9016,3243,4087,4073,4045,28,14,6,8,185,184,1,851,849,2,650,649,1
"2021","East Hertfordshire 013","E02004890",6982,2608,3178,3173,3153,20,5,2,3,121,119,2,690,689,1,385,385,0
"2021","East Hertfordshire 014","E02004891",6342,2064,3217,3198,3185,13,19,6,13,125,121,4,559,556,3,377,376,1
"2021","East Hertfordshire 015","E02004892",4637,1894,1947,1943,1930,13,4,0,4,100,100,0,458,457,1,238,237,1
"2021","East Hertfordshire 016","E02004893",4642,1763,2229,2222,2211,11,7,2,5,86,86,0,391,390,1,173,173,0
"2021","East Hertfordshire 017","E02004894",7909,3177,3283,3272,3245,27,11,2,9,183,182,1,791,789,2,475,475,0
"2021","East Hertfordshire 018","E02004895",7555,2580,3718,3705,3692,13,13,6,7,144,144,0,674,673,1,439,437,2
"2021","East Hertfordshire 019","E02007093",6715,1867,3786,3772,3760,12,14,2,12,133,133,0,542,541,1,387,387,0
"2021","Stevenage 001","E02004944",6197,2608,2600,2593,2577,16,7,4,3,160,159,1,607,606,1,222,222,0
"2021","Stevenage 002","E02004945",9863,3670,4620,4601,4568,33,19,10,9,214,213,1,848,844,4,511,509,2
"2021","Stevenage 003","E02004946",5123,1983,2120,2120,2103,17,0,0,0,137,137,0,563,563,0,320,320,0
"2021","Stevenage 005","E02004948",4948,1830,2137,2130,2120,10,7,2,5,149,148,1,514,514,0,318,317,1
"2021","Stevenage 006","E02004949",7119,2867,2788,2782,2762,20,6,6,0,179,178,1,779,777,2,506,506,0
"2021","Stevenage 007","E02004950",5308,1920,2383,2377,2364,13,6,6,0,140,139,1,536,534,2,329,329,0
"2021","Stevenage 008","E02004951",6388,2866,2427,2415,2407,8,12,6,6,175,175,0,576,574,2,344,344,0
"2021","Stevenage 009","E02004952",5515,2026,2483,2470,2465,5,13,2,11,139,138,1,548,545,3,319,319,0
"2021","Stevenage 010","E02004953",5015,1894,2213,2207,2196,11,6,2,4,149,149,0,481,479,2,278,278,0
"2021","Stevenage 011","E02004954",5641,2184,2422,2409,2400,9,13,4,9,158,157,1,581,581,0,296,296,0
"2021","Stevenage 012","E02004955",4801,1646,2316,2311,2291,20,5,1,4,98,97,1,445,445,0,296,295,1
"2021","Stevenage 013","E02007091",5328,1745,2755,2745,2736,9,10,4,6,108,106,2,475,473,2,245,245,0
"2021","East Suffolk 016","E02006287",5501,1318,3051,3015,3003,12,36,2,34,97,97,0,535,532,3,500,498,2
"2021","East Suffolk 017","E02006288",8414,2364,4476,4448,4426,22,28,7,21,181,181,0,770,769,1,623,623,0
"2021","East Suffolk 018","E02006289",8120,2319,4110,4081,4057,24,29,4,25,172,170,2,850,850,0,669,669,0
"2021","East Suffolk 019","E02006290",6973,2069,3220,3183,3164,19,37,6,31,185,183,2,774,769,5,725,721,4
"2021","East Suffolk 020","E02006291",6499,1848,3352,3340,3316,24,12,4,8,135,132,3,691,690,1,473,471,2
"2021","East Suffolk 021","E02006292",5731,1427,3353,3341,3331,10,12,8,4,93,91,2,480,479,1,378,378,0
"2021","East Suffolk 023","E02006293",9323,2879,4811,4782,4764,18,29,2,27,199,197,2,915,914,1,519,518,1
"2021","East Suffolk 022","E02006294",6786,1852,3170,3142,3119,23,28,14,14,166,165,1,791,790,1,807,803,4
"2021","East Suffolk 024","E02006295",7679,2079,4137,4126,4107,19,11,4,7,178,178,0,701,699,2,584,584,0
"2021","East Suffolk 025","E02006296",10621,2980,5904,5885,5871,14,19,6,13,206,205,1,930,930,0,601,600,1
"2021","East Suffolk 026","E02006297",6821,1672,4088,4072,4064,8,16,2,14,92,92,0,513,512,1,456,456,0
"2021","East Suffolk 027","E02006298",7679,2175,3996,3981,3969,12,15,9,6,149,149,0,883,882,1,476,475,1
"2021","East Suffolk 028","E02006299",7291,1488,4316,4299,4291,8,17,6,11,105,105,0,643,641,2,739,737,2
"2021","East Suffolk 029","E02006300",6498,2426,2484,2478,2460,18,6,0,6,230,230,0,952,950,2,406,406,0
"2021","East Suffolk 030","E02006301",5407,1721,2178,2167,2149,18,11,0,11,181,178,3,790,788,2,537,536,1
"2021","East Suffolk 001","E02006302",5833,1409,3271,3256,3237,19,15,5,10,96,96,0,567,566,1,490,490,0
"2021","East Suffolk 002","E02006303",6238,2442,2353,2337,2329,8,16,2,14,165,163,2,819,819,0,459,459,0
"2021","East Suffolk 003","E02006304",6905,1891,3584,3569,3558,11,15,6,9,107,107,0,703,700,3,620,620,0
"2021","East Suffolk 004","E02006305",7593,3558,2226,2209,2179,30,17,2,15,307,305,2,1155,1154,1,347,347,0
"2021","East Suffolk 005","E02006306",6047,2035,2654,2642,2631,11,12,2,10,144,143,1,697,697,0,517,516,1
"2021","East Suffolk 007","E02006307",6402,1585,3557,3545,3537,8,12,2,10,90,89,1,545,545,0,625,625,0
"2021","East Suffolk 006","E02006308",6307,2777,1852,1840,1815,25,12,0,12,231,230,1,996,991,5,451,451,0
"2021","East Suffolk 009","E02006309",5594,1732,2427,2416,2406,10,11,4,7,132,132,0,694,693,1,609,609,0
"2021","East Suffolk 008","E02006310",6576,2113,3160,3153,3138,15,7,2,5,132,131,1,699,695,4,472,471,1
"2021","East Suffolk 010","E02006311",6923,2097,3138,3123,3108,15,15,8,7,167,166,1,872,869,3,649,649,0
"2021","East Suffolk 011","E02006312",7201,1912,3955,3950,3942,8,5,4,1,108,108,0,686,684,2,540,539,1
"2021","East Suffolk 012","E02006313",8467,2356,4225,4210,4180,30,15,8,7,159,156,3,946,942,4,781,781,0
"2021","East Suffolk 013","E02006314",6167,1802,3001,2977,2967,10,24,10,14,121,121,0,660,659,1,583,582,1
"2021","East Suffolk 014","E02006315",5090,1291,2589,2573,2563,10,16,0,16,115,115,0,591,589,2,504,502,2
"2021","East Suffolk 015","E02006316",6041,1674,2950,2912,2907,5,38,12,26,134,134,0,650,650,0,633,633,0
"2021","West Suffolk 002","E02006238",8106,2527,3789,3769,3749,20,20,10,10,236,236,0,931,929,2,623,623,0
"2021","West Suffolk 001","E02006239",6805,2298,3457,3453,3414,39,4,0,4,173,172,1,624,620,4,253,253,0
"2021","West Suffolk 003","E02006240",8099,2768,4064,4054,4026,28,10,3,7,201,200,1,705,701,4,361,360,1
"2021","West Suffolk 004","E02006241",7268,2426,3353,3344,3323,21,9,2,7,173,173,0,849,847,2,467,467,0
"2021","West Suffolk 007","E02006242",8389,2790,4285,4266,4215,51,19,8,11,183,180,3,769,769,0,362,362,0
"2021","West Suffolk 008","E02006243",7727,3038,3162,3153,3132,21,9,3,6,177,177,0,963,960,3,387,387,0
"2021","West Suffolk 005","E02006273",5789,1529,3119,3109,3107,2,10,0,10,116,116,0,561,560,1,464,464,0
"2021","West Suffolk 006","E02006274",5544,1861,2705,2697,2685,12,8,2,6,130,130,0,519,518,1,329,329,0
"2021","West Suffolk 009","E02006275",5593,2200,2240,2232,2224,8,8,2,6,131,131,0,667,667,0,355,355,0
"2021","West Suffolk 016","E02006276",6823,1827,3666,3652,3631,21,14,2,12,248,247,1,576,576,0,506,505,1
"2021","West Suffolk 012","E02006277",6126,1963,3131,3124,3099,25,7,2,5,110,110,0,645,644,1,277,275,2
"2021","West Suffolk 011","E02006278",7351,3022,2741,2718,2682,36,23,2,21,216,213,3,873,868,5,499,497,2
"2021","West Suffolk 014","E02006279",7275,2163,3612,3601,3591,10,11,10,1,161,160,1,741,740,1,598,596,2
"2021","West Suffolk 010","E02006280",8068,2013,4605,4595,4579,16,10,4,6,155,154,1,683,680,3,612,609,3
"2021","West Suffolk 013","E02006281",7211,2171,3443,3434,3418,16,9,0,9,138,138,0,718,717,1,741,739,2
"2021","West Suffolk 017","E02006282",5622,1260,3132,3110,3098,12,22,4,18,107,106,1,677,677,0,446,443,3
"2021","West Suffolk 018","E02006283",7084,2609,3325,3308,3300,8,17,4,13,149,149,0,598,596,2,403,403,0
"2021","West Suffolk 019","E02006284",6189,2067,2869,2859,2842,17,10,6,4,185,185,0,676,676,0,392,392,0
"2021","West Suffolk 021","E02006285",5996,2098,2834,2820,2817,3,14,6,8,137,137,0,632,630,2,295,295,0
"2021","West Suffolk 020","E02006286",8873,3203,3949,3939,3926,13,10,2,8,247,247,0,946,946,0,528,526,2
"2021","West Suffolk 015","E02006826",8193,3364,3215,3207,3184,23,8,2,6,191,190,1,913,910,3,510,509,1
"2021","City of London 001","E02000001",8003,4594,2435,2322,2218,104,113,17,96,172,166,6,559,537,22,243,242,1
"2021","Barking and Dagenham 001","E02000002",5984,2484,2445,2439,2437,2,6,6,0,163,161,2,551,551,0,341,341,0
"2021","Barking and Dagenham 002","E02000003",8846,3398,4101,4089,4046,43,12,10,2,215,213,2,695,694,1,437,437,0
"2021","Barking and Dagenham 003","E02000004",5316,2056,2381,2372,2363,9,9,9,0,136,136,0,396,395,1,347,347,0
"2021","Barking and Dagenham 004","E02000005",7987,3141,3703,3691,3683,8,12,6,6,201,198,3,602,602,0,340,340,0
"2021","Barking and Dagenham 006","E02000007",7466,3430,2807,2799,2782,17,8,6,2,270,268,2,629,629,0,330,330,0
"2021","Barking and Dagenham 007","E02000008",9852,4129,4022,4004,3961,43,18,10,8,312,312,0,953,952,1,436,436,0
"2021","Barking and Dagenham 008","E02000009",9353,4080,3846,3835,3823,12,11,4,7,337,336,1,737,735,2,353,352,1
"2021","Barking and Dagenham 009","E02000010",7076,3036,2863,2852,2843,9,11,8,3,185,183,2,649,645,4,343,343,0
"2021","Barking and Dagenham 010","E02000011",5418,2114,2476,2463,2452,11,13,10,3,128,127,1,393,393,0,307,307,0
"2021","Barking and Dagenham 011","E02000012",8844,3453,4317,4308,4290,18,9,4,5,147,147,0,404,404,0,523,522,1
"2021","Barking and Dagenham 012","E02000013",6968,2864,2863,2859,2848,11,4,2,2,207,205,2,683,681,2,351,350,1
"2021","Barking and Dagenham 013","E02000014",7434,3145,2995,2983,2974,9,12,6,6,234,233,1,687,687,0,373,373,0
"2021","Barking and Dagenham 014","E02000015",6027,2746,2179,2175,2167,8,4,2,2,232,232,0,638,638,0,232,232,0
"2021","Barking and Dagenham 015","E02000016",7581,3187,3490,3481,3444,37,9,8,1,216,214,2,554,550,4,134,133,1
"2021","Barking and Dagenham 016","E02000017",7143,2806,3347,3328,3305,23,19,12,7,142,142,0,562,562,0,286,285,1
"2021","Barking and Dagenham 017","E02000018",6999,3024,2893,2884,2878,6,9,8,1,218,218,0,552,550,2,312,312,0
"2021","Barking and Dagenham 018","E02000019",7025,2991,2942,2926,2909,17,16,16,0,228,225,3,581,580,1,283,283,0
"2021","Barking and Dagenham 019","E02000020",10266,4224,4685,4666,4629,37,19,12,7,272,270,2,718,717,1,367,367,0
"2021","Barking and Dagenham 020","E02000021",6370,2638,2601,2595,2585,10,6,6,0,214,214,0,551,550,1,366,365,1
"2021","Barking and Dagenham 021","E02000022",5417,2562,2117,2111,2095,16,6,6,0,204,202,2,430,426,4,104,104,0
"2021","Barking and Dagenham 022","E02000023",5605,2614,2219,2210,2200,10,9,5,4,180,180,0,431,431,0,161,161,0
"2021","Barking and Dagenham 023","E02006799",8780,3532,3994,3976,3968,8,18,8,10,231,231,0,657,657,0,366,366,0
"2021","Barnet 001","E02000024",8923,3195,4324,4306,4286,20,18,6,12,170,168,2,702,700,2,532,532,0
"2021","Barnet 002","E02000025",6986,2859,2932,2914,2906,8,18,2,16,169,169,0,654,653,1,372,371,1
"2021","Barnet 003","E02000026",5217,1698,2703,2699,2696,3,4,2,2,85,85,0,422,420,2,309,309,0
"2021","Barnet 004","E02000027",7727,3031,3415,3391,3385,6,24,10,14,203,202,1,639,639,0,439,439,0
"2021","Barnet 005","E02000028",5303,1933,2573,2563,2556,7,10,2,8,104,103,1,420,420,0,273,273,0
"2021","Barnet 006","E02000029",7438,2838,3543,3524,3508,16,19,12,7,174,174,0,593,592,1,290,290,0
"2021","Barnet 007","E02000030",7717,2287,4279,4262,4250,12,17,6,11,145,145,0,536,535,1,470,470,0
"2021","Barnet 008","E02000031",6810,2252,3528,3518,3506,12,10,6,4,107,107,0,498,497,1,425,425,0
"2021","Barnet 009","E02000032",6423,1987,3602,3575,3563,12,27,2,25,97,97,0,346,345,1,391,391,0
"2021","Barnet 010","E02000033",7145,2827,3181,3171,3163,8,10,0,10,184,183,1,596,594,2,357,355,2
"2021","Barnet 011","E02000034",7281,2703,3510,3500,3486,14,10,3,7,155,155,0,545,545,0,368,367,1
"2021","Barnet 012","E02000035",7084,2606,3338,3302,3292,10,36,28,8,151,149,2,574,574,0,415,414,1
"2021","Barnet 013","E02000036",8647,2857,4462,4458,4450,8,4,0,4,264,260,4,583,583,0,481,480,1
"2021","Barnet 014","E02000037",8211,2540,4682,4678,4676,2,4,1,3,123,123,0,437,436,1,429,429,0
"2021","Barnet 015","E02000038",8641,3365,3962,3941,3916,25,21,16,5,217,217,0,660,657,3,437,436,1
"2021","Barnet 016","E02000039",5661,1733,3150,3139,3133,6,11,4,7,117,114,3,392,391,1,269,269,0
"2021","Barnet 017","E02000040",7251,2700,3491,3473,3459,14,18,6,12,141,140,1,566,561,5,353,353,0
"2021","Barnet 018","E02000041",7447,2608,3760,3752,3745,7,8,2,6,176,174,2,502,502,0,401,400,1
"2021","Barnet 019","E02000042",9410,3868,4106,4083,4058,25,23,9,14,169,168,1,794,791,3,473,473,0
"2021","Barnet 020","E02000043",5889,1783,3391,3375,3354,21,16,4,12,104,104,0,339,339,0,272,272,0
"2021","Barnet 021","E02000044",6875,2762,3100,3091,3079,12,9,4,5,200,199,1,509,508,1,304,304,0
"2021","Barnet 022","E02000045",8284,3671,3276,3254,3240,14,22,12,10,229,229,0,782,781,1,326,326,0
"2021","Barnet 023","E02000046",5700,2362,2571,2557,2528,29,14,2,12,105,105,0,438,436,2,224,223,1
"2021","Barnet 024","E02000047",9585,3925,4276,4259,4234,25,17,10,7,242,241,1,704,702,2,438,438,0
"2021","Barnet 025","E02000048",8088,2630,4253,4234,4213,21,19,8,11,183,182,1,611,609,2,411,410,1
"2021","Barnet 026","E02000049",8020,3676,3176,3162,3157,5,14,8,6,259,258,1,637,635,2,272,272,0
"2021","Barnet 027","E02000050",8366,3564,3607,3582,3569,13,25,6,19,204,204,0,623,622,1,368,366,2
"2021","Barnet 028","E02000051",7493,2686,3642,3630,3618,12,12,2,10,112,112,0,574,574,0,479,478,1
"2021","Barnet 029","E02000052",7973,3485,3335,3293,3253,40,42,14,28,173,173,0,659,658,1,321,320,1
"2021","Barnet 031","E02000054",6221,2608,2673,2666,2657,9,7,6,1,154,154,0,561,561,0,225,225,0
"2021","Barnet 032","E02000055",9495,4147,4102,4091,4080,11,11,6,5,179,177,2,673,672,1,394,393,1
"2021","Barnet 033","E02000056",7200,2093,4118,4095,4080,15,23,6,17,100,100,0,436,433,3,453,452,1
"2021","Barnet 034","E02000057",5933,2247,2968,2962,2956,6,6,2,4,101,101,0,338,338,0,279,279,0
"2021","Barnet 035","E02000058",7958,2701,4004,3990,3964,26,14,6,8,142,141,1,669,668,1,442,442,0
"2021","Barnet 036","E02000059",9624,4015,4327,4301,4270,31,26,11,15,236,235,1,672,669,3,374,372,2
"2021","Barnet 037","E02000060",7994,2816,4122,4108,4103,5,14,10,4,155,155,0,448,447,1,453,453,0
"2021","Barnet 038","E02000061",6886,2780,3149,3135,3117,18,14,4,10,124,123,1,509,508,1,324,324,0
"2021","Barnet 039","E02000062",5466,2500,2128,2104,2089,15,24,16,8,208,206,2,427,425,2,203,202,1
"2021","Barnet 040","E02000063",6083,2649,2554,2542,2519,23,12,6,6,178,177,1,475,475,0,227,224,3
"2021","Barnet 041","E02000064",5336,2519,2019,2007,1982,25,12,6,6,141,138,3,434,430,4,223,222,1
"2021","Barnet 042","E02006953",7512,3833,2974,2943,2900,43,31,9,22,170,168,2,423,422,1,112,112,0
"2021","Barnet 043","E02006954",8048,3479,3697,3687,3669,18,10,2,8,153,152,1,447,447,0,272,272,0
"2021","Bexley 001","E02000065",5940,2559,2370,2366,2361,5,4,4,0,234,230,4,584,584,0,193,192,1
"2021","Bexley 002","E02000066",7249,3329,2557,2546,2532,14,11,6,5,294,293,1,746,746,0,323,323,0
"2021","Bexley 003","E02000067",7908,3545,3006,2978,2961,17,28,18,10,261,259,2,751,748,3,345,344,1
"2021","Bexley 004","E02000068",6028,2696,2257,2238,2212,26,19,8,11,216,216,0,560,559,1,299,299,0
"2021","Bexley 005","E02000069",5675,2207,2463,2460,2448,12,3,2,1,134,134,0,521,520,1,350,350,0
"2021","Bexley 006","E02000070",6553,2118,3339,3323,3321,2,16,4,12,147,147,0,502,501,1,447,447,0
"2021","Bexley 007","E02000071",5986,2333,2670,2666,2644,22,4,2,2,124,124,0,520,520,0,339,338,1
"2021","Bexley 008","E02000072",9491,4185,3705,3701,3689,12,4,0,4,326,324,2,883,881,2,392,392,0
"2021","Bexley 009","E02000073",8704,2691,4778,4768,4765,3,10,6,4,151,150,1,551,551,0,533,533,0
"2021","Bexley 010","E02000074",6859,2935,2585,2579,2567,12,6,2,4,222,221,1,738,734,4,379,379,0
"2021","Bexley 011","E02000075",6607,1988,3576,3563,3553,10,13,5,8,103,102,1,466,465,1,474,474,0
"2021","Bexley 013","E02000077",6569,2363,3249,3244,3234,10,5,4,1,128,128,0,466,466,0,363,363,0
"2021","Bexley 014","E02000078",6396,2151,3284,3276,3270,6,8,2,6,112,111,1,450,450,0,399,399,0
"2021","Bexley 015","E02000079",7096,2539,3248,3244,3229,15,4,4,0,129,128,1,583,583,0,597,597,0
"2021","Bexley 016","E02000080",8087,2852,3988,3981,3969,12,7,4,3,172,172,0,554,553,1,521,521,0
"2021","Bexley 017","E02000081",6617,2249,3181,3176,3162,14,5,0,5,142,141,1,554,553,1,491,491,0
"2021","Bexley 018","E02000082",7455,2518,3870,3862,3852,10,8,2,6,140,140,0,490,490,0,437,437,0
"2021","Bexley 019","E02000083",8884,3700,3694,3687,3674,13,7,4,3,213,213,0,828,826,2,449,448,1
"2021","Bexley 020","E02000084",8928,2908,4729,4723,4711,12,6,0,6,152,152,0,612,610,2,527,527,0
"2021","Bexley 021","E02000085",6382,2337,3032,3025,3006,19,7,4,3,129,129,0,472,469,3,412,412,0
"2021","Bexley 022","E02000086",5853,1947,3041,3028,3019,9,13,2,11,106,106,0,424,424,0,335,335,0
"2021","Bexley 023","E02000087",6724,2169,3477,3465,3455,10,12,8,4,110,110,0,510,509,1,458,458,0
"2021","Bexley 024","E02000088",6272,2058,3250,3234,3210,24,16,12,4,122,122,0,456,456,0,386,386,0
"2021","Bexley 025","E02000089",6351,2027,3376,3370,3354,16,6,4,2,108,108,0,393,393,0,447,447,0
"2021","Bexley 026","E02000090",8111,3610,3021,3016,2986,30,5,3,2,175,175,0,690,689,1,615,615,0
"2021","Bexley 027","E02000091",8413,2987,3811,3792,3771,21,19,4,15,158,158,0,744,743,1,713,713,0
"2021","Bexley 028","E02000092",5289,2163,2090,2084,2072,12,6,3,3,174,173,1,549,549,0,313,313,0
"2021","Bexley 029","E02006785",5395,1879,2601,2600,2587,13,1,1,0,120,120,0,424,423,1,371,371,0
"2021","Brent 001","E02000093",9783,3546,5093,5083,5065,18,10,8,2,184,184,0,486,486,0,474,474,0
"2021","Brent 002","E02000094",8463,3367,4079,4069,4051,18,10,8,2,211,210,1,436,433,3,370,370,0
"2021","Brent 003","E02000095",8593,2852,4729,4715,4701,14,14,10,4,148,147,1,441,439,2,423,423,0
"2021","Brent 004","E02000096",6273,1763,3734,3728,3713,15,6,2,4,68,67,1,284,284,0,424,424,0
"2021","Brent 005","E02000097",7758,2730,4010,4005,3982,23,5,4,1,119,118,1,509,508,1,390,389,1
"2021","Brent 006","E02000098",7155,2719,3470,3455,3443,12,15,8,7,140,139,1,424,424,0,402,401,1
"2021","Brent 007","E02000099",7543,2771,3874,3860,3842,18,14,12,2,164,163,1,451,451,0,283,280,3
"2021","Brent 008","E02000100",7179,2705,3603,3593,3591,2,10,4,6,113,113,0,339,338,1,419,419,0
"2021","Brent 009","E02000101",7935,3317,3438,3425,3412,13,13,8,5,260,258,2,525,525,0,395,395,0
"2021","Brent 010","E02000102",6223,2577,2791,2791,2770,21,0,0,0,162,162,0,413,413,0,280,280,0
"2021","Brent 011","E02000103",7856,3449,3337,3329,3310,19,8,4,4,226,222,4,500,499,1,344,343,1
"2021","Brent 012","E02000104",6266,2536,2883,2876,2847,29,7,4,3,130,130,0,410,410,0,307,307,0
"2021","Brent 013","E02000105",7854,2819,3985,3970,3950,20,15,4,11,203,203,0,502,502,0,345,345,0
"2021","Brent 014","E02000106",8259,3550,3488,3482,3461,21,6,0,6,229,227,2,656,654,2,336,336,0
"2021","Brent 015","E02000107",9063,4413,3355,3334,3281,53,21,6,15,237,236,1,717,716,1,341,339,2
"2021","Brent 016","E02000108",5858,2160,3023,3012,2987,25,11,10,1,101,101,0,316,316,0,258,258,0
"2021","Brent 018","E02000110",6767,3223,2643,2612,2573,39,31,12,19,139,139,0,472,471,1,290,290,0
"2021","Brent 019","E02000111",9034,3160,4973,4961,4929,32,12,6,6,124,124,0,386,386,0,391,391,0
"2021","Brent 020","E02000112",9704,3550,5154,5138,5108,30,16,13,3,162,159,3,396,394,2,442,442,0
"2021","Brent 021","E02000113",7432,3687,2491,2479,2469,10,12,6,6,247,246,1,630,630,0,377,376,1
"2021","Brent 022","E02000114",7600,4058,2542,2521,2478,43,21,8,13,198,196,2,517,513,4,285,285,0
"2021","Brent 023","E02000115",7291,3990,2260,2236,2198,38,24,10,14,179,175,4,563,561,2,299,299,0
"2021","Brent 024","E02000116",6673,3217,2467,2447,2434,13,20,8,12,194,192,2,529,526,3,266,265,1
"2021","Brent 025","E02000117",9680,4751,3234,3223,3206,17,11,6,5,431,427,4,873,868,5,391,390,1
"2021","Brent 026","E02000118",9249,3325,4949,4919,4878,41,30,18,12,136,135,1,394,394,0,445,445,0
"2021","Brent 027","E02000119",8174,4086,2744,2734,2709,25,10,4,6,263,263,0,733,733,0,348,348,0
"2021","Brent 028","E02000120",7610,4344,2259,2224,2184,40,35,17,18,204,203,1,586,581,5,217,217,0
"2021","Brent 029","E02000121",9846,3579,5253,5233,5184,49,20,17,3,179,177,2,390,388,2,445,444,1
"2021","Brent 030","E02000122",6687,3015,2639,2621,2585,36,18,4,14,182,182,0,557,556,1,294,294,0
"2021","Brent 031","E02000123",10789,5681,3304,3281,3245,36,23,8,15,389,384,5,976,973,3,439,438,1
"2021","Brent 032","E02000124",8117,4087,2914,2873,2848,25,41,10,31,203,201,2,664,660,4,249,247,2
"2021","Brent 033","E02000125",8068,3988,2987,2972,2947,25,15,6,9,186,185,1,568,563,5,339,338,1
"2021","Brent 034","E02000126",6573,3579,1946,1936,1877,59,10,4,6,283,280,3,558,558,0,207,205,2
"2021","Brent 035","E02006955",6410,3620,2369,2358,2314,44,11,6,5,98,96,2,240,237,3,83,83,0
"2021","Brent 036","E02006956",7383,3439,3176,3158,3124,34,18,13,5,143,142,1,342,341,1,283,283,0
"2021","Bromley 001","E02000127",7218,3123,2690,2679,2659,20,11,0,11,266,263,3,761,760,1,378,378,0
"2021","Bromley 002","E02000128",6099,2081,3057,3047,3031,16,10,4,6,120,119,1,488,488,0,353,352,1
"2021","Bromley 004","E02000130",6821,3048,2845,2805,2758,47,40,13,27,158,158,0,518,515,3,252,252,0
"2021","Bromley 005","E02000131",8634,5099,2434,2387,2324,63,47,10,37,222,220,2,686,682,4,193,193,0
"2021","Bromley 006","E02000132",8227,3765,3045,3022,2934,88,23,6,17,183,181,2,832,826,6,402,402,0
"2021","Bromley 007","E02000133",8702,2458,4933,4913,4890,23,20,12,8,134,134,0,606,604,2,571,568,3
"2021","Bromley 008","E02000134",9441,4193,3827,3803,3762,41,24,4,20,232,231,1,798,796,2,391,391,0
"2021","Bromley 009","E02000135",7972,4355,2183,2158,2118,40,25,6,19,268,265,3,842,839,3,324,324,0
"2021","Bromley 010","E02000136",4655,1544,2253,2242,2229,13,11,0,11,98,98,0,336,336,0,424,424,0
"2021","Bromley 011","E02000137",6821,2441,3234,3212,3192,20,22,4,18,156,154,2,603,600,3,387,386,1
"2021","Bromley 012","E02000138",7235,2464,3334,3311,3268,43,23,7,16,169,169,0,713,708,5,555,555,0
"2021","Bromley 013","E02000139",6138,2561,2726,2706,2676,30,20,2,18,139,139,0,480,479,1,232,232,0
"2021","Bromley 014","E02000140",6582,2965,2503,2501,2494,7,2,2,0,172,172,0,641,641,0,301,301,0
"2021","Bromley 015","E02000141",5824,2720,2240,2216,2184,32,24,10,14,125,122,3,509,507,2,230,229,1
"2021","Bromley 016","E02000142",7008,2479,3514,3498,3475,23,16,4,12,134,134,0,483,483,0,398,398,0
"2021","Bromley 018","E02000144",8106,3216,3835,3820,3791,29,15,4,11,154,154,0,552,547,5,349,349,0
"2021","Bromley 019","E02000145",6679,2957,2488,2481,2473,8,7,6,1,201,201,0,650,649,1,383,383,0
"2021","Bromley 020","E02000146",7737,2931,3449,3424,3389,35,25,8,17,167,164,3,708,706,2,482,482,0
"2021","Bromley 021","E02000147",6565,1877,3854,3843,3810,33,11,5,6,79,78,1,378,376,2,377,377,0
"2021","Bromley 022","E02000148",5410,1527,3074,3064,3051,13,10,2,8,84,84,0,367,367,0,358,358,0
"2021","Bromley 023","E02000149",6499,2581,2876,2860,2834,26,16,4,12,135,135,0,554,554,0,353,353,0
"2021","Bromley 024","E02000150",6743,2224,3529,3516,3510,6,13,2,11,132,132,0,480,480,0,378,378,0
"2021","Bromley 025","E02000151",6004,1457,3754,3741,3732,9,13,2,11,63,62,1,369,368,1,361,361,0
"2021","Bromley 026","E02000152",6130,2450,2581,2567,2552,15,14,2,12,150,149,1,590,590,0,359,359,0
"2021","Bromley 027","E02000153",6379,1839,3743,3737,3726,11,6,0,6,97,97,0,373,373,0,327,325,2
"2021","Bromley 028","E02000154",6981,2337,3600,3589,3570,19,11,0,11,137,137,0,493,493,0,414,414,0
"2021","Bromley 029","E02000155",5973,1897,2943,2927,2916,11,16,4,12,105,102,3,544,544,0,484,482,2
"2021","Bromley 030","E02000156",10073,2850,5588,5571,5541,30,17,2,15,173,171,2,703,702,1,759,759,0
"2021","Bromley 031","E02000157",6746,1837,3980,3969,3960,9,11,2,9,80,80,0,390,389,1,459,459,0
"2021","Bromley 032","E02000158",6125,1978,3177,3172,3162,10,5,3,2,119,119,0,427,426,1,424,424,0
"2021","Bromley 033","E02000159",5906,1791,3174,3163,3154,9,11,6,5,101,101,0,436,433,3,404,404,0
"2021","Bromley 034","E02000160",6533,2023,3579,3571,3547,24,8,4,4,90,88,2,451,450,1,390,387,3
"2021","Bromley 035","E02000161",6918,1941,4015,4007,3999,8,8,4,4,90,90,0,455,455,0,417,417,0
"2021","Bromley 036","E02000162",5792,1778,2855,2848,2835,13,7,6,1,111,111,0,537,537,0,511,511,0
"2021","Bromley 037","E02000163",6298,1716,3583,3571,3551,20,12,4,8,111,111,0,481,480,1,407,407,0
"2021","Bromley 039","E02000165",5784,1997,2891,2880,2865,15,11,6,5,131,130,1,499,498,1,266,266,0
"2021","Bromley 040","E02006782",6504,2379,3050,3034,3011,23,16,6,10,172,171,1,539,538,1,364,363,1
"2021","Bromley 041","E02006787",6151,2096,3164,3148,3131,17,16,3,13,107,107,0,482,482,0,302,302,0
"2021","Bromley 042","E02006789",5671,1721,2988,2981,2977,4,7,4,3,89,89,0,446,446,0,427,427,0
"2021","Camden 001","E02000166",6528,3119,2364,2318,2282,36,46,14,32,151,149,2,594,588,6,300,300,0
"2021","Camden 002","E02000167",6003,2326,2874,2823,2789,34,51,14,37,108,104,4,441,441,0,254,250,4
"2021","Camden 003","E02000168",6623,3626,2185,2152,2120,32,33,8,25,126,122,4,484,481,3,202,201,1
"2021","Camden 004","E02000169",5758,2033,2960,2934,2901,33,26,10,16,108,108,0,436,434,2,221,219,2
"2021","Camden 005","E02000170",6578,3199,2535,2517,2499,18,18,8,10,127,124,3,488,482,6,229,227,2
"2021","Camden 006","E02000171",6211,3193,2169,2127,2097,30,42,12,30,123,120,3,504,498,6,222,222,0
"2021","Camden 007","E02000172",8165,4733,2268,2249,2212,37,19,4,15,220,217,3,608,605,3,336,333,3
"2021","Camden 008","E02000173",6176,2837,2589,2550,2520,30,39,18,21,112,109,3,441,439,2,197,195,2
"2021","Camden 009","E02000174",6763,4049,1850,1804,1756,48,46,18,28,131,127,4,532,526,6,201,200,1
"2021","Camden 010","E02000175",7881,4669,2363,2327,2298,29,36,17,19,152,152,0,511,500,11,186,186,0
"2021","Camden 011","E02000176",4968,2328,1988,1934,1899,35,54,24,30,85,83,2,421,417,4,146,145,1
"2021","Camden 012","E02000177",7096,4064,1920,1887,1856,31,33,14,19,194,193,1,606,599,7,312,312,0
"2021","Camden 013","E02000178",7611,4573,2052,2005,1974,31,47,16,31,209,209,0,553,549,4,224,224,0
"2021","Camden 014","E02000179",4720,2248,1785,1758,1738,20,27,10,17,114,113,1,379,375,4,194,192,2
"2021","Camden 015","E02000180",6742,4133,1795,1750,1703,47,45,10,35,133,133,0,488,487,1,193,193,0
"2021","Camden 016","E02000181",6842,3679,2441,2393,2343,50,48,14,34,101,100,1,468,465,3,153,153,0
"2021","Camden 017","E02000182",5784,2623,2390,2367,2336,31,23,6,17,134,133,1,391,391,0,246,245,1
"2021","Camden 018","E02000183",6445,3212,2251,2226,2208,18,25,6,19,160,158,2,595,592,3,227,224,3
"2021","Camden 019","E02000184",7747,5099,1788,1746,1697,49,42,6,36,156,155,1,488,484,4,216,216,0
"2021","Camden 020","E02000185",7264,3880,2111,2092,2062,30,19,12,7,266,265,1,694,692,2,313,313,0
"2021","Camden 021","E02000186",5438,3321,1448,1403,1356,47,45,14,31,114,112,2,387,384,3,168,164,4
"2021","Camden 022","E02000187",7985,4910,2079,2053,2018,35,26,11,15,220,219,1,515,513,2,261,261,0
"2021","Camden 023","E02000188",5930,3584,1612,1584,1562,22,28,10,18,163,160,3,342,338,4,229,229,0
"2021","Camden 026","E02000191",5023,3727,880,833,777,56,47,2,45,74,74,0,232,225,7,110,107,3
"2021","Camden 027","E02000192",5740,3340,1609,1556,1510,46,53,16,37,141,137,4,462,459,3,188,188,0
"2021","Camden 028","E02000193",5504,3601,1249,1175,1105,70,74,4,70,106,104,2,382,371,11,166,158,8
"2021","Camden 029","E02007115",10387,7049,2151,2105,2047,58,46,6,40,207,201,6,681,674,7,299,298,1
"2021","Croydon 001","E02000194",7483,3964,2399,2357,2305,52,42,8,34,199,197,2,657,651,6,264,264,0
"2021","Croydon 002","E02000195",7739,3008,3661,3645,3610,35,16,4,12,166,164,2,528,526,2,376,375,1
"2021","Croydon 003","E02000196",6480,2843,2659,2647,2623,24,12,8,4,149,147,2,485,485,0,344,344,0
"2021","Croydon 004","E02000197",7317,3154,2990,2967,2947,20,23,2,21,218,218,0,604,601,3,351,350,1
"2021","Croydon 005","E02000198",7013,3420,2357,2342,2323,19,15,7,8,252,250,2,735,729,6,249,248,1
"2021","Croydon 006","E02000199",6748,3171,2502,2481,2457,24,21,5,16,204,203,1,636,635,1,235,234,1
"2021","Croydon 007","E02000200",7351,3632,2498,2480,2446,34,18,8,10,231,229,2,687,682,5,303,303,0
"2021","Croydon 008","E02000201",6787,3548,2093,2063,2037,26,30,12,18,212,209,3,672,667,5,262,262,0
"2021","Croydon 009","E02000202",7146,2977,3101,3055,3026,29,46,13,33,184,183,1,546,545,1,338,338,0
"2021","Croydon 010","E02000203",6292,2987,2222,2209,2198,11,13,5,8,280,279,1,537,537,0,266,266,0
"2021","Croydon 011","E02000204",7612,3159,3254,3233,3213,20,21,5,16,252,251,1,570,570,0,377,377,0
"2021","Croydon 013","E02000206",8344,4276,2591,2574,2547,27,17,7,10,291,290,1,836,833,3,350,349,1
"2021","Croydon 014","E02000207",7212,3774,2247,2234,2224,10,13,3,10,226,223,3,713,709,4,252,250,2
"2021","Croydon 015","E02000208",8128,3891,2961,2942,2924,18,19,8,11,322,322,0,684,682,2,270,270,0
"2021","Croydon 016","E02000209",7002,2957,3140,3109,3102,7,31,28,3,177,177,0,460,460,0,268,268,0
"2021","Croydon 017","E02000210",6944,3205,2727,2709,2686,23,18,4,14,189,186,3,564,563,1,259,259,0
"2021","Croydon 018","E02000211",6827,2352,3292,3284,3271,13,8,6,2,143,143,0,609,607,2,431,428,3
"2021","Croydon 019","E02000212",7203,3227,2954,2933,2923,10,21,14,7,206,206,0,512,511,1,304,304,0
"2021","Croydon 020","E02000213",9888,5151,3337,3326,3293,33,11,4,7,312,312,0,793,787,6,295,294,1
"2021","Croydon 021","E02000214",5086,1833,2574,2556,2549,7,18,8,10,87,85,2,328,325,3,264,264,0
"2021","Croydon 022","E02000215",9619,4715,3389,3352,3306,46,37,11,26,267,265,2,875,855,20,373,373,0
"2021","Croydon 023","E02000216",5749,1997,2850,2844,2829,15,6,4,2,105,105,0,455,449,6,342,342,0
"2021","Croydon 024","E02000217",9313,4667,3266,3235,3186,49,31,14,17,301,299,2,766,762,4,313,312,1
"2021","Croydon 025","E02000218",5126,2081,2248,2234,2222,12,14,2,12,147,147,0,371,371,0,279,279,0
"2021","Croydon 026","E02000219",6508,2045,3506,3486,3464,22,20,10,10,99,98,1,383,380,3,475,474,1
"2021","Croydon 028","E02000221",8361,3746,3269,3255,3241,14,14,6,8,235,232,3,707,704,3,404,402,2
"2021","Croydon 029","E02000222",6729,3027,2743,2718,2693,25,25,10,15,170,170,0,549,547,2,240,240,0
"2021","Croydon 030","E02000223",6015,3064,1887,1878,1873,5,9,8,1,244,243,1,509,509,0,311,311,0
"2021","Croydon 031","E02000224",6404,2823,2701,2697,2672,25,4,2,2,174,172,2,496,494,2,210,209,1
"2021","Croydon 032","E02000225",5826,2457,2363,2344,2335,9,19,4,15,166,166,0,518,515,3,322,322,0
"2021","Croydon 033","E02000226",6283,1831,3546,3532,3519,13,14,4,10,96,96,0,409,408,1,401,401,0
"2021","Croydon 034","E02000227",9377,3619,3977,3968,3949,19,9,8,1,255,255,0,972,971,1,554,553,1
"2021","Croydon 035","E02000228",6396,1620,3893,3881,3869,12,12,0,12,97,97,0,353,353,0,433,433,0
"2021","Croydon 036","E02000229",4730,2220,1654,1648,1641,7,6,4,2,121,120,1,443,443,0,292,292,0
"2021","Croydon 037","E02000230",8574,3178,4097,4079,4050,29,18,2,16,169,169,0,609,609,0,521,520,1
"2021","Croydon 038","E02000231",6543,2008,3722,3710,3696,14,12,0,12,88,88,0,321,320,1,404,404,0
"2021","Croydon 039","E02000232",5071,1566,2682,2675,2668,7,7,4,3,79,79,0,350,348,2,394,393,1
"2021","Croydon 040","E02000233",4999,1882,2352,2338,2325,13,14,6,8,110,110,0,376,376,0,279,279,0
"2021","Croydon 041","E02000234",7418,2755,3538,3522,3499,23,16,2,14,159,156,3,600,599,1,366,366,0
"2021","Croydon 042","E02000235",5608,1770,2986,2970,2960,10,16,0,16,113,112,1,447,446,1,292,291,1
"2021","Croydon 043","E02000236",7067,2242,3912,3900,3880,20,12,6,6,91,91,0,506,505,1,316,316,0
"2021","Croydon 044","E02000237",6125,1827,3299,3294,3267,27,5,0,5,87,87,0,470,470,0,442,442,0
"2021","Croydon 045","E02006788",5923,2945,2039,2030,2010,20,9,1,8,172,172,0,534,533,1,233,233,0
"2021","Croydon 046","E02006987",6329,3690,1858,1836,1788,48,22,8,14,210,209,1,474,470,4,97,97,0
"2021","Croydon 047","E02006988",5713,2878,1896,1883,1856,27,13,6,7,191,187,4,526,524,2,222,221,1
"2021","Ealing 001","E02000238",8611,3394,4116,4107,4093,14,9,4,5,184,183,1,576,576,0,341,341,0
"2021","Ealing 002","E02000239",7457,2621,3867,3857,3842,15,10,8,2,143,143,0,447,447,0,379,378,1
"2021","Ealing 003","E02000240",8731,3508,3907,3899,3893,6,8,1,7,223,221,2,715,714,1,378,378,0
"2021","Ealing 004","E02000241",5909,2278,2840,2830,2816,14,10,0,10,125,124,1,409,408,1,257,257,0
"2021","Ealing 005","E02000242",5643,2071,2842,2834,2825,9,8,6,2,133,133,0,356,356,0,241,241,0
"2021","Ealing 006","E02000243",7114,2871,3102,3082,3072,10,20,12,8,174,174,0,580,580,0,387,387,0
"2021","Ealing 007","E02000244",6385,2511,3012,3000,2987,13,12,6,6,142,141,1,466,466,0,254,253,1
"2021","Ealing 008","E02000245",6942,2972,2945,2937,2933,4,8,2,6,225,225,0,543,542,1,257,257,0
"2021","Ealing 009","E02000246",7197,2988,3157,3145,3136,9,12,10,2,191,189,2,540,539,1,321,320,1
"2021","Ealing 010","E02000247",8648,3484,3821,3807,3786,21,14,8,6,231,230,1,681,678,3,431,429,2
"2021","Ealing 011","E02000248",6140,2453,2799,2775,2763,12,24,10,14,163,161,2,478,477,1,247,247,0
"2021","Ealing 012","E02000249",6679,2593,3027,3007,2988,19,20,6,14,153,153,0,516,515,1,390,390,0
"2021","Ealing 013","E02000250",5210,1754,2679,2667,2654,13,12,2,10,69,69,0,430,427,3,278,278,0
"2021","Ealing 014","E02000251",6645,2224,3489,3482,3470,12,7,6,1,120,120,0,458,457,1,354,352,2
"2021","Ealing 015","E02000252",10461,6484,2815,2801,2776,25,14,2,12,243,243,0,639,638,1,280,278,2
"2021","Ealing 016","E02000253",8045,3541,3136,3125,3104,21,11,8,3,211,209,2,757,757,0,400,400,0
"2021","Ealing 017","E02000254",7493,2359,4189,4184,4170,14,5,4,1,122,122,0,373,373,0,450,450,0
"2021","Ealing 018","E02000255",7878,3408,3403,3377,3360,17,26,4,22,167,165,2,567,566,1,333,332,1
"2021","Ealing 019","E02000256",7781,3474,3262,3232,3213,19,30,18,12,180,180,0,544,542,2,321,320,1
"2021","Ealing 021","E02000258",5486,2456,2301,2290,2279,11,11,0,11,117,115,2,399,399,0,213,213,0
"2021","Ealing 022","E02000259",5161,2013,2398,2384,2375,9,14,4,10,149,146,3,383,381,2,218,218,0
"2021","Ealing 023","E02000260",7834,2402,4377,4362,4336,26,15,10,5,135,134,1,415,415,0,505,505,0
"2021","Ealing 024","E02000261",10372,5470,3578,3524,3477,47,54,30,24,216,214,2,738,736,2,370,370,0
"2021","Ealing 025","E02000262",7600,3737,2705,2680,2647,33,25,10,15,184,184,0,711,708,3,263,263,0
"2021","Ealing 026","E02000263",10851,3437,6145,6139,6111,28,6,6,0,178,178,0,456,456,0,635,632,3
"2021","Ealing 027","E02000264",7289,3558,2819,2788,2749,39,31,12,19,140,139,1,479,476,3,293,292,1
"2021","Ealing 028","E02000265",9080,4432,3294,3273,3233,40,21,11,10,234,233,1,777,775,2,343,342,1
"2021","Ealing 029","E02000266",10331,4328,4557,4539,4507,32,18,6,12,260,256,4,680,678,2,506,506,0
"2021","Ealing 030","E02000267",6419,2923,2636,2606,2586,20,30,10,20,143,140,3,483,482,1,234,234,0
"2021","Ealing 031","E02000268",7796,3593,3111,3083,3047,36,28,12,16,179,176,3,600,597,3,313,311,2
"2021","Ealing 032","E02000269",6597,2689,3141,3098,3062,36,43,10,33,100,100,0,405,403,2,262,262,0
"2021","Ealing 033","E02000270",7771,4090,2681,2649,2603,46,32,13,19,177,175,2,588,584,4,235,235,0
"2021","Ealing 034","E02000271",5637,2155,2784,2744,2700,44,40,4,36,88,86,2,418,416,2,192,192,0
"2021","Ealing 035","E02000272",5364,1993,2650,2632,2606,26,18,4,14,81,81,0,350,348,2,290,286,4
"2021","Ealing 038","E02000275",6562,2027,3739,3727,3707,20,12,9,3,117,114,3,317,317,0,362,362,0
"2021","Ealing 039","E02000276",5423,2410,2313,2279,2250,29,34,4,30,90,89,1,405,402,3,205,199,6
"2021","Ealing 040","E02006791",6328,3101,2469,2398,2365,33,71,28,43,123,123,0,459,455,4,176,172,4
"2021","Ealing 041","E02006968",6877,2885,3148,3096,3073,23,52,34,18,143,142,1,412,411,1,289,287,2
"2021","Ealing 042","E02006969",5480,2724,2046,2028,2010,18,18,2,16,92,91,1,418,417,1,200,200,0
"2021","Ealing 043","E02006970",5663,1778,3319,3305,3278,27,14,10,4,112,112,0,232,232,0,222,222,0
"2021","Ealing 044","E02006971",6497,2081,3674,3654,3639,15,20,18,2,95,95,0,286,286,0,361,361,0
"2021","Enfield 001","E02000277",5727,2480,2288,2284,2275,9,4,4,0,171,169,2,457,456,1,331,331,0
"2021","Enfield 002","E02000278",7153,3184,2693,2670,2659,11,23,16,7,235,233,2,675,675,0,366,366,0
"2021","Enfield 003","E02000279",9081,4404,3149,3135,3119,16,14,4,10,396,396,0,821,819,2,311,310,1
"2021","Enfield 004","E02000280",6737,2576,2973,2954,2942,12,19,10,9,163,163,0,598,598,0,427,427,0
"2021","Enfield 005","E02000281",7377,3228,2936,2912,2897,15,24,12,12,199,198,1,683,681,2,331,331,0
"2021","Enfield 006","E02000282",7159,3271,2598,2594,2591,3,4,4,0,264,263,1,716,716,0,310,308,2
"2021","Enfield 007","E02000283",6498,2807,2646,2644,2639,5,2,2,0,208,208,0,556,556,0,281,281,0
"2021","Enfield 008","E02000284",6915,2744,3014,2989,2969,20,25,10,15,167,164,3,662,660,2,328,328,0
"2021","Enfield 009","E02000285",5375,1701,2901,2892,2882,10,9,3,6,81,79,2,379,378,1,313,313,0
"2021","Enfield 010","E02000286",7075,2522,3231,3221,3203,18,10,6,4,141,140,1,668,668,0,513,510,3
"2021","Enfield 011","E02000287",6018,1784,3279,3276,3266,10,3,0,3,105,104,1,408,408,0,442,441,1
"2021","Enfield 012","E02000288",9489,4110,3940,3928,3911,17,12,8,4,345,342,3,677,677,0,417,417,0
"2021","Enfield 013","E02000289",5470,1637,3078,3063,3056,7,15,3,12,96,96,0,341,341,0,318,318,0
"2021","Enfield 014","E02000290",4854,2323,1709,1703,1697,6,6,4,2,195,195,0,442,441,1,185,185,0
"2021","Enfield 015","E02000291",8046,3518,3135,3117,3098,19,18,2,16,250,249,1,724,720,4,419,419,0
"2021","Enfield 016","E02000292",7614,3073,3279,3268,3244,24,11,4,7,215,215,0,642,642,0,405,405,0
"2021","Enfield 017","E02000293",5220,1573,2939,2923,2920,3,16,8,8,86,86,0,303,302,1,319,319,0
"2021","Enfield 018","E02000294",7190,2973,2988,2979,2973,6,9,6,3,243,243,0,603,603,0,383,383,0
"2021","Enfield 019","E02000295",6893,2435,3359,3348,3335,13,11,4,7,143,143,0,545,544,1,411,411,0
"2021","Enfield 020","E02000296",8268,3199,3673,3654,3628,26,19,8,11,204,203,1,677,676,1,515,512,3
"2021","Enfield 021","E02000297",7728,2453,4064,4050,4038,12,14,2,12,130,129,1,577,576,1,504,504,0
"2021","Enfield 022","E02000298",6675,2145,3627,3608,3591,17,19,12,7,97,97,0,454,453,1,352,350,2
"2021","Enfield 023","E02000299",7143,3155,2734,2725,2715,10,9,7,2,255,253,2,637,635,2,362,359,3
"2021","Enfield 024","E02000300",6742,2898,2754,2729,2716,13,25,10,15,213,213,0,580,580,0,297,297,0
"2021","Enfield 025","E02000301",7750,3528,2780,2762,2746,16,18,14,4,315,315,0,799,798,1,328,328,0
"2021","Enfield 026","E02000302",6995,2680,3203,3196,3185,11,7,4,3,207,207,0,504,504,0,401,401,0
"2021","Enfield 027","E02000303",6474,2951,2405,2395,2385,10,10,8,2,253,250,3,572,571,1,293,293,0
"2021","Enfield 028","E02000304",6550,1980,3601,3582,3568,14,19,10,9,145,145,0,417,415,2,407,406,1
"2021","Enfield 029","E02000305",7311,2903,3285,3256,3240,16,29,16,13,165,165,0,667,666,1,291,291,0
"2021","Enfield 030","E02000306",6842,3206,2322,2319,2309,10,3,2,1,315,315,0,716,714,2,283,283,0
"2021","Enfield 031","E02000307",7820,3083,3549,3542,3536,6,7,4,3,270,269,1,546,546,0,372,372,0
"2021","Enfield 032","E02000308",7050,3220,2798,2770,2751,19,28,16,12,176,172,4,557,555,2,299,297,2
"2021","Enfield 033","E02000309",8800,3832,3458,3448,3433,15,10,4,6,308,308,0,767,765,2,435,435,0
"2021","Enfield 035","E02000311",8511,3532,3671,3648,3633,15,23,14,9,258,257,1,638,638,0,412,412,0
"2021","Enfield 036","E02000312",9319,4205,3771,3745,3724,21,26,4,22,221,221,0,716,711,5,406,403,3
"2021","Enfield 037","E02006793",7326,3338,2753,2743,2736,7,10,6,4,233,230,3,685,684,1,317,317,0
"2021","Greenwich 001","E02000313",4863,2260,1592,1587,1577,10,5,5,0,267,267,0,567,566,1,177,177,0
"2021","Greenwich 002","E02000314",10652,5353,3660,3631,3617,14,29,14,15,463,460,3,896,892,4,280,279,1
"2021","Greenwich 003","E02000315",7288,3369,2655,2646,2622,24,9,4,5,299,297,2,645,641,4,320,319,1
"2021","Greenwich 005","E02000317",5794,2814,2004,1991,1968,23,13,2,11,197,194,3,537,536,1,242,242,0
"2021","Greenwich 006","E02000318",8718,3387,4104,4085,4055,30,19,10,9,287,281,6,601,600,1,339,339,0
"2021","Greenwich 007","E02000319",8330,3820,3143,3117,3074,43,26,12,14,273,272,1,774,771,3,320,320,0
"2021","Greenwich 008","E02000320",5481,2493,2200,2185,2166,19,15,8,7,144,143,1,429,425,4,215,215,0
"2021","Greenwich 009","E02000321",5980,2855,2007,1998,1979,19,9,8,1,230,230,0,586,583,3,302,302,0
"2021","Greenwich 011","E02000323",9960,4850,3544,3518,3478,40,26,12,14,342,340,2,888,887,1,336,336,0
"2021","Greenwich 012","E02000324",6119,2946,2235,2225,2193,32,10,4,6,173,168,5,517,515,2,248,248,0
"2021","Greenwich 014","E02000326",6276,3041,2321,2300,2257,43,21,6,15,162,160,2,529,525,4,223,216,7
"2021","Greenwich 015","E02000327",5129,2570,1725,1712,1703,9,13,4,9,211,209,2,481,480,1,142,142,0
"2021","Greenwich 016","E02000328",5353,2381,2174,2152,2128,24,22,9,13,136,132,4,429,428,1,233,231,2
"2021","Greenwich 017","E02000329",5034,2029,2133,2120,2092,28,13,3,10,147,145,2,442,442,0,283,283,0
"2021","Greenwich 019","E02000331",6480,3048,2453,2437,2409,28,16,8,8,164,161,3,547,545,2,268,268,0
"2021","Greenwich 020","E02000332",5926,2384,2610,2591,2550,41,19,6,13,145,144,1,494,489,5,293,292,1
"2021","Greenwich 021","E02000333",5124,2077,2237,2207,2144,63,30,8,22,119,118,1,468,467,1,223,223,0
"2021","Greenwich 022","E02000334",5322,2163,2319,2299,2275,24,20,8,12,130,130,0,462,459,3,248,248,0
"2021","Greenwich 023","E02000335",5282,1786,2628,2616,2575,41,12,2,10,122,121,1,446,445,1,300,300,0
"2021","Greenwich 025","E02000337",6645,2813,2633,2615,2601,14,18,6,12,218,218,0,619,618,1,362,362,0
"2021","Greenwich 027","E02000339",5083,1865,2356,2342,2325,17,14,4,10,114,114,0,430,427,3,318,318,0
"2021","Greenwich 028","E02000340",5611,2173,2463,2443,2427,16,20,14,6,129,128,1,481,480,1,365,364,1
"2021","Greenwich 029","E02000341",6042,2707,2351,2334,2317,17,17,8,9,163,163,0,554,554,0,267,267,0
"2021","Greenwich 030","E02000342",5104,2606,1822,1811,1803,8,11,4,7,94,93,1,373,370,3,209,209,0
"2021","Greenwich 031","E02000343",5605,2275,2397,2387,2382,5,10,3,7,118,118,0,457,457,0,358,357,1
"2021","Greenwich 032","E02000344",5172,1886,2528,2525,2504,21,3,0,3,112,111,1,355,353,2,291,290,1
"2021","Greenwich 033","E02006786",5864,2572,2291,2280,2266,14,11,1,10,211,211,0,536,533,3,254,252,2
"2021","Greenwich 034","E02006927",9909,4310,4158,4121,4095,26,37,4,33,212,208,4,769,762,7,460,460,0
"2021","Greenwich 035","E02006928",10280,6598,2676,2646,2579,67,30,16,14,278,273,5,591,583,8,137,135,2
"2021","Greenwich 037","E02006930",8123,4376,2839,2807,2736,71,32,12,20,159,156,3,542,536,6,207,205,2
"2021","Greenwich 038","E02006931",7861,3979,2857,2811,2755,56,46,12,34,167,163,4,594,582,12,264,263,1
"2021","Greenwich 039","E02006991",5635,3331,1777,1752,1672,80,25,6,19,122,119,3,338,335,3,67,67,0
"2021","Greenwich 040","E02006992",6795,3703,2325,2298,2247,51,27,8,19,125,125,0,482,474,8,160,157,3
"2021","Greenwich 041","E02006993",6849,4142,2103,2071,2022,49,32,8,24,147,144,3,367,364,3,90,89,1
"2021","Greenwich 042","E02006994",6052,3145,1959,1943,1925,18,16,7,9,250,249,1,539,539,0,159,159,0
"2021","Hackney 001","E02000345",5361,2047,2681,2666,2653,13,15,6,9,154,153,1,318,317,1,161,160,1
"2021","Hackney 002","E02000346",7515,4418,2010,1959,1931,28,51,32,19,296,294,2,579,576,3,212,210,2
"2021","Hackney 003","E02000347",5504,2514,2353,2339,2326,13,14,4,10,114,112,2,328,325,3,195,194,1
"2021","Hackney 004","E02000348",5397,2372,2270,2251,2222,29,19,14,5,169,169,0,402,402,0,184,184,0
"2021","Hackney 006","E02000350",8129,4689,2718,2681,2654,27,37,9,28,144,140,4,418,414,4,160,160,0
"2021","Hackney 007","E02000351",7939,5061,2000,1960,1920,40,40,18,22,218,212,6,504,494,10,156,153,3
"2021","Hackney 008","E02000352",5262,2889,1626,1599,1583,16,27,9,18,113,113,0,457,454,3,177,177,0
"2021","Hackney 009","E02000353",6483,3788,2043,1974,1932,42,69,36,33,115,112,3,363,359,4,174,171,3
"2021","Hackney 010","E02000354",8004,4990,2008,1967,1922,45,41,7,34,214,213,1,566,556,10,226,226,0
"2021","Hackney 011","E02000355",6788,3947,2034,1993,1941,52,41,12,29,154,149,5,431,428,3,222,222,0
"2021","Hackney 012","E02000356",5906,3492,1758,1711,1674,37,47,20,27,124,119,5,379,377,2,153,152,1
"2021","Hackney 013","E02000357",5384,3072,1334,1319,1308,11,15,4,11,218,218,0,540,539,1,220,219,1
"2021","Hackney 014","E02000358",9405,5839,2346,2295,2250,45,51,12,39,257,251,6,684,678,6,279,279,0
"2021","Hackney 015","E02000359",5388,3164,1568,1550,1516,34,18,10,8,144,141,3,332,328,4,180,180,0
"2021","Hackney 016","E02000360",9217,5609,2291,2254,2215,39,37,9,28,311,311,0,729,729,0,277,276,1
"2021","Hackney 017","E02000361",6867,4599,1446,1427,1382,45,19,11,8,224,220,4,446,435,11,152,150,2
"2021","Hackney 018","E02000362",5811,3757,1300,1286,1261,25,14,6,8,176,173,3,404,403,1,174,174,0
"2021","Hackney 019","E02000363",9157,5555,2291,2276,2240,36,15,8,7,338,334,4,697,692,5,276,275,1
"2021","Hackney 020","E02000364",7784,4796,1855,1809,1744,65,46,17,29,242,240,2,624,617,7,267,266,1
"2021","Hackney 022","E02000366",6859,4086,1776,1740,1706,34,36,12,24,227,225,2,514,510,4,256,256,0
"2021","Hackney 023","E02000367",8892,6036,1906,1860,1809,51,46,18,28,213,211,2,543,534,9,194,194,0
"2021","Hackney 024","E02000368",8183,4976,2027,2003,1972,31,24,9,15,279,276,3,625,616,9,276,275,1
"2021","Hackney 025","E02000369",11251,7138,2656,2591,2535,56,65,20,45,353,350,3,783,774,9,321,321,0
"2021","Hackney 026","E02000370",7452,4846,1693,1664,1628,36,29,6,23,212,209,3,522,520,2,179,179,0
"2021","Hackney 028","E02006918",6335,3693,1788,1770,1748,22,18,6,12,231,228,3,427,423,4,196,195,1
"2021","Hackney 029","E02006921",5554,2693,2118,2101,2078,23,17,4,13,199,195,4,390,386,4,154,154,0
"2021","Hackney 030","E02007108",5312,3768,1071,1038,1004,34,33,10,23,86,82,4,285,279,6,102,102,0
"2021","Hackney 031","E02007109",6489,3930,1703,1650,1611,39,53,13,40,172,170,2,467,460,7,217,216,1
"2021","Hackney 032","E02007110",6354,4308,1365,1327,1296,31,38,6,32,181,177,4,395,389,6,105,105,0
"2021","Hackney 033","E02007111",5462,4122,922,876,815,61,46,11,35,104,99,5,265,259,6,49,49,0
"2021","Hammersmith and Fulham 001","E02000372",8510,5065,2290,2271,2236,35,19,6,13,218,214,4,641,638,3,296,293,3
"2021","Hammersmith and Fulham 002","E02000373",5463,2988,1645,1637,1634,3,8,2,6,182,182,0,457,456,1,191,190,1
"2021","Hammersmith and Fulham 003","E02000374",5625,3194,1705,1689,1661,28,16,4,12,123,123,0,386,382,4,217,216,1
"2021","Hammersmith and Fulham 004","E02000375",6299,3794,1667,1648,1624,24,19,6,13,163,160,3,509,509,0,166,164,2
"2021","Hammersmith and Fulham 005","E02000376",5834,3641,1465,1443,1405,38,22,6,16,159,155,4,417,410,7,152,152,0
"2021","Hammersmith and Fulham 006","E02000377",6579,3894,1810,1776,1748,28,34,8,26,160,158,2,524,522,2,191,189,2
"2021","Hammersmith and Fulham 007","E02000378",5583,3340,1542,1507,1472,35,35,4,31,133,132,1,448,447,1,120,118,2
"2021","Hammersmith and Fulham 008","E02000379",5969,2774,2382,2366,2329,37,16,8,8,122,122,0,458,454,4,233,230,3
"2021","Hammersmith and Fulham 009","E02000380",4569,2303,1704,1683,1649,34,21,4,17,85,84,1,342,339,3,135,135,0
"2021","Hammersmith and Fulham 010","E02000381",6313,3321,2260,2231,2209,22,29,10,19,136,134,2,431,430,1,165,164,1
"2021","Hammersmith and Fulham 011","E02000382",5261,2706,1860,1822,1782,40,38,3,35,119,117,2,411,408,3,165,162,3
"2021","Hammersmith and Fulham 012","E02000383",7527,4379,2153,2102,2060,42,51,18,33,136,132,4,578,573,5,281,280,1
"2021","Hammersmith and Fulham 013","E02000384",7140,4367,1839,1796,1774,22,43,18,25,181,179,2,536,534,2,217,214,3
"2021","Hammersmith and Fulham 014","E02000385",5097,3458,1133,1104,1061,43,29,5,24,88,86,2,324,318,6,94,92,2
"2021","Hammersmith and Fulham 015","E02000386",6443,3950,1556,1521,1495,26,35,10,25,190,190,0,523,521,2,224,223,1
"2021","Hammersmith and Fulham 016","E02000387",5220,3203,1352,1334,1314,20,18,4,14,108,107,1,398,396,2,159,159,0
"2021","Hammersmith and Fulham 017","E02000388",7593,4567,2126,2077,2030,47,49,17,32,155,152,3,514,509,5,231,227,4
"2021","Hammersmith and Fulham 018","E02000389",7310,3692,2763,2723,2691,32,40,4,36,90,90,0,496,495,1,269,266,3
"2021","Hammersmith and Fulham 019","E02000390",5290,3114,1580,1560,1546,14,20,0,20,100,96,4,341,340,1,155,154,1
"2021","Hammersmith and Fulham 020","E02000391",6250,3096,2324,2304,2288,16,20,8,12,124,124,0,477,477,0,229,224,5
"2021","Hammersmith and Fulham 021","E02000392",7696,4381,2453,2426,2395,31,27,12,15,169,166,3,498,495,3,195,193,2
"2021","Hammersmith and Fulham 022","E02000393",4985,2702,1782,1763,1746,17,19,4,15,82,82,0,290,287,3,129,129,0
"2021","Hammersmith and Fulham 023","E02000394",7720,4342,2373,2357,2327,30,16,2,14,180,178,2,626,624,2,199,199,0
"2021","Hammersmith and Fulham 024","E02000395",4877,2415,1886,1846,1826,20,40,18,22,59,58,1,309,308,1,208,207,1
"2021","Hammersmith and Fulham 025","E02000396",5474,2697,2092,2059,2034,25,33,6,27,107,107,0,418,414,4,160,160,0
"2021","Haringey 001","E02000397",6542,3369,2150,2123,2107,16,27,14,13,180,180,0,600,592,8,243,241,2
"2021","Haringey 002","E02000398",5925,3009,1772,1750,1732,18,22,12,10,227,226,1,674,674,0,243,242,1
"2021","Haringey 004","E02000400",6357,3083,2315,2282,2254,28,33,9,24,153,152,1,551,548,3,255,253,2
"2021","Haringey 005","E02000401",5605,2859,1844,1834,1824,10,10,2,8,183,183,0,500,496,4,219,218,1
"2021","Haringey 006","E02000402",5191,2583,1680,1670,1666,4,10,6,4,230,228,2,476,476,0,222,221,1
"2021","Haringey 007","E02000403",6216,3186,2143,2114,2096,18,29,16,13,149,146,3,510,505,5,228,226,2
"2021","Haringey 008","E02000404",5905,2957,2029,2013,1995,18,16,8,8,167,162,5,512,508,4,240,239,1
"2021","Haringey 009","E02000405",4983,1903,2506,2486,2473,13,20,8,12,73,73,0,307,306,1,194,194,0
"2021","Haringey 010","E02000406",5744,3163,1673,1649,1636,13,24,6,18,168,165,3,514,513,1,226,226,0
"2021","Haringey 011","E02000407",6172,3300,1859,1845,1812,33,14,10,4,212,208,4,579,577,2,222,222,0
"2021","Haringey 012","E02000408",6476,3154,2101,2091,2069,22,10,8,2,243,243,0,709,708,1,269,269,0
"2021","Haringey 013","E02000409",5011,2555,1599,1586,1578,8,13,6,7,198,195,3,468,468,0,191,191,0
"2021","Haringey 014","E02000410",5196,2297,2268,2243,2217,26,25,10,15,111,109,2,370,365,5,150,148,2
"2021","Haringey 015","E02000411",9370,5390,2718,2698,2662,36,20,8,12,301,298,3,713,709,4,248,247,1
"2021","Haringey 016","E02000412",6304,3556,1655,1641,1618,23,14,2,12,263,262,1,606,605,1,224,224,0
"2021","Haringey 017","E02000413",6036,2495,2783,2750,2722,28,33,14,19,124,124,0,408,408,0,226,226,0
"2021","Haringey 018","E02000414",5844,2996,1965,1937,1904,33,28,6,22,183,182,1,483,476,7,217,215,2
"2021","Haringey 019","E02000415",6068,3203,2078,2049,2013,36,29,8,21,149,146,3,417,415,2,221,219,2
"2021","Haringey 020","E02000416",7086,4047,2043,2001,1973,28,42,16,26,172,166,6,611,604,7,213,213,0
"2021","Haringey 021","E02000417",5444,2380,2312,2272,2249,23,40,12,28,106,106,0,428,427,1,218,216,2
"2021","Haringey 022","E02000418",4448,1732,2145,2107,2087,20,38,7,31,69,67,2,319,316,3,183,181,2
"2021","Haringey 023","E02000419",7403,4166,2277,2246,2203,43,31,6,25,169,164,5,539,532,7,252,251,1
"2021","Haringey 024","E02000420",6757,3695,1978,1952,1901,51,26,12,14,219,216,3,611,609,2,254,254,0
"2021","Haringey 025","E02000421",7076,4058,1974,1960,1938,22,14,6,8,231,226,5,580,579,1,233,233,0
"2021","Haringey 026","E02000422",6025,3195,1865,1836,1824,12,29,9,20,208,208,0,565,561,4,192,191,1
"2021","Haringey 027","E02000423",5950,3537,1658,1624,1578,46,34,16,18,144,142,2,416,410,6,195,194,1
"2021","Haringey 028","E02000424",5649,2944,1926,1890,1849,41,36,14,22,190,189,1,426,426,0,163,163,0
"2021","Haringey 029","E02000425",5115,2131,2352,2342,2318,24,10,2,8,151,149,2,314,314,0,167,167,0
"2021","Haringey 030","E02000426",5321,2265,2335,2313,2304,9,22,4,18,93,92,1,386,385,1,242,242,0
"2021","Haringey 031","E02000427",5779,3397,1694,1640,1618,22,54,10,44,130,127,3,370,370,0,188,185,3
"2021","Haringey 032","E02000428",6846,4084,1842,1819,1809,10,23,6,17,231,228,3,496,493,3,193,190,3
"2021","Haringey 033","E02000429",5623,2527,2334,2288,2262,26,46,12,34,118,117,1,417,408,9,227,224,3
"2021","Haringey 034","E02000430",5826,3269,1836,1817,1790,27,19,8,11,100,98,2,484,479,5,137,136,1
"2021","Haringey 035","E02000431",5086,2693,1776,1749,1719,30,27,6,21,92,89,3,375,373,2,150,149,1
"2021","Haringey 036","E02000432",5341,3221,1454,1371,1331,40,83,55,28,100,97,3,422,418,4,144,142,2
"2021","Haringey 037","E02006794",6274,3266,1949,1929,1918,11,20,6,14,203,202,1,629,628,1,227,226,1
"2021","Harrow 001","E02000433",7180,2055,3908,3903,3886,17,5,2,3,113,113,0,469,468,1,635,634,1
"2021","Harrow 002","E02000434",8107,2660,4410,4408,4402,6,2,2,0,124,123,1,452,450,2,461,460,1
"2021","Harrow 003","E02000435",6575,2119,3541,3539,3531,8,2,2,0,127,127,0,365,365,0,423,423,0
"2021","Harrow 004","E02000436",4821,1151,3056,3052,3040,12,4,2,2,48,48,0,223,223,0,343,343,0
"2021","Harrow 005","E02000437",7064,2257,3651,3643,3633,10,8,8,0,178,177,1,510,510,0,468,468,0
"2021","Harrow 006","E02000438",6701,2194,3464,3454,3443,11,10,4,6,116,115,1,453,453,0,474,474,0
"2021","Harrow 007","E02000439",7347,2639,3804,3798,3780,18,6,6,0,130,130,0,446,445,1,328,328,0
"2021","Harrow 008","E02000440",7701,2180,4648,4638,4634,4,10,8,2,113,113,0,347,347,0,413,413,0
"2021","Harrow 009","E02000441",5983,1886,3188,3184,3177,7,4,0,4,125,125,0,395,392,3,389,389,0
"2021","Harrow 010","E02000442",7699,2554,4296,4287,4285,2,9,6,3,120,120,0,402,402,0,327,325,2
"2021","Harrow 011","E02000443",8385,3141,4052,4048,4034,14,4,4,0,211,208,3,533,533,0,448,445,3
"2021","Harrow 012","E02000444",6909,2099,4031,4024,4020,4,7,6,1,115,115,0,287,287,0,377,377,0
"2021","Harrow 013","E02000445",9152,3340,4564,4549,4536,13,15,8,7,205,199,6,557,557,0,486,486,0
"2021","Harrow 015","E02000447",6478,1998,3741,3739,3732,7,2,2,0,99,99,0,320,320,0,320,319,1
"2021","Harrow 016","E02000448",5646,1590,3258,3243,3231,12,15,6,9,111,111,0,316,316,0,371,370,1
"2021","Harrow 017","E02000449",6807,2286,3724,3720,3705,15,4,4,0,89,89,0,333,333,0,375,375,0
"2021","Harrow 019","E02000451",5478,1520,3310,3307,3297,10,3,0,3,73,73,0,247,246,1,328,328,0
"2021","Harrow 020","E02000452",7530,2961,3649,3630,3613,17,19,13,6,172,172,0,489,489,0,259,259,0
"2021","Harrow 021","E02000453",6694,2409,3501,3491,3484,7,10,2,8,133,133,0,378,377,1,273,272,1
"2021","Harrow 022","E02000454",5732,1418,3716,3709,3707,2,7,3,4,64,64,0,243,243,0,291,291,0
"2021","Harrow 023","E02000455",9518,3502,4888,4879,4850,29,9,4,5,173,170,3,588,587,1,367,366,1
"2021","Harrow 024","E02000456",6401,2422,3165,3165,3151,14,0,0,0,109,109,0,348,346,2,357,355,2
"2021","Harrow 025","E02000457",5777,1851,3206,3196,3190,6,10,4,6,89,89,0,294,294,0,337,336,1
"2021","Harrow 027","E02000459",7344,2691,3520,3510,3506,4,10,4,6,202,200,2,558,558,0,373,371,2
"2021","Harrow 028","E02000460",5672,2172,2775,2771,2769,2,4,4,0,132,132,0,343,342,1,250,250,0
"2021","Harrow 029","E02000461",5813,2338,2684,2673,2658,15,11,2,9,119,118,1,390,390,0,282,282,0
"2021","Harrow 030","E02000462",5647,1968,2970,2961,2947,14,9,6,3,113,112,1,299,299,0,297,297,0
"2021","Harrow 031","E02000463",6937,2499,3522,3508,3494,14,14,12,2,142,141,1,443,443,0,331,331,0
"2021","Harrow 032","E02006795",6607,2096,3824,3813,3803,10,11,4,7,84,84,0,269,269,0,334,334,0
"2021","Harrow 033","E02006882",11918,3626,6856,6848,6831,17,8,2,6,150,150,0,555,555,0,731,731,0
"2021","Havering 001","E02000464",6064,2387,2540,2532,2515,17,8,4,4,170,168,2,574,574,0,393,392,1
"2021","Havering 002","E02000465",7117,3063,2898,2882,2866,16,16,8,8,154,153,1,677,676,1,325,325,0
"2021","Havering 003","E02000466",7135,2887,3044,3035,3021,14,9,6,3,140,138,2,606,606,0,458,458,0
"2021","Havering 004","E02000467",8363,3951,2904,2901,2890,11,3,2,1,254,253,1,859,855,4,395,394,1
"2021","Havering 005","E02000468",6808,2453,3157,3153,3147,6,4,4,0,156,155,1,604,602,2,438,438,0
"2021","Havering 006","E02000469",5589,2299,2306,2304,2294,10,2,0,2,133,133,0,516,516,0,335,335,0
"2021","Havering 007","E02000470",8047,3013,3663,3654,3629,25,9,2,7,153,153,0,685,682,3,533,533,0
"2021","Havering 008","E02000471",6486,1902,3628,3623,3615,8,5,0,5,89,88,1,381,380,1,486,486,0
"2021","Havering 009","E02000472",7570,2508,3911,3906,3898,8,5,4,1,138,138,0,535,535,0,478,478,0
"2021","Havering 010","E02000473",8381,2942,4181,4179,4175,4,2,0,2,165,163,2,597,596,1,496,496,0
"2021","Havering 011","E02000474",7205,2792,3213,3199,3184,15,14,6,8,156,154,2,583,583,0,461,460,1
"2021","Havering 012","E02000475",7904,2738,3955,3941,3935,6,14,14,0,142,141,1,565,564,1,504,504,0
"2021","Havering 013","E02000476",7552,3345,2983,2969,2950,19,14,2,12,181,180,1,649,646,3,394,394,0
"2021","Havering 014","E02000477",7888,2635,4086,4086,4077,9,0,0,0,115,113,2,542,542,0,510,510,0
"2021","Havering 015","E02000478",5091,1328,3063,3061,3060,1,2,2,0,65,65,0,258,257,1,377,377,0
"2021","Havering 016","E02000479",7503,3265,3076,3061,3035,26,15,6,9,169,169,0,643,640,3,350,349,1
"2021","Havering 017","E02000480",10616,4605,4508,4486,4457,29,22,6,16,240,239,1,752,751,1,511,511,0
"2021","Havering 018","E02000481",6658,2097,3348,3344,3329,15,4,2,2,122,122,0,528,528,0,563,562,1
"2021","Havering 019","E02000482",5411,1432,3157,3156,3151,5,1,0,1,72,72,0,297,295,2,453,453,0
"2021","Havering 020","E02000483",6637,2413,2949,2939,2929,10,10,4,6,94,94,0,633,632,1,548,547,1
"2021","Havering 021","E02000484",7004,2379,3578,3574,3565,9,4,2,2,96,96,0,531,527,4,420,420,0
"2021","Havering 022","E02000485",6883,2411,3348,3342,3330,12,6,0,6,127,127,0,570,570,0,427,427,0
"2021","Havering 023","E02000486",6169,2142,2976,2967,2961,6,9,6,3,94,94,0,485,483,2,472,472,0
"2021","Havering 024","E02000487",6598,1762,3998,3988,3977,11,10,4,6,58,58,0,308,308,0,472,472,0
"2021","Havering 025","E02000488",6347,1953,3419,3406,3398,8,13,7,6,84,83,1,427,426,1,464,462,2
"2021","Havering 026","E02000489",6868,2477,3263,3257,3251,6,6,4,2,114,112,2,574,574,0,440,439,1
"2021","Havering 027","E02000490",6775,2548,3080,3075,3066,9,5,4,1,127,127,0,510,510,0,510,510,0
"2021","Havering 028","E02000491",8250,3500,3427,3405,3389,16,22,13,9,187,186,1,680,677,3,456,456,0
"2021","Havering 029","E02000492",5626,1958,2730,2720,2714,6,10,2,8,98,98,0,400,400,0,440,440,0
"2021","Havering 030","E02000493",5183,2160,2156,2149,2138,11,7,6,1,124,124,0,441,439,2,302,302,0
"2021","Hillingdon 001","E02000494",6588,1638,3904,3894,3883,11,10,3,7,117,114,3,500,499,1,429,429,0
"2021","Hillingdon 002","E02000495",8386,2788,4171,4169,4141,28,2,0,2,161,159,2,751,751,0,515,515,0
"2021","Hillingdon 003","E02000496",6383,2434,2767,2762,2750,12,5,0,5,148,148,0,626,625,1,408,408,0
"2021","Hillingdon 004","E02000497",7608,2602,3807,3788,3770,18,19,11,8,139,137,2,594,594,0,466,466,0
"2021","Hillingdon 005","E02000498",5178,1699,2608,2596,2590,6,12,6,6,86,86,0,463,463,0,322,321,1
"2021","Hillingdon 006","E02000499",6368,1832,3643,3619,3608,11,24,14,10,74,73,1,388,388,0,431,431,0
"2021","Hillingdon 007","E02000500",6923,2132,3820,3805,3792,13,15,6,9,100,100,0,410,409,1,461,461,0
"2021","Hillingdon 008","E02000501",6807,2240,3615,3585,3557,28,30,20,10,91,89,2,460,460,0,401,401,0
"2021","Hillingdon 009","E02000502",7023,2420,3561,3536,3521,15,25,17,8,120,120,0,516,516,0,406,406,0
"2021","Hillingdon 010","E02000503",6955,2353,3660,3631,3621,10,29,24,5,115,114,1,473,470,3,354,354,0
"2021","Hillingdon 011","E02000504",6152,1717,3551,3544,3531,13,7,4,3,86,86,0,383,383,0,415,415,0
"2021","Hillingdon 013","E02000506",6581,1920,3743,3734,3725,9,9,6,3,93,92,1,345,345,0,480,478,2
"2021","Hillingdon 014","E02000507",6405,2215,3321,3321,3312,9,0,0,0,102,102,0,416,416,0,351,351,0
"2021","Hillingdon 015","E02000508",9803,5031,3636,3606,3580,26,30,13,17,196,196,0,647,643,4,293,293,0
"2021","Hillingdon 016","E02000509",8854,5207,2627,2612,2591,21,15,10,5,196,195,1,535,533,2,289,288,1
"2021","Hillingdon 017","E02000510",7315,2590,3626,3619,3601,18,7,4,3,143,143,0,560,558,2,396,396,0
"2021","Hillingdon 018","E02000511",7801,2650,4079,4075,4071,4,4,4,0,149,148,1,481,481,0,442,442,0
"2021","Hillingdon 019","E02000512",6813,2766,3008,3001,2995,6,7,2,5,156,154,2,556,556,0,327,327,0
"2021","Hillingdon 020","E02000513",7180,2738,3368,3359,3344,15,9,8,1,214,214,0,561,561,0,299,299,0
"2021","Hillingdon 021","E02000514",8232,2714,4587,4572,4563,9,15,12,3,141,140,1,423,423,0,367,367,0
"2021","Hillingdon 022","E02000515",10426,4731,4234,4204,4178,26,30,12,18,248,248,0,834,831,3,379,378,1
"2021","Hillingdon 023","E02000516",6707,2378,3413,3405,3396,9,8,5,3,159,158,1,465,464,1,292,292,0
"2021","Hillingdon 024","E02000517",7944,2980,3827,3814,3808,6,13,6,7,166,166,0,581,580,1,390,389,1
"2021","Hillingdon 025","E02000518",7375,3169,2985,2971,2961,10,14,12,2,180,179,1,664,663,1,377,377,0
"2021","Hillingdon 026","E02000519",7319,2586,3651,3649,3649,0,2,2,0,162,161,1,536,536,0,384,384,0
"2021","Hillingdon 027","E02000520",10789,4075,5310,5294,5274,20,16,16,0,258,258,0,636,635,1,510,506,4
"2021","Hillingdon 028","E02000521",10055,3939,4814,4802,4797,5,12,7,5,211,208,3,697,696,1,394,394,0
"2021","Hillingdon 029","E02000522",7394,2932,3330,3311,3297,14,19,10,9,183,183,0,577,577,0,372,372,0
"2021","Hillingdon 030","E02000523",9035,3195,4722,4705,4666,39,17,10,7,197,196,1,554,554,0,367,367,0
"2021","Hillingdon 031","E02000524",6059,2298,2768,2753,2742,11,15,7,8,152,152,0,523,522,1,318,318,0
"2021","Hillingdon 032","E02000525",7705,2710,3898,3870,3859,11,28,24,4,224,220,4,551,551,0,322,321,1
"2021","Hillingdon 033","E02006796",7721,2865,3735,3680,3673,7,55,50,5,172,170,2,547,546,1,402,402,0
"2021","Hounslow 001","E02000526",7176,3002,3291,3245,3181,64,46,10,36,149,148,1,479,476,3,255,254,1
"2021","Hounslow 004","E02000529",7554,2502,4021,4005,3994,11,16,14,2,224,223,1,439,439,0,368,368,0
"2021","Hounslow 005","E02000530",6038,2203,2939,2931,2921,10,8,8,0,183,182,1,411,409,2,302,302,0
"2021","Hounslow 006","E02000531",9420,4292,3784,3742,3712,30,42,6,36,207,205,2,781,776,5,356,356,0
"2021","Hounslow 007","E02000532",7287,2905,3335,3290,3254,36,45,14,31,157,156,1,565,565,0,325,321,4
"2021","Hounslow 008","E02000533",6766,2824,2914,2886,2854,32,28,8,20,136,136,0,638,635,3,254,253,1
"2021","Hounslow 009","E02000534",6940,2565,3491,3467,3455,12,24,0,24,148,137,11,435,431,4,301,301,0
"2021","Hounslow 010","E02000535",8111,2508,4452,4440,4426,14,12,8,4,144,144,0,492,492,0,515,515,0
"2021","Hounslow 011","E02000536",8699,3028,4494,4486,4464,22,8,6,2,210,209,1,473,473,0,494,493,1
"2021","Hounslow 012","E02000537",8136,2809,4366,4356,4342,14,10,4,6,145,144,1,453,451,2,363,362,1
"2021","Hounslow 013","E02000538",8164,2701,4443,4427,4409,18,16,14,2,188,185,3,430,430,0,402,402,0
"2021","Hounslow 014","E02000539",9618,4097,4058,4022,3981,41,36,7,29,246,245,1,867,864,3,350,350,0
"2021","Hounslow 015","E02000540",9508,3610,4536,4497,4479,18,39,12,27,216,213,3,733,726,7,413,412,1
"2021","Hounslow 016","E02000541",8452,2888,4341,4332,4307,25,9,8,1,206,205,1,519,518,1,498,497,1
"2021","Hounslow 017","E02000542",9579,3280,5122,5096,5079,17,26,20,6,194,194,0,548,545,3,435,435,0
"2021","Hounslow 018","E02000543",10898,3730,5791,5757,5731,26,34,20,14,267,266,1,743,741,2,367,367,0
"2021","Hounslow 019","E02000544",7012,2359,3704,3689,3674,15,15,8,7,149,149,0,469,467,2,331,331,0
"2021","Hounslow 020","E02000545",7149,3006,2941,2915,2893,22,26,10,16,202,201,1,687,682,5,313,311,2
"2021","Hounslow 021","E02000546",8184,2877,4267,4262,4249,13,5,0,5,175,173,2,483,483,0,382,382,0
"2021","Hounslow 022","E02000547",8642,3223,4112,4094,4083,11,18,16,2,187,187,0,665,665,0,455,454,1
"2021","Hounslow 023","E02000548",8126,3303,3531,3506,3497,9,25,6,19,251,250,1,675,673,2,366,366,0
"2021","Hounslow 024","E02000549",10112,3765,4901,4870,4846,24,31,18,13,252,249,3,683,680,3,511,511,0
"2021","Hounslow 025","E02000550",8228,3294,3785,3774,3751,23,11,6,5,248,245,3,618,616,2,283,282,1
"2021","Hounslow 026","E02000551",7428,3073,3047,3031,3020,11,16,2,14,229,223,6,783,783,0,296,296,0
"2021","Hounslow 027","E02000552",7191,2836,3277,3265,3247,18,12,5,7,183,181,2,607,607,0,288,287,1
"2021","Hounslow 028","E02000553",5512,2047,2568,2555,2545,10,13,10,3,155,151,4,449,449,0,293,290,3
"2021","Hounslow 029","E02006792",7660,3623,2957,2914,2869,45,43,16,27,150,148,2,610,600,10,320,316,4
"2021","Hounslow 030","E02006972",4292,1978,1696,1679,1650,29,17,6,11,115,114,1,380,378,2,123,123,0
"2021","Hounslow 031","E02006973",6812,3258,2392,2361,2325,36,31,14,17,178,178,0,711,705,6,273,273,0
"2021","Islington 001","E02000554",7638,4691,1856,1828,1790,38,28,6,22,235,232,3,620,618,2,236,235,1
"2021","Islington 002","E02000555",7968,4619,2223,2169,2129,40,54,10,44,213,213,0,602,597,5,311,311,0
"2021","Islington 003","E02000556",9790,6395,2262,2197,2097,100,65,28,37,188,187,1,628,623,5,317,315,2
"2021","Islington 004","E02000557",7461,4552,1769,1738,1702,36,31,14,17,226,223,3,658,650,8,256,256,0
"2021","Islington 005","E02000558",7614,4489,2000,1982,1952,30,18,8,10,222,219,3,637,632,5,266,265,1
"2021","Islington 006","E02000559",7937,4668,2495,2433,2373,60,62,23,39,143,141,2,421,419,2,210,210,0
"2021","Islington 007","E02000560",6405,4299,1413,1371,1329,42,42,14,28,139,136,3,393,386,7,161,159,2
"2021","Islington 008","E02000561",6286,3552,2031,1986,1950,36,45,18,27,104,102,2,422,418,4,177,173,4
"2021","Islington 009","E02000562",6643,3843,1927,1891,1856,35,36,6,30,167,162,5,492,490,2,214,211,3
"2021","Islington 010","E02000563",7235,4556,1705,1666,1634,32,39,10,29,188,180,8,565,559,6,221,220,1
"2021","Islington 011","E02000564",10815,7368,2377,2326,2244,82,51,21,30,229,224,5,640,630,10,201,200,1
"2021","Islington 012","E02000565",7121,4723,1549,1525,1496,29,24,4,20,155,153,2,472,463,9,222,222,0
"2021","Islington 013","E02000566",7239,4192,2245,2175,2127,48,70,18,52,137,135,2,484,482,2,181,179,2
"2021","Islington 014","E02000567",8951,5584,2326,2278,2206,72,48,18,30,159,155,4,630,626,4,252,250,2
"2021","Islington 015","E02000568",9587,6148,2214,2158,2117,41,56,14,42,222,217,5,675,666,9,328,328,0
"2021","Islington 016","E02000569",8235,4837,2269,2224,2150,74,45,14,31,217,216,1,652,649,3,260,258,2
"2021","Islington 017","E02000570",7152,4122,2305,2224,2123,101,81,28,53,121,118,3,456,449,7,148,148,0
"2021","Islington 018","E02000571",7501,4519,2070,2019,1981,38,51,12,39,167,165,2,511,505,6,234,231,3
"2021","Islington 019","E02000572",7146,4401,1761,1725,1698,27,36,26,10,170,166,4,563,557,6,251,250,1
"2021","Islington 020","E02000573",9025,5549,2530,2440,2353,87,90,24,66,157,156,1,546,535,11,243,240,3
"2021","Islington 021","E02000574",7025,4584,1669,1593,1534,59,76,26,50,125,122,3,463,457,6,184,180,4
"2021","Islington 022","E02000575",9879,6538,2229,2147,2050,97,82,22,60,198,191,7,679,667,12,235,235,0
"2021","Islington 023","E02000576",8981,5703,2179,2138,2067,71,41,10,31,205,203,2,624,616,8,270,269,1
"2021","Kensington and Chelsea 001","E02000577",6575,3681,1762,1740,1728,12,22,8,14,279,275,4,548,548,0,305,305,0
"2021","Kensington and Chelsea 002","E02000578",4910,2685,1369,1365,1353,12,4,0,4,148,147,1,454,453,1,254,253,1
"2021","Kensington and Chelsea 003","E02000579",7484,3946,2373,2354,2328,26,19,1,18,169,168,1,705,704,1,291,290,1
"2021","Kensington and Chelsea 004","E02000580",6945,3958,1752,1717,1680,37,35,16,19,176,172,4,775,774,1,284,283,1
"2021","Kensington and Chelsea 005","E02000581",6148,3062,1936,1925,1875,50,11,4,7,215,214,1,673,671,2,262,259,3
"2021","Kensington and Chelsea 006","E02000582",5730,3025,1852,1823,1765,58,29,8,21,102,99,3,570,566,4,181,180,1
"2021","Kensington and Chelsea 007","E02000583",5527,2479,2291,2267,2244,23,24,14,10,104,103,1,436,433,3,217,216,1
"2021","Kensington and Chelsea 008","E02000584",5999,2434,2783,2746,2723,23,37,10,27,94,93,1,490,485,5,198,194,4
"2021","Kensington and Chelsea 009","E02000585",6712,2840,2847,2818,2782,36,29,6,23,164,159,5,594,592,2,267,267,0
"2021","Kensington and Chelsea 010","E02000586",5573,2463,2416,2379,2355,24,37,10,27,183,182,1,360,359,1,151,148,3
"2021","Kensington and Chelsea 011","E02000587",5559,2292,2631,2597,2576,21,34,6,28,72,72,0,362,362,0,202,199,3
"2021","Kensington and Chelsea 012","E02000588",5201,2232,2275,2251,2224,27,24,6,18,95,94,1,392,388,4,207,206,1
"2021","Kensington and Chelsea 013","E02000589",6440,3598,2123,2040,2018,22,83,12,71,105,103,2,464,457,7,150,149,1
"2021","Kensington and Chelsea 014","E02000590",5227,2426,1900,1848,1828,20,52,36,16,109,106,3,551,549,2,241,241,0
"2021","Kensington and Chelsea 015","E02000591",5447,3010,1666,1606,1567,39,60,7,53,118,118,0,480,475,5,173,172,1
"2021","Kensington and Chelsea 016","E02000592",4940,2393,1932,1909,1875,34,23,8,15,78,76,2,403,403,0,134,133,1
"2021","Kensington and Chelsea 017","E02000593",6462,3623,1990,1952,1910,42,38,6,32,159,157,2,509,507,2,181,179,2
"2021","Kensington and Chelsea 018","E02000594",5766,2559,2168,2135,2102,33,33,6,27,102,100,2,572,570,2,365,361,4
"2021","Kensington and Chelsea 019","E02000595",5288,2283,2130,2114,2093,21,16,2,14,100,100,0,500,499,1,275,271,4
"2021","Kensington and Chelsea 020","E02000596",5795,3040,1914,1887,1854,33,27,10,17,155,153,2,491,488,3,195,190,5
"2021","Kensington and Chelsea 021","E02000597",5354,2581,1732,1705,1689,16,27,6,21,149,148,1,613,612,1,279,279,0
"2021","Kingston upon Thames 001","E02000598",6195,1704,3656,3638,3621,17,18,2,16,110,110,0,446,446,0,279,277,2
"2021","Kingston upon Thames 002","E02000599",5786,1793,3241,3233,3216,17,8,2,6,72,72,0,272,271,1,408,402,6
"2021","Kingston upon Thames 003","E02000600",6546,2631,2983,2968,2950,18,15,8,7,135,135,0,530,528,2,267,267,0
"2021","Kingston upon Thames 004","E02000601",9213,3429,4670,4637,4609,28,33,15,18,174,174,0,644,642,2,296,294,2
"2021","Kingston upon Thames 005","E02000602",8265,4174,2972,2944,2911,33,28,11,17,197,196,1,639,638,1,283,283,0
"2021","Kingston upon Thames 006","E02000603",6855,3004,2931,2918,2904,14,13,6,7,145,144,1,483,483,0,292,291,1
"2021","Kingston upon Thames 007","E02000604",7285,2495,3840,3814,3790,24,26,3,23,126,124,2,531,531,0,293,292,1
"2021","Kingston upon Thames 008","E02000605",6747,2221,3578,3544,3512,32,34,16,18,95,94,1,457,454,3,396,393,3
"2021","Kingston upon Thames 009","E02000606",9127,4884,3124,3072,3045,27,52,16,36,171,169,2,664,661,3,284,278,6
"2021","Kingston upon Thames 010","E02000607",5570,2506,2445,2427,2405,22,18,8,10,72,72,0,333,332,1,214,214,0
"2021","Kingston upon Thames 011","E02000608",6242,3458,1949,1942,1914,28,7,2,5,160,159,1,502,497,5,173,172,1
"2021","Kingston upon Thames 012","E02000609",6213,2086,3304,3295,3290,5,9,3,6,112,111,1,346,345,1,365,365,0
"2021","Kingston upon Thames 013","E02000610",6722,3443,2268,2248,2217,31,20,8,12,123,122,1,580,577,3,308,308,0
"2021","Kingston upon Thames 014","E02000611",5948,1705,3506,3496,3491,5,10,6,4,81,81,0,326,326,0,330,329,1
"2021","Kingston upon Thames 015","E02000612",6763,2028,3853,3834,3818,16,19,0,19,86,83,3,366,366,0,430,430,0
"2021","Kingston upon Thames 016","E02000613",6335,2385,3024,3002,2988,14,22,6,16,110,110,0,516,515,1,300,298,2
"2021","Kingston upon Thames 017","E02000614",7391,2751,3634,3616,3597,19,18,10,8,144,143,1,563,562,1,299,299,0
"2021","Kingston upon Thames 018","E02000615",6290,2143,3193,3175,3161,14,18,10,8,107,107,0,525,525,0,322,322,0
"2021","Kingston upon Thames 019","E02000616",4875,1759,2361,2354,2342,12,7,4,3,83,83,0,442,442,0,230,230,0
"2021","Kingston upon Thames 020","E02000617",7094,2734,3220,3209,3201,8,11,6,5,170,169,1,611,610,1,359,359,0
"2021","Lambeth 002","E02000619",7560,4467,1974,1908,1828,80,66,12,54,212,208,4,619,608,11,288,286,2
"2021","Lambeth 003","E02000620",8519,5435,1970,1882,1776,106,88,8,80,230,221,9,628,609,19,256,256,0
"2021","Lambeth 004","E02000621",11291,7732,2382,2281,2161,120,101,17,84,224,215,9,703,687,16,250,248,2
"2021","Lambeth 005","E02000622",7357,4889,1579,1502,1423,79,77,8,69,169,165,4,551,544,7,169,166,3
"2021","Lambeth 006","E02000623",6651,3919,1662,1623,1582,41,39,4,35,264,254,10,584,570,14,222,220,2
"2021","Lambeth 007","E02000624",8264,5632,1687,1642,1571,71,45,10,35,217,213,4,550,532,18,178,177,1
"2021","Lambeth 008","E02000625",7696,5082,1652,1630,1576,54,22,8,14,223,218,5,570,569,1,169,169,0
"2021","Lambeth 009","E02000626",6790,4113,1606,1578,1546,32,28,4,24,279,277,2,588,585,3,204,200,4
"2021","Lambeth 010","E02000627",8253,5689,1637,1582,1490,92,55,10,45,198,189,9,512,506,6,217,215,2
"2021","Lambeth 011","E02000628",9239,6067,1934,1907,1860,47,27,6,21,294,285,9,672,662,10,272,270,2
"2021","Lambeth 012","E02000629",8091,5543,1751,1701,1631,70,50,4,46,150,145,5,457,443,14,190,187,3
"2021","Lambeth 013","E02000630",6611,4235,1730,1669,1630,39,61,0,61,125,119,6,375,367,8,146,145,1
"2021","Lambeth 014","E02000631",7955,4731,2398,2356,2308,48,42,14,28,164,164,0,473,469,4,189,187,2
"2021","Lambeth 015","E02000632",8898,6863,1284,1231,1178,53,53,8,45,127,120,7,461,446,15,163,159,4
"2021","Lambeth 016","E02000633",7848,5284,1599,1533,1496,37,66,17,49,237,233,4,537,535,2,191,190,1
"2021","Lambeth 017","E02000634",5897,4031,1119,1075,1052,23,44,4,40,150,148,2,427,419,8,170,168,2
"2021","Lambeth 018","E02000635",8475,5681,1897,1835,1780,55,62,9,53,190,187,3,525,522,3,182,182,0
"2021","Lambeth 019","E02000636",6507,3929,2049,2005,1942,63,44,14,30,96,96,0,294,287,7,139,139,0
"2021","Lambeth 020","E02000637",7409,5137,1584,1528,1461,67,56,17,39,117,115,2,406,399,7,165,164,1
"2021","Lambeth 021","E02000638",8755,5695,1967,1929,1854,75,38,9,29,245,238,7,631,626,5,217,217,0
"2021","Lambeth 022","E02000639",7155,4415,1677,1656,1630,26,21,4,17,257,254,3,633,620,13,173,172,1
"2021","Lambeth 023","E02000640",7714,4729,2241,2208,2169,39,33,8,25,114,112,2,439,436,3,191,189,2
"2021","Lambeth 024","E02000641",6829,4126,1635,1600,1577,23,35,8,27,252,248,4,595,588,7,221,221,0
"2021","Lambeth 025","E02000642",8015,4339,2555,2502,2470,32,53,12,41,216,213,3,662,655,7,243,240,3
"2021","Lambeth 026","E02000643",7883,4795,2140,2105,2056,49,35,6,29,188,170,18,563,556,7,197,196,1
"2021","Lambeth 027","E02000644",6919,3840,2232,2197,2162,35,35,18,17,161,156,5,506,500,6,180,179,1
"2021","Lambeth 028","E02000645",7703,4236,2503,2470,2428,42,33,10,23,187,185,2,606,603,3,171,171,0
"2021","Lambeth 029","E02000646",7965,4367,2675,2632,2600,32,43,12,31,167,164,3,535,531,4,221,218,3
"2021","Lambeth 030","E02000647",6931,3435,2596,2566,2517,49,30,2,28,154,149,5,458,455,3,288,287,1
"2021","Lambeth 031","E02000648",6072,3386,1754,1729,1700,29,25,7,18,201,201,0,540,537,3,191,190,1
"2021","Lambeth 032","E02000649",10418,6117,2958,2895,2800,95,63,9,54,297,277,20,751,740,11,295,293,2
"2021","Lambeth 033","E02000650",6163,3505,1832,1803,1765,38,29,4,25,190,187,3,467,466,1,169,168,1
"2021","Lambeth 034","E02000651",7205,3631,2614,2591,2513,78,23,6,17,187,187,0,536,533,3,237,236,1
"2021","Lambeth 035","E02000652",6163,2872,2408,2391,2365,26,17,7,10,148,148,0,448,447,1,287,287,0
"2021","Lambeth 036","E02006801",7752,5243,1649,1607,1528,79,42,8,34,173,171,2,481,471,10,206,206,0
"2021","Lewisham 001","E02000653",10608,6516,2923,2876,2831,45,47,12,35,245,241,4,704,692,12,220,217,3
"2021","Lewisham 002","E02000654",7018,4323,1670,1641,1615,26,29,10,19,278,277,1,574,572,2,173,173,0
"2021","Lewisham 003","E02000655",8399,5253,2043,2015,1962,53,28,10,18,282,277,5,620,611,9,201,200,1
"2021","Lewisham 005","E02000657",8351,5477,1957,1888,1861,27,69,10,59,218,211,7,477,474,3,222,220,2
"2021","Lewisham 006","E02000658",7292,4277,2146,2078,2038,40,68,11,57,173,170,3,509,504,5,187,187,0
"2021","Lewisham 007","E02000659",6674,3644,2160,2126,2080,46,34,14,20,171,168,3,506,499,7,193,192,1
"2021","Lewisham 008","E02000660",6896,4200,1929,1902,1855,47,27,12,15,148,145,3,479,474,5,140,135,5
"2021","Lewisham 009","E02000661",5410,2630,1912,1892,1866,26,20,0,20,121,121,0,552,549,3,195,193,2
"2021","Lewisham 010","E02000662",6599,3829,1920,1892,1856,36,28,20,8,171,170,1,539,537,2,140,140,0
"2021","Lewisham 011","E02000663",5655,3075,1838,1806,1764,42,32,8,24,121,119,2,448,445,3,173,172,1
"2021","Lewisham 013","E02000665",6572,3179,2517,2493,2465,28,24,8,16,148,147,1,463,458,5,265,263,2
"2021","Lewisham 014","E02000666",5765,3014,2058,2038,2009,29,20,4,16,123,121,2,372,367,5,198,197,1
"2021","Lewisham 015","E02000667",5337,2619,2070,2056,2035,21,14,4,10,106,106,0,357,354,3,185,184,1
"2021","Lewisham 016","E02000668",5293,2204,2339,2324,2296,28,15,0,15,107,105,2,401,398,3,242,242,0
"2021","Lewisham 017","E02000669",6441,3468,2102,2074,2034,40,28,4,24,189,186,3,500,495,5,182,179,3
"2021","Lewisham 018","E02000670",5388,2920,1558,1535,1514,21,23,8,15,159,156,3,526,522,4,225,225,0
"2021","Lewisham 019","E02000671",6988,3659,2402,2354,2300,54,48,8,40,177,175,2,551,544,7,199,198,1
"2021","Lewisham 020","E02000672",8216,4457,2667,2645,2608,37,22,10,12,233,230,3,636,628,8,223,220,3
"2021","Lewisham 021","E02000673",6630,3501,2348,2313,2257,56,35,16,19,137,136,1,477,470,7,167,166,1
"2021","Lewisham 022","E02000674",6789,3148,2675,2649,2619,30,26,4,22,182,181,1,497,497,0,287,286,1
"2021","Lewisham 023","E02000675",6833,3043,2771,2761,2736,25,10,8,2,175,171,4,527,523,4,317,316,1
"2021","Lewisham 024","E02000676",6246,3176,2259,2229,2198,31,30,10,20,135,132,3,473,472,1,203,201,2
"2021","Lewisham 025","E02000677",5865,2656,2313,2296,2265,31,17,2,15,146,146,0,454,454,0,296,296,0
"2021","Lewisham 026","E02000678",5332,2547,1891,1881,1863,18,10,2,8,174,173,1,515,514,1,205,204,1
"2021","Lewisham 027","E02000679",6406,3303,2193,2169,2136,33,24,8,16,154,153,1,498,494,4,258,254,4
"2021","Lewisham 028","E02000680",5509,2839,1848,1831,1821,10,17,8,9,165,165,0,453,450,3,204,204,0
"2021","Lewisham 029","E02000681",6672,3152,2367,2354,2332,22,13,4,9,240,239,1,613,612,1,300,298,2
"2021","Lewisham 030","E02000682",6834,3324,2438,2428,2414,14,10,6,4,236,236,0,528,528,0,308,308,0
"2021","Lewisham 031","E02000683",5410,2592,1845,1833,1816,17,12,4,8,156,154,2,536,531,5,281,281,0
"2021","Lewisham 033","E02000685",6459,3307,2084,2065,2033,32,19,7,12,215,215,0,572,567,5,281,280,1
"2021","Lewisham 034","E02000686",5743,2968,1770,1759,1748,11,11,6,5,210,207,3,570,566,4,225,225,0
"2021","Lewisham 035","E02000687",6619,3232,2266,2211,2184,27,55,40,15,210,204,6,621,617,4,290,290,0
"2021","Lewisham 037","E02006783",5900,2885,2008,1997,1983,14,11,2,9,166,165,1,562,561,1,279,279,0
"2021","Lewisham 038","E02006784",6349,2860,2329,2318,2305,13,11,3,8,199,197,2,623,621,2,338,338,0
"2021","Lewisham 039","E02006798",7418,4641,1797,1776,1743,33,21,10,11,230,229,1,575,570,5,175,174,1
"2021","Lewisham 040","E02007008",4931,3213,1234,1218,1187,31,16,2,14,111,106,5,323,323,0,50,49,1
"2021","Lewisham 041","E02007009",7572,4278,2175,2150,2083,67,25,10,15,216,209,7,657,654,3,246,246,0
"2021","Merton 001","E02000689",7027,2878,3484,3452,3425,27,32,9,23,115,114,1,388,386,2,162,160,2
"2021","Merton 002","E02000690",4577,1204,2653,2634,2620,14,19,4,15,86,86,0,333,333,0,301,300,1
"2021","Merton 003","E02000691",6013,2693,2648,2623,2606,17,25,6,19,85,85,0,389,388,1,198,196,2
"2021","Merton 004","E02000692",6465,2563,2931,2905,2867,38,26,4,22,111,110,1,511,507,4,349,348,1
"2021","Merton 005","E02000693",8445,4677,2903,2864,2814,50,39,16,23,134,131,3,500,496,4,231,228,3
"2021","Merton 006","E02000694",7344,3455,3094,3060,3020,40,34,12,22,124,123,1,461,456,5,210,209,1
"2021","Merton 007","E02000695",7129,3098,3100,3075,3055,20,25,9,16,136,135,1,473,471,2,322,322,0
"2021","Merton 008","E02000696",7072,3578,2652,2628,2601,27,24,5,19,175,175,0,486,486,0,181,181,0
"2021","Merton 009","E02000697",7167,3343,3079,3034,2997,37,45,14,31,109,109,0,454,454,0,182,180,2
"2021","Merton 010","E02000698",6470,1962,3629,3601,3589,12,28,5,23,92,91,1,440,439,1,347,345,2
"2021","Merton 011","E02000699",6442,2409,3268,3250,3228,22,18,5,13,109,108,1,433,432,1,223,223,0
"2021","Merton 012","E02000700",6863,3364,2461,2444,2415,29,17,12,5,169,166,3,633,633,0,236,235,1
"2021","Merton 013","E02000701",7217,2936,3186,3181,3163,18,5,2,3,175,175,0,583,577,6,337,337,0
"2021","Merton 014","E02000702",7125,3290,2777,2761,2746,15,16,9,7,211,211,0,597,595,2,250,250,0
"2021","Merton 015","E02000703",6381,2107,3428,3405,3371,34,23,6,17,89,89,0,427,425,2,330,330,0
"2021","Merton 016","E02000704",7028,3127,2907,2884,2847,37,23,4,19,141,140,1,535,534,1,318,316,2
"2021","Merton 017","E02000705",7521,3125,3346,3325,3312,13,21,12,9,187,184,3,511,507,4,352,352,0
"2021","Merton 018","E02000706",7651,3453,3051,3038,3018,20,13,0,13,212,212,0,632,629,3,303,301,2
"2021","Merton 019","E02000707",6498,3012,2503,2497,2482,15,6,3,3,208,206,2,494,489,5,281,281,0
"2021","Merton 020","E02000708",7073,2520,3711,3688,3668,20,23,8,15,114,114,0,423,423,0,305,305,0
"2021","Merton 021","E02000709",6405,2028,3504,3484,3452,32,20,6,14,82,82,0,414,414,0,377,374,3
"2021","Merton 022","E02000710",7381,3020,3181,3160,3137,23,21,15,6,168,168,0,589,588,1,423,423,0
"2021","Merton 023","E02000711",7532,3157,3334,3322,3299,23,12,6,6,165,164,1,556,554,2,320,320,0
"2021","Merton 024","E02000712",7649,3069,3404,3392,3377,15,12,4,8,165,165,0,614,612,2,397,397,0
"2021","Merton 025","E02000713",6302,2225,3183,3164,3142,22,19,4,15,106,104,2,428,427,1,360,360,0
"2021","Newham 001","E02000714",6070,2853,2401,2378,2339,39,23,18,5,149,144,5,416,411,5,251,250,1
"2021","Newham 002","E02000715",5320,2126,2511,2500,2486,14,11,8,3,163,162,1,291,291,0,229,229,0
"2021","Newham 003","E02000716",5592,2325,2577,2556,2543,13,21,10,11,136,130,6,333,331,2,221,220,1
"2021","Newham 004","E02000717",6209,2351,3100,3095,3082,13,5,1,4,141,140,1,341,340,1,276,276,0
"2021","Newham 005","E02000718",5412,2305,2479,2465,2457,8,14,8,6,124,123,1,285,285,0,219,218,1
"2021","Newham 006","E02000719",6573,3388,2301,2262,2237,25,39,12,27,182,167,15,482,482,0,220,220,0
"2021","Newham 007","E02000720",5847,2324,2834,2827,2794,33,7,2,5,134,131,3,329,326,3,226,226,0
"2021","Newham 008","E02000721",7277,2855,3605,3595,3581,14,10,5,5,166,163,3,400,400,0,251,250,1
"2021","Newham 009","E02000722",6748,3587,2290,2267,2242,25,23,10,13,169,167,2,477,471,6,225,224,1
"2021","Newham 010","E02000723",8771,3260,4561,4550,4534,16,11,6,5,174,174,0,370,369,1,406,406,0
"2021","Newham 011","E02000724",7504,2830,3893,3878,3860,18,15,11,4,165,164,1,321,321,0,295,295,0
"2021","Newham 012","E02000725",8299,4783,2503,2464,2424,40,39,8,31,185,184,1,589,583,6,239,239,0
"2021","Newham 014","E02000727",6488,2335,3502,3493,3478,15,9,4,5,120,119,1,303,303,0,228,228,0
"2021","Newham 015","E02000728",6660,2350,3590,3577,3561,16,13,12,1,105,103,2,353,351,2,262,262,0
"2021","Newham 016","E02000729",5759,2492,2438,2430,2416,14,8,2,6,135,134,1,445,443,2,249,249,0
"2021","Newham 017","E02000730",7722,2653,4126,4121,4106,15,5,3,2,201,200,1,415,415,0,327,326,1
"2021","Newham 018","E02000731",7642,2774,4071,4052,4039,13,19,10,9,136,136,0,341,341,0,320,320,0
"2021","Newham 019","E02000732",6817,2895,3122,3110,3094,16,12,8,4,174,173,1,393,391,2,233,233,0
"2021","Newham 020","E02000733",8194,4266,2819,2758,2727,31,61,4,57,221,217,4,623,621,2,265,264,1
"2021","Newham 021","E02000734",5891,2894,2173,2158,2131,27,15,6,9,164,153,11,437,435,2,223,223,0
"2021","Newham 022","E02000735",6669,2822,2968,2949,2928,21,19,7,12,199,198,1,404,402,2,276,275,1
"2021","Newham 023","E02000736",6796,2853,3110,3105,3089,16,5,2,3,170,170,0,419,418,1,244,244,0
"2021","Newham 024","E02000737",7836,3248,3477,3458,3445,13,19,14,5,279,273,6,508,507,1,324,324,0
"2021","Newham 025","E02000738",7226,2838,3703,3687,3659,28,16,5,11,123,121,2,340,337,3,222,221,1
"2021","Newham 026","E02000739",6096,2959,2336,2321,2314,7,15,8,7,152,150,2,420,420,0,229,229,0
"2021","Newham 027","E02000740",5477,2825,1815,1803,1780,23,12,4,8,170,168,2,463,463,0,204,203,1
"2021","Newham 028","E02000741",6293,2697,2776,2751,2738,13,25,12,13,172,172,0,427,426,1,221,220,1
"2021","Newham 029","E02000742",6453,2837,2824,2815,2802,13,9,6,3,127,125,2,391,391,0,274,274,0
"2021","Newham 030","E02000743",8226,4445,2696,2672,2640,32,24,10,14,258,256,2,571,569,2,256,256,0
"2021","Newham 031","E02000744",7075,3477,2635,2600,2575,25,35,14,21,222,220,2,506,505,1,235,235,0
"2021","Newham 032","E02000745",6808,3235,2561,2549,2535,14,12,2,10,209,208,1,532,530,2,271,271,0
"2021","Newham 033","E02000746",7632,3992,2692,2680,2658,22,12,2,10,168,164,4,567,566,1,213,213,0
"2021","Newham 034","E02000747",10977,6160,3503,3468,3438,30,35,16,19,295,292,3,736,728,8,283,283,0
"2021","Newham 035","E02000748",4955,2211,1995,1978,1970,8,17,9,8,127,125,2,476,476,0,146,145,1
"2021","Newham 036","E02000749",7538,3976,2406,2390,2373,17,16,7,9,206,204,2,664,662,2,286,285,1
"2021","Newham 038","E02006995",7289,5167,1681,1653,1600,53,28,6,22,143,138,5,258,255,3,40,40,0
"2021","Newham 039","E02006996",7192,4694,1879,1865,1823,42,14,8,6,147,146,1,332,329,3,140,140,0
"2021","Newham 040","E02006997",6007,3949,1511,1494,1462,32,17,4,13,151,150,1,322,319,3,74,71,3
"2021","Newham 041","E02006998",5478,2775,1927,1913,1909,4,14,6,8,180,177,3,449,447,2,147,146,1
"2021","Newham 042","E02006999",9350,5267,3340,3302,3259,43,38,10,28,150,148,2,509,500,9,84,83,1
"2021","Redbridge 001","E02000751",9139,2752,4984,4967,4945,22,17,2,15,145,144,1,630,629,1,628,628,0
"2021","Redbridge 002","E02000752",6784,2677,2971,2964,2956,8,7,2,5,166,164,2,633,632,1,337,335,2
"2021","Redbridge 003","E02000753",5380,2060,2432,2422,2419,3,10,6,4,119,119,0,473,472,1,296,296,0
"2021","Redbridge 004","E02000754",5459,2175,2490,2476,2459,17,14,6,8,110,110,0,437,434,3,247,247,0
"2021","Redbridge 005","E02000755",4410,1742,1945,1938,1930,8,7,5,2,85,85,0,429,429,0,209,209,0
"2021","Redbridge 006","E02000756",11504,4097,5745,5732,5714,18,13,12,1,259,258,1,874,871,3,529,527,2
"2021","Redbridge 007","E02000757",10017,3875,4753,4714,4679,35,39,12,27,189,189,0,731,727,4,469,469,0
"2021","Redbridge 008","E02000758",5456,1846,2797,2793,2784,9,4,2,2,108,108,0,369,368,1,336,336,0
"2021","Redbridge 009","E02000759",10251,3966,4940,4923,4889,34,17,8,9,221,221,0,717,713,4,407,407,0
"2021","Redbridge 010","E02000760",5918,2106,2945,2934,2922,12,11,6,5,136,133,3,381,378,3,350,350,0
"2021","Redbridge 012","E02000762",5407,1614,3102,3090,3089,1,12,8,4,71,71,0,276,276,0,344,342,2
"2021","Redbridge 013","E02000763",6335,2192,3382,3371,3362,9,11,10,1,98,98,0,387,387,0,276,275,1
"2021","Redbridge 014","E02000764",10251,4099,4547,4483,4408,75,64,16,48,194,192,2,776,773,3,635,633,2
"2021","Redbridge 015","E02000765",5843,1955,3227,3214,3211,3,13,12,1,109,106,3,275,275,0,277,277,0
"2021","Redbridge 017","E02000767",6671,2086,3722,3694,3683,11,28,22,6,122,122,0,388,387,1,353,352,1
"2021","Redbridge 018","E02000768",4618,1610,2422,2409,2387,22,13,8,5,78,75,3,289,287,2,219,218,1
"2021","Redbridge 020","E02000770",6409,2321,3325,3321,3314,7,4,4,0,135,134,1,338,337,1,290,290,0
"2021","Redbridge 022","E02000772",6404,2320,3374,3370,3363,7,4,2,2,124,124,0,334,334,0,252,252,0
"2021","Redbridge 023","E02000773",8197,3036,4321,4312,4307,5,9,3,6,158,156,2,342,340,2,340,339,1
"2021","Redbridge 024","E02000774",6156,2282,3182,3181,3178,3,1,1,0,112,112,0,320,320,0,260,260,0
"2021","Redbridge 026","E02000776",5369,1853,2914,2906,2902,4,8,4,4,108,108,0,281,281,0,213,212,1
"2021","Redbridge 027","E02000777",4772,1775,2366,2337,2318,19,29,10,19,82,82,0,317,315,2,232,231,1
"2021","Redbridge 029","E02000779",6412,2276,3358,3349,3341,8,9,6,3,145,144,1,388,388,0,245,244,1
"2021","Redbridge 031","E02000781",12337,4296,6676,6666,6661,5,10,8,2,243,243,0,536,534,2,586,586,0
"2021","Redbridge 032","E02000782",8462,3256,4261,4251,4232,19,10,6,4,200,199,1,451,451,0,294,294,0
"2021","Redbridge 033","E02000783",5445,2165,2595,2590,2586,4,5,2,3,146,146,0,306,306,0,233,233,0
"2021","Redbridge 034","E02006800",11270,4071,5802,5789,5744,45,13,8,5,312,311,1,637,637,0,448,448,0
"2021","Redbridge 035","E02006924",10923,3740,5778,5759,5746,13,19,14,5,233,231,2,591,591,0,581,581,0
"2021","Redbridge 036","E02006925",11724,3957,6430,6418,6410,8,12,10,2,189,186,3,529,529,0,619,619,0
"2021","Redbridge 037","E02007017",6626,2297,3405,3399,3386,13,6,0,6,134,134,0,415,415,0,375,375,0
"2021","Redbridge 038","E02007018",5374,2050,2554,2550,2542,8,4,0,4,142,142,0,374,374,0,254,254,0
"2021","Redbridge 039","E02007019",5291,1714,2973,2968,2961,7,5,0,5,124,122,2,270,270,0,210,210,0
"2021","Redbridge 040","E02007020",7393,2657,3914,3906,3889,17,8,6,2,145,145,0,344,343,1,333,333,0
"2021","Richmond upon Thames 001","E02000784",8212,2793,4163,4101,4071,30,62,9,53,168,165,3,684,682,2,404,403,1
"2021","Richmond upon Thames 002","E02000785",7991,2660,4193,4141,4122,19,52,10,42,135,135,0,598,596,2,405,400,5
"2021","Richmond upon Thames 003","E02000786",8926,3341,4218,4192,4135,57,26,10,16,190,190,0,833,833,0,344,342,2
"2021","Richmond upon Thames 004","E02000787",9592,3746,4491,4462,4426,36,29,6,23,205,204,1,796,795,1,354,351,3
"2021","Richmond upon Thames 005","E02000788",6967,2258,3804,3780,3760,20,24,6,18,102,101,1,527,526,1,276,275,1
"2021","Richmond upon Thames 006","E02000789",5149,1880,2455,2430,2400,30,25,8,17,111,110,1,438,435,3,265,264,1
"2021","Richmond upon Thames 007","E02000790",5154,1882,2640,2623,2600,23,17,0,17,69,68,1,401,398,3,162,161,1
"2021","Richmond upon Thames 008","E02000791",5298,1959,2589,2555,2524,31,34,8,26,106,105,1,420,416,4,224,223,1
"2021","Richmond upon Thames 009","E02000792",5782,2069,2804,2777,2757,20,27,8,19,107,106,1,498,492,6,304,301,3
"2021","Richmond upon Thames 010","E02000793",6561,2382,3140,3128,3107,21,12,6,6,135,134,1,477,477,0,427,425,2
"2021","Richmond upon Thames 011","E02000794",5550,1967,2911,2882,2856,26,29,6,23,74,74,0,340,338,2,258,255,3
"2021","Richmond upon Thames 012","E02000795",5291,1452,3172,3154,3140,14,18,4,14,78,78,0,308,308,0,281,281,0
"2021","Richmond upon Thames 013","E02000796",8765,3098,4367,4351,4339,12,16,8,8,190,187,3,610,609,1,500,500,0
"2021","Richmond upon Thames 014","E02000797",6282,2671,2773,2738,2699,39,35,10,25,139,139,0,479,476,3,220,220,0
"2021","Richmond upon Thames 015","E02000798",8694,3170,4297,4271,4240,31,26,10,16,173,171,2,697,693,4,357,356,1
"2021","Richmond upon Thames 016","E02000799",5474,2398,2423,2411,2393,18,12,6,6,88,87,1,358,356,2,207,207,0
"2021","Richmond upon Thames 017","E02000800",4127,1477,1874,1847,1829,18,27,8,19,131,130,1,444,444,0,201,201,0
"2021","Richmond upon Thames 018","E02000801",5612,1962,2865,2840,2818,22,25,8,17,86,86,0,462,462,0,237,235,2
"2021","Richmond upon Thames 019","E02000802",5661,1977,2824,2812,2799,13,12,6,6,107,107,0,450,447,3,303,300,3
"2021","Richmond upon Thames 020","E02000803",7822,2815,3645,3623,3601,22,22,12,10,172,171,1,779,779,0,411,411,0
"2021","Richmond upon Thames 021","E02000804",5866,2157,2784,2764,2754,10,20,0,20,117,116,1,501,498,3,307,305,2
"2021","Richmond upon Thames 022","E02000805",8712,3174,4247,4205,4176,29,42,16,26,189,189,0,734,733,1,368,366,2
"2021","Richmond upon Thames 023","E02000806",8342,2674,4416,4385,4352,33,31,12,19,131,130,1,683,680,3,438,438,0
"2021","Southwark 001","E02000807",7167,4159,2279,2234,2174,60,45,10,35,139,135,4,419,410,9,171,169,2
"2021","Southwark 002","E02000808",9297,6525,1845,1772,1686,86,73,16,57,176,170,6,563,552,11,188,184,4
"2021","Southwark 004","E02000810",9885,6206,2391,2340,2278,62,51,14,37,293,291,2,733,720,13,262,261,1
"2021","Southwark 006","E02000812",9114,5840,2036,1997,1904,93,39,6,33,237,233,4,752,742,10,249,248,1
"2021","Southwark 007","E02000813",8522,5374,2020,1974,1928,46,46,14,32,229,225,4,676,668,8,223,222,1
"2021","Southwark 008","E02000814",8873,5312,2614,2553,2496,57,61,22,39,210,205,5,547,538,9,190,186,4
"2021","Southwark 009","E02000815",6706,4758,1350,1315,1266,49,35,8,27,159,155,4,342,334,8,97,97,0
"2021","Southwark 010","E02000816",7955,4749,2175,2141,2085,56,34,9,25,207,199,8,586,583,3,238,238,0
"2021","Southwark 011","E02000817",5599,3226,1335,1318,1299,19,17,8,9,247,245,2,550,543,7,241,241,0
"2021","Southwark 012","E02000818",8439,5477,1875,1834,1760,74,41,4,37,224,219,5,610,593,17,253,253,0
"2021","Southwark 013","E02000819",6958,4106,1765,1734,1708,26,31,6,25,243,239,4,619,613,6,225,225,0
"2021","Southwark 014","E02000820",7860,5235,1619,1565,1489,76,54,6,48,229,224,5,561,547,14,216,214,2
"2021","Southwark 015","E02000821",7396,4200,2116,2091,2055,36,25,3,22,250,247,3,614,607,7,216,216,0
"2021","Southwark 016","E02000822",5422,3348,1257,1246,1220,26,11,2,9,210,207,3,446,439,7,161,159,2
"2021","Southwark 017","E02000823",7317,4585,1595,1555,1503,52,40,4,36,238,231,7,666,657,9,233,232,1
"2021","Southwark 018","E02000824",7872,4595,1975,1960,1924,36,15,8,7,342,334,8,689,689,0,271,271,0
"2021","Southwark 019","E02000825",8228,4848,2117,2094,2064,30,23,4,19,324,323,1,674,668,6,265,265,0
"2021","Southwark 020","E02000826",8248,5074,1966,1927,1884,43,39,8,31,254,250,4,675,670,5,279,277,2
"2021","Southwark 021","E02000827",9376,5587,2362,2323,2270,53,39,10,29,342,334,8,816,805,11,269,269,0
"2021","Southwark 022","E02000828",7290,4437,1759,1738,1709,29,21,13,8,273,271,2,602,599,3,219,218,1
"2021","Southwark 023","E02000829",9076,5488,2183,2146,2088,58,37,16,21,314,309,5,734,728,6,357,357,0
"2021","Southwark 024","E02000830",7643,4696,2054,2002,1964,38,52,14,38,197,194,3,497,483,14,199,198,1
"2021","Southwark 025","E02000831",7790,4704,2140,2074,2020,54,66,20,46,191,189,2,519,506,13,236,231,5
"2021","Southwark 026","E02000832",8022,4680,2097,2073,2034,39,24,14,10,259,255,4,639,634,5,347,346,1
"2021","Southwark 027","E02000833",5945,3252,1812,1788,1760,28,24,14,10,204,200,4,508,501,7,169,167,2
"2021","Southwark 028","E02000834",7804,4550,2421,2380,2320,60,41,14,27,152,152,0,485,462,23,196,195,1
"2021","Southwark 029","E02000835",5943,3051,2173,2129,2083,46,44,16,28,137,136,1,395,390,5,187,186,1
"2021","Southwark 030","E02000836",6620,3214,2686,2638,2600,38,48,20,28,121,118,3,388,385,3,211,211,0
"2021","Southwark 031","E02000837",6590,2348,3505,3470,3437,33,35,14,21,99,98,1,373,370,3,265,265,0
"2021","Southwark 032","E02000838",7631,3916,2761,2714,2680,34,47,10,37,211,207,4,515,507,8,228,226,2
"2021","Southwark 033","E02000839",6616,3094,2532,2510,2477,33,22,6,16,194,193,1,542,540,2,254,253,1
"2021","Southwark 034","E02006802",8066,5510,1674,1598,1525,73,76,8,68,170,167,3,531,516,15,181,180,1
"2021","Southwark 035","E02006941",5020,3333,1260,1221,1175,46,39,8,31,69,68,1,299,293,6,59,58,1
"2021","Southwark 036","E02006942",5862,4017,1236,1208,1165,43,28,6,22,117,114,3,377,370,7,115,113,2
"2021","Sutton 001","E02000840",7065,3085,2879,2868,2857,11,11,6,5,201,199,2,628,626,2,272,272,0
"2021","Sutton 002","E02000841",7150,3034,2965,2952,2938,14,13,8,5,209,207,2,636,636,0,306,306,0
"2021","Sutton 003","E02000842",6669,2192,3538,3533,3526,7,5,1,4,108,107,1,426,424,2,405,405,0
"2021","Sutton 004","E02000843",7356,3109,3265,3251,3210,41,14,2,12,152,150,2,556,553,3,274,274,0
"2021","Sutton 005","E02000844",6754,2741,2971,2965,2942,23,6,2,4,160,158,2,525,525,0,357,357,0
"2021","Sutton 006","E02000845",7303,2616,3660,3646,3623,23,14,10,4,141,141,0,527,527,0,359,358,1
"2021","Sutton 007","E02000846",6059,2020,3166,3154,3144,10,12,6,6,92,92,0,417,416,1,364,363,1
"2021","Sutton 008","E02000847",7582,2398,4044,4028,4011,17,16,4,12,116,116,0,508,508,0,516,515,1
"2021","Sutton 009","E02000848",6384,2112,3369,3358,3346,12,11,8,3,93,92,1,453,453,0,357,357,0
"2021","Sutton 010","E02000849",6440,2429,2995,2984,2969,15,11,4,7,152,149,3,543,541,2,321,321,0
"2021","Sutton 011","E02000850",8661,3058,4345,4323,4312,11,22,10,12,170,170,0,622,621,1,466,465,1
"2021","Sutton 012","E02000851",9042,3874,3713,3679,3668,11,34,16,18,212,210,2,846,841,5,397,397,0
"2021","Sutton 013","E02000852",6427,2348,3121,3104,3084,20,17,8,9,122,121,1,517,514,3,319,319,0
"2021","Sutton 014","E02000853",6315,2244,3049,3038,3031,7,11,6,5,154,153,1,572,569,3,296,296,0
"2021","Sutton 015","E02000854",6026,2124,3025,3009,2992,17,16,4,12,99,98,1,472,470,2,306,306,0
"2021","Sutton 016","E02000855",6627,1993,3652,3638,3629,9,14,6,8,98,97,1,438,437,1,446,446,0
"2021","Sutton 017","E02000856",7394,2605,3719,3697,3674,23,22,10,12,163,160,3,552,552,0,355,355,0
"2021","Sutton 018","E02000857",7278,2887,3033,3021,3001,20,12,6,6,204,204,0,711,710,1,443,443,0
"2021","Sutton 019","E02000858",6503,2934,2486,2471,2462,9,15,10,5,204,202,2,590,590,0,289,289,0
"2021","Sutton 020","E02000859",6831,2287,3310,3299,3273,26,11,6,5,151,151,0,566,566,0,517,517,0
"2021","Sutton 021","E02000860",7010,2964,2722,2702,2683,19,20,8,12,212,211,1,756,754,2,356,356,0
"2021","Sutton 022","E02000861",6302,1620,3952,3945,3932,13,7,2,5,86,86,0,300,300,0,344,344,0
"2021","Sutton 024","E02000863",5454,1652,3047,3033,3024,9,14,6,8,104,104,0,336,334,2,315,315,0
"2021","Sutton 025","E02006836",7016,1955,4135,4131,4117,14,4,2,2,93,93,0,404,404,0,429,429,0
"2021","Tower Hamlets 001","E02000864",9181,5582,2562,2514,2463,51,48,16,32,195,193,2,528,524,4,314,314,0
"2021","Tower Hamlets 002","E02000865",6435,3771,1936,1918,1895,23,18,8,10,150,147,3,376,373,3,202,201,1
"2021","Tower Hamlets 003","E02000866",8790,5095,2648,2593,2538,55,55,11,44,188,183,5,582,574,8,277,277,0
"2021","Tower Hamlets 004","E02000867",9649,6360,2437,2387,2306,81,50,20,30,166,162,4,469,461,8,217,216,1
"2021","Tower Hamlets 005","E02000868",6105,3884,1652,1615,1585,30,37,18,19,95,93,2,292,282,10,182,181,1
"2021","Tower Hamlets 006","E02000869",4886,2877,1410,1379,1336,43,31,4,27,105,104,1,330,324,6,164,162,2
"2021","Tower Hamlets 007","E02000870",5157,3036,1534,1511,1474,37,23,5,18,97,95,2,296,294,2,194,194,0
"2021","Tower Hamlets 008","E02000871",8958,4976,3094,3076,3041,35,18,4,14,197,194,3,438,430,8,253,253,0
"2021","Tower Hamlets 009","E02000872",6815,4297,1879,1858,1819,39,21,4,17,113,110,3,324,320,4,202,202,0
"2021","Tower Hamlets 010","E02000873",7974,5131,2205,2175,2139,36,30,10,20,130,129,1,337,335,2,171,171,0
"2021","Tower Hamlets 011","E02000874",5959,3307,2066,2043,2011,32,23,8,15,119,118,1,287,284,3,180,178,2
"2021","Tower Hamlets 012","E02000875",10704,6131,3580,3549,3514,35,31,15,16,243,240,3,518,509,9,232,232,0
"2021","Tower Hamlets 013","E02000876",6036,3698,1814,1793,1756,37,21,8,13,110,109,1,268,266,2,146,144,2
"2021","Tower Hamlets 014","E02000877",10928,6360,3628,3603,3541,62,25,10,15,208,204,4,463,456,7,269,268,1
"2021","Tower Hamlets 015","E02000878",9007,5738,2402,2364,2320,44,38,8,30,143,140,3,415,409,6,309,306,3
"2021","Tower Hamlets 016","E02000879",6668,3552,2294,2269,2246,23,25,14,11,146,146,0,392,389,3,284,284,0
"2021","Tower Hamlets 017","E02000880",5203,2918,1756,1747,1728,19,9,0,9,112,111,1,229,228,1,188,187,1
"2021","Tower Hamlets 018","E02000881",8334,4656,2749,2727,2688,39,22,8,14,261,258,3,455,451,4,213,210,3
"2021","Tower Hamlets 019","E02000882",8884,4788,3102,3066,3031,35,36,11,25,207,202,5,409,403,6,378,378,0
"2021","Tower Hamlets 020","E02000883",7062,3684,2582,2561,2508,53,21,4,17,165,162,3,391,390,1,240,239,1
"2021","Tower Hamlets 021","E02000884",10819,7139,2892,2846,2791,55,46,14,32,169,165,4,362,355,7,257,256,1
"2021","Tower Hamlets 022","E02000885",5506,2750,2029,2004,1977,27,25,6,19,143,143,0,315,307,8,269,269,0
"2021","Tower Hamlets 023","E02000886",7945,4735,2503,2469,2387,82,34,4,30,158,153,5,395,390,5,154,152,2
"2021","Tower Hamlets 024","E02000887",8343,4486,2964,2934,2899,35,30,16,14,208,206,2,456,452,4,229,229,0
"2021","Tower Hamlets 025","E02000888",6931,3808,2469,2425,2384,41,44,10,34,123,119,4,351,346,5,180,177,3
"2021","Tower Hamlets 026","E02000889",7435,4308,2467,2423,2386,37,44,12,32,115,115,0,375,368,7,170,169,1
"2021","Tower Hamlets 027","E02000890",5171,2794,1808,1777,1716,61,31,8,23,99,98,1,345,341,4,125,124,1
"2021","Tower Hamlets 030","E02000893",5981,3029,2180,2168,2132,36,12,0,12,115,115,0,461,455,6,196,195,1
"2021","Tower Hamlets 031","E02000894",9019,4637,3579,3496,3449,47,83,6,77,152,145,7,466,462,4,185,183,2
"2021","Tower Hamlets 032","E02006853",9114,5369,3064,3022,2980,42,42,12,30,160,156,4,383,382,1,138,135,3
"2021","Tower Hamlets 033","E02006854",6209,3581,2140,2102,2056,46,38,12,26,113,112,1,314,304,10,61,60,1
"2021","Tower Hamlets 034","E02007112",5238,3516,1458,1429,1377,52,29,9,20,77,76,1,154,149,5,33,33,0
"2021","Tower Hamlets 035","E02007113",6102,3490,2143,2115,2067,48,28,10,18,121,118,3,267,263,4,81,80,1
"2021","Tower Hamlets 036","E02007114",6347,3911,1938,1907,1875,32,31,7,24,109,109,0,291,284,7,98,98,0
"2021","Waltham Forest 001","E02000895",6837,2576,3027,3025,3019,6,2,0,2,156,154,2,589,589,0,489,488,1
"2021","Waltham Forest 002","E02000896",7648,2876,3511,3485,3466,19,26,4,22,176,176,0,604,602,2,481,479,2
"2021","Waltham Forest 003","E02000897",6872,2882,2781,2773,2760,13,8,4,4,173,171,2,607,607,0,429,429,0
"2021","Waltham Forest 004","E02000898",6487,2566,2787,2777,2768,9,10,2,8,188,185,3,584,584,0,362,361,1
"2021","Waltham Forest 005","E02000899",7106,2621,3361,3352,3339,13,9,3,6,166,162,4,554,553,1,404,404,0
"2021","Waltham Forest 006","E02000900",7046,2912,3040,3027,3018,9,13,5,8,160,160,0,595,595,0,339,339,0
"2021","Waltham Forest 007","E02000901",8392,3407,3956,3947,3884,63,9,4,5,158,158,0,559,554,5,312,311,1
"2021","Waltham Forest 008","E02000902",7584,3284,3324,3303,3280,23,21,8,13,179,177,2,547,547,0,250,248,2
"2021","Waltham Forest 009","E02000903",7974,3873,3021,3005,2970,35,16,2,14,194,194,0,595,592,3,291,291,0
"2021","Waltham Forest 010","E02000904",6654,3023,2730,2714,2679,35,16,6,10,167,165,2,509,502,7,225,224,1
"2021","Waltham Forest 011","E02000905",8007,3485,3513,3486,3440,46,27,8,19,198,198,0,524,522,2,287,286,1
"2021","Waltham Forest 012","E02000906",7600,3960,2675,2639,2572,67,36,10,26,170,170,0,525,515,10,270,268,2
"2021","Waltham Forest 013","E02000907",8139,4154,2762,2747,2711,36,15,6,9,272,270,2,653,648,5,298,295,3
"2021","Waltham Forest 014","E02000908",10470,5842,3358,3317,3240,77,41,18,23,257,251,6,761,755,6,252,251,1
"2021","Waltham Forest 015","E02000909",7260,3404,2952,2912,2860,52,40,6,34,161,154,7,508,507,1,235,235,0
"2021","Waltham Forest 016","E02000910",9282,4503,3545,3501,3433,68,44,12,32,209,208,1,699,693,6,326,321,5
"2021","Waltham Forest 017","E02000911",10369,5237,3906,3874,3816,58,32,12,20,265,258,7,648,644,4,313,313,0
"2021","Waltham Forest 018","E02000912",7761,3643,3139,3114,3080,34,25,14,11,150,145,5,537,533,4,292,292,0
"2021","Waltham Forest 019","E02000913",7540,3313,3383,3361,3325,36,22,16,6,156,154,2,385,382,3,303,303,0
"2021","Waltham Forest 020","E02000914",9258,4379,3680,3648,3621,27,32,10,22,265,263,2,632,628,4,302,302,0
"2021","Waltham Forest 021","E02000915",6694,3408,2421,2389,2364,25,32,14,18,160,155,5,494,493,1,211,209,2
"2021","Waltham Forest 022","E02000916",8483,4271,3190,3174,3123,51,16,4,12,193,192,1,591,587,4,238,237,1
"2021","Waltham Forest 023","E02000917",7714,3828,2994,2953,2908,45,41,26,15,170,169,1,526,522,4,196,196,0
"2021","Waltham Forest 024","E02000918",7554,3612,2909,2876,2854,22,33,4,29,180,174,6,644,642,2,209,209,0
"2021","Waltham Forest 025","E02000919",7622,3758,2939,2905,2853,52,34,8,26,157,154,3,515,510,5,253,252,1
"2021","Waltham Forest 026","E02000920",8375,4369,2865,2837,2802,35,28,12,16,229,221,8,621,615,6,291,291,0
"2021","Waltham Forest 027","E02000921",9123,4866,2944,2920,2861,59,24,3,21,242,239,3,783,781,2,288,287,1
"2021","Waltham Forest 028","E02000922",8328,3995,3259,3221,3185,36,38,18,20,185,184,1,633,628,5,256,256,0
"2021","Wandsworth 001","E02000923",6532,3373,2184,2118,2102,16,66,14,52,121,116,5,532,528,4,322,317,5
"2021","Wandsworth 003","E02000925",6485,3805,1792,1776,1753,23,16,4,12,148,144,4,469,464,5,271,271,0
"2021","Wandsworth 004","E02000926",10061,6169,2757,2701,2632,69,56,8,48,209,205,4,705,700,5,221,220,1
"2021","Wandsworth 005","E02000927",6126,3744,1635,1612,1576,36,23,8,15,121,119,2,431,428,3,195,194,1
"2021","Wandsworth 006","E02000928",6951,3314,2837,2811,2785,26,26,6,20,97,96,1,455,452,3,248,248,0
"2021","Wandsworth 007","E02000929",6560,3894,1590,1561,1543,18,29,13,16,221,219,2,608,604,4,247,246,1
"2021","Wandsworth 008","E02000930",8850,6004,2145,2092,2052,40,53,12,41,101,99,2,441,434,7,159,158,1
"2021","Wandsworth 009","E02000931",7103,3972,2645,2596,2565,31,49,17,32,75,74,1,297,297,0,114,114,0
"2021","Wandsworth 010","E02000932",11134,6616,3477,3425,3388,37,52,16,36,156,152,4,649,638,11,236,230,6
"2021","Wandsworth 011","E02000933",7532,3532,3099,3064,3024,40,35,8,27,111,111,0,515,509,6,275,274,1
"2021","Wandsworth 012","E02000934",7926,5135,2039,2017,1982,35,22,4,18,136,135,1,471,468,3,145,144,1
"2021","Wandsworth 013","E02000935",5739,3349,1552,1546,1537,9,6,0,6,139,138,1,458,457,1,241,241,0
"2021","Wandsworth 014","E02000936",8146,4665,2598,2565,2529,36,33,6,27,129,128,1,532,528,4,222,221,1
"2021","Wandsworth 015","E02000937",6388,3038,2701,2682,2661,21,19,6,13,81,81,0,414,411,3,154,153,1
"2021","Wandsworth 016","E02000938",8597,3933,3304,3270,3250,20,34,14,20,203,200,3,785,779,6,372,371,1
"2021","Wandsworth 017","E02000939",5999,2440,2906,2865,2829,36,41,9,32,71,71,0,321,321,0,261,259,2
"2021","Wandsworth 018","E02000940",7891,4779,2259,2227,2181,46,32,8,24,173,169,4,468,463,5,212,210,2
"2021","Wandsworth 019","E02000941",8212,4082,3262,3239,3204,35,23,2,21,155,154,1,509,507,2,204,204,0
"2021","Wandsworth 020","E02000942",7881,3459,3610,3575,3548,27,35,6,29,133,132,1,446,443,3,233,232,1
"2021","Wandsworth 021","E02000943",7496,4529,2320,2291,2232,59,29,4,25,114,111,3,347,347,0,186,186,0
"2021","Wandsworth 022","E02000944",6099,3124,2085,2031,2002,29,54,4,50,209,207,2,461,459,2,220,219,1
"2021","Wandsworth 023","E02000945",6270,3219,2084,2011,1996,15,73,56,17,202,199,3,513,510,3,252,252,0
"2021","Wandsworth 024","E02000946",7148,4217,2145,2124,2100,24,21,4,17,143,141,2,474,467,7,169,168,1
"2021","Wandsworth 025","E02000947",7521,3608,3209,3168,3122,46,41,10,31,101,100,1,404,404,0,199,199,0
"2021","Wandsworth 026","E02000948",8706,5514,2437,2400,2316,84,37,6,31,128,123,5,394,389,5,233,233,0
"2021","Wandsworth 027","E02000949",8484,4572,3111,3089,3048,41,22,4,18,107,106,1,453,448,5,241,240,1
"2021","Wandsworth 028","E02000950",6226,3009,2406,2392,2374,18,14,4,10,104,102,2,469,469,0,238,237,1
"2021","Wandsworth 029","E02000951",5582,3411,1599,1574,1545,29,25,4,21,79,76,3,337,334,3,156,154,2
"2021","Wandsworth 030","E02000952",5243,3100,1586,1557,1549,8,29,10,19,99,99,0,292,291,1,166,165,1
"2021","Wandsworth 031","E02000953",6255,3536,2130,2104,2083,21,26,2,24,79,78,1,375,370,5,135,135,0
"2021","Wandsworth 032","E02000954",5135,2839,1751,1743,1719,24,8,0,8,55,55,0,285,283,2,205,204,1
"2021","Wandsworth 033","E02000955",5733,3306,1766,1755,1728,27,11,6,5,105,101,4,319,319,0,237,236,1
"2021","Wandsworth 034","E02000956",6368,4090,1608,1591,1560,31,17,6,11,118,116,2,372,370,2,180,179,1
"2021","Wandsworth 035","E02000957",9126,5329,2870,2795,2703,92,75,14,61,142,141,1,502,499,3,283,280,3
"2021","Wandsworth 036","E02000958",6696,3191,2680,2646,2629,17,34,8,26,109,108,1,441,441,0,275,275,0
"2021","Wandsworth 037","E02000959",6314,3399,2131,2118,2096,22,13,4,9,151,146,5,432,431,1,201,201,0
"2021","Wandsworth 038","E02007083",6744,4236,1932,1895,1842,53,37,4,33,105,105,0,397,390,7,74,73,1
"2021","Wandsworth 039","E02007084",8289,5151,1999,1972,1938,34,27,6,21,221,214,7,662,655,7,256,253,3
"2021","Westminster 001","E02000960",5220,2198,2289,2267,2246,21,22,8,14,82,82,0,395,394,1,256,256,0
"2021","Westminster 002","E02000961",8019,3859,3126,3094,3065,29,32,9,23,171,170,1,609,605,4,254,253,1
"2021","Westminster 003","E02000962",6726,3127,2622,2591,2570,21,31,7,24,125,125,0,542,539,3,310,308,2
"2021","Westminster 004","E02000963",8644,4602,2670,2657,2624,33,13,4,9,285,282,3,730,728,2,357,356,1
"2021","Westminster 005","E02000964",10293,5998,2819,2793,2723,70,26,4,22,304,302,2,830,830,0,342,338,4
"2021","Westminster 006","E02000965",6798,3804,2226,2190,2148,42,36,14,22,135,134,1,491,488,3,142,141,1
"2021","Westminster 007","E02000966",7963,3824,3171,3117,3041,76,54,14,40,134,132,2,600,596,4,234,232,2
"2021","Westminster 008","E02000967",5430,2920,1940,1899,1856,43,41,10,31,72,72,0,303,296,7,195,190,5
"2021","Westminster 009","E02000968",12040,6573,3517,3498,3466,32,19,10,9,428,423,5,913,909,4,609,603,6
"2021","Westminster 010","E02000969",7838,4335,2222,2207,2192,15,15,6,9,258,257,1,728,726,2,295,295,0
"2021","Westminster 011","E02000970",6124,3015,2335,2305,2270,35,30,6,24,122,117,5,431,429,2,221,218,3
"2021","Westminster 012","E02000971",6748,3902,2129,2097,2042,55,32,6,26,122,117,5,419,414,5,176,172,4
"2021","Westminster 013","E02000972",7269,4689,1631,1571,1506,65,60,6,54,157,150,7,561,549,12,231,231,0
"2021","Westminster 014","E02000973",8791,4954,2724,2684,2639,45,40,8,32,220,188,32,685,682,3,208,204,4
"2021","Westminster 015","E02000974",7689,4150,2631,2596,2548,48,35,2,33,179,179,0,510,505,5,219,218,1
"2021","Westminster 016","E02000975",6757,4048,2034,1985,1938,47,49,14,35,140,137,3,407,402,5,128,120,8
"2021","Westminster 017","E02000976",7513,4356,2205,2164,2136,28,41,8,33,150,145,5,567,564,3,235,232,3
"2021","Westminster 018","E02000977",5916,3560,1582,1510,1425,85,72,6,66,121,114,7,482,477,5,171,167,4
"2021","Westminster 019","E02000978",6261,2925,2578,2552,2510,42,26,14,12,88,88,0,426,421,5,244,243,1
"2021","Westminster 020","E02000979",7084,3899,2298,2255,2206,49,43,2,41,141,137,4,537,533,4,209,204,5
"2021","Westminster 021","E02000980",7653,4258,2259,2223,2178,45,36,2,34,177,176,1,699,692,7,260,254,6
"2021","Westminster 022","E02000981",7520,4522,2079,2037,1986,51,42,4,38,247,193,54,492,491,1,180,175,5
"2021","Westminster 023","E02000982",6575,3475,2017,1989,1964,25,28,6,22,163,160,3,629,624,5,291,290,1
"2021","Westminster 024","E02000983",6593,3557,1991,1955,1916,39,36,8,28,158,155,3,563,561,2,324,322,2
"2021","Medway 001","E02003314",5618,1726,2668,2659,2637,22,9,2,7,150,150,0,598,597,1,476,476,0
"2021","Medway 002","E02003315",4704,1466,2533,2523,2516,7,10,2,8,81,81,0,374,372,2,250,250,0
"2021","Medway 003","E02003316",9552,3314,4573,4556,4537,19,17,12,5,238,231,7,862,860,2,565,565,0
"2021","Medway 004","E02003317",5631,1896,2705,2698,2685,13,7,4,3,143,143,0,529,529,0,358,357,1
"2021","Medway 005","E02003318",4936,1432,2728,2722,2705,17,6,2,4,79,78,1,365,365,0,332,332,0
"2021","Medway 006","E02003319",6430,2667,2513,2501,2474,27,12,7,5,210,207,3,699,699,0,341,341,0
"2021","Medway 007","E02003320",7509,3392,2820,2797,2772,25,23,8,15,256,255,1,786,784,2,255,255,0
"2021","Medway 008","E02003321",5036,2021,2090,2084,2071,13,6,2,4,121,121,0,500,497,3,304,304,0
"2021","Medway 009","E02003322",6540,3687,1836,1825,1808,17,11,4,7,211,211,0,580,580,0,226,226,0
"2021","Medway 010","E02003323",5639,2302,2276,2271,2252,19,5,0,5,162,160,2,623,621,2,276,276,0
"2021","Medway 011","E02003324",7669,3240,3150,3137,3124,13,13,10,3,188,188,0,748,748,0,343,342,1
"2021","Medway 012","E02003325",5665,2746,1806,1795,1793,2,11,5,6,246,244,2,660,659,1,207,207,0
"2021","Medway 013","E02003326",6100,2439,2459,2448,2436,12,11,8,3,193,193,0,650,650,0,359,359,0
"2021","Medway 014","E02003327",6212,2755,2139,2116,2078,38,23,12,11,217,215,2,787,783,4,314,312,2
"2021","Medway 015","E02003328",7878,3935,2484,2465,2427,38,19,15,4,299,295,4,840,836,4,320,320,0
"2021","Medway 016","E02003329",5314,2178,2131,2114,2092,22,17,6,11,181,179,2,562,562,0,262,262,0
"2021","Medway 017","E02003330",5334,2226,2160,2153,2121,32,7,4,3,127,127,0,569,569,0,252,252,0
"2021","Medway 018","E02003331",7175,2672,2939,2925,2909,16,14,8,6,199,195,4,821,820,1,544,542,2
"2021","Medway 019","E02003332",5083,1703,2442,2440,2409,31,2,0,2,125,125,0,472,472,0,341,341,0
"2021","Medway 020","E02003333",5136,2379,1685,1673,1644,29,12,5,7,214,213,1,604,604,0,254,254,0
"2021","Medway 021","E02003334",4808,1934,2033,2020,2012,8,13,4,9,130,130,0,443,442,1,268,267,1
"2021","Medway 022","E02003335",5266,2440,1920,1902,1892,10,18,12,6,216,213,3,489,489,0,201,201,0
"2021","Medway 023","E02003336",5225,1490,2718,2717,2708,9,1,1,0,87,87,0,455,454,1,475,475,0
"2021","Medway 024","E02003337",6048,2472,2502,2495,2480,15,7,0,7,160,160,0,568,568,0,346,345,1
"2021","Medway 025","E02003338",5879,2249,2364,2356,2341,15,8,8,0,160,160,0,677,674,3,429,429,0
"2021","Medway 026","E02003339",5243,1652,2620,2612,2595,17,8,2,6,106,106,0,442,441,1,423,422,1
"2021","Medway 027","E02003340",6371,2343,2791,2779,2765,14,12,8,4,179,177,2,593,593,0,465,465,0
"2021","Medway 028","E02003341",5343,1711,2742,2734,2715,19,8,0,8,111,111,0,484,483,1,295,295,0
"2021","Medway 029","E02003342",5225,1596,2629,2628,2612,16,1,0,1,120,119,1,461,461,0,419,419,0
"2021","Medway 030","E02003343",5057,1233,3061,3059,3051,8,2,1,1,58,57,1,335,335,0,370,370,0
"2021","Medway 031","E02003344",5412,2004,2340,2333,2330,3,7,3,4,146,146,0,619,618,1,303,303,0
"2021","Medway 032","E02003345",4921,1601,2534,2532,2510,22,2,0,2,113,111,2,439,439,0,234,233,1
"2021","Medway 033","E02003346",5759,1809,2879,2873,2860,13,6,2,4,105,105,0,522,521,1,444,444,0
"2021","Medway 034","E02003347",4826,1902,2225,2215,2200,15,10,2,8,121,120,1,416,414,2,162,162,0
"2021","Medway 035","E02003348",6755,1715,4011,3999,3980,19,12,10,2,88,88,0,453,453,0,488,488,0
"2021","Medway 036","E02003349",6022,1904,2885,2880,2869,11,5,2,3,157,155,2,618,618,0,458,458,0
"2021","Medway 037","E02003350",5169,1734,2510,2503,2491,12,7,6,1,121,121,0,455,454,1,349,349,0
"2021","Medway 038","E02003351",6294,2177,2983,2975,2954,21,8,2,6,133,133,0,622,619,3,379,379,0
"2021","Bracknell Forest 001","E02003352",4862,1187,2844,2825,2823,2,19,2,17,70,69,1,409,408,1,352,351,1
"2021","Bracknell Forest 002","E02003353",9658,3201,5022,5016,4979,37,6,2,4,181,177,4,861,860,1,393,393,0
"2021","Bracknell Forest 003","E02003354",8303,2678,4388,4374,4349,25,14,6,8,129,129,0,754,753,1,354,354,0
"2021","Bracknell Forest 004","E02003355",5451,2287,2205,2190,2182,8,15,8,7,137,137,0,571,570,1,251,251,0
"2021","Bracknell Forest 005","E02003356",5743,1686,3080,3072,3060,12,8,4,4,100,100,0,555,555,0,322,322,0
"2021","Bracknell Forest 006","E02003357",8048,3227,3444,3435,3409,26,9,4,5,185,185,0,794,794,0,398,398,0
"2021","Bracknell Forest 007","E02003358",9493,3998,3969,3950,3928,22,19,2,17,257,256,1,857,853,4,412,411,1
"2021","Bracknell Forest 008","E02003359",5185,2042,2216,2210,2198,12,6,0,6,138,138,0,605,605,0,184,183,1
"2021","Bracknell Forest 009","E02003360",8900,3160,4350,4336,4318,18,14,6,8,190,187,3,831,829,2,369,369,0
"2021","Bracknell Forest 010","E02003361",5993,2171,2754,2734,2715,19,20,4,16,124,124,0,639,639,0,305,305,0
"2021","Bracknell Forest 011","E02003362",5320,1873,2470,2458,2451,7,12,8,4,119,119,0,580,580,0,278,277,1
"2021","Bracknell Forest 012","E02003363",5715,1916,2787,2772,2757,15,15,4,11,101,100,1,485,483,2,426,426,0
"2021","Bracknell Forest 013","E02003364",5689,1953,2873,2871,2853,18,2,2,0,103,102,1,516,514,2,244,244,0
"2021","Bracknell Forest 014","E02003365",5599,1707,2984,2982,2974,8,2,1,1,98,98,0,496,492,4,314,314,0
"2021","Bracknell Forest 015","E02003366",5971,2250,2892,2884,2873,11,8,6,2,100,99,1,452,452,0,277,276,1
"2021","West Berkshire 001","E02003367",5194,1469,2952,2948,2929,19,4,0,4,99,99,0,418,418,0,256,256,0
"2021","West Berkshire 002","E02003368",4759,1491,2409,2403,2387,16,6,2,4,93,93,0,461,461,0,305,305,0
"2021","West Berkshire 003","E02003369",5207,1371,3031,3021,3012,9,10,4,6,94,94,0,411,411,0,300,298,2
"2021","West Berkshire 004","E02003370",5545,1555,3172,3159,3150,9,13,2,11,74,74,0,441,437,4,303,303,0
"2021","West Berkshire 005","E02003371",4886,1422,2708,2706,2698,8,2,0,2,66,66,0,363,362,1,327,327,0
"2021","West Berkshire 006","E02003372",6331,1888,3448,3439,3432,7,9,8,1,110,110,0,524,524,0,361,361,0
"2021","West Berkshire 007","E02003373",6708,1944,3890,3881,3872,9,9,2,7,111,110,1,480,480,0,283,283,0
"2021","West Berkshire 008","E02003374",4803,1741,2309,2302,2289,13,7,4,3,90,90,0,462,461,1,201,201,0
"2021","West Berkshire 009","E02003375",5046,1744,2358,2350,2339,11,8,1,7,111,111,0,559,558,1,274,274,0
"2021","West Berkshire 010","E02003376",4844,1518,2312,2292,2277,15,20,8,12,110,108,2,534,531,3,370,370,0
"2021","West Berkshire 011","E02003377",8341,2464,4460,4440,4417,23,20,4,16,159,158,1,790,790,0,468,468,0
"2021","West Berkshire 012","E02003378",6629,2047,3193,3183,3170,13,10,4,6,150,150,0,667,666,1,572,570,2
"2021","West Berkshire 013","E02003379",5635,2144,2498,2494,2476,18,4,0,4,123,123,0,522,522,0,348,348,0
"2021","West Berkshire 014","E02003380",6711,2361,3280,3270,3261,9,10,6,4,131,130,1,600,599,1,339,339,0
"2021","West Berkshire 015","E02003381",4792,1296,2728,2720,2704,16,8,4,4,82,80,2,419,415,4,267,267,0
"2021","West Berkshire 016","E02003382",6059,2112,2694,2685,2681,4,9,4,5,143,143,0,675,674,1,435,434,1
"2021","West Berkshire 017","E02003383",5447,1666,2902,2901,2888,13,1,0,1,103,102,1,486,484,2,290,290,0
"2021","West Berkshire 018","E02003384",5395,1348,3170,3162,3154,8,8,6,2,83,82,1,420,419,1,374,374,0
"2021","West Berkshire 019","E02003385",9219,3840,3701,3687,3650,37,14,2,12,235,233,2,1007,1005,2,436,436,0
"2021","West Berkshire 020","E02003386",6683,2305,3145,3134,3125,9,11,5,6,137,136,1,700,698,2,396,396,0
"2021","West Berkshire 021","E02003387",7595,2063,4367,4365,4354,11,2,0,2,125,125,0,565,563,2,475,475,0
"2021","West Berkshire 022","E02003388",4907,1384,2676,2668,2662,6,8,2,6,116,115,1,444,444,0,287,287,0
"2021","Reading 001","E02003389",6514,1852,3567,3555,3540,15,12,4,8,100,100,0,558,558,0,437,437,0
"2021","Reading 002","E02003390",6115,1487,3874,3862,3853,9,12,2,10,58,58,0,349,349,0,347,346,1
"2021","Reading 003","E02003391",6721,2087,3530,3509,3487,22,21,11,10,108,108,0,522,519,3,474,474,0
"2021","Reading 004","E02003392",7001,3342,2576,2564,2546,18,12,8,4,182,179,3,621,621,0,280,280,0
"2021","Reading 005","E02003393",6595,2221,3301,3289,3279,10,12,2,10,130,130,0,516,516,0,427,425,2
"2021","Reading 006","E02003394",6623,2793,2746,2732,2702,30,14,6,8,166,166,0,589,588,1,329,329,0
"2021","Reading 007","E02003395",9051,4249,3695,3676,3647,29,19,12,7,209,205,4,631,630,1,267,266,1
"2021","Reading 008","E02003396",7901,3618,3151,3135,3114,21,16,8,8,183,182,1,620,618,2,329,328,1
"2021","Reading 009","E02003397",6377,2387,2797,2786,2770,16,11,2,9,152,152,0,602,602,0,439,439,0
"2021","Reading 010","E02003398",9437,4821,3535,3517,3498,19,18,12,6,207,206,1,612,607,5,262,261,1
"2021","Reading 012","E02003400",7829,4873,2248,2238,2221,17,10,4,6,97,96,1,314,314,0,297,297,0
"2021","Reading 013","E02003401",7402,3233,2980,2964,2950,14,16,8,8,184,182,2,639,638,1,366,364,2
"2021","Reading 014","E02003402",9117,5089,3128,3101,3071,30,27,14,13,153,150,3,511,509,2,236,234,2
"2021","Reading 015","E02003403",7461,2912,3269,3260,3242,18,9,0,9,150,150,0,681,680,1,449,449,0
"2021","Reading 016","E02003404",7228,4348,2070,2065,2053,12,5,4,1,111,111,0,404,404,0,295,295,0
"2021","Reading 017","E02003405",10160,4679,4103,4080,4049,31,23,16,7,255,253,2,786,782,4,337,336,1
"2021","Reading 018","E02003406",6536,2685,2816,2809,2799,10,7,4,3,130,129,1,556,553,3,349,348,1
"2021","Reading 019","E02006939",6117,3318,2124,2104,2083,21,20,7,13,120,119,1,457,455,2,98,97,1
"2021","Reading 020","E02006940",7174,4342,2183,2165,2137,28,18,14,4,113,110,3,421,420,1,115,115,0
"2021","Slough 001","E02003407",7833,3045,3561,3553,3541,12,8,4,4,207,206,1,670,668,2,350,347,3
"2021","Slough 002","E02003408",8400,2842,4357,4347,4339,8,10,10,0,212,211,1,627,627,0,362,362,0
"2021","Slough 003","E02003409",8105,3093,3708,3698,3676,22,10,4,6,215,214,1,710,710,0,379,378,1
"2021","Slough 004","E02003410",9087,3142,4737,4722,4706,16,15,10,5,229,227,2,547,546,1,432,432,0
"2021","Slough 005","E02003411",9322,3228,4855,4845,4829,16,10,2,8,201,200,1,554,554,0,484,484,0
"2021","Slough 006","E02003412",7885,2722,3991,3985,3975,10,6,0,6,186,185,1,616,616,0,370,370,0
"2021","Slough 008","E02003414",10068,3602,5050,5029,5013,16,21,14,7,278,275,3,775,773,2,363,363,0
"2021","Slough 009","E02003415",10026,3715,4918,4900,4887,13,18,10,8,259,259,0,700,700,0,434,432,2
"2021","Slough 010","E02003416",7354,2338,4047,4039,4025,14,8,2,6,138,138,0,515,515,0,316,316,0
"2021","Slough 011","E02003417",9800,3336,5173,5149,5126,23,24,12,12,219,217,2,700,696,4,372,372,0
"2021","Slough 012","E02003418",7829,2690,4029,4025,4018,7,4,2,2,191,190,1,545,544,1,374,374,0
"2021","Slough 013","E02003419",6811,2362,3338,3332,3323,9,6,2,4,179,178,1,633,631,2,299,298,1
"2021","Slough 014","E02003420",4918,1789,2286,2280,2265,15,6,2,4,136,135,1,511,511,0,196,196,0
"2021","Slough 015","E02007068",5310,1885,2779,2771,2759,12,8,6,2,147,143,4,316,316,0,183,183,0
"2021","Slough 016","E02007069",6190,2109,3333,3328,3318,10,5,4,1,128,127,1,383,383,0,237,235,2
"2021","Windsor and Maidenhead 001","E02003421",4570,1261,2626,2620,2614,6,6,2,4,57,57,0,340,340,0,286,286,0
"2021","Windsor and Maidenhead 002","E02003422",9740,2524,5497,5463,5439,24,34,15,19,178,178,0,911,909,2,630,630,0
"2021","Windsor and Maidenhead 003","E02003423",5103,1763,2577,2566,2554,12,11,4,7,96,95,1,396,396,0,271,271,0
"2021","Windsor and Maidenhead 004","E02003424",7733,2290,4244,4219,4199,20,25,14,11,115,115,0,586,583,3,498,498,0
"2021","Windsor and Maidenhead 005","E02003425",10440,4098,4651,4624,4573,51,27,6,21,254,254,0,930,927,3,507,506,1
"2021","Windsor and Maidenhead 006","E02003426",7886,2284,4448,4432,4418,14,16,10,6,103,102,1,574,574,0,477,476,1
"2021","Windsor and Maidenhead 007","E02003427",6362,2309,3052,3037,3024,13,15,4,11,151,151,0,528,526,2,322,322,0
"2021","Windsor and Maidenhead 008","E02003428",7235,2119,3936,3924,3907,17,12,4,8,148,147,1,604,602,2,428,428,0
"2021","Windsor and Maidenhead 009","E02003429",6287,1779,3516,3494,3483,11,22,8,14,105,105,0,507,507,0,380,378,2
"2021","Windsor and Maidenhead 010","E02003430",5965,2759,2292,2282,2240,42,10,2,8,136,136,0,537,536,1,241,240,1
"2021","Windsor and Maidenhead 011","E02003431",5713,1871,2854,2831,2816,15,23,6,17,131,129,2,522,521,1,335,335,0
"2021","Windsor and Maidenhead 012","E02003432",5811,2255,2463,2448,2415,33,15,6,9,138,136,2,638,635,3,317,317,0
"2021","Windsor and Maidenhead 013","E02003433",5206,1570,2667,2652,2645,7,15,2,13,107,107,0,490,487,3,372,372,0
"2021","Windsor and Maidenhead 014","E02003434",7331,2658,3248,3237,3218,19,11,4,7,156,156,0,713,712,1,556,556,0
"2021","Windsor and Maidenhead 015","E02003435",5769,1722,3216,3212,3190,22,4,0,4,83,82,1,479,479,0,269,269,0
"2021","Windsor and Maidenhead 016","E02003436",7522,2097,4110,4087,4068,19,23,10,13,153,151,2,641,638,3,521,520,1
"2021","Windsor and Maidenhead 017","E02003437",6015,1765,3229,3221,3211,10,8,2,6,137,137,0,536,536,0,348,348,0
"2021","Windsor and Maidenhead 018","E02003438",8985,2475,4934,4915,4904,11,19,4,15,162,162,0,776,774,2,638,638,0
"2021","Wokingham 001","E02003439",4536,1070,2680,2672,2662,10,8,0,8,71,71,0,375,375,0,340,340,0
"2021","Wokingham 002","E02003440",7360,2018,4139,4122,4105,17,17,8,9,117,116,1,602,599,3,484,484,0
"2021","Wokingham 003","E02003441",6256,1618,3613,3601,3590,11,12,8,4,90,90,0,477,477,0,458,458,0
"2021","Wokingham 004","E02003442",6619,2072,3676,3670,3652,18,6,4,2,109,108,1,499,499,0,263,263,0
"2021","Wokingham 005","E02003443",5418,1701,2687,2682,2677,5,5,2,3,106,104,2,490,487,3,434,433,1
"2021","Wokingham 006","E02003444",7405,2154,4318,4312,4298,14,6,2,4,97,97,0,397,397,0,439,439,0
"2021","Wokingham 007","E02003445",6959,1898,3953,3944,3927,17,9,4,5,111,111,0,552,547,5,445,445,0
"2021","Wokingham 008","E02003446",8191,3265,4126,4117,4105,12,9,4,5,69,69,0,372,372,0,359,358,1
"2021","Wokingham 009","E02003447",8333,2512,4620,4609,4587,22,11,2,9,142,142,0,667,666,1,392,391,1
"2021","Wokingham 010","E02003448",6378,1796,3677,3669,3658,11,8,2,6,109,109,0,485,485,0,311,311,0
"2021","Wokingham 011","E02003449",5971,2052,3076,3070,3062,8,6,0,6,100,99,1,524,521,3,219,218,1
"2021","Wokingham 012","E02003450",10277,3562,5435,5416,5386,30,19,10,9,159,159,0,677,677,0,444,444,0
"2021","Wokingham 013","E02003451",7976,2933,3341,3334,3318,16,7,3,4,194,194,0,837,836,1,671,670,1
"2021","Wokingham 014","E02003452",7295,2246,4097,4083,4074,9,14,8,6,129,129,0,518,518,0,305,304,1
"2021","Wokingham 015","E02003453",5571,1355,3542,3540,3527,13,2,0,2,72,72,0,346,346,0,256,256,0
"2021","Wokingham 016","E02003454",7021,2093,3779,3770,3753,17,9,4,5,118,117,1,544,543,1,487,487,0
"2021","Wokingham 017","E02003455",8242,2628,4453,4425,4406,19,28,4,24,173,173,0,643,641,2,345,345,0
"2021","Wokingham 018","E02003456",6262,2055,3216,3209,3192,17,7,4,3,154,152,2,579,577,2,258,256,2
"2021","Wokingham 019","E02003457",8023,1884,5077,5064,5055,9,13,3,10,92,92,0,573,573,0,397,397,0
"2021","Wokingham 020","E02003458",6724,1717,3996,3996,3982,14,0,0,0,100,100,0,518,518,0,393,392,1
"2021","Milton Keynes 001","E02003459",7405,2021,3968,3952,3938,14,16,4,12,141,141,0,759,758,1,516,516,0
"2021","Milton Keynes 002","E02003460",9410,2750,5041,5025,4998,27,16,2,14,232,231,1,831,830,1,556,556,0
"2021","Milton Keynes 003","E02003461",6047,1772,3152,3150,3134,16,2,2,0,113,111,2,559,558,1,451,451,0
"2021","Milton Keynes 004","E02003462",6548,2232,3089,3082,3060,22,7,0,7,187,186,1,664,663,1,376,376,0
"2021","Milton Keynes 005","E02003463",5634,1895,2677,2673,2648,25,4,2,2,146,144,2,594,593,1,322,322,0
"2021","Milton Keynes 006","E02003464",5471,2265,2176,2170,2161,9,6,0,6,164,161,3,576,576,0,290,290,0
"2021","Milton Keynes 007","E02003465",5217,1492,2685,2677,2667,10,8,4,4,100,100,0,530,529,1,410,410,0
"2021","Milton Keynes 008","E02003466",6133,2667,2529,2511,2484,27,18,8,10,161,159,2,539,538,1,237,237,0
"2021","Milton Keynes 009","E02003467",5287,2041,2107,2103,2092,11,4,2,2,158,158,0,616,615,1,365,365,0
"2021","Milton Keynes 010","E02003468",6983,2489,3103,3093,3066,27,10,2,8,168,165,3,747,744,3,476,476,0
"2021","Milton Keynes 011","E02003469",4725,1499,2378,2362,2353,9,16,2,14,85,85,0,493,490,3,270,270,0
"2021","Milton Keynes 012","E02003470",4479,1955,1633,1625,1613,12,8,2,6,177,173,4,505,505,0,209,209,0
"2021","Milton Keynes 013","E02003471",5361,2122,2306,2295,2283,12,11,6,5,123,122,1,530,528,2,280,280,0
"2021","Milton Keynes 014","E02003472",8382,4368,2833,2815,2799,16,18,10,8,286,283,3,710,708,2,185,184,1
"2021","Milton Keynes 015","E02003473",4529,1444,2406,2392,2381,11,14,2,12,90,89,1,391,388,3,198,198,0
"2021","Milton Keynes 016","E02003474",7016,2584,3314,3297,3270,27,17,10,7,189,185,4,647,646,1,282,281,1
"2021","Milton Keynes 018","E02003476",6735,3089,2364,2355,2331,24,9,0,9,236,236,0,741,740,1,305,305,0
"2021","Milton Keynes 020","E02003478",5449,1749,2808,2806,2798,8,2,0,2,125,124,1,514,514,0,253,253,0
"2021","Milton Keynes 021","E02003479",5927,2485,2414,2408,2388,20,6,4,2,194,192,2,595,594,1,239,239,0
"2021","Milton Keynes 022","E02003480",6518,2594,2882,2877,2866,11,5,4,1,173,173,0,668,665,3,201,201,0
"2021","Milton Keynes 023","E02003481",6334,2954,2164,2156,2138,18,8,7,1,242,240,2,668,668,0,306,305,1
"2021","Milton Keynes 024","E02003482",6987,2229,3544,3531,3504,27,13,6,7,165,165,0,670,667,3,379,378,1
"2021","Milton Keynes 025","E02003483",8558,2933,4512,4503,4474,29,9,2,7,208,207,1,687,686,1,218,218,0
"2021","Milton Keynes 026","E02003484",5723,2021,2781,2773,2757,16,8,4,4,127,125,2,539,538,1,255,255,0
"2021","Milton Keynes 027","E02003485",6542,2329,3048,3038,3021,17,10,4,6,171,168,3,559,559,0,435,434,1
"2021","Milton Keynes 028","E02003486",7749,2607,4063,4046,4032,14,17,12,5,168,168,0,694,692,2,217,217,0
"2021","Milton Keynes 029","E02003487",5942,1972,2911,2897,2883,14,14,6,8,147,146,1,507,507,0,405,405,0
"2021","Milton Keynes 030","E02003488",6740,2558,2929,2918,2906,12,11,6,5,191,190,1,602,600,2,460,460,0
"2021","Milton Keynes 031","E02003489",6174,2025,2988,2984,2974,10,4,0,4,133,133,0,568,567,1,460,460,0
"2021","Milton Keynes 032","E02003490",8077,3505,3165,3149,3133,16,16,4,12,289,289,0,777,773,4,341,341,0
"2021","Milton Keynes 033","E02007012",5931,2202,3011,3004,2985,19,7,0,7,132,132,0,447,446,1,139,139,0
"2021","Milton Keynes 034","E02007013",7049,2798,3461,3456,3443,13,5,0,5,189,187,2,512,512,0,89,89,0
"2021","Milton Keynes 035","E02007014",5544,2118,2511,2509,2503,6,2,2,0,148,147,1,500,500,0,267,267,0
"2021","Milton Keynes 036","E02007015",7228,2932,3433,3424,3407,17,9,6,3,150,148,2,528,526,2,185,184,1
"2021","Milton Keynes 037","E02007016",7009,2510,3588,3583,3560,23,5,4,1,119,119,0,513,513,0,279,279,0
"2021","Brighton and Hove 001","E02003491",6271,2272,2901,2871,2837,34,30,12,18,120,119,1,596,592,4,382,382,0
"2021","Brighton and Hove 002","E02003492",9193,6964,1499,1484,1458,26,15,1,14,106,103,3,390,390,0,234,234,0
"2021","Brighton and Hove 003","E02003493",6597,2112,3323,3285,3246,39,38,8,30,114,113,1,567,563,4,481,480,1
"2021","Brighton and Hove 004","E02003494",5345,1827,2714,2686,2650,36,28,2,26,97,93,4,463,459,4,244,243,1
"2021","Brighton and Hove 005","E02003495",5748,2154,2523,2503,2475,28,20,4,16,119,119,0,602,598,4,350,349,1
"2021","Brighton and Hove 006","E02003496",6153,2278,2760,2737,2720,17,23,6,17,133,133,0,581,579,2,401,401,0
"2021","Brighton and Hove 007","E02003497",6077,1775,3474,3445,3399,46,29,4,25,97,97,0,394,392,2,337,336,1
"2021","Brighton and Hove 008","E02003498",7104,4294,1748,1723,1671,52,25,10,15,166,162,4,619,613,6,277,274,3
"2021","Brighton and Hove 009","E02003499",6541,3798,1833,1805,1776,29,28,8,20,136,135,1,476,474,2,298,298,0
"2021","Brighton and Hove 010","E02003500",6419,2926,2719,2643,2567,76,76,30,46,117,116,1,494,487,7,163,163,0
"2021","Brighton and Hove 011","E02003501",6945,2970,2983,2901,2825,76,82,14,68,141,135,6,603,597,6,248,248,0
"2021","Brighton and Hove 012","E02003502",6262,2625,2526,2485,2440,45,41,10,31,160,155,5,627,625,2,324,323,1
"2021","Brighton and Hove 013","E02003503",7273,2808,3189,3168,3112,56,21,4,17,162,161,1,686,682,4,428,428,0
"2021","Brighton and Hove 014","E02003504",7342,4145,2297,2214,2136,78,83,28,55,143,139,4,553,543,10,204,204,0
"2021","Brighton and Hove 015","E02003505",8092,5833,1537,1420,1340,80,117,90,27,126,120,6,473,468,5,123,122,1
"2021","Brighton and Hove 016","E02003506",5638,2662,2177,2139,2068,71,38,10,28,115,112,3,514,502,12,170,169,1
"2021","Brighton and Hove 017","E02003507",8003,2867,3705,3651,3564,87,54,4,50,152,152,0,685,676,9,594,591,3
"2021","Brighton and Hove 018","E02003508",7510,4911,1864,1804,1732,72,60,10,50,135,132,3,441,434,7,159,159,0
"2021","Brighton and Hove 019","E02003509",7743,4373,2005,1949,1883,66,56,4,52,217,212,5,830,809,21,318,313,5
"2021","Brighton and Hove 020","E02003510",7443,3816,2400,2335,2260,75,65,10,55,150,146,4,718,704,14,359,358,1
"2021","Brighton and Hove 021","E02003511",6840,2833,2867,2833,2739,94,34,4,30,155,149,6,675,668,7,310,310,0
"2021","Brighton and Hove 022","E02003512",7822,5376,1624,1557,1483,74,67,17,50,127,118,9,543,530,13,152,150,2
"2021","Brighton and Hove 023","E02003513",5328,2129,2209,2165,2125,40,44,4,40,120,117,3,498,498,0,372,370,2
"2021","Brighton and Hove 024","E02003514",7696,5165,1629,1554,1476,78,75,14,61,137,135,2,629,621,8,136,133,3
"2021","Brighton and Hove 025","E02003515",7254,3795,2100,2073,2018,55,27,4,23,178,174,4,787,780,7,394,391,3
"2021","Brighton and Hove 026","E02003516",7457,4729,1581,1518,1407,111,63,6,57,172,167,5,759,755,4,216,213,3
"2021","Brighton and Hove 027","E02003517",9887,6850,1893,1790,1636,154,103,14,89,181,171,10,788,775,13,175,172,3
"2021","Brighton and Hove 028","E02003518",6752,3461,1915,1864,1792,72,51,2,49,178,177,1,778,761,17,420,417,3
"2021","Brighton and Hove 029","E02003519",7653,5169,1450,1382,1288,94,68,12,56,146,142,4,749,738,11,139,135,4
"2021","Brighton and Hove 030","E02003520",8222,5415,1670,1578,1478,100,92,8,84,172,165,7,697,690,7,268,261,7
"2021","Brighton and Hove 031","E02003521",7279,4299,1714,1599,1477,122,115,6,109,163,154,9,757,736,21,346,311,35
"2021","Brighton and Hove 032","E02003522",6710,3388,2125,2029,1877,152,96,6,90,164,157,7,747,738,9,286,281,5
"2021","Brighton and Hove 033","E02003523",8775,2731,4286,4168,4038,130,118,14,104,156,152,4,910,903,7,692,685,7
"2021","Portsmouth 001","E02003524",6246,2682,2335,2318,2291,27,17,10,7,175,174,1,708,706,2,346,346,0
"2021","Portsmouth 002","E02003525",5004,2252,1832,1824,1820,4,8,0,8,153,152,1,516,516,0,251,250,1
"2021","Portsmouth 003","E02003526",5731,1510,3127,3116,3105,11,11,2,9,96,95,1,433,432,1,565,563,2
"2021","Portsmouth 004","E02003527",5141,1785,2309,2295,2284,11,14,4,10,122,121,1,620,619,1,305,305,0
"2021","Portsmouth 006","E02003529",6635,2285,3162,3145,3131,14,17,8,9,131,129,2,666,663,3,391,391,0
"2021","Portsmouth 007","E02003530",6276,2170,2950,2940,2916,24,10,0,10,177,176,1,637,637,0,342,342,0
"2021","Portsmouth 008","E02003531",6464,2229,3085,3080,3061,19,5,0,5,113,113,0,648,644,4,389,389,0
"2021","Portsmouth 009","E02003532",6332,2574,2567,2559,2529,30,8,3,5,173,170,3,718,716,2,300,299,1
"2021","Portsmouth 010","E02003533",4577,1989,1604,1599,1579,20,5,2,3,135,134,1,584,581,3,265,265,0
"2021","Portsmouth 011","E02003534",7072,2918,2974,2956,2941,15,18,0,18,171,169,2,705,703,2,304,304,0
"2021","Portsmouth 012","E02003535",7494,3443,2729,2717,2695,22,12,6,6,194,194,0,808,804,4,320,320,0
"2021","Portsmouth 013","E02003536",6088,3015,1730,1710,1692,18,20,7,13,213,211,2,784,782,2,346,346,0
"2021","Portsmouth 014","E02003537",8312,3224,3596,3584,3558,26,12,6,6,212,212,0,812,811,1,468,465,3
"2021","Portsmouth 015","E02003538",8217,4094,2657,2639,2604,35,18,10,8,237,235,2,899,897,2,330,330,0
"2021","Portsmouth 017","E02003540",7690,2798,3380,3363,3328,35,17,8,9,157,157,0,791,790,1,564,562,2
"2021","Portsmouth 018","E02003541",8980,5619,1953,1939,1923,16,14,3,11,215,214,1,795,794,1,398,397,1
"2021","Portsmouth 019","E02003542",7411,4038,2282,2268,2240,28,14,6,8,146,145,1,643,640,3,302,300,2
"2021","Portsmouth 020","E02003543",7683,4918,1810,1798,1761,37,12,2,10,155,154,1,575,571,4,225,225,0
"2021","Portsmouth 021","E02003544",5130,2362,1840,1823,1777,46,17,2,15,139,137,2,579,577,2,210,208,2
"2021","Portsmouth 022","E02003545",6095,3329,1669,1649,1621,28,20,6,14,149,144,5,669,662,7,279,278,1
"2021","Portsmouth 023","E02003546",6721,2517,2840,2828,2794,34,12,0,12,180,171,9,796,795,1,388,387,1
"2021","Portsmouth 024","E02003547",7404,3508,2451,2423,2396,27,28,6,22,176,176,0,791,787,4,478,474,4
"2021","Portsmouth 025","E02003548",5365,2586,1879,1870,1849,21,9,1,8,112,110,2,539,538,1,249,246,3
"2021","Portsmouth 026","E02006821",5346,1581,2907,2903,2888,15,4,4,0,97,96,1,413,412,1,348,347,1
"2021","Portsmouth 027","E02006975",9326,7477,1063,1049,1039,10,14,6,8,141,140,1,462,462,0,183,183,0
"2021","Portsmouth 028","E02006976",4073,1998,1147,1139,1128,11,8,4,4,154,154,0,568,566,2,206,206,0
"2021","Southampton 001","E02003549",7401,3957,2672,2660,2645,15,12,4,8,100,99,1,390,388,2,282,281,1
"2021","Southampton 002","E02003550",6363,2351,2939,2925,2909,16,14,4,10,138,137,1,597,597,0,338,338,0
"2021","Southampton 003","E02003551",5574,3157,1515,1509,1502,7,6,2,4,117,117,0,551,548,3,234,234,0
"2021","Southampton 004","E02003552",5030,1876,2050,2043,2040,3,7,2,5,114,114,0,628,628,0,362,361,1
"2021","Southampton 005","E02003553",6028,3584,1784,1773,1766,7,11,10,1,117,116,1,359,359,0,184,183,1
"2021","Southampton 006","E02003554",5142,1999,2224,2211,2199,12,13,2,11,96,96,0,449,447,2,374,374,0
"2021","Southampton 007","E02003555",6874,2823,2772,2763,2753,10,9,4,5,175,175,0,731,729,2,373,373,0
"2021","Southampton 008","E02003556",4597,1600,2208,2194,2182,12,14,8,6,98,98,0,416,415,1,275,275,0
"2021","Southampton 009","E02003557",5958,3223,2031,2007,1998,9,24,6,18,85,84,1,358,355,3,261,260,1
"2021","Southampton 010","E02003558",5635,2416,2146,2139,2118,21,7,7,0,171,171,0,617,615,2,285,284,1
"2021","Southampton 011","E02003559",6269,2014,3393,3378,3363,15,15,8,7,98,98,0,428,427,1,336,335,1
"2021","Southampton 012","E02003560",5625,2606,1950,1933,1919,14,17,14,3,153,153,0,621,619,2,295,295,0
"2021","Southampton 013","E02003561",6949,4285,1697,1681,1674,7,16,4,12,130,129,1,565,563,2,272,272,0
"2021","Southampton 014","E02003562",6741,2700,2857,2848,2822,26,9,4,5,164,162,2,690,686,4,330,330,0
"2021","Southampton 015","E02003563",6390,2622,2551,2532,2514,18,19,2,17,171,168,3,677,675,2,369,369,0
"2021","Southampton 016","E02003564",6403,2440,2711,2705,2690,15,6,0,6,163,163,0,686,685,1,403,403,0
"2021","Southampton 017","E02003565",6059,4160,1281,1269,1258,11,12,2,10,99,99,0,357,357,0,162,162,0
"2021","Southampton 018","E02003566",5139,1850,2208,2201,2191,10,7,2,5,146,144,2,575,573,2,360,360,0
"2021","Southampton 019","E02003567",6256,2587,2604,2592,2582,10,12,8,4,137,137,0,635,633,2,293,292,1
"2021","Southampton 020","E02003568",7119,3833,2360,2333,2300,33,27,13,14,144,143,1,581,580,1,201,200,1
"2021","Southampton 021","E02003569",6526,3220,2156,2138,2099,39,18,7,11,199,196,3,736,735,1,215,215,0
"2021","Southampton 022","E02003570",9187,5131,2998,2986,2962,24,12,6,6,222,219,3,604,603,1,232,231,1
"2021","Southampton 023","E02003571",8237,6150,1306,1292,1272,20,14,2,12,106,104,2,438,438,0,237,237,0
"2021","Southampton 024","E02003572",4994,1652,2466,2458,2429,29,8,4,4,125,125,0,459,457,2,292,290,2
"2021","Southampton 025","E02003573",6163,2447,2492,2490,2483,7,2,2,0,146,146,0,650,648,2,428,428,0
"2021","Southampton 026","E02003574",6373,2156,3007,3003,2986,17,4,2,2,141,141,0,655,655,0,414,414,0
"2021","Southampton 027","E02003575",4930,2192,1692,1686,1675,11,6,2,4,150,149,1,609,605,4,287,286,1
"2021","Southampton 028","E02003576",6457,2620,2588,2567,2546,21,21,12,9,186,182,4,758,757,1,305,303,2
"2021","Southampton 030","E02003578",5225,1995,2268,2256,2246,10,12,0,12,141,140,1,524,522,2,297,297,0
"2021","Southampton 031","E02003579",7868,3489,3008,2989,2964,25,19,3,16,198,195,3,790,789,1,383,381,2
"2021","Southampton 032","E02003580",4697,2030,1670,1662,1647,15,8,8,0,143,142,1,605,605,0,249,249,0
"2021","Southampton 033","E02007074",7304,4921,1614,1600,1587,13,14,12,2,148,146,2,471,469,2,150,148,2
"2021","Southampton 034","E02007075",4850,2943,1302,1289,1270,19,13,2,11,114,112,2,418,413,5,73,73,0
"2021","Isle of Wight 001","E02003581",6469,2434,2484,2452,2430,22,32,12,20,208,208,0,903,900,3,440,440,0
"2021","Isle of Wight 002","E02003582",7157,1984,3773,3768,3746,22,5,4,1,118,117,1,729,727,2,553,552,1
"2021","Isle of Wight 003","E02003583",6425,2078,2980,2967,2949,18,13,4,9,137,135,2,751,750,1,479,479,0
"2021","Isle of Wight 004","E02003584",5409,2306,1677,1668,1642,26,9,2,7,189,189,0,853,852,1,384,381,3
"2021","Isle of Wight 005","E02003585",5750,1346,3150,3141,3134,7,9,2,7,95,95,0,609,609,0,550,550,0
"2021","Isle of Wight 006","E02003586",6371,2016,2922,2907,2894,13,15,4,11,148,148,0,736,734,2,549,547,2
"2021","Isle of Wight 007","E02003587",6926,2603,2778,2762,2742,20,16,8,8,201,201,0,902,902,0,442,441,1
"2021","Isle of Wight 008","E02003588",7640,2973,2988,2963,2935,28,25,8,17,230,227,3,988,985,3,461,461,0
"2021","Isle of Wight 009","E02003589",6022,2553,2102,2092,2078,14,10,4,6,195,194,1,815,815,0,357,357,0
"2021","Isle of Wight 010","E02003590",6510,1333,3666,3650,3639,11,16,10,6,101,100,1,699,699,0,711,708,3
"2021","Isle of Wight 011","E02003591",7755,2536,3632,3613,3585,28,19,8,11,165,165,0,826,826,0,596,594,2
"2021","Isle of Wight 012","E02003592",8665,2232,4327,4310,4287,23,17,10,7,207,206,1,946,945,1,953,951,2
"2021","Isle of Wight 013","E02003593",4656,1048,2679,2658,2644,14,21,8,13,92,91,1,481,481,0,356,353,3
"2021","Isle of Wight 014","E02003594",7963,2596,3464,3447,3430,17,17,4,13,243,242,1,1019,1016,3,641,639,2
"2021","Isle of Wight 015","E02003595",7038,1707,3839,3831,3807,24,8,2,6,121,121,0,714,714,0,657,657,0
"2021","Isle of Wight 016","E02003596",7555,2294,3318,3295,3275,20,23,6,17,220,220,0,1032,1031,1,691,690,1
"2021","Isle of Wight 017","E02003597",4941,1212,2749,2729,2721,8,20,9,11,86,86,0,498,498,0,396,393,3
"2021","Isle of Wight 018","E02003598",6329,1809,2899,2879,2842,37,20,6,14,169,169,0,866,865,1,586,586,0
"2021","Buckinghamshire 001","E02003652",8227,2662,4256,4252,4240,12,4,4,0,169,169,0,723,721,2,417,417,0
"2021","Buckinghamshire 002","E02003653",5537,1982,2492,2482,2476,6,10,0,10,150,147,3,556,553,3,357,357,0
"2021","Buckinghamshire 003","E02003654",4813,1183,2858,2849,2841,8,9,2,7,81,81,0,403,403,0,288,288,0
"2021","Buckinghamshire 004","E02003655",8392,2332,4636,4616,4590,26,20,6,14,173,173,0,808,806,2,443,443,0
"2021","Buckinghamshire 005","E02003656",5504,1691,2824,2816,2809,7,8,0,8,110,110,0,505,502,3,374,373,1
"2021","Buckinghamshire 006","E02003657",6029,1577,3477,3471,3462,9,6,4,2,101,101,0,516,516,0,358,358,0
"2021","Buckinghamshire 007","E02003658",7999,2454,4250,4233,4217,16,17,6,11,163,161,2,660,657,3,472,472,0
"2021","Buckinghamshire 009","E02003659",7659,2358,4070,4052,4018,34,18,6,12,169,165,4,676,675,1,386,386,0
"2021","Buckinghamshire 008","E02003660",8753,2323,4993,4981,4966,15,12,0,12,176,176,0,796,795,1,465,465,0
"2021","Buckinghamshire 010","E02003661",4916,1515,2584,2581,2573,8,3,2,1,96,96,0,467,466,1,254,254,0
"2021","Buckinghamshire 012","E02003662",5072,1896,2260,2248,2241,7,12,6,6,144,142,2,529,527,2,243,242,1
"2021","Buckinghamshire 011","E02003663",10136,3903,4947,4941,4906,35,6,4,2,220,219,1,797,795,2,269,268,1
"2021","Buckinghamshire 013","E02003664",6174,2463,2630,2622,2616,6,8,2,6,144,140,4,623,621,2,314,314,0
"2021","Buckinghamshire 014","E02003665",4944,1970,2177,2171,2165,6,6,2,4,111,111,0,460,459,1,226,226,0
"2021","Buckinghamshire 015","E02003666",6229,2667,2445,2435,2419,16,10,6,4,181,180,1,636,634,2,300,300,0
"2021","Buckinghamshire 016","E02003667",7489,2833,3460,3445,3414,31,15,2,13,188,188,0,759,757,2,249,249,0
"2021","Buckinghamshire 018","E02003668",7103,1887,4061,4054,4045,9,7,4,3,101,101,0,497,496,1,557,557,0
"2021","Buckinghamshire 017","E02003669",5644,2262,2451,2439,2434,5,12,4,8,139,138,1,539,538,1,253,253,0
"2021","Buckinghamshire 019","E02003670",7404,2588,3597,3593,3577,16,4,0,4,155,155,0,717,715,2,347,347,0
"2021","Buckinghamshire 020","E02003671",4693,1849,2036,2030,2019,11,6,2,4,121,119,2,495,489,6,192,192,0
"2021","Buckinghamshire 021","E02003672",10008,2792,5635,5611,5589,22,24,12,12,167,165,2,815,812,3,599,599,0
"2021","Buckinghamshire 022","E02003673",7703,1890,4499,4486,4479,7,13,0,13,142,141,1,615,614,1,557,556,1
"2021","Buckinghamshire 023","E02003674",4511,1032,2749,2741,2736,5,8,2,6,76,76,0,372,369,3,282,281,1
"2021","Buckinghamshire 024","E02003675",7827,2606,3849,3828,3795,33,21,6,15,173,170,3,735,734,1,464,463,1
"2021","Buckinghamshire 029","E02003676",6725,1611,4091,4073,4054,19,18,3,15,89,89,0,511,510,1,423,422,1
"2021","Buckinghamshire 027","E02003677",8144,2810,4055,4052,4024,28,3,1,2,180,178,2,633,633,0,466,466,0
"2021","Buckinghamshire 028","E02003678",4672,1424,2536,2522,2519,3,14,6,8,87,87,0,333,332,1,292,292,0
"2021","Buckinghamshire 030","E02003679",5567,2120,2306,2295,2276,19,11,4,7,151,151,0,643,643,0,347,347,0
"2021","Buckinghamshire 031","E02003680",8022,2079,4558,4546,4537,9,12,4,8,134,134,0,655,655,0,596,595,1
"2021","Buckinghamshire 032","E02003681",8286,2194,4799,4787,4776,11,12,3,9,127,126,1,542,541,1,624,623,1
"2021","Buckinghamshire 034","E02003682",6034,1672,3461,3455,3439,16,6,1,5,98,98,0,444,444,0,359,359,0
"2021","Buckinghamshire 035","E02003683",5582,1475,3360,3354,3346,8,6,4,2,78,78,0,367,366,1,302,302,0
"2021","Buckinghamshire 047","E02003685",6417,1568,3845,3836,3816,20,9,1,8,104,104,0,483,483,0,417,414,3
"2021","Buckinghamshire 050","E02003686",6193,1693,3511,3497,3486,11,14,6,8,75,74,1,436,435,1,478,478,0
"2021","Buckinghamshire 054","E02003687",4583,1252,2643,2633,2629,4,10,2,8,63,63,0,306,306,0,319,319,0
"2021","Buckinghamshire 053","E02003688",9679,2686,5352,5339,5322,17,13,4,9,157,157,0,766,766,0,718,718,0
"2021","Buckinghamshire 058","E02003689",7470,1949,4517,4501,4489,12,16,4,12,104,104,0,383,380,3,517,517,0
"2021","Buckinghamshire 059","E02003690",6232,2047,2927,2915,2904,11,12,6,6,136,135,1,572,569,3,550,549,1
"2021","Buckinghamshire 063","E02003691",5827,1549,3261,3249,3242,7,12,4,8,107,107,0,482,481,1,428,428,0
"2021","Buckinghamshire 064","E02003692",7350,2155,3976,3962,3948,14,14,10,4,146,146,0,566,565,1,507,507,0
"2021","Buckinghamshire 065","E02003693",6042,1636,3465,3453,3439,14,12,4,8,92,92,0,446,446,0,403,400,3
"2021","Buckinghamshire 066","E02003694",6784,2238,3308,3298,3286,12,10,6,4,142,141,1,652,652,0,444,444,0
"2021","Buckinghamshire 067","E02003695",8821,2830,4636,4632,4611,21,4,0,4,156,156,0,687,686,1,512,510,2
"2021","Buckinghamshire 026","E02003696",7152,1987,3701,3693,3677,16,8,2,6,138,137,1,646,646,0,680,680,0
"2021","Buckinghamshire 025","E02003697",5208,1354,3118,3110,3103,7,8,2,6,72,71,1,377,377,0,287,287,0
"2021","Buckinghamshire 033","E02003698",6923,1677,4288,4274,4261,13,14,8,6,85,85,0,463,462,1,410,409,1
"2021","Buckinghamshire 037","E02003699",4810,1492,2453,2448,2439,9,5,2,3,71,70,1,453,452,1,341,341,0
"2021","Buckinghamshire 038","E02003701",9714,3402,4786,4774,4759,15,12,2,10,179,178,1,753,750,3,594,594,0
"2021","Buckinghamshire 040","E02003702",6859,1993,3806,3801,3781,20,5,0,5,137,137,0,594,593,1,329,329,0
"2021","Buckinghamshire 041","E02003703",7116,2775,3384,3374,3356,18,10,5,5,157,156,1,545,544,1,255,255,0
"2021","Buckinghamshire 045","E02003704",4694,1271,2769,2766,2753,13,3,2,1,67,66,1,334,333,1,253,253,0
"2021","Buckinghamshire 042","E02003705",5531,2203,2533,2527,2522,5,6,2,4,150,147,3,421,421,0,224,224,0
"2021","Buckinghamshire 043","E02003706",5343,2065,2431,2431,2417,14,0,0,0,129,125,4,466,465,1,252,252,0
"2021","Buckinghamshire 044","E02003707",5310,2117,2476,2465,2448,17,11,3,8,120,119,1,399,399,0,198,198,0
"2021","Buckinghamshire 046","E02003708",7508,3064,3408,3400,3376,24,8,6,2,195,193,2,524,524,0,317,316,1
"2021","Buckinghamshire 048","E02003709",4390,1792,1850,1848,1837,11,2,1,1,121,121,0,407,406,1,220,220,0
"2021","Buckinghamshire 049","E02003710",10073,4247,4681,4677,4640,37,4,2,2,188,187,1,544,542,2,413,413,0
"2021","Buckinghamshire 051","E02003711",7752,3339,3070,3061,3031,30,9,2,7,195,194,1,820,818,2,328,328,0
"2021","Buckinghamshire 052","E02003712",6595,2117,3158,3153,3148,5,5,3,2,147,147,0,660,658,2,513,512,1
"2021","Buckinghamshire 055","E02003713",4788,1312,2700,2699,2692,7,1,1,0,54,54,0,361,361,0,361,360,1
"2021","Buckinghamshire 056","E02003714",5451,1973,2483,2471,2450,21,12,6,6,129,126,3,564,564,0,302,302,0
"2021","Buckinghamshire 057","E02003715",5314,1155,3429,3415,3410,5,14,8,6,67,67,0,363,363,0,300,300,0
"2021","Buckinghamshire 060","E02003716",4931,1525,2453,2439,2434,5,14,6,8,87,87,0,520,520,0,346,346,0
"2021","Buckinghamshire 062","E02003717",7285,1827,3933,3929,3921,8,4,2,2,137,137,0,777,774,3,611,608,3
"2021","Buckinghamshire 061","E02003718",4493,1390,2162,2158,2147,11,4,2,2,96,95,1,516,516,0,329,329,0
"2021","Buckinghamshire 039","E02006823",7242,1611,4491,4481,4471,10,10,0,10,94,94,0,504,503,1,542,542,0
"2021","Buckinghamshire 036","E02006824",7722,2080,4341,4325,4315,10,16,9,7,128,125,3,621,621,0,552,552,0
"2021","Eastbourne 001","E02004356",5942,2196,2457,2445,2436,9,12,4,8,169,168,1,745,742,3,375,375,0
"2021","Eastbourne 002","E02004357",5999,2328,2467,2449,2427,22,18,8,10,160,160,0,713,706,7,331,331,0
"2021","Eastbourne 003","E02004358",6467,2073,2890,2872,2845,27,18,4,14,165,164,1,752,750,2,587,587,0
"2021","Eastbourne 004","E02004359",6498,2131,2932,2917,2893,24,15,1,14,144,142,2,712,712,0,579,577,2
"2021","Eastbourne 006","E02004361",6566,1917,3363,3334,3310,24,29,6,23,134,134,0,662,659,3,490,488,2
"2021","Eastbourne 007","E02004362",7080,2642,3048,3026,2988,38,22,6,16,183,181,2,791,788,3,416,415,1
"2021","Eastbourne 008","E02004363",6005,2212,2373,2355,2314,41,18,2,16,161,158,3,737,733,4,522,519,3
"2021","Eastbourne 009","E02004364",6894,2378,2858,2826,2797,29,32,2,30,162,160,2,975,973,2,521,521,0
"2021","Eastbourne 010","E02004365",7039,3752,1795,1773,1748,25,22,8,14,295,291,4,927,921,6,270,267,3
"2021","Eastbourne 011","E02004366",6741,2856,2071,2027,1975,52,44,10,34,194,187,7,932,926,6,688,681,7
"2021","Eastbourne 012","E02004367",6094,1623,2887,2857,2819,38,30,3,27,123,121,2,686,682,4,775,769,6
"2021","Eastbourne 013","E02006857",7356,2344,3385,3363,3338,25,22,0,22,169,169,0,863,859,4,595,595,0
"2021","Eastbourne 014","E02006858",5898,1836,2670,2642,2623,19,28,2,26,171,170,1,812,809,3,409,408,1
"2021","Hastings 001","E02004368",6702,2249,3250,3239,3210,29,11,2,9,165,164,1,664,663,1,374,373,1
"2021","Hastings 002","E02004369",8608,2286,4543,4517,4478,39,26,14,12,151,150,1,831,831,0,797,793,4
"2021","Hastings 003","E02004370",6232,2624,2238,2220,2196,24,18,12,6,203,197,6,824,821,3,343,343,0
"2021","Hastings 004","E02004371",5597,2246,2205,2182,2162,20,23,3,20,155,154,1,660,659,1,331,329,2
"2021","Hastings 005","E02004372",5344,2417,1758,1742,1718,24,16,6,10,215,212,3,685,681,4,269,268,1
"2021","Hastings 006","E02004373",7110,2625,2950,2929,2913,16,21,10,11,179,177,2,876,875,1,480,480,0
"2021","Hastings 007","E02004374",6152,2462,2286,2244,2186,58,42,12,30,178,174,4,812,811,1,414,410,4
"2021","Hastings 008","E02004375",7037,3002,2476,2416,2365,51,60,14,46,183,182,1,987,984,3,389,386,3
"2021","Hastings 009","E02004376",5898,3046,1495,1454,1431,23,41,6,35,239,234,5,870,867,3,248,248,0
"2021","Hastings 010","E02004377",8955,3133,3815,3780,3731,49,35,8,27,234,229,5,1070,1062,8,703,698,5
"2021","Hastings 011","E02004378",7065,3519,1694,1654,1607,47,40,12,28,300,296,4,1202,1192,10,350,348,2
"2021","Lewes 001","E02004379",6279,1761,3510,3493,3469,24,17,7,10,127,127,0,514,512,2,367,367,0
"2021","Lewes 002","E02004380",8078,2166,4431,4407,4379,28,24,4,20,131,131,0,678,675,3,672,672,0
"2021","Lewes 003","E02004381",7779,2870,3163,3112,3077,35,51,30,21,237,235,2,1001,992,9,508,505,3
"2021","Lewes 004","E02004382",5398,1472,2801,2783,2759,24,18,0,18,89,89,0,564,560,4,472,472,0
"2021","Lewes 005","E02004383",6042,2139,2779,2745,2712,33,34,10,24,142,139,3,654,649,5,328,327,1
"2021","Lewes 006","E02004384",6197,2017,2889,2824,2745,79,65,4,61,137,132,5,669,660,9,485,483,2
"2021","Lewes 007","E02004385",6440,2057,3012,2978,2927,51,34,0,34,137,133,4,698,698,0,536,535,1
"2021","Lewes 008","E02004386",5427,1873,2345,2320,2286,34,25,8,17,172,170,2,622,615,7,415,415,0
"2021","Lewes 009","E02004387",4648,1935,1801,1787,1762,25,14,2,12,151,149,2,547,546,1,214,214,0
"2021","Lewes 010","E02004388",6366,2197,2789,2756,2672,84,33,4,29,156,152,4,730,721,9,494,492,2
"2021","Lewes 011","E02004389",8139,1981,4418,4398,4352,46,20,2,18,125,121,4,782,778,4,833,829,4
"2021","Lewes 012","E02004390",6764,1780,3632,3605,3581,24,27,2,25,130,129,1,601,600,1,621,621,0
"2021","Lewes 013","E02004391",5669,1897,2208,2186,2143,43,22,4,18,180,176,4,804,800,4,580,576,4
"2021","Rother 001","E02004392",7570,1992,4113,4095,4074,21,18,4,14,147,147,0,809,807,2,509,507,2
"2021","Rother 002","E02004393",5519,1416,2931,2907,2890,17,24,12,12,130,130,0,548,548,0,494,493,1
"2021","Rother 003","E02004394",6749,1812,3682,3663,3636,27,19,2,17,135,132,3,650,649,1,470,469,1
"2021","Rother 004","E02004395",6554,2023,2965,2923,2889,34,42,8,34,149,148,1,818,814,4,599,597,2
"2021","Rother 005","E02004396",8053,2006,4509,4457,4433,24,52,2,50,128,128,0,722,720,2,688,687,1
"2021","Rother 006","E02004397",6659,1908,3341,3322,3303,19,19,10,9,137,137,0,734,727,7,539,539,0
"2021","Rother 007","E02004398",7339,2890,2793,2783,2750,33,10,6,4,201,200,1,896,888,8,559,558,1
"2021","Rother 008","E02004399",6926,1939,3262,3235,3219,16,27,4,23,158,157,1,796,796,0,771,768,3
"2021","Rother 009","E02004400",9471,1942,5509,5470,5450,20,39,15,24,142,139,3,828,826,2,1050,1047,3
"2021","Rother 010","E02004401",6880,1526,3642,3621,3582,39,21,3,18,126,126,0,736,735,1,850,848,2
"2021","Rother 011","E02004402",7771,2890,2488,2464,2425,39,24,2,22,244,241,3,1325,1321,4,824,823,1
"2021","Wealden 001","E02004403",5300,1535,2760,2741,2730,11,19,8,11,111,111,0,561,560,1,333,333,0
"2021","Wealden 002","E02004404",5305,1311,3101,3093,3078,15,8,4,4,77,77,0,496,495,1,320,317,3
"2021","Wealden 003","E02004405",4918,1315,2720,2713,2700,13,7,2,5,88,88,0,431,431,0,364,363,1
"2021","Wealden 004","E02004406",6278,1509,3586,3577,3560,17,9,4,5,86,86,0,526,524,2,571,571,0
"2021","Wealden 005","E02004407",6776,1679,3829,3820,3781,39,9,4,5,125,125,0,676,676,0,467,467,0
"2021","Wealden 006","E02004408",6819,2153,3361,3355,3337,18,6,0,6,149,149,0,779,779,0,377,377,0
"2021","Wealden 007","E02004409",4554,1141,2680,2671,2659,12,9,2,7,97,94,3,359,359,0,277,276,1
"2021","Wealden 008","E02004410",6747,1604,4022,3975,3951,24,47,18,29,106,105,1,564,564,0,451,449,2
"2021","Wealden 009","E02004411",6983,2100,3420,3414,3391,23,6,4,2,150,148,2,783,780,3,530,530,0
"2021","Wealden 010","E02004412",6743,1907,3485,3469,3452,17,16,2,14,137,137,0,737,736,1,477,477,0
"2021","Wealden 011","E02004413",6192,1653,3363,3352,3318,34,11,2,9,126,126,0,587,587,0,463,462,1
"2021","Wealden 012","E02004414",5349,1737,2588,2574,2559,15,14,0,14,134,133,1,578,578,0,312,311,1
"2021","Wealden 013","E02004415",5625,1503,3163,3153,3139,14,10,2,8,97,96,1,512,507,5,350,348,2
"2021","Wealden 014","E02004416",5520,1425,3051,3034,3017,17,17,4,13,114,114,0,550,549,1,380,379,1
"2021","Wealden 015","E02004417",5457,1576,2700,2692,2683,9,8,0,8,112,108,4,549,548,1,520,520,0
"2021","Wealden 016","E02004418",4778,1410,2326,2319,2308,11,7,4,3,92,91,1,543,542,1,407,407,0
"2021","Wealden 017","E02004419",5114,1778,2152,2148,2133,15,4,2,2,135,135,0,638,635,3,411,411,0
"2021","Wealden 018","E02004420",11526,3231,6080,6039,5996,43,41,4,37,240,239,1,1120,1116,4,855,852,3
"2021","Wealden 019","E02004421",7767,2300,3707,3677,3647,30,30,8,22,191,185,6,913,906,7,656,653,3
"2021","Wealden 020","E02004422",9295,2614,4822,4791,4760,31,31,6,25,192,192,0,978,976,2,689,689,0
"2021","Wealden 021","E02004423",6597,1556,3638,3620,3588,32,18,2,16,94,94,0,672,668,4,637,635,2
"2021","Basingstoke and Deane 001","E02004675",6230,1995,3100,3095,3086,9,5,0,5,106,105,1,616,613,3,413,413,0
"2021","Basingstoke and Deane 002","E02004676",6722,1842,3760,3748,3735,13,12,6,6,106,105,1,571,571,0,443,443,0
"2021","Basingstoke and Deane 003","E02004677",6113,1574,3652,3645,3631,14,7,0,7,88,87,1,461,461,0,338,337,1
"2021","Basingstoke and Deane 004","E02004678",6311,1684,3505,3491,3481,10,14,2,12,106,106,0,604,603,1,412,412,0
"2021","Basingstoke and Deane 005","E02004679",8823,2732,4749,4726,4693,33,23,2,21,154,153,1,739,735,4,449,449,0
"2021","Basingstoke and Deane 006","E02004680",6277,2071,3289,3280,3256,24,9,3,6,133,131,2,589,587,2,195,195,0
"2021","Basingstoke and Deane 007","E02004681",11368,4758,4726,4710,4676,34,16,4,12,306,298,8,1091,1088,3,487,484,3
"2021","Basingstoke and Deane 008","E02004682",6700,2347,3313,3297,3280,17,16,4,12,136,133,3,638,637,1,266,264,2
"2021","Basingstoke and Deane 009","E02004683",6665,2682,2780,2772,2755,17,8,2,6,160,159,1,651,646,5,392,392,0
"2021","Basingstoke and Deane 010","E02004684",9012,3527,4075,4059,4038,21,16,8,8,210,208,2,805,804,1,395,395,0
"2021","Basingstoke and Deane 011","E02004685",6733,2934,2690,2679,2651,28,11,4,7,160,160,0,641,640,1,308,308,0
"2021","Basingstoke and Deane 012","E02004686",7285,2967,3089,3077,3047,30,12,6,6,154,154,0,707,705,2,368,367,1
"2021","Basingstoke and Deane 013","E02004687",5856,2339,2460,2449,2430,19,11,6,5,147,145,2,631,629,2,279,279,0
"2021","Basingstoke and Deane 014","E02004688",6359,2397,2642,2632,2622,10,10,0,10,172,171,1,718,716,2,430,430,0
"2021","Basingstoke and Deane 015","E02004689",4788,1105,2911,2905,2897,8,6,2,4,62,62,0,322,321,1,388,388,0
"2021","Basingstoke and Deane 016","E02004690",6699,2316,3229,3225,3201,24,4,4,0,160,158,2,638,636,2,356,356,0
"2021","Basingstoke and Deane 017","E02004691",6687,1508,3969,3963,3956,7,6,2,4,109,109,0,547,546,1,554,554,0
"2021","Basingstoke and Deane 018","E02004692",6155,1269,3921,3911,3901,10,10,4,6,59,59,0,408,407,1,498,497,1
"2021","Basingstoke and Deane 019","E02004693",5952,2270,2513,2503,2492,11,10,2,8,154,151,3,713,712,1,302,301,1
"2021","Basingstoke and Deane 020","E02004694",6106,1740,3302,3289,3284,5,13,4,9,110,110,0,545,545,0,409,409,0
"2021","Basingstoke and Deane 021","E02004695",6859,2183,3823,3819,3795,24,4,2,2,117,117,0,559,557,2,177,177,0
"2021","Basingstoke and Deane 022","E02004696",6110,1728,3346,3338,3320,18,8,0,8,119,119,0,532,529,3,385,385,0
"2021","East Hampshire 001","E02004697",5575,1429,3162,3156,3136,20,6,2,4,95,94,1,488,487,1,401,398,3
"2021","East Hampshire 002","E02004698",5319,1995,2041,2032,2027,5,9,5,4,163,162,1,664,661,3,456,456,0
"2021","East Hampshire 003","E02004699",9040,2585,4772,4749,4724,25,23,10,13,192,191,1,861,859,2,630,630,0
"2021","East Hampshire 004","E02004700",5348,2039,2445,2443,2416,27,2,0,2,130,130,0,545,543,2,189,189,0
"2021","East Hampshire 006","E02004702",6561,2211,3090,3079,3061,18,11,2,9,157,156,1,751,748,3,352,351,1
"2021","East Hampshire 007","E02004703",10506,2479,6516,6489,6458,31,27,8,19,175,174,1,789,787,2,547,546,1
"2021","East Hampshire 008","E02004704",5182,1439,2827,2813,2806,7,14,6,8,125,125,0,503,502,1,288,287,1
"2021","East Hampshire 009","E02004705",7900,2178,4229,4214,4195,19,15,2,13,172,172,0,737,734,3,584,584,0
"2021","East Hampshire 010","E02004706",6374,1717,3449,3437,3433,4,12,8,4,113,113,0,589,588,1,506,506,0
"2021","East Hampshire 011","E02004707",9366,2419,5360,5334,5319,15,26,8,18,158,158,0,773,770,3,656,654,2
"2021","East Hampshire 012","E02004708",7846,2530,3587,3575,3556,19,12,0,12,215,214,1,917,916,1,597,597,0
"2021","East Hampshire 013","E02004709",7161,1869,4134,4122,4104,18,12,10,2,102,102,0,645,645,0,411,411,0
"2021","East Hampshire 014","E02004710",5467,1437,3135,3127,3111,16,8,4,4,93,91,2,498,498,0,304,303,1
"2021","East Hampshire 016","E02006829",6253,1536,3547,3538,3507,31,9,2,7,96,96,0,544,544,0,530,530,0
"2021","East Hampshire 017","E02006838",5932,1368,3498,3477,3458,19,21,5,16,106,105,1,471,471,0,489,487,2
"2021","Eastleigh 001","E02004712",6995,1484,4491,4481,4471,10,10,2,8,96,96,0,414,414,0,510,510,0
"2021","Eastleigh 002","E02004713",6490,1645,3698,3689,3675,14,9,8,1,117,116,1,577,577,0,453,453,0
"2021","Eastleigh 003","E02004714",6356,1666,3496,3474,3452,22,22,14,8,98,97,1,600,598,2,496,495,1
"2021","Eastleigh 004","E02004715",7292,2522,3361,3349,3331,18,12,0,12,185,185,0,782,780,2,442,442,0
"2021","Eastleigh 005","E02004716",7060,2212,3588,3577,3552,25,11,4,7,113,112,1,740,739,1,407,407,0
"2021","Eastleigh 006","E02004717",10045,4029,4084,4067,4034,33,17,6,11,291,291,0,1138,1138,0,503,502,1
"2021","Eastleigh 007","E02004718",7084,3082,2573,2556,2539,17,17,2,15,244,242,2,861,861,0,324,324,0
"2021","Eastleigh 008","E02004719",9402,2811,5046,5029,5003,26,17,2,15,165,164,1,812,810,2,568,567,1
"2021","Eastleigh 009","E02004720",9601,2914,4773,4759,4741,18,14,6,8,187,184,3,1014,1014,0,713,713,0
"2021","Eastleigh 010","E02004721",8824,3020,4552,4540,4512,28,12,4,8,196,195,1,792,791,1,264,263,1
"2021","Eastleigh 011","E02004722",5744,1728,2800,2794,2778,16,6,2,4,122,122,0,615,612,3,479,477,2
"2021","Eastleigh 012","E02004723",8117,2322,4424,4414,4389,25,10,4,6,136,135,1,657,656,1,578,578,0
"2021","Eastleigh 013","E02004724",7753,2743,3725,3704,3677,27,21,12,9,181,178,3,771,767,4,333,333,0
"2021","Eastleigh 014","E02004725",4546,1443,2061,2057,2047,10,4,0,4,107,107,0,541,541,0,394,394,0
"2021","Eastleigh 015","E02004726",5017,1474,2536,2514,2495,19,22,10,12,123,123,0,591,589,2,293,293,0
"2021","Fareham 001","E02004727",8012,2243,4613,4605,4586,19,8,0,8,160,160,0,683,683,0,313,312,1
"2021","Fareham 002","E02004728",7480,2205,3822,3816,3790,26,6,4,2,153,153,0,783,779,4,517,517,0
"2021","Fareham 003","E02004729",6025,1970,2841,2834,2817,17,7,1,6,135,135,0,683,680,3,396,396,0
"2021","Fareham 004","E02004730",7359,1827,4234,4220,4206,14,14,2,12,101,101,0,588,587,1,609,609,0
"2021","Fareham 005","E02004731",6391,1630,3578,3572,3555,17,6,4,2,102,102,0,596,591,5,485,484,1
"2021","Fareham 006","E02004732",7279,1898,4023,4013,4000,13,10,6,4,130,130,0,735,734,1,493,493,0
"2021","Fareham 007","E02004733",6657,1906,3556,3537,3518,19,19,6,13,129,128,1,663,661,2,403,403,0
"2021","Fareham 008","E02004734",8588,2648,4149,4119,4091,28,30,8,22,159,158,1,969,960,9,663,662,1
"2021","Fareham 009","E02004735",6394,1385,3869,3856,3837,19,13,4,9,84,82,2,531,528,3,525,525,0
"2021","Fareham 010","E02004736",6845,1698,3798,3781,3755,26,17,3,14,118,118,0,680,677,3,551,550,1
"2021","Fareham 011","E02004737",6124,2330,2408,2398,2365,33,10,2,8,157,157,0,808,805,3,421,421,0
"2021","Fareham 012","E02004738",6120,1712,3140,3124,3090,34,16,6,10,99,96,3,671,667,4,498,498,0
"2021","Fareham 013","E02004739",6314,1813,3248,3236,3227,9,12,4,8,90,90,0,571,571,0,592,592,0
"2021","Fareham 014","E02004740",6042,1219,3703,3685,3666,19,18,4,14,87,87,0,499,498,1,534,534,0
"2021","Gosport 001","E02004741",6199,1903,2952,2946,2927,19,6,2,4,137,136,1,690,688,2,517,516,1
"2021","Gosport 002","E02004742",5868,1795,2717,2705,2670,35,12,6,6,152,152,0,734,734,0,470,470,0
"2021","Gosport 003","E02004743",6026,1872,2960,2957,2940,17,3,0,3,131,131,0,659,657,2,404,403,1
"2021","Gosport 004","E02004744",7186,2952,2810,2795,2770,25,15,6,9,288,288,0,909,906,3,227,227,0
"2021","Gosport 005","E02004745",6954,2690,2706,2700,2674,26,6,4,2,201,198,3,975,973,2,382,382,0
"2021","Gosport 006","E02004746",9229,2236,5057,5041,5016,25,16,4,12,201,201,0,986,984,2,749,749,0
"2021","Gosport 007","E02004747",5237,1756,2190,2178,2164,14,12,6,6,177,174,3,722,717,5,392,391,1
"2021","Gosport 008","E02004748",7772,3326,2491,2475,2440,35,16,6,10,266,264,2,1192,1185,7,497,497,0
"2021","Gosport 009","E02004749",6040,1385,3457,3454,3439,15,3,0,3,98,98,0,531,531,0,569,569,0
"2021","Gosport 010","E02004750",6697,2133,3051,3038,3014,24,13,4,9,153,153,0,843,843,0,517,517,0
"2021","Hart 001","E02004751",7045,1966,3759,3751,3741,10,8,2,6,118,118,0,678,676,2,524,524,0
"2021","Hart 002","E02004752",6488,1726,3755,3743,3734,9,12,6,6,104,104,0,554,553,1,349,349,0
"2021","Hart 003","E02004753",9610,3580,4529,4515,4498,17,14,8,6,181,180,1,783,781,2,537,537,0
"2021","Hart 004","E02004754",5807,1435,3280,3266,3246,20,14,6,8,114,114,0,548,547,1,430,430,0
"2021","Hart 005","E02004755",9683,3187,4817,4799,4763,36,18,4,14,200,198,2,924,921,3,555,554,1
"2021","Hart 006","E02004756",7685,2324,4212,4196,4176,20,16,4,12,154,149,5,678,675,3,317,317,0
"2021","Hart 007","E02004757",6498,1361,4198,4190,4178,12,8,4,4,56,56,0,408,406,2,475,475,0
"2021","Hart 008","E02004758",7395,1978,4290,4278,4260,18,12,0,12,127,125,2,577,574,3,423,423,0
"2021","Hart 009","E02004759",6634,1711,3720,3702,3691,11,18,4,14,99,99,0,657,655,2,447,447,0
"2021","Hart 010","E02004760",8173,2341,4533,4519,4494,25,14,6,8,167,167,0,702,699,3,430,430,0
"2021","Hart 011","E02004761",5311,1624,2832,2819,2809,10,13,10,3,98,98,0,456,456,0,301,301,0
"2021","Havant 003","E02004764",7110,1947,3777,3769,3757,12,8,6,2,110,110,0,645,645,0,631,631,0
"2021","Havant 004","E02004765",5137,1559,2646,2640,2628,12,6,0,6,107,107,0,510,510,0,315,315,0
"2021","Havant 005","E02004766",5847,2099,2434,2428,2418,10,6,4,2,172,170,2,663,663,0,479,479,0
"2021","Havant 006","E02004767",4435,1828,1682,1672,1658,14,10,3,7,131,129,2,527,526,1,267,267,0
"2021","Havant 007","E02004768",4342,1505,1963,1963,1955,8,0,0,0,128,128,0,495,493,2,251,251,0
"2021","Havant 008","E02004769",4794,2130,1734,1728,1712,16,6,3,3,137,135,2,540,540,0,253,253,0
"2021","Havant 009","E02004770",5312,2231,1950,1944,1923,21,6,0,6,157,155,2,643,640,3,331,331,0
"2021","Havant 010","E02004771",6974,2907,2646,2632,2605,27,14,10,4,198,195,3,789,785,4,434,433,1
"2021","Havant 011","E02004772",7866,2268,4115,4103,4091,12,12,7,5,152,152,0,779,776,3,552,552,0
"2021","Havant 013","E02004774",8763,2270,4547,4520,4500,20,27,8,19,154,153,1,961,960,1,831,831,0
"2021","Havant 014","E02004775",8673,2804,4166,4148,4127,21,18,0,18,180,180,0,904,900,4,619,619,0
"2021","Havant 015","E02004776",5252,1184,2947,2935,2913,22,12,4,8,106,105,1,552,552,0,463,463,0
"2021","Havant 016","E02004777",4611,1189,2182,2172,2163,9,10,2,8,112,112,0,595,594,1,533,532,1
"2021","Havant 017","E02004778",5458,1362,2718,2711,2700,11,7,4,3,136,135,1,694,693,1,548,547,1
"2021","Havant 018","E02006822",7783,2402,3920,3913,3893,20,7,2,5,132,129,3,742,741,1,587,584,3
"2021","Havant 019","E02006830",5263,1967,2207,2203,2191,12,4,2,2,150,149,1,635,633,2,304,304,0
"2021","Havant 020","E02006831",5254,1306,2900,2886,2883,3,14,6,8,94,94,0,510,510,0,444,444,0
"2021","New Forest 001","E02004779",9381,2433,5078,5067,5046,21,11,2,9,161,159,2,958,958,0,751,749,2
"2021","New Forest 002","E02004780",4828,1598,2220,2216,2209,7,4,0,4,122,122,0,516,516,0,372,372,0
"2021","New Forest 003","E02004781",6529,2124,3212,3210,3196,14,2,2,0,153,152,1,683,680,3,357,357,0
"2021","New Forest 004","E02004782",6390,2206,2877,2869,2855,14,8,4,4,132,132,0,706,706,0,469,468,1
"2021","New Forest 005","E02004783",5734,1756,2897,2889,2878,11,8,4,4,134,133,1,587,587,0,360,359,1
"2021","New Forest 006","E02004784",4900,1133,2914,2898,2886,12,16,6,10,58,58,0,349,348,1,446,446,0
"2021","New Forest 007","E02004785",4844,1152,2696,2685,2678,7,11,6,5,97,97,0,506,504,2,393,393,0
"2021","New Forest 008","E02004786",6711,2065,3406,3394,3372,22,12,4,8,183,181,2,727,727,0,330,330,0
"2021","New Forest 009","E02004787",6276,1466,3443,3429,3418,11,14,4,10,125,125,0,626,626,0,616,616,0
"2021","New Forest 010","E02004788",6045,1505,3482,3470,3458,12,12,6,6,111,110,1,597,597,0,350,350,0
"2021","New Forest 011","E02004789",8550,2377,4402,4386,4367,19,16,2,14,191,191,0,889,888,1,691,691,0
"2021","New Forest 012","E02004790",6718,2244,2871,2855,2837,18,16,10,6,151,149,2,876,874,2,576,576,0
"2021","New Forest 013","E02004791",4330,1469,2024,2022,2000,22,2,2,0,104,103,1,425,424,1,308,308,0
"2021","New Forest 014","E02004792",7171,1765,3940,3931,3920,11,9,4,5,149,149,0,737,737,0,580,580,0
"2021","New Forest 015","E02004793",6332,1396,3715,3690,3681,9,25,6,19,95,95,0,523,519,4,603,603,0
"2021","New Forest 016","E02004794",5785,1356,3417,3400,3386,14,17,8,9,95,94,1,466,465,1,451,449,2
"2021","New Forest 017","E02004795",7367,1866,3776,3765,3743,22,11,6,5,156,155,1,871,868,3,698,695,3
"2021","New Forest 018","E02004796",8431,1921,4836,4805,4784,21,31,8,23,122,122,0,796,796,0,756,752,4
"2021","New Forest 019","E02004797",6733,2067,3162,3147,3133,14,15,8,7,169,167,2,839,838,1,496,495,1
"2021","New Forest 020","E02004798",5051,1720,2242,2240,2226,14,2,0,2,115,112,3,646,646,0,328,328,0
"2021","New Forest 021","E02004799",6889,1998,3180,3174,3157,17,6,0,6,133,133,0,806,805,1,772,772,0
"2021","New Forest 022","E02004800",6847,1196,4089,4068,4055,13,21,6,15,79,79,0,617,617,0,866,863,3
"2021","New Forest 023","E02004801",6899,1231,4067,4051,4038,13,16,2,14,101,101,0,671,670,1,829,828,1
"2021","Rushmoor 001","E02004802",5502,1897,2568,2561,2548,13,7,4,3,136,136,0,543,541,2,358,357,1
"2021","Rushmoor 002","E02004803",5957,2192,2707,2701,2687,14,6,2,4,164,164,0,589,589,0,305,305,0
"2021","Rushmoor 003","E02004804",5922,1912,3034,3024,3012,12,10,3,7,124,124,0,547,546,1,305,305,0
"2021","Rushmoor 004","E02004805",7133,2225,3844,3830,3817,13,14,4,10,135,134,1,537,534,3,392,392,0
"2021","Rushmoor 005","E02004806",6463,2058,3458,3450,3433,17,8,0,8,105,104,1,570,570,0,272,272,0
"2021","Rushmoor 006","E02004807",7657,2623,3671,3661,3633,28,10,4,6,177,177,0,707,707,0,479,479,0
"2021","Rushmoor 007","E02004808",9828,4057,4204,4183,4151,32,21,6,15,273,272,1,924,923,1,370,370,0
"2021","Rushmoor 008","E02004809",8333,3144,4206,4191,4158,33,15,9,6,222,222,0,517,514,3,244,244,0
"2021","Rushmoor 009","E02004810",6501,2557,2826,2818,2791,27,8,2,6,163,160,3,674,672,2,281,281,0
"2021","Rushmoor 010","E02004811",6744,2334,3129,3121,3110,11,8,2,6,154,153,1,688,685,3,439,439,0
"2021","Rushmoor 011","E02004812",5581,1800,2966,2956,2948,8,10,6,4,122,122,0,438,435,3,255,255,0
"2021","Rushmoor 012","E02004813",5246,1888,2283,2277,2264,13,6,2,4,167,167,0,587,585,2,321,321,0
"2021","Test Valley 001","E02004814",5911,1612,3334,3323,3307,16,11,2,9,103,103,0,519,519,0,343,343,0
"2021","Test Valley 002","E02004815",5606,2404,2047,2037,2023,14,10,2,8,195,193,2,712,710,2,248,248,0
"2021","Test Valley 004","E02004817",6236,2101,2746,2740,2728,12,6,4,2,162,160,2,777,774,3,450,450,0
"2021","Test Valley 005","E02004818",8603,2435,4520,4511,4475,36,9,4,5,240,238,2,812,811,1,596,596,0
"2021","Test Valley 006","E02004819",6572,1947,3374,3363,3354,9,11,7,4,129,128,1,653,650,3,469,469,0
"2021","Test Valley 007","E02004820",5999,1449,3529,3508,3486,22,21,5,16,161,160,1,523,523,0,337,337,0
"2021","Test Valley 008","E02004821",4280,871,2691,2674,2668,6,17,4,13,71,71,0,352,352,0,295,295,0
"2021","Test Valley 009","E02004822",6755,1602,4052,4039,4019,20,13,6,7,117,117,0,563,562,1,421,418,3
"2021","Test Valley 010","E02004823",7237,1870,3979,3966,3960,6,13,5,8,121,119,2,747,746,1,520,518,2
"2021","Test Valley 011","E02004824",5165,1531,2196,2172,2164,8,24,14,10,122,120,2,654,654,0,662,660,2
"2021","Test Valley 012","E02004825",9028,2217,5224,5197,5182,15,27,4,23,133,132,1,764,763,1,690,690,0
"2021","Test Valley 013","E02004826",7934,2106,4532,4521,4509,12,11,2,9,167,166,1,660,659,1,469,469,0
"2021","Test Valley 014","E02004827",5850,1474,3542,3532,3526,6,10,4,6,103,99,4,515,515,0,216,215,1
"2021","Test Valley 015","E02004828",6050,1615,3480,3470,3461,9,10,4,6,84,84,0,497,495,2,374,373,1
"2021","Test Valley 016","E02007076",5738,2171,2775,2760,2746,14,15,6,9,129,129,0,522,522,0,141,141,0
"2021","Test Valley 017","E02007077",5471,2161,2471,2467,2441,26,4,0,4,148,147,1,537,536,1,154,154,0
"2021","Test Valley 018","E02007078",4324,1489,1814,1805,1796,9,9,4,5,134,129,5,541,541,0,346,346,0
"2021","Winchester 001","E02004829",4740,1107,2948,2934,2916,18,14,4,10,72,72,0,332,331,1,281,281,0
"2021","Winchester 002","E02004830",5664,1644,3180,3164,3148,16,16,6,10,90,89,1,450,449,1,300,298,2
"2021","Winchester 003","E02004831",8457,2549,4616,4593,4578,15,23,10,13,113,113,0,562,559,3,617,615,2
"2021","Winchester 004","E02004832",7208,1774,4005,3996,3986,10,9,4,5,135,134,1,663,660,3,631,630,1
"2021","Winchester 005","E02004833",8272,3267,3854,3842,3819,23,12,4,8,139,137,2,530,530,0,482,481,1
"2021","Winchester 006","E02004834",6366,2936,2229,2209,2192,17,20,4,16,148,145,3,666,665,1,387,386,1
"2021","Winchester 007","E02004835",9010,4151,3358,3341,3314,27,17,6,11,168,168,0,828,828,0,505,503,2
"2021","Winchester 008","E02004836",5771,3561,1520,1516,1514,2,4,0,4,110,109,1,382,382,0,198,198,0
"2021","Winchester 009","E02004837",6696,2091,3682,3672,3668,4,10,6,4,93,93,0,454,454,0,376,376,0
"2021","Winchester 010","E02004838",7794,1952,4603,4599,4583,16,4,0,4,116,116,0,641,640,1,482,482,0
"2021","Winchester 011","E02004839",7378,1706,4551,4533,4520,13,18,4,14,113,111,2,575,572,3,433,433,0
"2021","Winchester 012","E02004840",8467,2211,4583,4567,4554,13,16,8,8,166,164,2,883,883,0,624,624,0
"2021","Winchester 013","E02004841",9590,3036,4900,4887,4855,32,13,2,11,230,229,1,903,901,2,521,520,1
"2021","Winchester 014","E02004842",9342,2828,4941,4928,4895,33,13,8,5,200,194,6,770,769,1,603,603,0
"2021","Ashford 001","E02004996",6738,1982,3488,3478,3451,27,10,0,10,143,140,3,640,639,1,485,485,0
"2021","Ashford 002","E02004997",6879,1788,3774,3764,3730,34,10,0,10,139,139,0,685,682,3,493,492,1
"2021","Ashford 003","E02004998",5566,1594,2995,2980,2973,7,15,6,9,103,103,0,477,475,2,397,397,0
"2021","Ashford 005","E02005000",9638,4289,3762,3742,3712,30,20,6,14,253,253,0,921,918,3,413,412,1
"2021","Ashford 006","E02005001",7726,2387,4056,4045,4028,17,11,4,7,135,135,0,662,660,2,486,486,0
"2021","Ashford 007","E02005002",7798,3056,3242,3230,3207,23,12,4,8,201,200,1,853,851,2,446,446,0
"2021","Ashford 008","E02005003",7007,2923,2924,2913,2892,21,11,6,5,175,174,1,658,657,1,327,327,0
"2021","Ashford 009","E02005004",9277,3414,4397,4388,4364,24,9,0,9,205,205,0,864,861,3,397,396,1
"2021","Ashford 010","E02005005",8264,2261,4694,4670,4634,36,24,1,23,145,145,0,707,704,3,457,455,2
"2021","Ashford 011","E02005006",5154,1364,2905,2899,2897,2,6,2,4,98,98,0,459,458,1,328,327,1
"2021","Ashford 012","E02005007",7697,2315,4058,4046,4020,26,12,8,4,152,152,0,680,679,1,492,492,0
"2021","Ashford 013","E02005008",7561,2007,3903,3882,3866,16,21,7,14,162,161,1,758,756,2,731,731,0
"2021","Ashford 014","E02005009",4994,1351,2730,2719,2708,11,11,2,9,94,93,1,465,464,1,354,353,1
"2021","Ashford 015","E02007046",5638,1968,2517,2513,2499,14,4,2,2,127,127,0,606,606,0,420,420,0
"2021","Ashford 016","E02007047",6835,2594,3242,3223,3210,13,19,6,13,160,159,1,600,598,2,239,239,0
"2021","Canterbury 001","E02005010",6345,2479,2181,2160,2136,24,21,2,19,225,218,7,900,895,5,560,559,1
"2021","Canterbury 002","E02005011",6531,1540,3588,3567,3550,17,21,6,15,114,114,0,631,631,0,658,658,0
"2021","Canterbury 003","E02005012",7442,2455,3434,3423,3410,13,11,2,9,150,149,1,811,810,1,592,592,0
"2021","Canterbury 004","E02005013",6963,2145,3262,3252,3235,17,10,2,8,146,142,4,768,767,1,642,641,1
"2021","Canterbury 005","E02005014",7289,1636,4286,4263,4238,25,23,6,17,95,95,0,624,618,6,648,648,0
"2021","Canterbury 006","E02005015",7693,2397,3945,3932,3908,24,13,4,9,151,151,0,708,708,0,492,492,0
"2021","Canterbury 007","E02005016",6494,2044,3099,3075,3046,29,24,6,18,135,132,3,716,715,1,500,500,0
"2021","Canterbury 008","E02005017",5635,1970,2350,2309,2267,42,41,10,31,149,146,3,725,721,4,441,441,0
"2021","Canterbury 009","E02005018",7275,2035,3833,3800,3784,16,33,8,25,151,150,1,701,700,1,555,552,3
"2021","Canterbury 010","E02005019",5395,1760,2647,2635,2616,19,12,2,10,101,101,0,528,528,0,359,359,0
"2021","Canterbury 011","E02005020",6115,2110,2864,2848,2836,12,16,8,8,118,118,0,573,573,0,450,447,3
"2021","Canterbury 012","E02005021",9895,6089,2917,2911,2892,19,6,2,4,95,95,0,408,407,1,386,386,0
"2021","Canterbury 013","E02005022",6963,4300,1919,1906,1900,6,13,0,13,111,110,1,421,421,0,212,212,0
"2021","Canterbury 014","E02005023",7985,5014,1895,1886,1860,26,9,5,4,172,169,3,623,623,0,281,280,1
"2021","Canterbury 016","E02005025",8658,4718,2855,2832,2800,32,23,10,13,129,125,4,545,543,2,411,411,0
"2021","Canterbury 017","E02005026",6492,2033,3402,3377,3356,21,25,11,14,129,129,0,585,584,1,343,343,0
"2021","Canterbury 018","E02005027",4662,1298,2496,2482,2464,18,14,6,8,72,72,0,391,391,0,405,404,1
"2021","Canterbury 019","E02006855",5261,2948,1557,1550,1538,12,7,6,1,126,125,1,440,438,2,190,190,0
"2021","Canterbury 020","E02006856",9688,5670,2563,2541,2506,35,22,8,14,197,196,1,776,771,5,482,478,4
"2021","Dartford 001","E02005028",10172,4082,4694,4683,4663,20,11,6,5,292,291,1,733,730,3,371,371,0
"2021","Dartford 002","E02005029",11215,4774,4931,4923,4890,33,8,4,4,291,291,0,909,908,1,310,310,0
"2021","Dartford 003","E02005030",9477,3849,4237,4221,4207,14,16,8,8,235,235,0,771,771,0,385,383,2
"2021","Dartford 004","E02005031",6296,2817,2395,2385,2356,29,10,2,8,165,165,0,644,644,0,275,275,0
"2021","Dartford 005","E02005032",7615,3202,3131,3117,3095,22,14,6,8,235,234,1,773,771,2,274,274,0
"2021","Dartford 006","E02005033",5911,2481,2331,2317,2309,8,14,4,10,150,150,0,662,662,0,287,287,0
"2021","Dartford 007","E02005034",6245,1954,3412,3406,3398,8,6,0,6,104,103,1,421,421,0,354,354,0
"2021","Dartford 008","E02005035",6674,2070,3551,3548,3535,13,3,2,1,121,121,0,505,504,1,427,427,0
"2021","Dartford 009","E02005036",5142,2116,2052,2041,2029,12,11,7,4,155,151,4,545,544,1,274,274,0
"2021","Dartford 010","E02005037",5825,1751,3127,3114,3108,6,13,5,8,96,96,0,446,446,0,405,405,0
"2021","Dartford 011","E02005038",4935,1539,2460,2454,2443,11,6,2,4,116,116,0,402,402,0,418,418,0
"2021","Dartford 012","E02005039",5459,1836,2635,2630,2627,3,5,4,1,133,133,0,497,496,1,358,358,0
"2021","Dartford 013","E02005040",5725,1446,3299,3287,3276,11,12,4,8,77,75,2,431,430,1,472,471,1
"2021","Dover 001","E02005041",6098,1698,3338,3322,3303,19,16,8,8,116,113,3,556,556,0,390,390,0
"2021","Dover 002","E02005042",7683,2146,3896,3871,3852,19,25,10,15,192,190,2,846,844,2,603,603,0
"2021","Dover 003","E02005043",6136,1851,2777,2752,2727,25,25,6,19,170,169,1,765,763,2,573,573,0
"2021","Dover 004","E02005044",5401,1688,2314,2260,2200,60,54,15,39,136,134,2,781,779,2,482,475,7
"2021","Dover 005","E02005045",7450,2474,3435,3427,3402,25,8,0,8,189,189,0,840,840,0,512,511,1
"2021","Dover 006","E02005046",6942,2637,3102,3086,3069,17,16,10,6,155,155,0,654,654,0,394,394,0
"2021","Dover 007","E02005047",6388,1994,2854,2837,2820,17,17,4,13,152,151,1,770,769,1,618,611,7
"2021","Dover 008","E02005048",5671,1438,3142,3131,3110,21,11,4,7,87,87,0,534,534,0,470,470,0
"2021","Dover 009","E02005049",6094,1324,3520,3482,3451,31,38,4,34,100,99,1,554,553,1,596,594,2
"2021","Dover 010","E02005050",8100,2316,4190,4178,4156,22,12,0,12,142,141,1,799,798,1,653,653,0
"2021","Dover 011","E02005051",10481,4648,3706,3680,3634,46,26,12,14,351,348,3,1232,1228,4,544,544,0
"2021","Dover 012","E02005052",6737,2760,2399,2372,2344,28,27,10,17,226,225,1,870,869,1,482,482,0
"2021","Dover 013","E02005053",7227,3317,2409,2389,2374,15,20,5,15,262,261,1,859,859,0,380,379,1
"2021","Dover 014","E02005054",5719,1524,3120,3112,3089,23,8,2,6,104,104,0,553,553,0,418,418,0
"2021","Gravesham 001","E02005055",6172,2715,2400,2393,2384,9,7,4,3,199,198,1,593,593,0,265,263,2
"2021","Gravesham 002","E02005056",8257,3715,2809,2785,2763,22,24,16,8,313,306,7,921,918,3,499,497,2
"2021","Gravesham 003","E02005057",8930,3406,4105,4089,4075,14,16,2,14,239,238,1,734,734,0,446,446,0
"2021","Gravesham 004","E02005058",6109,2415,2594,2586,2565,21,8,4,4,149,148,1,588,585,3,363,363,0
"2021","Gravesham 005","E02005059",7897,2640,3987,3979,3956,23,8,2,6,160,160,0,629,626,3,481,481,0
"2021","Gravesham 006","E02005060",6819,2538,3072,3056,3032,24,16,6,10,183,181,2,540,539,1,486,486,0
"2021","Gravesham 007","E02005061",5774,2219,2467,2461,2457,4,6,6,0,181,181,0,525,523,2,382,382,0
"2021","Gravesham 008","E02005062",5583,1744,2922,2914,2903,11,8,2,6,116,116,0,413,413,0,388,388,0
"2021","Gravesham 009","E02005063",5751,1878,2970,2966,2959,7,4,4,0,121,121,0,415,414,1,367,367,0
"2021","Gravesham 010","E02005064",5490,1460,3093,3081,3073,8,12,2,10,86,86,0,413,413,0,438,438,0
"2021","Gravesham 011","E02005065",6325,2610,2580,2568,2550,18,12,4,8,182,181,1,582,581,1,371,371,0
"2021","Gravesham 012","E02005066",6535,1588,3794,3782,3774,8,12,6,6,111,111,0,493,493,0,549,549,0
"2021","Gravesham 013","E02005067",4911,1371,2765,2753,2744,9,12,6,6,91,91,0,389,389,0,295,295,0
"2021","Maidstone 001","E02005068",5847,1799,3171,3159,3151,8,12,0,12,109,106,3,507,505,2,261,261,0
"2021","Maidstone 002","E02005069",7373,2311,3829,3821,3796,25,8,0,8,142,140,2,659,656,3,432,432,0
"2021","Maidstone 003","E02005070",8069,2086,4547,4534,4516,18,13,6,7,146,146,0,614,610,4,676,675,1
"2021","Maidstone 004","E02005071",10341,5118,3327,3291,3258,33,36,14,22,340,336,4,1115,1103,12,441,441,0
"2021","Maidstone 005","E02005072",6474,1590,3898,3885,3872,13,13,3,10,117,117,0,523,523,0,346,346,0
"2021","Maidstone 006","E02005073",10108,4596,3669,3653,3620,33,16,10,6,305,304,1,1092,1088,4,446,445,1
"2021","Maidstone 007","E02005074",6642,1755,3627,3625,3616,9,2,2,0,129,128,1,610,609,1,521,521,0
"2021","Maidstone 008","E02005075",8673,3309,3897,3877,3854,23,20,9,11,215,215,0,864,861,3,388,387,1
"2021","Maidstone 009","E02005076",7865,3310,3235,3218,3199,19,17,8,9,210,209,1,748,745,3,362,360,2
"2021","Maidstone 010","E02005077",6493,2264,3081,3074,3060,14,7,1,6,131,131,0,575,573,2,442,441,1
"2021","Maidstone 011","E02005078",8123,2295,4324,4295,4267,28,29,8,21,154,154,0,788,787,1,562,562,0
"2021","Maidstone 012","E02005079",7268,1968,4052,4043,4032,11,9,2,7,117,115,2,603,603,0,528,528,0
"2021","Maidstone 013","E02005080",9123,3674,3594,3584,3562,22,10,6,4,257,256,1,997,995,2,601,601,0
"2021","Maidstone 014","E02005081",5899,1553,3265,3245,3231,14,20,12,8,89,88,1,570,570,0,422,420,2
"2021","Maidstone 015","E02005082",9467,2944,4969,4953,4928,25,16,6,10,213,212,1,805,805,0,536,534,2
"2021","Maidstone 016","E02005083",6392,1831,3373,3363,3352,11,10,4,6,126,125,1,587,587,0,475,475,0
"2021","Maidstone 017","E02005084",6138,1805,3188,3178,3167,11,10,2,8,150,150,0,573,573,0,422,422,0
"2021","Maidstone 018","E02005085",6331,1971,3321,3308,3293,15,13,3,10,125,123,2,552,548,4,362,361,1
"2021","Maidstone 019","E02005086",5518,1650,2883,2869,2850,19,14,6,8,115,113,2,505,504,1,365,365,0
"2021","Sevenoaks 001","E02005087",5874,1769,3071,3061,3049,12,10,2,8,122,119,3,482,482,0,430,430,0
"2021","Sevenoaks 002","E02005088",7741,2997,3199,3182,3163,19,17,4,13,232,231,1,780,779,1,533,533,0
"2021","Sevenoaks 003","E02005089",5585,1868,2792,2786,2764,22,6,2,4,111,109,2,441,441,0,373,373,0
"2021","Sevenoaks 004","E02005090",5045,1234,2854,2850,2841,9,4,2,2,49,49,0,410,409,1,498,498,0
"2021","Sevenoaks 005","E02005091",5594,1749,2699,2681,2675,6,18,2,16,121,121,0,559,558,1,466,466,0
"2021","Sevenoaks 007","E02005093",5118,1365,2699,2693,2686,7,6,3,3,112,112,0,518,518,0,424,424,0
"2021","Sevenoaks 008","E02005094",7799,2474,3963,3943,3914,29,20,6,14,165,165,0,756,754,2,441,441,0
"2021","Sevenoaks 009","E02005095",6004,1533,3506,3500,3484,16,6,6,0,85,83,2,442,441,1,438,437,1
"2021","Sevenoaks 010","E02005096",7633,2568,3716,3696,3680,16,20,6,14,180,179,1,731,731,0,438,438,0
"2021","Sevenoaks 011","E02005097",7262,1661,4698,4683,4677,6,15,7,8,113,113,0,395,395,0,395,395,0
"2021","Sevenoaks 012","E02005098",8054,2326,4388,4373,4364,9,15,6,9,137,137,0,585,584,1,618,618,0
"2021","Sevenoaks 013","E02005099",6477,1909,3428,3401,3392,9,27,8,19,137,137,0,629,628,1,374,374,0
"2021","Sevenoaks 014","E02005100",7854,2745,3703,3685,3657,28,18,4,14,181,181,0,706,705,1,519,518,1
"2021","Sevenoaks 015","E02005101",5717,1487,3335,3327,3318,9,8,3,5,122,122,0,463,463,0,310,310,0
"2021","Sevenoaks 016","E02006832",4844,1509,2423,2416,2402,14,7,4,3,114,112,2,530,530,0,268,268,0
"2021","Folkestone and Hythe 001","E02005102",5319,1282,2994,2981,2962,19,13,2,11,83,83,0,503,502,1,457,456,1
"2021","Folkestone and Hythe 002","E02005103",8027,2578,4032,4023,4000,23,9,1,8,178,178,0,797,797,0,442,442,0
"2021","Folkestone and Hythe 003","E02005104",6414,2336,2727,2724,2709,15,3,2,1,161,161,0,753,751,2,437,432,5
"2021","Folkestone and Hythe 004","E02005105",5827,2624,1986,1967,1949,18,19,10,9,192,192,0,739,738,1,286,286,0
"2021","Folkestone and Hythe 005","E02005106",8026,2835,3690,3681,3658,23,9,4,5,167,167,0,845,845,0,489,487,2
"2021","Folkestone and Hythe 006","E02005107",10846,3693,5086,5050,5018,32,36,6,30,240,237,3,1096,1095,1,731,727,4
"2021","Folkestone and Hythe 008","E02005109",5868,1261,3345,3322,3305,17,23,8,15,107,107,0,511,511,0,644,643,1
"2021","Folkestone and Hythe 009","E02005110",6010,1547,3341,3331,3313,18,10,0,10,108,108,0,564,563,1,450,450,0
"2021","Folkestone and Hythe 010","E02005111",6279,1810,2744,2722,2702,20,22,4,18,171,169,2,901,900,1,653,650,3
"2021","Folkestone and Hythe 011","E02005112",6154,1657,3133,3127,3121,6,6,1,5,117,114,3,637,636,1,610,610,0
"2021","Folkestone and Hythe 012","E02005113",6244,1698,3178,3168,3151,17,10,4,6,103,101,2,630,630,0,635,632,3
"2021","Folkestone and Hythe 013","E02005114",5290,1688,2487,2473,2467,6,14,5,9,147,146,1,600,598,2,368,367,1
"2021","Folkestone and Hythe 014","E02006879",5415,2742,1269,1254,1233,21,15,6,9,213,212,1,896,893,3,295,292,3
"2021","Folkestone and Hythe 015","E02006880",5832,2546,1712,1685,1651,34,27,6,21,192,191,1,874,871,3,508,506,2
"2021","Swale 001","E02005115",4893,2354,1511,1500,1485,15,11,6,5,197,194,3,615,611,4,216,214,2
"2021","Swale 002","E02005116",4976,2226,1615,1601,1592,9,14,4,10,163,162,1,612,610,2,360,360,0
"2021","Swale 003","E02005117",5607,1561,2941,2932,2911,21,9,2,7,114,114,0,549,549,0,442,442,0
"2021","Swale 004","E02005118",8594,3111,3818,3799,3783,16,19,8,11,234,231,3,888,885,3,543,542,1
"2021","Swale 005","E02005119",5292,1920,2301,2288,2272,16,13,2,11,150,148,2,523,520,3,398,397,1
"2021","Swale 006","E02005120",8416,3594,3202,3185,3166,19,17,2,15,266,265,1,849,846,3,505,504,1
"2021","Swale 007","E02005121",10873,4068,5076,5060,5020,40,16,12,4,267,265,2,1065,1061,4,397,397,0
"2021","Swale 008","E02005122",6420,1962,3331,3315,3307,8,16,6,10,129,128,1,572,571,1,426,426,0
"2021","Swale 009","E02005123",10058,3637,4738,4728,4700,28,10,2,8,261,258,3,879,878,1,543,542,1
"2021","Swale 010","E02005124",6997,3122,2343,2327,2316,11,16,6,10,239,235,4,802,800,2,491,491,0
"2021","Swale 011","E02005125",6633,2468,2887,2871,2855,16,16,2,14,156,154,2,707,706,1,415,415,0
"2021","Swale 012","E02005126",6635,2124,3271,3259,3240,19,12,2,10,136,136,0,565,564,1,539,539,0
"2021","Swale 013","E02005127",7284,2011,4115,4111,4100,11,4,0,4,131,129,2,535,532,3,492,492,0
"2021","Swale 014","E02005128",7244,2374,3484,3465,3440,25,19,2,17,169,167,2,725,725,0,492,492,0
"2021","Swale 015","E02005129",9443,3574,3876,3862,3814,48,14,10,4,243,243,0,1063,1062,1,687,686,1
"2021","Swale 016","E02005130",7785,2655,3693,3680,3649,31,13,6,7,186,186,0,766,763,3,485,484,1
"2021","Swale 017","E02005131",4842,1405,2512,2494,2482,12,18,4,14,112,112,0,489,487,2,324,324,0
"2021","Thanet 001","E02005132",8348,4197,2149,2093,2060,33,56,21,35,322,320,2,1151,1143,8,529,529,0
"2021","Thanet 002","E02005133",7443,1932,3961,3952,3921,31,9,0,9,145,145,0,723,722,1,682,682,0
"2021","Thanet 003","E02005134",6344,3080,1942,1920,1879,41,22,6,16,251,249,2,809,807,2,262,261,1
"2021","Thanet 004","E02005135",6232,2527,2442,2430,2415,15,12,6,6,182,182,0,701,700,1,380,379,1
"2021","Thanet 005","E02005136",6611,2210,3085,3061,3040,21,24,1,23,170,169,1,652,650,2,494,491,3
"2021","Thanet 006","E02005137",5918,2344,2281,2269,2240,29,12,8,4,166,165,1,723,721,2,404,404,0
"2021","Thanet 007","E02005138",7593,2693,2999,2978,2956,22,21,7,14,213,211,2,1061,1061,0,627,623,4
"2021","Thanet 008","E02005139",7806,1821,4066,4041,4025,16,25,7,18,138,137,1,869,868,1,912,912,0
"2021","Thanet 009","E02005140",6430,1715,3271,3241,3227,14,30,6,24,147,147,0,697,694,3,600,599,1
"2021","Thanet 010","E02005141",5975,1798,2898,2871,2852,19,27,4,23,157,156,1,659,659,0,463,462,1
"2021","Thanet 011","E02005142",6136,1833,2947,2935,2923,12,12,6,6,150,150,0,644,643,1,562,561,1
"2021","Thanet 012","E02005143",6610,2386,2757,2747,2729,18,10,4,6,195,193,2,848,845,3,424,424,0
"2021","Thanet 013","E02005144",6895,2990,2470,2461,2428,33,9,2,7,209,209,0,826,823,3,400,397,3
"2021","Thanet 014","E02005145",6697,1942,3399,3380,3368,12,19,8,11,178,176,2,732,731,1,446,446,0
"2021","Thanet 015","E02005146",6387,2702,2431,2406,2388,18,25,11,14,201,201,0,750,739,11,303,302,1
"2021","Thanet 016","E02005147",7277,3258,1973,1950,1930,20,23,2,21,328,321,7,1228,1227,1,490,488,2
"2021","Thanet 017","E02005148",6713,1758,3510,3500,3481,19,10,6,4,129,128,1,681,681,0,635,634,1
"2021","Tonbridge and Malling 001","E02005149",9813,3391,4734,4721,4696,25,13,5,8,209,209,0,958,956,2,521,519,2
"2021","Tonbridge and Malling 002","E02005150",9343,3470,4059,4040,4008,32,19,0,19,259,256,3,1006,1006,0,549,549,0
"2021","Tonbridge and Malling 003","E02005151",10187,3164,5146,5133,5106,27,13,2,11,222,222,0,1009,1008,1,646,646,0
"2021","Tonbridge and Malling 005","E02005153",7465,2363,3727,3719,3707,12,8,4,4,161,159,2,712,709,3,502,502,0
"2021","Tonbridge and Malling 006","E02005154",9372,2528,5231,5218,5188,30,13,8,5,179,178,1,800,798,2,634,632,2
"2021","Tonbridge and Malling 007","E02005155",9548,2616,5440,5431,5412,19,9,7,2,208,207,1,902,902,0,382,382,0
"2021","Tonbridge and Malling 008","E02005156",6005,1804,3096,3084,3078,6,12,4,8,118,118,0,544,541,3,443,442,1
"2021","Tonbridge and Malling 009","E02005157",5368,1680,2593,2585,2570,15,8,0,8,113,113,0,551,551,0,431,431,0
"2021","Tonbridge and Malling 010","E02005158",5374,1364,3130,3126,3120,6,4,0,4,94,94,0,400,400,0,386,386,0
"2021","Tonbridge and Malling 011","E02005159",6231,1679,3422,3414,3407,7,8,6,2,102,99,3,514,514,0,514,514,0
"2021","Tonbridge and Malling 012","E02005160",9945,3860,4199,4185,4161,24,14,4,10,228,228,0,1056,1056,0,602,601,1
"2021","Tonbridge and Malling 013","E02005161",6848,2392,3344,3335,3317,18,9,4,5,134,132,2,641,640,1,337,337,0
"2021","Tonbridge and Malling 014","E02006833",10032,3046,5163,5154,5140,14,9,3,6,247,245,2,954,950,4,622,621,1
"2021","Tunbridge Wells 001","E02005162",8613,2677,4415,4409,4392,17,6,0,6,170,170,0,768,767,1,583,583,0
"2021","Tunbridge Wells 002","E02005163",6328,1979,3301,3290,3275,15,11,4,7,118,115,3,598,595,3,332,332,0
"2021","Tunbridge Wells 003","E02005164",7016,2474,3319,3311,3294,17,8,2,6,148,147,1,718,717,1,357,357,0
"2021","Tunbridge Wells 004","E02005165",6211,1781,3307,3298,3289,9,9,4,5,117,117,0,534,533,1,472,471,1
"2021","Tunbridge Wells 005","E02005166",5357,2125,2276,2269,2255,14,7,1,6,129,129,0,549,548,1,278,276,2
"2021","Tunbridge Wells 006","E02005167",6026,1408,3694,3675,3665,10,19,6,13,63,63,0,461,461,0,400,400,0
"2021","Tunbridge Wells 007","E02005168",6001,1869,3086,3074,3057,17,12,4,8,120,120,0,517,516,1,409,409,0
"2021","Tunbridge Wells 008","E02005169",7621,3560,2702,2683,2662,21,19,6,13,243,243,0,822,818,4,294,294,0
"2021","Tunbridge Wells 009","E02005170",7810,2541,3871,3852,3833,19,19,12,7,166,166,0,688,687,1,544,544,0
"2021","Tunbridge Wells 010","E02005171",4920,1828,2035,2025,2019,6,10,2,8,141,141,0,590,590,0,326,326,0
"2021","Tunbridge Wells 011","E02005172",6623,1746,3804,3796,3786,10,8,0,8,133,133,0,578,576,2,362,362,0
"2021","Tunbridge Wells 012","E02005173",6864,1980,3754,3729,3706,23,25,12,13,125,125,0,591,591,0,414,413,1
"2021","Tunbridge Wells 013","E02005174",6062,1683,3133,3119,3102,17,14,6,8,143,142,1,598,598,0,505,505,0
"2021","Tunbridge Wells 014","E02005175",6953,2009,3646,3632,3618,14,14,6,8,120,118,2,724,722,2,454,454,0
"2021","Cherwell 001","E02005921",5745,1595,3188,3167,3148,19,21,2,19,108,106,2,514,514,0,340,339,1
"2021","Cherwell 002","E02005922",7053,2746,3164,3147,3138,9,17,8,9,156,154,2,721,719,2,266,266,0
"2021","Cherwell 003","E02005923",4725,1797,1968,1966,1948,18,2,0,2,153,152,1,551,549,2,256,256,0
"2021","Cherwell 004","E02005924",10389,4753,3743,3723,3690,33,20,10,10,294,291,3,1084,1083,1,515,514,1
"2021","Cherwell 005","E02005925",6739,2700,2746,2742,2720,22,4,2,2,173,172,1,717,717,0,403,403,0
"2021","Cherwell 006","E02005926",7612,2491,3730,3719,3685,34,11,0,11,129,127,2,691,690,1,571,571,0
"2021","Cherwell 007","E02005927",4679,1621,2294,2286,2272,14,8,2,6,87,86,1,433,433,0,244,244,0
"2021","Cherwell 008","E02005928",8732,2641,4683,4666,4650,16,17,6,11,156,155,1,768,767,1,484,484,0
"2021","Cherwell 009","E02005929",6059,1607,3426,3412,3377,35,14,2,12,101,99,2,561,558,3,364,364,0
"2021","Cherwell 010","E02005930",7593,2172,4137,4114,4089,25,23,6,17,160,156,4,675,674,1,449,446,3
"2021","Cherwell 011","E02005931",8966,2842,4790,4776,4730,46,14,4,10,195,195,0,735,732,3,404,403,1
"2021","Cherwell 012","E02005932",5418,2011,2686,2678,2669,9,8,4,4,96,96,0,479,479,0,146,146,0
"2021","Cherwell 013","E02005933",6332,2249,3045,3038,3017,21,7,0,7,135,135,0,612,612,0,291,291,0
"2021","Cherwell 014","E02005934",7274,2413,3613,3601,3575,26,12,4,8,142,142,0,673,671,2,433,433,0
"2021","Cherwell 015","E02005935",7009,2766,3052,3034,3004,30,18,6,12,141,141,0,695,691,4,355,355,0
"2021","Cherwell 016","E02005936",10357,3417,5359,5343,5290,53,16,6,10,224,220,4,881,876,5,476,476,0
"2021","Cherwell 017","E02005937",5616,1738,2793,2777,2766,11,16,7,9,104,103,1,521,518,3,460,460,0
"2021","Cherwell 018","E02005938",4670,1536,2334,2325,2310,15,9,4,5,96,96,0,370,368,2,334,334,0
"2021","Cherwell 019","E02005939",5629,1908,2761,2747,2739,8,14,10,4,92,91,1,491,491,0,377,377,0
"2021","Oxford 001","E02005940",4993,1682,2511,2495,2479,16,16,6,10,65,65,0,404,403,1,331,329,2
"2021","Oxford 002","E02005941",5501,2253,2499,2487,2468,19,12,5,7,77,77,0,411,411,0,261,260,1
"2021","Oxford 003","E02005942",5274,2329,2305,2282,2272,10,23,7,16,55,54,1,339,339,0,246,246,0
"2021","Oxford 004","E02005943",5956,2560,2561,2543,2535,8,18,4,14,64,64,0,457,456,1,314,314,0
"2021","Oxford 005","E02005944",6566,3147,2463,2446,2426,20,17,9,8,148,148,0,521,520,1,287,286,1
"2021","Oxford 006","E02005945",9575,5141,3555,3530,3503,27,25,13,12,88,87,1,429,427,2,362,362,0
"2021","Oxford 007","E02005946",6905,2820,3176,3162,3148,14,14,10,4,113,110,3,462,462,0,334,333,1
"2021","Oxford 008","E02005947",17678,15132,2014,1996,1965,31,18,6,12,75,72,3,327,325,2,130,130,0
"2021","Oxford 009","E02005948",5777,3443,1666,1645,1619,26,21,10,11,66,66,0,399,399,0,203,202,1
"2021","Oxford 010","E02005949",6434,3861,1904,1893,1885,8,11,9,2,112,110,2,353,350,3,204,204,0
"2021","Oxford 011","E02005950",10249,7394,2086,2056,2000,56,30,6,24,94,94,0,451,449,2,224,221,3
"2021","Oxford 012","E02005951",4719,2446,1631,1614,1598,16,17,8,9,80,80,0,366,366,0,196,196,0
"2021","Oxford 014","E02005953",5181,2988,1667,1636,1619,17,31,8,23,87,87,0,283,282,1,156,156,0
"2021","Oxford 015","E02005954",8644,3709,3579,3546,3521,25,33,12,21,177,173,4,703,700,3,476,472,4
"2021","Oxford 016","E02005955",8806,4008,3485,3472,3408,64,13,8,5,197,196,1,760,755,5,356,356,0
"2021","Oxford 017","E02005956",5155,2339,1906,1896,1881,15,10,8,2,141,141,0,448,445,3,321,321,0
"2021","Oxford 018","E02005957",5301,2611,1799,1793,1782,11,6,4,2,145,142,3,506,504,2,240,240,0
"2021","Oxford 020","E02007021",7039,3806,2479,2468,2462,6,11,9,2,113,113,0,380,380,0,261,261,0
"2021","Oxford 019","E02007116",6966,4147,2092,2073,2049,24,19,10,9,127,126,1,441,439,2,159,159,0
"2021","South Oxfordshire 001","E02005958",4464,1426,2256,2246,2235,11,10,2,8,98,97,1,442,441,1,242,242,0
"2021","South Oxfordshire 002","E02005959",4952,1566,2631,2619,2614,5,12,0,12,73,72,1,393,393,0,289,287,2
"2021","South Oxfordshire 003","E02005960",6233,1818,3269,3258,3245,13,11,8,3,125,125,0,559,559,0,462,462,0
"2021","South Oxfordshire 004","E02005961",5658,1692,3020,3010,2993,17,10,0,10,89,88,1,476,474,2,381,379,2
"2021","South Oxfordshire 005","E02005962",8240,2476,4473,4464,4449,15,9,4,5,133,133,0,724,724,0,434,434,0
"2021","South Oxfordshire 006","E02005963",6694,2090,3411,3389,3367,22,22,6,16,141,141,0,614,613,1,438,438,0
"2021","South Oxfordshire 007","E02005964",6114,1640,3526,3513,3505,8,13,5,8,97,95,2,454,454,0,397,397,0
"2021","South Oxfordshire 008","E02005965",4541,1186,2549,2537,2524,13,12,4,8,78,78,0,391,391,0,337,337,0
"2021","South Oxfordshire 009","E02005966",6502,2499,3138,3126,3101,25,12,4,8,131,130,1,582,581,1,152,151,1
"2021","South Oxfordshire 010","E02005967",7471,2874,3522,3504,3488,16,18,13,5,148,147,1,564,563,1,363,363,0
"2021","South Oxfordshire 011","E02005968",6480,2063,3468,3446,3428,18,22,10,12,137,137,0,495,493,2,317,317,0
"2021","South Oxfordshire 012","E02005969",7913,2458,3995,3984,3968,16,11,4,7,167,164,3,751,747,4,542,542,0
"2021","South Oxfordshire 013","E02005970",4597,2044,1779,1773,1764,9,6,4,2,115,115,0,501,501,0,158,158,0
"2021","South Oxfordshire 014","E02005971",5179,1863,2416,2398,2388,10,18,2,16,108,106,2,438,436,2,354,354,0
"2021","South Oxfordshire 015","E02005972",9346,2964,4962,4937,4916,21,25,6,19,164,162,2,767,762,5,489,489,0
"2021","South Oxfordshire 016","E02005973",4990,1573,2259,2253,2248,5,6,0,6,106,106,0,604,602,2,448,445,3
"2021","South Oxfordshire 017","E02005974",5213,1584,2563,2561,2550,11,2,0,2,109,109,0,553,553,0,404,404,0
"2021","South Oxfordshire 018","E02005975",6703,1609,4067,4043,4035,8,24,10,14,89,88,1,492,490,2,446,445,1
"2021","South Oxfordshire 019","E02005976",5201,1302,3177,3165,3151,14,12,6,6,61,61,0,361,358,3,300,300,0
"2021","South Oxfordshire 020","E02005977",5008,1307,2881,2872,2859,13,9,4,5,70,70,0,397,397,0,353,352,1
"2021","Vale of White Horse 001","E02005978",6353,1762,3602,3592,3561,31,10,2,8,95,94,1,468,467,1,426,426,0
"2021","Vale of White Horse 002","E02005979",8552,3163,4198,4170,4143,27,28,5,23,144,142,2,561,558,3,486,486,0
"2021","Vale of White Horse 003","E02005980",9298,2949,5037,5019,5003,16,18,0,18,121,121,0,666,665,1,525,525,0
"2021","Vale of White Horse 004","E02005981",7057,2010,4108,4100,4086,14,8,2,6,94,92,2,518,517,1,327,327,0
"2021","Vale of White Horse 005","E02005982",4683,1428,2534,2527,2520,7,7,2,5,61,61,0,401,401,0,259,258,1
"2021","Vale of White Horse 006","E02005983",9128,3692,3732,3723,3710,13,9,6,3,200,198,2,900,898,2,604,604,0
"2021","Vale of White Horse 007","E02005984",7398,1973,4358,4350,4323,27,8,2,6,112,112,0,582,582,0,373,373,0
"2021","Vale of White Horse 008","E02005985",6437,2260,2963,2958,2939,19,5,4,1,157,157,0,617,616,1,440,440,0
"2021","Vale of White Horse 009","E02005986",7845,2555,3767,3757,3736,21,10,6,4,202,202,0,797,797,0,524,523,1
"2021","Vale of White Horse 010","E02005987",8126,2627,4202,4191,4167,24,11,0,11,150,148,2,698,694,4,449,449,0
"2021","Vale of White Horse 011","E02005988",7237,2452,3632,3620,3598,22,12,4,8,151,149,2,626,626,0,376,376,0
"2021","Vale of White Horse 014","E02005991",8343,2763,4023,4011,3989,22,12,4,8,182,181,1,719,719,0,656,656,0
"2021","Vale of White Horse 015","E02005992",10911,3305,5909,5890,5861,29,19,4,15,219,219,0,889,886,3,589,589,0
"2021","Vale of White Horse 016","E02006886",11060,3061,6290,6254,6218,36,36,13,23,250,248,2,851,849,2,608,608,0
"2021","West Oxfordshire 001","E02005993",5986,1959,2804,2790,2766,24,14,4,10,136,136,0,627,621,6,460,459,1
"2021","West Oxfordshire 002","E02005994",5147,1491,2775,2766,2751,15,9,2,7,85,85,0,456,452,4,340,338,2
"2021","West Oxfordshire 003","E02005995",5370,1330,3057,3043,3019,24,14,4,10,91,90,1,490,489,1,402,399,3
"2021","West Oxfordshire 004","E02005996",7325,2150,3853,3833,3827,6,20,4,16,136,135,1,672,668,4,514,514,0
"2021","West Oxfordshire 005","E02005997",5005,1360,2730,2718,2711,7,12,4,8,87,87,0,488,486,2,340,339,1
"2021","West Oxfordshire 006","E02005998",5734,1587,3209,3200,3186,14,9,7,2,112,112,0,446,443,3,380,380,0
"2021","West Oxfordshire 007","E02005999",5497,1481,3141,3125,3108,17,16,4,12,93,93,0,447,446,1,335,334,1
"2021","West Oxfordshire 008","E02006000",9578,3143,4689,4659,4643,16,30,7,23,176,176,0,995,993,2,575,575,0
"2021","West Oxfordshire 009","E02006001",5598,2066,2556,2546,2532,14,10,4,6,118,117,1,562,562,0,296,296,0
"2021","West Oxfordshire 010","E02006002",9060,3349,3844,3825,3795,30,19,10,9,218,214,4,942,939,3,707,707,0
"2021","West Oxfordshire 011","E02006003",4888,1501,2487,2479,2472,7,8,0,8,117,117,0,453,453,0,330,330,0
"2021","West Oxfordshire 012","E02006004",6375,2511,2766,2743,2728,15,23,8,15,181,181,0,585,584,1,332,331,1
"2021","West Oxfordshire 013","E02006005",7607,2374,4115,4107,4073,34,8,4,4,191,191,0,670,669,1,257,257,0
"2021","West Oxfordshire 014","E02006006",4632,1316,2464,2457,2451,6,7,2,5,104,104,0,464,464,0,284,284,0
"2021","West Oxfordshire 015","E02006007",6015,1620,3342,3322,3314,8,20,3,17,101,101,0,534,534,0,418,418,0
"2021","Elmbridge 001","E02006317",5027,1530,2581,2565,2557,8,16,4,12,93,93,0,514,512,2,309,309,0
"2021","Elmbridge 002","E02006318",5622,1723,3053,3032,3007,25,21,7,14,117,117,0,447,447,0,282,280,2
"2021","Elmbridge 003","E02006319",5621,2033,2563,2544,2537,7,19,12,7,109,109,0,580,579,1,336,335,1
"2021","Elmbridge 004","E02006320",5605,2236,2377,2360,2340,20,17,9,8,144,144,0,598,598,0,250,249,1
"2021","Elmbridge 005","E02006321",5045,1430,2865,2854,2838,16,11,2,9,93,92,1,357,356,1,300,300,0
"2021","Elmbridge 006","E02006322",5034,1537,2774,2763,2749,14,11,6,5,91,91,0,383,381,2,249,248,1
"2021","Elmbridge 007","E02006323",6022,1985,2966,2956,2934,22,10,8,2,117,115,2,578,577,1,376,376,0
"2021","Elmbridge 008","E02006324",6016,1905,3272,3266,3252,14,6,0,6,104,104,0,451,451,0,284,284,0
"2021","Elmbridge 009","E02006325",6998,1730,4426,4410,4389,21,16,4,12,110,109,1,363,362,1,369,368,1
"2021","Elmbridge 010","E02006326",5883,1928,3032,3018,3000,18,14,0,14,111,111,0,487,486,1,325,324,1
"2021","Elmbridge 011","E02006327",5227,1301,3013,3008,3000,8,5,2,3,90,89,1,465,465,0,358,358,0
"2021","Elmbridge 012","E02006328",7605,2482,3732,3718,3704,14,14,10,4,174,173,1,775,773,2,442,442,0
"2021","Elmbridge 013","E02006329",5714,1598,3255,3249,3236,13,6,6,0,111,111,0,423,423,0,327,326,1
"2021","Elmbridge 014","E02006330",7780,2373,3967,3957,3939,18,10,5,5,151,151,0,721,720,1,568,568,0
"2021","Elmbridge 015","E02006331",5721,1513,3313,3302,3296,6,11,4,7,95,95,0,428,428,0,372,371,1
"2021","Elmbridge 016","E02006332",5348,1464,2975,2963,2954,9,12,0,12,94,94,0,463,462,1,352,350,2
"2021","Elmbridge 017","E02006333",7787,2299,4100,4090,4076,14,10,8,2,157,156,1,724,722,2,507,506,1
"2021","Elmbridge 018","E02006334",6707,1484,4260,4246,4237,9,14,4,10,90,89,1,455,455,0,418,418,0
"2021","Epsom and Ewell 001","E02006335",6554,1938,3621,3615,3600,15,6,3,3,98,98,0,467,467,0,430,429,1
"2021","Epsom and Ewell 002","E02006336",5607,2077,2633,2620,2610,10,13,1,12,117,116,1,508,508,0,272,272,0
"2021","Epsom and Ewell 003","E02006337",7164,1908,4335,4332,4323,9,3,0,3,91,91,0,391,389,2,439,439,0
"2021","Epsom and Ewell 004","E02006338",5420,1579,3012,3002,2995,7,10,4,6,66,66,0,411,409,2,352,352,0
"2021","Epsom and Ewell 005","E02006339",8284,3020,4085,4071,4047,24,14,4,10,179,176,3,708,707,1,292,291,1
"2021","Epsom and Ewell 007","E02006341",8231,3089,3861,3845,3832,13,16,6,10,160,160,0,648,648,0,473,471,2
"2021","Epsom and Ewell 008","E02006342",6721,2709,2810,2789,2768,21,21,5,16,130,130,0,626,625,1,446,445,1
"2021","Epsom and Ewell 009","E02006343",7081,2102,3989,3980,3965,15,9,6,3,98,96,2,491,491,0,401,401,0
"2021","Epsom and Ewell 010","E02006837",9545,2697,5550,5541,5525,16,9,4,5,118,118,0,573,572,1,607,607,0
"2021","Guildford 001","E02006344",7092,1974,3936,3918,3899,19,18,6,12,122,121,1,606,604,2,454,453,1
"2021","Guildford 002","E02006345",6444,2744,2929,2919,2899,20,10,0,10,106,106,0,394,391,3,271,270,1
"2021","Guildford 003","E02006346",8048,1898,4925,4915,4902,13,10,4,6,117,117,0,541,541,0,567,566,1
"2021","Guildford 004","E02006347",5886,1927,2951,2929,2910,19,22,6,16,132,132,0,533,531,2,343,343,0
"2021","Guildford 005","E02006348",7018,2136,3746,3739,3723,16,7,4,3,130,130,0,542,539,3,464,464,0
"2021","Guildford 006","E02006349",6505,2673,2858,2844,2823,21,14,2,12,122,122,0,550,549,1,302,301,1
"2021","Guildford 007","E02006350",5148,2227,2123,2113,2096,17,10,3,7,107,106,1,449,448,1,242,240,2
"2021","Guildford 008","E02006351",6570,2117,3467,3459,3446,13,8,8,0,125,125,0,535,535,0,326,326,0
"2021","Guildford 009","E02006352",5180,2412,2110,2108,2097,11,2,2,0,81,80,1,359,358,1,218,218,0
"2021","Guildford 010","E02006353",4990,1753,2247,2241,2230,11,6,2,4,119,119,0,535,533,2,336,336,0
"2021","Guildford 011","E02006354",7677,2123,4528,4517,4509,8,11,4,7,103,103,0,485,484,1,438,437,1
"2021","Guildford 012","E02006355",8659,6139,1781,1770,1764,6,11,4,7,118,118,0,404,404,0,217,217,0
"2021","Guildford 013","E02006356",9904,5267,3353,3328,3297,31,25,2,23,183,180,3,745,744,1,356,354,2
"2021","Guildford 014","E02006357",5892,1817,3112,3088,3071,17,24,12,12,116,115,1,550,550,0,297,296,1
"2021","Guildford 015","E02006358",7899,5066,2247,2226,2214,12,21,4,17,68,68,0,294,294,0,224,221,3
"2021","Guildford 016","E02006359",5084,1658,2745,2729,2719,10,16,7,9,71,71,0,383,383,0,227,227,0
"2021","Guildford 017","E02006360",6655,1801,3663,3651,3639,12,12,6,6,120,120,0,573,570,3,498,497,1
"2021","Guildford 018","E02006361",4714,1171,2736,2720,2706,14,16,6,10,85,84,1,414,414,0,308,308,0
"2021","Mole Valley 001","E02006362",5555,1389,3321,3315,3307,8,6,0,6,80,80,0,348,347,1,417,416,1
"2021","Mole Valley 002","E02006363",4855,1295,2763,2751,2741,10,12,4,8,79,79,0,366,366,0,352,352,0
"2021","Mole Valley 003","E02006364",6209,2856,2268,2262,2252,10,6,4,2,176,175,1,636,635,1,273,272,1
"2021","Mole Valley 004","E02006365",5281,1483,2800,2793,2777,16,7,2,5,128,127,1,472,472,0,398,397,1
"2021","Mole Valley 005","E02006366",6614,1637,4017,4007,3999,8,10,8,2,108,108,0,441,441,0,411,411,0
"2021","Mole Valley 006","E02006367",4930,1272,2828,2820,2808,12,8,6,2,81,80,1,392,392,0,357,357,0
"2021","Mole Valley 007","E02006368",4721,1173,2610,2606,2601,5,4,2,2,70,70,0,394,392,2,474,473,1
"2021","Mole Valley 008","E02006369",5440,1336,2981,2977,2963,14,4,0,4,106,105,1,554,554,0,463,463,0
"2021","Mole Valley 009","E02006370",5330,1699,2680,2666,2637,29,14,8,6,111,111,0,467,465,2,373,373,0
"2021","Mole Valley 010","E02006371",6092,1967,2959,2941,2926,15,18,6,12,136,136,0,599,596,3,431,431,0
"2021","Mole Valley 011","E02006372",5156,1797,2350,2339,2323,16,11,6,5,130,130,0,577,574,3,302,301,1
"2021","Mole Valley 012","E02006373",6245,1790,3336,3330,3318,12,6,0,6,119,118,1,591,590,1,409,408,1
"2021","Mole Valley 013","E02006374",5908,1708,3091,3081,3066,15,10,6,4,132,132,0,585,585,0,392,392,0
"2021","Reigate and Banstead 001","E02006375",5449,1442,3219,3211,3197,14,8,8,0,77,77,0,361,359,2,350,350,0
"2021","Reigate and Banstead 002","E02006376",7821,2797,3527,3511,3494,17,16,6,10,168,167,1,677,677,0,652,651,1
"2021","Reigate and Banstead 003","E02006377",5116,1409,2946,2936,2930,6,10,8,2,66,66,0,349,349,0,346,346,0
"2021","Reigate and Banstead 004","E02006378",7107,2149,3898,3882,3863,19,16,6,10,121,121,0,547,547,0,392,390,2
"2021","Reigate and Banstead 005","E02006379",5213,2076,2155,2146,2131,15,9,1,8,139,138,1,555,554,1,288,287,1
"2021","Reigate and Banstead 006","E02006380",5903,1380,3454,3439,3428,11,15,6,9,105,105,0,480,480,0,484,484,0
"2021","Reigate and Banstead 007","E02006381",6020,1629,3415,3409,3390,19,6,3,3,95,95,0,496,496,0,385,382,3
"2021","Reigate and Banstead 008","E02006382",5259,1943,2433,2417,2405,12,16,2,14,122,122,0,491,490,1,270,270,0
"2021","Reigate and Banstead 009","E02006383",8003,2535,4124,4109,4096,13,15,6,9,125,125,0,626,624,2,593,593,0
"2021","Reigate and Banstead 010","E02006384",8623,3220,4081,4057,4045,12,24,8,16,184,182,2,700,699,1,438,435,3
"2021","Reigate and Banstead 011","E02006385",8987,3589,4142,4127,4102,25,15,2,13,191,188,3,760,759,1,305,305,0
"2021","Reigate and Banstead 012","E02006386",6459,1986,3492,3481,3470,11,11,5,6,113,113,0,511,506,5,357,357,0
"2021","Reigate and Banstead 013","E02006387",5206,1686,2691,2685,2673,12,6,2,4,128,128,0,438,438,0,263,262,1
"2021","Reigate and Banstead 014","E02006388",7486,2651,3607,3587,3572,15,20,8,12,176,176,0,678,676,2,374,374,0
"2021","Reigate and Banstead 015","E02006389",5814,1811,3018,3006,2989,17,12,2,10,102,102,0,523,520,3,360,360,0
"2021","Reigate and Banstead 016","E02006390",8109,2814,3948,3936,3912,24,12,0,12,150,150,0,706,706,0,491,491,0
"2021","Reigate and Banstead 017","E02006391",6046,1828,3351,3333,3300,33,18,6,12,113,113,0,497,497,0,257,257,0
"2021","Reigate and Banstead 018","E02006392",7509,2801,3235,3219,3208,11,16,7,9,157,155,2,787,787,0,529,529,0
"2021","Runnymede 001","E02006393",6022,3271,1970,1958,1950,8,12,6,6,97,94,3,391,391,0,293,293,0
"2021","Runnymede 002","E02006394",10464,6635,2805,2795,2780,15,10,2,8,127,127,0,550,547,3,347,347,0
"2021","Runnymede 003","E02006395",7877,2975,3618,3609,3585,24,9,5,4,153,153,0,740,738,2,391,391,0
"2021","Runnymede 004","E02006396",5030,1576,2476,2465,2449,16,11,5,6,93,91,2,548,548,0,337,337,0
"2021","Runnymede 005","E02006397",5179,1330,3028,3019,3001,18,9,2,7,113,113,0,375,375,0,333,332,1
"2021","Runnymede 006","E02006398",6964,2820,2851,2835,2808,27,16,6,10,161,159,2,778,774,4,354,354,0
"2021","Runnymede 007","E02006399",9836,3471,4652,4640,4608,32,12,6,6,208,204,4,915,910,5,590,588,2
"2021","Runnymede 008","E02006400",4698,1370,2447,2439,2426,13,8,4,4,86,85,1,459,458,1,336,336,0
"2021","Runnymede 009","E02006401",8566,3065,3963,3946,3926,20,17,4,13,183,181,2,821,819,2,534,532,2
"2021","Runnymede 010","E02006402",8089,2387,4396,4392,4376,16,4,2,2,146,143,3,645,644,1,515,515,0
"2021","Spelthorne 001","E02006403",5385,2038,2357,2341,2331,10,16,4,12,155,154,1,557,557,0,278,278,0
"2021","Spelthorne 002","E02006404",5941,2233,2765,2765,2752,13,0,0,0,142,142,0,498,496,2,303,303,0
"2021","Spelthorne 003","E02006405",9282,3211,4647,4636,4606,30,11,2,9,190,189,1,749,745,4,485,485,0
"2021","Spelthorne 004","E02006406",7468,3013,3298,3270,3231,39,28,12,16,177,175,2,673,669,4,307,306,1
"2021","Spelthorne 005","E02006407",7542,2479,3735,3710,3704,6,25,8,17,141,141,0,657,656,1,530,530,0
"2021","Spelthorne 006","E02006408",7141,2594,3320,3310,3302,8,10,4,6,181,178,3,626,626,0,420,420,0
"2021","Spelthorne 007","E02006409",5430,1978,2410,2403,2392,11,7,6,1,121,119,2,581,580,1,340,340,0
"2021","Spelthorne 008","E02006410",6665,2587,2948,2940,2916,24,8,0,8,175,175,0,606,604,2,349,348,1
"2021","Spelthorne 009","E02006411",5991,1712,3275,3263,3249,14,12,6,6,105,105,0,461,460,1,438,438,0
"2021","Spelthorne 010","E02006412",6243,1813,3407,3393,3366,27,14,6,8,114,114,0,489,486,3,420,420,0
"2021","Spelthorne 011","E02006413",5291,1678,2578,2567,2553,14,11,6,5,119,118,1,515,512,3,401,401,0
"2021","Spelthorne 012","E02006414",5074,1562,2587,2576,2567,9,11,1,10,88,88,0,481,481,0,356,356,0
"2021","Spelthorne 013","E02006415",5909,1621,3100,3076,3050,26,24,4,20,91,91,0,569,566,3,528,527,1
"2021","Surrey Heath 001","E02006416",6925,1796,3950,3940,3925,15,10,4,6,131,131,0,620,620,0,428,428,0
"2021","Surrey Heath 002","E02006417",4901,1522,2412,2400,2389,11,12,3,9,115,115,0,522,522,0,330,329,1
"2021","Surrey Heath 003","E02006418",5548,1477,3097,3092,3083,9,5,0,5,74,74,0,496,496,0,404,404,0
"2021","Surrey Heath 004","E02006419",6636,2415,2987,2985,2961,24,2,0,2,156,156,0,658,657,1,420,420,0
"2021","Surrey Heath 005","E02006420",6512,1786,3728,3715,3707,8,13,2,11,108,108,0,442,440,2,448,447,1
"2021","Surrey Heath 006","E02006421",8185,2652,4329,4321,4296,25,8,2,6,150,150,0,604,604,0,450,450,0
"2021","Surrey Heath 007","E02006422",4934,1270,2879,2875,2863,12,4,0,4,110,109,1,418,418,0,257,257,0
"2021","Surrey Heath 008","E02006423",9277,3353,4371,4355,4333,22,16,6,10,186,184,2,822,818,4,545,543,2
"2021","Surrey Heath 009","E02006424",5277,1263,3264,3262,3258,4,2,0,2,77,77,0,350,350,0,323,322,1
"2021","Surrey Heath 010","E02006425",5228,1645,2715,2710,2697,13,5,1,4,97,97,0,451,450,1,320,320,0
"2021","Surrey Heath 011","E02006426",4502,1257,2482,2476,2467,9,6,0,6,73,73,0,431,430,1,259,259,0
"2021","Surrey Heath 012","E02006427",5865,1787,2995,2982,2959,23,13,5,8,125,125,0,552,551,1,406,405,1
"2021","Tandridge 002","E02006429",6644,2504,3074,3070,3058,12,4,0,4,151,149,2,604,603,1,311,311,0
"2021","Tandridge 003","E02006430",7455,2688,3462,3449,3436,13,13,4,9,176,176,0,713,712,1,416,416,0
"2021","Tandridge 004","E02006431",8980,3289,4218,4200,4176,24,18,2,16,190,190,0,801,801,0,482,482,0
"2021","Tandridge 005","E02006432",4631,1303,2542,2537,2528,9,5,0,5,89,89,0,386,386,0,311,309,2
"2021","Tandridge 006","E02006433",7721,2015,4380,4362,4341,21,18,4,14,146,146,0,607,606,1,573,573,0
"2021","Tandridge 007","E02006434",5216,1719,2624,2612,2605,7,12,8,4,87,86,1,458,456,2,328,327,1
"2021","Tandridge 008","E02006435",4950,1507,2529,2526,2512,14,3,0,3,112,111,1,497,496,1,305,305,0
"2021","Tandridge 009","E02006436",5012,1639,2413,2401,2392,9,12,0,12,110,110,0,527,527,0,323,323,0
"2021","Tandridge 010","E02006437",6922,2052,3552,3541,3529,12,11,2,9,145,145,0,635,635,0,538,537,1
"2021","Tandridge 011","E02006438",6996,2038,3742,3732,3718,14,10,6,4,136,134,2,616,613,3,464,464,0
"2021","Tandridge 012","E02006790",6295,1856,3201,3193,3177,16,8,4,4,133,133,0,600,599,1,505,505,0
"2021","Waverley 001","E02006439",5107,1642,2553,2546,2537,9,7,2,5,98,98,0,476,474,2,338,337,1
"2021","Waverley 002","E02006440",5872,1803,3151,3139,3126,13,12,4,8,115,115,0,468,466,2,335,334,1
"2021","Waverley 003","E02006441",7073,2973,2670,2656,2641,15,14,4,10,168,167,1,705,705,0,557,557,0
"2021","Waverley 004","E02006442",5029,1235,3159,3156,3152,4,3,2,1,64,64,0,278,278,0,293,293,0
"2021","Waverley 005","E02006443",6051,2040,2773,2758,2743,15,15,4,11,156,155,1,611,611,0,471,471,0
"2021","Waverley 006","E02006444",5529,1622,3088,3077,3067,10,11,4,7,96,96,0,416,414,2,307,307,0
"2021","Waverley 007","E02006445",6744,2575,3064,3045,3032,13,19,6,13,187,186,1,570,569,1,348,348,0
"2021","Waverley 008","E02006446",5617,1495,3209,3203,3194,9,6,0,6,103,101,2,468,464,4,342,342,0
"2021","Waverley 009","E02006447",5283,1484,2933,2925,2918,7,8,3,5,111,111,0,449,448,1,306,306,0
"2021","Waverley 010","E02006448",5827,1696,3335,3331,3322,9,4,2,2,88,88,0,423,421,2,285,284,1
"2021","Waverley 011","E02006449",5667,1543,3059,3049,3034,15,10,6,4,103,103,0,496,493,3,466,465,1
"2021","Waverley 012","E02006450",5755,1509,3366,3354,3351,3,12,6,6,70,70,0,453,450,3,357,357,0
"2021","Waverley 013","E02006451",9579,2704,5165,5151,5131,20,14,4,10,188,188,0,853,853,0,669,666,3
"2021","Waverley 015","E02006453",6996,1856,3893,3880,3868,12,13,6,7,110,110,0,576,576,0,561,561,0
"2021","Waverley 016","E02006454",5414,1357,3125,3111,3103,8,14,6,8,97,97,0,448,447,1,387,387,0
"2021","Waverley 017","E02006455",5000,1642,2459,2439,2431,8,20,14,6,116,116,0,442,442,0,341,341,0
"2021","Waverley 018","E02006839",7089,1809,4021,4007,3994,13,14,8,6,115,115,0,580,579,1,564,562,2
"2021","Woking 001","E02006456",6425,2200,3016,3009,2993,16,7,2,5,140,140,0,634,631,3,435,435,0
"2021","Woking 002","E02006457",7562,1865,4558,4543,4531,12,15,3,12,100,98,2,514,514,0,525,525,0
"2021","Woking 003","E02006458",7392,1995,4425,4416,4388,28,9,5,4,109,106,3,439,438,1,424,424,0
"2021","Woking 004","E02006459",8292,3256,3924,3913,3887,26,11,0,11,217,216,1,550,550,0,345,345,0
"2021","Woking 005","E02006460",7347,2611,3457,3449,3439,10,8,2,6,195,195,0,718,717,1,366,366,0
"2021","Woking 006","E02006461",5590,1679,2967,2941,2929,12,26,11,15,99,98,1,471,471,0,374,374,0
"2021","Woking 007","E02006462",6677,2308,3288,3281,3253,28,7,2,5,138,138,0,637,637,0,306,306,0
"2021","Woking 008","E02006463",8794,3677,3766,3750,3718,32,16,6,10,178,174,4,789,785,4,384,384,0
"2021","Woking 009","E02006464",5492,1756,2731,2720,2708,12,11,4,7,119,119,0,537,534,3,349,349,0
"2021","Woking 010","E02006465",5043,1395,2941,2928,2919,9,13,6,7,69,69,0,356,356,0,282,282,0
"2021","Woking 011","E02006466",8615,3111,4142,4129,4096,33,13,4,9,194,192,2,735,734,1,433,432,1
"2021","Woking 012","E02006467",5748,1526,3435,3428,3410,18,7,6,1,99,98,1,379,379,0,309,309,0
"2021","Adur 001","E02006534",7399,2478,3515,3500,3455,45,15,4,11,146,145,1,691,689,2,569,567,2
"2021","Adur 002","E02006535",5895,1621,3234,3212,3179,33,22,4,18,97,96,1,502,499,3,441,440,1
"2021","Adur 003","E02006536",6062,1854,3161,3137,3110,27,24,4,20,104,104,0,552,548,4,391,391,0
"2021","Adur 004","E02006537",8388,3243,3326,3309,3278,31,17,4,13,240,237,3,973,971,2,606,605,1
"2021","Adur 005","E02006538",7740,2691,3326,3282,3217,65,44,10,34,222,220,2,968,958,10,533,532,1
"2021","Adur 006","E02006539",6086,2018,2784,2766,2741,25,18,4,14,131,131,0,646,645,1,507,506,1
"2021","Adur 007","E02006540",4797,1563,2092,2080,2067,13,12,4,8,116,114,2,641,637,4,385,384,1
"2021","Adur 008","E02006541",6588,2280,2699,2685,2651,34,14,2,12,152,148,4,851,848,3,606,604,2
"2021","Arun 001","E02006542",5009,1406,2539,2518,2482,36,21,8,13,105,103,2,565,565,0,394,393,1
"2021","Arun 002","E02006543",4833,1277,2512,2505,2496,9,7,0,7,106,104,2,562,562,0,376,376,0
"2021","Arun 003","E02006544",9696,2753,5127,5109,5078,31,18,4,14,196,195,1,938,938,0,682,681,1
"2021","Arun 004","E02006545",9251,3531,3974,3939,3895,44,35,16,19,276,275,1,1054,1053,1,416,415,1
"2021","Arun 005","E02006546",9126,2633,4498,4475,4445,30,23,10,13,199,199,0,1000,999,1,796,794,2
"2021","Arun 006","E02006547",5749,1896,2759,2742,2707,35,17,6,11,141,141,0,596,595,1,357,356,1
"2021","Arun 007","E02006548",8053,2427,3806,3792,3772,20,14,2,12,197,197,0,981,978,3,642,641,1
"2021","Arun 008","E02006549",5678,1093,3329,3310,3291,19,19,2,17,77,77,0,520,519,1,659,657,2
"2021","Arun 009","E02006550",8268,2277,4123,4112,4087,25,11,4,7,170,168,2,844,842,2,854,854,0
"2021","Arun 010","E02006551",7386,1358,4041,4012,3980,32,29,12,17,117,117,0,853,852,1,1017,1012,5
"2021","Arun 011","E02006552",6256,2616,1976,1952,1936,16,24,4,20,247,247,0,1006,1004,2,411,408,3
"2021","Arun 012","E02006553",7847,2625,3707,3699,3679,20,8,2,6,154,154,0,843,840,3,518,518,0
"2021","Arun 013","E02006554",5762,1459,2937,2919,2911,8,18,4,14,123,123,0,665,663,2,578,577,1
"2021","Arun 014","E02006555",6367,2526,2399,2381,2360,21,18,8,10,145,143,2,829,829,0,468,468,0
"2021","Arun 015","E02006556",8823,2385,4662,4638,4614,24,24,8,16,154,152,2,873,872,1,749,749,0
"2021","Arun 016","E02006557",6281,2590,2396,2380,2360,20,16,12,4,176,174,2,731,729,2,388,386,2
"2021","Arun 017","E02006558",9369,4215,2752,2720,2694,26,32,8,24,268,265,3,1359,1357,2,775,775,0
"2021","Arun 018","E02006559",7345,1448,4384,4370,4350,20,14,8,6,105,105,0,608,606,2,800,797,3
"2021","Arun 019","E02006560",8454,2251,4310,4300,4282,18,10,8,2,145,145,0,912,912,0,836,832,4
"2021","Chichester 001","E02006561",5408,1419,3118,3109,3096,13,9,3,6,82,82,0,471,471,0,318,318,0
"2021","Chichester 002","E02006562",5108,1235,3090,3079,3061,18,11,6,5,80,80,0,414,413,1,289,287,2
"2021","Chichester 003","E02006563",4882,1199,2825,2801,2794,7,24,14,10,86,85,1,422,420,2,350,348,2
"2021","Chichester 004","E02006564",6744,1793,3430,3410,3384,26,20,10,10,138,137,1,767,767,0,616,614,2
"2021","Chichester 005","E02006565",6860,1776,3679,3651,3624,27,28,10,18,142,142,0,690,688,2,573,572,1
"2021","Chichester 006","E02006566",7008,1865,3745,3725,3704,21,20,6,14,161,159,2,663,663,0,574,573,1
"2021","Chichester 007","E02006567",6417,1726,3476,3465,3451,14,11,0,11,133,133,0,634,634,0,448,448,0
"2021","Chichester 008","E02006568",10373,4861,3446,3417,3388,29,29,14,15,255,252,3,1126,1120,6,685,681,4
"2021","Chichester 009","E02006569",8091,2544,3999,3985,3959,26,14,4,10,168,167,1,778,772,6,602,601,1
"2021","Chichester 010","E02006570",7874,3411,2712,2688,2667,21,24,8,16,176,176,0,951,947,4,624,622,2
"2021","Chichester 011","E02006571",7084,2096,3687,3671,3648,23,16,6,10,137,137,0,657,656,1,507,504,3
"2021","Chichester 012","E02006572",9360,3396,4176,4155,4127,28,21,10,11,227,226,1,1062,1060,2,499,497,2
"2021","Chichester 013","E02006573",9912,2481,5301,5273,5233,40,28,12,16,213,208,5,951,947,4,966,964,2
"2021","Chichester 014","E02006574",9582,2469,4822,4802,4760,42,20,5,15,215,211,4,1013,1012,1,1063,1062,1
"2021","Crawley 001","E02006575",6958,2620,3203,3189,3173,16,14,10,4,191,190,1,602,601,1,342,342,0
"2021","Crawley 002","E02006576",8331,2899,4263,4247,4238,9,16,8,8,178,177,1,636,633,3,355,354,1
"2021","Crawley 003","E02006577",7096,2630,3123,3120,3102,18,3,0,3,173,173,0,704,702,2,466,465,1
"2021","Crawley 004","E02006578",10024,4306,4182,4169,4149,20,13,4,9,219,214,5,866,864,2,451,451,0
"2021","Crawley 005","E02006579",6769,2532,3117,3105,3092,13,12,8,4,159,158,1,598,595,3,363,363,0
"2021","Crawley 006","E02006580",6750,2395,3155,3145,3132,13,10,8,2,155,152,3,596,596,0,449,449,0
"2021","Crawley 007","E02006581",8251,3507,3256,3245,3208,37,11,4,7,233,227,6,781,781,0,474,474,0
"2021","Crawley 008","E02006582",6246,2016,3355,3337,3322,15,18,4,14,107,107,0,557,557,0,211,211,0
"2021","Crawley 009","E02006583",7693,2665,3653,3637,3624,13,16,4,12,169,167,2,752,752,0,454,454,0
"2021","Crawley 010","E02006584",6064,2455,2496,2494,2477,17,2,2,0,157,157,0,686,685,1,270,269,1
"2021","Crawley 011","E02006585",6495,2430,2876,2870,2854,16,6,2,4,122,121,1,644,641,3,423,423,0
"2021","Crawley 012","E02006586",6163,2609,2600,2593,2576,17,7,4,3,187,185,2,555,554,1,212,212,0
"2021","Crawley 013","E02006587",6731,2825,2671,2656,2635,21,15,6,9,201,201,0,784,782,2,250,250,0
"2021","Horsham 001","E02006588",8467,3085,4010,4000,3963,37,10,2,8,164,163,1,822,821,1,386,386,0
"2021","Horsham 002","E02006589",9335,2550,5376,5364,5340,24,12,4,8,133,133,0,746,745,1,530,530,0
"2021","Horsham 003","E02006590",7215,2326,3497,3477,3470,7,20,10,10,172,168,4,742,741,1,478,478,0
"2021","Horsham 004","E02006591",6829,2365,3166,3152,3128,24,14,8,6,160,158,2,676,674,2,462,462,0
"2021","Horsham 005","E02006592",5482,1505,3095,3087,3081,6,8,5,3,90,89,1,455,455,0,337,337,0
"2021","Horsham 006","E02006593",9327,3471,3901,3876,3846,30,25,12,13,192,190,2,997,992,5,766,766,0
"2021","Horsham 007","E02006594",8559,2771,4397,4382,4357,25,15,4,11,167,166,1,804,798,6,420,419,1
"2021","Horsham 008","E02006595",7171,2022,4144,4121,4095,26,23,10,13,92,92,0,493,491,2,420,420,0
"2021","Horsham 009","E02006596",7534,2220,4129,4116,4099,17,13,4,9,135,134,1,667,665,2,383,382,1
"2021","Horsham 010","E02006597",9897,3040,5117,5097,5064,33,20,10,10,203,201,2,986,981,5,551,551,0
"2021","Horsham 011","E02006598",4630,1241,2581,2571,2565,6,10,0,10,97,96,1,403,402,1,308,308,0
"2021","Horsham 012","E02006599",6097,1079,4050,4024,4011,13,26,4,22,70,70,0,427,426,1,471,471,0
"2021","Horsham 013","E02006600",8386,2271,4145,4122,4090,32,23,8,15,214,212,2,970,968,2,786,786,0
"2021","Horsham 014","E02006601",7455,2134,3777,3753,3722,31,24,2,22,170,169,1,758,755,3,616,615,1
"2021","Horsham 015","E02006602",7083,1851,4124,4107,4088,19,17,2,15,143,143,0,577,575,2,388,387,1
"2021","Horsham 016","E02006603",7193,1795,3841,3821,3807,14,20,6,14,131,131,0,797,795,2,629,628,1
"2021","Mid Sussex 001","E02006604",10903,3911,4808,4793,4773,20,15,6,9,276,275,1,1189,1187,2,719,719,0
"2021","Mid Sussex 002","E02006605",5258,1605,2735,2719,2709,10,16,4,12,116,116,0,494,493,1,308,308,0
"2021","Mid Sussex 003","E02006606",6729,1921,3626,3620,3608,12,6,2,4,112,112,0,673,672,1,397,396,1
"2021","Mid Sussex 004","E02006607",6550,1703,3798,3791,3776,15,7,1,6,105,105,0,515,514,1,429,429,0
"2021","Mid Sussex 005","E02006608",5191,1294,2997,2982,2976,6,15,11,4,81,80,1,464,464,0,355,355,0
"2021","Mid Sussex 006","E02006609",5649,1595,3109,3091,3073,18,18,4,14,94,94,0,483,481,2,368,368,0
"2021","Mid Sussex 007","E02006610",6339,1921,3318,3290,3272,18,28,10,18,154,152,2,565,562,3,381,381,0
"2021","Mid Sussex 008","E02006611",9020,2200,5309,5287,5263,24,22,10,12,140,140,0,710,707,3,661,661,0
"2021","Mid Sussex 009","E02006612",9658,3479,4368,4339,4287,52,29,4,25,226,224,2,963,958,5,622,621,1
"2021","Mid Sussex 010","E02006613",6187,2261,2835,2825,2802,23,10,2,8,128,128,0,624,621,3,339,339,0
"2021","Mid Sussex 011","E02006614",10112,3132,5341,5325,5270,55,16,6,10,227,227,0,917,915,2,495,495,0
"2021","Mid Sussex 012","E02006615",5685,1885,2859,2850,2832,18,9,2,7,87,84,3,603,603,0,251,251,0
"2021","Mid Sussex 013","E02006616",7939,2601,4050,4032,4004,28,18,0,18,151,151,0,694,690,4,443,443,0
"2021","Mid Sussex 014","E02006617",7521,2547,3398,3375,3354,21,23,8,15,196,193,3,807,805,2,573,571,2
"2021","Mid Sussex 015","E02006618",5383,1382,3152,3141,3129,12,11,8,3,77,77,0,386,384,2,386,385,1
"2021","Mid Sussex 016","E02006619",7100,2203,3707,3687,3661,26,20,2,18,142,141,1,663,660,3,385,384,1
"2021","Mid Sussex 017","E02006620",8093,2093,4539,4522,4491,31,17,2,15,149,148,1,650,645,5,662,660,2
"2021","Worthing 001","E02006621",6783,1523,3956,3938,3917,21,18,4,14,94,94,0,637,634,3,573,571,2
"2021","Worthing 002","E02006622",6551,1978,3229,3209,3191,18,20,2,18,142,142,0,735,734,1,467,467,0
"2021","Worthing 003","E02006623",6513,2163,2890,2880,2844,36,10,4,6,166,165,1,816,815,1,478,478,0
"2021","Worthing 004","E02006624",5990,1726,3361,3354,3328,26,7,0,7,97,97,0,454,451,3,352,351,1
"2021","Worthing 005","E02006625",6445,2332,2879,2858,2835,23,21,2,19,158,158,0,727,719,8,349,349,0
"2021","Worthing 006","E02006626",7693,2930,3388,3377,3344,33,11,4,7,220,219,1,830,827,3,325,324,1
"2021","Worthing 007","E02006627",7886,2668,3624,3609,3575,34,15,6,9,185,182,3,856,853,3,553,553,0
"2021","Worthing 008","E02006628",7159,3054,2664,2642,2603,39,22,0,22,187,187,0,913,908,5,341,339,2
"2021","Worthing 009","E02006629",6360,2479,2551,2525,2490,35,26,2,24,167,165,2,742,740,2,421,418,3
"2021","Worthing 010","E02006630",7805,3135,2511,2487,2449,38,24,8,16,230,228,2,1064,1057,7,865,865,0
"2021","Worthing 011","E02006631",8872,4250,2402,2374,2307,67,28,0,28,281,275,6,1325,1319,6,614,606,8
"2021","Worthing 012","E02006632",7050,2125,3257,3233,3197,36,24,2,22,166,164,2,895,890,5,607,604,3
"2021","Worthing 013","E02006633",7241,1798,3934,3915,3891,24,19,1,18,106,106,0,684,682,2,719,718,1
"2021","Bath and North East Somerset 001","E02002985",5484,1905,2562,2545,2528,17,17,8,9,122,121,1,503,501,2,392,392,0
"2021","Bath and North East Somerset 002","E02002986",5666,2190,2375,2366,2351,15,9,0,9,124,124,0,562,559,3,415,415,0
"2021","Bath and North East Somerset 003","E02002987",4817,1263,2725,2721,2709,12,4,2,2,82,82,0,397,397,0,350,350,0
"2021","Bath and North East Somerset 004","E02002988",4592,1588,2179,2161,2148,13,18,6,12,64,63,1,475,475,0,286,285,1
"2021","Bath and North East Somerset 005","E02002989",4473,1511,2186,2174,2159,15,12,8,4,62,62,0,381,381,0,333,332,1
"2021","Bath and North East Somerset 006","E02002990",4994,2461,1836,1816,1789,27,20,12,8,82,81,1,443,443,0,172,172,0
"2021","Bath and North East Somerset 007","E02002991",9742,5030,3258,3219,3171,48,39,8,31,165,165,0,791,787,4,498,495,3
"2021","Bath and North East Somerset 008","E02002992",4757,1786,2232,2214,2208,6,18,11,7,74,73,1,381,380,1,284,284,0
"2021","Bath and North East Somerset 009","E02002993",5478,3420,1427,1415,1395,20,12,6,6,65,65,0,394,394,0,172,171,1
"2021","Bath and North East Somerset 010","E02002994",8635,2509,4727,4702,4680,22,25,2,23,118,118,0,717,716,1,564,563,1
"2021","Bath and North East Somerset 011","E02002995",4694,2616,1336,1335,1325,10,1,0,1,92,91,1,440,440,0,210,210,0
"2021","Bath and North East Somerset 012","E02002996",10609,6591,3107,3074,3056,18,33,8,25,109,109,0,412,412,0,390,389,1
"2021","Bath and North East Somerset 013","E02002997",7574,5230,1709,1696,1674,22,13,2,11,89,89,0,360,360,0,186,186,0
"2021","Bath and North East Somerset 014","E02002998",5209,3095,1490,1482,1468,14,8,8,0,60,60,0,334,334,0,230,230,0
"2021","Bath and North East Somerset 015","E02002999",4665,1982,1927,1919,1917,2,8,8,0,89,87,2,379,379,0,288,288,0
"2021","Bath and North East Somerset 016","E02003000",8090,2102,4601,4590,4564,26,11,0,11,111,111,0,682,678,4,594,594,0
"2021","Bath and North East Somerset 017","E02003001",4554,1444,2445,2442,2419,23,3,0,3,72,72,0,317,317,0,276,276,0
"2021","Bath and North East Somerset 018","E02003002",4990,1950,2189,2177,2167,10,12,0,12,113,112,1,435,434,1,303,302,1
"2021","Bath and North East Somerset 019","E02003003",4905,2046,2045,2035,2022,13,10,4,6,73,72,1,414,413,1,327,327,0
"2021","Bath and North East Somerset 020","E02003004",6003,1953,3171,3166,3164,2,5,1,4,101,101,0,438,437,1,340,340,0
"2021","Bath and North East Somerset 021","E02003005",5510,1372,3299,3292,3286,6,7,3,4,89,88,1,426,426,0,324,324,0
"2021","Bath and North East Somerset 022","E02003006",8393,3474,3716,3698,3676,22,18,3,15,152,152,0,638,638,0,413,413,0
"2021","Bath and North East Somerset 023","E02003007",7740,2444,3944,3934,3909,25,10,6,4,157,157,0,685,681,4,510,509,1
"2021","Bath and North East Somerset 024","E02003008",4832,1800,2151,2145,2129,16,6,0,6,125,125,0,504,503,1,252,252,0
"2021","Bath and North East Somerset 025","E02003009",5104,1623,2546,2534,2516,18,12,4,8,96,95,1,502,498,4,337,335,2
"2021","Bath and North East Somerset 026","E02003010",5235,1871,2474,2472,2454,18,2,0,2,115,115,0,495,495,0,280,279,1
"2021","Bath and North East Somerset 027","E02003011",4871,1486,2504,2504,2498,6,0,0,0,103,102,1,410,409,1,368,368,0
"2021","Bristol 001","E02003012",9503,4152,3685,3656,3638,18,29,10,19,223,222,1,981,978,3,462,457,5
"2021","Bristol 002","E02003013",10040,4557,3718,3707,3681,26,11,2,9,270,270,0,896,889,7,599,599,0
"2021","Bristol 003","E02003014",6296,2959,2175,2165,2156,9,10,6,4,176,175,1,623,618,5,363,361,2
"2021","Bristol 004","E02003015",5611,2638,2204,2184,2173,11,20,8,12,96,95,1,416,415,1,257,254,3
"2021","Bristol 005","E02003016",6622,3920,1902,1892,1878,14,10,6,4,130,130,0,440,439,1,230,230,0
"2021","Bristol 006","E02003017",5109,1578,2560,2544,2534,10,16,8,8,80,80,0,453,453,0,438,438,0
"2021","Bristol 007","E02003018",4900,1729,2293,2285,2274,11,8,3,5,108,107,1,496,494,2,274,274,0
"2021","Bristol 008","E02003019",8312,3432,3302,3282,3260,22,20,8,12,204,204,0,878,877,1,496,494,2
"2021","Bristol 009","E02003020",5107,1221,3008,2994,2982,12,14,2,12,48,48,0,342,340,2,488,488,0
"2021","Bristol 010","E02003021",6208,3634,1932,1915,1895,20,17,14,3,86,85,1,349,347,2,207,207,0
"2021","Bristol 011","E02003022",4873,1166,3071,3059,3048,11,12,4,8,52,50,2,280,280,0,304,303,1
"2021","Bristol 012","E02003023",5652,2685,2100,2088,2066,22,12,6,6,103,103,0,493,493,0,271,271,0
"2021","Bristol 013","E02003024",8247,4166,2754,2741,2704,37,13,4,9,182,182,0,654,653,1,491,491,0
"2021","Bristol 014","E02003025",6151,3023,2097,2085,2073,12,12,8,4,148,148,0,554,554,0,329,328,1
"2021","Bristol 015","E02003026",8901,4170,3703,3681,3659,22,22,10,12,76,76,0,482,479,3,470,469,1
"2021","Bristol 016","E02003027",10812,5987,3795,3733,3700,33,62,22,40,151,147,4,630,629,1,249,246,3
"2021","Bristol 017","E02003028",7152,3092,3262,3242,3238,4,20,8,12,84,84,0,431,430,1,283,280,3
"2021","Bristol 018","E02003029",5184,2372,1938,1932,1918,14,6,0,6,128,127,1,466,461,5,280,279,1
"2021","Bristol 019","E02003030",6558,3473,2248,2234,2195,39,14,5,9,143,141,2,500,497,3,194,194,0
"2021","Bristol 020","E02003031",8923,5342,2947,2905,2881,24,42,16,26,108,108,0,372,371,1,154,154,0
"2021","Bristol 021","E02003032",6689,3163,2524,2509,2487,22,15,6,9,150,150,0,587,586,1,265,264,1
"2021","Bristol 022","E02003033",8116,5914,1672,1653,1631,22,19,8,11,78,76,2,307,306,1,145,145,0
"2021","Bristol 025","E02003036",7935,5901,1491,1475,1458,17,16,8,8,88,87,1,362,360,2,93,93,0
"2021","Bristol 026","E02003037",8484,6105,1787,1757,1746,11,30,14,16,83,81,2,357,354,3,152,150,2
"2021","Bristol 027","E02003038",5639,2482,2219,2214,2207,7,5,2,3,131,128,3,521,519,2,286,286,0
"2021","Bristol 028","E02003039",7231,3526,2552,2529,2510,19,23,14,9,163,162,1,653,648,5,337,336,1
"2021","Bristol 029","E02003040",8417,5168,2059,2020,1981,39,39,24,15,159,157,2,701,698,3,330,330,0
"2021","Bristol 030","E02003041",5599,3402,1598,1564,1544,20,34,12,22,75,74,1,343,341,2,181,181,0
"2021","Bristol 033","E02003044",5128,2154,2156,2146,2135,11,10,4,6,95,95,0,467,466,1,256,255,1
"2021","Bristol 034","E02003045",6382,4475,1328,1305,1288,17,23,8,15,89,88,1,368,366,2,122,122,0
"2021","Bristol 035","E02003046",8201,4127,2911,2895,2859,36,16,4,12,186,183,3,644,639,5,333,333,0
"2021","Bristol 036","E02003047",9354,5405,2917,2892,2851,41,25,10,15,124,122,2,623,621,2,285,284,1
"2021","Bristol 037","E02003048",5816,3430,1739,1697,1662,35,42,12,30,94,93,1,421,410,11,132,131,1
"2021","Bristol 038","E02003049",6394,2638,2763,2757,2728,29,6,3,3,129,129,0,542,541,1,322,322,0
"2021","Bristol 039","E02003050",9006,5662,2245,2215,2177,38,30,12,18,133,132,1,624,623,1,342,342,0
"2021","Bristol 040","E02003051",6016,3356,1988,1984,1961,23,4,2,2,99,99,0,402,397,5,171,171,0
"2021","Bristol 041","E02003052",5955,2900,2325,2305,2257,48,20,10,10,92,92,0,390,385,5,248,248,0
"2021","Bristol 042","E02003053",6985,2931,3095,3057,3038,19,38,8,30,106,104,2,532,529,3,321,320,1
"2021","Bristol 043","E02003054",5657,2360,2477,2461,2441,20,16,2,14,109,109,0,439,437,2,272,272,0
"2021","Bristol 044","E02003055",6918,3435,2513,2504,2493,11,9,2,7,145,144,1,508,506,2,317,316,1
"2021","Bristol 045","E02003056",5903,2842,2014,2002,1986,16,12,8,4,157,157,0,556,556,0,334,334,0
"2021","Bristol 046","E02003057",5058,2010,2211,2200,2181,19,11,0,11,102,102,0,426,426,0,309,309,0
"2021","Bristol 047","E02003058",7868,3305,3168,3161,3136,25,7,2,5,166,163,3,727,726,1,502,501,1
"2021","Bristol 048","E02003059",5376,2379,2088,2075,2065,10,13,4,9,110,107,3,442,440,2,357,357,0
"2021","Bristol 049","E02003060",9131,3264,4136,4115,4088,27,21,9,12,170,168,2,827,825,2,734,732,2
"2021","Bristol 050","E02003061",4762,2235,1632,1623,1618,5,9,4,5,127,126,1,497,497,0,271,271,0
"2021","Bristol 051","E02003062",4586,2256,1487,1481,1474,7,6,6,0,124,122,2,434,434,0,285,285,0
"2021","Bristol 052","E02003063",6022,1895,3168,3161,3153,8,7,4,3,87,87,0,438,437,1,434,434,0
"2021","Bristol 053","E02003064",5365,2845,1522,1508,1502,6,14,4,10,170,169,1,524,523,1,304,304,0
"2021","Bristol 054","E02006887",8803,6631,1444,1425,1400,25,19,8,11,138,134,4,475,473,2,115,115,0
"2021","Bristol 055","E02006888",5621,3275,1589,1574,1559,15,15,12,3,151,149,2,435,430,5,171,171,0
"2021","Bristol 056","E02006889",5762,2997,1825,1819,1794,25,6,4,2,211,209,2,516,514,2,213,213,0
"2021","Bristol 057","E02006890",7422,4364,2174,2146,2106,40,28,10,18,153,153,0,516,516,0,215,214,1
"2021","Bristol 058","E02006949",5684,3773,1293,1267,1249,18,26,11,15,105,103,2,392,392,0,121,118,3
"2021","Bristol 059","E02006950",6482,4831,1057,1025,1002,23,32,16,16,95,95,0,416,413,3,83,83,0
"2021","Bristol 060","E02006951",8143,6836,963,947,930,17,16,8,8,71,70,1,211,210,1,62,62,0
"2021","Bristol 061","E02006952",7631,6103,1068,1048,1014,34,20,16,4,87,86,1,286,282,4,87,87,0
"2021","North Somerset 001","E02003065",8134,2484,3874,3868,3840,28,6,2,4,206,205,1,942,939,3,628,628,0
"2021","North Somerset 002","E02003066",5161,1068,3294,3280,3269,11,14,4,10,60,60,0,391,389,2,348,346,2
"2021","North Somerset 003","E02003067",6420,1810,3334,3326,3310,16,8,4,4,142,142,0,638,638,0,496,496,0
"2021","North Somerset 004","E02003068",5297,1608,2753,2741,2724,17,12,6,6,110,110,0,482,481,1,344,344,0
"2021","North Somerset 005","E02003069",4836,1117,2733,2714,2694,20,19,8,11,79,79,0,440,438,2,467,465,2
"2021","North Somerset 006","E02003070",10578,2672,6210,6190,6155,35,20,10,10,179,179,0,842,842,0,675,673,2
"2021","North Somerset 007","E02003071",6706,2134,3025,3005,2994,11,20,10,10,151,151,0,789,789,0,607,606,1
"2021","North Somerset 008","E02003072",7850,2112,3986,3961,3951,10,25,19,6,137,137,0,835,832,3,780,779,1
"2021","North Somerset 009","E02003073",5270,1237,3223,3213,3203,10,10,2,8,74,73,1,411,410,1,325,325,0
"2021","North Somerset 010","E02003074",6389,1988,3208,3201,3185,16,7,0,7,115,115,0,677,676,1,401,401,0
"2021","North Somerset 011","E02003075",4912,1215,3022,3012,3001,11,10,2,8,46,46,0,338,337,1,291,291,0
"2021","North Somerset 012","E02003076",8092,2313,4359,4330,4320,10,29,2,27,138,137,1,763,762,1,519,519,0
"2021","North Somerset 013","E02003077",5248,1429,2926,2916,2905,11,10,2,8,99,99,0,431,431,0,363,362,1
"2021","North Somerset 014","E02003078",6147,1700,3341,3324,3306,18,17,4,13,119,118,1,565,563,2,422,422,0
"2021","North Somerset 015","E02003079",7518,2304,3853,3850,3839,11,3,0,3,172,171,1,819,818,1,370,370,0
"2021","North Somerset 016","E02003080",7316,2135,3343,3337,3322,15,6,4,2,187,187,0,918,915,3,733,731,2
"2021","North Somerset 017","E02003081",7979,2246,4209,4194,4184,10,15,4,11,138,138,0,789,787,2,597,597,0
"2021","North Somerset 018","E02003082",8143,3091,2899,2867,2827,40,32,12,20,225,224,1,1260,1256,4,668,667,1
"2021","North Somerset 020","E02003084",9015,3977,2776,2758,2730,28,18,8,10,310,309,1,1285,1279,6,667,666,1
"2021","North Somerset 021","E02003085",6073,2722,1926,1914,1899,15,12,8,4,203,203,0,850,850,0,372,372,0
"2021","North Somerset 022","E02003086",5337,1860,2184,2165,2156,9,19,0,19,130,127,3,647,645,2,516,515,1
"2021","North Somerset 023","E02003087",8999,2404,4864,4849,4826,23,15,2,13,188,188,0,891,890,1,652,649,3
"2021","North Somerset 024","E02003088",7526,1924,4260,4251,4225,26,9,4,5,140,140,0,580,579,1,622,622,0
"2021","North Somerset 025","E02003089",4919,1469,2358,2353,2348,5,5,2,3,127,127,0,566,563,3,399,399,0
"2021","North Somerset 026","E02006845",7486,2615,3404,3393,3364,29,11,5,6,205,203,2,836,835,1,426,426,0
"2021","North Somerset 027","E02006846",7214,3073,2895,2891,2859,32,4,0,4,226,226,0,825,823,2,195,195,0
"2021","South Gloucestershire 001","E02003090",7585,2366,3968,3953,3931,22,15,3,12,135,135,0,606,606,0,510,510,0
"2021","South Gloucestershire 002","E02003091",5574,1628,2833,2831,2817,14,2,0,2,120,120,0,563,563,0,430,430,0
"2021","South Gloucestershire 003","E02003092",7251,2241,3836,3819,3802,17,17,2,15,157,157,0,683,682,1,334,333,1
"2021","South Gloucestershire 004","E02003093",5686,1366,3395,3391,3391,0,4,2,2,81,81,0,402,402,0,442,442,0
"2021","South Gloucestershire 005","E02003094",7276,2237,3885,3874,3852,22,11,7,4,136,136,0,610,609,1,408,408,0
"2021","South Gloucestershire 006","E02003095",7040,2413,3689,3685,3670,15,4,2,2,106,106,0,500,500,0,332,332,0
"2021","South Gloucestershire 007","E02003096",5214,1971,2242,2234,2222,12,8,2,6,113,113,0,563,563,0,325,325,0
"2021","South Gloucestershire 008","E02003097",5505,1464,2924,2918,2913,5,6,0,6,89,88,1,509,506,3,519,518,1
"2021","South Gloucestershire 009","E02003098",8012,3038,3903,3893,3862,31,10,6,4,153,152,1,709,707,2,209,209,0
"2021","South Gloucestershire 010","E02003099",6195,2023,2984,2978,2964,14,6,4,2,106,106,0,629,627,2,453,453,0
"2021","South Gloucestershire 012","E02003101",8517,3225,4122,4114,4105,9,8,2,6,170,170,0,754,753,1,246,246,0
"2021","South Gloucestershire 013","E02003102",5743,1560,3302,3292,3277,15,10,2,8,87,86,1,415,415,0,379,379,0
"2021","South Gloucestershire 014","E02003103",5668,2173,2536,2524,2513,11,12,6,6,132,132,0,600,599,1,227,227,0
"2021","South Gloucestershire 015","E02003104",6188,2173,2992,2986,2970,16,6,4,2,114,114,0,578,577,1,331,331,0
"2021","South Gloucestershire 016","E02003105",5283,1446,2855,2847,2841,6,8,4,4,89,89,0,445,444,1,448,447,1
"2021","South Gloucestershire 018","E02003107",9645,4836,3385,3372,3350,22,13,2,11,168,167,1,746,742,4,510,510,0
"2021","South Gloucestershire 019","E02003108",10285,3786,4801,4789,4767,22,12,4,8,215,214,1,934,929,5,549,545,4
"2021","South Gloucestershire 020","E02003109",5000,1275,3029,3023,3013,10,6,2,4,52,52,0,309,309,0,335,334,1
"2021","South Gloucestershire 021","E02003110",9608,3252,5088,5075,5050,25,13,8,5,188,186,2,707,707,0,373,373,0
"2021","South Gloucestershire 022","E02003111",5522,1708,2813,2802,2782,20,11,4,7,85,85,0,467,467,0,449,449,0
"2021","South Gloucestershire 023","E02003112",5197,1932,2225,2220,2208,12,5,3,2,108,106,2,562,562,0,370,370,0
"2021","South Gloucestershire 024","E02003113",8707,2369,4898,4879,4854,25,19,8,11,150,150,0,724,723,1,566,566,0
"2021","South Gloucestershire 025","E02003114",5986,2155,2694,2682,2673,9,12,6,6,108,108,0,558,554,4,471,471,0
"2021","South Gloucestershire 026","E02003115",7961,3338,3135,3110,3090,20,25,10,15,195,194,1,792,788,4,501,501,0
"2021","South Gloucestershire 027","E02003116",6350,2536,2506,2497,2483,14,9,4,5,132,129,3,671,669,2,505,505,0
"2021","South Gloucestershire 028","E02003117",7637,3141,3258,3238,3211,27,20,7,13,140,139,1,678,675,3,420,420,0
"2021","South Gloucestershire 029","E02003118",8243,3053,3822,3808,3781,27,14,2,12,152,152,0,789,787,2,427,427,0
"2021","South Gloucestershire 030","E02003119",8368,2966,3922,3909,3893,16,13,2,11,166,165,1,847,846,1,467,466,1
"2021","South Gloucestershire 031","E02003120",7606,2312,4055,4043,4032,11,12,10,2,113,113,0,594,593,1,532,532,0
"2021","South Gloucestershire 032","E02003121",8569,2520,4578,4562,4542,20,16,6,10,117,117,0,729,726,3,625,625,0
"2021","South Gloucestershire 033","E02007064",6435,2348,2890,2887,2867,20,3,0,3,164,163,1,602,602,0,431,430,1
"2021","South Gloucestershire 034","E02007065",5992,2713,2430,2406,2386,20,24,12,12,115,114,1,524,523,1,210,210,0
"2021","South Gloucestershire 035","E02007066",7946,5602,1739,1737,1717,20,2,2,0,108,108,0,352,350,2,145,145,0
"2021","South Gloucestershire 036","E02007067",5563,1942,2853,2843,2829,14,10,0,10,97,96,1,372,372,0,299,299,0
"2021","Plymouth 001","E02003122",6121,1373,3571,3557,3545,12,14,6,8,107,106,1,519,518,1,551,551,0
"2021","Plymouth 002","E02003123",6874,2458,2972,2961,2948,13,11,2,9,191,190,1,778,775,3,475,475,0
"2021","Plymouth 003","E02003124",6452,2504,2567,2554,2535,19,13,6,7,218,216,2,762,757,5,401,400,1
"2021","Plymouth 004","E02003125",4977,1842,1965,1958,1944,14,7,6,1,151,147,4,657,653,4,362,362,0
"2021","Plymouth 005","E02003126",6993,2512,3194,3186,3180,6,8,4,4,138,138,0,707,703,4,442,442,0
"2021","Plymouth 006","E02003127",5985,2250,2439,2428,2424,4,11,6,5,175,175,0,724,724,0,397,397,0
"2021","Plymouth 007","E02003128",7372,2840,2836,2821,2806,15,15,4,11,235,234,1,953,953,0,508,508,0
"2021","Plymouth 008","E02003129",5224,1424,2759,2753,2743,10,6,0,6,138,138,0,536,535,1,367,367,0
"2021","Plymouth 009","E02003130",8446,3135,3532,3512,3491,21,20,6,14,230,228,2,1016,1014,2,533,533,0
"2021","Plymouth 010","E02003131",5966,2049,2649,2646,2624,22,3,0,3,158,158,0,692,687,5,418,417,1
"2021","Plymouth 011","E02003132",7047,2388,3284,3273,3259,14,11,4,7,175,175,0,776,775,1,424,424,0
"2021","Plymouth 012","E02003133",5877,1775,2914,2902,2888,14,12,4,8,137,137,0,630,629,1,421,421,0
"2021","Plymouth 013","E02003134",5497,2217,2244,2231,2207,24,13,4,9,131,131,0,577,573,4,328,328,0
"2021","Plymouth 014","E02003135",5528,2489,1835,1818,1803,15,17,10,7,217,214,3,691,688,3,296,296,0
"2021","Plymouth 015","E02003136",6594,1653,3559,3552,3545,7,7,3,4,123,123,0,617,617,0,642,642,0
"2021","Plymouth 016","E02003137",6524,1790,3522,3507,3487,20,15,2,13,104,102,2,538,534,4,570,570,0
"2021","Plymouth 017","E02003138",6112,2261,2749,2735,2693,42,14,2,12,156,154,2,671,667,4,275,271,4
"2021","Plymouth 018","E02003139",5344,1764,2797,2791,2777,14,6,4,2,104,104,0,487,485,2,192,192,0
"2021","Plymouth 019","E02003140",6356,1820,3342,3327,3312,15,15,4,11,113,112,1,598,598,0,483,482,1
"2021","Plymouth 020","E02003141",6662,3020,2226,2213,2172,41,13,2,11,210,206,4,886,883,3,320,319,1
"2021","Plymouth 021","E02003142",7414,2940,2866,2845,2815,30,21,8,13,204,203,1,957,956,1,447,446,1
"2021","Plymouth 022","E02003143",5994,1738,2999,2991,2979,12,8,2,6,173,172,1,669,668,1,415,415,0
"2021","Plymouth 023","E02003144",7852,5635,1279,1273,1258,15,6,4,2,161,125,36,523,521,2,254,253,1
"2021","Plymouth 024","E02003145",5672,2434,2098,2084,2061,23,14,6,8,164,162,2,611,608,3,365,365,0
"2021","Plymouth 025","E02003146",7299,4300,1945,1931,1918,13,14,4,10,187,185,2,678,678,0,189,189,0
"2021","Plymouth 026","E02003147",7185,3524,2107,2091,2056,35,16,8,8,265,263,2,992,987,5,297,296,1
"2021","Plymouth 027","E02003148",10421,7619,1425,1403,1382,21,22,9,13,235,199,36,859,855,4,283,281,2
"2021","Plymouth 028","E02003149",7933,4663,1892,1880,1859,21,12,2,10,223,223,0,867,862,5,288,287,1
"2021","Plymouth 030","E02003151",6983,1590,4032,4019,4010,9,13,2,11,119,119,0,544,543,1,698,698,0
"2021","Plymouth 031","E02003152",9274,2704,4821,4815,4783,32,6,0,6,200,198,2,903,902,1,646,644,2
"2021","Plymouth 032","E02003153",6132,1663,3200,3192,3181,11,8,4,4,124,124,0,604,601,3,541,541,0
"2021","Plymouth 033","E02006989",4557,2447,1135,1120,1104,16,15,6,9,158,156,2,630,625,5,187,186,1
"2021","Plymouth 034","E02006990",5957,3018,1527,1509,1485,24,18,6,12,205,205,0,870,867,3,337,334,3
"2021","Torbay 001","E02003154",5813,2085,2462,2456,2431,25,6,0,6,142,142,0,682,682,0,442,441,1
"2021","Torbay 002","E02003155",5018,1590,2169,2157,2144,13,12,2,10,118,118,0,639,638,1,502,502,0
"2021","Torbay 003","E02003156",8504,2850,4107,4093,4052,41,14,5,9,188,188,0,932,929,3,427,427,0
"2021","Torbay 004","E02003157",5524,2235,1993,1980,1953,27,13,6,7,173,168,5,802,799,3,321,321,0
"2021","Torbay 005","E02003158",4849,1652,1868,1848,1840,8,20,2,18,123,120,3,713,710,3,493,493,0
"2021","Torbay 006","E02003159",4801,2000,1719,1713,1689,24,6,2,4,153,152,1,670,668,2,259,258,1
"2021","Torbay 008","E02003161",6642,3165,1843,1796,1763,33,47,2,45,240,239,1,1029,1025,4,365,365,0
"2021","Torbay 010","E02003163",7533,2109,3373,3332,3272,60,41,4,37,182,181,1,1060,1056,4,809,805,4
"2021","Torbay 011","E02003164",7685,2142,3865,3849,3823,26,16,0,16,154,152,2,842,840,2,682,680,2
"2021","Torbay 012","E02003165",6035,1903,2885,2876,2849,27,9,4,5,123,121,2,669,667,2,455,455,0
"2021","Torbay 013","E02003166",10137,3684,4444,4426,4399,27,18,4,14,262,261,1,1167,1165,2,580,580,0
"2021","Torbay 014","E02003167",8669,3204,2995,2980,2947,33,15,0,15,270,268,2,1361,1359,2,839,839,0
"2021","Torbay 015","E02003168",6141,1661,3007,2986,2959,27,21,2,19,127,126,1,772,769,3,574,572,2
"2021","Torbay 016","E02003169",5865,1208,3433,3414,3405,9,19,4,15,72,72,0,528,528,0,624,623,1
"2021","Torbay 017","E02003170",8333,2188,4106,4080,4048,32,26,10,16,185,185,0,1072,1072,0,782,780,2
"2021","Torbay 018","E02003171",6286,1727,3128,3106,3085,21,22,3,19,111,111,0,743,743,0,577,577,0
"2021","Torbay 019","E02006840",9202,3006,4316,4295,4272,23,21,4,17,203,202,1,1055,1054,1,622,620,2
"2021","Swindon 001","E02003212",7064,1932,3696,3684,3663,21,12,6,6,171,171,0,719,717,2,546,546,0
"2021","Swindon 003","E02003214",4998,2199,1738,1727,1719,8,11,2,9,159,158,1,604,602,2,298,298,0
"2021","Swindon 004","E02003215",5791,1539,3097,3091,3082,9,6,0,6,106,105,1,569,567,2,480,480,0
"2021","Swindon 005","E02003216",8257,2621,4027,4009,3987,22,18,6,12,193,191,2,806,805,1,610,610,0
"2021","Swindon 006","E02003217",5789,2074,2548,2540,2527,13,8,4,4,151,151,0,633,633,0,383,383,0
"2021","Swindon 007","E02003218",5177,1983,2198,2185,2165,20,13,6,7,147,146,1,564,564,0,285,285,0
"2021","Swindon 008","E02003219",9972,3115,5473,5452,5412,40,21,2,19,177,175,2,819,816,3,388,387,1
"2021","Swindon 009","E02003220",8671,2593,4448,4431,4410,21,17,4,13,150,150,0,796,793,3,684,681,3
"2021","Swindon 010","E02003221",5887,2077,2777,2764,2747,17,13,10,3,128,128,0,605,603,2,300,299,1
"2021","Swindon 011","E02003222",4851,1581,2505,2501,2490,11,4,2,2,109,107,2,496,495,1,160,160,0
"2021","Swindon 012","E02003223",8789,3462,3906,3887,3855,32,19,4,15,233,229,4,830,827,3,358,357,1
"2021","Swindon 013","E02003224",7237,2026,3771,3761,3752,9,10,2,8,131,129,2,734,734,0,575,574,1
"2021","Swindon 014","E02003225",5274,1809,2640,2635,2619,16,5,4,1,135,135,0,490,488,2,200,200,0
"2021","Swindon 015","E02003226",8557,3041,4508,4457,4444,13,51,48,3,202,200,2,500,500,0,306,303,3
"2021","Swindon 016","E02003227",5293,2214,2059,2044,2035,9,15,4,11,142,142,0,621,621,0,257,256,1
"2021","Swindon 017","E02003228",6216,1962,3375,3348,3329,19,27,12,15,111,111,0,462,458,4,306,306,0
"2021","Swindon 018","E02003229",4597,1529,2322,2318,2308,10,4,4,0,83,83,0,485,484,1,178,177,1
"2021","Swindon 019","E02003230",7286,3239,2866,2832,2814,18,34,26,8,183,183,0,720,718,2,278,277,1
"2021","Swindon 020","E02003231",6573,2480,2797,2782,2764,18,15,4,11,208,207,1,680,676,4,408,408,0
"2021","Swindon 021","E02003232",7006,2614,3318,3300,3287,13,18,8,10,145,143,2,614,611,3,315,315,0
"2021","Swindon 022","E02003233",6997,2378,3226,3204,3185,19,22,12,10,197,194,3,790,790,0,406,405,1
"2021","Swindon 023","E02003234",7015,2303,3363,3354,3331,23,9,8,1,141,141,0,719,719,0,489,489,0
"2021","Swindon 024","E02003235",7658,2409,3920,3909,3897,12,11,4,7,129,129,0,659,655,4,541,540,1
"2021","Swindon 025","E02003236",10445,2964,5515,5488,5475,13,27,11,16,219,218,1,1002,1002,0,745,745,0
"2021","Swindon 026","E02006847",7382,2576,3720,3706,3690,16,14,2,12,179,179,0,709,704,5,198,196,2
"2021","Swindon 027","E02006848",6324,2500,2771,2751,2738,13,20,6,14,222,220,2,691,687,4,140,140,0
"2021","Swindon 028","E02006849",8051,2530,4327,4313,4296,17,14,6,8,178,175,3,740,736,4,276,276,0
"2021","Cornwall 010","E02003892",5750,1440,3069,3051,3035,16,18,0,18,134,132,2,690,686,4,417,417,0
"2021","Cornwall 012","E02003893",5699,1470,3118,3101,3083,18,17,2,15,110,110,0,580,577,3,421,419,2
"2021","Cornwall 013","E02003894",7007,2048,3444,3426,3408,18,18,6,12,154,154,0,814,811,3,547,546,1
"2021","Cornwall 016","E02003895",7734,2376,3689,3676,3653,23,13,4,9,181,181,0,909,908,1,579,579,0
"2021","Cornwall 017","E02003896",4978,1702,2052,2037,2022,15,15,2,13,155,155,0,648,644,4,421,420,1
"2021","Cornwall 022","E02003897",4530,1074,2659,2653,2638,15,6,2,4,105,105,0,434,433,1,258,258,0
"2021","Cornwall 023","E02003898",5818,1370,3354,3346,3321,25,8,4,4,95,95,0,561,561,0,438,438,0
"2021","Cornwall 025","E02003899",4390,1203,2134,2125,2114,11,9,2,7,113,113,0,547,544,3,393,393,0
"2021","Cornwall 026","E02003900",5857,1739,2813,2802,2782,20,11,2,9,154,153,1,678,677,1,473,473,0
"2021","Cornwall 028","E02003901",7166,1866,3742,3722,3712,10,20,4,16,146,145,1,770,768,2,642,642,0
"2021","Cornwall 029","E02003902",4409,1348,1966,1963,1954,9,3,0,3,118,118,0,594,592,2,383,383,0
"2021","Cornwall 034","E02003903",5306,1375,2824,2810,2800,10,14,12,2,124,124,0,582,582,0,401,400,1
"2021","Cornwall 037","E02003904",4492,1155,2273,2262,2249,13,11,2,9,111,111,0,579,579,0,374,373,1
"2021","Cornwall 032","E02003905",5825,1808,2938,2925,2904,21,13,7,6,110,108,2,632,629,3,337,337,0
"2021","Cornwall 033","E02003906",5296,1650,2527,2519,2503,16,8,4,4,130,129,1,567,564,3,422,422,0
"2021","Cornwall 040","E02003907",6914,2114,3410,3399,3392,7,11,0,11,144,144,0,749,745,4,497,497,0
"2021","Cornwall 042","E02003908",6964,2421,3127,3110,3082,28,17,4,13,127,127,0,776,775,1,513,513,0
"2021","Cornwall 043","E02003909",8952,3343,3868,3840,3826,14,28,8,20,187,185,2,923,923,0,631,630,1
"2021","Cornwall 044","E02003910",5851,2227,2273,2261,2217,44,12,4,8,137,137,0,710,708,2,504,502,2
"2021","Cornwall 047","E02003911",7692,2028,4298,4282,4266,16,16,8,8,108,108,0,679,673,6,579,578,1
"2021","Cornwall 048","E02003912",7032,1925,3665,3654,3646,8,11,3,8,129,126,3,725,725,0,588,586,2
"2021","Cornwall 056","E02003913",5112,1222,2960,2952,2942,10,8,0,8,66,66,0,461,460,1,403,401,2
"2021","Cornwall 060","E02003914",7226,3824,2290,2272,2261,11,18,6,12,123,123,0,666,666,0,323,323,0
"2021","Cornwall 062","E02003915",7218,4016,1984,1974,1960,14,10,0,10,135,134,1,666,666,0,417,416,1
"2021","Cornwall 063","E02003916",6480,3455,1989,1971,1958,13,18,4,14,84,84,0,502,502,0,450,449,1
"2021","Cornwall 064","E02003917",6867,2322,3287,3270,3256,14,17,6,11,118,118,0,699,696,3,441,441,0
"2021","Cornwall 045","E02003918",6047,1819,2969,2952,2941,11,17,6,11,108,108,0,678,672,6,473,473,0
"2021","Cornwall 046","E02003919",6022,2221,2396,2387,2379,8,9,1,8,166,163,3,819,817,2,420,420,0
"2021","Cornwall 049","E02003920",6747,2360,2891,2869,2854,15,22,10,12,149,149,0,878,874,4,469,468,1
"2021","Cornwall 050","E02003921",5262,1612,2576,2558,2535,23,18,2,16,99,99,0,561,561,0,414,414,0
"2021","Cornwall 051","E02003922",7270,2504,3243,3231,3219,12,12,4,8,214,212,2,912,908,4,397,395,2
"2021","Cornwall 052","E02003923",7533,3056,2930,2911,2898,13,19,10,9,189,188,1,927,924,3,431,431,0
"2021","Cornwall 053","E02003924",6216,1976,2723,2713,2700,13,10,4,6,140,140,0,823,823,0,554,551,3
"2021","Cornwall 055","E02003925",5890,2004,2684,2674,2647,27,10,0,10,127,127,0,670,666,4,405,405,0
"2021","Cornwall 059","E02003926",6960,2011,3774,3751,3735,16,23,10,13,127,126,1,639,639,0,409,409,0
"2021","Cornwall 066","E02003927",9193,3435,4282,4258,4236,22,24,6,18,112,110,2,766,765,1,598,598,0
"2021","Cornwall 071","E02003928",9688,2792,4879,4829,4806,23,50,36,14,223,223,0,1155,1153,2,639,639,0
"2021","Cornwall 072","E02003929",5917,1605,3096,3084,3071,13,12,2,10,99,99,0,660,660,0,457,457,0
"2021","Cornwall 073","E02003930",7585,2045,3961,3929,3907,22,32,14,18,119,118,1,810,809,1,650,650,0
"2021","Cornwall 001","E02003931",8792,2636,4135,4121,4107,14,14,0,14,235,235,0,998,996,2,788,788,0
"2021","Cornwall 002","E02003932",6209,1556,3524,3510,3477,33,14,4,10,112,110,2,566,564,2,451,451,0
"2021","Cornwall 003","E02003933",6010,1628,3092,3077,3060,17,15,2,13,117,117,0,700,700,0,473,470,3
"2021","Cornwall 004","E02003934",5957,1653,3164,3150,3138,12,14,2,12,116,114,2,614,612,2,410,410,0
"2021","Cornwall 005","E02003935",8244,2845,3643,3618,3586,32,25,8,17,257,256,1,977,975,2,522,522,0
"2021","Cornwall 006","E02003936",7233,1794,4106,4093,4069,24,13,2,11,109,109,0,684,681,3,540,539,1
"2021","Cornwall 007","E02003937",4477,1228,2348,2336,2327,9,12,5,7,77,76,1,429,429,0,395,395,0
"2021","Cornwall 008","E02003938",5583,1723,2818,2797,2784,13,21,6,15,124,124,0,562,562,0,356,354,2
"2021","Cornwall 009","E02003939",5746,1688,2707,2699,2691,8,8,2,6,97,95,2,731,731,0,523,523,0
"2021","Cornwall 011","E02003940",5506,1378,3063,3057,3045,12,6,6,0,87,87,0,567,567,0,411,410,1
"2021","Cornwall 014","E02003941",7283,2617,3236,3216,3212,4,20,4,16,167,166,1,735,733,2,528,527,1
"2021","Cornwall 015","E02003942",6362,2479,2463,2456,2440,16,7,4,3,184,184,0,830,829,1,406,406,0
"2021","Cornwall 054","E02003943",5908,1891,2608,2594,2572,22,14,2,12,142,142,0,776,774,2,491,491,0
"2021","Cornwall 057","E02003944",8540,2844,3824,3799,3772,27,25,6,19,185,183,2,1014,1013,1,673,673,0
"2021","Cornwall 058","E02003945",5163,1386,2694,2666,2649,17,28,12,16,99,98,1,566,566,0,418,417,1
"2021","Cornwall 061","E02003946",7873,2257,3983,3940,3923,17,43,4,39,138,137,1,909,906,3,586,583,3
"2021","Cornwall 065","E02003947",5607,1622,2854,2825,2787,38,29,6,23,107,107,0,601,600,1,423,421,2
"2021","Cornwall 067","E02003948",6974,2496,2827,2809,2796,13,18,6,12,137,135,2,1000,1000,0,514,514,0
"2021","Cornwall 068","E02003949",5702,2343,1672,1655,1634,21,17,2,15,176,175,1,1035,1032,3,476,473,3
"2021","Cornwall 069","E02003950",4611,1372,2246,2204,2185,19,42,28,14,80,80,0,578,577,1,335,335,0
"2021","Cornwall 070","E02003951",5019,1508,2275,2258,2243,15,17,6,11,105,105,0,663,662,1,468,467,1
"2021","Cornwall 018","E02003952",7843,2785,3532,3516,3492,24,16,6,10,176,176,0,891,889,2,459,459,0
"2021","Cornwall 019","E02003953",8809,2859,4248,4223,4186,37,25,7,18,200,200,0,892,890,2,610,610,0
"2021","Cornwall 020","E02003954",6629,2806,2464,2452,2438,14,12,6,6,148,145,3,791,790,1,420,420,0
"2021","Cornwall 021","E02003955",8411,3131,3659,3648,3632,16,11,4,7,183,183,0,894,892,2,544,544,0
"2021","Cornwall 024","E02003956",6339,2104,3011,2999,2989,10,12,8,4,147,145,2,651,648,3,426,425,1
"2021","Cornwall 027","E02003957",9131,2947,4278,4251,4218,33,27,4,23,214,213,1,1087,1080,7,605,605,0
"2021","Cornwall 030","E02003958",6709,2124,3260,3242,3227,15,18,4,14,139,139,0,734,731,3,452,452,0
"2021","Cornwall 031","E02003959",5652,1857,2521,2504,2491,13,17,8,9,144,143,1,697,696,1,433,433,0
"2021","Cornwall 035","E02003960",4976,1308,2554,2544,2529,15,10,2,8,90,89,1,593,590,3,431,428,3
"2021","Cornwall 036","E02003961",8009,2223,4197,4186,4166,20,11,8,3,127,123,4,865,862,3,597,597,0
"2021","Cornwall 038","E02003962",5974,2060,2705,2689,2670,19,16,8,8,131,129,2,692,690,2,386,385,1
"2021","Cornwall 039","E02003963",8275,2992,3300,3283,3264,19,17,6,11,209,207,2,1047,1044,3,727,727,0
"2021","Cornwall 041","E02003964",6973,1622,3815,3800,3778,22,15,6,9,141,140,1,745,743,2,650,648,2
"2021","Isles of Scilly 001","E02006781",1730,473,927,927,926,1,0,0,0,34,34,0,158,158,0,138,138,0
"2021","Wiltshire 012","E02006634",7144,1739,4136,4121,4107,14,15,5,10,137,137,0,650,650,0,482,482,0
"2021","Wiltshire 019","E02006635",7434,2511,3345,3334,3323,11,11,6,5,151,150,1,763,762,1,664,663,1
"2021","Wiltshire 024","E02006636",5997,1599,3186,3173,3156,17,13,6,7,124,123,1,640,639,1,448,448,0
"2021","Wiltshire 025","E02006637",9000,2975,4199,4180,4156,24,19,8,11,224,224,0,1033,1030,3,569,569,0
"2021","Wiltshire 026","E02006638",5502,1641,2536,2529,2520,9,7,3,4,133,131,2,676,675,1,516,515,1
"2021","Wiltshire 028","E02006639",7330,2018,3957,3946,3925,21,11,8,3,140,139,1,734,734,0,481,481,0
"2021","Wiltshire 029","E02006640",6081,1478,3569,3557,3551,6,12,8,4,119,119,0,564,561,3,351,349,2
"2021","Wiltshire 034","E02006641",6762,1863,3606,3593,3568,25,13,12,1,147,147,0,703,701,2,443,443,0
"2021","Wiltshire 038","E02006642",4794,1173,2717,2707,2694,13,10,0,10,126,126,0,502,501,1,276,276,0
"2021","Wiltshire 001","E02006644",5710,1404,3216,3209,3198,11,7,0,7,99,96,3,587,587,0,404,404,0
"2021","Wiltshire 002","E02006645",6383,1975,3211,3195,3187,8,16,8,8,145,145,0,657,656,1,395,395,0
"2021","Wiltshire 003","E02006646",6543,1769,3661,3653,3629,24,8,4,4,134,132,2,552,552,0,427,427,0
"2021","Wiltshire 004","E02006647",5126,1155,3229,3224,3216,8,5,3,2,70,70,0,385,382,3,287,287,0
"2021","Wiltshire 005","E02006648",5144,1178,3068,3053,3048,5,15,0,15,103,102,1,423,421,2,372,372,0
"2021","Wiltshire 006","E02006649",6329,1968,2996,2991,2981,10,5,2,3,194,194,0,711,711,0,460,460,0
"2021","Wiltshire 007","E02006650",11809,4284,5809,5777,5753,24,32,16,16,250,250,0,877,872,5,589,588,1
"2021","Wiltshire 008","E02006651",6073,1504,3565,3545,3541,4,20,4,16,108,108,0,517,515,2,379,379,0
"2021","Wiltshire 009","E02006652",7936,2715,3932,3912,3892,20,20,4,16,173,173,0,728,728,0,388,388,0
"2021","Wiltshire 010","E02006653",8087,2612,4106,4094,4070,24,12,2,10,148,148,0,797,795,2,424,421,3
"2021","Wiltshire 011","E02006654",8064,2839,3423,3404,3386,18,19,4,15,222,222,0,933,932,1,647,646,1
"2021","Wiltshire 013","E02006655",6888,1770,3911,3881,3867,14,30,4,26,116,116,0,621,619,2,470,470,0
"2021","Wiltshire 014","E02006656",5579,1798,2866,2862,2846,16,4,2,2,113,110,3,603,602,1,199,199,0
"2021","Wiltshire 015","E02006657",8726,3044,4039,4025,3993,32,14,4,10,196,196,0,989,986,3,458,457,1
"2021","Wiltshire 016","E02006658",6647,1951,3388,3368,3346,22,20,6,14,121,120,1,768,767,1,419,419,0
"2021","Wiltshire 017","E02006659",6663,1875,3702,3686,3673,13,16,6,10,118,118,0,581,580,1,387,387,0
"2021","Wiltshire 018","E02006660",11055,3273,5633,5611,5578,33,22,3,19,237,237,0,1150,1147,3,762,760,2
"2021","Wiltshire 045","E02006661",7582,2500,4213,4200,4167,33,13,6,7,224,222,2,440,440,0,205,204,1
"2021","Wiltshire 046","E02006662",5723,1466,3231,3226,3208,18,5,2,3,173,170,3,564,564,0,289,289,0
"2021","Wiltshire 048","E02006663",10442,3353,5071,5059,5040,19,12,6,6,301,301,0,1069,1065,4,648,648,0
"2021","Wiltshire 049","E02006664",5372,1247,3212,3201,3193,8,11,4,7,88,88,0,470,468,2,355,355,0
"2021","Wiltshire 050","E02006665",5813,1449,3144,3137,3119,18,7,0,7,116,116,0,598,597,1,506,506,0
"2021","Wiltshire 051","E02006666",5422,1678,2699,2691,2683,8,8,0,8,119,119,0,576,572,4,350,350,0
"2021","Wiltshire 052","E02006667",5757,2317,2378,2375,2365,10,3,0,3,199,199,0,631,630,1,232,232,0
"2021","Wiltshire 053","E02006668",4976,1383,2634,2628,2615,13,6,0,6,105,105,0,460,458,2,394,393,1
"2021","Wiltshire 054","E02006669",8797,2351,4710,4679,4656,23,31,10,21,201,198,3,880,877,3,655,651,4
"2021","Wiltshire 055","E02006670",5839,2245,2353,2340,2319,21,13,4,9,136,133,3,729,729,0,376,375,1
"2021","Wiltshire 056","E02006671",5308,2003,2046,2030,2014,16,16,8,8,142,140,2,707,704,3,410,410,0
"2021","Wiltshire 057","E02006672",7505,2270,3961,3945,3925,20,16,2,14,181,180,1,622,622,0,471,470,1
"2021","Wiltshire 058","E02006673",4402,1416,1931,1916,1908,8,15,8,7,95,95,0,506,506,0,454,452,2
"2021","Wiltshire 059","E02006674",4907,1634,2361,2350,2342,8,11,4,7,112,110,2,501,500,1,299,298,1
"2021","Wiltshire 060","E02006675",6805,1616,4134,4127,4110,17,7,4,3,87,87,0,534,533,1,434,434,0
"2021","Wiltshire 061","E02006676",5223,1216,2924,2900,2888,12,24,2,22,144,143,1,534,534,0,405,405,0
"2021","Wiltshire 062","E02006677",6682,1604,3866,3846,3836,10,20,12,8,103,103,0,588,587,1,521,519,2
"2021","Wiltshire 020","E02006678",6331,2131,2978,2970,2957,13,8,4,4,135,135,0,700,700,0,387,386,1
"2021","Wiltshire 021","E02006679",10045,2825,5532,5512,5495,17,20,6,14,191,190,1,932,930,2,565,565,0
"2021","Wiltshire 022","E02006680",6379,2011,2881,2872,2859,13,9,0,9,136,136,0,742,741,1,609,608,1
"2021","Wiltshire 023","E02006681",4956,1130,2940,2926,2905,21,14,6,8,65,64,1,443,443,0,378,377,1
"2021","Wiltshire 027","E02006682",8678,2394,4467,4446,4418,28,21,6,15,177,176,1,918,915,3,722,720,2
"2021","Wiltshire 030","E02006683",6562,1975,3431,3417,3399,18,14,6,8,118,118,0,656,655,1,382,380,2
"2021","Wiltshire 031","E02006684",5739,2389,2179,2170,2141,29,9,8,1,168,165,3,646,646,0,357,357,0
"2021","Wiltshire 032","E02006685",8029,2504,4019,4013,4001,12,6,4,2,173,172,1,826,826,0,507,507,0
"2021","Wiltshire 033","E02006686",4496,1518,2139,2131,2119,12,8,4,4,106,106,0,403,403,0,330,330,0
"2021","Wiltshire 035","E02006687",6538,2384,2924,2915,2900,15,9,6,3,158,156,2,773,771,2,299,299,0
"2021","Wiltshire 036","E02006688",4691,1698,2021,2017,2008,9,4,1,3,126,124,2,548,546,2,298,298,0
"2021","Wiltshire 037","E02006689",5749,1516,3228,3216,3213,3,12,4,8,97,96,1,524,524,0,384,382,2
"2021","Wiltshire 039","E02006690",5924,1614,3226,3213,3207,6,13,3,10,118,118,0,571,571,0,395,395,0
"2021","Wiltshire 042","E02006692",4520,1382,2292,2276,2274,2,16,2,14,110,110,0,431,430,1,305,305,0
"2021","Wiltshire 043","E02006693",5410,1710,2589,2581,2574,7,8,2,6,126,125,1,613,612,1,372,372,0
"2021","Wiltshire 044","E02006694",5277,1617,2364,2354,2343,11,10,6,4,155,152,3,659,657,2,482,482,0
"2021","Wiltshire 047","E02006695",5489,1239,3189,3179,3163,16,10,4,6,99,99,0,514,511,3,448,446,2
"2021","Wiltshire 063","E02007023",6192,2139,2919,2908,2894,14,11,6,5,163,161,2,647,646,1,324,323,1
"2021","Wiltshire 064","E02007024",5785,2094,2485,2483,2452,31,2,2,0,143,143,0,666,666,0,397,396,1
"2021","Wiltshire 065","E02007025",6533,2298,3174,3168,3139,29,6,2,4,205,204,1,601,598,3,255,255,0
"2021","Wiltshire 066","E02007026",6441,2367,3354,3344,3326,18,10,0,10,201,200,1,428,427,1,91,91,0
"2021","Bournemouth, Christchurch and Poole 003","E02003172",5325,1852,2324,2316,2296,20,8,2,6,133,133,0,592,592,0,424,422,2
"2021","Bournemouth, Christchurch and Poole 005","E02003173",5772,1860,2583,2572,2551,21,11,6,5,104,104,0,725,723,2,500,499,1
"2021","Bournemouth, Christchurch and Poole 006","E02003174",6920,2038,3542,3528,3503,25,14,4,10,116,116,0,703,702,1,521,521,0
"2021","Bournemouth, Christchurch and Poole 007","E02003175",7336,2396,3523,3517,3505,12,6,0,6,155,153,2,829,827,2,433,431,2
"2021","Bournemouth, Christchurch and Poole 010","E02003176",5869,2543,2097,2090,2078,12,7,4,3,146,146,0,744,742,2,339,337,2
"2021","Bournemouth, Christchurch and Poole 009","E02003177",6634,2118,3470,3460,3429,31,10,2,8,116,115,1,603,603,0,327,327,0
"2021","Bournemouth, Christchurch and Poole 011","E02003178",7107,2803,2937,2921,2882,39,16,8,8,146,146,0,800,794,6,421,420,1
"2021","Bournemouth, Christchurch and Poole 012","E02003179",5241,1773,2306,2293,2275,18,13,7,6,123,120,3,636,635,1,403,403,0
"2021","Bournemouth, Christchurch and Poole 015","E02003180",8500,4975,2415,2404,2379,25,11,2,9,175,173,2,683,682,1,252,251,1
"2021","Bournemouth, Christchurch and Poole 017","E02003181",7172,2788,3225,3188,3148,40,37,8,29,143,143,0,663,660,3,353,353,0
"2021","Bournemouth, Christchurch and Poole 020","E02003182",5335,1535,2900,2888,2860,28,12,2,10,73,73,0,501,501,0,326,325,1
"2021","Bournemouth, Christchurch and Poole 028","E02003183",6358,2843,2637,2609,2588,21,28,10,18,84,83,1,457,456,1,337,333,4
"2021","Bournemouth, Christchurch and Poole 027","E02003184",6797,3667,2084,2068,2039,29,16,2,14,151,145,6,669,668,1,226,226,0
"2021","Bournemouth, Christchurch and Poole 026","E02003185",6116,2103,2894,2877,2851,26,17,2,15,125,125,0,678,673,5,316,316,0
"2021","Bournemouth, Christchurch and Poole 025","E02003186",7586,3847,2538,2517,2479,38,21,2,19,198,198,0,797,794,3,206,205,1
"2021","Bournemouth, Christchurch and Poole 035","E02003187",7762,3515,2792,2774,2756,18,18,10,8,186,185,1,890,885,5,379,379,0
"2021","Bournemouth, Christchurch and Poole 038","E02003188",12145,7622,2664,2620,2562,58,44,10,34,276,264,12,1125,1115,10,458,457,1
"2021","Bournemouth, Christchurch and Poole 036","E02003189",7338,2669,2932,2899,2854,45,33,4,29,194,192,2,956,952,4,587,585,2
"2021","Bournemouth, Christchurch and Poole 037","E02003190",8904,4673,2293,2271,2230,41,22,8,14,284,279,5,1308,1302,6,346,344,2
"2021","Bournemouth, Christchurch and Poole 039","E02003191",7196,1938,3682,3643,3622,21,39,3,36,135,134,1,779,772,7,662,661,1
"2021","Bournemouth, Christchurch and Poole 041","E02003192",11933,7399,2819,2788,2755,33,31,4,27,260,257,3,1017,1011,6,438,433,5
"2021","Bournemouth, Christchurch and Poole 001","E02003194",5284,1303,3122,3118,3106,12,4,4,0,56,56,0,384,383,1,419,419,0
"2021","Bournemouth, Christchurch and Poole 008","E02003195",4794,1651,2393,2388,2372,16,5,2,3,88,86,2,413,411,2,249,249,0
"2021","Bournemouth, Christchurch and Poole 004","E02003196",8830,1903,5420,5410,5382,28,10,0,10,114,113,1,620,619,1,773,772,1
"2021","Bournemouth, Christchurch and Poole 013","E02003197",5549,1704,2781,2779,2772,7,2,0,2,101,99,2,657,656,1,306,305,1
"2021","Bournemouth, Christchurch and Poole 016","E02003198",6059,2096,2843,2837,2821,16,6,2,4,126,125,1,655,655,0,339,339,0
"2021","Bournemouth, Christchurch and Poole 021","E02003199",7835,2517,3730,3711,3682,29,19,6,13,138,135,3,879,879,0,571,568,3
"2021","Bournemouth, Christchurch and Poole 022","E02003200",8382,3146,3497,3479,3450,29,18,4,14,207,204,3,967,962,5,565,564,1
"2021","Bournemouth, Christchurch and Poole 023","E02003201",9042,3493,3840,3814,3762,52,26,2,24,207,206,1,998,994,4,504,503,1
"2021","Bournemouth, Christchurch and Poole 029","E02003202",5165,1962,2275,2234,2208,26,41,10,31,88,87,1,557,557,0,283,283,0
"2021","Bournemouth, Christchurch and Poole 032","E02003203",6207,2295,2747,2731,2684,47,16,4,12,123,123,0,729,725,4,313,313,0
"2021","Bournemouth, Christchurch and Poole 030","E02003204",7713,2668,3405,3380,3362,18,25,8,17,178,174,4,896,894,2,566,565,1
"2021","Bournemouth, Christchurch and Poole 034","E02003205",6948,2062,3648,3643,3635,8,5,4,1,114,114,0,643,643,0,481,479,2
"2021","Bournemouth, Christchurch and Poole 043","E02003206",8216,2747,3988,3954,3919,35,34,2,32,160,159,1,916,912,4,405,405,0
"2021","Bournemouth, Christchurch and Poole 042","E02003207",5867,2163,2595,2578,2565,13,17,8,9,154,154,0,649,649,0,306,306,0
"2021","Bournemouth, Christchurch and Poole 044","E02003208",9650,3889,3457,3430,3403,27,27,8,19,240,237,3,1270,1265,5,794,794,0
"2021","Bournemouth, Christchurch and Poole 046","E02003209",5623,1886,2489,2481,2465,16,8,0,8,119,119,0,710,710,0,419,419,0
"2021","Bournemouth, Christchurch and Poole 047","E02003210",8192,2383,4020,3992,3970,22,28,14,14,168,167,1,911,909,2,710,708,2
"2021","Bournemouth, Christchurch and Poole 048","E02003211",7723,1763,4130,4071,4024,47,59,4,55,133,132,1,765,763,2,932,925,7
"2021","Bournemouth, Christchurch and Poole 002","E02004236",5340,1344,2883,2869,2857,12,14,2,12,102,101,1,555,555,0,456,456,0
"2021","Bournemouth, Christchurch and Poole 014","E02004237",6666,1920,3438,3432,3414,18,6,2,4,127,127,0,602,602,0,579,574,5
"2021","Bournemouth, Christchurch and Poole 019","E02004238",6688,1389,3711,3696,3675,21,15,2,13,102,101,1,636,633,3,850,850,0
"2021","Bournemouth, Christchurch and Poole 018","E02004239",5364,1267,3010,3002,2989,13,8,0,8,75,75,0,517,515,2,495,495,0
"2021","Bournemouth, Christchurch and Poole 024","E02004240",4912,1904,1894,1882,1874,8,12,2,10,142,141,1,659,658,1,313,313,0
"2021","Bournemouth, Christchurch and Poole 031","E02004241",7824,2491,3367,3350,3331,19,17,2,15,176,175,1,1089,1087,2,701,699,2
"2021","Bournemouth, Christchurch and Poole 033","E02004242",5717,1163,3321,3302,3295,7,19,4,15,100,100,0,574,573,1,559,559,0
"2021","Bournemouth, Christchurch and Poole 040","E02006883",5170,2374,1563,1536,1490,46,27,0,27,125,122,3,672,669,3,436,428,8
"2021","Bournemouth, Christchurch and Poole 045","E02006885",6796,3008,2348,2307,2244,63,41,8,33,173,169,4,791,781,10,476,471,5
"2021","Dorset 007","E02004243",5409,1323,3123,3115,3109,6,8,6,2,108,108,0,534,533,1,321,320,1
"2021","Dorset 010","E02004244",6438,1630,3677,3660,3646,14,17,12,5,106,106,0,559,555,4,466,466,0
"2021","Dorset 012","E02004245",6230,1581,3474,3463,3452,11,11,0,11,111,111,0,614,614,0,450,450,0
"2021","Dorset 015","E02004246",6944,1359,4316,4297,4280,17,19,6,13,101,100,1,558,558,0,610,607,3
"2021","Dorset 013","E02004247",5130,1207,3072,3067,3061,6,5,1,4,98,96,2,428,427,1,325,324,1
"2021","Dorset 016","E02004248",6634,1346,3738,3724,3705,19,14,4,10,88,88,0,675,671,4,787,786,1
"2021","Dorset 017","E02004249",4991,1190,3000,2996,2990,6,4,0,4,64,64,0,434,433,1,303,302,1
"2021","Dorset 018","E02004250",6715,1631,3483,3459,3436,23,24,12,12,126,125,1,727,727,0,748,746,2
"2021","Dorset 020","E02004251",5358,1263,2988,2978,2970,8,10,0,10,83,83,0,538,537,1,486,485,1
"2021","Dorset 021","E02004252",6665,2088,2858,2852,2831,21,6,4,2,226,225,1,888,886,2,605,605,0
"2021","Dorset 024","E02004253",8544,1814,5024,5014,4994,20,10,3,7,87,87,0,723,721,2,896,895,1
"2021","Dorset 025","E02004254",8596,2270,4731,4719,4707,12,12,4,8,146,143,3,823,823,0,626,626,0
"2021","Dorset 001","E02004255",6200,1719,2984,2974,2953,21,10,2,8,175,173,2,731,729,2,591,590,1
"2021","Dorset 002","E02004256",7680,1898,4329,4319,4304,15,10,4,6,168,167,1,766,766,0,519,519,0
"2021","Dorset 003","E02004257",7493,2542,3311,3290,3270,20,21,5,16,188,187,1,907,901,6,545,545,0
"2021","Dorset 005","E02004258",8952,2192,4841,4822,4809,13,19,12,7,164,163,1,927,926,1,828,826,2
"2021","Dorset 006","E02004259",6098,1646,3353,3342,3324,18,11,1,10,135,135,0,522,522,0,442,442,0
"2021","Dorset 009","E02004260",7364,2389,3868,3850,3833,17,18,6,12,122,121,1,626,625,1,359,359,0
"2021","Dorset 011","E02004261",8490,2644,3950,3930,3910,20,20,6,14,211,211,0,988,986,2,697,695,2
"2021","Dorset 014","E02004262",6811,1696,3912,3885,3869,16,27,7,20,163,162,1,644,644,0,396,395,1
"2021","Dorset 027","E02004263",4856,1201,2680,2673,2657,16,7,4,3,100,100,0,518,517,1,357,357,0
"2021","Dorset 028","E02004264",7154,2099,3660,3651,3638,13,9,5,4,136,135,1,742,740,2,517,516,1
"2021","Dorset 033","E02004265",7220,1993,3637,3627,3612,15,10,8,2,150,150,0,773,773,0,667,666,1
"2021","Dorset 035","E02004266",6822,2015,3571,3560,3540,20,11,0,11,156,154,2,670,670,0,410,410,0
"2021","Dorset 039","E02004267",4481,1083,2575,2553,2537,16,22,5,17,84,82,2,378,378,0,361,360,1
"2021","Dorset 042","E02004268",8249,2197,4174,4143,4129,14,31,10,21,171,169,2,942,941,1,765,763,2
"2021","Dorset 004","E02004269",8537,2705,3719,3698,3671,27,21,1,20,203,203,0,1028,1027,1,882,880,2
"2021","Dorset 008","E02004270",6678,1492,4019,4003,3985,18,16,4,12,102,102,0,569,568,1,496,496,0
"2021","Dorset 019","E02004271",8668,2080,4853,4816,4789,27,37,6,31,187,184,3,880,878,2,668,668,0
"2021","Dorset 022","E02004272",10325,2520,5760,5724,5698,26,36,6,30,195,184,11,1042,1039,3,808,807,1
"2021","Dorset 023","E02004273",6341,1430,3477,3443,3424,19,34,12,22,150,148,2,671,670,1,613,612,1
"2021","Dorset 026","E02004274",5497,1612,2560,2547,2537,10,13,6,7,121,120,1,695,694,1,509,509,0
"2021","Dorset 029","E02004275",6645,1616,3758,3726,3707,19,32,8,24,131,131,0,623,619,4,517,515,2
"2021","Dorset 030","E02004276",4903,1367,2324,2311,2296,15,13,6,7,106,104,2,634,631,3,472,470,2
"2021","Dorset 034","E02004278",7329,2037,3748,3740,3718,22,8,2,6,173,172,1,790,790,0,581,581,0
"2021","Dorset 036","E02004279",6819,1622,3882,3867,3856,11,15,6,9,126,126,0,663,663,0,526,524,2
"2021","Dorset 037","E02004280",7120,1915,3711,3679,3670,9,32,18,14,139,138,1,765,764,1,590,589,1
"2021","Dorset 038","E02004281",6259,2278,2555,2534,2519,15,21,6,15,157,156,1,887,887,0,382,382,0
"2021","Dorset 040","E02004282",7863,1680,4501,4485,4471,14,16,2,14,127,123,4,753,749,4,802,801,1
"2021","Dorset 041","E02004283",7540,2227,3711,3700,3681,19,11,8,3,138,137,1,823,821,2,641,640,1
"2021","Dorset 044","E02004284",8332,3165,2824,2812,2801,11,12,6,6,295,295,0,1346,1341,5,702,701,1
"2021","Dorset 043","E02004285",6540,2276,2676,2658,2650,8,18,4,14,149,148,1,888,883,5,551,550,1
"2021","Dorset 045","E02004286",4243,1314,2062,2057,2047,10,5,0,5,93,93,0,470,469,1,304,304,0
"2021","Dorset 046","E02004287",4664,1409,2150,2139,2125,14,11,9,2,99,99,0,658,658,0,348,348,0
"2021","Dorset 047","E02004288",5261,2114,1847,1837,1821,16,10,2,8,193,193,0,821,820,1,286,284,2
"2021","Dorset 048","E02004289",6121,1791,3027,3020,3001,19,7,0,7,122,120,2,738,738,0,443,443,0
"2021","Dorset 031","E02007006",5052,1654,1991,1975,1957,18,16,6,10,134,133,1,644,643,1,629,629,0
"2021","Dorset 032","E02007007",5603,1740,2700,2686,2672,14,14,2,12,141,141,0,575,574,1,447,444,3
"2021","East Devon 001","E02004129",5156,1291,2921,2895,2883,12,26,7,19,100,100,0,510,510,0,334,334,0
"2021","East Devon 002","E02004130",5242,1649,2234,2227,2208,19,7,4,3,141,141,0,688,688,0,530,530,0
"2021","East Devon 003","E02004131",4651,1316,2425,2412,2404,8,13,0,13,92,92,0,467,467,0,351,351,0
"2021","East Devon 004","E02004132",7411,1857,4284,4273,4253,20,11,6,5,141,138,3,664,663,1,465,465,0
"2021","East Devon 005","E02004133",8248,2383,4092,4077,4065,12,15,3,12,206,202,4,917,917,0,650,650,0
"2021","East Devon 007","E02004135",7290,1670,4212,4186,4174,12,26,16,10,110,109,1,645,645,0,653,649,4
"2021","East Devon 008","E02004136",7770,1992,4286,4276,4259,17,10,6,4,147,144,3,732,729,3,613,612,1
"2021","East Devon 009","E02004137",4685,1052,2698,2673,2667,6,25,10,15,79,77,2,438,437,1,418,417,1
"2021","East Devon 010","E02004138",6906,1576,3520,3498,3476,22,22,6,16,147,147,0,836,835,1,827,826,1
"2021","East Devon 011","E02004139",5979,1565,3110,3095,3085,10,15,2,13,110,109,1,635,633,2,559,559,0
"2021","East Devon 012","E02004140",4815,934,2565,2547,2530,17,18,4,14,92,92,0,492,492,0,732,731,1
"2021","East Devon 013","E02004141",5309,1463,2840,2823,2811,12,17,8,9,90,90,0,503,502,1,413,412,1
"2021","East Devon 014","E02004142",5452,1767,2858,2842,2824,18,16,6,10,96,96,0,460,457,3,271,270,1
"2021","East Devon 015","E02004143",5347,1304,3083,3079,3076,3,4,4,0,77,77,0,466,463,3,417,417,0
"2021","East Devon 016","E02004144",5815,1496,3097,3087,3075,12,10,0,10,115,113,2,633,633,0,474,474,0
"2021","East Devon 017","E02004145",5418,1146,3056,3042,3037,5,14,4,10,79,79,0,546,546,0,591,590,1
"2021","East Devon 018","E02004146",6135,1942,2974,2967,2954,13,7,4,3,145,145,0,702,702,0,372,372,0
"2021","East Devon 019","E02004147",5939,2371,2117,2106,2098,8,11,4,7,191,187,4,945,944,1,315,314,1
"2021","East Devon 020","E02004148",6820,1690,3326,3312,3285,27,14,5,9,142,141,1,769,769,0,893,890,3
"2021","East Devon 021","E02007027",8723,2905,4420,4395,4380,15,25,8,17,172,172,0,779,774,5,447,447,0
"2021","East Devon 022","E02007028",4272,1866,1853,1847,1821,26,6,4,2,116,116,0,391,391,0,46,46,0
"2021","Exeter 001","E02004149",10179,6642,2715,2695,2693,2,20,14,6,71,68,3,433,432,1,318,317,1
"2021","Exeter 002","E02004150",5887,3005,1960,1953,1940,13,7,4,3,137,137,0,555,553,2,230,230,0
"2021","Exeter 003","E02004151",8057,2775,3925,3910,3884,26,15,4,11,156,156,0,685,683,2,516,515,1
"2021","Exeter 004","E02004152",9200,7278,1221,1204,1190,14,17,10,7,92,92,0,439,437,2,170,169,1
"2021","Exeter 005","E02004153",6038,2503,2455,2440,2432,8,15,6,9,161,159,2,651,651,0,268,268,0
"2021","Exeter 006","E02004154",7164,4088,2140,2128,2108,20,12,10,2,107,103,4,532,531,1,297,296,1
"2021","Exeter 007","E02004155",6042,2142,2682,2669,2658,11,13,9,4,139,138,1,675,672,3,404,403,1
"2021","Exeter 008","E02004156",10862,7908,1628,1616,1586,30,12,10,2,175,172,3,823,820,3,328,327,1
"2021","Exeter 009","E02004157",5371,2235,2152,2135,2110,25,17,2,15,112,112,0,548,543,5,324,323,1
"2021","Exeter 010","E02004158",6700,2939,2468,2458,2433,25,10,0,10,175,174,1,784,777,7,334,334,0
"2021","Exeter 011","E02004159",10274,3641,5072,5056,5032,24,16,4,12,218,216,2,911,908,3,432,431,1
"2021","Exeter 012","E02004160",5996,1859,2951,2929,2912,17,22,4,18,96,94,2,617,613,4,473,473,0
"2021","Exeter 013","E02004161",6740,2713,2745,2733,2717,16,12,4,8,157,155,2,684,684,0,441,441,0
"2021","Exeter 014","E02004162",5947,2370,2361,2351,2329,22,10,2,8,141,140,1,646,644,2,429,428,1
"2021","Exeter 015","E02004163",6875,2123,3305,3288,3262,26,17,2,15,114,114,0,789,789,0,544,544,0
"2021","Mid Devon 001","E02004164",5750,1379,3330,3305,3294,11,25,2,23,104,104,0,488,487,1,449,449,0
"2021","Mid Devon 002","E02004165",7478,2084,4032,4023,4001,22,9,0,9,153,152,1,657,654,3,552,551,1
"2021","Mid Devon 003","E02004166",5537,1516,2975,2969,2950,19,6,4,2,131,129,2,543,539,4,372,372,0
"2021","Mid Devon 004","E02004167",5658,2189,2254,2240,2227,13,14,4,10,161,160,1,672,670,2,382,382,0
"2021","Mid Devon 005","E02004168",5112,1860,2108,2098,2075,23,10,4,6,148,147,1,619,617,2,377,376,1
"2021","Mid Devon 006","E02004169",6218,1704,3349,3338,3330,8,11,2,9,129,129,0,613,612,1,423,423,0
"2021","Mid Devon 007","E02004170",7159,2308,3371,3363,3342,21,8,2,6,202,199,3,799,799,0,479,478,1
"2021","Mid Devon 008","E02004171",6986,2018,3732,3704,3690,14,28,9,19,131,131,0,675,674,1,430,430,0
"2021","Mid Devon 009","E02004172",5461,1466,3084,3071,3055,16,13,2,11,117,117,0,461,461,0,333,333,0
"2021","Mid Devon 010","E02004173",6244,1683,3447,3432,3408,24,15,4,11,124,122,2,561,560,1,429,427,2
"2021","Mid Devon 011","E02004174",6593,2273,2920,2906,2877,29,14,8,6,177,177,0,732,729,3,491,491,0
"2021","North Devon 001","E02004175",4364,1641,1620,1606,1596,10,14,4,10,121,120,1,648,645,3,334,331,3
"2021","North Devon 002","E02004176",4832,1210,2617,2599,2572,27,18,4,14,94,94,0,526,526,0,385,384,1
"2021","North Devon 003","E02004177",4905,1706,2110,2095,2086,9,15,6,9,119,119,0,601,597,4,369,367,2
"2021","North Devon 004","E02004178",4416,1101,2560,2557,2538,19,3,0,3,71,70,1,372,371,1,312,311,1
"2021","North Devon 005","E02004179",7554,2274,3774,3764,3750,14,10,6,4,164,163,1,764,761,3,578,577,1
"2021","North Devon 006","E02004180",5431,1404,3093,3079,3076,3,14,8,6,86,86,0,463,463,0,385,383,2
"2021","North Devon 007","E02004181",4727,1526,2137,2134,2128,6,3,1,2,109,108,1,566,565,1,389,388,1
"2021","North Devon 008","E02004182",5172,2099,1837,1832,1822,10,5,2,3,172,172,0,705,704,1,359,359,0
"2021","North Devon 009","E02004183",5016,1513,2447,2436,2425,11,11,2,9,102,102,0,510,510,0,444,444,0
"2021","North Devon 010","E02004184",6831,2558,2961,2954,2938,16,7,4,3,178,178,0,740,738,2,394,394,0
"2021","North Devon 011","E02004185",5700,1305,3274,3260,3247,13,14,4,10,126,124,2,486,485,1,509,509,0
"2021","North Devon 012","E02004186",8287,2527,4154,4141,4116,25,13,4,9,184,184,0,832,831,1,590,590,0
"2021","North Devon 013","E02004187",8913,2622,4504,4495,4471,24,9,1,8,214,213,1,902,902,0,671,668,3
"2021","North Devon 014","E02004188",6040,1572,3273,3262,3243,19,11,0,11,115,114,1,596,595,1,484,484,0
"2021","South Hams 001","E02004189",5133,1512,2686,2680,2650,30,6,2,4,118,118,0,505,504,1,312,312,0
"2021","South Hams 002","E02004190",7356,2014,3963,3934,3900,34,29,6,23,136,133,3,760,755,5,483,482,1
"2021","South Hams 003","E02004191",7656,2790,3085,3052,3022,30,33,12,21,168,166,2,1066,1061,5,547,545,2
"2021","South Hams 004","E02004192",6646,1539,3865,3831,3813,18,34,4,30,93,93,0,654,652,2,495,495,0
"2021","South Hams 005","E02004193",9755,2779,5130,5123,5108,15,7,4,3,182,182,0,1009,1008,1,655,654,1
"2021","South Hams 006","E02004194",6081,1791,3147,3121,3108,13,26,12,14,119,119,0,629,625,4,395,395,0
"2021","South Hams 007","E02004195",4625,1420,2138,2128,2112,16,10,2,8,122,122,0,564,561,3,381,381,0
"2021","South Hams 008","E02004196",6731,1575,3898,3881,3856,25,17,6,11,115,115,0,659,650,9,484,481,3
"2021","South Hams 009","E02004197",6140,1415,3598,3586,3575,11,12,6,6,101,99,2,594,594,0,432,431,1
"2021","South Hams 010","E02004198",5339,1571,2453,2437,2427,10,16,6,10,129,126,3,685,684,1,501,501,0
"2021","South Hams 011","E02004199",5034,1103,2909,2883,2880,3,26,10,16,90,88,2,503,501,2,429,427,2
"2021","South Hams 012","E02004200",4480,1103,2404,2390,2386,4,14,10,4,99,99,0,515,515,0,359,358,1
"2021","Teignbridge 001","E02004201",4726,1133,2675,2666,2662,4,9,0,9,83,83,0,457,456,1,378,378,0
"2021","Teignbridge 002","E02004202",7164,2078,3632,3610,3574,36,22,12,10,154,151,3,784,779,5,516,516,0
"2021","Teignbridge 003","E02004203",4986,1245,2749,2728,2718,10,21,6,15,78,77,1,516,515,1,398,398,0
"2021","Teignbridge 004","E02004204",8176,2155,4260,4249,4234,15,11,4,7,207,207,0,943,939,4,611,609,2
"2021","Teignbridge 005","E02004205",7217,2169,3611,3585,3566,19,26,8,18,157,152,5,791,789,2,489,489,0
"2021","Teignbridge 006","E02004206",5933,1613,2762,2746,2724,22,16,2,14,170,169,1,755,752,3,633,632,1
"2021","Teignbridge 007","E02004207",5613,1575,2891,2874,2860,14,17,6,11,120,120,0,642,641,1,385,383,2
"2021","Teignbridge 008","E02004208",7107,1818,3861,3842,3823,19,19,6,13,135,135,0,723,723,0,570,569,1
"2021","Teignbridge 009","E02004209",7598,2335,3622,3611,3599,12,11,2,9,157,157,0,944,940,4,540,540,0
"2021","Teignbridge 010","E02004210",5586,1978,2040,2019,1991,28,21,2,19,192,192,0,853,850,3,523,522,1
"2021","Teignbridge 011","E02004211",5768,1282,3277,3263,3251,12,14,6,8,91,90,1,614,614,0,504,504,0
"2021","Teignbridge 012","E02004212",5094,1656,2415,2406,2397,9,9,2,7,106,106,0,567,566,1,350,350,0
"2021","Teignbridge 013","E02004213",7379,2678,3381,3360,3347,13,21,4,17,161,159,2,804,800,4,355,355,0
"2021","Teignbridge 014","E02004214",5044,2068,1673,1665,1649,16,8,4,4,178,177,1,772,770,2,353,352,1
"2021","Teignbridge 015","E02004215",4915,1657,2100,2092,2082,10,8,0,8,125,125,0,631,630,1,402,401,1
"2021","Teignbridge 016","E02004216",4698,1340,2421,2416,2406,10,5,0,5,76,76,0,486,484,2,375,375,0
"2021","Teignbridge 017","E02004217",6468,2133,2898,2883,2871,12,15,6,9,163,162,1,791,788,3,483,482,1
"2021","Teignbridge 018","E02004218",5192,1370,2756,2743,2731,12,13,6,7,87,87,0,603,603,0,376,376,0
"2021","Teignbridge 019","E02004219",4803,1130,2709,2685,2667,18,24,4,20,79,79,0,473,470,3,412,412,0
"2021","Torridge 001","E02004220",5238,1365,2552,2541,2534,7,11,2,9,103,103,0,701,698,3,517,516,1
"2021","Torridge 002","E02004221",5640,1312,3048,3027,3011,16,21,4,17,116,109,7,588,587,1,576,576,0
"2021","Torridge 003","E02004222",4849,1687,1987,1981,1967,14,6,2,4,143,142,1,689,687,2,343,343,0
"2021","Torridge 004","E02004223",10378,3590,4528,4507,4476,31,21,6,15,301,298,3,1313,1309,4,646,645,1
"2021","Torridge 005","E02004224",5564,1387,3131,3115,3100,15,16,6,10,100,100,0,514,513,1,432,432,0
"2021","Torridge 006","E02004225",4770,1531,2164,2154,2142,12,10,2,8,120,120,0,541,540,1,414,414,0
"2021","Torridge 007","E02004226",6324,1492,3615,3601,3581,20,14,10,4,130,128,2,600,599,1,487,487,0
"2021","Torridge 008","E02004227",8514,2398,4493,4474,4449,25,19,4,15,177,174,3,782,782,0,664,664,0
"2021","Torridge 009","E02004228",6280,1554,3574,3551,3527,24,23,10,13,125,124,1,563,561,2,464,463,1
"2021","West Devon 001","E02004229",8273,2394,4434,4411,4389,22,23,13,10,188,188,0,735,735,0,522,522,0
"2021","West Devon 002","E02004230",6390,2038,2895,2882,2874,8,13,4,9,189,189,0,759,759,0,509,509,0
"2021","West Devon 003","E02004231",6133,1804,3084,3066,3047,19,18,4,14,148,147,1,702,702,0,395,395,0
"2021","West Devon 004","E02004232",5938,1456,3447,3433,3415,18,14,6,8,86,85,1,538,538,0,411,411,0
"2021","West Devon 005","E02004233",10663,2957,5364,5347,5335,12,17,4,13,222,222,0,1216,1213,3,904,900,4
"2021","West Devon 006","E02004234",5391,1275,3058,3037,3021,16,21,16,5,87,87,0,537,536,1,434,434,0
"2021","West Devon 007","E02004235",5577,1287,3088,3072,3058,14,16,4,12,114,114,0,583,579,4,505,504,1
"2021","Cheltenham 001","E02004600",4584,1634,2127,2119,2108,11,8,2,6,86,84,2,456,455,1,281,281,0
"2021","Cheltenham 002","E02004601",5221,1511,2804,2788,2776,12,16,4,12,62,62,0,409,409,0,435,435,0
"2021","Cheltenham 003","E02004602",5353,2239,2083,2075,2058,17,8,0,8,104,101,3,607,605,2,320,319,1
"2021","Cheltenham 004","E02004603",7055,4361,1767,1752,1742,10,15,6,9,113,112,1,558,557,1,256,256,0
"2021","Cheltenham 005","E02004604",6351,2950,2209,2198,2187,11,11,8,3,179,177,2,694,692,2,319,318,1
"2021","Cheltenham 006","E02004605",4591,1884,1832,1823,1807,16,9,7,2,97,97,0,506,504,2,272,272,0
"2021","Cheltenham 007","E02004606",8822,4213,3177,3148,3116,32,29,6,23,180,178,2,796,792,4,456,456,0
"2021","Cheltenham 008","E02004607",8437,4020,2998,2984,2959,25,14,4,10,175,172,3,825,825,0,419,416,3
"2021","Cheltenham 009","E02004608",8606,4364,2600,2574,2552,22,26,6,20,182,182,0,910,906,4,550,548,2
"2021","Cheltenham 010","E02004609",5951,1837,2988,2984,2971,13,4,0,4,116,116,0,574,573,1,436,436,0
"2021","Cheltenham 011","E02004610",6507,2329,2857,2849,2837,12,8,4,4,122,120,2,689,687,2,510,507,3
"2021","Cheltenham 012","E02004611",9503,2869,5126,5105,5091,14,21,12,9,154,154,0,811,810,1,543,543,0
"2021","Cheltenham 013","E02004612",7688,2331,3926,3916,3898,18,10,4,6,127,126,1,761,761,0,543,543,0
"2021","Cheltenham 014","E02004613",5289,1313,3054,3044,3042,2,10,2,8,68,68,0,455,455,0,399,399,0
"2021","Cheltenham 015","E02004614",4478,1033,2617,2605,2597,8,12,2,10,62,62,0,377,377,0,389,386,3
"2021","Cotswold 001","E02004615",7438,1725,4253,4236,4202,34,17,4,13,120,117,3,754,754,0,586,583,3
"2021","Cotswold 002","E02004616",8546,2362,4343,4308,4276,32,35,4,31,202,201,1,900,896,4,739,735,4
"2021","Cotswold 003","E02004617",7827,2129,4261,4245,4230,15,16,0,16,150,148,2,775,775,0,512,512,0
"2021","Cotswold 004","E02004618",6130,1587,3622,3601,3576,25,21,4,17,96,94,2,511,507,4,314,313,1
"2021","Cotswold 005","E02004619",6121,1533,3437,3421,3406,15,16,4,12,113,113,0,618,615,3,420,418,2
"2021","Cotswold 006","E02004620",6855,2086,3653,3645,3625,20,8,3,5,130,130,0,611,610,1,375,375,0
"2021","Cotswold 007","E02004621",5378,1976,2037,2031,2001,30,6,4,2,123,123,0,683,682,1,559,559,0
"2021","Cotswold 008","E02004622",6327,2244,2890,2881,2867,14,9,2,7,134,134,0,599,596,3,460,458,2
"2021","Cotswold 009","E02004623",7662,1877,4328,4312,4302,10,16,6,10,174,174,0,732,730,2,551,551,0
"2021","Cotswold 010","E02004624",5464,1328,3259,3245,3230,15,14,4,10,96,96,0,441,441,0,340,339,1
"2021","Cotswold 011","E02004625",8560,2419,4528,4514,4493,21,14,1,13,190,190,0,845,845,0,578,578,0
"2021","Forest of Dean 001","E02004626",8650,2951,4435,4413,4396,17,22,2,20,115,115,0,631,628,3,518,518,0
"2021","Forest of Dean 002","E02004627",5279,1665,2528,2520,2505,15,8,4,4,104,104,0,574,571,3,408,407,1
"2021","Forest of Dean 003","E02004628",6563,1963,3335,3319,3306,13,16,4,12,136,131,5,617,616,1,512,512,0
"2021","Forest of Dean 004","E02004629",10667,3637,4869,4834,4815,19,35,8,27,248,247,1,1192,1192,0,721,721,0
"2021","Forest of Dean 005","E02004630",5683,1701,2905,2891,2868,23,14,7,7,99,98,1,535,534,1,443,442,1
"2021","Forest of Dean 006","E02004631",4426,1118,2465,2457,2443,14,8,2,6,71,70,1,441,441,0,331,331,0
"2021","Forest of Dean 007","E02004632",9018,2870,4227,4212,4193,19,15,6,9,205,205,0,1029,1025,4,687,686,1
"2021","Forest of Dean 008","E02004633",7049,2050,3717,3703,3679,24,14,10,4,132,132,0,689,687,2,461,461,0
"2021","Forest of Dean 009","E02004634",9375,3206,4291,4277,4257,20,14,3,11,208,208,0,994,994,0,676,675,1
"2021","Forest of Dean 010","E02004635",6338,1768,3487,3479,3458,21,8,2,6,136,136,0,519,519,0,428,428,0
"2021","Gloucester 001","E02004636",6588,2047,3446,3442,3428,14,4,0,4,100,100,0,583,583,0,412,412,0
"2021","Gloucester 002","E02004637",7964,3497,2953,2944,2924,20,9,6,3,180,180,0,803,799,4,531,530,1
"2021","Gloucester 003","E02004638",4810,1556,2460,2453,2443,10,7,0,7,63,63,0,425,423,2,306,306,0
"2021","Gloucester 004","E02004639",9961,5421,2750,2723,2694,29,27,8,19,246,245,1,1024,1023,1,520,520,0
"2021","Gloucester 005","E02004640",6572,2800,2754,2744,2718,26,10,2,8,181,180,1,567,563,4,270,270,0
"2021","Gloucester 006","E02004641",6255,1655,3324,3310,3300,10,14,2,12,110,109,1,621,617,4,545,545,0
"2021","Gloucester 007","E02004642",9657,3467,4538,4526,4507,19,12,6,6,209,206,3,953,951,2,490,490,0
"2021","Gloucester 008","E02004643",6333,2985,2233,2231,2219,12,2,2,0,190,187,3,625,622,3,300,299,1
"2021","Gloucester 009","E02004644",7293,3071,2891,2884,2871,13,7,0,7,155,155,0,798,794,4,378,378,0
"2021","Gloucester 010","E02004645",7492,2321,3933,3919,3902,17,14,4,10,124,123,1,726,726,0,388,388,0
"2021","Gloucester 011","E02004646",7270,2982,2796,2774,2751,23,22,8,14,195,193,2,849,849,0,448,448,0
"2021","Gloucester 012","E02004647",5067,1773,2349,2341,2334,7,8,4,4,93,92,1,478,478,0,374,374,0
"2021","Gloucester 013","E02004648",4744,1414,2353,2349,2343,6,4,0,4,92,92,0,480,480,0,405,405,0
"2021","Gloucester 014","E02004649",5892,2249,2735,2727,2708,19,8,2,6,135,135,0,573,573,0,200,197,3
"2021","Gloucester 015","E02004650",11033,4409,4887,4867,4848,19,20,8,12,287,286,1,1100,1094,6,350,350,0
"2021","Stroud 001","E02004651",8747,3073,4346,4331,4315,16,15,8,7,190,189,1,772,770,2,366,366,0
"2021","Stroud 002","E02004652",5696,1255,3387,3366,3351,15,21,10,11,67,66,1,508,505,3,479,477,2
"2021","Stroud 003","E02004653",6442,1800,3479,3463,3443,20,16,4,12,150,150,0,567,564,3,446,446,0
"2021","Stroud 004","E02004654",9545,3116,4443,4431,4406,25,12,0,12,241,239,2,1076,1076,0,669,668,1
"2021","Stroud 005","E02004655",6676,2339,2982,2971,2957,14,11,0,11,153,152,1,726,724,2,476,476,0
"2021","Stroud 006","E02004656",9504,3940,3597,3578,3543,35,19,8,11,234,233,1,1212,1208,4,521,519,2
"2021","Stroud 007","E02004657",5599,1689,2926,2920,2897,23,6,1,5,100,99,1,563,561,2,321,321,0
"2021","Stroud 008","E02004658",5233,1443,2921,2907,2900,7,14,2,12,78,78,0,472,471,1,319,318,1
"2021","Stroud 009","E02004659",5927,1579,3318,3307,3291,16,11,2,9,107,107,0,549,549,0,374,374,0
"2021","Stroud 010","E02004660",5611,1353,3174,3160,3138,22,14,2,12,82,82,0,500,497,3,502,500,2
"2021","Stroud 011","E02004661",7151,2018,3700,3694,3683,11,6,4,2,135,135,0,742,740,2,556,556,0
"2021","Stroud 012","E02004662",5488,1664,2779,2766,2753,13,13,0,13,96,96,0,554,554,0,395,395,0
"2021","Stroud 013","E02004663",5410,1597,2677,2656,2634,22,21,8,13,136,132,4,611,610,1,389,389,0
"2021","Stroud 014","E02004664",6017,2068,2779,2762,2746,16,17,6,11,153,153,0,618,617,1,399,399,0
"2021","Stroud 015","E02004665",7154,1991,3871,3861,3842,19,10,2,8,134,134,0,669,668,1,489,488,1
"2021","Tewkesbury 001","E02004666",9738,3228,4799,4784,4753,31,15,2,13,192,191,1,969,968,1,550,550,0
"2021","Tewkesbury 002","E02004667",9005,2797,4211,4194,4173,21,17,4,13,177,175,2,1073,1070,3,747,747,0
"2021","Tewkesbury 003","E02004668",7688,1833,4447,4423,4407,16,24,10,14,136,136,0,703,700,3,569,567,2
"2021","Tewkesbury 004","E02004669",6240,1492,3731,3724,3712,12,7,2,5,102,102,0,497,496,1,418,418,0
"2021","Tewkesbury 006","E02004671",5908,1667,3304,3297,3289,8,7,0,7,97,96,1,537,535,2,303,303,0
"2021","Tewkesbury 007","E02004672",10047,2870,5274,5261,5245,16,13,2,11,196,196,0,1001,999,2,706,706,0
"2021","Tewkesbury 008","E02004673",6271,1947,3119,3113,3096,17,6,2,4,118,117,1,625,625,0,462,462,0
"2021","Tewkesbury 009","E02004674",9713,3550,4451,4435,4416,19,16,6,10,189,189,0,989,987,2,534,534,0
"2021","Tewkesbury 010","E02007034",6273,2181,3003,2998,2985,13,5,0,5,134,134,0,683,680,3,272,272,0
"2021","Tewkesbury 011","E02007035",6468,1777,3353,3335,3320,15,18,10,8,115,115,0,628,628,0,595,594,1
"2021","Mendip 001","E02006047",7323,2036,3994,3978,3968,10,16,2,14,141,141,0,717,715,2,435,433,2
"2021","Mendip 002","E02006048",5886,1775,3124,3119,3099,20,5,2,3,97,94,3,524,523,1,366,365,1
"2021","Mendip 003","E02006049",6069,1633,3300,3286,3272,14,14,8,6,114,114,0,597,596,1,425,425,0
"2021","Mendip 004","E02006050",7047,2816,2667,2645,2625,20,22,6,16,209,209,0,891,888,3,464,464,0
"2021","Mendip 005","E02006051",7099,2012,3803,3790,3764,26,13,1,12,126,123,3,652,651,1,506,505,1
"2021","Mendip 006","E02006052",6558,1899,3416,3391,3376,15,25,4,21,128,128,0,645,644,1,470,470,0
"2021","Mendip 007","E02006053",8746,3189,3854,3833,3809,24,21,6,15,219,216,3,990,989,1,494,494,0
"2021","Mendip 008","E02006054",7153,2158,3218,3193,3186,7,25,10,15,176,176,0,913,913,0,688,688,0
"2021","Mendip 009","E02006055",7384,2720,3264,3249,3234,15,15,2,13,176,176,0,832,830,2,392,391,1
"2021","Mendip 010","E02006056",6488,1844,3469,3448,3425,23,21,4,17,127,127,0,653,653,0,395,395,0
"2021","Mendip 011","E02006057",6525,2300,2573,2549,2514,35,24,6,18,192,189,3,993,991,2,467,466,1
"2021","Mendip 012","E02006058",7103,2342,3631,3619,3602,17,12,4,8,133,133,0,575,574,1,422,419,3
"2021","Mendip 013","E02006059",5908,1551,3342,3329,3315,14,13,4,9,109,107,2,529,529,0,377,377,0
"2021","Mendip 014","E02006060",6755,2433,2758,2746,2729,17,12,2,10,213,210,3,820,817,3,531,531,0
"2021","Sedgemoor 001","E02006061",7813,2173,4064,4058,4040,18,6,2,4,187,183,4,788,786,2,601,601,0
"2021","Sedgemoor 002","E02006062",9533,2289,5336,5323,5307,16,13,6,7,190,190,0,927,926,1,791,791,0
"2021","Sedgemoor 003","E02006063",5852,1309,3537,3519,3503,16,18,6,12,103,103,0,501,501,0,402,401,1
"2021","Sedgemoor 004","E02006064",6857,1887,3016,3002,2989,13,14,1,13,205,204,1,875,872,3,874,872,2
"2021","Sedgemoor 005","E02006065",7244,2475,3198,3183,3169,14,15,3,12,212,212,0,860,858,2,499,498,1
"2021","Sedgemoor 006","E02006066",7169,1955,3810,3784,3763,21,26,14,12,128,127,1,735,732,3,541,541,0
"2021","Sedgemoor 007","E02006067",6000,1560,3225,3209,3193,16,16,10,6,115,114,1,613,613,0,487,487,0
"2021","Sedgemoor 008","E02006068",6164,2664,2285,2273,2266,7,12,6,6,171,169,2,691,688,3,353,353,0
"2021","Sedgemoor 009","E02006069",8678,3840,2990,2967,2955,12,23,11,12,281,278,3,1057,1057,0,510,509,1
"2021","Sedgemoor 010","E02006070",7141,2598,3251,3243,3223,20,8,6,2,189,187,2,711,709,2,392,392,0
"2021","Sedgemoor 011","E02006071",7846,2360,4065,4052,4032,20,13,7,6,163,162,1,744,743,1,514,514,0
"2021","Sedgemoor 012","E02006072",8071,1988,4654,4625,4605,20,29,4,25,134,132,2,730,730,0,565,564,1
"2021","Sedgemoor 013","E02006073",6154,2582,2228,2211,2200,11,17,6,11,226,225,1,727,725,2,391,390,1
"2021","Sedgemoor 014","E02006074",9263,2927,4705,4671,4654,17,34,10,24,217,214,3,911,909,2,503,503,0
"2021","South Somerset 001","E02006075",4298,1295,2236,2227,2215,12,9,8,1,77,77,0,431,431,0,259,259,0
"2021","South Somerset 002","E02006076",7819,2039,4218,4200,4184,16,18,6,12,146,145,1,753,753,0,663,661,2
"2021","South Somerset 003","E02006077",5209,1472,2632,2619,2613,6,13,4,9,89,89,0,533,533,0,483,482,1
"2021","South Somerset 004","E02006078",5370,1484,2814,2801,2793,8,13,2,11,92,92,0,563,562,1,417,416,1
"2021","South Somerset 005","E02006079",6915,2029,3527,3521,3506,15,6,4,2,157,154,3,720,720,0,482,481,1
"2021","South Somerset 006","E02006080",5721,1989,2765,2757,2750,7,8,2,6,141,141,0,496,496,0,330,330,0
"2021","South Somerset 007","E02006081",4855,1227,2769,2751,2732,19,18,0,18,95,95,0,428,426,2,336,336,0
"2021","South Somerset 008","E02006082",5856,1713,3018,3014,2992,22,4,2,2,128,128,0,636,636,0,361,360,1
"2021","South Somerset 009","E02006083",4832,1362,2419,2410,2398,12,9,2,7,110,110,0,564,564,0,377,377,0
"2021","South Somerset 010","E02006084",6382,1527,3550,3530,3518,12,20,4,16,112,112,0,704,699,5,489,488,1
"2021","South Somerset 011","E02006085",6243,1922,3147,3143,3139,4,4,0,4,129,128,1,687,687,0,358,358,0
"2021","South Somerset 012","E02006086",6227,1914,3256,3250,3237,13,6,2,4,113,113,0,554,553,1,390,390,0
"2021","South Somerset 013","E02006087",4776,1815,1904,1898,1889,9,6,0,6,126,125,1,598,598,0,333,331,2
"2021","South Somerset 014","E02006088",6183,2421,2491,2474,2460,14,17,8,9,181,178,3,742,742,0,348,348,0
"2021","South Somerset 015","E02006089",6036,2641,2049,2041,2020,21,8,4,4,198,196,2,805,805,0,343,342,1
"2021","South Somerset 016","E02006090",5880,2002,2655,2651,2642,9,4,4,0,149,149,0,671,669,2,403,403,0
"2021","South Somerset 017","E02006091",8500,2105,4660,4645,4622,23,15,4,11,193,191,2,928,925,3,614,614,0
"2021","South Somerset 018","E02006092",5475,1609,2867,2858,2845,13,9,0,9,92,89,3,535,534,1,372,372,0
"2021","South Somerset 019","E02006093",7354,1973,3716,3706,3693,13,10,6,4,157,157,0,822,819,3,686,686,0
"2021","South Somerset 020","E02006094",4611,1128,2524,2508,2499,9,16,4,12,86,84,2,485,485,0,388,388,0
"2021","South Somerset 021","E02006095",7073,2097,3376,3362,3344,18,14,2,12,174,174,0,867,863,4,559,558,1
"2021","South Somerset 022","E02006096",6040,1875,2899,2890,2885,5,9,4,5,152,152,0,683,680,3,431,431,0
"2021","South Somerset 023","E02006097",5677,2076,2350,2346,2340,6,4,2,2,138,136,2,651,648,3,462,462,0
"2021","South Somerset 024","E02006098",6475,1506,3773,3759,3749,10,14,1,13,119,118,1,605,605,0,472,471,1
"2021","Somerset West and Taunton 006","E02006099",5893,1684,3135,3126,3115,11,9,4,5,124,122,2,593,588,5,357,357,0
"2021","Somerset West and Taunton 007","E02006100",6614,2212,3171,3159,3143,16,12,4,8,140,140,0,661,660,1,430,430,0
"2021","Somerset West and Taunton 013","E02006101",4877,1359,2546,2531,2510,21,15,8,7,100,98,2,524,523,1,348,346,2
"2021","Somerset West and Taunton 010","E02006102",5606,1958,2345,2341,2320,21,4,1,3,148,146,2,738,736,2,417,417,0
"2021","Somerset West and Taunton 009","E02006103",6697,1627,3742,3728,3704,24,14,10,4,126,126,0,676,675,1,526,526,0
"2021","Somerset West and Taunton 008","E02006104",8567,2998,4015,4000,3979,21,15,6,9,171,170,1,938,935,3,445,445,0
"2021","Somerset West and Taunton 011","E02006105",9345,4069,3382,3361,3328,33,21,6,15,290,286,4,1142,1140,2,462,462,0
"2021","Somerset West and Taunton 012","E02006106",7961,2720,3775,3767,3752,15,8,2,6,188,188,0,847,846,1,431,429,2
"2021","Somerset West and Taunton 014","E02006107",6545,2585,2527,2521,2504,17,6,0,6,189,188,1,822,822,0,422,422,0
"2021","Somerset West and Taunton 015","E02006108",7485,2603,3062,3039,3029,10,23,6,17,206,201,5,886,882,4,728,727,1
"2021","Somerset West and Taunton 016","E02006109",6551,1615,3733,3728,3710,18,5,3,2,96,96,0,587,586,1,520,520,0
"2021","Somerset West and Taunton 018","E02006110",8482,2947,3701,3694,3656,38,7,0,7,236,236,0,1053,1053,0,545,545,0
"2021","Somerset West and Taunton 017","E02006111",9144,2240,5001,4976,4949,27,25,12,13,182,182,0,912,911,1,809,809,0
"2021","Somerset West and Taunton 019","E02006112",7056,1908,3896,3880,3867,13,16,6,10,114,113,1,638,635,3,500,499,1
"2021","Somerset West and Taunton 001","E02006113",6421,2030,2824,2813,2796,17,11,4,7,147,147,0,722,721,1,698,697,1
"2021","Somerset West and Taunton 002","E02006114",5636,1525,2822,2788,2772,16,34,10,24,133,133,0,604,602,2,552,551,1
"2021","Somerset West and Taunton 003","E02006115",6414,1703,3170,3150,3138,12,20,10,10,151,151,0,827,827,0,563,561,2
"2021","Somerset West and Taunton 004","E02006116",7030,1604,3928,3898,3876,22,30,10,20,124,124,0,779,778,1,595,594,1
"2021","Somerset West and Taunton 005","E02006117",4972,1221,2663,2649,2640,9,14,8,6,93,93,0,549,548,1,446,443,3
"2021","Isle of Anglesey 001","W02000001",7052,2284,3336,3319,3315,4,17,4,13,150,149,1,787,785,2,495,495,0
"2021","Isle of Anglesey 002","W02000002",5479,1408,2947,2925,2922,3,22,10,12,81,81,0,523,523,0,520,519,1
"2021","Isle of Anglesey 003","W02000003",8312,3636,2868,2861,2840,21,7,1,6,205,204,1,1006,1005,1,597,597,0
"2021","Isle of Anglesey 004","W02000004",6297,1776,3227,3215,3203,12,12,4,8,126,125,1,608,607,1,560,559,1
"2021","Isle of Anglesey 005","W02000005",7066,1929,3662,3647,3637,10,15,6,9,115,115,0,727,727,0,633,629,4
"2021","Isle of Anglesey 006","W02000006",5575,2076,2388,2378,2377,1,10,6,4,107,107,0,582,582,0,422,421,1
"2021","Isle of Anglesey 007","W02000007",5607,1941,2551,2543,2523,20,8,0,8,116,116,0,560,559,1,439,439,0
"2021","Isle of Anglesey 008","W02000008",5095,1655,2343,2334,2330,4,9,6,3,69,69,0,515,514,1,513,513,0
"2021","Isle of Anglesey 009","W02000009",6666,2143,3277,3259,3249,10,18,0,18,96,96,0,650,646,4,500,500,0
"2021","Gwynedd 001","W02000010",7923,6072,1162,1152,1144,8,10,8,2,70,69,1,387,387,0,232,232,0
"2021","Gwynedd 002","W02000011",6630,2931,2641,2622,2608,14,19,6,13,142,142,0,513,513,0,403,403,0
"2021","Gwynedd 003","W02000012",6683,2765,2729,2709,2697,12,20,10,10,100,99,1,640,640,0,449,449,0
"2021","Gwynedd 004","W02000013",5269,2045,2324,2318,2308,10,6,2,4,81,81,0,447,447,0,372,371,1
"2021","Gwynedd 005","W02000014",5578,2363,2206,2180,2165,15,26,14,12,111,111,0,543,543,0,355,355,0
"2021","Gwynedd 006","W02000015",6717,2843,2597,2584,2573,11,13,5,8,118,118,0,666,664,2,493,493,0
"2021","Gwynedd 007","W02000016",5232,1889,2388,2377,2369,8,11,6,5,89,89,0,471,470,1,395,394,1
"2021","Gwynedd 008","W02000017",6165,2314,2698,2693,2687,6,5,0,5,104,104,0,607,607,0,442,441,1
"2021","Gwynedd 009","W02000018",4980,2017,1956,1944,1938,6,12,2,10,112,112,0,540,540,0,355,355,0
"2021","Gwynedd 010","W02000019",5634,1920,2472,2452,2438,14,20,10,10,121,121,0,573,573,0,548,548,0
"2021","Gwynedd 011","W02000020",5451,1678,2707,2686,2674,12,21,6,15,93,93,0,491,490,1,482,482,0
"2021","Gwynedd 012","W02000021",6425,2337,2783,2772,2759,13,11,4,7,123,123,0,645,644,1,537,536,1
"2021","Gwynedd 013","W02000022",4775,1433,2314,2296,2277,19,18,6,12,88,88,0,501,500,1,439,437,2
"2021","Gwynedd 014","W02000023",4443,1429,2213,2202,2195,7,11,4,7,58,58,0,349,349,0,394,391,3
"2021","Gwynedd 015","W02000024",4740,1640,2181,2168,2153,15,13,2,11,94,94,0,452,451,1,373,372,1
"2021","Gwynedd 016","W02000025",5201,1837,2321,2312,2299,13,9,4,5,91,91,0,546,546,0,406,406,0
"2021","Gwynedd 017","W02000026",6118,1732,2960,2941,2925,16,19,4,15,116,112,4,671,670,1,639,637,2
"2021","Conwy 001","W02000027",7380,2698,2752,2733,2716,17,19,4,15,198,197,1,976,974,2,756,753,3
"2021","Conwy 002","W02000028",5562,1889,2412,2398,2387,11,14,8,6,94,92,2,619,619,0,548,548,0
"2021","Conwy 003","W02000029",5197,1335,2693,2687,2676,11,6,2,4,80,79,1,531,531,0,558,554,4
"2021","Conwy 004","W02000030",5104,1322,2466,2458,2442,16,8,0,8,111,110,1,607,606,1,598,598,0
"2021","Conwy 005","W02000031",6852,2204,3119,3105,3086,19,14,4,10,175,175,0,718,717,1,636,636,0
"2021","Conwy 006","W02000032",7095,1956,3563,3554,3534,20,9,2,7,125,123,2,766,765,1,685,683,2
"2021","Conwy 007","W02000033",5674,2360,1972,1966,1961,5,6,0,6,179,179,0,745,744,1,418,418,0
"2021","Conwy 008","W02000034",6396,2024,3038,3028,3008,20,10,2,8,138,137,1,713,712,1,483,483,0
"2021","Conwy 009","W02000035",7156,2540,3160,3142,3116,26,18,4,14,158,157,1,822,820,2,476,476,0
"2021","Conwy 010","W02000036",9565,2815,4555,4524,4490,34,31,10,21,219,219,0,1069,1068,1,907,903,4
"2021","Conwy 011","W02000037",5855,2095,2576,2566,2549,17,10,2,8,137,137,0,635,635,0,412,412,0
"2021","Conwy 012","W02000038",5272,1673,2553,2549,2529,20,4,2,2,94,94,0,578,578,0,374,373,1
"2021","Conwy 013","W02000039",6566,2276,2816,2798,2779,19,18,6,12,163,163,0,793,790,3,518,518,0
"2021","Conwy 014","W02000040",5552,1690,2952,2949,2934,15,3,0,3,87,87,0,444,443,1,379,379,0
"2021","Conwy 015","W02000041",7125,2398,3362,3333,3313,20,29,8,21,102,102,0,712,710,2,551,551,0
"2021","Denbighshire 001","W02000042",4925,1497,2245,2232,2215,17,13,4,9,90,90,0,613,611,2,480,478,2
"2021","Denbighshire 002","W02000043",4365,1467,1908,1899,1897,2,9,2,7,104,104,0,504,504,0,382,382,0
"2021","Denbighshire 003","W02000044",4501,1349,2147,2137,2130,7,10,0,10,88,88,0,495,495,0,422,422,0
"2021","Denbighshire 004","W02000045",7742,3138,2536,2531,2509,22,5,0,5,292,287,5,1034,1034,0,742,741,1
"2021","Denbighshire 006","W02000047",4092,1918,1359,1352,1349,3,7,2,5,112,112,0,476,475,1,227,227,0
"2021","Denbighshire 008","W02000049",5437,1829,2610,2595,2587,8,15,6,9,124,123,1,533,533,0,341,341,0
"2021","Denbighshire 009","W02000050",5344,1748,2478,2463,2454,9,15,6,9,123,123,0,583,582,1,412,412,0
"2021","Denbighshire 010","W02000051",4537,1449,2124,2113,2096,17,11,4,7,99,99,0,516,516,0,349,349,0
"2021","Denbighshire 011","W02000052",4031,1754,1383,1372,1360,12,11,8,3,128,125,3,498,498,0,268,268,0
"2021","Denbighshire 012","W02000053",5224,1618,2679,2665,2648,17,14,8,6,90,90,0,417,415,2,420,420,0
"2021","Denbighshire 013","W02000054",5227,1490,2882,2870,2862,8,12,6,6,78,78,0,468,468,0,309,308,1
"2021","Denbighshire 014","W02000055",4695,1695,2024,2019,2003,16,5,1,4,97,97,0,476,476,0,403,402,1
"2021","Denbighshire 015","W02000056",4257,1327,2197,2180,2172,8,17,4,13,75,75,0,394,394,0,264,264,0
"2021","Denbighshire 016","W02000057",5337,1644,2531,2518,2506,12,13,4,9,100,100,0,581,577,4,481,481,0
"2021","Denbighshire 017","W02000419",9200,3176,4047,4027,4006,21,20,1,19,202,201,1,1043,1039,4,732,730,2
"2021","Flintshire 001","W02000058",4380,1374,2070,2064,2060,4,6,0,6,94,94,0,486,484,2,356,356,0
"2021","Flintshire 002","W02000059",5380,1763,2641,2629,2616,13,12,2,10,113,112,1,499,497,2,364,364,0
"2021","Flintshire 003","W02000060",8650,3466,3378,3364,3353,11,14,2,12,239,237,2,947,946,1,620,619,1
"2021","Flintshire 004","W02000061",6081,2592,2054,2044,2033,11,10,6,4,175,172,3,782,781,1,478,478,0
"2021","Flintshire 005","W02000062",5087,1621,2609,2606,2595,11,3,2,1,87,87,0,452,452,0,318,318,0
"2021","Flintshire 006","W02000063",6994,1927,3796,3782,3763,19,14,10,4,118,118,0,653,652,1,500,500,0
"2021","Flintshire 007","W02000064",4958,2062,1880,1872,1863,9,8,4,4,112,110,2,561,560,1,343,342,1
"2021","Flintshire 008","W02000065",5963,2029,2838,2834,2819,15,4,0,4,130,130,0,581,581,0,385,384,1
"2021","Flintshire 009","W02000066",7900,3165,3040,3026,3002,24,14,4,10,194,192,2,979,972,7,522,522,0
"2021","Flintshire 010","W02000067",5544,1538,3093,3087,3075,12,6,6,0,95,95,0,452,452,0,366,366,0
"2021","Flintshire 011","W02000068",4388,1514,1848,1844,1834,10,4,0,4,124,124,0,564,564,0,338,338,0
"2021","Flintshire 012","W02000069",5228,1494,2801,2792,2775,17,9,4,5,94,93,1,500,499,1,339,339,0
"2021","Flintshire 013","W02000070",8787,2465,4784,4771,4758,13,13,4,9,135,132,3,794,793,1,609,608,1
"2021","Flintshire 014","W02000071",5968,1624,3174,3170,3142,28,4,2,2,94,94,0,562,560,2,514,514,0
"2021","Flintshire 015","W02000072",9468,3605,4183,4178,4148,30,5,2,3,212,211,1,937,936,1,531,531,0
"2021","Flintshire 016","W02000073",8323,2846,3715,3709,3679,30,6,0,6,182,180,2,889,889,0,691,691,0
"2021","Flintshire 017","W02000074",8045,2915,3495,3484,3462,22,11,6,5,171,167,4,906,903,3,558,558,0
"2021","Flintshire 018","W02000075",5196,1465,2888,2882,2870,12,6,4,2,71,71,0,490,489,1,282,282,0
"2021","Flintshire 019","W02000076",6201,1831,3223,3209,3201,8,14,6,8,119,117,2,580,580,0,448,448,0
"2021","Flintshire 020","W02000077",5032,1538,2504,2494,2488,6,10,2,8,108,108,0,480,480,0,402,402,0
"2021","Wrexham 003","W02000080",6275,2196,2862,2856,2837,19,6,4,2,132,132,0,628,628,0,457,457,0
"2021","Wrexham 004","W02000081",4708,1713,2133,2129,2119,10,4,2,2,93,92,1,459,459,0,310,310,0
"2021","Wrexham 005","W02000082",6076,2409,2520,2507,2488,19,13,4,9,126,125,1,680,678,2,341,341,0
"2021","Wrexham 006","W02000083",6939,2666,2907,2902,2888,14,5,0,5,148,148,0,747,744,3,471,471,0
"2021","Wrexham 008","W02000085",7616,2668,3380,3370,3356,14,10,4,6,151,150,1,766,765,1,651,649,2
"2021","Wrexham 010","W02000087",5034,2414,1535,1523,1516,7,12,4,8,130,128,2,614,611,3,341,341,0
"2021","Wrexham 011","W02000088",7216,3131,2713,2701,2672,29,12,2,10,176,174,2,781,779,2,415,415,0
"2021","Wrexham 012","W02000089",6880,3088,2385,2355,2342,13,30,19,11,210,210,0,791,791,0,406,405,1
"2021","Wrexham 013","W02000090",4607,1609,2186,2174,2161,13,12,6,6,104,104,0,448,448,0,260,260,0
"2021","Wrexham 014","W02000091",5104,1749,2458,2451,2446,5,7,6,1,82,81,1,467,465,2,348,348,0
"2021","Wrexham 015","W02000092",5450,2294,2022,2010,2002,8,12,0,12,98,98,0,638,637,1,398,398,0
"2021","Wrexham 016","W02000093",5380,1778,2603,2594,2572,22,9,2,7,96,96,0,564,563,1,339,339,0
"2021","Wrexham 017","W02000094",7107,2818,2876,2860,2841,19,16,8,8,154,152,2,777,775,2,482,482,0
"2021","Wrexham 018","W02000095",5380,1415,2975,2963,2948,15,12,6,6,103,101,2,506,506,0,381,381,0
"2021","Wrexham 019","W02000096",5356,1743,2479,2471,2455,16,8,2,6,108,108,0,576,573,3,450,450,0
"2021","Wrexham 021","W02000424",5760,1539,3104,3098,3093,5,6,2,4,80,80,0,539,537,2,498,496,2
"2021","Wrexham 022","W02000425",7180,2845,3212,3198,3189,9,14,2,12,128,128,0,613,611,2,382,382,0
"2021","Wrexham 023","W02000426",8203,2606,3998,3992,3977,15,6,2,4,121,119,2,826,826,0,652,652,0
"2021","Ceredigion 001","W02000116",6173,2054,2941,2912,2898,14,29,6,23,121,121,0,608,604,4,449,448,1
"2021","Ceredigion 002","W02000117",8384,6379,1284,1271,1253,18,13,4,9,70,69,1,400,400,0,251,251,0
"2021","Ceredigion 003","W02000118",5377,2630,1800,1786,1769,17,14,6,8,105,105,0,536,535,1,306,304,2
"2021","Ceredigion 005","W02000120",6107,1837,3049,3039,3017,22,10,2,8,107,107,0,589,589,0,525,525,0
"2021","Ceredigion 007","W02000122",5479,1442,3018,3003,2995,8,15,8,7,84,83,1,530,530,0,405,405,0
"2021","Ceredigion 008","W02000123",6461,2186,3004,2985,2964,21,19,6,13,131,126,5,642,639,3,498,498,0
"2021","Ceredigion 009","W02000124",7292,2366,3269,3247,3234,13,22,10,12,145,144,1,823,823,0,689,689,0
"2021","Ceredigion 010","W02000125",6396,1899,3160,3141,3118,23,19,6,13,103,102,1,688,687,1,546,545,1
"2021","Ceredigion 011","W02000421",9718,2973,4942,4906,4884,22,36,12,24,161,160,1,866,863,3,776,773,3
"2021","Pembrokeshire 001","W02000126",6923,2168,3425,3409,3394,15,16,10,6,122,122,0,687,685,2,521,519,2
"2021","Pembrokeshire 002","W02000127",8104,2581,3755,3731,3724,7,24,10,14,190,189,1,883,881,2,695,695,0
"2021","Pembrokeshire 003","W02000128",6225,1874,3122,3105,3095,10,17,6,11,123,123,0,602,600,2,504,503,1
"2021","Pembrokeshire 004","W02000129",5969,1612,3288,3268,3256,12,20,10,10,111,110,1,534,532,2,424,424,0
"2021","Pembrokeshire 005","W02000130",5321,2166,1990,1978,1962,16,12,2,10,160,156,4,651,650,1,354,354,0
"2021","Pembrokeshire 006","W02000131",5835,2051,2482,2474,2457,17,8,2,6,137,137,0,674,671,3,491,491,0
"2021","Pembrokeshire 007","W02000132",5933,1784,2968,2958,2937,21,10,3,7,110,108,2,572,572,0,499,499,0
"2021","Pembrokeshire 008","W02000133",6953,1875,3693,3683,3672,11,10,4,6,120,120,0,676,674,2,589,589,0
"2021","Pembrokeshire 009","W02000134",6979,1986,3667,3652,3635,17,15,2,13,123,123,0,698,696,2,505,504,1
"2021","Pembrokeshire 010","W02000135",5931,2140,2477,2465,2446,19,12,8,4,157,157,0,653,651,2,504,504,0
"2021","Pembrokeshire 011","W02000136",7181,1796,3753,3737,3723,14,16,1,15,120,120,0,779,779,0,733,733,0
"2021","Pembrokeshire 012","W02000137",5939,2299,2394,2383,2369,14,11,0,11,123,123,0,660,660,0,463,463,0
"2021","Pembrokeshire 013","W02000138",7823,3029,3019,3007,2985,22,12,6,6,248,246,2,942,940,2,585,582,3
"2021","Pembrokeshire 014","W02000139",6600,1643,3718,3700,3693,7,18,8,10,91,90,1,578,578,0,570,570,0
"2021","Pembrokeshire 015","W02000140",5836,2070,2500,2485,2475,10,15,0,15,164,161,3,664,659,5,438,438,0
"2021","Pembrokeshire 016","W02000141",5001,1492,2236,2230,2221,9,6,2,4,108,108,0,661,660,1,504,503,1
"2021","Carmarthenshire 001","W02000142",4696,1473,2285,2266,2261,5,19,8,11,85,84,1,482,480,2,371,370,1
"2021","Carmarthenshire 002","W02000143",4794,1455,2394,2388,2371,17,6,2,4,89,89,0,443,441,2,413,413,0
"2021","Carmarthenshire 003","W02000144",6565,1902,3390,3382,3348,34,8,2,6,125,124,1,632,632,0,516,515,1
"2021","Carmarthenshire 004","W02000145",6055,1797,3039,3023,2989,34,16,0,16,99,98,1,585,584,1,535,532,3
"2021","Carmarthenshire 005","W02000146",5593,1501,3115,3099,3079,20,16,6,10,78,78,0,489,489,0,410,410,0
"2021","Carmarthenshire 006","W02000147",6868,2569,3138,3129,3111,18,9,2,7,112,111,1,646,645,1,403,403,0
"2021","Carmarthenshire 007","W02000148",4239,1678,1705,1703,1701,2,2,2,0,106,106,0,470,470,0,280,280,0
"2021","Carmarthenshire 008","W02000149",5474,1908,2303,2296,2291,5,7,4,3,107,107,0,626,625,1,530,530,0
"2021","Carmarthenshire 010","W02000151",6052,2046,2753,2744,2735,9,9,2,7,118,116,2,667,666,1,468,468,0
"2021","Carmarthenshire 011","W02000152",7148,2027,3640,3632,3614,18,8,2,6,135,134,1,731,731,0,615,614,1
"2021","Carmarthenshire 012","W02000153",7338,2054,3886,3867,3853,14,19,6,13,115,115,0,682,682,0,601,601,0
"2021","Carmarthenshire 013","W02000154",6401,2149,2856,2841,2816,25,15,4,11,138,137,1,720,718,2,538,538,0
"2021","Carmarthenshire 015","W02000156",6937,2242,3407,3389,3381,8,18,9,9,137,137,0,659,658,1,492,490,2
"2021","Carmarthenshire 016","W02000157",8280,2509,4185,4167,4141,26,18,10,8,146,145,1,827,825,2,613,613,0
"2021","Carmarthenshire 017","W02000158",4836,1492,2459,2445,2425,20,14,4,10,92,92,0,459,458,1,334,334,0
"2021","Carmarthenshire 018","W02000159",5073,1608,2367,2348,2339,9,19,6,13,112,111,1,573,572,1,413,413,0
"2021","Carmarthenshire 019","W02000160",6317,1801,3343,3337,3329,8,6,2,4,83,82,1,557,557,0,533,533,0
"2021","Carmarthenshire 020","W02000161",4210,1482,1719,1712,1687,25,7,4,3,112,110,2,521,519,2,376,376,0
"2021","Carmarthenshire 021","W02000162",7006,2134,3326,3311,3294,17,15,2,13,150,150,0,790,789,1,606,605,1
"2021","Carmarthenshire 022","W02000163",4309,1583,1755,1748,1742,6,7,0,7,129,129,0,502,502,0,340,340,0
"2021","Carmarthenshire 023","W02000164",6240,2070,2834,2819,2805,14,15,6,9,150,147,3,676,676,0,510,509,1
"2021","Carmarthenshire 024","W02000165",5272,1937,2236,2224,2203,21,12,4,8,114,112,2,612,612,0,373,372,1
"2021","Carmarthenshire 025","W02000166",7231,2661,3179,3163,3151,12,16,8,8,165,165,0,738,738,0,488,488,0
"2021","Carmarthenshire 026","W02000167",8271,3373,2943,2909,2869,40,34,17,17,234,232,2,1159,1157,2,562,561,1
"2021","Carmarthenshire 027","W02000418",10268,2932,5266,5248,5236,12,18,10,8,220,218,2,1064,1063,1,786,786,0
"2021","Swansea 001","W02000168",5248,1965,2267,2259,2250,9,8,4,4,111,111,0,543,542,1,362,362,0
"2021","Swansea 002","W02000169",7477,2582,3369,3351,3328,23,18,4,14,185,185,0,786,783,3,555,555,0
"2021","Swansea 003","W02000170",7269,2500,3458,3453,3434,19,5,2,3,128,128,0,630,626,4,553,553,0
"2021","Swansea 004","W02000171",6828,2221,3475,3464,3451,13,11,0,11,135,133,2,629,627,2,368,368,0
"2021","Swansea 005","W02000172",8320,3068,3438,3428,3398,30,10,8,2,207,207,0,980,978,2,627,627,0
"2021","Swansea 006","W02000173",6289,2231,3031,3023,3006,17,8,1,7,138,138,0,578,575,3,311,311,0
"2021","Swansea 007","W02000174",7905,2525,3900,3897,3883,14,3,0,3,135,135,0,739,735,4,606,606,0
"2021","Swansea 008","W02000175",6099,2469,2248,2240,2221,19,8,0,8,159,157,2,739,736,3,484,484,0
"2021","Swansea 009","W02000176",7319,2633,3172,3157,3144,13,15,6,9,170,167,3,734,732,2,610,610,0
"2021","Swansea 010","W02000177",5631,2056,2542,2529,2514,15,13,8,5,113,113,0,577,572,5,343,343,0
"2021","Swansea 011","W02000178",6575,3159,2173,2158,2150,8,15,4,11,213,211,2,704,703,1,326,326,0
"2021","Swansea 012","W02000179",5472,1705,2672,2670,2654,16,2,2,0,103,103,0,586,586,0,406,406,0
"2021","Swansea 013","W02000180",6238,2681,2309,2305,2284,21,4,0,4,168,165,3,659,656,3,421,421,0
"2021","Swansea 014","W02000181",6070,2673,2172,2159,2145,14,13,8,5,144,143,1,582,579,3,499,499,0
"2021","Swansea 015","W02000182",6205,2520,2512,2501,2486,15,11,6,5,161,159,2,596,594,2,416,416,0
"2021","Swansea 016","W02000183",8483,4218,2601,2585,2554,31,16,10,6,228,226,2,914,912,2,522,521,1
"2021","Swansea 017","W02000184",5615,2085,2396,2382,2353,29,14,4,10,122,121,1,571,569,2,441,441,0
"2021","Swansea 018","W02000185",4278,1205,2282,2282,2271,11,0,0,0,75,75,0,372,372,0,344,343,1
"2021","Swansea 019","W02000186",6408,3263,1823,1807,1795,12,16,10,6,247,245,2,713,713,0,362,362,0
"2021","Swansea 021","W02000188",6702,3243,2257,2243,2213,30,14,6,8,209,208,1,584,582,2,409,408,1
"2021","Swansea 022","W02000189",6882,2225,3085,3076,3069,7,9,2,7,156,156,0,842,840,2,574,574,0
"2021","Swansea 024","W02000191",7749,4337,2359,2342,2311,31,17,2,15,131,127,4,547,545,2,375,373,2
"2021","Swansea 025","W02000192",8377,5109,1779,1760,1723,37,19,8,11,185,183,2,928,927,1,376,374,2
"2021","Swansea 026","W02000193",8123,5736,1386,1377,1366,11,9,4,5,122,121,1,547,546,1,332,331,1
"2021","Swansea 027","W02000194",5690,2312,2580,2570,2552,18,10,2,8,54,54,0,314,314,0,430,430,0
"2021","Swansea 028","W02000195",4918,1041,2888,2881,2872,9,7,4,3,77,76,1,408,408,0,504,504,0
"2021","Swansea 029","W02000196",5314,1579,2446,2431,2423,8,15,5,10,129,129,0,620,620,0,540,538,2
"2021","Swansea 030","W02000197",5207,1232,2990,2982,2972,10,8,2,6,67,66,1,408,406,2,510,508,2
"2021","Swansea 031","W02000198",6231,1600,3358,3350,3322,28,8,2,6,99,99,0,588,585,3,586,586,0
"2021","Swansea 032","W02000428",8937,2862,4460,4452,4446,6,8,4,4,110,109,1,796,795,1,709,708,1
"2021","Neath Port Talbot 002","W02000200",4203,1364,1970,1965,1947,18,5,2,3,101,99,2,438,437,1,330,330,0
"2021","Neath Port Talbot 003","W02000201",4344,1489,1957,1944,1932,12,13,2,11,101,101,0,423,422,1,374,374,0
"2021","Neath Port Talbot 004","W02000202",10258,3511,4706,4691,4663,28,15,6,9,195,193,2,1088,1085,3,758,758,0
"2021","Neath Port Talbot 006","W02000204",5656,1606,2987,2978,2969,9,9,4,5,80,80,0,547,547,0,436,435,1
"2021","Neath Port Talbot 007","W02000205",4898,1561,2238,2235,2217,18,3,1,2,94,92,2,594,594,0,411,411,0
"2021","Neath Port Talbot 008","W02000206",5528,2159,1906,1890,1876,14,16,4,12,150,148,2,807,805,2,506,505,1
"2021","Neath Port Talbot 009","W02000207",4449,1240,2374,2370,2347,23,4,2,2,73,73,0,419,418,1,343,343,0
"2021","Neath Port Talbot 010","W02000208",10590,5123,3752,3745,3707,38,7,5,2,188,188,0,968,965,3,559,557,2
"2021","Neath Port Talbot 012","W02000210",4938,1970,2075,2065,2050,15,10,4,6,101,100,1,525,520,5,267,267,0
"2021","Neath Port Talbot 013","W02000211",6272,2562,2341,2331,2319,12,10,6,4,188,188,0,744,742,2,437,436,1
"2021","Neath Port Talbot 014","W02000212",6383,2245,2882,2878,2869,9,4,0,4,118,117,1,677,677,0,461,461,0
"2021","Neath Port Talbot 015","W02000213",5652,1761,2829,2816,2792,24,13,2,11,90,90,0,526,526,0,446,446,0
"2021","Neath Port Talbot 016","W02000214",7747,2975,2998,2968,2944,24,30,18,12,190,188,2,885,882,3,699,698,1
"2021","Neath Port Talbot 017","W02000215",7622,3007,2910,2898,2866,32,12,4,8,219,218,1,940,937,3,546,546,0
"2021","Neath Port Talbot 018","W02000216",5971,2199,2522,2509,2487,22,13,2,11,143,142,1,659,658,1,448,447,1
"2021","Neath Port Talbot 019","W02000217",5165,1826,2363,2359,2354,5,4,2,2,109,109,0,516,514,2,351,351,0
"2021","Neath Port Talbot 020","W02000417",8360,3007,3569,3550,3520,30,19,4,15,197,195,2,952,948,4,635,635,0
"2021","Neath Port Talbot 021","W02000427",9146,3329,3929,3909,3882,27,20,10,10,230,226,4,899,897,2,759,758,1
"2021","Bridgend 001","W02000218",5284,2222,2034,2023,2006,17,11,5,6,113,111,2,505,504,1,410,410,0
"2021","Bridgend 002","W02000219",5978,2169,2612,2607,2590,17,5,0,5,112,112,0,635,635,0,450,450,0
"2021","Bridgend 003","W02000220",6475,2479,2709,2702,2692,10,7,6,1,155,152,3,661,660,1,471,470,1
"2021","Bridgend 004","W02000221",6185,2476,2508,2500,2481,19,8,4,4,139,138,1,638,638,0,424,424,0
"2021","Bridgend 005","W02000222",5157,1654,2527,2521,2517,4,6,6,0,62,62,0,459,459,0,455,455,0
"2021","Bridgend 006","W02000223",4947,1725,2203,2188,2176,12,15,8,7,106,106,0,577,576,1,336,336,0
"2021","Bridgend 007","W02000224",5261,1970,2271,2254,2234,20,17,4,13,117,117,0,565,565,0,338,338,0
"2021","Bridgend 008","W02000225",7169,2658,3060,3045,3028,17,15,8,7,153,153,0,760,760,0,538,538,0
"2021","Bridgend 009","W02000226",8289,2590,4152,4142,4126,16,10,6,4,173,173,0,786,785,1,588,587,1
"2021","Bridgend 010","W02000227",5856,2176,2472,2465,2456,9,7,2,5,130,128,2,677,676,1,401,401,0
"2021","Bridgend 011","W02000228",9932,4320,4138,4114,4089,25,24,2,22,223,223,0,815,812,3,436,434,2
"2021","Bridgend 012","W02000229",5039,1704,2169,2167,2159,8,2,0,2,140,139,1,647,647,0,379,379,0
"2021","Bridgend 013","W02000230",4789,1315,2679,2677,2656,21,2,0,2,76,76,0,393,393,0,326,325,1
"2021","Bridgend 014","W02000231",6846,2680,2598,2593,2576,17,5,1,4,192,191,1,889,889,0,487,487,0
"2021","Bridgend 015","W02000232",4754,1597,2326,2316,2299,17,10,2,8,82,82,0,471,467,4,278,277,1
"2021","Bridgend 016","W02000233",4954,1801,2182,2172,2157,15,10,6,4,122,120,2,573,571,2,276,276,0
"2021","Bridgend 017","W02000234",8494,2617,4431,4421,4391,30,10,6,4,165,164,1,801,800,1,480,479,1
"2021","Bridgend 018","W02000235",8026,2016,4114,4104,4083,21,10,0,10,118,118,0,853,852,1,925,925,0
"2021","Bridgend 019","W02000236",6037,1759,2886,2871,2858,13,15,6,9,110,109,1,720,718,2,562,562,0
"2021","Vale of Glamorgan 001","W02000237",5067,1193,3120,3114,3096,18,6,0,6,54,54,0,378,378,0,322,322,0
"2021","Vale of Glamorgan 002","W02000238",5438,1120,3240,3230,3210,20,10,2,8,95,94,1,455,454,1,528,528,0
"2021","Vale of Glamorgan 003","W02000239",6671,1758,3954,3940,3916,24,14,0,14,73,73,0,500,497,3,386,386,0
"2021","Vale of Glamorgan 004","W02000240",7193,2428,3423,3411,3381,30,12,0,12,134,134,0,708,707,1,500,500,0
"2021","Vale of Glamorgan 005","W02000241",8442,2831,3776,3747,3701,46,29,12,17,179,178,1,1015,1010,5,641,641,0
"2021","Vale of Glamorgan 006","W02000242",6788,1862,3619,3597,3561,36,22,10,12,106,103,3,596,595,1,605,605,0
"2021","Vale of Glamorgan 007","W02000243",7224,3127,2686,2670,2638,32,16,3,13,165,164,1,770,770,0,476,476,0
"2021","Vale of Glamorgan 008","W02000244",8252,2267,4425,4412,4398,14,13,2,11,140,140,0,786,781,5,634,634,0
"2021","Vale of Glamorgan 009","W02000245",6657,2590,2836,2828,2803,25,8,1,7,174,174,0,734,733,1,323,323,0
"2021","Vale of Glamorgan 010","W02000246",4595,1131,2650,2642,2629,13,8,4,4,74,74,0,379,376,3,361,361,0
"2021","Vale of Glamorgan 011","W02000247",7324,2266,3574,3557,3538,19,17,7,10,143,142,1,716,713,3,625,624,1
"2021","Vale of Glamorgan 012","W02000248",8385,3784,2922,2911,2883,28,11,0,11,236,233,3,971,967,4,472,472,0
"2021","Vale of Glamorgan 013","W02000249",7092,2894,2579,2570,2542,28,9,7,2,177,176,1,895,891,4,547,547,0
"2021","Vale of Glamorgan 014","W02000250",9383,3216,4520,4509,4480,29,11,0,11,199,198,1,930,929,1,518,517,1
"2021","Vale of Glamorgan 015","W02000251",8947,3533,3599,3566,3518,48,33,2,31,255,254,1,1010,1008,2,550,549,1
"2021","Cardiff 001","W02000367",5128,1349,2990,2976,2967,9,14,1,13,59,59,0,354,354,0,376,375,1
"2021","Cardiff 002","W02000368",4716,1657,2349,2340,2326,14,9,2,7,66,64,2,432,432,0,212,212,0
"2021","Cardiff 003","W02000369",7703,3118,3688,3681,3640,41,7,4,3,114,113,1,592,591,1,191,190,1
"2021","Cardiff 004","W02000370",5471,1360,3055,3045,3022,23,10,2,8,68,67,1,429,429,0,559,559,0
"2021","Cardiff 005","W02000371",7312,2737,3074,3052,3028,24,22,6,16,170,169,1,750,748,2,581,580,1
"2021","Cardiff 006","W02000372",6596,1902,3702,3690,3672,18,12,10,2,125,125,0,517,514,3,350,350,0
"2021","Cardiff 007","W02000373",5364,2440,1999,1988,1975,13,11,4,7,126,125,1,514,514,0,285,284,1
"2021","Cardiff 008","W02000374",4695,1193,2789,2780,2773,7,9,4,5,51,51,0,329,328,1,333,332,1
"2021","Cardiff 009","W02000375",5478,2470,2061,2051,2036,15,10,4,6,125,123,2,521,521,0,301,301,0
"2021","Cardiff 010","W02000376",5358,1892,2467,2466,2445,21,1,0,1,100,100,0,533,533,0,366,366,0
"2021","Cardiff 011","W02000377",6048,2462,2510,2503,2493,10,7,2,5,153,153,0,627,626,1,296,296,0
"2021","Cardiff 012","W02000378",6057,1782,3293,3285,3273,12,8,6,2,76,75,1,487,487,0,419,419,0
"2021","Cardiff 013","W02000379",4653,2270,1468,1457,1447,10,11,4,7,145,145,0,561,559,2,209,209,0
"2021","Cardiff 014","W02000380",6515,1883,3683,3663,3640,23,20,8,12,79,78,1,518,518,0,352,352,0
"2021","Cardiff 015","W02000381",5100,2118,1932,1920,1905,15,12,4,8,154,154,0,507,507,0,389,388,1
"2021","Cardiff 016","W02000382",4531,2150,1475,1467,1460,7,8,2,6,109,109,0,460,459,1,337,337,0
"2021","Cardiff 017","W02000383",5711,2415,2168,2157,2148,9,11,0,11,173,172,1,592,589,3,363,363,0
"2021","Cardiff 018","W02000384",4638,1359,2661,2652,2643,9,9,4,5,61,61,0,273,272,1,284,283,1
"2021","Cardiff 019","W02000385",5541,1903,2897,2890,2881,9,7,0,7,55,53,2,325,323,2,361,361,0
"2021","Cardiff 020","W02000386",6222,1742,3380,3370,3345,25,10,4,6,105,105,0,501,500,1,494,492,2
"2021","Cardiff 021","W02000387",4866,1730,2350,2342,2328,14,8,4,4,77,77,0,379,378,1,330,330,0
"2021","Cardiff 022","W02000388",4756,1649,2253,2247,2224,23,6,2,4,82,82,0,428,428,0,344,343,1
"2021","Cardiff 023","W02000389",6653,2766,2648,2625,2591,34,23,6,17,132,132,0,754,749,5,353,352,1
"2021","Cardiff 024","W02000390",5252,1766,2660,2653,2641,12,7,4,3,53,52,1,339,339,0,434,434,0
"2021","Cardiff 025","W02000391",8390,6178,1660,1645,1619,26,15,8,7,75,75,0,336,332,4,141,141,0
"2021","Cardiff 026","W02000392",7377,2550,3583,3569,3554,15,14,2,12,106,105,1,632,626,6,506,505,1
"2021","Cardiff 027","W02000393",5187,2386,1834,1829,1817,12,5,0,5,100,99,1,569,569,0,298,298,0
"2021","Cardiff 028","W02000394",9022,7703,954,954,945,9,0,0,0,31,31,0,209,208,1,125,124,1
"2021","Cardiff 029","W02000395",5365,2225,2339,2327,2313,14,12,6,6,86,86,0,427,424,3,288,287,1
"2021","Cardiff 030","W02000396",6617,4487,1500,1485,1467,18,15,8,7,101,99,2,337,334,3,192,192,0
"2021","Cardiff 031","W02000397",5300,2125,2019,2011,1994,17,8,0,8,133,133,0,622,621,1,401,401,0
"2021","Cardiff 032","W02000398",11871,10602,907,892,885,7,15,4,11,39,38,1,201,200,1,122,122,0
"2021","Cardiff 033","W02000399",9844,7171,1716,1698,1670,28,18,10,8,140,138,2,545,541,4,272,269,3
"2021","Cardiff 034","W02000400",5464,2796,1875,1844,1806,38,31,6,25,122,111,11,479,476,3,192,191,1
"2021","Cardiff 035","W02000401",4867,2079,2022,2015,1976,39,7,2,5,85,82,3,432,432,0,249,249,0
"2021","Cardiff 036","W02000402",9919,6857,2105,2090,2060,30,15,6,9,175,173,2,557,553,4,225,224,1
"2021","Cardiff 037","W02000403",5897,3009,1937,1918,1898,20,19,4,15,166,165,1,525,523,2,260,260,0
"2021","Cardiff 038","W02000404",5209,2910,1450,1425,1384,41,25,10,15,125,125,0,480,475,5,244,244,0
"2021","Cardiff 039","W02000405",5364,2837,1574,1563,1548,15,11,8,3,172,169,3,520,518,2,261,261,0
"2021","Cardiff 040","W02000406",8175,4142,2826,2792,2752,40,34,9,25,189,185,4,649,644,5,369,369,0
"2021","Cardiff 041","W02000407",4949,2253,1705,1704,1700,4,1,0,1,174,173,1,506,506,0,311,311,0
"2021","Cardiff 042","W02000408",5872,3037,2000,1984,1975,9,16,8,8,173,165,8,441,440,1,221,219,2
"2021","Cardiff 043","W02000409",4690,2062,1763,1756,1744,12,7,2,5,120,119,1,456,456,0,289,289,0
"2021","Cardiff 044","W02000410",6775,3532,2439,2424,2401,23,15,6,9,173,173,0,399,396,3,232,232,0
"2021","Cardiff 045","W02000411",5127,2452,1700,1691,1687,4,9,2,7,122,122,0,492,488,4,361,361,0
"2021","Cardiff 046","W02000412",5414,2618,1968,1957,1937,20,11,4,7,105,105,0,461,461,0,262,261,1
"2021","Cardiff 048","W02000422",6659,4329,1664,1645,1598,47,19,1,18,131,127,4,436,429,7,99,97,2
"2021","Cardiff 049","W02000423",8584,5533,1988,1971,1940,31,17,2,15,167,166,1,563,559,4,333,332,1
"2021","Rhondda Cynon Taf 001","W02000252",7350,2754,3249,3238,3194,44,11,4,7,169,164,5,649,649,0,529,528,1
"2021","Rhondda Cynon Taf 002","W02000253",5672,2206,2303,2294,2251,43,9,4,5,123,122,1,596,596,0,444,444,0
"2021","Rhondda Cynon Taf 003","W02000254",6553,2371,2936,2931,2906,25,5,4,1,113,113,0,647,645,2,486,486,0
"2021","Rhondda Cynon Taf 004","W02000255",5674,1922,2715,2706,2700,6,9,3,6,114,113,1,541,540,1,382,382,0
"2021","Rhondda Cynon Taf 005","W02000256",8051,3328,3145,3134,3105,29,11,2,9,185,185,0,797,796,1,596,596,0
"2021","Rhondda Cynon Taf 006","W02000257",5971,2389,2425,2416,2396,20,9,0,9,115,114,1,593,592,1,449,449,0
"2021","Rhondda Cynon Taf 007","W02000258",4628,1787,1773,1764,1752,12,9,3,6,112,112,0,537,536,1,419,419,0
"2021","Rhondda Cynon Taf 008","W02000259",4578,1954,1730,1725,1717,8,5,1,4,131,130,1,424,423,1,339,339,0
"2021","Rhondda Cynon Taf 009","W02000260",4702,1887,1836,1828,1816,12,8,2,6,95,95,0,462,462,0,422,422,0
"2021","Rhondda Cynon Taf 010","W02000261",6348,2444,2614,2595,2577,18,19,5,14,134,134,0,643,643,0,513,512,1
"2021","Rhondda Cynon Taf 011","W02000262",4281,1673,1750,1744,1733,11,6,2,4,99,99,0,439,439,0,320,320,0
"2021","Rhondda Cynon Taf 012","W02000263",5111,2115,2011,2011,1997,14,0,0,0,114,112,2,532,532,0,339,338,1
"2021","Rhondda Cynon Taf 013","W02000264",4574,2105,1594,1585,1570,15,9,2,7,114,112,2,436,434,2,325,325,0
"2021","Rhondda Cynon Taf 014","W02000265",7498,3174,2942,2923,2901,22,19,12,7,173,172,1,661,657,4,548,548,0
"2021","Rhondda Cynon Taf 015","W02000266",6006,2366,2530,2519,2510,9,11,6,5,122,120,2,575,573,2,413,413,0
"2021","Rhondda Cynon Taf 016","W02000267",5144,2198,1976,1960,1948,12,16,6,10,102,102,0,469,469,0,399,399,0
"2021","Rhondda Cynon Taf 017","W02000268",7443,2955,2983,2967,2955,12,16,6,10,160,160,0,751,749,2,594,593,1
"2021","Rhondda Cynon Taf 018","W02000269",6694,2702,2705,2692,2675,17,13,4,9,128,128,0,669,666,3,490,490,0
"2021","Rhondda Cynon Taf 019","W02000270",5453,2070,2354,2347,2335,12,7,4,3,106,104,2,544,542,2,379,379,0
"2021","Rhondda Cynon Taf 020","W02000271",4413,1781,1718,1705,1693,12,13,2,11,94,93,1,464,461,3,356,355,1
"2021","Rhondda Cynon Taf 021","W02000272",8286,3270,3422,3399,3369,30,23,2,21,172,170,2,840,837,3,582,582,0
"2021","Rhondda Cynon Taf 022","W02000273",8715,5122,2358,2345,2323,22,13,6,7,156,155,1,702,702,0,377,377,0
"2021","Rhondda Cynon Taf 023","W02000274",8229,3094,3669,3650,3636,14,19,6,13,164,162,2,726,724,2,576,575,1
"2021","Rhondda Cynon Taf 024","W02000275",4972,1917,2139,2131,2118,13,8,2,6,93,92,1,531,529,2,292,291,1
"2021","Rhondda Cynon Taf 025","W02000276",5293,1701,2575,2574,2569,5,1,0,1,95,94,1,470,469,1,452,452,0
"2021","Rhondda Cynon Taf 026","W02000277",5796,2165,2397,2388,2365,23,9,4,5,143,141,2,646,645,1,445,445,0
"2021","Rhondda Cynon Taf 027","W02000278",7265,2171,3933,3921,3906,15,12,2,10,117,117,0,619,618,1,425,425,0
"2021","Rhondda Cynon Taf 028","W02000279",6273,2343,2803,2792,2773,19,11,2,9,126,122,4,619,616,3,382,381,1
"2021","Rhondda Cynon Taf 029","W02000280",7561,2647,3736,3716,3685,31,20,14,6,137,137,0,691,688,3,350,350,0
"2021","Rhondda Cynon Taf 030","W02000281",6191,1899,3094,3083,3068,15,11,0,11,102,102,0,663,663,0,433,433,0
"2021","Rhondda Cynon Taf 031","W02000282",9116,2754,4750,4741,4710,31,9,0,9,180,176,4,880,877,3,552,550,2
"2021","Caerphilly 001","W02000290",7039,2904,2664,2644,2625,19,20,13,7,170,167,3,741,739,2,560,558,2
"2021","Caerphilly 002","W02000291",5779,2428,2256,2251,2236,15,5,2,3,127,127,0,548,548,0,420,419,1
"2021","Caerphilly 003","W02000292",4668,1862,1873,1863,1845,18,10,6,4,101,99,2,483,483,0,349,349,0
"2021","Caerphilly 004","W02000293",4876,2011,1846,1838,1825,13,8,4,4,126,125,1,530,529,1,363,363,0
"2021","Caerphilly 005","W02000294",4716,1617,2250,2237,2226,11,13,2,11,88,88,0,442,438,4,319,319,0
"2021","Caerphilly 006","W02000295",7672,2556,3733,3722,3712,10,11,2,9,144,144,0,703,702,1,536,535,1
"2021","Caerphilly 007","W02000296",6070,2275,2557,2546,2537,9,11,6,5,117,116,1,646,643,3,475,474,1
"2021","Caerphilly 008","W02000297",6212,2206,2873,2863,2841,22,10,4,6,114,111,3,587,587,0,432,432,0
"2021","Caerphilly 009","W02000298",5865,2112,2698,2694,2679,15,4,2,2,123,123,0,540,538,2,392,392,0
"2021","Caerphilly 010","W02000299",5122,1766,2356,2348,2327,21,8,4,4,98,96,2,518,516,2,384,384,0
"2021","Caerphilly 011","W02000300",6882,2413,3119,3114,3103,11,5,0,5,147,147,0,675,675,0,528,528,0
"2021","Caerphilly 012","W02000301",6399,2440,2896,2887,2874,13,9,6,3,116,116,0,564,559,5,383,382,1
"2021","Caerphilly 013","W02000302",8165,2745,3837,3825,3798,27,12,2,10,124,122,2,830,829,1,629,629,0
"2021","Caerphilly 014","W02000303",5801,2133,2575,2565,2548,17,10,3,7,128,127,1,608,607,1,357,357,0
"2021","Caerphilly 015","W02000304",4547,1662,2006,1997,1973,24,9,4,5,111,109,2,453,453,0,315,315,0
"2021","Caerphilly 016","W02000305",5034,1870,2182,2167,2158,9,15,6,9,110,108,2,525,525,0,347,347,0
"2021","Caerphilly 017","W02000306",4273,1548,1802,1796,1791,5,6,0,6,90,90,0,483,483,0,350,350,0
"2021","Caerphilly 018","W02000307",5075,2179,1956,1952,1938,14,4,2,2,129,128,1,516,516,0,295,295,0
"2021","Caerphilly 019","W02000308",7121,2695,3068,3051,3038,13,17,8,9,140,140,0,750,749,1,468,468,0
"2021","Caerphilly 020","W02000309",5557,1878,2589,2585,2572,13,4,0,4,106,105,1,532,532,0,452,452,0
"2021","Caerphilly 021","W02000310",4219,1434,2028,2015,1998,17,13,6,7,86,86,0,401,400,1,270,269,1
"2021","Caerphilly 022","W02000311",7846,2947,3320,3305,3290,15,15,2,13,153,152,1,923,923,0,503,502,1
"2021","Caerphilly 023","W02000312",5966,2084,2709,2699,2684,15,10,6,4,102,100,2,622,618,4,449,449,0
"2021","Caerphilly 024","W02000313",8585,2827,4226,4208,4186,22,18,4,14,161,159,2,797,794,3,574,574,0
"2021","Blaenau Gwent 001","W02000314",5446,1947,2433,2431,2417,14,2,0,2,107,104,3,502,499,3,457,456,1
"2021","Blaenau Gwent 002","W02000315",4334,1650,1738,1722,1708,14,16,2,14,101,99,2,501,500,1,344,343,1
"2021","Blaenau Gwent 003","W02000316",5511,2053,2381,2369,2355,14,12,5,7,142,141,1,500,499,1,435,434,1
"2021","Blaenau Gwent 004","W02000317",6405,2484,2638,2622,2609,13,16,6,10,143,143,0,658,656,2,482,482,0
"2021","Blaenau Gwent 005","W02000318",7425,2791,3130,3120,3105,15,10,2,8,177,174,3,759,757,2,568,568,0
"2021","Blaenau Gwent 006","W02000319",6670,2686,2602,2592,2575,17,10,2,8,155,152,3,743,743,0,484,484,0
"2021","Blaenau Gwent 007","W02000320",6738,2773,2616,2604,2587,17,12,8,4,165,165,0,701,699,2,483,482,1
"2021","Blaenau Gwent 008","W02000321",7090,2701,2930,2922,2913,9,8,0,8,160,157,3,736,736,0,563,562,1
"2021","Blaenau Gwent 009","W02000322",5533,2238,2133,2113,2098,15,20,6,14,137,136,1,639,636,3,386,386,0
"2021","Torfaen 001","W02000323",4819,1940,1935,1923,1910,13,12,8,4,111,109,2,461,460,1,372,372,0
"2021","Torfaen 002","W02000324",5610,2154,2313,2302,2298,4,11,4,7,123,123,0,578,577,1,442,442,0
"2021","Torfaen 003","W02000325",5717,2394,2235,2220,2209,11,15,6,9,166,161,5,541,537,4,381,381,0
"2021","Torfaen 004","W02000326",7289,2708,3015,3000,2981,19,15,4,11,196,196,0,824,817,7,546,544,2
"2021","Torfaen 005","W02000327",5015,1344,2668,2656,2646,10,12,0,12,82,82,0,509,509,0,412,412,0
"2021","Torfaen 006","W02000328",6197,2068,2985,2977,2946,31,8,2,6,112,109,3,609,609,0,423,422,1
"2021","Torfaen 007","W02000329",6594,2450,2782,2775,2763,12,7,0,7,134,134,0,772,771,1,456,456,0
"2021","Torfaen 008","W02000330",5899,1831,2741,2732,2722,10,9,4,5,116,116,0,656,656,0,555,555,0
"2021","Torfaen 009","W02000331",4985,2119,1869,1847,1837,10,22,6,16,117,114,3,582,581,1,298,298,0
"2021","Torfaen 010","W02000332",6167,2441,2300,2286,2271,15,14,6,8,129,129,0,787,787,0,510,508,2
"2021","Torfaen 011","W02000333",5093,1762,2408,2398,2381,17,10,2,8,108,106,2,521,520,1,294,294,0
"2021","Torfaen 012","W02000334",5489,1657,2858,2848,2839,9,10,2,8,89,89,0,558,556,2,327,327,0
"2021","Torfaen 013","W02000335",6240,1940,3195,3182,3161,21,13,0,13,106,106,0,560,560,0,439,439,0
"2021","Monmouthshire 001","W02000336",7400,2075,3692,3657,3640,17,35,19,16,147,145,2,845,844,1,641,640,1
"2021","Monmouthshire 002","W02000337",6223,2211,2582,2565,2548,17,17,2,15,154,154,0,749,747,2,527,524,3
"2021","Monmouthshire 003","W02000338",7178,1962,3850,3824,3801,23,26,12,14,123,121,2,637,636,1,606,606,0
"2021","Monmouthshire 004","W02000339",9133,2729,4367,4349,4329,20,18,8,10,199,196,3,1049,1049,0,789,787,2
"2021","Monmouthshire 005","W02000340",6143,1467,3582,3573,3554,19,9,4,5,107,105,2,520,518,2,467,464,3
"2021","Monmouthshire 006","W02000341",7315,2012,3949,3929,3905,24,20,6,14,137,137,0,702,702,0,515,514,1
"2021","Monmouthshire 007","W02000342",7900,1881,4750,4718,4701,17,32,8,24,125,124,1,623,623,0,521,521,0
"2021","Monmouthshire 008","W02000343",6823,2471,2729,2717,2698,19,12,4,8,179,179,0,926,925,1,518,518,0
"2021","Monmouthshire 009","W02000344",7145,1785,4135,4126,4110,16,9,4,5,125,125,0,636,635,1,464,464,0
"2021","Monmouthshire 010","W02000345",6563,2125,3024,3012,2998,14,12,4,8,141,139,2,746,746,0,527,526,1
"2021","Monmouthshire 011","W02000346",6418,1917,3497,3485,3473,12,12,6,6,104,104,0,515,514,1,385,385,0
"2021","Newport 001","W02000347",6709,1961,3422,3410,3400,10,12,2,10,120,120,0,693,693,0,513,512,1
"2021","Newport 002","W02000348",6299,2094,2980,2972,2956,16,8,4,4,100,100,0,603,602,1,522,521,1
"2021","Newport 003","W02000349",6552,3018,2282,2263,2237,26,19,9,10,158,158,0,655,652,3,439,438,1
"2021","Newport 004","W02000350",8034,2587,4296,4286,4251,35,10,4,6,124,124,0,595,595,0,432,432,0
"2021","Newport 005","W02000351",4916,1895,2067,2061,2053,8,6,2,4,104,102,2,516,513,3,334,334,0
"2021","Newport 006","W02000352",5397,2429,1922,1918,1905,13,4,0,4,112,112,0,610,607,3,324,324,0
"2021","Newport 007","W02000353",5850,2407,2407,2398,2381,17,9,6,3,156,154,2,551,551,0,329,329,0
"2021","Newport 008","W02000354",4873,1686,2193,2190,2172,18,3,0,3,97,96,1,449,449,0,448,448,0
"2021","Newport 009","W02000355",8114,2410,4474,4466,4451,15,8,4,4,123,123,0,597,595,2,510,509,1
"2021","Newport 010","W02000356",4015,1842,1412,1402,1394,8,10,8,2,90,90,0,363,362,1,308,308,0
"2021","Newport 011","W02000357",6670,2796,2736,2724,2704,20,12,4,8,164,163,1,683,682,1,291,290,1
"2021","Newport 012","W02000358",5411,1626,2947,2937,2915,22,10,0,10,75,75,0,393,393,0,370,369,1
"2021","Newport 013","W02000359",9043,4171,3530,3517,3471,46,13,6,7,258,255,3,769,767,2,315,315,0
"2021","Newport 014","W02000360",5813,2753,1964,1937,1912,25,27,4,23,146,146,0,660,657,3,290,288,2
"2021","Newport 015","W02000361",9131,3954,3580,3564,3543,21,16,10,6,275,273,2,745,743,2,577,576,1
"2021","Newport 016","W02000362",5623,1805,2790,2781,2769,12,9,0,9,109,109,0,548,547,1,371,371,0
"2021","Newport 017","W02000363",4791,1768,1995,1985,1974,11,10,6,4,99,99,0,539,538,1,390,390,0
"2021","Newport 018","W02000364",7010,3060,2766,2752,2724,28,14,2,12,208,208,0,652,648,4,324,324,0
"2021","Newport 019","W02000365",6421,2765,2452,2441,2429,12,11,4,7,160,159,1,725,723,2,319,319,0
"2021","Newport 020","W02000366",6755,1995,3638,3620,3598,22,18,5,13,118,118,0,616,616,0,388,388,0
"2021","Powys 001","W02000097",7877,2315,4104,4070,4051,19,34,6,28,123,123,0,731,730,1,604,604,0
"2021","Powys 002","W02000098",5313,1470,2880,2873,2869,4,7,2,5,84,83,1,477,477,0,402,401,1
"2021","Powys 003","W02000099",5534,2134,2069,2062,2049,13,7,0,7,146,146,0,695,695,0,490,490,0
"2021","Powys 004","W02000100",5268,1717,2573,2555,2543,12,18,8,10,90,90,0,519,518,1,369,367,2
"2021","Powys 005","W02000101",4715,1331,2498,2479,2467,12,19,4,15,82,82,0,442,442,0,362,361,1
"2021","Powys 006","W02000102",5200,1522,2763,2753,2752,1,10,2,8,70,70,0,485,485,0,360,360,0
"2021","Powys 007","W02000103",4926,1376,2672,2651,2639,12,21,8,13,91,91,0,399,398,1,388,384,4
"2021","Powys 008","W02000104",5215,1840,2226,2215,2205,10,11,0,11,135,134,1,598,598,0,416,416,0
"2021","Powys 009","W02000105",3968,1707,1416,1409,1406,3,7,0,7,118,115,3,462,461,1,265,265,0
"2021","Powys 010","W02000106",5491,1622,2736,2731,2723,8,5,0,5,133,133,0,570,569,1,430,430,0
"2021","Powys 011","W02000107",8431,2368,4340,4313,4291,22,27,17,10,178,178,0,867,866,1,678,678,0
"2021","Powys 012","W02000108",6143,1736,3147,3145,3132,13,2,0,2,140,136,4,580,580,0,540,540,0
"2021","Powys 013","W02000109",4740,1660,1958,1949,1941,8,9,4,5,127,127,0,565,565,0,430,430,0
"2021","Powys 014","W02000110",5820,1759,2884,2861,2848,13,23,10,13,141,139,2,578,577,1,458,458,0
"2021","Powys 015","W02000111",7235,2226,3436,3409,3396,13,27,10,17,155,155,0,818,817,1,600,596,4
"2021","Powys 017","W02000113",6895,2442,2923,2909,2897,12,14,6,8,165,165,0,802,802,0,563,561,2
"2021","Powys 018","W02000114",5968,1441,3370,3354,3344,10,16,7,9,99,99,0,560,558,2,498,497,1
"2021","Powys 020","W02000414",5108,1317,2915,2887,2874,13,28,2,26,90,90,0,417,416,1,369,369,0
"2021","Powys 021","W02000416",8674,2707,4069,4052,4038,14,17,2,15,177,175,2,909,907,2,812,809,3
"2021","Merthyr Tydfil 002","W02000284",7624,3147,3041,3030,3007,23,11,8,3,194,194,0,708,706,2,534,534,0
"2021","Merthyr Tydfil 003","W02000285",6855,2265,3368,3345,3338,7,23,14,9,119,119,0,603,598,5,500,500,0
"2021","Merthyr Tydfil 004","W02000286",5484,2352,1958,1950,1938,12,8,2,6,148,147,1,634,625,9,392,391,1
"2021","Merthyr Tydfil 005","W02000287",6769,2554,2952,2943,2930,13,9,4,5,127,127,0,638,638,0,498,498,0
"2021","Merthyr Tydfil 006","W02000288",6639,2675,2609,2588,2573,15,21,10,11,153,153,0,663,662,1,539,539,0
"2021","Merthyr Tydfil 007","W02000289",7130,2522,3337,3327,3299,28,10,4,6,142,141,1,645,644,1,484,483,1
"2021","Merthyr Tydfil 008","W02000415",7169,3214,2666,2641,2637,4,25,16,9,175,174,1,641,640,1,473,473,0
