"date","geography","geography code","Household composition: Total; measures: Value","Household composition: One person household; measures: Value","Household composition: One person household: Aged 66 years and over; measures: Value","Household composition: One person household: Other; measures: Value","Household composition: Single family household; measures: Value","Household composition: Single family household: All aged 66 years and over; measures: Value","Household composition: Single family household: Married or civil partnership couple; measures: Value","Household composition: Single family household: Married or civil partnership couple: No children; measures: Value","Household composition: Single family household: Married or civil partnership couple: Dependent children; measures: Value","Household composition: Single family household: Married or civil partnership couple: All children non-dependent; measures: Value","Household composition: Single family household: Cohabiting couple family; measures: Value","Household composition: Single family household: Cohabiting couple family: No children; measures: Value","Household composition: Single family household: Cohabiting couple family: With dependent children; measures: Value","Household composition: Single family household: Cohabiting couple family: All children non-dependent; measures: Value","Household composition: Single family household: Lone parent family; measures: Value","Household composition: Single family household: Lone parent family: With dependent children; measures: Value","Household composition: Single family household: Lone parent family: All children non-dependent; measures: Value","Household composition: Single family household: Other single family household; measures: Value","Household composition: Single family household: Other single family household: Other family composition; measures: Value","Household composition: Other household types; measures: Value","Household composition: Other household types: With dependent children; measures: Value","Household composition: Other household types: Other, including all full-time students and all aged 66 years and over; measures: Value"
"2021","Hartlepool 001","E02002483",4330,1183,568,615,3040,411,1463,499,647,317,649,274,335,40,507,354,153,10,10,107,53,54
"2021","Hartlepool 002","E02002484",4592,1655,612,1043,2778,257,1055,459,370,226,595,255,286,54,838,611,227,33,33,159,68,91
"2021","Hartlepool 003","E02002485",3542,1202,516,686,2222,226,839,325,304,210,447,186,220,41,684,498,186,26,26,118,63,55
"2021","Hartlepool 007","E02002489",3242,1461,446,1015,1605,177,674,268,266,140,305,129,157,19,424,270,154,25,25,176,81,95
"2021","Hartlepool 008","E02002490",2645,947,315,632,1580,190,600,251,209,140,345,144,171,30,430,296,134,15,15,118,48,70
"2021","Hartlepool 009","E02002491",2811,966,460,506,1727,239,700,264,262,174,330,116,185,29,445,309,136,13,13,118,65,53
"2021","Hartlepool 010","E02002492",2974,965,419,546,1915,263,822,337,304,181,418,189,194,35,405,274,131,7,7,94,50,44
"2021","Hartlepool 011","E02002493",2953,827,460,367,2046,422,1007,408,376,223,354,164,170,20,258,150,108,5,5,80,40,40
"2021","Hartlepool 012","E02002494",3388,1127,424,703,2143,199,695,287,236,172,445,166,240,39,787,613,174,17,17,118,58,60
"2021","Hartlepool 014","E02006909",5510,1411,808,603,3940,842,2108,860,787,461,626,315,259,52,352,207,145,12,12,159,65,94
"2021","Hartlepool 015","E02007059",4944,1873,620,1253,2853,441,1326,543,514,269,562,303,218,41,496,304,192,28,28,218,96,122
"2021","Middlesbrough 001","E02002496",4458,1962,403,1559,1844,59,874,217,553,104,287,170,104,13,483,298,185,141,141,652,162,490
"2021","Middlesbrough 002","E02002497",2744,1067,319,748,1497,86,463,181,192,90,327,145,156,26,572,444,128,49,49,180,74,106
"2021","Middlesbrough 003","E02002498",3641,1440,344,1096,1657,88,579,161,346,72,310,186,110,14,576,398,178,104,104,544,141,403
"2021","Middlesbrough 004","E02002499",3067,890,332,558,2033,122,661,218,268,175,411,129,242,40,807,572,235,32,32,144,87,57
"2021","Middlesbrough 005","E02002500",2336,772,252,520,1373,144,634,197,327,110,232,114,88,30,329,200,129,34,34,191,94,97
"2021","Middlesbrough 006","E02002501",2606,872,307,565,1609,116,677,209,340,128,305,135,147,23,490,347,143,21,21,125,68,57
"2021","Middlesbrough 007","E02002502",4354,1674,666,1008,2499,241,824,307,294,223,492,186,256,50,888,653,235,54,54,181,93,88
"2021","Middlesbrough 008","E02002503",2742,776,295,481,1823,129,704,229,313,162,375,134,196,45,593,421,172,22,22,143,92,51
"2021","Middlesbrough 009","E02002504",3775,1144,418,726,2378,269,1212,355,601,256,433,222,177,34,445,278,167,19,19,253,153,100
"2021","Middlesbrough 010","E02002505",2646,769,278,491,1764,120,489,167,182,140,350,103,195,52,783,576,207,22,22,113,61,52
"2021","Middlesbrough 011","E02002506",2329,888,305,583,1334,105,456,151,199,106,255,85,137,33,503,357,146,15,15,107,50,57
"2021","Middlesbrough 012","E02002507",2557,716,360,356,1737,290,879,282,414,183,288,123,140,25,270,161,109,10,10,104,56,48
"2021","Middlesbrough 013","E02002508",2277,694,418,276,1482,281,747,246,327,174,231,115,95,21,212,107,105,11,11,101,62,39
"2021","Middlesbrough 014","E02002509",2254,716,311,405,1439,194,566,246,189,131,285,130,129,26,378,245,133,16,16,99,59,40
"2021","Middlesbrough 015","E02002510",3117,849,489,360,2191,453,1009,371,421,217,444,217,200,27,277,171,106,8,8,77,41,36
"2021","Middlesbrough 017","E02002512",2305,602,345,257,1639,383,841,306,347,188,250,127,112,11,160,87,73,5,5,64,40,24
"2021","Middlesbrough 018","E02002513",4524,1529,613,916,2844,408,1110,457,432,221,676,323,316,37,617,422,195,33,33,151,72,79
"2021","Middlesbrough 019","E02002514",3790,1386,631,755,2270,318,1119,454,433,232,389,183,170,36,434,288,146,10,10,134,58,76
"2021","Middlesbrough 020","E02006811",4729,1220,656,564,3335,687,1797,587,874,336,494,243,226,25,348,209,139,9,9,174,82,92
"2021","Redcar and Cleveland 001","E02002515",3137,1455,454,1001,1539,165,586,231,226,129,327,156,150,21,434,277,157,27,27,143,53,90
"2021","Redcar and Cleveland 002","E02002516",2563,791,391,400,1678,216,697,263,273,161,351,133,182,36,404,277,127,10,10,94,44,50
"2021","Redcar and Cleveland 003","E02002517",2387,816,387,429,1468,183,611,250,222,139,300,116,154,30,363,239,124,11,11,103,55,48
"2021","Redcar and Cleveland 004","E02002518",4766,1353,716,637,3284,560,1711,660,672,379,597,292,271,34,401,225,176,15,15,129,55,74
"2021","Redcar and Cleveland 005","E02002519",3393,1300,673,627,1985,322,797,304,333,160,367,143,192,32,485,329,156,14,14,108,57,51
"2021","Redcar and Cleveland 006","E02002520",5954,1868,1069,799,3942,891,1818,681,731,406,641,313,276,52,574,338,236,18,18,144,70,74
"2021","Redcar and Cleveland 007","E02002521",2865,1174,584,590,1598,361,707,323,264,120,263,151,95,17,253,160,93,14,14,93,35,58
"2021","Redcar and Cleveland 009","E02002523",2677,909,300,609,1666,107,483,167,186,130,387,119,233,35,663,515,148,26,26,102,57,45
"2021","Redcar and Cleveland 010","E02002524",2383,677,317,360,1637,333,713,310,247,156,301,128,149,24,275,189,86,15,15,69,28,41
"2021","Redcar and Cleveland 011","E02002525",3797,1416,665,751,2253,353,916,413,273,230,417,214,154,49,545,349,196,22,22,128,64,64
"2021","Redcar and Cleveland 012","E02002526",3385,1002,468,534,2286,378,1068,445,413,210,437,182,220,35,393,245,148,10,10,97,48,49
"2021","Redcar and Cleveland 013","E02002527",2222,801,339,462,1342,180,528,236,186,106,299,103,177,19,329,217,112,6,6,79,46,33
"2021","Redcar and Cleveland 015","E02002529",2614,871,373,498,1669,298,743,279,255,209,290,136,126,28,331,249,82,7,7,74,33,41
"2021","Redcar and Cleveland 016","E02002530",2885,957,456,501,1838,374,783,385,226,172,359,164,164,31,311,202,109,11,11,90,43,47
"2021","Redcar and Cleveland 018","E02002532",3231,1299,561,738,1856,270,760,341,279,140,366,176,159,31,441,310,131,19,19,76,40,36
"2021","Redcar and Cleveland 019","E02002533",2852,738,384,354,2049,479,966,392,391,183,300,152,127,21,296,202,94,8,8,65,40,25
"2021","Redcar and Cleveland 020","E02002534",2501,646,418,228,1799,556,864,378,312,174,230,114,103,13,144,72,72,5,5,56,25,31
"2021","Redcar and Cleveland 021","E02006812",3446,1167,579,588,2149,413,856,344,317,195,390,165,176,49,474,307,167,16,16,130,71,59
"2021","Redcar and Cleveland 022","E02006910",4587,1425,605,820,2968,420,1219,460,450,309,616,269,291,56,686,465,221,27,27,194,103,91
"2021","Stockton-on-Tees 001","E02002535",4040,1151,534,617,2774,482,1533,648,571,314,428,236,166,26,322,186,136,9,9,115,62,53
"2021","Stockton-on-Tees 002","E02002536",4258,1482,686,796,2630,407,1164,494,439,231,486,220,233,33,550,350,200,23,23,146,75,71
"2021","Stockton-on-Tees 003","E02002537",3605,1183,458,725,2253,200,862,322,355,185,500,211,246,43,655,454,201,36,36,169,79,90
"2021","Stockton-on-Tees 004","E02002538",2449,758,378,380,1603,228,703,284,272,147,320,159,137,24,341,210,131,11,11,88,44,44
"2021","Stockton-on-Tees 005","E02002539",4301,916,485,431,3234,627,1854,732,810,312,473,263,192,18,272,170,102,8,8,151,69,82
"2021","Stockton-on-Tees 006","E02002540",2826,888,550,338,1876,455,924,380,358,186,313,181,113,19,177,116,61,7,7,62,22,40
"2021","Stockton-on-Tees 007","E02002541",2878,1118,451,667,1645,252,654,261,254,139,407,228,156,23,316,200,116,16,16,115,41,74
"2021","Stockton-on-Tees 008","E02002542",3365,1006,429,577,2204,217,779,264,321,194,479,170,226,83,703,432,271,26,26,155,78,77
"2021","Stockton-on-Tees 009","E02002543",3857,1186,436,750,2503,171,999,329,456,214,522,202,289,31,785,547,238,26,26,168,85,83
"2021","Stockton-on-Tees 010","E02002544",3569,1356,428,928,2062,206,737,305,267,165,545,287,228,30,543,394,149,31,31,151,92,59
"2021","Stockton-on-Tees 011","E02002545",2268,671,378,293,1528,333,721,297,258,166,263,131,119,13,208,104,104,3,3,69,36,33
"2021","Stockton-on-Tees 012","E02002546",3062,951,299,652,1893,145,789,265,345,179,368,159,184,25,570,383,187,21,21,218,88,130
"2021","Stockton-on-Tees 013","E02002547",2764,858,535,323,1827,441,904,394,324,186,253,105,133,15,220,126,94,9,9,79,43,36
"2021","Stockton-on-Tees 015","E02002549",3312,970,573,397,2240,563,1042,394,408,240,335,165,147,23,293,166,127,7,7,102,52,50
"2021","Stockton-on-Tees 016","E02002550",2582,785,361,424,1681,270,844,292,377,175,309,169,119,21,246,152,94,12,12,116,52,64
"2021","Stockton-on-Tees 017","E02002551",2628,1266,302,964,1225,97,435,153,177,105,276,138,125,13,384,288,96,33,33,137,48,89
"2021","Stockton-on-Tees 018","E02002552",3004,904,336,568,1977,237,855,315,377,163,419,167,207,45,449,315,134,17,17,123,57,66
"2021","Stockton-on-Tees 019","E02002553",2487,825,388,437,1567,231,710,269,298,143,342,130,194,18,278,184,94,6,6,95,47,48
"2021","Stockton-on-Tees 020","E02002554",2294,817,400,417,1403,234,515,214,181,120,286,146,111,29,358,239,119,10,10,74,48,26
"2021","Stockton-on-Tees 021","E02002555",4390,1260,667,593,3006,579,1547,521,759,267,461,237,198,26,409,270,139,10,10,124,69,55
"2021","Stockton-on-Tees 022","E02002556",2883,598,274,324,2145,354,1244,456,529,259,304,143,146,15,235,145,90,8,8,140,71,69
"2021","Stockton-on-Tees 024","E02002558",4886,1449,666,783,3325,701,1710,634,807,269,511,317,173,21,389,253,136,14,14,112,48,64
"2021","Stockton-on-Tees 025","E02007060",2862,1386,329,1057,1327,73,576,165,349,62,320,160,145,15,328,231,97,30,30,149,54,95
"2021","Stockton-on-Tees 026","E02007061",3195,1159,222,937,1794,82,813,238,475,100,431,235,170,26,437,297,140,31,31,242,163,79
"2021","Stockton-on-Tees 027","E02007062",2810,580,119,461,2131,88,1215,285,806,124,456,235,205,16,360,282,78,12,12,99,51,48
"2021","Stockton-on-Tees 028","E02007063",3180,455,127,328,2603,183,1733,450,994,289,399,167,210,22,279,206,73,9,9,122,80,42
"2021","Darlington 001","E02002559",4119,1054,468,586,2923,484,1537,598,706,233,556,319,205,32,336,227,109,10,10,142,62,80
"2021","Darlington 002","E02002560",2687,744,302,442,1869,280,849,309,358,182,349,169,152,28,378,276,102,13,13,74,39,35
"2021","Darlington 003","E02002561",2474,729,340,389,1681,352,815,384,272,159,278,141,119,18,225,132,93,11,11,64,36,28
"2021","Darlington 004","E02002562",2851,1325,415,910,1413,128,592,272,221,99,326,179,131,16,353,253,100,14,14,113,35,78
"2021","Darlington 005","E02002563",2471,781,417,364,1603,278,679,324,222,133,322,153,145,24,307,208,99,17,17,87,39,48
"2021","Darlington 006","E02002564",4351,1450,664,786,2738,334,1217,494,486,237,524,217,264,43,639,422,217,24,24,163,76,87
"2021","Darlington 009","E02002567",4111,1320,531,789,2615,273,997,388,436,173,622,302,291,29,700,509,191,23,23,176,90,86
"2021","Darlington 010","E02002568",2726,919,487,432,1732,372,954,362,460,132,231,137,84,10,161,95,66,14,14,75,26,49
"2021","Darlington 011","E02002569",4067,1165,841,324,2810,750,1504,573,666,265,327,168,135,24,221,114,107,8,8,92,48,44
"2021","Darlington 012","E02002570",3600,1524,515,1009,1914,211,724,336,241,147,428,214,179,35,532,356,176,19,19,162,68,94
"2021","Darlington 013","E02002571",2703,795,316,479,1788,195,743,286,322,135,398,176,204,18,433,311,122,19,19,120,51,69
"2021","Darlington 014","E02002572",2793,992,315,677,1642,151,675,236,314,125,346,171,146,29,447,302,145,23,23,159,66,93
"2021","Darlington 015","E02002573",3970,1029,552,477,2828,538,1488,583,655,250,448,259,168,21,347,232,115,7,7,113,58,55
"2021","Darlington 016","E02007058",5992,2889,686,2203,2839,258,1103,493,444,166,752,488,227,37,678,463,215,48,48,264,95,169
"2021","County Durham 002","E02004290",2591,737,345,392,1795,369,928,371,352,205,282,161,102,19,210,122,88,6,6,59,24,35
"2021","County Durham 005","E02004291",3352,1182,448,734,2085,261,929,395,345,189,450,229,191,30,436,298,138,9,9,85,32,53
"2021","County Durham 007","E02004292",3673,1128,617,511,2430,551,1109,457,429,223,415,239,155,21,345,211,134,10,10,115,51,64
"2021","County Durham 011","E02004293",4615,1913,716,1197,2581,310,1065,408,431,226,533,266,224,43,652,458,194,21,21,121,56,65
"2021","County Durham 013","E02004294",3655,1135,571,564,2458,507,1352,558,544,250,331,209,105,17,259,149,110,9,9,62,26,36
"2021","County Durham 015","E02004295",3289,955,507,448,2261,420,1076,444,411,221,339,182,128,29,419,264,155,7,7,73,37,36
"2021","County Durham 019","E02004296",3839,1274,499,775,2432,362,1056,437,401,218,500,249,215,36,500,324,176,14,14,133,64,69
"2021","County Durham 001","E02004297",3611,1134,504,630,2373,409,1135,473,459,203,461,241,188,32,359,221,138,9,9,104,43,61
"2021","County Durham 003","E02004298",4454,1280,634,646,3042,591,1507,631,571,305,495,272,196,27,437,284,153,12,12,132,65,67
"2021","County Durham 004","E02004299",3740,1265,578,687,2385,415,1087,475,402,210,468,229,188,51,406,265,141,9,9,90,43,47
"2021","County Durham 006","E02004300",3618,1336,592,744,2165,347,898,363,318,217,409,189,187,33,487,316,171,24,24,117,51,66
"2021","County Durham 008","E02004301",4282,1462,544,918,2697,277,1073,399,482,192,627,300,276,51,696,492,204,24,24,123,54,69
"2021","County Durham 009","E02004302",3792,1473,485,988,2188,299,857,393,281,183,453,218,196,39,561,387,174,18,18,131,62,69
"2021","County Durham 010","E02004303",5368,2129,794,1335,3076,449,1409,579,532,298,630,354,234,42,558,350,208,30,30,163,66,97
"2021","County Durham 012","E02004304",3930,1234,538,696,2562,335,1172,455,481,236,470,200,233,37,559,383,176,26,26,134,61,73
"2021","County Durham 014","E02004305",4461,1343,563,780,2990,362,1324,486,585,253,645,316,297,32,628,480,148,31,31,128,58,70
"2021","County Durham 020","E02004306",2761,884,511,373,1797,389,863,376,340,147,275,147,114,14,260,166,94,10,10,80,40,40
"2021","County Durham 024","E02004307",2926,937,405,532,1881,265,939,414,336,189,338,174,144,20,328,217,111,11,11,108,46,62
"2021","County Durham 022","E02004308",3037,900,463,437,2058,507,1108,446,470,192,235,124,89,22,202,111,91,6,6,79,32,47
"2021","County Durham 023","E02004309",2955,1166,491,675,1699,281,847,316,404,127,290,171,98,21,270,180,90,11,11,90,34,56
"2021","County Durham 026","E02004310",3587,1210,512,698,2280,367,1009,414,375,220,455,222,210,23,438,305,133,11,11,97,45,52
"2021","County Durham 027","E02004311",4251,1397,618,779,2740,460,1268,561,454,253,539,289,219,31,455,300,155,18,18,114,56,58
"2021","County Durham 028","E02004312",3502,1170,620,550,2233,624,1042,396,453,193,331,190,127,14,226,126,100,10,10,99,42,57
"2021","County Durham 029","E02004313",2965,1052,340,712,1466,169,537,219,193,125,321,193,106,22,401,263,138,38,38,447,45,402
"2021","County Durham 030","E02004314",2372,842,309,533,564,142,240,111,97,32,98,83,13,2,59,36,23,25,25,966,25,941
"2021","County Durham 033","E02004315",4730,1231,421,810,2954,418,1695,527,944,224,505,298,185,22,318,212,106,18,18,545,69,476
"2021","County Durham 031","E02004316",3040,1118,417,701,1828,246,861,373,335,153,368,194,153,21,337,248,89,16,16,94,45,49
"2021","County Durham 038","E02004317",3540,1392,604,788,2046,348,929,417,321,191,348,154,167,27,402,268,134,19,19,102,56,46
"2021","County Durham 041","E02004318",3051,1031,396,635,1922,302,938,401,365,172,356,202,136,18,310,194,116,16,16,98,28,70
"2021","County Durham 044","E02004319",3665,1177,481,696,2401,343,1141,464,474,203,515,295,196,24,398,286,112,4,4,87,42,45
"2021","County Durham 016","E02004320",3784,1113,525,588,2558,416,1330,539,522,269,407,187,184,36,392,253,139,13,13,113,65,48
"2021","County Durham 017","E02004321",3671,1348,559,789,2188,254,1014,411,383,220,417,194,186,37,483,316,167,20,20,135,58,77
"2021","County Durham 018","E02004322",3875,1258,572,686,2483,326,897,351,349,197,489,215,242,32,749,520,229,22,22,134,79,55
"2021","County Durham 021","E02004323",3363,1142,439,703,2112,266,1002,423,372,207,422,192,198,32,407,280,127,15,15,109,49,60
"2021","County Durham 025","E02004324",2699,941,349,592,1680,288,718,294,271,153,325,143,159,23,327,206,121,22,22,78,42,36
"2021","County Durham 032","E02004325",4059,1452,544,908,2466,202,861,350,314,197,540,237,261,42,779,553,226,84,84,141,72,69
"2021","County Durham 034","E02004326",3037,1040,403,637,1886,224,819,333,295,191,383,173,183,27,446,311,135,14,14,111,56,55
"2021","County Durham 036","E02004327",2774,1157,489,668,1536,245,582,275,163,144,270,120,132,18,420,295,125,19,19,81,34,47
"2021","County Durham 035","E02004328",3191,1008,417,591,2090,252,793,286,332,175,427,172,209,46,594,408,186,24,24,93,54,39
"2021","County Durham 037","E02004329",2869,840,383,457,1937,369,915,394,291,230,289,122,138,29,353,228,125,11,11,92,50,42
"2021","County Durham 039","E02004330",2897,1144,491,653,1677,308,695,336,190,169,284,122,141,21,382,249,133,8,8,76,38,38
"2021","County Durham 040","E02004331",3252,1073,447,626,2093,304,909,377,294,238,444,210,204,30,417,284,133,19,19,86,38,48
"2021","County Durham 043","E02004332",3259,990,390,600,2158,278,1003,418,372,213,426,206,188,32,434,302,132,17,17,111,60,51
"2021","County Durham 047","E02004333",3174,1021,520,501,2085,470,940,427,311,202,335,154,156,25,332,204,128,8,8,68,36,32
"2021","County Durham 048","E02004334",3183,1085,497,588,2018,275,934,404,334,196,390,164,198,28,407,261,146,12,12,80,34,46
"2021","County Durham 049","E02004335",3665,1302,446,856,2252,262,879,347,373,159,529,279,223,27,557,408,149,25,25,111,49,62
"2021","County Durham 050","E02004336",3307,1314,613,701,1925,347,809,376,250,183,370,189,159,22,387,243,144,12,12,68,31,37
"2021","County Durham 052","E02004337",4790,1625,638,987,3040,413,1468,582,598,288,615,311,269,35,522,371,151,22,22,125,49,76
"2021","County Durham 053","E02004338",3498,1283,450,833,2113,305,942,420,343,179,448,244,177,27,400,272,128,18,18,102,35,67
"2021","County Durham 054","E02004339",3158,961,487,474,2108,473,1084,402,480,202,302,159,124,19,245,167,78,4,4,89,37,52
"2021","County Durham 059","E02004340",4932,1955,795,1160,2834,388,1162,512,424,226,622,298,273,51,641,449,192,21,21,143,51,92
"2021","County Durham 060","E02004341",3853,1011,460,551,2734,507,1417,632,518,267,489,281,178,30,311,213,98,10,10,108,53,55
"2021","County Durham 061","E02004342",2404,817,310,507,1480,133,494,176,214,104,301,116,167,18,542,394,148,10,10,107,45,62
"2021","County Durham 062","E02004343",2567,921,413,508,1568,250,684,287,262,135,280,139,125,16,340,238,102,14,14,78,28,50
"2021","County Durham 063","E02004344",3233,1123,587,536,2008,366,863,392,291,180,349,145,169,35,406,266,140,24,24,102,46,56
"2021","County Durham 064","E02004345",5847,1887,983,904,3778,786,1826,843,640,343,620,345,231,44,524,306,218,22,22,182,85,97
"2021","County Durham 042","E02004348",3755,1228,642,586,2423,581,1139,559,367,213,382,219,139,24,306,200,106,15,15,104,41,63
"2021","County Durham 045","E02004349",4170,1389,608,781,2621,342,1108,415,434,259,526,222,265,39,627,432,195,18,18,160,72,88
"2021","County Durham 046","E02004350",4557,1573,635,938,2853,518,1323,616,484,223,537,269,236,32,464,315,149,11,11,131,65,66
"2021","County Durham 051","E02004351",3260,1135,469,666,2007,298,840,381,284,175,372,161,185,26,483,345,138,14,14,118,54,64
"2021","County Durham 055","E02004352",3895,1535,537,998,2237,284,964,405,357,202,439,223,189,27,522,388,134,28,28,123,52,71
"2021","County Durham 056","E02004353",3295,1109,554,555,2092,414,1028,429,371,228,316,149,137,30,325,214,111,9,9,94,39,55
"2021","County Durham 057","E02004354",4016,1214,508,706,2662,386,1199,493,464,242,536,266,235,35,532,391,141,9,9,140,61,79
"2021","County Durham 058","E02004355",3199,1116,452,664,1986,256,751,314,274,163,359,151,183,25,600,436,164,20,20,97,46,51
"2021","County Durham 067","E02007022",5609,1926,1013,913,3525,812,1779,887,609,283,500,289,182,29,421,268,153,13,13,158,67,91
"2021","Northumberland 004","E02005702",2961,803,448,355,2097,552,1117,539,403,175,245,150,85,10,173,106,67,10,10,61,24,37
"2021","Northumberland 005","E02005703",3460,1509,661,848,1896,368,842,377,286,179,376,186,162,28,300,179,121,10,10,55,26,29
"2021","Northumberland 006","E02005704",5905,1782,957,825,3978,889,1983,1033,609,341,592,300,234,58,493,289,204,21,21,145,58,87
"2021","Northumberland 007","E02005705",3585,1072,635,437,2423,642,1277,672,417,188,290,187,90,13,203,109,94,11,11,90,38,52
"2021","Northumberland 001","E02005706",4378,1712,791,921,2527,426,1035,460,365,210,467,221,220,26,570,397,173,29,29,139,63,76
"2021","Northumberland 002","E02005707",3267,977,575,402,2199,599,1064,526,326,212,317,159,138,20,211,105,106,8,8,91,35,56
"2021","Northumberland 003","E02005708",4955,1688,948,740,3109,851,1490,866,388,236,442,270,151,21,303,172,131,23,23,158,52,106
"2021","Northumberland 022","E02005709",3072,1221,389,832,1739,161,597,247,225,125,399,147,215,37,558,402,156,24,24,112,53,59
"2021","Northumberland 023","E02005710",4514,1922,669,1253,2473,318,1082,435,448,199,555,300,217,38,495,316,179,23,23,119,48,71
"2021","Northumberland 024","E02005711",3594,1229,604,625,2258,348,860,364,298,198,411,160,220,31,611,417,194,28,28,107,51,56
"2021","Northumberland 025","E02005712",4023,1130,374,756,2757,313,1282,486,550,246,611,328,259,24,530,394,136,21,21,136,68,68
"2021","Northumberland 026","E02005713",2765,686,401,285,2017,447,1083,471,394,218,273,155,101,17,211,133,78,3,3,62,31,31
"2021","Northumberland 029","E02005715",4097,1363,560,803,2583,342,1033,411,398,224,561,271,249,41,631,422,209,16,16,151,78,73
"2021","Northumberland 030","E02005717",3545,1198,662,536,2271,529,1076,483,384,209,312,177,122,13,343,182,161,11,11,76,32,44
"2021","Northumberland 031","E02005718",3098,1115,612,503,1924,566,857,365,307,185,253,133,103,17,242,138,104,6,6,59,25,34
"2021","Northumberland 032","E02005719",4046,1559,576,983,2416,405,1075,438,427,210,476,291,155,30,446,289,157,14,14,71,31,40
"2021","Northumberland 008","E02005720",5071,1626,751,875,3288,628,1506,771,450,285,620,308,270,42,520,295,225,14,14,157,73,84
"2021","Northumberland 011","E02005721",2485,817,388,429,1605,254,819,358,317,144,249,134,97,18,279,196,83,4,4,63,27,36
"2021","Northumberland 015","E02005722",4043,921,437,484,3006,548,1702,772,664,266,467,297,154,16,283,197,86,6,6,116,54,62
"2021","Northumberland 016","E02005723",3106,1339,741,598,1704,339,735,325,269,141,282,163,101,18,332,214,118,16,16,63,17,46
"2021","Northumberland 018","E02005724",2857,695,440,255,2104,575,1136,428,515,193,195,99,86,10,194,113,81,4,4,58,29,29
"2021","Northumberland 033","E02005725",3053,917,592,325,2028,518,1052,367,459,226,219,107,97,15,227,137,90,12,12,108,55,53
"2021","Northumberland 034","E02005726",3133,664,443,221,2354,626,1351,486,621,244,225,111,93,21,148,81,67,4,4,115,54,61
"2021","Northumberland 019","E02005727",2801,818,433,385,1890,414,1011,537,325,149,276,156,109,11,180,94,86,9,9,93,35,58
"2021","Northumberland 037","E02005728",3155,1039,555,484,2030,465,940,456,288,196,344,172,152,20,271,150,121,10,10,86,35,51
"2021","Northumberland 036","E02005729",2510,777,400,377,1666,364,900,357,371,172,215,127,76,12,181,107,74,6,6,67,34,33
"2021","Northumberland 035","E02005730",5985,2142,1125,1017,3674,818,1742,752,698,292,534,285,209,40,553,340,213,27,27,169,58,111
"2021","Northumberland 038","E02005731",4763,1499,693,806,3142,497,1570,592,690,288,508,250,223,35,555,333,222,12,12,122,54,68
"2021","Northumberland 040","E02005733",3725,1073,593,480,2551,577,1322,631,462,229,402,233,150,19,236,143,93,14,14,101,48,53
"2021","Northumberland 009","E02005734",2868,1084,523,561,1673,292,648,338,177,133,298,138,135,25,415,271,144,20,20,111,56,55
"2021","Northumberland 010","E02005735",3494,1461,418,1043,1931,215,669,274,249,146,395,179,192,24,629,464,165,23,23,102,42,60
"2021","Northumberland 013","E02005736",3936,1397,453,944,2415,356,1043,397,467,179,474,211,227,36,524,379,145,18,18,124,66,58
"2021","Northumberland 017","E02005739",4217,1371,656,715,2731,526,1212,542,397,273,467,240,189,38,507,319,188,19,19,115,51,64
"2021","Northumberland 020","E02005740",4730,1777,653,1124,2804,396,1175,515,409,251,578,261,267,50,635,437,198,20,20,149,60,89
"2021","Northumberland 021","E02005741",3785,1106,539,567,2584,491,1323,587,480,256,380,193,163,24,379,247,132,11,11,95,42,53
"2021","Northumberland 041","E02007105",5750,1847,801,1046,3766,630,1781,779,605,397,661,344,266,51,668,445,223,26,26,137,62,75
"2021","Northumberland 042","E02007106",6205,1611,693,918,4444,708,2374,838,1076,460,763,416,296,51,575,358,217,24,24,150,59,91
"2021","Northumberland 043","E02007107",3975,1202,762,440,2679,720,1404,614,546,244,306,182,105,19,240,143,97,9,9,94,36,58
"2021","Newcastle upon Tyne 002","E02001709",4404,1248,637,611,2974,554,1669,549,872,248,468,329,124,15,268,154,114,15,15,182,63,119
"2021","Newcastle upon Tyne 003","E02001710",4557,1696,643,1053,2655,262,1128,421,474,233,495,244,207,44,714,452,262,56,56,206,71,135
"2021","Newcastle upon Tyne 004","E02001711",4318,1457,568,889,2676,304,1101,378,465,258,551,264,242,45,693,450,243,27,27,185,90,95
"2021","Newcastle upon Tyne 005","E02001712",4148,1415,578,837,2486,393,1298,429,713,156,504,387,105,12,263,146,117,28,28,247,37,210
"2021","Newcastle upon Tyne 006","E02001713",4379,1388,623,765,2806,463,1556,492,835,229,459,325,122,12,306,187,119,22,22,185,60,125
"2021","Newcastle upon Tyne 007","E02001714",3973,1008,451,557,2769,377,1631,491,867,273,448,287,134,27,285,146,139,28,28,196,78,118
"2021","Newcastle upon Tyne 008","E02001715",4905,1582,614,968,3068,280,1385,425,742,218,533,241,235,57,840,606,234,30,30,255,118,137
"2021","Newcastle upon Tyne 011","E02001718",2961,1051,418,633,1805,181,743,247,347,149,408,203,174,31,453,275,178,20,20,105,50,55
"2021","Newcastle upon Tyne 012","E02001719",3766,1098,476,622,2414,351,1197,443,538,216,508,324,152,32,323,166,157,35,35,254,59,195
"2021","Newcastle upon Tyne 013","E02001720",3328,831,277,554,1109,161,506,214,209,83,328,280,41,7,72,37,35,42,42,1388,23,1365
"2021","Newcastle upon Tyne 014","E02001721",4946,1706,697,1009,3061,460,1298,521,502,275,594,304,253,37,690,455,235,19,19,179,78,101
"2021","Newcastle upon Tyne 015","E02001722",4149,1386,682,704,2606,384,1064,386,434,244,496,219,234,43,640,427,213,22,22,157,65,92
"2021","Newcastle upon Tyne 016","E02001723",2836,816,303,513,1818,140,865,223,491,151,311,164,127,20,480,329,151,22,22,202,104,98
"2021","Newcastle upon Tyne 017","E02001724",3555,1232,396,836,1185,155,456,202,193,61,462,416,44,2,75,36,39,37,37,1138,22,1116
"2021","Newcastle upon Tyne 018","E02001725",4375,1700,365,1335,1741,77,545,231,236,78,747,643,96,8,306,187,119,66,66,934,47,887
"2021","Newcastle upon Tyne 019","E02001726",4768,1504,652,852,2982,294,1460,402,730,328,501,238,214,49,700,415,285,27,27,282,142,140
"2021","Newcastle upon Tyne 020","E02001727",4026,1397,558,839,2465,394,1108,434,377,297,443,213,190,40,504,334,170,16,16,164,67,97
"2021","Newcastle upon Tyne 021","E02001728",4293,1431,572,859,2731,426,1114,415,468,231,539,271,235,33,628,421,207,24,24,131,59,72
"2021","Newcastle upon Tyne 022","E02001729",4087,1288,283,1005,2052,78,1143,251,768,124,352,222,114,16,379,212,167,100,100,747,237,510
"2021","Newcastle upon Tyne 025","E02001732",2460,825,314,511,1509,146,651,236,310,105,352,169,144,39,346,240,106,14,14,126,61,65
"2021","Newcastle upon Tyne 027","E02001734",3410,1152,417,735,2053,182,901,283,447,171,346,165,158,23,586,423,163,38,38,205,101,104
"2021","Newcastle upon Tyne 028","E02001735",2881,1004,371,633,1759,123,577,171,234,172,323,110,165,48,702,499,203,34,34,118,56,62
"2021","Newcastle upon Tyne 030","E02001737",2874,1209,419,790,1525,139,511,155,229,127,274,105,125,44,577,407,170,24,24,140,60,80
"2021","Newcastle upon Tyne 031","E02006893",4934,1521,915,606,3279,782,1523,560,586,377,523,244,250,29,431,222,209,20,20,134,53,81
"2021","Newcastle upon Tyne 032","E02007095",4133,1156,397,759,2813,205,1485,393,920,172,700,463,221,16,405,291,114,18,18,164,69,95
"2021","Newcastle upon Tyne 033","E02007096",2448,627,259,368,1720,250,959,321,460,178,291,177,94,20,207,112,95,13,13,101,42,59
"2021","Newcastle upon Tyne 034","E02007097",2749,960,239,721,972,67,329,131,162,36,368,303,58,7,162,103,59,46,46,817,24,793
"2021","Newcastle upon Tyne 035","E02007098",2995,1205,367,838,1594,171,569,222,223,124,357,167,158,32,466,299,167,31,31,196,63,133
"2021","Newcastle upon Tyne 036","E02007099",3273,1758,239,1519,1001,43,360,226,117,17,400,389,11,0,113,54,59,85,85,514,12,502
"2021","Newcastle upon Tyne 037","E02007100",2030,1057,191,866,665,44,209,98,88,23,247,225,19,3,128,74,54,37,37,308,12,296
"2021","Newcastle upon Tyne 038","E02007101",3152,920,210,710,1878,79,1047,181,750,116,278,88,182,8,418,285,133,56,56,354,201,153
"2021","Newcastle upon Tyne 039","E02007102",2502,1149,283,866,1031,49,442,105,249,88,236,166,61,9,244,148,96,60,60,322,63,259
"2021","Newcastle upon Tyne 040","E02007103",3042,1366,297,1069,1422,75,434,177,185,72,395,233,149,13,485,344,141,33,33,254,59,195
"2021","Newcastle upon Tyne 041","E02007104",2170,891,210,681,1071,37,513,106,316,91,152,81,53,18,345,210,135,24,24,208,80,128
"2021","North Tyneside 001","E02001738",2614,664,481,183,1892,564,1031,307,541,183,159,62,79,18,137,69,68,1,1,58,26,32
"2021","North Tyneside 002","E02001739",3443,1235,538,697,2125,355,991,419,332,240,364,174,169,21,394,251,143,21,21,83,38,45
"2021","North Tyneside 003","E02001740",2304,517,328,189,1719,323,1067,299,618,150,186,74,101,11,140,79,61,3,3,68,33,35
"2021","North Tyneside 004","E02001741",3746,1359,779,580,2320,499,1088,437,461,190,400,231,158,11,323,194,129,10,10,67,34,33
"2021","North Tyneside 005","E02001742",2604,809,459,350,1749,360,935,335,426,174,224,134,77,13,227,131,96,3,3,46,20,26
"2021","North Tyneside 006","E02001743",3274,1131,435,696,2009,237,1084,342,569,173,381,236,128,17,298,178,120,9,9,134,47,87
"2021","North Tyneside 007","E02001744",3686,1160,460,700,2430,264,1156,446,544,166,559,324,206,29,444,305,139,7,7,96,41,55
"2021","North Tyneside 008","E02001745",3045,981,435,546,1987,254,858,334,354,170,424,231,168,25,442,313,129,9,9,77,33,44
"2021","North Tyneside 009","E02001746",3627,1184,610,574,2320,336,1128,387,543,198,415,212,180,23,425,264,161,16,16,123,53,70
"2021","North Tyneside 010","E02001747",2894,980,631,349,1833,438,967,347,451,169,258,140,106,12,166,70,96,4,4,81,34,47
"2021","North Tyneside 011","E02001748",3719,1052,419,633,2561,253,1268,442,651,175,537,284,223,30,492,329,163,11,11,106,53,53
"2021","North Tyneside 012","E02001749",2953,1013,479,534,1864,333,912,365,371,176,333,171,142,20,275,183,92,11,11,76,36,40
"2021","North Tyneside 013","E02001750",2877,783,475,308,1994,407,1027,348,475,204,307,145,138,24,250,136,114,3,3,100,51,49
"2021","North Tyneside 014","E02001751",3011,933,437,496,1989,262,897,338,395,164,423,240,166,17,395,244,151,12,12,89,33,56
"2021","North Tyneside 015","E02001752",2844,961,430,531,1778,228,684,233,298,153,315,133,153,29,536,400,136,15,15,105,57,48
"2021","North Tyneside 016","E02001753",3163,1354,571,783,1732,325,802,332,367,103,338,244,78,16,257,150,107,10,10,77,26,51
"2021","North Tyneside 017","E02001754",2788,1010,427,583,1719,313,864,367,359,138,335,223,94,18,199,128,71,8,8,59,19,40
"2021","North Tyneside 018","E02001755",4306,1272,551,721,2904,390,1535,566,739,230,577,333,211,33,389,249,140,13,13,130,61,69
"2021","North Tyneside 019","E02001756",4380,1608,575,1033,2618,213,1090,421,493,176,680,418,228,34,591,386,205,44,44,154,60,94
"2021","North Tyneside 020","E02001757",2754,912,443,469,1757,323,807,355,282,170,291,149,120,22,322,198,124,14,14,85,35,50
"2021","North Tyneside 021","E02001758",2542,821,342,479,1658,267,812,308,329,175,256,110,131,15,313,218,95,10,10,63,28,35
"2021","North Tyneside 022","E02001759",3346,1647,524,1123,1598,216,672,295,276,101,400,282,104,14,286,176,110,24,24,101,24,77
"2021","North Tyneside 023","E02001760",3469,1282,388,894,2043,150,677,258,265,154,444,192,209,43,746,558,188,26,26,144,72,72
"2021","North Tyneside 024","E02001761",2587,894,426,468,1614,303,687,287,258,142,295,151,114,30,318,213,105,11,11,79,38,41
"2021","North Tyneside 025","E02001762",3073,932,351,581,2064,272,974,419,351,204,475,269,187,19,334,232,102,9,9,77,45,32
"2021","North Tyneside 026","E02001763",3000,1122,454,668,1767,211,684,264,246,174,399,177,185,37,450,306,144,23,23,111,46,65
"2021","North Tyneside 027","E02001764",3857,1837,494,1343,1888,202,738,332,272,134,416,239,149,28,506,367,139,26,26,132,55,77
"2021","North Tyneside 028","E02001765",3526,1318,472,846,2072,162,807,324,346,137,471,218,226,27,598,453,145,34,34,136,58,78
"2021","North Tyneside 029","E02001766",3441,1403,346,1057,1925,173,797,272,369,156,484,282,177,25,434,297,137,37,37,113,44,69
"2021","North Tyneside 030","E02001767",3358,1378,509,869,1861,197,754,300,284,170,437,267,144,26,450,287,163,23,23,119,47,72
"2021","South Tyneside 001","E02001768",3682,1543,522,1021,1964,226,952,338,456,158,358,224,103,31,404,238,166,24,24,175,87,88
"2021","South Tyneside 002","E02001769",3958,2032,542,1490,1788,174,700,296,292,112,377,226,126,25,510,340,170,27,27,138,53,85
"2021","South Tyneside 003","E02001770",2980,1310,467,843,1594,237,732,316,248,168,332,202,116,14,283,171,112,10,10,76,31,45
"2021","South Tyneside 004","E02001771",2775,909,489,420,1796,299,795,334,264,197,256,92,147,17,435,305,130,11,11,70,37,33
"2021","South Tyneside 005","E02001772",2409,951,398,553,1392,228,625,236,249,140,249,139,94,16,281,169,112,9,9,66,30,36
"2021","South Tyneside 006","E02001773",2361,646,412,234,1662,393,837,339,298,200,220,103,96,21,206,120,86,6,6,53,22,31
"2021","South Tyneside 007","E02001774",2524,1070,337,733,1371,195,516,209,183,124,274,146,107,21,371,246,125,15,15,83,40,43
"2021","South Tyneside 008","E02001775",2403,799,456,343,1535,197,629,221,246,162,247,91,127,29,446,296,150,16,16,69,29,40
"2021","South Tyneside 009","E02001776",4129,1412,503,909,2587,270,1040,386,441,213,585,292,245,48,665,459,206,27,27,130,59,71
"2021","South Tyneside 010","E02001777",3047,1028,353,675,1927,225,926,348,385,193,461,267,168,26,295,195,100,20,20,92,40,52
"2021","South Tyneside 011","E02001778",2861,1290,416,874,1476,163,536,225,182,129,315,159,132,24,439,292,147,23,23,95,38,57
"2021","South Tyneside 012","E02001779",2524,983,396,587,1468,195,583,249,208,126,281,137,117,27,392,257,135,17,17,73,24,49
"2021","South Tyneside 013","E02001780",2685,846,447,399,1751,283,776,266,338,172,278,123,137,18,403,268,135,11,11,88,35,53
"2021","South Tyneside 014","E02001781",2558,964,377,587,1526,144,529,218,195,116,307,135,152,20,524,380,144,22,22,68,34,34
"2021","South Tyneside 015","E02001782",4484,1439,706,733,2910,322,1279,441,566,272,617,258,311,48,667,444,223,25,25,135,69,66
"2021","South Tyneside 016","E02001783",3154,922,352,570,2131,197,714,248,300,166,401,134,225,42,811,614,197,8,8,101,56,45
"2021","South Tyneside 017","E02001784",2912,951,491,460,1864,266,748,262,275,211,323,128,159,36,508,319,189,19,19,97,49,48
"2021","South Tyneside 018","E02001785",3527,1208,714,494,2231,407,1071,402,417,252,325,154,140,31,413,254,159,15,15,88,39,49
"2021","South Tyneside 019","E02001786",3106,1119,463,656,1901,264,814,333,268,213,327,124,173,30,477,305,172,19,19,86,37,49
"2021","South Tyneside 020","E02001787",2419,762,354,408,1585,313,650,249,246,155,230,107,97,26,383,247,136,9,9,72,31,41
"2021","South Tyneside 021","E02001788",2665,901,356,545,1707,244,784,320,286,178,327,160,143,24,345,228,117,7,7,57,28,29
"2021","South Tyneside 022","E02001789",2497,658,450,208,1774,421,995,333,447,215,204,109,86,9,147,75,72,7,7,65,37,28
"2021","South Tyneside 023","E02001790",2622,802,481,321,1758,317,873,307,400,166,302,138,132,32,257,152,105,9,9,62,28,34
"2021","Sunderland 001","E02001791",2410,633,369,264,1700,312,928,344,341,243,274,158,105,11,177,75,102,9,9,77,43,34
"2021","Sunderland 002","E02001792",3036,874,494,380,2116,444,1140,460,398,282,295,161,116,18,232,102,130,5,5,46,25,21
"2021","Sunderland 003","E02001793",3832,1439,564,875,2286,175,772,292,276,204,564,225,268,71,747,539,208,28,28,107,56,51
"2021","Sunderland 004","E02001794",3874,1263,531,732,2468,304,835,321,291,223,493,181,251,61,809,559,250,27,27,143,68,75
"2021","Sunderland 005","E02001795",3528,1446,569,877,1983,249,778,300,295,183,420,181,198,41,516,316,200,20,20,99,45,54
"2021","Sunderland 006","E02001796",4234,1775,750,1025,2307,399,993,437,332,224,452,253,163,36,440,225,215,23,23,152,54,98
"2021","Sunderland 007","E02001797",2574,733,343,390,1770,357,903,328,365,210,303,157,128,18,202,111,91,5,5,71,33,38
"2021","Sunderland 008","E02001798",3540,1035,444,591,2378,287,1002,406,360,236,466,187,226,53,602,418,184,21,21,127,65,62
"2021","Sunderland 009","E02001799",4255,1481,583,898,2611,272,926,383,334,209,554,232,275,47,822,582,240,37,37,163,81,82
"2021","Sunderland 010","E02001800",2981,924,426,498,1962,339,849,339,313,197,369,168,164,37,401,243,158,4,4,95,52,43
"2021","Sunderland 011","E02001801",2361,857,267,590,1360,111,638,211,297,130,242,136,89,17,332,201,131,37,37,144,76,68
"2021","Sunderland 012","E02001802",3144,978,430,548,2022,175,692,238,280,174,486,181,261,44,637,458,179,32,32,144,83,61
"2021","Sunderland 013","E02001803",3874,1968,509,1459,1625,134,682,275,315,92,436,321,99,16,307,161,146,66,66,281,71,210
"2021","Sunderland 014","E02001804",2732,860,365,495,1778,241,746,295,267,184,336,143,150,43,439,274,165,16,16,94,58,36
"2021","Sunderland 015","E02001805",2450,747,395,352,1593,303,742,287,258,197,271,135,107,29,257,140,117,20,20,110,51,59
"2021","Sunderland 016","E02001806",3816,1895,606,1289,1714,166,641,239,266,136,386,213,152,21,487,318,169,34,34,207,97,110
"2021","Sunderland 017","E02001807",3572,985,377,608,2475,320,1217,412,586,219,472,197,241,34,454,307,147,12,12,112,54,58
"2021","Sunderland 018","E02001808",2303,766,318,448,1361,177,691,209,341,141,230,125,89,16,243,137,106,20,20,176,80,96
"2021","Sunderland 019","E02001809",2975,969,509,460,1940,434,837,326,317,194,319,131,161,27,342,219,123,8,8,66,23,43
"2021","Sunderland 020","E02001810",3718,1152,466,686,2452,425,1120,457,403,260,494,235,224,35,405,251,154,8,8,114,42,72
"2021","Sunderland 021","E02001811",3985,1393,611,782,2440,333,870,318,316,236,508,200,253,55,694,465,229,35,35,152,87,65
"2021","Sunderland 022","E02001812",4269,1167,683,484,2936,685,1598,598,630,370,373,209,135,29,261,121,140,19,19,166,92,74
"2021","Sunderland 023","E02001813",4145,1317,470,847,2652,240,931,297,377,257,581,202,305,74,866,593,273,34,34,176,96,80
"2021","Sunderland 024","E02001814",2687,867,380,487,1733,213,801,275,312,214,293,131,134,28,411,255,156,15,15,87,54,33
"2021","Sunderland 025","E02001815",4248,1080,548,532,3008,652,1539,662,571,306,389,200,150,39,409,232,177,19,19,160,86,74
"2021","Sunderland 026","E02001816",3426,1452,647,805,1880,265,710,319,231,160,395,189,165,41,491,330,161,19,19,94,52,42
"2021","Sunderland 027","E02001817",2962,967,491,476,1895,266,836,307,328,201,365,139,192,34,405,256,149,23,23,100,52,48
"2021","Sunderland 028","E02001818",4060,1201,502,699,2703,301,1232,429,554,249,560,250,275,35,597,415,182,13,13,156,71,85
"2021","Sunderland 029","E02001819",3121,876,536,340,2149,514,1070,415,374,281,311,162,126,23,245,130,115,9,9,96,48,48
"2021","Sunderland 030","E02001820",4107,1078,518,560,2923,381,1403,524,615,264,597,275,284,38,532,353,179,10,10,106,53,53
"2021","Sunderland 031","E02001821",2419,649,308,341,1691,249,905,350,317,238,289,138,133,18,241,141,100,7,7,79,43,36
"2021","Sunderland 032","E02001822",3304,942,402,540,2235,294,1146,453,435,258,435,223,174,38,345,227,118,15,15,127,57,70
"2021","Sunderland 033","E02001823",3523,1058,435,623,2365,283,1051,402,437,212,525,248,246,31,492,331,161,14,14,100,53,47
"2021","Sunderland 034","E02001824",3903,1294,687,607,2496,454,1086,444,417,225,435,189,202,44,498,336,162,23,23,113,50,63
"2021","Sunderland 035","E02001825",3554,1219,595,624,2248,395,966,423,301,242,467,248,182,37,404,262,142,16,16,87,46,41
"2021","Sunderland 036","E02001826",3258,1024,404,620,2130,278,883,361,356,166,456,184,246,26,502,349,153,11,11,104,61,43
"2021","Gateshead 001","E02001682",3790,1144,546,598,2537,440,1210,448,543,219,469,242,189,38,410,252,158,8,8,109,40,69
"2021","Gateshead 002","E02001683",4272,1311,564,747,2866,499,1357,564,532,261,570,344,196,30,426,268,158,14,14,95,43,52
"2021","Gateshead 003","E02001684",3146,1226,408,818,1772,213,638,239,283,116,440,259,145,36,449,303,146,32,32,148,54,94
"2021","Gateshead 004","E02001685",3664,1264,516,748,2273,255,881,348,363,170,540,274,229,37,571,373,198,26,26,127,55,72
"2021","Gateshead 005","E02001686",3153,1086,503,583,1969,383,939,417,333,189,339,174,140,25,297,153,144,11,11,98,45,53
"2021","Gateshead 007","E02001688",3808,1669,442,1227,1972,141,774,299,337,138,584,394,165,25,455,303,152,18,18,167,54,113
"2021","Gateshead 008","E02001689",3109,1237,389,848,1606,154,737,226,386,125,313,203,91,19,369,229,140,33,33,266,109,157
"2021","Gateshead 009","E02001690",3217,1113,429,684,2009,319,958,354,401,203,352,198,126,28,363,224,139,17,17,95,38,57
"2021","Gateshead 010","E02001691",3807,1444,311,1133,2082,150,858,285,443,130,583,407,159,17,443,278,165,48,48,281,89,192
"2021","Gateshead 011","E02001692",2711,837,274,563,1744,136,636,223,261,152,377,168,166,43,567,393,174,28,28,130,64,66
"2021","Gateshead 012","E02001693",2552,1026,453,573,1427,202,567,225,201,141,267,132,111,24,374,228,146,17,17,99,39,60
"2021","Gateshead 013","E02001694",2787,823,381,442,1868,280,871,323,327,221,347,196,133,18,350,194,156,20,20,96,34,62
"2021","Gateshead 014","E02001695",2643,825,425,400,1760,316,906,380,357,169,295,160,110,25,238,134,104,5,5,58,25,33
"2021","Gateshead 015","E02001696",3959,1141,580,561,2669,336,1084,397,445,242,500,214,234,52,724,463,261,25,25,149,81,68
"2021","Gateshead 016","E02001697",3327,1025,464,561,2200,342,1146,418,531,197,410,261,119,30,285,154,131,17,17,102,39,63
"2021","Gateshead 017","E02001698",3193,966,651,315,2163,663,1075,358,498,219,220,119,88,13,201,104,97,4,4,64,23,41
"2021","Gateshead 018","E02001699",3035,1062,530,532,1889,284,811,319,294,198,374,178,162,34,410,237,173,10,10,84,45,39
"2021","Gateshead 019","E02001700",4543,1324,664,660,3088,528,1406,518,621,267,566,289,226,51,559,343,216,29,29,131,60,71
"2021","Gateshead 020","E02001701",2729,871,480,391,1785,366,943,286,438,219,288,172,99,17,176,97,79,12,12,73,33,40
"2021","Gateshead 021","E02001702",3475,1236,514,722,2107,205,775,256,325,194,407,164,207,36,685,457,228,35,35,132,65,67
"2021","Gateshead 022","E02001703",2495,737,472,265,1683,372,841,329,328,184,236,119,87,30,228,128,100,6,6,75,29,46
"2021","Gateshead 023","E02001704",3297,1336,550,786,1855,276,743,277,281,185,371,177,157,37,445,250,195,20,20,106,42,64
"2021","Gateshead 025","E02001706",3372,947,449,498,2327,282,1082,389,504,189,459,230,187,42,487,325,162,17,17,98,48,50
"2021","Gateshead 026","E02001707",3693,1197,580,617,2371,424,1038,377,424,237,435,235,160,40,458,268,190,16,16,125,64,61
"2021","Gateshead 027","E02006841",3693,1819,330,1489,1622,93,630,276,262,92,594,504,80,10,252,136,116,53,53,252,26,226
"2021","Gateshead 028","E02006842",2244,925,298,627,1205,141,550,169,287,94,260,174,71,15,228,138,90,26,26,114,50,64
"2021","Gateshead 029","E02007094",3274,1214,529,685,1948,304,839,365,299,175,401,233,141,27,388,262,126,16,16,112,45,67
"2021","Halton 001","E02002574",3588,871,423,448,2607,427,1478,491,689,298,421,211,184,26,270,163,107,11,11,110,47,63
"2021","Halton 002","E02002575",3809,867,379,488,2814,424,1689,546,776,367,395,209,157,29,298,165,133,8,8,128,66,62
"2021","Halton 003","E02002576",3398,1284,527,757,2009,258,855,334,313,208,468,228,211,29,410,266,144,18,18,105,59,46
"2021","Halton 004","E02002577",3238,1087,451,636,2027,246,706,241,305,160,371,145,181,45,685,480,205,19,19,124,64,60
"2021","Halton 005","E02002578",3499,1048,484,564,2283,235,1093,324,509,260,472,233,205,34,459,274,185,24,24,168,86,82
"2021","Halton 006","E02002579",3379,1068,466,602,2164,231,884,344,324,216,427,183,208,36,595,401,194,27,27,147,87,60
"2021","Halton 007","E02002580",3686,1540,429,1111,1974,127,650,240,279,131,503,242,220,41,658,458,200,36,36,172,74,98
"2021","Halton 008","E02002581",3088,895,459,436,2042,423,907,327,328,252,389,178,177,34,305,185,120,18,18,151,69,82
"2021","Halton 009","E02002582",3623,682,300,382,2801,354,1687,640,752,295,504,260,208,36,243,132,111,13,13,140,69,71
"2021","Halton 010","E02002583",3384,1188,447,741,2035,194,691,256,278,157,405,153,218,34,711,498,213,34,34,161,63,98
"2021","Halton 011","E02002584",3113,890,386,504,2092,287,908,351,339,218,431,182,217,32,449,299,150,17,17,131,70,61
"2021","Halton 012","E02002585",5208,2085,614,1471,2945,309,1147,459,447,241,782,449,291,42,663,448,215,44,44,178,61,117
"2021","Halton 013","E02002586",4074,1329,542,787,2540,262,875,317,338,220,510,180,266,64,857,565,292,36,36,205,101,104
"2021","Halton 014","E02002587",2870,926,381,545,1828,241,667,252,244,171,373,170,166,37,531,371,160,16,16,116,54,62
"2021","Halton 015","E02002588",3259,1246,453,793,1880,265,692,270,243,179,336,126,185,25,561,368,193,26,26,133,65,68
"2021","Halton 016","E02002589",2726,695,415,280,1942,493,1012,386,392,234,261,117,127,17,171,77,94,5,5,89,48,41
"2021","Warrington 001","E02002590",2634,643,357,286,1919,376,1091,389,480,222,249,125,101,23,200,111,89,3,3,72,33,39
"2021","Warrington 002","E02002591",2854,875,501,374,1866,370,971,383,407,181,261,119,124,18,251,150,101,13,13,113,49,64
"2021","Warrington 003","E02002592",2577,728,385,343,1748,328,918,313,384,221,253,123,114,16,241,132,109,8,8,101,39,62
"2021","Warrington 004","E02002593",2367,792,357,435,1491,262,684,296,268,120,267,133,122,12,266,162,104,12,12,84,35,49
"2021","Warrington 005","E02002594",2602,967,320,647,1535,170,695,294,281,120,333,192,118,23,324,225,99,13,13,100,37,63
"2021","Warrington 006","E02002595",3448,1143,379,764,2135,145,815,272,371,172,509,196,274,39,638,449,189,28,28,170,84,86
"2021","Warrington 007","E02002596",3513,993,498,495,2381,499,1145,472,440,233,386,212,142,32,333,178,155,18,18,139,65,74
"2021","Warrington 008","E02002597",3857,1241,478,763,2421,252,938,326,422,190,504,167,281,56,711,483,228,16,16,195,106,89
"2021","Warrington 009","E02002598",4264,856,235,621,3244,208,2021,589,1090,342,630,372,243,15,371,252,119,14,14,164,93,71
"2021","Warrington 010","E02002599",4377,1077,399,678,3077,391,1872,599,879,394,444,228,184,32,357,217,140,13,13,223,106,117
"2021","Warrington 011","E02002600",4164,1436,579,857,2512,248,1021,405,394,222,594,282,259,53,601,385,216,48,48,216,80,136
"2021","Warrington 012","E02002601",3847,998,534,464,2709,443,1361,490,589,282,512,234,243,35,379,226,153,14,14,140,48,92
"2021","Warrington 013","E02002602",3529,1187,304,883,2148,107,904,299,460,145,490,238,223,29,606,465,141,41,41,194,73,121
"2021","Warrington 014","E02002603",2872,670,415,255,2086,433,1136,421,428,287,275,117,137,21,235,124,111,7,7,116,55,61
"2021","Warrington 015","E02002604",3242,764,431,333,2380,470,1243,429,538,276,396,216,162,18,259,132,127,12,12,98,48,50
"2021","Warrington 016","E02002605",3729,1028,443,585,2536,378,1293,438,587,268,434,199,201,34,415,248,167,16,16,165,77,88
"2021","Warrington 017","E02002606",5483,2317,501,1816,2848,168,1058,406,496,156,854,527,297,30,691,496,195,77,77,318,99,219
"2021","Warrington 018","E02002607",5654,2400,730,1670,2960,323,1156,475,510,171,823,539,247,37,583,351,232,75,75,294,72,222
"2021","Warrington 019","E02002608",3561,985,621,364,2481,614,1216,405,512,299,360,167,165,28,273,124,149,18,18,95,36,59
"2021","Warrington 020","E02002609",4392,1676,438,1238,2513,159,1011,336,489,186,679,358,282,39,637,465,172,27,27,203,91,112
"2021","Warrington 021","E02002610",5315,1509,787,722,3649,682,2011,612,1095,304,490,255,206,29,451,299,152,15,15,157,69,88
"2021","Warrington 022","E02002611",3257,854,498,356,2314,416,1320,430,645,245,356,182,154,20,217,120,97,5,5,89,38,51
"2021","Warrington 023","E02002612",3991,1242,649,593,2645,430,1401,475,690,236,448,256,167,25,357,208,149,9,9,104,35,69
"2021","Warrington 024","E02002613",2640,525,287,238,2014,377,1148,413,534,201,309,192,97,20,175,103,72,5,5,101,32,69
"2021","Warrington 025","E02002614",2380,464,321,143,1855,496,1108,400,502,206,144,64,70,10,102,49,53,5,5,61,23,38
"2021","Blackburn with Darwen 001","E02002615",4118,1203,532,671,2674,362,1414,369,820,225,393,157,197,39,483,303,180,22,22,241,156,85
"2021","Blackburn with Darwen 002","E02002616",2996,564,264,300,2170,271,1434,280,941,213,190,81,96,13,259,155,104,16,16,262,166,96
"2021","Blackburn with Darwen 003","E02002617",2767,599,235,364,1805,97,1246,171,844,231,114,38,70,6,311,208,103,37,37,363,268,95
"2021","Blackburn with Darwen 004","E02002618",2209,400,149,251,1481,87,1066,157,686,223,75,19,51,5,229,126,103,24,24,328,229,99
"2021","Blackburn with Darwen 005","E02002619",3041,907,253,654,1781,107,1039,197,678,164,210,98,95,17,389,259,130,36,36,353,240,113
"2021","Blackburn with Darwen 006","E02002620",3418,1376,410,966,1727,108,935,191,566,178,195,99,82,14,459,312,147,30,30,315,206,109
"2021","Blackburn with Darwen 007","E02002621",2540,623,228,395,1590,80,1072,185,689,198,88,26,48,14,330,199,131,20,20,327,242,85
"2021","Blackburn with Darwen 008","E02002622",3981,1158,392,766,2522,153,1090,234,654,202,401,126,236,39,835,602,233,43,43,301,185,116
"2021","Blackburn with Darwen 009","E02002623",4702,1820,582,1238,2625,152,887,307,429,151,634,268,324,42,893,658,235,59,59,257,131,126
"2021","Blackburn with Darwen 010","E02002624",3589,942,540,402,2482,520,1273,451,538,284,425,187,202,36,254,120,134,10,10,165,86,79
"2021","Blackburn with Darwen 011","E02002625",3958,1159,424,735,2523,197,1110,331,561,218,526,209,275,42,662,450,212,28,28,276,169,107
"2021","Blackburn with Darwen 012","E02002626",3147,1041,443,598,1951,252,766,307,265,194,401,152,204,45,514,323,191,18,18,155,86,69
"2021","Blackburn with Darwen 013","E02002627",2934,628,223,405,2181,210,1165,398,575,192,453,190,228,35,335,214,121,18,18,125,62,63
"2021","Blackburn with Darwen 014","E02002628",3116,1148,425,723,1827,217,738,293,294,151,409,218,160,31,438,270,168,25,25,141,64,77
"2021","Blackburn with Darwen 015","E02002629",2642,908,301,607,1601,163,576,228,247,101,378,183,168,27,460,314,146,24,24,133,75,58
"2021","Blackburn with Darwen 016","E02002630",2898,1131,428,703,1620,168,643,248,260,135,395,188,186,21,402,280,122,12,12,147,62,85
"2021","Blackburn with Darwen 017","E02002631",4018,1309,535,774,2576,407,1192,457,462,273,545,255,248,42,413,250,163,19,19,133,57,76
"2021","Blackburn with Darwen 018","E02002632",2699,660,308,352,1929,393,1050,453,399,198,317,172,117,28,160,95,65,9,9,110,62,48
"2021","Blackpool 001","E02002633",3577,1277,772,505,2143,473,906,395,327,184,362,183,153,26,385,220,165,17,17,157,63,94
"2021","Blackpool 002","E02002634",4044,1669,827,842,2247,474,929,422,305,202,384,195,162,27,442,270,172,18,18,128,60,68
"2021","Blackpool 003","E02002635",3650,1344,711,633,2132,458,921,396,333,192,387,200,156,31,346,183,163,20,20,174,73,101
"2021","Blackpool 004","E02002636",3702,1288,517,771,2258,327,924,392,343,189,491,221,231,39,490,321,169,26,26,156,61,95
"2021","Blackpool 005","E02002637",2707,767,344,423,1764,262,749,291,275,183,374,168,186,20,356,218,138,23,23,176,77,99
"2021","Blackpool 006","E02002638",2939,1533,361,1172,1148,118,431,173,173,85,302,183,108,11,276,189,87,21,21,258,81,177
"2021","Blackpool 007","E02002639",2717,1091,377,714,1463,87,491,160,216,115,319,115,186,18,544,352,192,22,22,163,76,87
"2021","Blackpool 008","E02002640",3327,1433,402,1031,1657,89,481,197,200,84,446,195,216,35,598,437,161,43,43,237,107,130
"2021","Blackpool 009","E02002641",3599,1190,463,727,2191,237,882,359,338,185,509,267,189,53,539,364,175,24,24,218,67,151
"2021","Blackpool 010","E02002642",3400,1748,440,1308,1365,87,477,235,168,74,318,186,107,25,433,303,130,50,50,287,103,184
"2021","Blackpool 011","E02002643",3385,1186,384,802,1901,138,627,239,274,114,490,225,226,39,604,410,194,42,42,298,123,175
"2021","Blackpool 012","E02002644",3500,1115,479,636,2223,288,969,389,360,220,491,220,238,33,451,305,146,24,24,162,61,101
"2021","Blackpool 013","E02002645",2840,1398,328,1070,1189,81,397,181,150,66,284,148,116,20,378,248,130,49,49,253,98,155
"2021","Blackpool 014","E02002646",3378,1299,583,716,1918,297,713,337,252,124,429,209,185,35,459,300,159,20,20,161,68,93
"2021","Blackpool 015","E02002647",3628,1263,450,813,2101,199,712,301,268,143,481,226,216,39,675,463,212,34,34,264,95,169
"2021","Blackpool 016","E02002648",3221,1064,474,590,1974,228,682,269,281,132,449,202,210,37,599,389,210,16,16,183,79,104
"2021","Blackpool 017","E02002649",3733,1437,573,864,2071,288,872,351,324,197,469,225,217,27,416,257,159,26,26,225,88,137
"2021","Blackpool 018","E02002650",3902,1313,659,654,2398,468,1014,445,354,215,446,225,185,36,454,294,160,16,16,191,77,114
"2021","Blackpool 019","E02002651",3535,1175,654,521,2189,373,923,384,324,215,440,206,196,38,440,274,166,13,13,171,66,105
"2021","Cheshire East 022","E02003811",3153,709,403,306,2327,541,1261,485,556,220,314,168,130,16,203,131,72,8,8,117,54,63
"2021","Cheshire East 023","E02003812",2851,773,476,297,2003,475,1007,303,526,178,294,166,116,12,223,152,71,4,4,75,29,46
"2021","Cheshire East 024","E02003813",2793,909,469,440,1805,343,959,416,338,205,289,155,115,19,204,99,105,10,10,79,28,51
"2021","Cheshire East 025","E02003814",3486,895,353,542,2460,271,1287,460,600,227,527,284,212,31,363,237,126,12,12,131,53,78
"2021","Cheshire East 026","E02003815",3268,1042,374,668,2085,307,913,337,419,157,426,191,215,20,426,290,136,13,13,141,62,79
"2021","Cheshire East 027","E02003816",3657,1416,534,882,2137,381,913,362,383,168,466,287,153,26,358,230,128,19,19,104,45,59
"2021","Cheshire East 028","E02003817",3410,1002,602,400,2302,495,1162,442,508,212,376,193,166,17,263,143,120,6,6,106,37,69
"2021","Cheshire East 029","E02003818",2509,664,377,287,1777,444,960,381,403,176,243,140,94,9,126,67,59,4,4,68,27,41
"2021","Cheshire East 030","E02003819",3002,923,502,421,2008,492,948,366,410,172,346,213,122,11,208,137,71,14,14,71,28,43
"2021","Cheshire East 031","E02003820",4124,1084,347,737,2907,313,1535,522,782,231,621,350,250,21,424,295,129,14,14,133,54,79
"2021","Cheshire East 032","E02003821",2726,974,491,483,1699,345,774,333,298,143,300,199,86,15,272,164,108,8,8,53,16,37
"2021","Cheshire East 033","E02003822",5130,1301,670,631,3645,797,1828,835,661,332,623,378,207,38,385,231,154,12,12,184,71,113
"2021","Cheshire East 040","E02003823",3128,1044,604,440,1999,510,932,345,410,177,300,145,138,17,248,148,100,9,9,85,40,45
"2021","Cheshire East 042","E02003824",2797,775,404,371,1946,350,991,340,496,155,364,209,142,13,241,169,72,0,0,76,35,41
"2021","Cheshire East 034","E02003825",2643,668,212,456,1877,179,1110,428,445,237,387,198,164,25,197,129,68,4,4,98,42,56
"2021","Cheshire East 035","E02003826",3596,1056,420,636,2356,171,994,355,456,183,632,283,321,28,514,344,170,45,45,184,83,101
"2021","Cheshire East 036","E02003827",4218,1458,475,983,2519,240,904,339,410,155,674,328,309,37,654,435,219,47,47,241,99,142
"2021","Cheshire East 037","E02003828",2657,743,290,453,1769,203,743,245,365,133,402,173,198,31,401,273,128,20,20,145,62,83
"2021","Cheshire East 038","E02003829",2576,931,504,427,1549,385,667,323,219,125,293,155,117,21,193,109,84,11,11,96,31,65
"2021","Cheshire East 039","E02003830",3560,1268,364,904,2038,146,794,319,364,111,548,324,196,28,511,352,159,39,39,254,105,149
"2021","Cheshire East 041","E02003831",4272,999,509,490,3104,556,1697,702,672,323,503,268,200,35,336,210,126,12,12,169,64,105
"2021","Cheshire East 043","E02003832",2737,998,245,753,1385,116,583,189,287,107,353,181,156,16,250,156,94,83,83,354,129,225
"2021","Cheshire East 044","E02003833",2735,820,410,410,1806,225,883,327,399,157,365,162,184,19,322,197,125,11,11,109,52,57
"2021","Cheshire East 045","E02003834",2935,941,260,681,1726,129,734,268,335,131,486,229,240,17,344,212,132,33,33,268,87,181
"2021","Cheshire East 046","E02003835",3624,857,536,321,2662,714,1392,560,552,280,338,195,122,21,208,110,98,10,10,105,48,57
"2021","Cheshire East 047","E02003836",3488,1454,758,696,1939,439,813,321,313,179,374,236,122,16,287,159,128,26,26,95,25,70
"2021","Cheshire East 048","E02003838",3664,1040,525,515,2529,399,1178,474,520,184,588,354,222,12,341,220,121,23,23,95,44,51
"2021","Cheshire East 050","E02003839",3427,1295,681,614,2005,448,856,343,370,143,379,232,125,22,304,189,115,18,18,127,28,99
"2021","Cheshire East 051","E02003840",4634,1092,674,418,3394,783,1862,835,674,353,442,250,170,22,288,159,129,19,19,148,72,76
"2021","Cheshire East 001","E02003853",2695,750,361,389,1861,404,1002,398,427,177,275,153,111,11,169,94,75,11,11,84,26,58
"2021","Cheshire East 002","E02003854",2738,707,473,234,1956,450,1026,321,512,193,236,120,95,21,239,132,107,5,5,75,29,46
"2021","Cheshire East 003","E02003855",2818,825,569,256,1933,553,1039,352,481,206,176,95,69,12,162,88,74,3,3,60,32,28
"2021","Cheshire East 004","E02003856",5172,1865,732,1133,3109,404,1497,480,758,259,618,343,229,46,562,352,210,28,28,198,82,116
"2021","Cheshire East 005","E02003857",2874,820,355,465,1922,280,990,315,516,159,319,183,111,25,323,197,126,10,10,132,56,76
"2021","Cheshire East 006","E02003858",3072,993,555,438,1971,419,1051,344,535,172,318,204,90,24,172,109,63,11,11,108,33,75
"2021","Cheshire East 007","E02003859",4989,1215,673,542,3546,778,2008,705,961,342,416,241,135,40,330,190,140,14,14,228,111,117
"2021","Cheshire East 008","E02003860",2963,750,462,288,2130,398,1239,341,721,177,264,124,124,16,218,119,99,11,11,83,37,46
"2021","Cheshire East 009","E02003861",2898,983,464,519,1812,338,796,275,407,114,340,188,139,13,327,206,121,11,11,103,37,66
"2021","Cheshire East 011","E02003862",2177,510,344,166,1590,460,859,317,361,181,151,74,71,6,114,59,55,6,6,77,31,46
"2021","Cheshire East 010","E02003863",2983,899,570,329,1975,444,1091,360,577,154,255,140,110,5,177,96,81,8,8,109,28,81
"2021","Cheshire East 012","E02003864",3929,1339,686,653,2475,582,1250,477,561,212,349,220,104,25,278,164,114,16,16,115,43,72
"2021","Cheshire East 013","E02003865",3664,1224,549,675,2370,430,1162,446,530,186,423,246,154,23,341,214,127,14,14,70,27,43
"2021","Cheshire East 014","E02003866",2631,648,377,271,1912,387,1107,366,528,213,223,116,94,13,190,109,81,5,5,71,28,43
"2021","Cheshire East 015","E02003867",3301,1001,434,567,2199,327,1125,397,544,184,357,185,152,20,377,266,111,13,13,101,44,57
"2021","Cheshire East 016","E02003868",4040,1612,648,964,2290,320,1029,362,486,181,505,288,189,28,409,240,169,27,27,138,36,102
"2021","Cheshire East 017","E02003869",3248,1044,432,612,2112,399,1105,408,512,185,360,223,129,8,234,133,101,14,14,92,38,54
"2021","Cheshire East 018","E02003870",5370,2315,642,1673,2832,280,1224,523,534,167,797,576,204,17,488,287,201,43,43,223,53,170
"2021","Cheshire East 019","E02003871",3066,996,516,480,1986,327,906,308,393,205,342,151,166,25,391,247,144,20,20,84,31,53
"2021","Cheshire East 020","E02003872",4444,1163,655,508,3106,760,1706,722,694,290,395,240,133,22,235,122,113,10,10,175,64,111
"2021","Cheshire East 021","E02003873",2843,1064,339,725,1674,165,685,248,314,123,414,236,158,20,392,253,139,18,18,105,32,73
"2021","Cheshire East 052","E02007030",2796,593,251,342,2063,280,1111,481,493,137,471,288,168,15,193,129,64,8,8,140,52,88
"2021","Cheshire East 053","E02007031",3373,696,264,432,2543,358,1543,528,801,214,382,213,151,18,250,156,94,10,10,134,56,78
"2021","Cheshire West and Chester 022","E02003794",3646,1005,472,533,2483,463,1322,495,578,249,382,205,153,24,304,170,134,12,12,158,79,79
"2021","Cheshire West and Chester 025","E02003795",2355,610,369,241,1639,343,900,327,411,162,224,141,72,11,162,95,67,10,10,106,47,59
"2021","Cheshire West and Chester 027","E02003796",3321,1132,666,466,2092,357,1012,332,469,211,302,135,140,27,399,240,159,22,22,97,36,61
"2021","Cheshire West and Chester 028","E02003797",4196,1203,496,707,2795,464,1539,514,778,247,506,300,180,26,259,145,114,27,27,198,53,145
"2021","Cheshire West and Chester 029","E02003798",2565,761,308,453,1654,154,652,206,287,159,350,137,178,35,462,296,166,36,36,150,63,87
"2021","Cheshire West and Chester 031","E02003799",3212,1056,432,624,2026,229,809,284,327,198,415,153,223,39,546,358,188,27,27,130,58,72
"2021","Cheshire West and Chester 030","E02003800",3001,738,439,299,2171,518,1163,394,554,215,272,146,114,12,214,130,84,4,4,92,33,59
"2021","Cheshire West and Chester 032","E02003801",2974,815,456,359,2059,301,1105,332,562,211,371,223,133,15,265,139,126,17,17,100,34,66
"2021","Cheshire West and Chester 033","E02003802",4534,2251,675,1576,1863,175,683,324,276,83,687,567,112,8,270,141,129,48,48,420,29,391
"2021","Cheshire West and Chester 034","E02003803",4337,1939,521,1418,1708,198,577,316,188,73,632,490,138,4,229,111,118,72,72,690,36,654
"2021","Cheshire West and Chester 036","E02003804",3290,1235,516,719,1847,203,838,301,433,104,493,350,129,14,281,174,107,32,32,208,33,175
"2021","Cheshire West and Chester 039","E02003805",2607,657,403,254,1865,439,1037,317,507,213,201,99,87,15,182,117,65,6,6,85,36,49
"2021","Cheshire West and Chester 041","E02003806",3423,863,449,414,2479,363,1334,413,729,192,431,227,183,21,345,224,121,6,6,81,37,44
"2021","Cheshire West and Chester 043","E02003807",4072,1318,719,599,2614,585,1246,452,603,191,452,281,91,80,309,196,113,22,22,140,56,84
"2021","Cheshire West and Chester 044","E02003808",2841,902,331,571,1812,182,806,276,378,152,408,203,177,28,399,280,119,17,17,127,53,74
"2021","Cheshire West and Chester 046","E02003809",3522,956,502,454,2429,536,1311,496,575,240,335,193,113,29,237,146,91,10,10,137,56,81
"2021","Cheshire West and Chester 047","E02003810",4171,1127,597,530,2897,565,1521,576,680,265,456,242,191,23,338,197,141,17,17,147,60,87
"2021","Cheshire West and Chester 001","E02003841",3645,1237,662,575,2248,532,1044,407,426,211,312,172,119,21,349,200,149,11,11,160,55,105
"2021","Cheshire West and Chester 004","E02003842",2511,679,400,279,1750,487,912,387,354,171,200,127,59,14,142,70,72,9,9,82,28,54
"2021","Cheshire West and Chester 005","E02003843",2918,1000,437,563,1794,294,835,315,309,211,316,157,127,32,329,183,146,20,20,124,56,68
"2021","Cheshire West and Chester 006","E02003844",2983,871,494,377,1979,498,956,370,388,198,269,147,98,24,249,133,116,7,7,133,37,96
"2021","Cheshire West and Chester 007","E02003845",5119,1975,516,1459,2910,148,1036,370,498,168,906,486,388,32,774,549,225,46,46,234,95,139
"2021","Cheshire West and Chester 008","E02003846",2966,976,393,583,1858,133,752,275,330,147,401,157,212,32,559,380,179,13,13,132,55,77
"2021","Cheshire West and Chester 009","E02003847",4165,1004,512,492,3042,490,1737,647,719,371,501,280,193,28,299,162,137,15,15,119,55,64
"2021","Cheshire West and Chester 010","E02003848",2228,681,292,389,1437,163,631,211,266,154,295,116,152,27,336,208,128,12,12,110,50,60
"2021","Cheshire West and Chester 011","E02003849",3653,1132,393,739,2327,186,815,255,391,169,551,225,291,35,756,521,235,19,19,194,91,103
"2021","Cheshire West and Chester 013","E02003850",2247,647,360,287,1529,299,700,266,273,161,259,126,110,23,259,141,118,12,12,71,26,45
"2021","Cheshire West and Chester 014","E02003851",2407,575,309,266,1748,323,990,353,420,217,268,144,96,28,162,90,72,5,5,84,32,52
"2021","Cheshire West and Chester 016","E02003852",2789,720,416,304,1975,399,1053,390,409,254,299,156,127,16,213,98,115,11,11,94,26,68
"2021","Cheshire West and Chester 002","E02003874",4118,1286,682,604,2740,547,1388,511,623,254,387,216,147,24,407,234,173,11,11,92,39,53
"2021","Cheshire West and Chester 003","E02003875",2810,663,410,253,2033,480,1152,517,416,219,251,158,80,13,143,70,73,7,7,114,47,67
"2021","Cheshire West and Chester 012","E02003876",2474,699,329,370,1677,276,752,312,310,130,358,182,154,22,279,185,94,12,12,98,42,56
"2021","Cheshire West and Chester 015","E02003877",4241,1176,666,510,2945,647,1545,624,613,308,466,294,144,28,278,158,120,9,9,120,50,70
"2021","Cheshire West and Chester 017","E02003878",3894,997,493,504,2744,498,1437,583,591,263,453,274,147,32,341,171,170,15,15,153,63,90
"2021","Cheshire West and Chester 018","E02003879",4157,1441,397,1044,2557,208,1105,373,573,159,800,433,336,31,416,287,129,28,28,159,58,101
"2021","Cheshire West and Chester 019","E02003880",2799,786,409,377,1899,338,899,327,383,189,332,146,158,28,321,176,145,9,9,114,51,63
"2021","Cheshire West and Chester 020","E02003881",2729,1009,338,671,1598,190,722,291,307,124,371,211,136,24,294,189,105,21,21,122,39,83
"2021","Cheshire West and Chester 021","E02003882",4087,1197,545,652,2687,332,1193,436,504,253,573,310,217,46,562,348,214,27,27,203,91,112
"2021","Cheshire West and Chester 023","E02003883",4806,1298,574,724,3405,608,1956,657,974,325,468,272,177,19,363,229,134,10,10,103,41,62
"2021","Cheshire West and Chester 024","E02003884",3785,909,536,373,2771,640,1479,568,670,241,372,171,173,28,274,148,126,6,6,105,41,64
"2021","Cheshire West and Chester 026","E02003885",2763,702,343,359,1971,398,999,386,432,181,306,161,132,13,259,155,104,9,9,90,35,55
"2021","Cheshire West and Chester 035","E02003886",2624,669,297,372,1800,207,816,319,323,174,371,166,177,28,391,247,144,15,15,155,62,93
"2021","Cheshire West and Chester 037","E02003887",2887,662,263,399,2098,296,1007,399,380,228,451,215,212,24,331,205,126,13,13,127,47,80
"2021","Cheshire West and Chester 038","E02003888",2872,982,366,616,1745,180,746,305,266,175,417,191,195,31,382,235,147,20,20,145,57,88
"2021","Cheshire West and Chester 040","E02003889",2675,788,337,451,1739,196,671,229,303,139,423,158,240,25,440,324,116,9,9,148,61,87
"2021","Cheshire West and Chester 042","E02003890",2984,810,310,500,2036,268,936,365,367,204,465,238,202,25,343,227,116,24,24,138,53,85
"2021","Cheshire West and Chester 045","E02003891",2798,751,457,294,1943,477,1030,406,463,161,228,131,81,16,201,112,89,7,7,104,43,61
"2021","Allerdale 001","E02003965",5023,1666,884,782,3215,702,1491,630,526,335,538,266,229,43,460,278,182,24,24,142,65,77
"2021","Allerdale 002","E02003966",3063,816,464,352,2140,490,1174,513,403,258,299,172,113,14,166,75,91,11,11,107,38,69
"2021","Allerdale 003","E02003967",3603,1097,538,559,2382,485,1157,513,418,226,413,197,189,27,313,180,133,14,14,124,56,68
"2021","Allerdale 004","E02003968",4003,1324,607,717,2554,516,1239,488,514,237,479,246,190,43,309,194,115,11,11,125,46,79
"2021","Allerdale 005","E02003969",2905,971,435,536,1837,247,719,281,251,187,389,162,205,22,465,319,146,17,17,97,56,41
"2021","Allerdale 006","E02003970",3829,1310,599,711,2413,497,1275,524,544,207,364,236,114,14,269,161,108,8,8,106,50,56
"2021","Allerdale 007","E02003971",3558,1111,590,521,2344,543,1222,537,482,203,297,176,99,22,276,168,108,6,6,103,32,71
"2021","Allerdale 008","E02003972",4219,1509,632,877,2614,456,1211,511,450,250,504,255,212,37,427,282,145,16,16,96,48,48
"2021","Allerdale 009","E02003973",4185,1755,636,1119,2314,243,923,403,328,192,498,225,244,29,628,431,197,22,22,116,57,59
"2021","Allerdale 010","E02003974",3498,1168,501,667,2243,368,971,413,336,222,411,196,187,28,482,354,128,11,11,87,42,45
"2021","Allerdale 011","E02003975",3178,928,431,497,2174,415,1103,458,455,190,379,187,176,16,271,166,105,6,6,76,36,40
"2021","Allerdale 012","E02003976",2907,1020,567,453,1755,437,850,415,286,149,262,161,87,14,190,97,93,16,16,132,45,87
"2021","Barrow-in-Furness 001","E02003977",2781,903,403,500,1811,289,956,388,355,213,329,170,141,18,230,122,108,7,7,67,30,37
"2021","Barrow-in-Furness 002","E02003978",2647,892,396,496,1677,301,753,315,277,161,341,184,140,17,276,158,118,6,6,78,32,46
"2021","Barrow-in-Furness 003","E02003979",3460,1034,655,379,2313,633,1223,477,494,252,298,145,138,15,152,69,83,7,7,113,52,61
"2021","Barrow-in-Furness 004","E02003980",3280,1380,514,866,1796,185,677,276,259,142,401,162,211,28,507,357,150,26,26,104,49,55
"2021","Barrow-in-Furness 005","E02003981",2934,984,389,595,1861,247,865,334,342,189,405,200,178,27,334,213,121,10,10,89,31,58
"2021","Barrow-in-Furness 006","E02003982",3387,883,455,428,2404,438,1228,468,528,232,419,194,198,27,312,179,133,7,7,100,59,41
"2021","Barrow-in-Furness 007","E02003983",3318,1245,433,812,1961,188,759,292,300,167,458,183,240,35,533,333,200,23,23,112,50,62
"2021","Barrow-in-Furness 008","E02003984",3296,1660,455,1205,1499,118,457,198,169,90,400,195,186,19,497,357,140,27,27,137,53,84
"2021","Barrow-in-Furness 009","E02003985",3145,1101,538,563,1967,370,855,372,317,166,404,188,191,25,330,196,134,8,8,77,35,42
"2021","Barrow-in-Furness 010","E02003986",3005,1223,445,778,1711,319,714,307,261,146,355,154,179,22,313,193,120,10,10,71,22,49
"2021","Carlisle 001","E02003987",2716,873,407,466,1745,327,909,418,321,170,281,148,113,20,209,118,91,19,19,98,32,66
"2021","Carlisle 002","E02003988",3034,1054,547,507,1890,414,905,427,315,163,290,163,100,27,274,166,108,7,7,90,42,48
"2021","Carlisle 003","E02003989",3486,1188,623,565,2208,446,1092,431,455,206,356,186,152,18,303,193,110,11,11,90,36,54
"2021","Carlisle 004","E02003990",4751,1295,632,663,3314,635,1734,679,763,292,559,322,208,29,370,244,126,16,16,142,70,72
"2021","Carlisle 005","E02003991",3243,805,477,328,2339,521,1305,580,479,246,319,151,149,19,186,100,86,8,8,99,36,63
"2021","Carlisle 006","E02003992",4160,2096,578,1518,1775,236,767,328,291,148,453,293,138,22,285,168,117,34,34,289,62,227
"2021","Carlisle 007","E02003993",3946,1119,632,487,2697,649,1457,634,543,280,372,222,131,19,215,111,104,4,4,130,54,76
"2021","Carlisle 008","E02003994",3598,1523,497,1026,1940,229,776,339,288,149,456,261,177,18,460,300,160,19,19,135,36,99
"2021","Carlisle 009","E02003995",4772,1855,705,1150,2808,344,1100,421,477,202,662,300,335,27,680,463,217,22,22,109,38,71
"2021","Carlisle 010","E02003996",4674,2087,512,1575,2368,191,1003,438,398,167,677,424,231,22,464,279,185,33,33,219,63,156
"2021","Carlisle 011","E02003997",4218,1497,584,913,2567,230,1022,356,466,200,589,256,291,42,708,516,192,18,18,154,70,84
"2021","Carlisle 012","E02003998",2908,969,457,512,1853,223,728,291,284,153,395,166,205,24,492,328,164,15,15,86,40,46
"2021","Carlisle 013","E02003999",5165,1422,739,683,3591,729,1845,753,789,303,639,353,260,26,365,244,121,13,13,152,63,89
"2021","Copeland 001","E02004000",2296,693,312,381,1545,295,744,308,246,190,250,110,120,20,244,163,81,12,12,58,26,32
"2021","Copeland 002","E02004001",2713,1297,470,827,1331,224,611,274,213,124,250,148,93,9,231,124,107,15,15,85,27,58
"2021","Copeland 003","E02004002",4267,1304,594,710,2848,539,1451,578,582,291,467,254,186,27,373,236,137,18,18,115,58,57
"2021","Copeland 004","E02004003",5403,1890,785,1105,3343,526,1651,760,561,330,557,274,246,37,585,376,209,24,24,170,75,95
"2021","Copeland 005","E02004004",4348,1433,561,872,2766,327,1228,476,508,244,552,258,263,31,639,435,204,20,20,149,72,77
"2021","Copeland 006","E02004005",3526,1239,537,702,2167,388,995,418,358,219,389,166,199,24,385,253,132,10,10,120,53,67
"2021","Copeland 007","E02004006",3899,1234,610,624,2537,603,1332,653,473,206,334,192,125,17,252,133,119,16,16,128,49,79
"2021","Copeland 008","E02004007",4345,1477,731,746,2751,531,1314,586,443,285,473,232,208,33,424,238,186,9,9,117,61,56
"2021","Eden 001","E02004008",2822,778,416,362,1924,394,1042,497,350,195,311,181,111,19,163,82,81,14,14,120,52,68
"2021","Eden 002","E02004009",2667,674,359,315,1891,385,1072,471,379,222,261,167,87,7,164,83,81,9,9,102,46,56
"2021","Eden 003","E02004010",3672,1500,627,873,1982,259,889,355,369,165,449,257,165,27,360,216,144,25,25,190,74,116
"2021","Eden 004","E02004011",4914,1501,792,709,3232,741,1563,638,606,319,572,323,221,28,340,194,146,16,16,181,72,109
"2021","Eden 005","E02004012",2454,701,371,330,1655,404,861,424,281,156,241,146,78,17,140,72,68,9,9,98,38,60
"2021","Eden 006","E02004013",4624,1439,756,683,3047,684,1564,704,561,299,474,264,187,23,315,176,139,10,10,138,64,74
"2021","Eden 007","E02004014",3461,1025,542,483,2310,546,1200,556,415,229,338,179,136,23,210,107,103,16,16,126,44,82
"2021","South Lakeland 001","E02004015",2743,1017,591,426,1550,393,703,374,205,124,265,165,84,16,178,103,75,11,11,176,33,143
"2021","South Lakeland 002","E02004016",3625,1190,634,556,2238,447,1117,497,429,191,396,230,149,17,250,142,108,28,28,197,40,157
"2021","South Lakeland 003","E02004017",4079,1341,623,718,2546,456,1181,490,491,200,513,301,182,30,379,212,167,17,17,192,53,139
"2021","South Lakeland 004","E02004018",3939,1584,596,988,2164,274,995,395,446,154,498,291,176,31,380,238,142,17,17,191,47,144
"2021","South Lakeland 005","E02004019",3400,931,542,389,2342,578,1219,522,457,240,350,195,130,25,186,97,89,9,9,127,27,100
"2021","South Lakeland 006","E02004020",3971,1234,658,576,2603,516,1328,497,563,268,449,276,159,14,297,187,110,13,13,134,51,83
"2021","South Lakeland 007","E02004021",2428,697,376,321,1628,420,820,434,239,147,266,172,75,19,115,53,62,7,7,103,29,74
"2021","South Lakeland 008","E02004022",2508,710,377,333,1703,413,882,442,283,157,277,157,102,18,130,71,59,1,1,95,31,64
"2021","South Lakeland 009","E02004023",2714,931,566,365,1688,443,864,410,304,150,201,125,63,13,171,91,80,9,9,95,35,60
"2021","South Lakeland 010","E02004024",3288,824,505,319,2363,655,1208,526,456,226,311,196,105,10,186,114,72,3,3,101,47,54
"2021","South Lakeland 011","E02004025",3629,1169,715,454,2344,637,1126,515,425,186,362,207,136,19,207,122,85,12,12,116,45,71
"2021","South Lakeland 012","E02004026",3867,1460,611,849,2271,361,1067,449,415,203,450,246,180,24,379,231,148,14,14,136,37,99
"2021","South Lakeland 013","E02004027",3871,1353,853,500,2394,759,1107,594,337,176,333,200,121,12,187,99,88,8,8,124,32,92
"2021","South Lakeland 014","E02004028",3583,1049,620,429,2435,626,1292,566,470,256,312,174,122,16,199,116,83,6,6,99,39,60
"2021","Burnley 001","E02005176",3777,1053,499,554,2542,418,1182,436,502,244,452,197,218,37,478,320,158,12,12,182,101,81
"2021","Burnley 002","E02005177",2575,829,361,468,1515,184,717,206,404,107,249,140,88,21,335,208,127,30,30,231,113,118
"2021","Burnley 003","E02005178",3697,1087,277,810,2088,58,1312,209,937,166,226,123,90,13,436,266,170,56,56,522,332,190
"2021","Burnley 004","E02005179",4293,1595,587,1008,2523,334,919,386,353,180,580,250,280,50,658,473,185,32,32,175,75,100
"2021","Burnley 005","E02005180",3007,821,452,369,2073,381,1039,428,429,182,380,176,176,28,262,169,93,11,11,113,46,67
"2021","Burnley 006","E02005181",3085,1147,433,714,1794,210,658,268,268,122,430,194,208,28,480,338,142,16,16,144,63,81
"2021","Burnley 007","E02005182",2838,1195,442,753,1464,166,509,187,244,78,322,142,153,27,431,305,126,36,36,179,80,99
"2021","Burnley 008","E02005183",2860,1094,501,593,1664,300,687,267,256,164,314,126,159,29,356,232,124,7,7,102,37,65
"2021","Burnley 009","E02005184",2277,614,351,263,1588,407,764,343,255,166,250,126,101,23,164,76,88,3,3,75,36,39
"2021","Burnley 010","E02005185",4226,1581,473,1108,2399,179,825,302,359,164,594,260,295,39,752,548,204,49,49,246,116,130
"2021","Burnley 011","E02005186",2663,704,280,424,1843,275,918,381,349,188,372,180,166,26,266,173,93,12,12,116,45,71
"2021","Burnley 014","E02006881",4568,1405,565,840,2914,369,1247,480,514,253,596,253,293,50,662,466,196,40,40,249,106,143
"2021","Chorley 001","E02005189",2400,918,327,591,1378,175,615,243,261,111,270,129,130,11,304,205,99,14,14,104,47,57
"2021","Chorley 002","E02005190",2658,717,351,366,1853,382,964,401,388,175,306,199,91,16,201,107,94,0,0,88,41,47
"2021","Chorley 003","E02005191",4084,1013,462,551,2939,519,1567,569,710,288,491,254,210,27,355,235,120,7,7,132,59,73
"2021","Chorley 004","E02005192",3691,965,357,608,2602,321,1447,465,746,236,496,294,181,21,325,208,117,13,13,124,48,76
"2021","Chorley 005","E02005193",3678,912,509,403,2652,572,1340,487,599,254,434,216,190,28,295,174,121,11,11,114,52,62
"2021","Chorley 006","E02005194",3568,1134,463,671,2301,379,974,383,401,190,503,248,214,41,430,257,173,15,15,133,50,83
"2021","Chorley 007","E02005195",2550,634,323,311,1814,369,961,373,432,156,248,137,94,17,229,128,101,7,7,102,41,61
"2021","Chorley 008","E02005196",4828,1443,601,842,3236,545,1554,485,846,223,659,357,278,24,458,331,127,20,20,149,74,75
"2021","Chorley 009","E02005197",3194,1098,416,682,1952,219,815,287,384,144,451,218,210,23,450,298,152,17,17,144,62,82
"2021","Chorley 010","E02005198",4416,1564,581,983,2693,400,1172,383,568,221,583,291,251,41,510,340,170,28,28,159,57,102
"2021","Chorley 011","E02005199",3255,805,473,332,2342,543,1208,457,504,247,321,164,129,28,263,148,115,7,7,108,54,54
"2021","Chorley 012","E02005200",3856,1170,390,780,2513,219,1177,397,577,203,561,292,224,45,542,362,180,14,14,173,76,97
"2021","Chorley 013","E02005201",3536,1006,433,573,2398,378,1118,401,458,259,500,235,231,34,392,250,142,10,10,132,52,80
"2021","Chorley 014","E02005202",4403,1277,595,682,2981,587,1468,579,630,259,531,284,211,36,386,241,145,9,9,145,63,82
"2021","Fylde 001","E02005203",3553,841,439,402,2540,495,1345,567,556,222,410,223,174,13,280,181,99,10,10,172,59,113
"2021","Fylde 002","E02005204",5559,1666,706,960,3664,550,1762,696,743,323,741,409,295,37,589,389,200,22,22,229,90,139
"2021","Fylde 003","E02005205",2636,653,349,304,1863,373,946,380,357,209,284,152,111,21,251,146,105,9,9,120,56,64
"2021","Fylde 004","E02005206",3526,1226,633,593,2154,389,947,420,349,178,388,194,179,15,422,262,160,8,8,146,60,86
"2021","Fylde 005","E02005207",3942,1242,738,504,2579,706,1193,513,444,236,343,171,145,27,318,190,128,19,19,121,52,69
"2021","Fylde 006","E02005208",5220,2525,1044,1481,2483,556,1108,531,397,180,428,278,128,22,367,206,161,24,24,212,79,133
"2021","Fylde 007","E02005209",4007,1226,643,583,2644,543,1218,558,438,222,493,268,192,33,379,239,140,11,11,137,66,71
"2021","Fylde 008","E02005210",4947,1868,1159,709,2932,826,1419,608,573,238,357,213,120,24,314,162,152,16,16,147,47,100
"2021","Fylde 009","E02005211",4221,1618,843,775,2490,617,1184,544,422,218,349,220,103,26,328,196,132,12,12,113,40,73
"2021","Hyndburn 001","E02005212",4916,1737,752,985,2973,475,1285,500,528,257,619,316,253,50,562,377,185,32,32,206,113,93
"2021","Hyndburn 002","E02005213",4830,1399,530,869,3221,464,1490,569,633,288,634,283,300,51,613,424,189,20,20,210,97,113
"2021","Hyndburn 003","E02005214",2994,991,422,569,1886,286,784,313,284,187,410,187,195,28,381,253,128,25,25,117,52,65
"2021","Hyndburn 004","E02005215",5570,2019,786,1233,3278,425,1227,472,505,250,719,321,343,55,856,593,263,51,51,273,125,148
"2021","Hyndburn 005","E02005216",2299,792,334,458,1405,158,600,227,245,128,321,136,154,31,305,206,99,21,21,102,57,45
"2021","Hyndburn 006","E02005217",4328,1189,407,782,2716,126,1462,278,956,228,394,136,231,27,683,488,195,51,51,423,295,128
"2021","Hyndburn 007","E02005218",3315,1204,554,650,1974,251,790,324,307,159,464,206,225,33,448,317,131,21,21,137,61,76
"2021","Hyndburn 008","E02005219",3874,1288,479,809,2413,386,1111,453,440,218,474,232,206,36,413,261,152,29,29,173,75,98
"2021","Hyndburn 009","E02005220",2671,812,425,387,1753,381,775,330,278,167,345,176,132,37,246,136,110,6,6,106,43,63
"2021","Lancaster 001","E02005221",4493,1368,779,589,2986,665,1437,640,540,257,506,286,183,37,368,225,143,10,10,139,57,82
"2021","Lancaster 002","E02005222",2618,687,409,278,1825,453,980,454,363,163,228,129,85,14,158,81,77,6,6,106,36,70
"2021","Lancaster 003","E02005223",3230,904,580,324,2218,583,1153,510,418,225,299,169,107,23,181,100,81,2,2,108,40,68
"2021","Lancaster 004","E02005224",2553,1041,678,363,1451,466,630,292,223,115,184,105,66,13,163,85,78,8,8,61,27,34
"2021","Lancaster 005","E02005225",2650,749,460,289,1799,359,929,358,414,157,317,180,119,18,183,103,80,11,11,102,36,66
"2021","Lancaster 006","E02005226",3365,1396,527,869,1768,192,664,243,292,129,398,196,175,27,491,355,136,23,23,201,72,129
"2021","Lancaster 008","E02005228",2395,674,310,364,1559,197,705,294,286,125,340,130,177,33,303,194,109,14,14,162,72,90
"2021","Lancaster 009","E02005229",2633,1154,297,857,1275,118,489,203,201,85,297,150,131,16,347,246,101,24,24,204,86,118
"2021","Lancaster 010","E02005230",3140,1103,567,536,1905,365,709,341,246,122,324,163,139,22,476,317,159,31,31,132,41,91
"2021","Lancaster 011","E02005231",3734,1299,449,850,2182,220,882,355,348,179,503,240,224,39,552,399,153,25,25,253,63,190
"2021","Lancaster 013","E02005233",3165,932,333,599,2025,166,1081,340,565,176,429,244,159,26,325,205,120,24,24,208,63,145
"2021","Lancaster 014","E02005234",3474,1543,407,1136,1278,113,506,219,240,47,394,306,75,13,227,149,78,38,38,653,57,596
"2021","Lancaster 015","E02005235",2104,699,208,491,891,65,386,149,185,52,265,204,52,9,161,102,59,14,14,514,30,484
"2021","Lancaster 016","E02005236",5763,1643,827,816,3841,684,1836,735,766,335,716,345,337,34,587,394,193,18,18,279,117,162
"2021","Lancaster 017","E02005237",4290,1315,499,816,2598,352,1297,498,608,191,554,317,212,25,377,249,128,18,18,377,80,297
"2021","Lancaster 018","E02005238",2395,736,378,358,1487,231,763,261,378,124,253,126,117,10,231,147,84,9,9,172,30,142
"2021","Lancaster 019","E02005239",2700,726,368,358,1831,340,988,381,444,163,310,190,99,21,183,91,92,10,10,143,54,89
"2021","Lancaster 020","E02006871",5277,1559,838,721,3520,631,1643,640,680,323,658,302,306,50,570,364,206,18,18,198,95,103
"2021","Pendle 001","E02005240",2401,702,350,352,1613,238,721,284,298,139,362,153,178,31,285,188,97,7,7,86,37,49
"2021","Pendle 002","E02005241",2506,826,338,488,1545,275,707,311,278,118,326,162,142,22,226,144,82,11,11,135,58,77
"2021","Pendle 003","E02005242",2778,848,406,442,1832,322,865,402,324,139,384,183,170,31,249,150,99,12,12,98,47,51
"2021","Pendle 006","E02005245",3061,835,420,415,2114,379,1066,465,403,198,430,241,155,34,228,149,79,11,11,112,50,62
"2021","Pendle 007","E02005246",2476,932,302,630,1423,167,552,220,232,100,356,165,161,30,332,225,107,16,16,121,51,70
"2021","Pendle 008","E02005247",4491,1368,721,647,2975,670,1444,616,594,234,513,285,202,26,339,192,147,9,9,148,74,74
"2021","Pendle 009","E02005248",2626,864,326,538,1439,102,770,163,517,90,187,85,90,12,341,213,128,39,39,323,222,101
"2021","Pendle 010","E02005249",3935,1407,480,927,2127,160,1103,275,686,142,347,158,157,32,483,338,145,34,34,401,250,151
"2021","Pendle 011","E02005250",2803,701,281,420,1674,80,1067,183,724,160,154,72,73,9,336,221,115,37,37,428,317,111
"2021","Pendle 012","E02005251",2622,666,350,316,1738,277,881,291,431,159,261,107,127,27,309,201,108,10,10,218,148,70
"2021","Pendle 013","E02005252",3553,949,439,510,2235,322,1269,357,707,205,277,137,112,28,341,194,147,26,26,369,251,118
"2021","Pendle 014","E02007003",4806,1726,726,1000,2885,388,1147,485,448,214,700,317,322,61,630,442,188,20,20,195,95,100
"2021","Preston 001","E02005253",2777,609,300,309,2054,363,1146,420,520,206,342,162,158,22,190,121,69,13,13,114,69,45
"2021","Preston 002","E02005254",3774,771,376,395,2849,446,1647,511,899,237,486,271,197,18,257,172,85,13,13,154,85,69
"2021","Preston 003","E02005255",3925,1066,576,490,2709,490,1519,479,753,287,354,171,164,19,338,192,146,8,8,150,74,76
"2021","Preston 004","E02005256",2873,915,377,538,1830,220,1069,354,512,203,284,163,106,15,242,141,101,15,15,128,54,74
"2021","Preston 005","E02005257",2773,1209,432,777,1464,193,522,207,223,92,303,132,150,21,425,287,138,21,21,100,46,54
"2021","Preston 006","E02005258",3244,967,533,434,2036,387,1153,347,601,205,223,111,93,19,254,132,122,19,19,241,121,120
"2021","Preston 007","E02005259",4096,1261,557,704,2560,261,1182,346,584,252,441,152,245,44,641,438,203,35,35,275,152,123
"2021","Preston 008","E02005260",2859,829,440,389,1924,317,987,369,398,220,315,142,152,21,291,154,137,14,14,106,52,54
"2021","Preston 009","E02005261",4003,1214,398,816,2501,179,1020,314,498,208,510,180,286,44,754,541,213,38,38,288,168,120
"2021","Preston 010","E02005262",3250,993,273,720,2097,199,1050,409,469,172,487,295,169,23,349,245,104,12,12,160,70,90
"2021","Preston 011","E02005263",2741,845,222,623,1539,77,779,190,460,129,276,180,79,17,341,217,124,66,66,357,97,260
"2021","Preston 012","E02005264",4914,1919,419,1500,2464,153,890,312,426,152,689,421,244,24,673,485,188,59,59,531,103,428
"2021","Preston 013","E02005265",4788,1673,580,1093,2863,306,1239,442,536,261,646,329,271,46,637,435,202,35,35,252,99,153
"2021","Preston 014","E02005266",3391,1152,290,862,1937,86,818,210,490,118,381,167,194,20,605,473,132,47,47,302,153,149
"2021","Preston 015","E02005267",2026,750,168,582,1049,50,561,127,332,102,155,93,54,8,233,134,99,50,50,227,85,142
"2021","Preston 016","E02005268",3440,955,325,630,2195,145,1116,263,649,204,336,142,174,20,555,368,187,43,43,290,146,144
"2021","Preston 017","E02005269",4732,2273,404,1869,1944,99,800,303,363,134,546,416,114,16,407,263,144,92,92,515,112,403
"2021","Ribble Valley 001","E02005270",3061,788,448,340,2145,472,1215,551,440,224,287,161,96,30,162,89,73,9,9,128,58,70
"2021","Ribble Valley 002","E02005271",3662,1177,555,622,2369,431,1134,405,510,219,438,242,171,25,346,215,131,20,20,116,50,66
"2021","Ribble Valley 003","E02005272",4020,1395,632,763,2479,387,1162,412,568,182,532,283,220,29,376,240,136,22,22,146,54,92
"2021","Ribble Valley 004","E02005273",2621,736,381,355,1801,338,975,443,336,196,280,145,116,19,189,110,79,19,19,84,36,48
"2021","Ribble Valley 005","E02005274",3399,915,447,468,2383,463,1294,493,561,240,373,207,140,26,249,155,94,4,4,101,41,60
"2021","Ribble Valley 006","E02005275",2546,802,372,430,1671,303,795,316,310,169,329,163,146,20,231,149,82,13,13,73,30,43
"2021","Ribble Valley 007","E02005276",3750,1024,563,461,2608,474,1437,525,667,245,387,186,159,42,296,161,135,14,14,118,50,68
"2021","Ribble Valley 008","E02005277",3685,969,602,367,2587,628,1424,550,585,289,301,170,116,15,225,125,100,9,9,129,59,70
"2021","Rossendale 001","E02005278",3256,845,412,433,2278,307,1246,457,558,231,449,230,190,29,268,156,112,8,8,133,67,66
"2021","Rossendale 002","E02005279",4273,1432,565,867,2585,302,1218,417,580,221,546,271,244,31,495,343,152,24,24,256,162,94
"2021","Rossendale 003","E02005280",4674,1372,518,854,3073,350,1396,524,619,253,664,300,324,40,637,448,189,26,26,229,107,122
"2021","Rossendale 004","E02005281",3867,1304,580,724,2390,278,1152,427,562,163,516,241,244,31,427,273,154,17,17,173,90,83
"2021","Rossendale 007","E02005284",2610,738,360,378,1792,349,889,328,408,153,303,148,135,20,243,163,80,8,8,80,33,47
"2021","Rossendale 008","E02005285",2786,842,390,452,1843,336,880,343,377,160,361,180,159,22,254,139,115,12,12,101,46,55
"2021","Rossendale 009","E02005286",3486,1134,461,673,2233,334,963,396,367,200,519,240,231,48,402,262,140,15,15,119,54,65
"2021","Rossendale 010","E02006884",5608,2040,805,1235,3334,446,1403,556,538,309,781,358,377,46,674,441,233,30,30,234,114,120
"2021","South Ribble 001","E02005287",2205,547,329,218,1592,309,916,295,438,183,197,101,85,11,164,92,72,6,6,66,35,31
"2021","South Ribble 002","E02005288",2643,784,417,367,1753,379,867,359,327,181,277,147,117,13,219,129,90,11,11,106,47,59
"2021","South Ribble 003","E02005289",2618,733,425,308,1815,430,943,385,384,174,217,100,100,17,215,118,97,10,10,70,33,37
"2021","South Ribble 004","E02005290",3074,870,384,486,2091,284,1131,427,508,196,398,230,149,19,267,156,111,11,11,113,45,68
"2021","South Ribble 005","E02005291",2527,792,374,418,1659,260,769,286,328,155,338,165,150,23,272,169,103,20,20,76,38,38
"2021","South Ribble 006","E02005292",2584,950,428,522,1534,203,647,243,274,130,305,151,132,22,370,243,127,9,9,100,54,46
"2021","South Ribble 007","E02005293",2564,964,452,512,1508,257,610,256,229,125,315,165,134,16,311,188,123,15,15,92,36,56
"2021","South Ribble 008","E02005294",2966,809,293,516,2041,260,919,315,424,180,454,223,210,21,390,233,157,18,18,116,54,62
"2021","South Ribble 009","E02005295",3317,961,414,547,2235,347,1072,412,451,209,483,245,204,34,318,208,110,15,15,121,41,80
"2021","South Ribble 010","E02005296",2548,623,399,224,1832,424,977,335,448,194,232,107,106,19,190,98,92,9,9,93,52,41
"2021","South Ribble 011","E02005297",3640,1012,618,394,2509,560,1270,486,493,291,357,188,145,24,309,172,137,13,13,119,56,63
"2021","South Ribble 012","E02005298",3551,926,428,498,2479,361,1237,485,537,215,546,304,217,25,328,185,143,7,7,146,68,78
"2021","South Ribble 013","E02005299",3365,1162,405,757,2071,216,946,330,430,186,504,284,196,24,384,254,130,21,21,132,54,78
"2021","South Ribble 014","E02005300",2112,543,253,290,1471,246,761,320,301,140,250,118,116,16,206,136,70,8,8,98,38,60
"2021","South Ribble 015","E02005301",2792,964,436,528,1712,266,717,310,248,159,342,162,161,19,373,226,147,14,14,116,47,69
"2021","South Ribble 016","E02005302",3308,892,420,472,2303,415,1176,419,566,191,378,208,155,15,327,214,113,7,7,113,54,59
"2021","South Ribble 017","E02005303",2772,963,390,573,1716,225,644,241,245,158,381,136,213,32,448,312,136,18,18,93,41,52
"2021","West Lancashire 001","E02005304",3801,931,528,403,2715,567,1409,524,566,319,406,197,189,20,322,176,146,11,11,155,70,85
"2021","West Lancashire 002","E02005305",3504,973,495,478,2376,525,1203,550,401,252,346,180,144,22,286,142,144,16,16,155,60,95
"2021","West Lancashire 003","E02005306",3217,821,478,343,2242,482,1126,462,416,248,335,177,132,26,280,137,143,19,19,154,71,83
"2021","West Lancashire 004","E02005307",4050,1129,570,559,2760,479,1347,427,649,271,508,262,221,25,412,232,180,14,14,161,71,90
"2021","West Lancashire 005","E02005308",2786,717,433,284,1953,468,1041,382,449,210,251,136,102,13,182,87,95,11,11,116,43,73
"2021","West Lancashire 006","E02005309",3705,981,554,427,2521,480,1244,427,549,268,424,218,168,38,356,204,152,17,17,203,61,142
"2021","West Lancashire 007","E02005310",3477,1294,639,655,1712,326,781,277,341,163,303,189,101,13,275,169,106,27,27,471,50,421
"2021","West Lancashire 008","E02005311",2387,599,353,246,1664,390,855,353,313,189,251,151,86,14,157,73,84,11,11,124,45,79
"2021","West Lancashire 009","E02005312",2681,773,376,397,1784,278,902,336,330,236,368,171,168,29,232,126,106,4,4,124,47,77
"2021","West Lancashire 010","E02005313",3590,1068,347,721,2256,190,866,262,389,215,458,161,256,41,704,479,225,38,38,266,119,147
"2021","West Lancashire 011","E02005314",2893,1033,394,639,1706,206,697,272,257,168,371,173,169,29,412,272,140,20,20,154,59,95
"2021","West Lancashire 012","E02005315",3380,910,585,325,2373,600,1296,423,558,315,230,97,119,14,234,111,123,13,13,97,45,52
"2021","West Lancashire 013","E02005316",2707,829,297,532,1710,153,705,211,337,157,363,133,200,30,456,314,142,33,33,168,72,96
"2021","West Lancashire 014","E02005317",3104,1044,346,698,1837,149,601,211,251,139,412,151,233,28,628,431,197,47,47,223,82,141
"2021","West Lancashire 015","E02005318",3245,888,463,425,2230,402,1158,403,500,255,342,177,131,34,314,186,128,14,14,127,62,65
"2021","Wyre 001","E02005319",4059,1787,673,1114,2052,267,744,337,235,172,462,218,214,30,553,375,178,26,26,220,68,152
"2021","Wyre 002","E02005320",2413,658,393,265,1657,270,774,303,297,174,273,99,150,24,325,210,115,15,15,98,49,49
"2021","Wyre 003","E02005321",2589,749,449,300,1728,409,644,297,201,146,290,122,148,20,368,224,144,17,17,112,51,61
"2021","Wyre 004","E02005322",4822,1564,983,581,3067,879,1368,664,452,252,437,213,193,31,365,219,146,18,18,191,74,117
"2021","Wyre 005","E02005323",3235,942,460,482,2143,322,960,384,387,189,365,124,212,29,480,318,162,16,16,150,65,85
"2021","Wyre 006","E02005324",2880,742,348,394,2013,396,1087,459,439,189,304,172,119,13,220,136,84,6,6,125,54,71
"2021","Wyre 007","E02005325",4385,1437,878,559,2817,796,1316,582,501,233,396,221,152,23,295,148,147,14,14,131,63,68
"2021","Wyre 008","E02005326",4038,1561,854,707,2282,567,936,424,289,223,372,191,150,31,389,218,171,18,18,195,80,115
"2021","Wyre 009","E02005327",2815,649,374,275,2033,440,1032,427,392,213,321,189,115,17,231,121,110,9,9,133,66,67
"2021","Wyre 010","E02005328",3603,1155,687,468,2339,629,1095,518,363,214,347,180,139,28,260,163,97,8,8,109,38,71
"2021","Wyre 011","E02005329",4211,1386,642,744,2658,394,1158,445,514,199,544,256,254,34,538,323,215,24,24,167,72,95
"2021","Wyre 012","E02005330",3941,1119,643,476,2669,671,1333,551,547,235,369,185,152,32,290,169,121,6,6,153,48,105
"2021","Wyre 013","E02005331",3946,1448,736,712,2374,497,1053,416,451,186,393,231,150,12,412,263,149,19,19,124,55,69
"2021","Wyre 014","E02005332",3832,1149,711,438,2558,599,1233,529,465,239,385,219,140,26,332,200,132,9,9,125,53,72
"2021","Bolton 001","E02000984",3209,775,397,378,2338,475,1267,417,602,248,354,176,157,21,229,139,90,13,13,96,45,51
"2021","Bolton 002","E02000985",3225,863,522,341,2258,527,1137,399,505,233,322,156,145,21,265,157,108,7,7,104,44,60
"2021","Bolton 003","E02000986",3646,1185,574,611,2336,369,1183,411,538,234,439,244,169,26,337,194,143,8,8,125,71,54
"2021","Bolton 004","E02000987",3464,1313,549,764,2056,269,849,346,322,181,468,251,184,33,451,273,178,19,19,95,41,54
"2021","Bolton 005","E02000988",3635,1250,499,751,2151,221,1051,301,540,210,367,152,189,26,496,326,170,16,16,234,141,93
"2021","Bolton 006","E02000989",3743,1099,726,373,2539,626,1214,451,491,272,402,194,175,33,289,148,141,8,8,105,48,57
"2021","Bolton 007","E02000990",3691,1084,438,646,2461,372,1200,455,505,240,507,287,183,37,369,238,131,13,13,146,74,72
"2021","Bolton 008","E02000991",3249,938,415,523,2167,282,1107,382,513,212,401,183,194,24,357,213,144,20,20,144,91,53
"2021","Bolton 009","E02000992",2759,809,402,407,1835,341,846,316,382,148,375,179,160,36,257,157,100,16,16,115,47,68
"2021","Bolton 010","E02000993",3449,1124,386,738,2130,123,810,208,429,173,474,189,248,37,702,501,201,21,21,195,113,82
"2021","Bolton 011","E02000994",3317,1189,392,797,1846,105,1018,207,663,148,250,102,134,14,457,309,148,16,16,282,184,98
"2021","Bolton 012","E02000995",3425,1016,497,519,2256,382,1065,325,540,200,351,145,172,34,436,282,154,22,22,153,81,72
"2021","Bolton 013","E02000996",3382,1057,392,665,2170,200,759,227,351,181,470,132,293,45,706,508,198,35,35,155,86,69
"2021","Bolton 014","E02000997",2719,772,341,431,1824,308,903,286,428,189,325,173,130,22,265,160,105,23,23,123,65,58
"2021","Bolton 015","E02000998",3699,1209,355,854,2110,162,1125,228,693,204,292,137,133,22,466,332,134,65,65,380,227,153
"2021","Bolton 016","E02000999",3635,1775,482,1293,1623,75,813,198,504,111,242,147,76,19,448,246,202,45,45,237,127,110
"2021","Bolton 017","E02001000",4065,1513,564,949,2306,281,907,332,382,193,509,269,206,34,584,389,195,25,25,246,121,125
"2021","Bolton 018","E02001001",3211,887,335,552,2086,225,1144,278,646,220,292,141,131,20,402,277,125,23,23,238,155,83
"2021","Bolton 019","E02001002",4075,1163,503,660,2717,400,1137,410,449,278,522,193,289,40,630,425,205,28,28,195,114,81
"2021","Bolton 020","E02001003",2829,673,401,272,1978,478,1105,342,519,244,177,97,66,14,202,106,96,16,16,178,116,62
"2021","Bolton 021","E02001004",3060,898,297,601,1862,115,1087,224,682,181,176,71,94,11,417,242,175,67,67,300,199,101
"2021","Bolton 022","E02001005",3388,1105,349,756,1931,158,1016,236,623,157,300,177,112,11,410,262,148,47,47,352,240,112
"2021","Bolton 023","E02001006",2760,628,226,402,1853,120,1142,229,701,212,175,63,97,15,388,231,157,28,28,279,180,99
"2021","Bolton 024","E02001007",4393,1303,691,612,2882,593,1272,447,525,300,479,184,254,41,518,293,225,20,20,208,86,122
"2021","Bolton 025","E02001008",2830,698,289,409,1863,96,1108,181,774,153,181,58,103,20,462,292,170,16,16,269,184,85
"2021","Bolton 026","E02001009",2977,973,414,559,1835,217,943,254,504,185,272,111,134,27,379,245,134,24,24,169,111,58
"2021","Bolton 027","E02001010",2485,755,218,537,1528,122,641,180,352,109,336,155,162,19,410,268,142,19,19,202,124,78
"2021","Bolton 028","E02001011",4233,1193,596,597,2891,513,1477,536,626,315,516,246,238,32,367,206,161,18,18,149,69,80
"2021","Bolton 029","E02001012",2982,631,312,319,1987,197,1073,245,629,199,290,92,167,31,407,245,162,20,20,364,263,101
"2021","Bolton 030","E02001013",2500,647,362,285,1738,345,909,284,435,190,248,119,102,27,227,127,100,9,9,115,56,59
"2021","Bolton 031","E02001014",3786,1255,525,730,2378,302,1030,393,420,217,511,248,229,34,515,325,190,20,20,153,74,79
"2021","Bolton 032","E02001015",3856,1631,629,1002,2050,241,730,274,296,160,511,242,234,35,543,333,210,25,25,175,85,90
"2021","Bolton 033","E02001016",3341,899,341,558,2209,169,866,245,450,171,471,162,257,52,681,467,214,22,22,233,141,92
"2021","Bolton 034","E02001017",4663,1509,657,852,2940,362,1262,437,525,300,698,261,381,56,592,385,207,26,26,214,108,106
"2021","Bolton 035","E02001018",3110,705,314,391,2274,282,1239,436,531,272,419,190,197,32,325,194,131,9,9,131,77,54
"2021","Bury 001","E02001019",4072,1356,586,770,2574,399,1161,420,561,180,554,320,203,31,445,283,162,15,15,142,64,78
"2021","Bury 002","E02001020",2512,621,434,187,1819,525,924,302,437,185,187,84,87,16,174,91,83,9,9,72,23,49
"2021","Bury 003","E02001021",3177,847,420,427,2243,385,1265,484,533,248,332,162,139,31,248,150,98,13,13,87,31,56
"2021","Bury 004","E02001022",3368,1036,513,523,2149,341,1024,380,440,204,391,205,165,21,373,214,159,20,20,183,90,93
"2021","Bury 005","E02001023",2321,591,319,272,1615,308,762,249,354,159,233,81,135,17,300,186,114,12,12,115,58,57
"2021","Bury 006","E02001024",3377,871,438,433,2404,399,1197,394,551,252,436,192,211,33,363,209,154,9,9,102,45,57
"2021","Bury 007","E02001025",3425,1141,406,735,2100,202,869,276,427,166,394,157,190,47,595,408,187,40,40,184,94,90
"2021","Bury 008","E02001026",4379,1494,368,1126,2484,124,1176,321,683,172,494,286,174,34,635,412,223,55,55,401,248,153
"2021","Bury 009","E02001027",3179,1137,349,788,1896,175,785,237,409,139,446,230,183,33,477,341,136,13,13,146,63,83
"2021","Bury 010","E02001028",3096,778,566,212,2224,617,1184,385,544,255,229,108,103,18,192,93,99,2,2,94,48,46
"2021","Bury 011","E02001029",2876,887,335,552,1724,153,897,227,498,172,299,157,123,19,347,215,132,28,28,265,172,93
"2021","Bury 012","E02001030",2510,569,258,311,1847,282,989,355,406,228,328,144,161,23,234,129,105,14,14,94,40,54
"2021","Bury 013","E02001031",2951,1035,432,603,1758,228,828,278,410,140,313,158,134,21,371,234,137,18,18,158,88,70
"2021","Bury 014","E02001032",3277,973,475,498,2161,315,929,340,370,219,451,199,226,26,441,283,158,25,25,143,69,74
"2021","Bury 015","E02001033",2684,880,315,565,1699,146,706,232,330,144,413,183,195,35,422,308,114,12,12,105,50,55
"2021","Bury 016","E02001034",4088,1774,496,1278,2135,190,733,265,336,132,494,225,231,38,673,489,184,45,45,179,74,105
"2021","Bury 017","E02001035",2995,801,464,337,2058,401,1073,322,494,257,280,143,121,16,293,152,141,11,11,136,77,59
"2021","Bury 018","E02001036",3091,865,316,549,2073,260,880,295,410,175,450,203,202,45,462,319,143,21,21,153,77,76
"2021","Bury 019","E02001037",3035,841,472,369,2077,448,1105,357,540,208,302,178,108,16,211,108,103,11,11,117,44,73
"2021","Bury 020","E02001038",2674,1041,420,621,1503,165,684,238,325,121,326,203,104,19,302,185,117,26,26,130,50,80
"2021","Bury 021","E02001039",3513,1026,429,597,2282,176,942,282,475,185,461,209,220,32,684,470,214,19,19,205,104,101
"2021","Bury 022","E02001040",2632,794,369,425,1692,247,877,264,440,173,347,191,139,17,200,107,93,21,21,146,67,79
"2021","Bury 023","E02001041",3400,1149,507,642,2072,184,883,296,435,152,544,339,168,37,437,257,180,24,24,179,74,105
"2021","Bury 024","E02001042",2894,1069,428,641,1667,235,907,307,466,134,298,193,92,13,219,109,110,8,8,158,59,99
"2021","Bury 025","E02001043",2372,740,281,459,1512,159,718,210,385,123,329,169,131,29,297,181,116,9,9,120,54,66
"2021","Bury 026","E02001044",2791,561,246,315,1998,229,1364,230,934,200,156,84,53,19,234,127,107,15,15,232,134,98
"2021","Manchester 001","E02001045",3604,1278,521,757,2111,186,742,231,355,156,374,124,206,44,776,506,270,33,33,215,107,108
"2021","Manchester 002","E02001046",4378,1301,395,906,2719,162,1149,327,611,211,532,218,258,56,824,582,242,52,52,358,206,152
"2021","Manchester 003","E02001047",4360,1557,599,958,2520,192,1019,293,517,209,446,158,241,47,813,520,293,50,50,283,151,132
"2021","Manchester 004","E02001048",3484,1125,376,749,2045,196,1089,238,665,186,255,125,115,15,464,298,166,41,41,314,208,106
"2021","Manchester 005","E02001049",4209,1209,517,692,2707,278,1119,341,507,271,499,206,245,48,759,493,266,52,52,293,130,163
"2021","Manchester 006","E02001050",3160,1042,298,744,1830,83,777,193,482,102,266,115,126,25,642,482,160,62,62,288,170,118
"2021","Manchester 007","E02001051",3526,975,327,648,2235,157,903,238,455,210,336,125,181,30,784,597,187,55,55,316,185,131
"2021","Manchester 008","E02001052",4414,1195,386,809,2572,82,1649,226,1195,228,228,113,103,12,529,297,232,84,84,647,462,185
"2021","Manchester 009","E02001053",4589,1580,426,1154,2618,103,937,207,594,136,375,121,212,42,1129,782,347,74,74,391,238,153
"2021","Manchester 011","E02001055",3989,1463,461,1002,2261,139,783,254,370,159,418,151,222,45,862,629,233,59,59,265,134,131
"2021","Manchester 012","E02001056",3445,1155,378,777,2030,109,681,144,416,121,325,121,170,34,867,590,277,48,48,260,147,113
"2021","Manchester 015","E02001059",4801,1589,369,1220,2712,119,1058,275,650,133,528,294,205,29,914,649,265,93,93,500,207,293
"2021","Manchester 017","E02001061",4322,1403,453,950,2546,124,997,259,582,156,431,178,218,35,895,644,251,99,99,373,184,189
"2021","Manchester 018","E02001062",3570,1213,244,969,1859,47,860,152,607,101,252,141,88,23,606,372,234,94,94,498,136,362
"2021","Manchester 019","E02001063",3466,1312,170,1142,1472,18,587,187,357,43,335,265,60,10,401,246,155,131,131,682,93,589
"2021","Manchester 020","E02001064",3907,1264,325,939,2287,70,1137,212,767,158,287,122,135,30,710,458,252,83,83,356,206,150
"2021","Manchester 021","E02001065",3843,1209,356,853,2352,152,893,233,479,181,437,170,224,43,797,616,181,73,73,282,123,159
"2021","Manchester 022","E02001066",3448,1141,171,970,1415,35,815,151,553,111,191,139,43,9,285,158,127,89,89,892,236,656
"2021","Manchester 023","E02001067",4123,1216,387,829,2510,88,1056,175,749,132,394,132,217,45,895,647,248,77,77,397,231,166
"2021","Manchester 024","E02001068",4119,1315,383,932,2259,41,942,139,718,85,250,150,89,11,898,576,322,128,128,545,251,294
"2021","Manchester 025","E02001069",4304,1224,250,974,2128,48,954,150,727,77,305,194,100,11,691,497,194,130,130,952,162,790
"2021","Manchester 026","E02001070",3139,1038,219,819,1306,55,738,177,438,123,203,169,34,0,249,126,123,61,61,795,228,567
"2021","Manchester 028","E02001072",3898,1635,249,1386,1778,68,821,227,500,94,506,357,134,15,329,209,120,54,54,485,139,346
"2021","Manchester 029","E02001073",3985,1399,422,977,2090,144,1008,305,564,139,647,480,150,17,245,132,113,46,46,496,109,387
"2021","Manchester 030","E02001074",4226,1342,356,986,2312,114,1128,221,693,214,333,207,96,30,679,386,293,58,58,572,263,309
"2021","Manchester 031","E02001075",3452,1144,257,887,1871,45,917,208,605,104,487,326,145,16,367,223,144,55,55,437,167,270
"2021","Manchester 032","E02001076",2799,665,121,544,919,36,458,126,268,64,185,132,42,11,166,85,81,74,74,1215,97,1118
"2021","Manchester 033","E02001077",3043,957,294,663,1693,127,830,219,458,153,494,337,142,15,214,114,100,28,28,393,120,273
"2021","Manchester 034","E02001078",3801,987,446,541,2343,208,1270,277,746,247,401,238,143,20,428,235,193,36,36,471,206,265
"2021","Manchester 035","E02001079",3441,952,307,645,1858,78,744,166,417,161,322,194,101,27,643,366,277,71,71,631,129,502
"2021","Manchester 036","E02001080",3426,1017,294,723,1259,93,485,130,278,77,364,288,66,10,225,127,98,92,92,1150,74,1076
"2021","Manchester 037","E02001081",2800,907,342,565,1694,106,805,297,404,104,509,361,136,12,258,144,114,16,16,199,60,139
"2021","Manchester 038","E02001082",2901,1030,179,851,1347,93,580,196,327,57,468,407,51,10,172,98,74,34,34,524,51,473
"2021","Manchester 039","E02001083",4077,1679,224,1455,1948,52,703,270,380,53,898,777,110,11,254,157,97,41,41,450,49,401
"2021","Manchester 040","E02001084",3327,985,328,657,1753,151,857,253,472,132,385,258,106,21,317,177,140,43,43,589,82,507
"2021","Manchester 041","E02001085",3202,804,308,496,2090,87,856,163,538,155,322,130,144,48,797,465,332,28,28,308,194,114
"2021","Manchester 042","E02001086",2950,1036,294,742,1680,93,639,208,353,78,489,348,115,26,422,252,170,37,37,234,74,160
"2021","Manchester 043","E02001087",4333,1552,544,1008,2445,283,1220,396,695,129,707,549,143,15,206,110,96,29,29,336,39,297
"2021","Manchester 044","E02001088",3787,1190,427,763,2342,158,917,276,479,162,474,225,220,29,760,499,261,33,33,255,104,151
"2021","Manchester 045","E02001089",3202,836,352,484,2125,233,1138,318,628,192,464,308,134,22,257,126,131,33,33,241,95,146
"2021","Manchester 046","E02001090",3143,1135,470,665,1763,202,837,282,398,157,413,243,147,23,283,151,132,28,28,245,77,168
"2021","Manchester 047","E02001091",3883,1424,529,895,2285,274,893,308,416,169,490,237,211,42,594,376,218,34,34,174,78,96
"2021","Manchester 048","E02001092",3853,1345,386,959,2257,156,955,271,476,208,446,191,226,29,654,446,208,46,46,251,129,122
"2021","Manchester 049","E02001093",3916,1202,393,809,2393,150,827,225,454,148,528,218,275,35,843,610,233,45,45,321,173,148
"2021","Manchester 050","E02001094",3942,1189,401,788,2441,108,771,177,452,142,496,198,258,40,1010,760,250,56,56,312,174,138
"2021","Manchester 051","E02001095",3737,1194,449,745,2241,136,789,239,371,179,476,184,238,54,786,512,274,54,54,302,135,167
"2021","Manchester 052","E02001096",3425,1098,394,704,2087,191,805,269,349,187,419,175,205,39,620,383,237,52,52,240,110,130
"2021","Manchester 053","E02001097",3527,1071,385,686,2147,130,721,227,340,154,475,167,254,54,766,517,249,55,55,309,147,162
"2021","Manchester 054","E02006902",4354,1956,100,1856,1603,20,456,265,167,24,829,781,44,4,174,99,75,124,124,795,24,771
"2021","Manchester 055","E02006912",5024,2260,244,2016,1762,43,378,302,67,9,1112,1083,26,3,62,21,41,167,167,1002,8,994
"2021","Manchester 056","E02006913",3180,1144,161,983,1510,36,663,169,406,88,462,407,46,9,281,183,98,68,68,526,161,365
"2021","Manchester 057","E02006914",2212,984,47,937,747,4,192,99,83,10,383,358,25,0,87,57,30,81,81,481,14,467
"2021","Manchester 058","E02006915",3037,866,153,713,1828,48,909,144,638,127,269,157,93,19,539,351,188,63,63,343,167,176
"2021","Manchester 059","E02006916",3802,1585,157,1428,1529,14,345,171,152,22,779,718,56,5,290,178,112,101,101,688,39,649
"2021","Manchester 060","E02006917",3815,1785,67,1718,1341,14,345,242,90,13,789,770,18,1,77,25,52,116,116,689,10,679
"2021","Manchester 061","E02006983",3228,1136,236,900,1611,40,482,196,218,68,585,468,99,18,455,278,177,49,49,481,109,372
"2021","Manchester 062","E02006984",2965,1140,106,1034,1263,24,345,175,142,28,625,583,34,8,184,114,70,85,85,562,44,518
"2021","Manchester 063","E02006985",2513,444,119,325,1633,52,1023,111,782,130,114,44,65,5,382,255,127,62,62,436,292,144
"2021","Manchester 064","E02006986",2322,696,158,538,1358,46,693,124,517,52,225,134,84,7,353,238,115,41,41,268,130,138
"2021","Oldham 001","E02001098",2728,923,532,391,1715,372,755,289,287,179,309,147,134,28,270,157,113,9,9,90,49,41
"2021","Oldham 002","E02001099",2651,951,401,550,1597,222,637,242,254,141,344,162,145,37,377,237,140,17,17,103,50,53
"2021","Oldham 003","E02001100",2590,769,372,397,1709,329,762,295,296,171,302,128,146,28,307,186,121,9,9,112,57,55
"2021","Oldham 004","E02001101",2452,681,369,312,1674,357,771,272,327,172,264,117,125,22,274,153,121,8,8,97,46,51
"2021","Oldham 005","E02001102",2526,685,284,401,1727,238,818,294,349,175,379,153,187,39,287,182,105,5,5,114,52,62
"2021","Oldham 006","E02001103",2424,723,441,282,1634,341,880,307,401,172,225,122,84,19,182,95,87,6,6,67,26,41
"2021","Oldham 007","E02001104",2840,649,256,393,2022,213,946,299,431,216,441,173,234,34,412,285,127,10,10,169,90,79
"2021","Oldham 008","E02001105",2674,870,472,398,1726,313,731,263,275,193,296,113,148,35,369,217,152,17,17,78,38,40
"2021","Oldham 009","E02001106",2740,1023,436,587,1598,242,635,229,250,156,316,137,154,25,388,241,147,17,17,119,63,56
"2021","Oldham 010","E02001107",2562,669,294,375,1753,245,908,190,553,165,236,100,119,17,338,220,118,26,26,140,86,54
"2021","Oldham 011","E02001108",2357,658,219,439,1556,90,504,167,228,109,366,134,206,26,576,442,134,20,20,143,69,74
"2021","Oldham 012","E02001109",3360,1197,454,743,1995,205,797,287,345,165,373,144,203,26,593,402,191,27,27,168,78,90
"2021","Oldham 013","E02001110",2860,831,399,432,1922,395,979,372,454,153,327,190,116,21,212,116,96,9,9,107,55,52
"2021","Oldham 014","E02001111",3436,1431,366,1065,1715,78,711,162,451,98,285,106,154,25,585,415,170,56,56,290,217,73
"2021","Oldham 015","E02001112",2450,572,303,269,1761,347,934,316,387,231,267,126,113,28,202,111,91,11,11,117,52,65
"2021","Oldham 016","E02001113",2513,498,145,353,1606,53,1043,131,778,134,112,37,69,6,361,217,144,37,37,409,325,84
"2021","Oldham 017","E02001114",3493,1154,506,648,2171,291,1056,250,590,216,345,154,162,29,452,308,144,27,27,168,106,62
"2021","Oldham 018","E02001115",2607,807,352,455,1703,236,687,238,303,146,362,165,173,24,405,239,166,13,13,97,44,53
"2021","Oldham 019","E02001116",2388,527,169,358,1582,96,950,273,574,103,184,68,108,8,325,236,89,27,27,279,214,65
"2021","Oldham 020","E02001117",2623,779,488,291,1757,377,922,316,411,195,237,105,114,18,213,121,92,8,8,87,37,50
"2021","Oldham 021","E02001118",2630,739,417,322,1806,312,927,350,390,187,312,156,122,34,241,143,98,14,14,85,38,47
"2021","Oldham 022","E02001119",2876,492,144,348,1778,52,1242,133,956,153,108,41,58,9,344,207,137,32,32,606,484,122
"2021","Oldham 024","E02001121",2467,613,175,438,1524,44,939,155,674,110,135,44,84,7,379,269,110,27,27,330,251,79
"2021","Oldham 026","E02001123",2786,843,347,496,1750,153,685,205,373,107,345,134,182,29,551,406,145,16,16,193,126,67
"2021","Oldham 027","E02001124",2806,1010,338,672,1604,135,641,168,365,108,346,143,165,38,459,306,153,23,23,192,109,83
"2021","Oldham 028","E02001125",3335,1055,458,597,2109,250,948,317,410,221,438,197,190,51,451,273,178,22,22,171,95,76
"2021","Oldham 029","E02001126",3359,921,308,613,2203,145,885,229,504,152,386,133,226,27,734,524,210,53,53,235,143,92
"2021","Oldham 030","E02001127",2944,780,329,451,1979,159,798,235,384,179,350,125,179,46,649,451,198,23,23,185,104,81
"2021","Oldham 031","E02001128",3286,1078,459,619,2048,245,806,284,322,200,401,178,189,34,572,379,193,24,24,160,74,86
"2021","Oldham 032","E02001129",3064,1118,410,708,1791,158,625,226,285,114,468,242,195,31,518,311,207,22,22,155,67,88
"2021","Oldham 033","E02001130",2587,827,434,393,1650,298,753,267,258,228,270,126,127,17,316,181,135,13,13,110,58,52
"2021","Oldham 034","E02001131",2308,639,367,272,1570,232,671,228,278,165,310,120,161,29,350,217,133,7,7,99,39,60
"2021","Oldham 036","E02007000",2202,508,146,362,1395,45,811,120,593,98,113,41,67,5,382,276,106,44,44,299,231,68
"2021","Oldham 037","E02007001",2224,372,155,217,1452,88,941,143,657,141,99,38,47,14,302,194,108,22,22,400,290,110
"2021","Rochdale 001","E02001132",3057,1071,434,637,1867,260,757,284,322,151,429,230,172,27,405,271,134,16,16,119,55,64
"2021","Rochdale 002","E02001133",2740,687,318,369,1950,333,915,330,417,168,418,185,201,32,275,171,104,9,9,103,58,45
"2021","Rochdale 003","E02001134",2655,711,349,362,1831,316,963,410,383,170,322,168,127,27,224,124,100,6,6,113,65,48
"2021","Rochdale 004","E02001135",3201,1111,410,701,1882,139,872,203,536,133,307,124,151,32,546,399,147,18,18,208,142,66
"2021","Rochdale 005","E02001136",3740,1119,519,600,2403,401,1125,395,511,219,410,189,183,38,445,281,164,22,22,218,130,88
"2021","Rochdale 006","E02001137",2613,664,308,356,1855,313,968,368,387,213,341,166,145,30,225,123,102,8,8,94,47,47
"2021","Rochdale 007","E02001138",3645,1010,537,473,2481,516,1295,460,562,273,336,170,135,31,326,187,139,8,8,154,80,74
"2021","Rochdale 008","E02001139",3245,849,272,577,1978,78,1144,192,765,187,222,105,103,14,483,311,172,51,51,418,308,110
"2021","Rochdale 009","E02001140",3050,887,347,540,1919,197,845,224,472,149,336,133,181,22,518,369,149,23,23,244,155,89
"2021","Rochdale 010","E02001141",4582,1781,480,1301,2414,121,1223,254,771,198,319,141,154,24,684,473,211,67,67,387,245,142
"2021","Rochdale 011","E02001142",2430,656,404,252,1632,400,863,272,386,205,169,95,56,18,188,97,91,12,12,142,86,56
"2021","Rochdale 012","E02001143",4047,1083,357,726,2607,178,1229,268,724,237,397,153,206,38,745,529,216,58,58,357,243,114
"2021","Rochdale 013","E02001144",2862,961,387,574,1794,268,797,294,349,154,372,194,149,29,340,236,104,17,17,107,47,60
"2021","Rochdale 014","E02001145",3079,898,443,455,2070,323,956,351,404,201,393,190,173,30,388,255,133,10,10,111,55,56
"2021","Rochdale 015","E02001146",3080,729,271,458,1937,78,1151,162,769,220,164,62,85,17,482,288,194,62,62,414,294,120
"2021","Rochdale 016","E02001147",4144,1213,445,768,2726,208,1167,325,624,218,557,216,304,37,752,521,231,42,42,205,121,84
"2021","Rochdale 017","E02001148",4381,1392,642,750,2751,356,1194,409,533,252,527,254,238,35,635,423,212,39,39,238,115,123
"2021","Rochdale 018","E02001149",4817,1880,743,1137,2735,266,999,383,402,214,638,276,293,69,798,590,208,34,34,202,93,109
"2021","Rochdale 019","E02001150",3695,1041,402,639,2461,259,939,351,398,190,507,197,261,49,723,498,225,33,33,193,96,97
"2021","Rochdale 020","E02001151",4191,1180,465,715,2831,376,1317,423,591,303,570,239,286,45,547,378,169,21,21,180,89,91
"2021","Rochdale 021","E02001152",4128,1282,463,819,2655,279,1074,365,470,239,585,265,272,48,683,464,219,34,34,191,96,95
"2021","Rochdale 022","E02001153",4933,1482,596,886,3135,231,1130,329,624,177,693,258,376,59,997,682,315,84,84,316,204,112
"2021","Rochdale 023","E02001154",4383,1389,525,864,2772,260,1105,397,445,263,635,276,307,52,747,505,242,25,25,222,109,113
"2021","Rochdale 024","E02001155",3449,1425,548,877,1870,206,744,293,315,136,418,220,168,30,481,334,147,21,21,154,68,86
"2021","Rochdale 025","E02001156",4099,1140,619,521,2746,498,1400,423,639,338,423,178,207,38,412,246,166,13,13,213,123,90
"2021","Salford 001","E02001157",3468,1094,404,690,2167,142,650,177,328,145,490,163,268,59,825,620,205,60,60,207,132,75
"2021","Salford 002","E02001158",2725,1022,371,651,1563,158,557,211,222,124,351,140,180,31,476,336,140,21,21,140,65,75
"2021","Salford 003","E02001159",3258,1044,341,703,2056,149,799,278,387,134,605,328,239,38,484,321,163,19,19,158,91,67
"2021","Salford 004","E02001160",2859,741,286,455,1984,194,773,239,379,155,405,156,208,41,586,415,171,26,26,134,89,45
"2021","Salford 005","E02001161",2665,912,381,531,1636,230,740,289,284,167,331,170,134,27,312,211,101,23,23,117,46,71
"2021","Salford 006","E02001162",2685,981,409,572,1579,255,609,205,236,168,339,150,163,26,356,227,129,20,20,125,55,70
"2021","Salford 007","E02001163",4423,1402,578,824,2839,442,1211,416,547,248,686,381,264,41,471,287,184,29,29,182,83,99
"2021","Salford 008","E02001164",2844,814,228,586,1846,131,664,207,316,141,453,219,209,25,571,425,146,27,27,184,78,106
"2021","Salford 009","E02001165",2663,812,344,468,1702,153,720,237,324,159,430,228,175,27,390,251,139,9,9,149,53,96
"2021","Salford 010","E02001166",2383,741,304,437,1458,184,997,202,704,91,110,61,43,6,156,105,51,11,11,184,108,76
"2021","Salford 011","E02001167",2810,946,300,646,1665,148,822,244,464,114,295,164,105,26,360,224,136,40,40,199,96,103
"2021","Salford 012","E02001168",4218,1304,530,774,2681,259,1131,376,526,229,585,295,259,31,683,431,252,23,23,233,111,122
"2021","Salford 013","E02001169",4454,1033,558,475,3257,559,1740,534,844,362,560,288,230,42,378,235,143,20,20,164,68,96
"2021","Salford 014","E02001170",4145,1143,637,506,2874,524,1555,477,817,261,488,253,207,28,293,176,117,14,14,128,56,72
"2021","Salford 015","E02001171",2549,678,340,338,1743,273,853,248,388,217,367,194,154,19,238,134,104,12,12,128,51,77
"2021","Salford 017","E02001173",3574,1207,321,886,1863,86,587,200,288,99,423,226,162,35,711,504,207,56,56,504,112,392
"2021","Salford 018","E02001174",2339,661,287,374,1407,164,622,215,256,151,366,202,142,22,228,128,100,27,27,271,68,203
"2021","Salford 019","E02001175",3076,944,327,617,1914,171,764,257,353,154,508,277,192,39,448,282,166,23,23,218,105,113
"2021","Salford 020","E02001176",5472,2248,833,1415,2858,329,1283,380,653,250,765,521,208,36,434,244,190,47,47,366,107,259
"2021","Salford 021","E02001177",5822,2023,737,1286,3235,239,1261,415,612,234,889,598,246,45,773,493,280,73,73,564,152,412
"2021","Salford 023","E02001179",3170,1181,368,813,1583,116,500,196,198,106,462,309,131,22,457,298,159,48,48,406,98,308
"2021","Salford 024","E02001180",2543,1165,332,833,1177,61,390,106,229,55,269,158,86,25,413,284,129,44,44,201,72,129
"2021","Salford 025","E02001181",2631,971,297,674,1479,107,533,172,247,114,336,141,160,35,473,314,159,30,30,181,97,84
"2021","Salford 026","E02001182",3328,1255,307,948,1857,95,672,226,335,111,504,296,183,25,518,370,148,68,68,216,74,142
"2021","Salford 027","E02001183",3189,1076,293,783,1860,105,662,227,311,124,525,275,215,35,537,368,169,31,31,253,78,175
"2021","Salford 029","E02001185",4088,1208,596,612,2676,397,1089,359,439,291,547,219,285,43,624,415,209,19,19,204,91,113
"2021","Salford 030","E02001186",4478,1400,541,859,2875,319,1202,380,578,244,664,294,316,54,669,439,230,21,21,203,101,102
"2021","Salford 031","E02006957",2670,1055,244,811,1457,72,861,144,650,67,145,51,81,13,335,226,109,44,44,158,80,78
"2021","Salford 032","E02006958",3070,1022,225,797,1582,70,668,172,422,74,376,234,115,27,399,267,132,69,69,466,121,345
"2021","Salford 033","E02006959",4635,2080,130,1950,1708,13,404,242,132,30,922,874,42,6,173,113,60,196,196,847,20,827
"2021","Salford 034","E02006960",3798,1507,153,1354,1651,21,505,201,238,66,746,636,91,19,300,213,87,79,79,640,47,593
"2021","Salford 035","E02006961",3150,1252,209,1043,1484,70,407,141,201,65,528,374,138,16,416,301,115,63,63,414,76,338
"2021","Salford 036","E02006962",2477,758,107,651,1010,29,277,103,108,66,460,410,45,5,167,112,55,77,77,709,36,673
"2021","Salford 037","E02006963",3458,1458,62,1396,1450,35,469,274,178,17,786,753,32,1,64,27,37,96,96,550,16,534
"2021","Stockport 001","E02001187",3083,982,388,594,1945,246,812,287,320,205,414,202,182,30,444,277,167,29,29,156,74,82
"2021","Stockport 002","E02001188",3830,1306,341,965,2319,161,816,291,370,155,643,368,229,46,667,475,192,32,32,205,91,114
"2021","Stockport 003","E02001189",3594,1056,435,621,2370,295,1114,386,488,240,504,273,200,31,436,250,186,21,21,168,64,104
"2021","Stockport 004","E02001190",3484,1366,292,1074,1958,84,580,181,258,141,492,220,240,32,776,586,190,26,26,160,79,81
"2021","Stockport 005","E02001191",2629,927,429,498,1610,333,798,281,342,175,284,144,118,22,186,94,92,9,9,92,32,60
"2021","Stockport 006","E02001192",2854,1006,413,593,1688,199,952,313,496,143,366,227,116,23,153,72,81,18,18,160,53,107
"2021","Stockport 007","E02001193",3013,1114,306,808,1755,148,650,237,286,127,489,304,152,33,416,267,149,52,52,144,67,77
"2021","Stockport 008","E02001194",2653,815,372,443,1726,277,988,269,573,146,277,167,98,12,172,97,75,12,12,112,51,61
"2021","Stockport 009","E02001195",3267,969,443,526,2169,291,968,333,404,231,508,246,227,35,386,226,160,16,16,129,52,77
"2021","Stockport 010","E02001196",3418,1047,606,441,2244,447,1059,347,485,227,385,188,161,36,344,203,141,9,9,127,50,77
"2021","Stockport 011","E02001197",2626,778,361,417,1739,202,961,283,520,158,279,142,118,19,275,157,118,22,22,109,57,52
"2021","Stockport 012","E02001198",3347,1161,610,551,2071,366,813,270,354,189,392,184,172,36,489,336,153,11,11,115,51,64
"2021","Stockport 013","E02001199",3399,1119,537,582,2130,288,1187,348,614,225,405,256,134,15,233,126,107,17,17,150,80,70
"2021","Stockport 014","E02001200",4080,2007,450,1557,1863,105,576,270,239,67,482,301,161,20,665,478,187,35,35,210,62,148
"2021","Stockport 015","E02001201",2457,689,287,402,1660,179,731,248,330,153,396,184,188,24,340,212,128,14,14,108,45,63
"2021","Stockport 016","E02001202",3178,1236,325,911,1759,81,606,256,267,83,532,345,164,23,499,335,164,41,41,183,59,124
"2021","Stockport 017","E02001203",2453,559,354,205,1819,470,1008,358,482,168,205,109,90,6,131,64,67,5,5,75,35,40
"2021","Stockport 018","E02001204",3781,1113,395,718,2497,220,1188,401,561,226,620,332,256,32,445,293,152,24,24,171,74,97
"2021","Stockport 019","E02001205",3971,1441,443,998,2351,232,956,346,415,195,545,310,207,28,594,428,166,24,24,179,74,105
"2021","Stockport 020","E02001206",3101,899,544,355,2098,404,1017,304,493,220,336,177,143,16,328,212,116,13,13,104,41,63
"2021","Stockport 021","E02001207",2938,847,446,401,1981,360,1023,367,430,226,346,164,150,32,243,144,99,9,9,110,53,57
"2021","Stockport 022","E02001208",3444,1236,476,760,2072,203,960,316,454,190,506,303,180,23,381,238,143,22,22,136,54,82
"2021","Stockport 023","E02001209",3441,1110,364,746,2196,171,944,298,482,164,558,328,205,25,494,341,153,29,29,135,43,92
"2021","Stockport 024","E02001210",3041,902,430,472,1986,253,815,244,390,181,370,149,186,35,529,359,170,19,19,153,83,70
"2021","Stockport 025","E02001211",2606,680,391,289,1785,260,1095,291,627,177,238,137,88,13,183,104,79,9,9,141,74,67
"2021","Stockport 026","E02001212",2684,753,249,504,1760,108,716,212,363,141,361,149,182,30,550,376,174,25,25,171,93,78
"2021","Stockport 027","E02001213",4278,1364,587,777,2749,292,1447,449,746,252,578,329,219,30,410,230,180,22,22,165,74,91
"2021","Stockport 028","E02001214",3172,927,546,381,2025,389,1120,270,586,264,234,126,94,14,269,143,126,13,13,220,118,102
"2021","Stockport 029","E02001215",2624,814,505,309,1713,387,825,291,370,164,280,144,122,14,213,126,87,8,8,97,49,48
"2021","Stockport 030","E02001216",3322,1015,498,517,2166,427,1187,328,667,192,299,168,117,14,246,126,120,7,7,141,56,85
"2021","Stockport 031","E02001217",3137,1159,533,626,1850,264,785,248,398,139,416,247,142,27,361,234,127,24,24,128,57,71
"2021","Stockport 032","E02001218",2360,516,301,215,1751,380,974,269,525,180,194,89,90,15,193,113,80,10,10,93,50,43
"2021","Stockport 033","E02001219",2219,563,387,176,1575,359,821,245,391,185,230,116,97,17,165,80,85,0,0,81,33,48
"2021","Stockport 034","E02001220",2316,648,334,314,1570,249,866,223,469,174,228,110,108,10,219,118,101,8,8,98,44,54
"2021","Stockport 035","E02001221",2385,550,384,166,1743,401,964,301,459,204,213,106,96,11,159,70,89,6,6,92,41,51
"2021","Stockport 036","E02001222",2414,593,419,174,1633,347,919,223,479,217,181,91,78,12,178,73,105,8,8,188,114,74
"2021","Stockport 037","E02001223",2797,768,474,294,1938,423,1100,344,548,208,218,98,105,15,191,101,90,6,6,91,36,55
"2021","Stockport 038","E02001224",2550,704,464,240,1757,540,874,342,356,176,202,110,72,20,134,57,77,7,7,89,34,55
"2021","Stockport 039","E02001225",3026,790,487,303,2136,384,1191,313,654,224,281,151,113,17,268,153,115,12,12,100,43,57
"2021","Stockport 040","E02001226",2785,752,390,362,1851,289,1004,257,536,211,258,125,114,19,275,168,107,25,25,182,104,78
"2021","Stockport 041","E02001227",2331,566,413,153,1695,422,975,289,518,168,141,59,70,12,156,73,83,1,1,70,38,32
"2021","Stockport 042","E02001228",2519,589,393,196,1845,396,1104,335,586,183,213,120,83,10,129,69,60,3,3,85,38,47
"2021","Tameside 001","E02001229",4671,1566,578,988,2950,356,1294,479,596,219,758,433,292,33,518,352,166,24,24,155,71,84
"2021","Tameside 002","E02001230",2344,574,328,246,1626,340,863,275,335,253,199,80,103,16,215,120,95,9,9,144,66,78
"2021","Tameside 003","E02001231",2862,706,297,409,2027,260,963,319,456,188,388,133,217,38,398,256,142,18,18,129,68,61
"2021","Tameside 004","E02001232",3613,1075,385,690,2361,244,980,321,469,190,460,193,229,38,647,472,175,30,30,177,93,84
"2021","Tameside 005","E02001233",3372,1149,566,583,2038,259,892,305,380,207,390,172,183,35,480,315,165,17,17,185,118,67
"2021","Tameside 006","E02001234",3265,1042,400,642,2049,185,813,261,382,170,411,156,213,42,603,425,178,37,37,174,105,69
"2021","Tameside 007","E02001235",3055,945,332,613,1921,201,831,287,392,152,452,229,198,25,416,273,143,21,21,189,94,95
"2021","Tameside 008","E02001236",2623,898,347,551,1592,123,560,186,270,104,360,142,178,40,526,378,148,23,23,133,65,68
"2021","Tameside 009","E02001237",3087,998,337,661,1970,188,868,307,398,163,462,203,222,37,424,289,135,28,28,119,54,65
"2021","Tameside 010","E02001238",3539,1202,562,640,2178,285,967,333,376,258,456,210,212,34,449,285,164,21,21,159,73,86
"2021","Tameside 011","E02001239",3987,1185,479,706,2580,244,1106,382,444,280,597,236,294,67,606,389,217,27,27,222,106,116
"2021","Tameside 012","E02001240",2630,696,292,404,1750,211,765,271,306,188,376,176,165,35,377,217,160,21,21,184,88,96
"2021","Tameside 013","E02001241",4711,2091,534,1557,2265,111,983,238,598,147,402,225,154,23,710,500,210,59,59,355,221,134
"2021","Tameside 014","E02001242",2886,762,357,405,1965,261,978,315,460,203,407,189,187,31,308,188,120,11,11,159,79,80
"2021","Tameside 015","E02001243",3828,1307,512,795,2385,436,1084,416,439,229,464,252,184,28,383,240,143,18,18,136,56,80
"2021","Tameside 016","E02001244",2304,599,333,266,1604,296,752,275,276,201,304,136,138,30,245,142,103,7,7,101,48,53
"2021","Tameside 017","E02001245",3622,1308,437,871,2158,205,903,356,383,164,523,246,239,38,505,348,157,22,22,156,77,79
"2021","Tameside 018","E02001246",3186,1062,462,600,1989,247,795,273,344,178,462,194,217,51,466,313,153,19,19,135,69,66
"2021","Tameside 019","E02001247",3272,1104,437,667,2021,195,828,316,349,163,500,223,231,46,480,311,169,18,18,147,83,64
"2021","Tameside 020","E02001248",5221,1823,572,1251,3179,240,1283,404,662,217,836,412,375,49,783,528,255,37,37,219,121,98
"2021","Tameside 021","E02001249",2920,1004,371,633,1788,212,695,253,287,155,404,194,189,21,450,272,178,27,27,128,59,69
"2021","Tameside 022","E02001250",2738,704,326,378,1925,306,963,359,371,233,377,177,158,42,268,153,115,11,11,109,55,54
"2021","Tameside 023","E02001251",2837,943,418,525,1786,325,753,338,262,153,383,217,144,22,317,210,107,8,8,108,43,65
"2021","Tameside 024","E02001252",3277,987,528,459,2149,378,1045,356,441,248,407,195,181,31,304,156,148,15,15,141,71,70
"2021","Tameside 025","E02001253",2259,767,290,477,1401,189,620,219,244,157,277,140,120,17,304,176,128,11,11,91,44,47
"2021","Tameside 026","E02001254",2492,786,365,421,1608,256,603,210,235,158,351,143,170,38,376,224,152,22,22,98,44,54
"2021","Tameside 027","E02001255",3232,1034,356,678,2030,140,671,228,305,138,497,215,245,37,698,490,208,24,24,168,93,75
"2021","Tameside 028","E02001256",4172,1452,516,936,2441,197,1149,318,640,191,482,239,209,34,580,417,163,33,33,279,181,98
"2021","Tameside 029","E02001257",4282,1650,803,847,2468,376,935,352,374,209,504,224,230,50,631,396,235,22,22,164,87,77
"2021","Tameside 030","E02001258",3231,955,493,462,2149,380,1012,372,437,203,430,230,173,27,315,195,120,12,12,127,61,66
"2021","Trafford 001","E02001259",4762,1801,387,1414,2407,73,1033,227,653,153,525,378,135,12,671,423,248,105,105,554,223,331
"2021","Trafford 002","E02001260",3075,738,402,336,2200,331,1170,342,578,250,344,175,141,28,346,197,149,9,9,137,69,68
"2021","Trafford 003","E02001261",3664,1123,286,837,2259,117,992,265,555,172,545,322,194,29,567,354,213,38,38,282,95,187
"2021","Trafford 004","E02001262",3085,841,338,503,1823,151,952,194,535,223,284,160,106,18,404,211,193,32,32,421,217,204
"2021","Trafford 005","E02001263",3410,883,515,368,2402,465,1318,379,647,292,343,161,155,27,270,140,130,6,6,125,60,65
"2021","Trafford 006","E02001264",3300,772,318,454,2326,213,1230,335,656,239,406,209,163,34,462,242,220,15,15,202,118,84
"2021","Trafford 007","E02001265",3387,949,487,462,2296,303,1154,345,546,263,408,175,203,30,419,247,172,12,12,142,75,67
"2021","Trafford 008","E02001266",3093,1150,437,713,1803,207,831,258,408,165,293,151,112,30,441,291,150,31,31,140,66,74
"2021","Trafford 009","E02001267",3390,1336,585,751,1927,242,950,308,476,166,424,267,141,16,302,169,133,9,9,127,43,84
"2021","Trafford 010","E02001268",2957,808,477,331,2059,385,1108,338,541,229,309,153,130,26,243,127,116,14,14,90,45,45
"2021","Trafford 011","E02001269",3578,1254,512,742,2074,180,993,281,548,164,439,258,161,20,433,262,171,29,29,250,98,152
"2021","Trafford 012","E02001270",3651,1155,472,683,2377,243,1257,311,776,170,505,348,137,20,348,225,123,24,24,119,47,72
"2021","Trafford 013","E02001271",2788,828,398,430,1842,223,899,249,475,175,319,141,150,28,381,236,145,20,20,118,61,57
"2021","Trafford 014","E02001272",3368,987,463,524,2255,359,1256,318,757,181,358,200,138,20,273,154,119,9,9,126,59,67
"2021","Trafford 015","E02001273",4349,1658,645,1013,2544,300,1438,404,901,133,497,345,140,12,286,189,97,23,23,147,48,99
"2021","Trafford 016","E02001274",3145,777,490,287,2230,481,1382,370,759,253,176,85,80,11,180,87,93,11,11,138,64,74
"2021","Trafford 017","E02001275",3345,1010,428,582,2160,188,787,293,323,171,430,142,248,40,732,505,227,23,23,175,83,92
"2021","Trafford 018","E02001276",3245,885,471,414,2203,227,1080,273,606,201,386,164,184,38,492,314,178,18,18,157,87,70
"2021","Trafford 019","E02001277",3802,1147,387,760,2456,150,1181,267,719,195,427,214,170,43,676,439,237,22,22,199,105,94
"2021","Trafford 020","E02001278",3363,807,371,436,2428,340,1523,355,915,253,301,156,125,20,244,139,105,20,20,128,64,64
"2021","Trafford 021","E02001279",3165,642,360,282,2407,382,1542,384,884,274,265,132,114,19,213,109,104,5,5,116,58,58
"2021","Trafford 022","E02001280",3513,1159,605,554,2176,304,1033,273,575,185,307,130,146,31,509,326,183,23,23,178,92,86
"2021","Trafford 023","E02001281",3075,751,501,250,2229,456,1341,330,761,250,236,110,108,18,189,102,87,7,7,95,48,47
"2021","Trafford 024","E02001282",4225,1225,482,743,2818,258,1513,347,976,190,618,409,191,18,405,261,144,24,24,182,63,119
"2021","Trafford 025","E02001283",4096,1290,575,715,2660,447,1450,409,848,193,458,333,101,24,278,170,108,27,27,146,60,86
"2021","Trafford 026","E02001284",3122,689,359,330,2320,297,1498,361,933,204,272,153,108,11,242,142,100,11,11,113,43,70
"2021","Trafford 027","E02001285",3255,978,518,460,2169,442,1183,328,669,186,289,194,82,13,245,160,85,10,10,108,51,57
"2021","Trafford 028","E02001286",3060,730,497,233,2151,440,1350,325,790,235,145,55,77,13,211,122,89,5,5,179,105,74
"2021","Wigan 001","E02001287",2801,697,341,356,2022,286,1040,361,476,203,459,247,186,26,229,144,85,8,8,82,35,47
"2021","Wigan 002","E02001288",3617,1010,509,501,2502,454,1283,452,580,251,451,253,170,28,301,159,142,13,13,105,45,60
"2021","Wigan 003","E02001289",4451,1230,690,540,3069,650,1555,582,658,315,473,226,213,34,380,208,172,11,11,152,65,87
"2021","Wigan 004","E02001290",2692,812,424,388,1788,306,914,335,390,189,297,140,133,24,263,157,106,8,8,92,39,53
"2021","Wigan 005","E02001291",3329,956,455,501,2261,294,993,359,396,238,471,199,235,37,478,290,188,25,25,112,53,59
"2021","Wigan 006","E02001292",3687,1255,511,744,2298,423,1130,406,496,228,428,248,163,17,294,166,128,23,23,134,41,93
"2021","Wigan 007","E02001293",2674,713,337,376,1856,321,906,349,345,212,352,159,169,24,271,157,114,6,6,105,48,57
"2021","Wigan 008","E02001294",3681,1353,430,923,2171,223,955,345,422,188,561,319,215,27,402,237,165,30,30,157,61,96
"2021","Wigan 009","E02001295",3537,1632,543,1089,1762,167,672,264,262,146,414,199,180,35,481,294,187,28,28,143,69,74
"2021","Wigan 010","E02001296",3602,1087,413,674,2302,138,742,237,343,162,590,187,349,54,793,557,236,39,39,213,123,90
"2021","Wigan 011","E02001297",2925,982,428,554,1832,222,836,287,362,187,416,210,174,32,346,210,136,12,12,111,53,58
"2021","Wigan 012","E02001298",3363,1032,373,659,2135,185,834,268,375,191,503,189,265,49,582,366,216,31,31,196,116,80
"2021","Wigan 013","E02001299",3875,1270,497,773,2454,307,1152,432,464,256,521,274,220,27,454,280,174,20,20,151,67,84
"2021","Wigan 014","E02001300",3505,1156,502,654,2201,296,886,343,332,211,552,244,264,44,444,269,175,23,23,148,76,72
"2021","Wigan 015","E02001301",4078,1498,494,1004,2372,207,911,347,397,167,660,330,285,45,566,380,186,28,28,208,101,107
"2021","Wigan 016","E02001302",3359,1039,529,510,2166,313,935,300,406,229,458,171,236,51,442,281,161,18,18,154,92,62
"2021","Wigan 017","E02001303",3877,1291,421,870,2388,223,900,288,434,178,581,276,266,39,647,442,205,37,37,198,106,92
"2021","Wigan 018","E02001304",5611,1632,901,731,3841,705,1942,651,904,387,658,322,291,45,518,317,201,18,18,138,59,79
"2021","Wigan 019","E02001305",3640,916,480,436,2570,484,1230,505,465,260,491,233,231,27,345,194,151,20,20,154,77,77
"2021","Wigan 020","E02001306",3028,741,391,350,2183,431,1055,387,366,302,366,145,188,33,320,174,146,11,11,104,51,53
"2021","Wigan 021","E02001307",4617,941,511,430,3523,636,1961,573,923,465,570,263,256,51,351,190,161,5,5,153,79,74
"2021","Wigan 022","E02001308",2720,889,406,483,1728,310,746,295,291,160,347,166,152,29,313,190,123,12,12,103,52,51
"2021","Wigan 023","E02001309",3828,1318,526,792,2383,324,976,361,441,174,610,319,250,41,452,283,169,21,21,127,59,68
"2021","Wigan 024","E02001310",3911,1218,423,795,2500,257,1064,354,500,210,590,253,290,47,563,387,176,26,26,193,93,100
"2021","Wigan 025","E02001311",3721,1245,517,728,2334,342,987,372,404,211,510,241,236,33,477,285,192,18,18,142,55,87
"2021","Wigan 026","E02001312",3425,930,323,607,2337,286,1020,361,459,200,570,264,261,45,449,283,166,12,12,158,89,69
"2021","Wigan 027","E02001313",3513,1146,419,727,2220,253,939,355,415,169,490,211,247,32,505,318,187,33,33,147,79,68
"2021","Wigan 028","E02001314",3226,782,332,450,2325,307,1263,418,599,246,387,148,215,24,361,209,152,7,7,119,67,52
"2021","Wigan 029","E02001315",4008,1009,468,541,2850,425,1337,480,630,227,684,348,298,38,398,230,168,6,6,149,60,89
"2021","Wigan 030","E02001316",3493,1443,359,1084,1883,137,682,269,302,111,558,279,256,23,467,317,150,39,39,167,75,92
"2021","Wigan 031","E02001317",3905,1208,397,811,2573,349,1126,426,456,244,612,275,308,29,463,300,163,23,23,124,67,57
"2021","Wigan 032","E02001318",3403,1050,563,487,2234,406,987,337,379,271,419,164,213,42,408,250,158,14,14,119,55,64
"2021","Wigan 033","E02001319",3669,1217,471,746,2276,219,879,346,345,188,611,292,283,36,542,335,207,25,25,176,75,101
"2021","Wigan 034","E02001320",3397,1184,448,736,2079,317,834,331,306,197,456,182,230,44,456,274,182,16,16,134,61,73
"2021","Wigan 035","E02001321",3340,851,428,423,2370,401,1163,421,490,252,400,172,188,40,391,236,155,15,15,119,54,65
"2021","Wigan 036","E02001322",3186,958,464,494,2130,426,961,362,379,220,384,195,151,38,340,186,154,19,19,98,38,60
"2021","Wigan 037","E02001323",3433,1107,517,590,2215,370,1031,328,488,215,422,196,180,46,377,221,156,15,15,111,49,62
"2021","Wigan 038","E02001324",3601,1148,489,659,2302,301,966,368,405,193,533,242,253,38,485,313,172,17,17,151,79,72
"2021","Wigan 039","E02001325",3841,998,459,539,2711,467,1329,498,570,261,559,306,229,24,346,196,150,10,10,132,59,73
"2021","Wigan 040","E02001326",3545,1007,501,506,2416,425,1143,416,500,227,488,259,202,27,352,219,133,8,8,122,64,58
"2021","Knowsley 001","E02001327",3630,818,299,519,2551,170,817,248,346,223,548,213,284,51,984,694,290,32,32,261,143,118
"2021","Knowsley 002","E02001328",4414,1228,525,703,2984,352,1324,419,532,373,675,283,352,40,607,361,246,26,26,202,111,91
"2021","Knowsley 003","E02001329",3339,1296,377,919,1839,128,668,211,238,219,360,144,171,45,649,413,236,34,34,204,110,94
"2021","Knowsley 004","E02001330",3972,1285,419,866,2483,229,838,288,294,256,457,178,229,50,920,617,303,39,39,204,109,95
"2021","Knowsley 005","E02001331",4338,1397,543,854,2661,305,904,306,334,264,503,168,257,78,896,549,347,53,53,280,148,132
"2021","Knowsley 006","E02001332",3354,1195,389,806,1979,158,670,221,280,169,372,152,178,42,739,465,274,40,40,180,89,91
"2021","Knowsley 007","E02001333",4412,1689,596,1093,2569,225,985,365,420,200,658,353,265,40,660,427,233,41,41,154,70,84
"2021","Knowsley 008","E02001334",2822,874,316,558,1806,96,538,170,222,146,342,146,159,37,782,507,275,48,48,142,74,68
"2021","Knowsley 009","E02001335",3455,983,394,589,2327,279,1175,380,506,289,457,213,205,39,395,230,165,21,21,145,66,79
"2021","Knowsley 010","E02001336",3039,1061,392,669,1823,120,563,169,207,187,318,113,165,40,777,498,279,45,45,155,95,60
"2021","Knowsley 011","E02001337",2407,728,334,394,1543,146,698,195,286,217,274,123,124,27,405,239,166,20,20,136,80,56
"2021","Knowsley 012","E02001338",2646,828,371,457,1683,156,624,220,230,174,407,197,178,32,475,296,179,21,21,135,68,67
"2021","Knowsley 013","E02001339",2688,816,366,450,1752,185,669,213,273,183,334,136,161,37,548,355,193,16,16,120,62,58
"2021","Knowsley 014","E02001340",4015,1027,510,517,2841,405,1410,407,624,379,589,274,268,47,419,227,192,18,18,147,75,72
"2021","Knowsley 015","E02001341",3352,1195,458,737,1999,174,692,235,280,177,404,171,190,43,696,449,247,33,33,158,79,79
"2021","Knowsley 016","E02001342",3197,781,429,352,2299,395,1215,427,465,323,410,197,182,31,268,122,146,11,11,117,47,70
"2021","Knowsley 017","E02001343",3021,791,401,390,2087,329,1145,402,445,298,357,185,147,25,239,135,104,17,17,143,67,76
"2021","Knowsley 018","E02001344",2386,840,316,524,1438,151,661,197,261,203,293,128,123,42,318,176,142,15,15,108,70,38
"2021","Knowsley 019","E02001345",2332,669,345,324,1591,257,778,258,293,227,287,131,136,20,256,121,135,13,13,72,44,28
"2021","Knowsley 020","E02001346",3256,1143,403,740,1940,164,699,223,280,196,378,153,182,43,672,427,245,27,27,173,100,73
"2021","Liverpool 001","E02001347",3414,1070,410,660,2159,190,866,244,361,261,407,165,210,32,661,410,251,35,35,185,83,102
"2021","Liverpool 002","E02001348",2998,1063,380,683,1811,191,723,235,265,223,380,163,182,35,497,296,201,20,20,124,57,67
"2021","Liverpool 003","E02001349",3250,1067,369,698,2038,221,918,295,339,284,425,201,191,33,452,263,189,22,22,145,62,83
"2021","Liverpool 004","E02001350",3385,1170,488,682,2014,181,800,232,346,222,365,151,185,29,638,427,211,30,30,201,114,87
"2021","Liverpool 005","E02001351",3519,1110,417,693,2195,142,792,245,327,220,397,155,195,47,812,502,310,52,52,214,108,106
"2021","Liverpool 006","E02001352",2936,1106,351,755,1649,137,536,154,216,166,334,149,152,33,610,418,192,32,32,181,72,109
"2021","Liverpool 007","E02001353",2950,778,320,458,2015,221,1060,337,438,285,336,143,166,27,372,215,157,26,26,157,72,85
"2021","Liverpool 008","E02001354",3433,1147,424,723,2106,183,763,231,309,223,403,156,204,43,736,451,285,21,21,180,96,84
"2021","Liverpool 009","E02001355",2955,1170,439,731,1618,162,567,175,209,183,293,136,124,33,555,363,192,41,41,167,75,92
"2021","Liverpool 010","E02001356",3584,868,321,547,2521,94,876,220,510,146,572,220,320,32,953,711,242,26,26,195,124,71
"2021","Liverpool 011","E02001357",2818,775,342,433,1861,156,631,153,272,206,314,66,189,59,714,427,287,46,46,182,95,87
"2021","Liverpool 012","E02001358",3269,1318,378,940,1735,149,501,164,206,131,334,165,139,30,713,462,251,38,38,216,96,120
"2021","Liverpool 013","E02001359",2327,688,331,357,1504,233,740,233,266,241,214,84,100,30,305,161,144,12,12,135,67,68
"2021","Liverpool 014","E02001360",4126,1722,548,1174,2099,189,617,188,270,159,394,178,172,44,833,542,291,66,66,305,128,177
"2021","Liverpool 015","E02001361",3310,1189,470,719,1948,221,775,257,276,242,290,133,123,34,635,387,248,27,27,173,81,92
"2021","Liverpool 016","E02001362",3181,1002,528,474,2008,235,856,229,336,291,336,133,162,41,548,308,240,33,33,171,87,84
"2021","Liverpool 017","E02001363",3475,1255,467,788,2037,139,765,195,361,209,375,174,168,33,721,497,224,37,37,183,96,87
"2021","Liverpool 018","E02001364",2705,1065,286,779,1446,86,508,116,272,120,302,138,143,21,512,341,171,38,38,194,88,106
"2021","Liverpool 019","E02001365",4085,1566,359,1207,2155,125,735,216,360,159,391,194,161,36,828,547,281,76,76,364,134,230
"2021","Liverpool 020","E02001366",3953,1468,422,1046,2223,209,805,249,332,224,457,219,187,51,705,461,244,47,47,262,103,159
"2021","Liverpool 021","E02001367",4094,1273,631,642,2630,425,1372,383,635,354,427,197,199,31,383,202,181,23,23,191,94,97
"2021","Liverpool 022","E02001368",3435,1459,538,921,1728,149,526,162,246,118,342,187,115,40,653,370,283,58,58,248,79,169
"2021","Liverpool 023","E02001369",3734,1633,499,1134,1820,184,580,168,241,171,331,211,98,22,675,361,314,50,50,281,110,171
"2021","Liverpool 024","E02001370",3337,1438,510,928,1663,132,525,153,272,100,243,109,116,18,706,447,259,57,57,236,88,148
"2021","Liverpool 025","E02001371",3178,1015,346,669,2002,133,713,209,322,182,379,148,184,47,748,483,265,29,29,161,96,65
"2021","Liverpool 026","E02001372",2701,1049,489,560,1539,186,703,211,277,215,266,114,122,30,355,214,141,29,29,113,49,64
"2021","Liverpool 027","E02001373",3952,1419,458,961,2270,220,892,256,364,272,449,222,188,39,666,412,254,43,43,263,99,164
"2021","Liverpool 028","E02001374",3966,1828,374,1454,1753,100,674,196,330,148,386,233,114,39,517,316,201,76,76,385,109,276
"2021","Liverpool 029","E02001375",3077,1112,467,645,1792,200,658,225,258,175,328,152,139,37,570,332,238,36,36,173,74,99
"2021","Liverpool 030","E02001376",3714,1231,361,870,1695,108,636,142,381,113,297,144,134,19,562,332,230,92,92,788,118,670
"2021","Liverpool 031","E02001377",3800,1542,417,1125,1418,79,531,149,297,85,307,225,63,19,425,218,207,76,76,840,80,760
"2021","Liverpool 032","E02001378",3400,1370,438,932,1835,215,765,222,347,196,339,165,133,41,484,247,237,32,32,195,83,112
"2021","Liverpool 034","E02001380",3107,785,399,386,2184,315,1171,325,531,315,370,191,158,21,314,153,161,14,14,138,74,64
"2021","Liverpool 035","E02001381",4275,1563,385,1178,2176,106,815,229,433,153,415,267,130,18,707,478,229,133,133,536,127,409
"2021","Liverpool 036","E02001382",2726,596,334,262,2006,304,1116,316,507,293,319,138,159,22,261,122,139,6,6,124,67,57
"2021","Liverpool 037","E02001383",4190,2403,396,2007,1357,45,431,155,236,40,455,384,56,15,335,193,142,91,91,430,48,382
"2021","Liverpool 038","E02001384",3657,1108,313,795,1239,71,476,142,254,80,287,202,72,13,355,201,154,50,50,1310,100,1210
"2021","Liverpool 039","E02001385",3434,1339,323,1016,1738,39,762,121,562,79,217,122,87,8,667,396,271,53,53,357,159,198
"2021","Liverpool 040","E02001386",3797,1465,699,766,2166,248,743,250,287,206,421,178,199,44,727,367,360,27,27,166,84,82
"2021","Liverpool 041","E02001387",3112,831,462,369,2114,339,1198,326,593,279,312,153,138,21,249,110,139,16,16,167,65,102
"2021","Liverpool 042","E02001388",2907,849,256,593,1678,118,712,235,366,111,489,319,152,18,332,183,149,27,27,380,54,326
"2021","Liverpool 043","E02001389",3604,1967,369,1598,1372,44,449,180,234,35,538,450,77,11,308,194,114,33,33,265,39,226
"2021","Liverpool 044","E02001390",4365,1758,503,1255,2251,110,769,207,433,129,454,263,141,50,849,518,331,69,69,356,140,216
"2021","Liverpool 045","E02001391",2523,825,390,435,1563,156,524,150,218,156,256,80,139,37,598,360,238,29,29,135,75,60
"2021","Liverpool 046","E02001392",2791,837,469,368,1862,407,916,303,420,193,318,171,133,14,205,95,110,16,16,92,39,53
"2021","Liverpool 047","E02001393",2847,677,428,249,2062,498,1236,341,583,312,187,89,80,18,128,59,69,13,13,108,43,65
"2021","Liverpool 048","E02001394",4259,2049,629,1420,1845,213,751,276,334,141,559,430,114,15,296,146,150,26,26,365,61,304
"2021","Liverpool 049","E02001395",2515,720,376,344,1682,251,902,268,448,186,302,166,115,21,212,110,102,15,15,113,61,52
"2021","Liverpool 050","E02001396",3822,1578,487,1091,1972,140,676,282,257,137,603,440,136,27,503,318,185,50,50,272,64,208
"2021","Liverpool 051","E02001397",3617,1608,818,790,1912,317,886,313,378,195,350,225,101,24,345,185,160,14,14,97,40,57
"2021","Liverpool 052","E02001398",3528,1533,525,1008,1746,216,739,270,332,137,467,327,118,22,291,150,141,33,33,249,65,184
"2021","Liverpool 053","E02001399",2834,688,418,270,2011,346,1160,314,588,258,250,119,109,22,249,110,139,6,6,135,59,76
"2021","Liverpool 054","E02001400",2895,933,386,547,1813,201,908,265,397,246,296,124,143,29,380,179,201,28,28,149,84,65
"2021","Liverpool 055","E02001401",3456,1055,559,496,2260,368,1063,315,463,285,444,209,206,29,360,191,169,25,25,141,67,74
"2021","Liverpool 056","E02001402",3859,1243,542,701,2437,375,1296,393,677,226,430,233,162,35,314,159,155,22,22,179,72,107
"2021","Liverpool 057","E02001403",2918,1049,314,735,1718,117,598,194,273,131,382,191,162,29,589,386,203,32,32,151,58,93
"2021","Liverpool 058","E02001404",3416,1115,346,769,2125,131,763,268,326,169,483,229,214,40,719,468,251,29,29,176,88,88
"2021","Liverpool 059","E02001405",4249,1400,507,893,2630,167,819,259,335,225,560,212,292,56,1032,710,322,52,52,219,107,112
"2021","Liverpool 060","E02006932",3438,1828,88,1740,1084,19,273,160,93,20,559,533,25,1,109,71,38,124,124,526,14,512
"2021","Liverpool 061","E02006933",3878,1728,230,1498,1587,87,438,247,148,43,746,675,52,19,232,126,106,84,84,563,30,533
"2021","Liverpool 062","E02006934",3402,1844,101,1743,1174,31,291,189,78,24,636,612,24,0,89,51,38,127,127,384,9,375
"2021","St. Helens 001","E02001406",3501,1031,665,366,2368,613,1149,414,467,268,330,162,145,23,265,122,143,11,11,102,44,58
"2021","St. Helens 002","E02001407",2581,700,457,243,1799,506,859,326,304,229,212,102,85,25,214,120,94,8,8,82,35,47
"2021","St. Helens 003","E02001408",2370,638,344,294,1632,391,762,287,279,196,269,138,107,24,202,107,95,8,8,100,53,47
"2021","St. Helens 004","E02001409",4568,1398,640,758,3002,492,1306,487,503,316,585,278,264,43,587,361,226,32,32,168,88,80
"2021","St. Helens 005","E02001410",2531,792,364,428,1640,240,708,272,254,182,333,127,175,31,342,216,126,17,17,99,52,47
"2021","St. Helens 006","E02001411",2560,816,452,364,1666,293,784,296,303,185,313,128,149,36,261,149,112,15,15,78,34,44
"2021","St. Helens 007","E02001412",3833,1077,528,549,2626,402,1287,400,600,287,406,197,184,25,515,303,212,16,16,130,52,78
"2021","St. Helens 008","E02001413",4052,1105,588,517,2786,530,1175,430,430,315,504,230,217,57,548,307,241,29,29,161,77,84
"2021","St. Helens 009","E02001414",2366,606,416,190,1700,411,939,293,453,193,173,104,59,10,169,87,82,8,8,60,31,29
"2021","St. Helens 010","E02001415",2916,846,323,523,1971,179,927,313,461,153,467,245,186,36,382,242,140,16,16,99,38,61
"2021","St. Helens 011","E02001416",2769,860,302,558,1776,161,646,242,259,145,418,171,213,34,520,358,162,31,31,133,58,75
"2021","St. Helens 012","E02001417",3849,1908,533,1375,1791,124,637,260,243,134,449,238,176,35,552,354,198,29,29,150,41,109
"2021","St. Helens 013","E02001418",3117,1161,416,745,1851,165,708,291,274,143,564,329,203,32,392,276,116,22,22,105,51,54
"2021","St. Helens 014","E02001419",3678,1499,438,1061,2000,138,609,251,230,128,550,285,227,38,662,464,198,41,41,179,71,108
"2021","St. Helens 015","E02001420",5145,1521,564,957,3454,368,1542,541,705,296,829,457,319,53,686,438,248,29,29,170,87,83
"2021","St. Helens 016","E02001421",4884,1712,607,1105,2979,355,1218,451,445,322,669,366,265,38,703,422,281,34,34,193,80,113
"2021","St. Helens 017","E02001422",2794,892,302,590,1735,118,686,247,280,159,419,159,217,43,471,323,148,41,41,167,74,93
"2021","St. Helens 018","E02001423",2831,796,421,375,1943,388,1043,355,443,245,273,130,122,21,229,120,109,10,10,92,49,43
"2021","St. Helens 020","E02001425",4770,1477,642,835,3106,518,1360,516,512,332,606,292,261,53,598,360,238,24,24,187,87,100
"2021","St. Helens 021","E02001426",2418,750,403,347,1592,298,690,231,291,168,282,139,124,19,310,169,141,12,12,76,41,35
"2021","St. Helens 022","E02001427",4626,1313,543,770,3095,370,1325,493,549,283,625,297,276,52,745,462,283,30,30,218,119,99
"2021","St. Helens 023","E02001428",2368,679,449,230,1592,391,843,247,361,235,161,66,75,20,186,91,95,11,11,97,50,47
"2021","St. Helens 024","E02006935",3289,1107,433,674,2036,236,839,328,319,192,373,167,179,27,559,350,209,29,29,146,79,67
"2021","St. Helens 025","E02006936",3195,877,413,464,2192,222,1056,310,556,190,509,268,212,29,389,274,115,16,16,126,65,61
"2021","Sefton 001","E02001429",3098,961,613,348,2029,507,846,354,291,201,329,168,141,20,337,193,144,10,10,108,44,64
"2021","Sefton 002","E02001430",2982,837,530,307,2060,481,1050,393,417,240,268,130,114,24,255,133,122,6,6,85,38,47
"2021","Sefton 003","E02001431",3723,1690,1036,654,1925,578,817,365,292,160,252,146,90,16,264,137,127,14,14,108,38,70
"2021","Sefton 004","E02001432",5181,2933,923,2010,1919,270,668,331,242,95,529,371,138,20,386,231,155,66,66,329,102,227
"2021","Sefton 005","E02001433",3132,885,379,506,2098,225,964,350,416,198,412,183,202,27,474,300,174,23,23,149,70,79
"2021","Sefton 006","E02001434",2951,766,301,465,1989,208,1008,363,452,193,371,173,173,25,381,219,162,21,21,196,91,105
"2021","Sefton 007","E02001435",3808,1369,453,916,2065,228,862,275,418,169,468,234,203,31,479,305,174,28,28,374,105,269
"2021","Sefton 008","E02001436",4077,1172,500,672,2699,360,1221,433,574,214,480,246,205,29,611,366,245,27,27,206,99,107
"2021","Sefton 009","E02001437",4309,1649,1007,642,2486,730,1146,452,418,276,303,178,103,22,288,143,145,19,19,174,76,98
"2021","Sefton 010","E02001438",3070,854,439,415,2110,297,1062,369,457,236,352,166,162,24,383,224,159,16,16,106,45,61
"2021","Sefton 011","E02001439",2879,981,549,432,1774,281,774,258,329,187,318,125,171,22,391,226,165,10,10,124,64,60
"2021","Sefton 012","E02001440",2632,666,494,172,1843,612,896,360,312,224,186,99,70,17,144,59,85,5,5,123,60,63
"2021","Sefton 013","E02001441",2662,666,500,166,1916,616,965,353,413,199,171,82,74,15,161,78,83,3,3,80,37,43
"2021","Sefton 014","E02001442",2699,928,633,295,1675,444,788,246,358,184,201,87,99,15,233,100,133,9,9,96,40,56
"2021","Sefton 015","E02001443",2329,577,423,154,1666,451,852,248,394,210,168,71,85,12,189,85,104,6,6,86,41,45
"2021","Sefton 016","E02001444",2422,719,450,269,1628,331,795,231,366,198,241,105,120,16,256,113,143,5,5,75,31,44
"2021","Sefton 017","E02001445",2944,844,517,327,1962,437,1008,339,408,261,250,110,118,22,253,107,146,14,14,138,57,81
"2021","Sefton 018","E02001446",3066,881,566,315,2090,410,982,290,403,289,351,154,165,32,337,178,159,10,10,95,57,38
"2021","Sefton 019","E02001447",2665,851,525,326,1726,376,804,257,315,232,292,138,128,26,243,124,119,11,11,88,41,47
"2021","Sefton 020","E02001448",2840,786,479,307,1959,375,1053,339,434,280,273,132,118,23,249,118,131,9,9,95,44,51
"2021","Sefton 021","E02001449",3967,1108,612,496,2702,537,1327,474,525,328,415,217,171,27,401,184,217,22,22,157,72,85
"2021","Sefton 022","E02001450",3660,1179,661,518,2323,517,1264,421,562,281,263,137,108,18,261,122,139,18,18,158,63,95
"2021","Sefton 023","E02001451",2610,902,392,510,1574,173,578,185,203,190,261,107,125,29,540,321,219,22,22,134,58,76
"2021","Sefton 024","E02001452",2924,1121,465,656,1666,137,547,214,193,140,307,126,145,36,629,366,263,46,46,137,77,60
"2021","Sefton 025","E02001453",3631,939,572,367,2550,414,1363,406,614,343,412,187,199,26,348,177,171,13,13,142,58,84
"2021","Sefton 026","E02001454",3003,792,453,339,2054,367,1009,268,433,308,325,137,164,24,337,188,149,16,16,157,78,79
"2021","Sefton 027","E02001455",2999,817,391,426,2053,321,1004,358,360,286,383,145,205,33,328,182,146,17,17,129,64,65
"2021","Sefton 028","E02001456",3241,1059,529,530,2015,337,973,320,405,248,353,172,161,20,337,186,151,15,15,167,67,100
"2021","Sefton 029","E02001457",2999,1062,382,680,1797,152,673,202,220,251,330,125,173,32,610,375,235,32,32,140,75,65
"2021","Sefton 030","E02001458",3429,1252,440,812,1984,195,923,279,431,213,459,257,171,31,381,205,176,26,26,193,78,115
"2021","Sefton 031","E02001459",2877,823,349,474,1907,230,766,251,306,209,384,158,168,58,504,292,212,23,23,147,80,67
"2021","Sefton 032","E02001460",3828,1841,621,1220,1825,195,715,257,268,190,370,201,139,30,527,296,231,18,18,162,84,78
"2021","Sefton 033","E02001461",2970,913,469,444,1935,252,890,278,351,261,403,161,205,37,376,206,170,14,14,122,66,56
"2021","Sefton 034","E02001462",3553,1403,469,934,1993,113,604,205,230,169,447,214,199,34,801,514,287,28,28,157,83,74
"2021","Sefton 035","E02001463",3052,871,360,511,2003,164,802,238,329,235,374,157,176,41,637,376,261,26,26,178,103,75
"2021","Sefton 036","E02001464",3231,1297,377,920,1754,127,541,182,228,131,388,167,194,27,669,410,259,29,29,180,71,109
"2021","Sefton 037","E02001465",3839,1870,559,1311,1717,99,576,213,218,145,378,196,152,30,626,410,216,38,38,252,69,183
"2021","Sefton 038","E02001466",3784,1257,458,799,2269,225,896,254,352,290,433,168,215,50,676,448,228,39,39,258,128,130
"2021","Wirral 001","E02001467",3886,1824,704,1120,1879,303,784,328,288,168,423,272,129,22,348,209,139,21,21,183,70,113
"2021","Wirral 002","E02001468",3358,1255,469,786,1920,212,823,330,319,174,399,192,175,32,461,288,173,25,25,183,94,89
"2021","Wirral 003","E02001469",3498,1243,656,587,2102,405,1039,385,434,220,338,181,134,23,309,183,126,11,11,153,67,86
"2021","Wirral 004","E02001470",3404,878,463,415,2354,385,1216,417,497,302,387,172,190,25,347,190,157,19,19,172,73,99
"2021","Wirral 005","E02001471",3292,1350,491,859,1764,175,649,209,287,153,363,162,176,25,562,408,154,15,15,178,81,97
"2021","Wirral 006","E02001472",2928,787,353,434,2004,236,932,334,374,224,373,150,194,29,452,290,162,11,11,137,61,76
"2021","Wirral 007","E02001473",3393,1162,508,654,2079,257,848,294,345,209,419,179,207,33,530,306,224,25,25,152,79,73
"2021","Wirral 008","E02001474",3105,1235,434,801,1701,101,502,177,190,135,347,136,183,28,723,528,195,28,28,169,81,88
"2021","Wirral 009","E02001475",2814,1035,476,559,1648,153,579,200,246,133,344,138,176,30,550,363,187,22,22,131,56,75
"2021","Wirral 010","E02001476",3632,1340,350,990,2139,152,642,227,267,148,443,200,208,35,870,604,266,32,32,153,70,83
"2021","Wirral 011","E02001477",3328,1180,392,788,1975,79,547,192,231,124,398,159,202,37,925,652,273,26,26,173,91,82
"2021","Wirral 012","E02001478",3632,1226,669,557,2225,380,967,351,371,245,384,169,193,22,474,273,201,20,20,181,84,97
"2021","Wirral 013","E02001479",2597,716,372,344,1797,325,964,312,433,219,243,119,107,17,256,138,118,9,9,84,41,43
"2021","Wirral 014","E02001480",3355,1202,627,575,2035,344,1079,374,478,227,322,193,104,25,274,134,140,16,16,118,46,72
"2021","Wirral 015","E02001481",3515,1111,489,622,2251,340,1008,328,429,251,436,207,183,46,454,286,168,13,13,153,68,85
"2021","Wirral 016","E02001482",4374,2436,615,1821,1717,85,511,199,211,101,375,230,117,28,705,487,218,41,41,221,104,117
"2021","Wirral 017","E02001483",3210,961,525,436,2130,402,1059,414,399,246,342,169,148,25,318,159,159,9,9,119,53,66
"2021","Wirral 018","E02001484",3604,1230,673,557,2255,423,1083,347,486,250,349,159,161,29,380,228,152,20,20,119,65,54
"2021","Wirral 019","E02001485",2831,843,378,465,1857,184,699,231,286,182,297,101,173,23,656,457,199,21,21,131,79,52
"2021","Wirral 020","E02001486",4285,2296,856,1440,1847,375,823,339,316,168,359,243,103,13,279,162,117,11,11,142,53,89
"2021","Wirral 021","E02001487",4400,1863,462,1401,2323,124,736,258,355,123,511,239,243,29,904,649,255,48,48,214,93,121
"2021","Wirral 022","E02001488",3934,1544,473,1071,2208,240,847,316,359,172,493,259,206,28,607,448,159,21,21,182,60,122
"2021","Wirral 023","E02001489",3636,1087,724,363,2457,629,1287,461,535,291,273,146,105,22,258,134,124,10,10,92,39,53
"2021","Wirral 024","E02001490",3441,851,456,395,2466,427,1228,387,524,317,421,203,186,32,375,198,177,15,15,124,67,57
"2021","Wirral 025","E02001491",3030,1200,561,639,1692,139,602,185,230,187,329,119,177,33,596,411,185,26,26,138,61,77
"2021","Wirral 026","E02001492",3522,1340,755,585,2081,420,970,288,493,189,339,197,126,16,334,193,141,18,18,101,38,63
"2021","Wirral 027","E02001493",4166,1746,493,1253,2247,128,617,198,283,136,488,245,209,34,980,692,288,34,34,173,84,89
"2021","Wirral 028","E02001494",2996,787,525,262,2108,558,1165,404,547,214,182,86,79,17,198,103,95,5,5,101,36,65
"2021","Wirral 029","E02001495",3463,1203,478,725,2093,236,902,294,394,214,405,170,201,34,524,328,196,26,26,167,81,86
"2021","Wirral 030","E02001496",2529,711,367,344,1715,326,872,246,404,222,240,105,115,20,258,144,114,19,19,103,50,53
"2021","Wirral 031","E02001497",3682,1346,526,820,2161,196,805,294,353,158,418,207,184,27,718,458,260,24,24,175,77,98
"2021","Wirral 032","E02001498",3044,840,405,435,2098,335,1071,317,505,249,315,132,156,27,361,219,142,16,16,106,48,58
"2021","Wirral 033","E02001499",2887,831,551,280,1964,455,1008,360,424,224,264,137,114,13,231,116,115,6,6,92,36,56
"2021","Wirral 034","E02001500",3250,947,562,385,2186,473,1102,393,481,228,312,160,127,25,285,161,124,14,14,117,50,67
"2021","Wirral 035","E02001501",3246,888,479,409,2253,380,1181,367,563,251,337,158,151,28,336,186,150,19,19,105,45,60
"2021","Wirral 036","E02001502",4273,1394,614,780,2736,333,1220,421,579,220,652,366,254,32,506,314,192,25,25,143,61,82
"2021","Wirral 037","E02001503",3518,1295,790,505,2124,459,1003,346,439,218,288,168,103,17,364,207,157,10,10,99,46,53
"2021","Wirral 038","E02001504",3029,813,556,257,2148,622,1088,384,466,238,236,126,95,15,188,84,104,14,14,68,28,40
"2021","Wirral 039","E02001505",2866,902,437,465,1848,307,811,269,357,185,325,161,145,19,384,231,153,21,21,116,56,60
"2021","Wirral 040","E02001506",3806,943,685,258,2766,857,1514,537,653,324,185,91,75,19,207,93,114,3,3,97,38,59
"2021","Wirral 041","E02001507",2998,821,574,247,2052,532,1060,363,466,231,241,119,111,11,211,100,111,8,8,125,57,68
"2021","Wirral 042","E02001508",3492,1018,503,515,2335,328,1108,396,493,219,413,202,186,25,458,270,188,28,28,139,68,71
"2021","Kingston upon Hull 002","E02002653",3383,1076,409,667,2156,199,740,262,315,163,483,142,290,51,707,486,221,27,27,151,89,62
"2021","Kingston upon Hull 003","E02002654",3070,912,302,610,2003,101,646,166,361,119,498,112,319,67,741,554,187,17,17,155,104,51
"2021","Kingston upon Hull 004","E02002655",3528,1077,418,659,2282,215,823,294,341,188,588,191,336,61,633,466,167,23,23,169,92,77
"2021","Kingston upon Hull 005","E02002656",2560,920,448,472,1579,404,651,321,200,130,306,198,99,9,211,112,99,7,7,61,26,35
"2021","Kingston upon Hull 006","E02002657",3247,918,505,413,2193,409,1022,413,400,209,433,178,217,38,318,196,122,11,11,136,59,77
"2021","Kingston upon Hull 007","E02002658",3024,1043,494,549,1906,349,919,390,335,194,380,192,162,26,238,132,106,20,20,75,31,44
"2021","Kingston upon Hull 008","E02002659",4607,1409,559,850,2891,199,1001,338,443,220,748,237,436,75,906,642,264,37,37,307,167,140
"2021","Kingston upon Hull 009","E02002660",3071,967,444,523,1992,276,738,336,245,157,445,146,261,38,516,356,160,17,17,112,47,65
"2021","Kingston upon Hull 010","E02002661",3382,910,432,478,2346,278,943,340,415,188,540,193,302,45,563,377,186,22,22,126,58,68
"2021","Kingston upon Hull 011","E02002662",3366,1219,635,584,2041,311,808,328,315,165,456,201,216,39,451,275,176,15,15,106,47,59
"2021","Kingston upon Hull 012","E02002663",2414,625,215,410,1247,144,586,228,253,105,325,176,126,23,171,98,73,21,21,542,50,492
"2021","Kingston upon Hull 013","E02002664",2959,653,353,300,2204,400,1142,425,465,252,399,160,200,39,255,140,115,8,8,102,45,57
"2021","Kingston upon Hull 014","E02002665",3361,948,468,480,2253,356,1099,421,477,201,447,193,219,35,340,198,142,11,11,160,61,99
"2021","Kingston upon Hull 015","E02002666",3530,1430,325,1105,1362,83,473,184,222,67,477,311,132,34,258,174,84,71,71,738,162,576
"2021","Kingston upon Hull 016","E02002667",3376,1176,368,808,2058,255,863,364,339,160,578,301,241,36,339,222,117,23,23,142,52,90
"2021","Kingston upon Hull 017","E02002668",3594,1146,621,525,2301,198,704,280,294,130,579,181,328,70,788,549,239,32,32,147,76,71
"2021","Kingston upon Hull 018","E02002669",3601,1322,255,1067,1790,140,740,300,338,102,567,371,172,24,297,180,117,46,46,489,95,394
"2021","Kingston upon Hull 019","E02002670",3610,1269,641,628,2219,269,903,369,347,187,525,242,237,46,502,350,152,20,20,122,47,75
"2021","Kingston upon Hull 020","E02002671",3431,1015,342,673,2243,183,972,369,396,207,587,272,264,51,479,303,176,22,22,173,86,87
"2021","Kingston upon Hull 021","E02002672",2858,792,330,462,1927,132,630,222,260,148,483,148,294,41,655,524,131,27,27,139,80,59
"2021","Kingston upon Hull 022","E02002673",3382,1147,375,772,2070,227,791,320,296,175,572,276,261,35,450,299,151,30,30,165,87,78
"2021","Kingston upon Hull 023","E02002674",3218,1159,436,723,1975,242,682,305,234,143,632,340,260,32,400,270,130,19,19,84,29,55
"2021","Kingston upon Hull 024","E02002675",3859,1667,457,1210,1902,104,733,208,420,105,564,332,186,46,449,277,172,52,52,290,121,169
"2021","Kingston upon Hull 025","E02002676",3468,1343,386,957,1911,160,695,288,282,125,590,363,203,24,426,280,146,40,40,214,61,153
"2021","Kingston upon Hull 026","E02002677",4130,1863,552,1311,2079,186,884,370,405,109,542,316,197,29,424,277,147,43,43,188,62,126
"2021","Kingston upon Hull 027","E02002678",3706,1237,344,893,2240,164,931,377,392,162,643,336,273,34,477,317,160,25,25,229,87,142
"2021","Kingston upon Hull 028","E02002679",3403,1080,563,517,2209,333,1057,401,443,213,496,230,225,41,308,186,122,15,15,114,53,61
"2021","Kingston upon Hull 029","E02002680",5415,3248,535,2713,1876,105,634,241,325,68,635,479,135,21,427,283,144,75,75,291,85,206
"2021","Kingston upon Hull 030","E02002681",3999,1561,346,1215,2123,88,746,287,356,103,613,304,279,30,621,453,168,55,55,315,131,184
"2021","Kingston upon Hull 031","E02002682",4593,1465,483,982,2869,209,1080,386,490,204,812,370,397,45,728,497,231,40,40,259,119,140
"2021","Kingston upon Hull 033","E02006813",3814,1427,700,727,2227,345,864,345,335,184,486,213,235,38,512,335,177,20,20,160,84,76
"2021","Kingston upon Hull 034","E02007079",3226,728,180,548,2331,163,858,282,418,158,682,288,358,36,621,441,180,7,7,167,81,86
"2021","Kingston upon Hull 035","E02007080",3298,701,67,634,2463,71,1291,389,754,148,809,428,363,18,285,219,66,7,7,134,57,77
"2021","East Riding of Yorkshire 001","E02002684",4968,1600,1047,553,3220,1112,1288,685,367,236,445,223,198,24,361,227,134,14,14,148,59,89
"2021","East Riding of Yorkshire 002","E02002685",3760,1202,759,443,2441,764,1066,571,292,203,339,157,156,26,260,156,104,12,12,117,38,79
"2021","East Riding of Yorkshire 003","E02002686",3632,1487,825,662,2034,322,705,313,258,134,408,161,225,22,575,404,171,24,24,111,50,61
"2021","East Riding of Yorkshire 004","E02002687",2824,1211,535,676,1471,298,576,290,178,108,292,154,119,19,285,200,85,20,20,142,58,84
"2021","East Riding of Yorkshire 005","E02002688",2586,1153,414,739,1266,223,555,264,195,96,237,124,100,13,233,143,90,18,18,167,58,109
"2021","East Riding of Yorkshire 006","E02002689",2541,684,406,278,1747,429,879,454,268,157,260,152,91,17,173,96,77,6,6,110,53,57
"2021","East Riding of Yorkshire 008","E02002691",3669,967,570,397,2578,622,1284,579,496,209,419,239,158,22,247,140,107,6,6,124,55,69
"2021","East Riding of Yorkshire 009","E02002692",3849,887,500,387,2830,615,1497,615,635,247,483,286,173,24,227,149,78,8,8,132,46,86
"2021","East Riding of Yorkshire 010","E02002693",3141,795,451,344,2224,554,1140,576,376,188,311,174,117,20,208,114,94,11,11,122,49,73
"2021","East Riding of Yorkshire 011","E02002694",5851,1845,909,936,3820,743,1842,812,724,306,740,441,277,22,478,313,165,17,17,186,74,112
"2021","East Riding of Yorkshire 012","E02002695",3709,1184,742,442,2345,671,1007,487,325,195,327,156,149,22,332,196,136,8,8,180,67,113
"2021","East Riding of Yorkshire 013","E02002696",2472,583,308,275,1813,406,997,453,384,160,247,144,82,21,158,88,70,5,5,76,38,38
"2021","East Riding of Yorkshire 014","E02002697",3305,844,518,326,2335,597,1189,497,479,213,319,181,122,16,223,133,90,7,7,126,52,74
"2021","East Riding of Yorkshire 015","E02002698",3764,1070,539,531,2572,502,1240,504,551,185,509,266,214,29,308,207,101,13,13,122,53,69
"2021","East Riding of Yorkshire 016","E02002699",4327,1175,697,478,3048,686,1628,680,706,242,416,214,172,30,312,182,130,6,6,104,36,68
"2021","East Riding of Yorkshire 017","E02002700",2788,1055,470,585,1641,196,640,238,279,123,340,147,168,25,446,296,150,19,19,92,34,58
"2021","East Riding of Yorkshire 018","E02002701",3667,794,455,339,2715,561,1511,708,568,235,400,213,165,22,234,125,109,9,9,158,79,79
"2021","East Riding of Yorkshire 019","E02002702",5103,2209,993,1216,2791,547,1226,620,430,176,582,385,174,23,412,227,185,24,24,103,30,73
"2021","East Riding of Yorkshire 020","E02002703",3910,998,543,455,2793,569,1484,591,616,277,432,260,151,21,302,182,120,6,6,119,60,59
"2021","East Riding of Yorkshire 021","E02002704",3178,779,476,303,2288,623,1119,561,347,211,338,188,131,19,195,103,92,13,13,111,47,64
"2021","East Riding of Yorkshire 022","E02002705",3143,841,547,294,2227,553,1070,465,425,180,369,191,163,15,228,129,99,7,7,75,33,42
"2021","East Riding of Yorkshire 023","E02002706",3241,972,514,458,2165,410,1107,476,452,179,389,212,154,23,248,150,98,11,11,104,45,59
"2021","East Riding of Yorkshire 024","E02002707",2922,697,403,294,2150,472,1177,522,454,201,289,158,112,19,204,119,85,8,8,75,29,46
"2021","East Riding of Yorkshire 025","E02002708",2889,1231,728,503,1599,439,730,317,294,119,244,126,96,22,180,89,91,6,6,59,29,30
"2021","East Riding of Yorkshire 026","E02002709",3290,912,517,395,2251,421,1180,532,456,192,404,204,174,26,234,131,103,12,12,127,59,68
"2021","East Riding of Yorkshire 027","E02002710",3171,924,502,422,2199,441,1152,420,496,236,349,185,135,29,251,163,88,6,6,48,19,29
"2021","East Riding of Yorkshire 028","E02002711",3409,872,573,299,2456,669,1312,496,591,225,278,155,104,19,188,112,76,9,9,81,38,43
"2021","East Riding of Yorkshire 029","E02002712",3357,1089,577,512,2182,511,1016,452,352,212,363,174,154,35,289,178,111,3,3,86,35,51
"2021","East Riding of Yorkshire 031","E02002714",3436,877,512,365,2410,541,1225,598,384,243,401,204,170,27,230,143,87,13,13,149,76,73
"2021","East Riding of Yorkshire 032","E02002715",5632,1465,633,832,4001,577,2242,750,1146,346,708,391,288,29,458,301,157,16,16,166,87,79
"2021","East Riding of Yorkshire 033","E02002716",3699,1035,591,444,2543,537,1242,524,484,234,426,208,188,30,328,207,121,10,10,121,50,71
"2021","East Riding of Yorkshire 034","E02002717",3736,1373,632,741,2248,296,941,384,394,163,565,279,249,37,427,288,139,19,19,115,53,62
"2021","East Riding of Yorkshire 035","E02002718",3399,814,515,299,2477,646,1331,442,654,235,273,132,124,17,223,133,90,4,4,108,47,61
"2021","East Riding of Yorkshire 036","E02002719",2795,702,336,366,1988,330,1042,397,464,181,377,228,132,17,234,153,81,5,5,105,47,58
"2021","East Riding of Yorkshire 037","E02002720",3255,844,454,390,2285,445,1199,503,478,218,419,235,160,24,210,125,85,12,12,126,60,66
"2021","East Riding of Yorkshire 038","E02002721",2963,864,454,410,2002,354,1046,471,384,191,357,196,143,18,235,150,85,10,10,97,36,61
"2021","East Riding of Yorkshire 039","E02002722",3788,1226,667,559,2385,531,1033,517,313,203,429,205,194,30,376,231,145,16,16,177,77,100
"2021","East Riding of Yorkshire 040","E02002723",3732,1160,501,659,2317,371,962,424,369,169,509,253,226,30,439,290,149,36,36,255,107,148
"2021","East Riding of Yorkshire 041","E02002724",4109,1348,470,878,2507,258,978,352,428,198,622,272,309,41,614,443,171,35,35,254,117,137
"2021","East Riding of Yorkshire 042","E02002725",2923,714,380,334,2098,410,1055,448,427,180,356,188,137,31,269,155,114,8,8,111,63,48
"2021","East Riding of Yorkshire 043","E02006814",3538,1000,530,470,2418,428,1101,424,439,238,499,254,216,29,379,216,163,11,11,120,63,57
"2021","East Riding of Yorkshire 044","E02006891",3576,971,530,441,2494,515,1296,576,500,220,424,247,154,23,251,168,83,8,8,111,38,73
"2021","East Riding of Yorkshire 045","E02006892",3021,1225,596,629,1688,338,671,310,243,118,354,192,147,15,311,186,125,14,14,108,39,69
"2021","North East Lincolnshire 001","E02002726",4453,1336,685,651,2889,464,1322,570,485,267,579,240,296,43,496,310,186,28,28,228,120,108
"2021","North East Lincolnshire 002","E02002727",2595,1336,394,942,1123,65,310,144,104,62,264,110,135,19,451,346,105,33,33,136,54,82
"2021","North East Lincolnshire 003","E02002728",3650,1519,456,1063,1923,119,641,292,254,95,520,272,217,31,599,438,161,44,44,208,87,121
"2021","North East Lincolnshire 004","E02002729",2562,869,346,523,1589,293,746,344,248,154,293,132,138,23,251,161,90,6,6,104,53,51
"2021","North East Lincolnshire 005","E02002730",3079,1063,309,754,1822,105,617,255,238,124,479,183,266,30,587,470,117,34,34,194,86,108
"2021","North East Lincolnshire 006","E02002731",2378,747,218,529,1476,69,453,173,183,97,378,145,209,24,544,412,132,32,32,155,58,97
"2021","North East Lincolnshire 007","E02002732",3323,800,420,380,2412,453,1322,548,540,234,381,168,190,23,246,171,75,10,10,111,58,53
"2021","North East Lincolnshire 008","E02002733",2766,1099,440,659,1527,210,613,276,191,146,365,153,187,25,324,214,110,15,15,140,59,81
"2021","North East Lincolnshire 009","E02002734",2441,754,346,408,1592,230,644,270,253,121,372,164,185,23,332,230,102,14,14,95,37,58
"2021","North East Lincolnshire 011","E02002736",2415,859,188,671,1379,55,450,171,177,102,386,167,194,25,456,341,115,32,32,177,64,113
"2021","North East Lincolnshire 012","E02002737",3037,856,402,454,2061,297,931,418,305,208,473,228,216,29,349,231,118,11,11,120,49,71
"2021","North East Lincolnshire 013","E02002738",2968,778,343,435,2073,361,932,426,311,195,446,195,218,33,326,229,97,8,8,117,58,59
"2021","North East Lincolnshire 014","E02002739",2835,1138,497,641,1615,248,595,293,193,109,379,186,177,16,383,263,120,10,10,82,43,39
"2021","North East Lincolnshire 015","E02002740",2365,759,317,442,1491,192,594,240,214,140,328,128,180,20,363,258,105,14,14,115,52,63
"2021","North East Lincolnshire 016","E02002741",3676,1066,462,604,2397,344,1122,461,447,214,476,217,226,33,435,306,129,20,20,213,88,125
"2021","North East Lincolnshire 018","E02002743",2645,1014,646,368,1557,449,600,280,201,119,259,122,114,23,236,142,94,13,13,74,31,43
"2021","North East Lincolnshire 019","E02002744",2777,794,313,481,1837,146,661,233,279,149,389,120,229,40,616,439,177,25,25,146,76,70
"2021","North East Lincolnshire 020","E02002745",3343,1042,667,375,2210,604,1083,506,352,225,325,183,118,24,194,106,88,4,4,91,35,56
"2021","North East Lincolnshire 021","E02002746",4278,1258,664,594,2888,503,1408,535,644,229,586,295,251,40,383,262,121,8,8,132,71,61
"2021","North East Lincolnshire 022","E02002747",4025,1053,627,426,2856,628,1409,569,566,274,473,245,195,33,337,213,124,9,9,116,46,70
"2021","North East Lincolnshire 023","E02002748",3538,995,610,385,2443,594,1238,564,443,231,355,182,146,27,244,134,110,12,12,100,44,56
"2021","North East Lincolnshire 024","E02007081",4671,1574,674,900,2912,549,1271,543,503,225,584,297,246,41,486,343,143,22,22,185,72,113
"2021","North Lincolnshire 001","E02002749",5365,1661,765,896,3510,585,1627,728,603,296,734,381,303,50,543,342,201,21,21,194,80,114
"2021","North Lincolnshire 002","E02002750",2735,708,376,332,1915,373,1014,482,356,176,317,159,139,19,207,125,82,4,4,112,52,60
"2021","North Lincolnshire 003","E02002751",2747,762,428,334,1883,363,874,393,301,180,361,177,165,19,270,176,94,15,15,102,41,61
"2021","North Lincolnshire 004","E02002752",3052,773,399,374,2132,353,1091,545,382,164,392,205,157,30,286,175,111,10,10,147,72,75
"2021","North Lincolnshire 005","E02002753",4014,1372,749,623,2503,553,1158,578,373,207,452,252,175,25,328,186,142,12,12,139,61,78
"2021","North Lincolnshire 006","E02002754",3567,990,481,509,2404,395,1174,535,422,217,458,210,206,42,363,235,128,14,14,173,89,84
"2021","North Lincolnshire 007","E02002755",3005,947,347,600,1726,170,786,262,385,139,394,192,175,27,319,198,121,57,57,332,130,202
"2021","North Lincolnshire 008","E02002756",3370,1023,294,729,1914,122,817,227,433,157,431,198,196,37,473,310,163,71,71,433,197,236
"2021","North Lincolnshire 009","E02002757",2523,627,314,313,1739,265,834,311,353,170,353,162,165,26,269,167,102,18,18,157,74,83
"2021","North Lincolnshire 010","E02002758",2779,868,294,574,1715,168,689,243,285,161,413,178,203,32,415,305,110,30,30,196,83,113
"2021","North Lincolnshire 011","E02002759",4269,1297,703,594,2811,580,1389,651,490,248,506,259,210,37,322,198,124,14,14,161,75,86
"2021","North Lincolnshire 012","E02002760",2498,740,342,398,1653,317,748,322,290,136,315,142,151,22,260,165,95,13,13,105,46,59
"2021","North Lincolnshire 013","E02002761",2867,823,419,404,1956,379,953,453,330,170,377,188,165,24,235,141,94,12,12,88,38,50
"2021","North Lincolnshire 014","E02002762",2832,1011,444,567,1696,209,733,291,302,140,385,167,191,27,349,221,128,20,20,125,54,71
"2021","North Lincolnshire 015","E02002763",3751,1197,409,788,2390,194,969,317,491,161,655,286,328,41,545,380,165,27,27,164,75,89
"2021","North Lincolnshire 016","E02002764",2321,592,251,341,1579,172,589,224,265,100,366,123,205,38,440,323,117,12,12,150,80,70
"2021","North Lincolnshire 017","E02002765",2726,924,441,483,1685,223,688,291,259,138,419,176,211,32,341,227,114,14,14,117,55,62
"2021","North Lincolnshire 018","E02002766",3814,1066,590,476,2597,482,1182,445,528,209,506,231,244,31,416,281,135,11,11,151,80,71
"2021","North Lincolnshire 019","E02002767",3059,904,509,395,2045,480,961,447,342,172,387,182,174,31,207,124,83,10,10,110,29,81
"2021","North Lincolnshire 020","E02002768",3252,878,471,407,2250,454,1174,495,456,223,345,177,153,15,269,163,106,8,8,124,64,60
"2021","North Lincolnshire 021","E02002769",2525,673,414,259,1786,471,906,392,330,184,248,139,94,15,157,82,75,4,4,66,24,42
"2021","North Lincolnshire 022","E02002770",3062,813,444,369,2133,465,1071,474,402,195,378,202,157,19,213,128,85,6,6,116,46,70
"2021","North Lincolnshire 023","E02002771",3033,713,426,287,2193,490,1154,543,379,232,335,180,128,27,208,106,102,6,6,127,54,73
"2021","York 001","E02002772",2786,622,340,282,2056,349,1199,402,599,198,276,143,117,16,227,134,93,5,5,108,46,62
"2021","York 002","E02002773",2616,793,535,258,1757,496,854,348,371,135,220,117,82,21,185,109,76,2,2,66,19,47
"2021","York 003","E02002774",2635,702,465,237,1850,463,991,379,451,161,226,110,99,17,165,87,78,5,5,83,29,54
"2021","York 004","E02002775",2598,890,521,369,1598,398,725,308,290,127,202,92,91,19,260,158,102,13,13,110,38,72
"2021","York 005","E02002776",3027,902,466,436,1994,386,914,372,382,160,390,220,146,24,283,151,132,21,21,131,36,95
"2021","York 006","E02002777",3835,992,366,626,2680,321,1401,512,661,228,612,402,186,24,325,197,128,21,21,163,57,106
"2021","York 007","E02002778",3541,1104,545,559,2251,412,1160,474,498,188,408,255,136,17,250,148,102,21,21,186,40,146
"2021","York 008","E02002779",4147,1250,689,561,2656,568,1368,539,611,218,438,257,151,30,274,147,127,8,8,241,47,194
"2021","York 009","E02002780",3452,1137,384,753,1856,118,789,299,349,141,494,309,163,22,415,254,161,40,40,459,74,385
"2021","York 010","E02002781",4143,1422,399,1023,2116,160,837,344,375,118,643,462,156,25,439,296,143,37,37,605,60,545
"2021","York 011","E02002782",2536,600,410,190,1852,465,1021,353,512,156,227,119,90,18,136,86,50,3,3,84,27,57
"2021","York 012","E02002783",4292,1128,556,572,2948,416,1505,534,715,256,564,310,216,38,432,260,172,31,31,216,70,146
"2021","York 013","E02002784",5692,2932,663,2269,2274,232,785,461,254,70,823,706,105,12,362,244,118,72,72,486,30,456
"2021","York 014","E02002785",3240,796,436,360,2104,387,1052,375,491,186,379,224,133,22,277,170,107,9,9,340,54,286
"2021","York 015","E02002786",3866,985,312,673,1876,162,752,273,344,135,500,301,180,19,430,282,148,32,32,1005,78,927
"2021","York 016","E02002787",4302,1609,649,960,2445,298,1063,429,481,153,589,400,164,25,472,298,174,23,23,248,58,190
"2021","York 017","E02002788",3919,1341,392,949,2299,227,1131,485,521,125,666,519,140,7,245,159,86,30,30,279,55,224
"2021","York 018","E02002789",3979,1275,489,786,2487,224,957,303,491,163,618,297,280,41,653,449,204,35,35,217,75,142
"2021","York 019","E02002790",4635,1558,541,1017,2347,286,1085,405,559,121,597,445,128,24,331,199,132,48,48,730,37,693
"2021","York 020","E02002791",2707,694,458,236,1907,445,1060,368,524,168,225,116,97,12,174,92,82,3,3,106,32,74
"2021","York 021","E02002792",3513,1088,412,676,2231,334,1137,421,567,149,500,373,112,15,243,151,92,17,17,194,30,164
"2021","York 022","E02002793",4224,1308,629,679,2751,525,1285,511,559,215,554,322,198,34,370,222,148,17,17,165,50,115
"2021","York 023","E02002794",2214,610,321,289,1449,274,785,266,380,139,210,128,73,9,173,114,59,7,7,155,41,114
"2021","York 024","E02002795",3580,907,631,276,2565,677,1365,498,662,205,288,159,110,19,227,132,95,8,8,108,32,76
"2021","Craven 001","E02005742",3449,1121,618,503,2208,525,1132,528,403,201,352,213,115,24,187,98,89,12,12,120,44,76
"2021","Craven 003","E02005744",3696,1224,722,502,2364,599,1202,594,362,246,334,192,124,18,223,122,101,6,6,108,47,61
"2021","Craven 005","E02005746",3166,1073,538,535,1987,390,979,430,405,144,368,220,133,15,234,132,102,16,16,106,42,64
"2021","Craven 006","E02005747",3306,1337,518,819,1834,252,752,292,332,128,445,266,154,25,365,227,138,20,20,135,41,94
"2021","Craven 007","E02005748",3476,1030,495,535,2355,429,1256,548,515,193,412,234,157,21,249,144,105,9,9,91,42,49
"2021","Craven 008","E02005749",4400,1319,708,611,2966,658,1454,553,648,253,492,257,207,28,351,224,127,11,11,115,53,62
"2021","Craven 009","E02007041",4584,1336,802,534,3100,846,1645,756,616,273,381,238,121,22,215,115,100,13,13,148,52,96
"2021","Hambleton 001","E02005750",3665,1275,735,540,2286,566,1092,463,393,236,308,166,114,28,309,197,112,11,11,104,39,65
"2021","Hambleton 002","E02005751",3986,1131,716,415,2748,843,1402,652,498,252,288,170,93,25,203,111,92,12,12,107,47,60
"2021","Hambleton 003","E02005752",3133,906,428,478,2128,458,1126,510,404,212,329,194,112,23,205,108,97,10,10,99,44,55
"2021","Hambleton 005","E02005754",3332,826,517,309,2383,665,1268,613,441,214,264,143,108,13,178,93,85,8,8,123,46,77
"2021","Hambleton 006","E02005755",3097,1004,544,460,1994,402,1049,449,395,205,305,185,98,22,231,148,83,7,7,99,37,62
"2021","Hambleton 007","E02005756",2529,582,301,281,1854,369,1063,475,425,163,289,172,100,17,129,80,49,4,4,93,40,53
"2021","Hambleton 008","E02005757",4051,1373,692,681,2525,503,1269,582,459,228,469,306,145,18,269,172,97,15,15,153,44,109
"2021","Hambleton 009","E02005758",4025,1041,582,459,2848,552,1458,605,617,236,512,270,206,36,310,196,114,16,16,136,46,90
"2021","Hambleton 010","E02005759",4302,1351,750,601,2822,732,1315,572,513,230,413,231,159,23,344,200,144,18,18,129,41,88
"2021","Hambleton 011","E02005760",2530,542,253,289,1886,335,1076,426,459,191,296,194,83,19,174,102,72,5,5,102,43,59
"2021","Hambleton 012","E02007042",3215,1029,549,480,2081,437,975,436,371,168,332,172,146,14,323,225,98,14,14,105,35,70
"2021","Hambleton 013","E02007043",2936,1113,510,603,1711,231,752,318,299,135,349,182,147,20,360,240,120,19,19,112,43,69
"2021","Harrogate 001","E02005761",2376,633,353,280,1640,400,912,399,366,147,170,94,63,13,150,83,67,8,8,103,49,54
"2021","Harrogate 002","E02005762",2584,824,417,407,1678,345,878,325,438,115,213,124,77,12,232,150,82,10,10,82,29,53
"2021","Harrogate 003","E02005763",2763,677,342,335,2014,431,1100,458,499,143,293,174,102,17,179,107,72,11,11,72,30,42
"2021","Harrogate 004","E02005764",4695,1596,827,769,2954,572,1383,578,537,268,477,247,199,31,508,322,186,14,14,145,59,86
"2021","Harrogate 005","E02005765",3146,825,420,405,2206,460,1164,534,457,173,353,213,122,18,224,133,91,5,5,115,33,82
"2021","Harrogate 006","E02005766",2675,757,414,343,1799,432,952,424,367,161,262,150,95,17,145,80,65,8,8,119,44,75
"2021","Harrogate 007","E02005767",3060,683,395,288,2291,491,1337,532,593,212,259,129,115,15,198,120,78,6,6,86,42,44
"2021","Harrogate 008","E02005768",2774,650,340,310,2041,320,1197,430,594,173,309,171,128,10,206,145,61,9,9,83,33,50
"2021","Harrogate 009","E02005769",3329,1260,653,607,1960,330,847,306,378,163,349,206,125,18,416,258,158,18,18,109,33,76
"2021","Harrogate 010","E02005770",4130,1232,627,605,2735,477,1301,551,553,197,517,300,190,27,421,230,191,19,19,163,53,110
"2021","Harrogate 011","E02005771",3531,1252,455,797,2160,243,1013,381,496,136,471,267,191,13,415,295,120,18,18,119,48,71
"2021","Harrogate 012","E02005772",2508,605,401,204,1824,438,1049,426,441,182,195,113,68,14,136,72,64,6,6,79,30,49
"2021","Harrogate 013","E02005773",4351,1811,664,1147,2333,240,1014,384,481,149,553,369,160,24,492,302,190,34,34,207,60,147
"2021","Harrogate 014","E02005774",4158,1332,637,695,2620,345,1252,478,550,224,527,297,193,37,466,286,180,30,30,206,70,136
"2021","Harrogate 015","E02005775",4841,2311,641,1670,2289,329,1048,468,458,122,593,477,95,21,269,170,99,50,50,241,45,196
"2021","Harrogate 016","E02005776",3530,727,339,388,2683,489,1510,604,669,237,428,273,133,22,248,153,95,8,8,120,54,66
"2021","Harrogate 017","E02005777",3430,852,508,344,2483,487,1403,456,749,198,288,161,112,15,297,151,146,8,8,95,28,67
"2021","Harrogate 018","E02005778",2600,591,320,271,1920,447,1103,460,438,205,227,137,77,13,130,73,57,13,13,89,36,53
"2021","Harrogate 019","E02005779",3633,1485,699,786,2049,429,1067,401,520,146,309,230,72,7,235,131,104,9,9,99,22,77
"2021","Harrogate 020","E02005780",4571,1191,673,518,3239,716,1780,544,991,245,346,191,140,15,383,248,135,14,14,141,59,82
"2021","Harrogate 021","E02005781",2460,549,335,214,1829,402,1071,396,499,176,202,110,88,4,149,83,66,5,5,82,38,44
"2021","Richmondshire 001","E02005782",3397,889,492,397,2399,593,1314,628,465,221,280,183,81,16,204,125,79,8,8,109,40,69
"2021","Richmondshire 002","E02005783",3881,1436,716,720,2346,517,1132,502,447,183,340,191,124,25,344,213,131,13,13,99,31,68
"2021","Richmondshire 003","E02005784",2383,687,373,314,1606,299,852,355,347,150,246,135,93,18,205,131,74,4,4,90,48,42
"2021","Richmondshire 004","E02005785",4568,1038,341,697,3325,218,2009,626,1108,275,508,241,239,28,576,427,149,14,14,205,94,111
"2021","Richmondshire 005","E02005786",2769,889,495,394,1825,455,962,529,264,169,255,168,76,11,150,62,88,3,3,55,22,33
"2021","Richmondshire 006","E02005787",3940,1172,688,484,2639,689,1333,700,417,216,375,245,117,13,225,145,80,17,17,129,52,77
"2021","Ryedale 001","E02005788",2973,923,508,415,1951,504,953,487,294,172,290,173,99,18,195,119,76,9,9,99,32,67
"2021","Ryedale 002","E02005789",5015,1646,974,672,3214,898,1464,709,507,248,477,257,193,27,365,195,170,10,10,155,48,107
"2021","Ryedale 003","E02005790",3114,936,540,396,2065,487,1100,559,375,166,280,174,95,11,188,99,89,10,10,113,45,68
"2021","Ryedale 004","E02005791",2948,742,371,371,2088,391,1092,504,368,220,362,181,155,26,229,143,86,14,14,118,43,75
"2021","Ryedale 007","E02005794",4142,1109,626,483,2862,638,1544,740,551,253,422,265,139,18,244,128,116,14,14,171,58,113
"2021","Ryedale 009","E02007044",3466,1225,499,726,2095,205,927,326,462,139,572,313,233,26,368,241,127,23,23,146,40,106
"2021","Ryedale 010","E02007045",3061,970,538,432,1995,434,976,402,395,179,358,202,131,25,211,126,85,16,16,96,25,71
"2021","Scarborough 001","E02005795",3401,1403,710,693,1897,393,884,421,300,163,332,184,128,20,274,150,124,14,14,101,29,72
"2021","Scarborough 002","E02005796",2970,902,520,382,1940,480,962,471,303,188,298,151,127,20,186,97,89,14,14,128,44,84
"2021","Scarborough 003","E02005797",2822,890,419,471,1834,340,841,394,285,162,316,144,145,27,328,204,124,9,9,98,33,65
"2021","Scarborough 004","E02005798",3759,1088,671,417,2538,685,1245,634,386,225,373,224,132,17,229,119,110,6,6,133,52,81
"2021","Scarborough 005","E02005799",4204,1281,882,399,2802,757,1351,544,530,277,384,180,176,28,304,188,116,6,6,121,53,68
"2021","Scarborough 006","E02005800",3857,1901,609,1292,1754,221,684,311,248,125,398,229,155,14,421,279,142,30,30,202,70,132
"2021","Scarborough 007","E02005801",2383,813,394,419,1471,196,573,220,234,119,281,101,156,24,402,278,124,19,19,99,46,53
"2021","Scarborough 008","E02005802",3535,1254,464,790,2085,218,758,315,307,136,507,256,223,28,572,394,178,30,30,196,80,116
"2021","Scarborough 009","E02005803",4375,1617,834,783,2554,468,1129,530,415,184,493,266,197,30,437,276,161,27,27,204,71,133
"2021","Scarborough 010","E02005804",4408,2484,842,1642,1724,368,676,444,161,71,386,297,73,16,264,168,96,30,30,200,49,151
"2021","Scarborough 011","E02005805",3653,1107,635,472,2440,613,1119,573,359,187,426,240,167,19,269,163,106,13,13,106,45,61
"2021","Scarborough 012","E02005806",3377,921,405,516,2307,300,887,326,397,164,538,205,287,46,564,410,154,18,18,149,79,70
"2021","Scarborough 013","E02005807",2854,726,452,274,2014,512,1012,454,394,164,288,152,121,15,196,116,80,6,6,114,52,62
"2021","Scarborough 014","E02005808",5520,1831,1135,696,3485,1041,1481,815,399,267,524,261,221,42,427,259,168,12,12,204,86,118
"2021","Selby 001","E02005809",3405,1124,583,541,2188,399,1160,438,512,210,364,186,153,25,251,147,104,14,14,93,31,62
"2021","Selby 002","E02005810",3848,861,417,444,2857,489,1700,642,794,264,421,237,161,23,238,168,70,9,9,130,64,66
"2021","Selby 003","E02005811",4100,957,489,468,3004,507,1652,681,701,270,540,322,195,23,294,189,105,11,11,139,61,78
"2021","Selby 004","E02005812",4863,1253,559,694,3442,429,1735,681,804,250,790,493,261,36,467,321,146,21,21,168,66,102
"2021","Selby 005","E02005813",5912,2031,585,1446,3607,276,1486,576,682,228,999,519,434,46,787,555,232,59,59,274,108,166
"2021","Selby 006","E02005814",3058,876,490,386,2061,409,1004,405,399,200,332,176,138,18,306,197,109,10,10,121,61,60
"2021","Selby 007","E02005815",3766,925,517,408,2742,577,1427,618,542,267,454,246,184,24,274,167,107,10,10,99,42,57
"2021","Selby 008","E02005816",3633,790,391,399,2680,458,1474,671,566,237,463,275,164,24,277,182,95,8,8,163,85,78
"2021","Selby 009","E02005817",3284,883,406,477,2316,456,1165,510,476,179,430,242,168,20,253,165,88,12,12,85,36,49
"2021","Selby 010","E02005818",3689,855,390,465,2673,433,1479,621,587,271,478,288,167,23,274,187,87,9,9,161,76,85
"2021","Barnsley 001","E02001509",3015,862,399,463,2049,291,966,384,391,191,435,206,204,25,348,241,107,9,9,104,54,50
"2021","Barnsley 002","E02001510",2608,776,311,465,1725,260,748,297,273,178,349,162,165,22,351,233,118,17,17,107,46,61
"2021","Barnsley 003","E02001511",2718,818,412,406,1792,317,808,375,260,173,352,162,162,28,303,209,94,12,12,108,56,52
"2021","Barnsley 004","E02001512",3782,1125,492,633,2548,414,1186,480,482,224,552,298,216,38,389,254,135,7,7,109,48,61
"2021","Barnsley 005","E02001513",3392,992,501,491,2305,424,1088,433,408,247,496,281,187,28,290,180,110,7,7,95,52,43
"2021","Barnsley 006","E02001514",3198,896,337,559,2134,238,895,349,353,193,554,251,261,42,428,289,139,19,19,168,90,78
"2021","Barnsley 007","E02001515",4082,1250,523,727,2638,289,981,384,375,222,642,235,349,58,700,491,209,26,26,194,100,94
"2021","Barnsley 008","E02001516",2627,723,271,452,1811,181,805,323,314,168,424,191,204,29,384,267,117,17,17,93,47,46
"2021","Barnsley 009","E02001517",3570,1066,534,532,2390,451,1148,496,420,232,457,213,210,34,323,203,120,11,11,114,60,54
"2021","Barnsley 010","E02001518",4620,1544,561,983,2890,358,1316,533,541,242,647,336,264,47,549,342,207,20,20,186,82,104
"2021","Barnsley 011","E02001519",3217,801,337,464,2248,271,943,343,385,215,555,229,291,35,460,345,115,19,19,168,87,81
"2021","Barnsley 012","E02001520",5238,1521,808,713,3551,721,1681,669,672,340,719,389,276,54,412,256,156,18,18,166,82,84
"2021","Barnsley 013","E02001521",5810,2261,564,1697,3146,243,1201,492,489,220,945,578,328,39,678,459,219,79,79,403,127,276
"2021","Barnsley 014","E02001522",4191,1334,541,793,2687,324,1055,466,364,225,603,253,299,51,676,475,201,29,29,170,87,83
"2021","Barnsley 015","E02001523",3118,990,363,627,1985,319,861,383,306,172,491,268,188,35,293,190,103,21,21,143,56,87
"2021","Barnsley 016","E02001524",2695,688,426,262,1937,493,1056,452,431,173,249,140,88,21,132,72,60,7,7,70,32,38
"2021","Barnsley 017","E02001525",3226,1352,441,911,1701,156,605,244,248,113,474,228,217,29,422,288,134,44,44,173,67,106
"2021","Barnsley 018","E02001526",2633,844,373,471,1652,187,642,244,267,131,384,144,218,22,420,296,124,19,19,137,79,58
"2021","Barnsley 019","E02001527",2671,842,410,432,1762,322,844,334,327,183,333,163,143,27,257,156,101,6,6,67,37,30
"2021","Barnsley 020","E02001528",4668,1403,671,732,3083,527,1329,589,463,277,616,274,302,40,584,391,193,27,27,182,97,85
"2021","Barnsley 021","E02001529",4269,1424,584,840,2700,408,1076,484,358,234,587,261,276,50,604,389,215,25,25,145,76,69
"2021","Barnsley 022","E02001530",3181,995,358,637,2055,189,842,362,318,162,538,274,235,29,467,305,162,19,19,131,65,66
"2021","Barnsley 023","E02001531",3552,1193,454,739,2191,290,871,372,325,174,579,306,244,29,419,281,138,32,32,168,76,92
"2021","Barnsley 024","E02001532",4548,1280,624,656,3144,476,1659,649,759,251,568,263,265,40,429,274,155,12,12,124,51,73
"2021","Barnsley 025","E02001533",3277,930,385,545,2201,258,964,386,356,222,539,232,265,42,422,278,144,18,18,146,93,53
"2021","Barnsley 026","E02001534",4156,1208,503,705,2782,311,1238,486,495,257,687,328,306,53,521,357,164,25,25,166,66,100
"2021","Barnsley 027","E02001535",2772,682,372,310,1978,421,1060,438,431,191,305,168,119,18,183,93,90,9,9,112,45,67
"2021","Barnsley 028","E02001536",3973,1279,633,646,2575,441,1138,463,445,230,596,312,247,37,393,232,161,7,7,119,54,65
"2021","Barnsley 029","E02001537",3769,1188,501,687,2442,288,1158,466,470,222,562,283,231,48,422,269,153,12,12,139,63,76
"2021","Barnsley 030","E02001538",3485,1022,480,542,2351,388,1037,467,351,219,482,206,240,36,434,288,146,10,10,112,64,48
"2021","Doncaster 001","E02001539",2683,679,287,392,1866,206,838,301,340,197,384,159,195,30,421,323,98,17,17,138,73,65
"2021","Doncaster 002","E02001540",5128,1441,634,807,3472,518,1576,608,615,353,686,309,326,51,672,459,213,20,20,215,109,106
"2021","Doncaster 003","E02001541",5070,1631,784,847,3198,542,1421,578,544,299,633,290,294,49,573,358,215,29,29,241,103,138
"2021","Doncaster 004","E02001542",3141,921,388,533,2050,284,834,335,312,187,427,168,225,34,479,342,137,26,26,170,98,72
"2021","Doncaster 005","E02001543",3460,1059,564,495,2246,355,925,407,321,197,480,213,228,39,457,304,153,29,29,155,72,83
"2021","Doncaster 006","E02001544",3555,1036,464,572,2396,345,1076,459,408,209,472,191,250,31,487,345,142,16,16,123,55,68
"2021","Doncaster 007","E02001545",3881,1198,681,517,2583,578,1231,488,496,247,419,213,178,28,343,215,128,12,12,100,50,50
"2021","Doncaster 008","E02001546",2968,821,436,385,2031,450,973,432,361,180,366,184,154,28,234,134,100,8,8,116,54,62
"2021","Doncaster 009","E02001547",4479,1224,464,760,3004,289,1261,482,490,289,722,331,349,42,703,469,234,29,29,251,103,148
"2021","Doncaster 010","E02001548",3557,1248,459,789,2099,181,760,291,313,156,507,223,238,46,630,448,182,21,21,210,93,117
"2021","Doncaster 011","E02001549",2703,744,386,358,1868,324,878,342,364,172,365,159,176,30,287,174,113,14,14,91,45,46
"2021","Doncaster 012","E02001550",3362,1044,508,536,2203,251,1012,402,406,204,521,229,248,44,405,250,155,14,14,115,57,58
"2021","Doncaster 013","E02001551",2753,965,320,645,1671,238,646,262,257,127,402,206,172,24,366,241,125,19,19,117,50,67
"2021","Doncaster 014","E02001552",3218,970,396,574,2066,218,912,330,401,181,516,229,258,29,404,260,144,16,16,182,97,85
"2021","Doncaster 015","E02001553",4313,1324,565,759,2749,343,1261,425,559,277,571,242,284,45,542,339,203,32,32,240,123,117
"2021","Doncaster 016","E02001554",2654,746,399,347,1842,325,903,342,355,206,348,161,159,28,262,163,99,4,4,66,26,40
"2021","Doncaster 017","E02001555",2462,796,454,342,1589,364,791,397,258,136,256,135,108,13,171,102,69,7,7,77,29,48
"2021","Doncaster 018","E02001556",3762,1119,489,630,2410,266,1033,331,471,231,450,174,226,50,627,385,242,34,34,233,109,124
"2021","Doncaster 019","E02001557",4668,1988,520,1468,2318,213,1080,429,469,182,559,333,193,33,394,213,181,72,72,362,138,224
"2021","Doncaster 020","E02001558",2768,794,462,332,1896,453,920,425,289,206,299,169,113,17,220,129,91,4,4,78,32,46
"2021","Doncaster 021","E02001559",3236,854,469,385,2287,469,1148,428,499,221,397,191,182,24,263,142,121,10,10,95,42,53
"2021","Doncaster 022","E02001560",4974,2094,488,1606,2424,125,886,313,464,109,641,365,244,32,649,461,188,123,123,456,207,249
"2021","Doncaster 023","E02001561",2926,1199,344,855,1524,99,652,246,296,110,393,191,184,18,344,232,112,36,36,203,66,137
"2021","Doncaster 024","E02001562",2611,889,472,417,1595,245,655,265,254,136,338,141,169,28,344,224,120,13,13,127,56,71
"2021","Doncaster 025","E02001563",3472,1046,565,481,2264,456,1146,405,495,246,353,185,145,23,297,176,121,12,12,162,75,87
"2021","Doncaster 026","E02001564",3538,883,498,385,2547,576,1339,554,550,235,359,199,136,24,266,158,108,7,7,108,57,51
"2021","Doncaster 027","E02001565",3358,876,411,465,2344,505,1274,527,544,203,330,213,106,11,215,120,95,20,20,138,64,74
"2021","Doncaster 028","E02001566",3671,1121,288,833,2295,151,1012,362,494,156,614,323,265,26,468,334,134,50,50,255,97,158
"2021","Doncaster 029","E02001567",3727,1156,552,604,2364,374,920,359,354,207,486,200,258,28,559,392,167,25,25,207,108,99
"2021","Doncaster 030","E02001568",3083,985,401,584,1974,269,792,319,310,163,433,199,209,25,458,320,138,22,22,124,63,61
"2021","Doncaster 031","E02001569",3951,1396,472,924,2391,276,909,405,300,204,603,266,288,49,577,415,162,26,26,164,66,98
"2021","Doncaster 032","E02001570",3238,1258,498,760,1853,231,713,330,255,128,445,213,204,28,450,297,153,14,14,127,63,64
"2021","Doncaster 033","E02001571",2617,741,381,360,1778,332,876,393,308,175,317,158,133,26,243,145,98,10,10,98,50,48
"2021","Doncaster 034","E02001572",3395,1096,449,647,2148,206,937,389,357,191,488,232,226,30,496,329,167,21,21,151,89,62
"2021","Doncaster 035","E02001573",3182,879,390,489,2168,266,972,374,370,228,429,153,233,43,486,336,150,15,15,135,60,75
"2021","Doncaster 036","E02001574",2641,673,329,344,1860,365,911,422,338,151,332,168,145,19,238,147,91,14,14,108,50,58
"2021","Doncaster 037","E02001575",3269,955,399,556,2134,186,810,323,332,155,581,237,310,34,542,340,202,15,15,180,80,100
"2021","Doncaster 038","E02001576",3014,879,394,485,2026,269,1003,336,503,164,446,254,174,18,297,194,103,11,11,109,46,63
"2021","Doncaster 039","E02001577",2983,943,585,358,1965,554,936,413,342,181,289,163,110,16,181,102,79,5,5,75,36,39
"2021","Rotherham 001","E02001578",4755,1269,497,772,3313,317,1576,546,747,283,800,352,382,66,593,418,175,27,27,173,81,92
"2021","Rotherham 002","E02001579",4275,1312,650,662,2786,406,1267,460,527,280,549,234,271,44,546,380,166,18,18,177,80,97
"2021","Rotherham 003","E02001580",3887,1243,589,654,2522,483,1048,425,411,212,543,246,248,49,434,277,157,14,14,122,50,72
"2021","Rotherham 004","E02001581",2712,752,337,415,1866,274,848,369,306,173,432,210,194,28,297,203,94,15,15,94,39,55
"2021","Rotherham 005","E02001582",3306,932,411,521,2251,323,992,406,371,215,494,203,236,55,433,262,171,9,9,123,62,61
"2021","Rotherham 006","E02001583",2387,663,266,397,1628,183,699,291,279,129,407,180,197,30,328,214,114,11,11,96,47,49
"2021","Rotherham 007","E02001584",2983,803,420,383,2097,402,1094,493,370,231,374,208,141,25,221,116,105,6,6,83,38,45
"2021","Rotherham 008","E02001585",2919,1139,388,751,1673,192,657,280,258,119,386,174,181,31,422,297,125,16,16,107,53,54
"2021","Rotherham 009","E02001586",3955,1706,608,1098,2118,370,777,377,222,178,470,228,202,40,465,274,191,36,36,131,59,72
"2021","Rotherham 010","E02001587",2629,902,378,524,1625,217,626,260,218,148,389,175,181,33,375,223,152,18,18,102,52,50
"2021","Rotherham 011","E02001588",3049,937,433,504,1997,208,799,289,328,182,420,148,230,42,542,353,189,28,28,115,58,57
"2021","Rotherham 012","E02001589",3450,914,452,462,2433,424,1227,494,532,201,451,215,210,26,318,199,119,13,13,103,52,51
"2021","Rotherham 013","E02001590",2983,908,326,582,1882,149,696,215,310,171,404,140,227,37,609,414,195,24,24,193,104,89
"2021","Rotherham 014","E02001591",3258,1093,346,747,1918,174,830,257,413,160,393,151,207,35,487,314,173,34,34,247,144,103
"2021","Rotherham 015","E02001592",3786,1101,505,596,2542,456,1166,490,406,270,508,241,221,46,398,257,141,14,14,143,69,74
"2021","Rotherham 016","E02001593",2947,1114,290,824,1617,105,662,213,336,113,345,169,153,23,464,322,142,41,41,216,128,88
"2021","Rotherham 017","E02001594",3073,1301,242,1059,1516,100,625,199,336,90,374,191,171,12,372,284,88,45,45,256,149,107
"2021","Rotherham 018","E02001595",3593,952,487,465,2533,442,1270,531,455,284,491,254,189,48,319,189,130,11,11,108,53,55
"2021","Rotherham 019","E02001596",3754,1196,704,492,2451,515,1120,443,436,241,409,184,196,29,391,252,139,16,16,107,48,59
"2021","Rotherham 020","E02001597",4127,1348,533,815,2620,334,963,363,351,249,627,248,323,56,677,467,210,19,19,159,77,82
"2021","Rotherham 021","E02001598",4035,1114,639,475,2749,502,1287,448,601,238,497,231,224,42,446,257,189,17,17,172,83,89
"2021","Rotherham 023","E02001600",4138,1170,577,593,2621,504,1420,402,734,284,349,189,139,21,330,173,157,18,18,347,230,117
"2021","Rotherham 025","E02001602",3935,1087,565,522,2710,505,1216,489,453,274,538,251,239,48,434,259,175,17,17,138,78,60
"2021","Rotherham 026","E02001603",3201,901,391,510,2173,298,969,412,372,185,478,195,246,37,406,260,146,22,22,127,64,63
"2021","Rotherham 027","E02001604",4775,1113,362,751,3510,333,1720,562,909,249,925,492,375,58,512,333,179,20,20,152,73,79
"2021","Rotherham 028","E02001605",3303,956,408,548,2235,352,1042,448,381,213,497,253,211,33,333,229,104,11,11,112,52,60
"2021","Rotherham 029","E02001606",3431,1000,460,540,2291,390,963,361,382,220,501,208,246,47,422,275,147,15,15,140,74,66
"2021","Rotherham 030","E02001607",3826,1078,593,485,2618,474,1152,434,483,235,544,230,267,47,436,287,149,12,12,130,68,62
"2021","Rotherham 031","E02001608",2950,742,381,361,2122,369,1052,356,479,217,398,181,187,30,293,177,116,10,10,86,51,35
"2021","Rotherham 032","E02001609",3719,967,606,361,2653,638,1233,494,479,260,428,202,203,23,348,198,150,6,6,99,46,53
"2021","Rotherham 033","E02001610",3737,1013,535,478,2621,509,1293,495,568,230,476,225,214,37,330,199,131,13,13,103,54,49
"2021","Rotherham 034","E02007002",5048,1493,796,697,3388,657,1727,659,696,372,569,275,251,43,421,252,169,14,14,167,85,82
"2021","Sheffield 001","E02001611",3436,1063,533,530,2278,449,988,395,402,191,479,244,201,34,347,229,118,15,15,95,40,55
"2021","Sheffield 002","E02001612",2530,749,329,420,1718,337,830,340,324,166,327,171,134,22,220,135,85,4,4,63,26,37
"2021","Sheffield 003","E02001613",4527,1336,713,623,3051,565,1393,550,526,317,559,265,254,40,519,341,178,15,15,140,68,72
"2021","Sheffield 004","E02001614",4782,1286,714,572,3345,701,1676,626,696,354,557,309,209,39,398,206,192,13,13,151,46,105
"2021","Sheffield 005","E02001615",3281,979,540,439,2200,598,1046,457,367,222,377,210,140,27,174,94,80,5,5,102,44,58
"2021","Sheffield 006","E02001616",3232,1113,547,566,2001,318,888,300,385,203,422,188,204,30,356,195,161,17,17,118,52,66
"2021","Sheffield 007","E02001617",2335,643,244,399,1592,106,575,184,256,135,363,115,218,30,526,376,150,22,22,100,50,50
"2021","Sheffield 008","E02001618",4094,1065,472,593,2897,500,1572,569,766,237,492,250,208,34,325,204,121,8,8,132,50,82
"2021","Sheffield 009","E02001619",4225,1288,543,745,2754,261,1009,362,433,214,722,261,381,80,739,496,243,23,23,183,94,89
"2021","Sheffield 010","E02001620",2832,833,334,499,1873,167,764,211,403,150,348,143,178,27,575,374,201,19,19,126,62,64
"2021","Sheffield 011","E02001621",2508,782,267,515,1604,141,644,204,321,119,315,127,161,27,481,357,124,23,23,122,65,57
"2021","Sheffield 012","E02001622",4005,1380,512,868,2456,277,858,309,359,190,583,263,264,56,700,518,182,38,38,169,85,84
"2021","Sheffield 013","E02001623",3226,1158,469,689,1866,163,800,183,447,170,285,142,111,32,591,379,212,27,27,202,117,85
"2021","Sheffield 014","E02001624",4086,1379,465,914,2492,346,1138,454,465,219,497,286,182,29,484,308,176,27,27,215,108,107
"2021","Sheffield 015","E02001625",3203,913,388,525,2121,198,750,245,328,177,425,145,232,48,728,535,193,20,20,169,68,101
"2021","Sheffield 016","E02001626",2541,721,323,398,1728,268,856,332,354,170,335,166,137,32,256,160,96,13,13,92,34,58
"2021","Sheffield 017","E02001627",2872,1107,326,781,1619,153,672,260,285,127,480,317,137,26,298,189,109,16,16,146,43,103
"2021","Sheffield 018","E02001628",2138,570,244,326,1292,116,723,144,470,109,125,57,59,9,298,183,115,30,30,276,195,81
"2021","Sheffield 019","E02001629",2821,1124,359,765,1529,136,643,213,332,98,251,104,128,19,472,319,153,27,27,168,90,78
"2021","Sheffield 020","E02001630",2862,798,263,535,1638,94,944,166,647,131,173,84,73,16,357,227,130,70,70,426,263,163
"2021","Sheffield 021","E02001631",3401,1073,487,586,2192,310,1007,401,431,175,540,305,194,41,323,190,133,12,12,136,50,86
"2021","Sheffield 022","E02001632",4357,1505,308,1197,2354,86,1123,202,802,119,413,252,144,17,637,430,207,95,95,498,273,225
"2021","Sheffield 023","E02001633",3305,885,565,320,2317,507,1230,436,552,242,360,207,127,26,214,102,112,6,6,103,44,59
"2021","Sheffield 024","E02001634",4424,1586,525,1061,2567,290,1104,483,481,140,801,607,168,26,338,187,151,34,34,271,43,228
"2021","Sheffield 025","E02001635",2867,1076,509,567,1726,333,745,269,324,152,319,158,133,28,312,209,103,17,17,65,29,36
"2021","Sheffield 026","E02001636",4082,1856,551,1305,1905,162,869,281,471,117,405,284,105,16,426,262,164,43,43,321,76,245
"2021","Sheffield 027","E02001637",2679,703,243,460,1659,88,922,127,681,114,170,65,91,14,441,307,134,38,38,317,217,100
"2021","Sheffield 028","E02001638",2149,509,150,359,955,80,398,146,204,48,352,282,65,5,101,58,43,24,24,685,13,672
"2021","Sheffield 029","E02001639",2717,910,377,533,1486,177,636,219,345,72,475,355,103,17,180,112,68,18,18,321,28,293
"2021","Sheffield 030","E02001640",3013,1027,261,766,1079,109,527,166,302,59,302,243,54,5,117,79,38,24,24,907,48,859
"2021","Sheffield 032","E02001642",4246,1285,545,740,2730,364,1320,423,656,241,593,321,224,48,439,265,174,14,14,231,110,121
"2021","Sheffield 033","E02001643",2678,761,456,305,1863,390,1089,375,554,160,212,111,88,13,163,90,73,9,9,54,21,33
"2021","Sheffield 036","E02001646",2499,815,269,546,1034,137,508,191,251,66,272,216,47,9,87,50,37,30,30,650,32,618
"2021","Sheffield 037","E02001647",2715,846,443,403,1794,304,825,288,374,163,348,159,158,31,311,194,117,6,6,75,35,40
"2021","Sheffield 038","E02001648",2570,912,388,524,1553,276,840,300,434,106,293,195,87,11,143,92,51,1,1,105,37,68
"2021","Sheffield 039","E02001649",4689,1639,514,1125,2769,150,1053,334,525,194,675,338,275,62,834,621,213,57,57,281,136,145
"2021","Sheffield 040","E02001650",3511,1555,205,1350,1297,40,553,193,312,48,385,320,56,9,245,154,91,74,74,659,70,589
"2021","Sheffield 041","E02001651",3291,756,506,250,2424,610,1412,426,773,213,223,104,112,7,174,96,78,5,5,111,49,62
"2021","Sheffield 042","E02001652",3718,1289,210,1079,1518,77,640,167,387,86,480,394,78,8,248,146,102,73,73,911,134,777
"2021","Sheffield 043","E02001653",3269,1193,376,817,1874,138,695,252,339,104,496,307,161,28,506,348,158,39,39,202,69,133
"2021","Sheffield 044","E02001654",2643,723,439,284,1822,304,848,319,331,198,348,173,151,24,316,186,130,6,6,98,41,57
"2021","Sheffield 045","E02001655",3348,1037,441,596,2208,301,853,303,365,185,479,207,231,41,554,380,174,21,21,103,52,51
"2021","Sheffield 046","E02001656",3086,795,306,489,1821,211,957,303,551,103,435,309,116,10,188,111,77,30,30,470,62,408
"2021","Sheffield 047","E02001657",3647,833,407,426,2615,369,1495,392,932,171,486,286,178,22,250,143,107,15,15,199,45,154
"2021","Sheffield 048","E02001658",2244,718,278,440,1406,103,485,193,179,113,260,79,148,33,542,388,154,16,16,120,57,63
"2021","Sheffield 049","E02001659",2881,1247,495,752,1536,201,625,264,227,134,317,187,108,22,376,255,121,17,17,98,43,55
"2021","Sheffield 050","E02001660",4108,1479,491,988,2201,227,1111,335,610,166,595,433,142,20,248,152,96,20,20,428,159,269
"2021","Sheffield 051","E02001661",3533,1362,501,861,1928,177,702,250,329,123,448,269,153,26,569,392,177,32,32,243,72,171
"2021","Sheffield 052","E02001662",3363,1136,550,586,2112,342,857,345,308,204,500,249,211,40,399,259,140,14,14,115,42,73
"2021","Sheffield 053","E02001663",3283,1065,291,774,1990,143,886,325,445,116,669,435,211,23,278,185,93,14,14,228,50,178
"2021","Sheffield 054","E02001664",2808,866,436,430,1836,358,787,332,289,166,355,201,132,22,322,194,128,14,14,106,51,55
"2021","Sheffield 055","E02001665",3993,971,662,309,2905,643,1747,530,939,278,304,141,140,23,200,107,93,11,11,117,46,71
"2021","Sheffield 056","E02001666",2541,733,304,429,1703,193,773,290,296,187,383,169,191,23,346,213,133,8,8,105,45,60
"2021","Sheffield 059","E02001669",3545,1182,413,769,2202,216,991,377,462,152,633,414,189,30,334,199,135,28,28,161,56,105
"2021","Sheffield 060","E02001670",2692,1037,380,657,1559,160,546,168,241,137,305,123,155,27,529,372,157,19,19,96,49,47
"2021","Sheffield 061","E02001671",2626,841,474,367,1718,401,865,369,282,214,276,144,105,27,169,82,87,7,7,67,22,45
"2021","Sheffield 062","E02001672",2693,880,458,422,1731,306,747,279,293,175,408,210,169,29,262,168,94,8,8,82,31,51
"2021","Sheffield 063","E02001673",2156,490,216,274,1595,228,913,359,356,198,276,150,111,15,177,112,65,1,1,71,26,45
"2021","Sheffield 064","E02001674",4048,1206,703,503,2730,576,1392,552,614,226,495,275,196,24,254,149,105,13,13,112,47,65
"2021","Sheffield 065","E02001675",4010,1456,645,811,2424,505,991,420,345,226,434,223,166,45,477,293,184,17,17,130,69,61
"2021","Sheffield 066","E02001676",2527,679,449,230,1779,368,999,357,464,178,262,157,90,15,145,79,66,5,5,69,32,37
"2021","Sheffield 068","E02001678",4475,1261,768,493,3093,767,1698,539,910,249,333,192,128,13,284,172,112,11,11,121,51,70
"2021","Sheffield 069","E02001679",2936,1110,431,679,1741,218,658,203,323,132,344,158,165,21,508,356,152,13,13,85,40,45
"2021","Sheffield 070","E02001680",3050,1335,419,916,1582,140,507,171,240,96,366,150,192,24,545,387,158,24,24,133,55,78
"2021","Sheffield 071","E02001681",3356,1031,585,446,2256,491,1197,414,620,163,305,168,123,14,253,149,104,10,10,69,29,40
"2021","Sheffield 072","E02006803",4022,1057,501,556,2857,491,1465,582,617,266,593,335,221,37,293,183,110,15,15,108,48,60
"2021","Sheffield 073","E02006843",4059,2181,69,2112,1428,7,455,253,190,12,794,775,16,3,90,61,29,82,82,450,21,429
"2021","Sheffield 074","E02006844",2705,1324,89,1235,776,14,328,120,191,17,250,225,21,4,146,72,74,38,38,605,37,568
"2021","Sheffield 075","E02006868",5046,1805,565,1240,2830,233,1042,391,458,193,634,406,191,37,868,601,267,53,53,411,102,309
"2021","Sheffield 076","E02006869",4817,1442,625,817,3220,418,1397,499,572,326,735,338,326,71,647,402,245,23,23,155,72,83
"2021","Bradford 001","E02002183",2759,1021,648,373,1656,501,818,348,353,117,199,130,61,8,136,84,52,2,2,82,28,54
"2021","Bradford 002","E02002184",5829,1866,1171,695,3778,920,1940,637,984,319,511,299,183,29,390,238,152,17,17,185,80,105
"2021","Bradford 003","E02002185",2514,707,383,324,1753,351,953,299,509,145,253,123,115,15,193,123,70,3,3,54,16,38
"2021","Bradford 005","E02002187",2612,658,390,268,1875,397,1093,382,556,155,232,136,89,7,146,84,62,7,7,79,36,43
"2021","Bradford 006","E02002188",3190,861,413,448,2189,371,1156,443,521,192,393,231,133,29,261,181,80,8,8,140,82,58
"2021","Bradford 007","E02002189",2274,597,252,345,1402,203,794,211,447,136,160,88,58,14,225,134,91,20,20,275,201,74
"2021","Bradford 008","E02002190",4266,1404,425,979,2414,237,1207,299,708,200,378,190,166,22,561,370,191,31,31,448,307,141
"2021","Bradford 009","E02002191",3696,1201,434,767,2233,156,1049,297,602,150,363,164,171,28,639,436,203,26,26,262,171,91
"2021","Bradford 010","E02002192",4023,1154,659,495,2756,595,1492,576,653,263,395,212,165,18,267,165,102,7,7,113,51,62
"2021","Bradford 011","E02002193",3087,1280,461,819,1641,176,593,251,245,97,358,169,170,19,494,363,131,20,20,166,75,91
"2021","Bradford 012","E02002194",3195,917,426,491,2145,327,909,390,339,180,404,180,182,42,490,351,139,15,15,133,70,63
"2021","Bradford 013","E02002195",2874,862,515,347,1933,444,1044,437,440,167,251,144,94,13,185,116,69,9,9,79,37,42
"2021","Bradford 014","E02002196",2709,731,320,411,1874,266,936,396,373,167,391,198,165,28,272,190,82,9,9,104,44,60
"2021","Bradford 015","E02002197",4157,1662,690,972,2335,315,987,368,445,174,552,307,203,42,453,307,146,28,28,160,56,104
"2021","Bradford 016","E02002198",3942,1386,654,732,2410,423,1058,436,446,176,480,266,189,25,427,296,131,22,22,146,47,99
"2021","Bradford 017","E02002199",3270,994,416,578,2172,333,1137,480,475,182,426,249,147,30,259,176,83,17,17,104,47,57
"2021","Bradford 018","E02002200",3957,1333,603,730,2460,441,1184,416,590,178,477,304,156,17,343,221,122,15,15,164,80,84
"2021","Bradford 019","E02002201",5431,1812,707,1105,3384,370,1566,593,685,288,762,426,294,42,663,480,183,23,23,235,108,127
"2021","Bradford 020","E02002202",3777,1754,420,1334,1845,171,763,298,366,99,493,346,129,18,390,261,129,28,28,178,72,106
"2021","Bradford 021","E02002203",3532,1280,415,865,2096,220,832,328,327,177,475,231,219,25,550,404,146,19,19,156,82,74
"2021","Bradford 022","E02002204",5072,1510,802,708,3372,642,1666,669,704,293,530,286,196,48,513,313,200,21,21,190,94,96
"2021","Bradford 023","E02002205",4567,1514,658,856,2910,498,1418,657,537,224,611,375,195,41,371,247,124,12,12,143,55,88
"2021","Bradford 024","E02002206",3563,974,481,493,2345,304,1092,372,491,229,425,172,219,34,506,322,184,18,18,244,126,118
"2021","Bradford 025","E02002207",2388,755,201,554,1289,90,767,139,459,169,133,63,62,8,282,179,103,17,17,344,241,103
"2021","Bradford 026","E02002208",3500,1097,504,593,2233,251,837,332,349,156,446,208,210,28,662,491,171,37,37,170,86,84
"2021","Bradford 027","E02002209",2603,731,220,511,1732,86,740,207,414,119,350,121,194,35,533,415,118,23,23,140,86,54
"2021","Bradford 028","E02002210",2851,765,326,439,1852,206,972,278,500,194,257,132,102,23,390,252,138,27,27,234,147,87
"2021","Bradford 029","E02002211",2103,508,222,286,1199,100,786,115,518,153,78,37,37,4,223,138,85,12,12,396,313,83
"2021","Bradford 030","E02002212",2726,494,157,337,1951,81,1196,162,908,126,117,32,78,7,537,410,127,20,20,281,213,68
"2021","Bradford 031","E02002213",3383,1004,479,525,2253,351,1081,440,434,207,429,232,168,29,373,267,106,19,19,126,65,61
"2021","Bradford 032","E02002214",2543,758,291,467,1628,165,839,258,452,129,304,145,139,20,300,218,82,20,20,157,99,58
"2021","Bradford 033","E02002215",2881,673,170,503,1652,63,1055,139,709,207,111,73,38,0,395,223,172,28,28,556,423,133
"2021","Bradford 034","E02002216",2942,1008,255,753,1422,53,865,117,588,160,124,61,55,8,344,226,118,36,36,512,396,116
"2021","Bradford 035","E02002217",3312,1047,326,721,1889,90,1056,180,734,142,221,93,111,17,487,346,141,35,35,376,247,129
"2021","Bradford 036","E02002218",3897,1168,440,728,2433,241,1217,333,702,182,357,183,153,21,595,440,155,23,23,296,204,92
"2021","Bradford 037","E02002219",2244,422,113,309,1484,47,1009,137,733,139,86,19,61,6,302,211,91,40,40,338,246,92
"2021","Bradford 038","E02002220",2611,450,137,313,1755,52,1091,143,762,186,105,27,68,10,480,288,192,27,27,406,295,111
"2021","Bradford 040","E02002222",3099,755,318,437,2088,165,1064,245,664,155,236,93,124,19,588,408,180,35,35,256,184,72
"2021","Bradford 041","E02002223",2276,524,115,409,1405,55,817,124,563,130,118,39,67,12,372,265,107,43,43,347,254,93
"2021","Bradford 042","E02002224",2910,639,186,453,1779,47,1195,168,854,173,102,30,65,7,390,229,161,45,45,492,372,120
"2021","Bradford 043","E02002225",3648,1131,462,669,2363,333,1099,413,490,196,463,236,196,31,441,312,129,27,27,154,82,72
"2021","Bradford 044","E02002226",3744,1110,156,954,1964,63,1211,149,833,229,158,75,78,5,460,315,145,72,72,670,455,215
"2021","Bradford 045","E02002227",2336,868,228,640,1222,53,565,133,351,81,224,78,130,16,359,234,125,21,21,246,135,111
"2021","Bradford 046","E02002228",3079,1029,334,695,1870,106,663,208,343,112,344,130,191,23,726,540,186,31,31,180,95,85
"2021","Bradford 047","E02002229",3302,1059,453,606,2066,268,926,345,384,197,376,178,162,36,476,332,144,20,20,177,84,93
"2021","Bradford 048","E02002230",2808,955,233,722,1507,25,816,112,590,114,144,44,92,8,477,375,102,45,45,346,240,106
"2021","Bradford 049","E02002231",4552,1077,387,690,3090,273,1653,396,956,301,384,169,180,35,728,498,230,52,52,385,268,117
"2021","Bradford 050","E02002232",2589,822,252,570,1545,93,781,143,543,95,241,96,134,11,399,269,130,31,31,222,154,68
"2021","Bradford 051","E02002233",2759,518,155,363,1879,48,1068,129,792,147,135,35,91,9,575,422,153,53,53,362,253,109
"2021","Bradford 052","E02002234",3199,1199,362,837,1832,75,570,180,290,100,375,126,216,33,761,587,174,51,51,168,94,74
"2021","Bradford 053","E02002235",2354,666,198,468,1463,90,805,168,504,133,172,75,76,21,368,264,104,28,28,225,148,77
"2021","Bradford 054","E02002236",2558,773,330,443,1625,181,828,229,459,140,258,123,110,25,329,220,109,29,29,160,104,56
"2021","Bradford 055","E02002237",3350,893,330,563,2240,221,988,308,492,188,426,182,211,33,565,400,165,40,40,217,146,71
"2021","Bradford 056","E02002238",2592,847,371,476,1591,117,664,191,350,123,282,130,124,28,500,345,155,28,28,154,86,68
"2021","Bradford 057","E02002239",4340,1307,479,828,2765,208,1317,448,634,235,577,242,282,53,631,463,168,32,32,268,159,109
"2021","Bradford 058","E02002240",4982,1466,557,909,3319,412,1661,635,705,321,683,337,310,36,546,371,175,17,17,197,96,101
"2021","Bradford 059","E02002241",5082,1593,619,974,3228,283,1339,485,603,251,692,289,343,60,869,647,222,45,45,261,138,123
"2021","Bradford 060","E02002242",3511,1121,491,630,2233,397,983,414,378,191,436,201,189,46,400,245,155,17,17,157,81,76
"2021","Bradford 061","E02002243",4180,1343,570,773,2646,350,1088,435,435,218,569,248,281,40,615,390,225,24,24,191,101,90
"2021","Bradford 062","E02006945",3813,1065,468,597,2646,518,1353,583,546,224,488,268,180,40,278,167,111,9,9,102,32,70
"2021","Bradford 063","E02006946",2456,910,381,529,1480,261,651,272,262,117,330,176,135,19,233,152,81,5,5,66,24,42
"2021","Bradford 064","E02006947",3378,1256,162,1094,1714,34,980,181,682,117,235,158,67,10,426,277,149,39,39,408,274,134
"2021","Bradford 065","E02006948",2683,1313,117,1196,1121,12,594,123,421,50,205,165,40,0,242,167,75,68,68,249,140,109
"2021","Calderdale 001","E02002244",2640,772,382,390,1781,318,821,305,323,193,322,146,147,29,315,194,121,5,5,87,34,53
"2021","Calderdale 002","E02002245",2256,691,234,457,1463,122,500,203,195,102,336,121,180,35,487,368,119,18,18,102,49,53
"2021","Calderdale 003","E02002246",4277,1282,651,631,2879,574,1427,567,578,282,521,245,231,45,349,216,133,8,8,116,51,65
"2021","Calderdale 004","E02002247",4281,1572,658,914,2521,363,1176,553,459,164,611,365,214,32,353,235,118,18,18,188,77,111
"2021","Calderdale 005","E02002248",3343,1075,443,632,2089,210,800,307,314,179,474,192,235,47,578,408,170,27,27,179,92,87
"2021","Calderdale 006","E02002249",2403,772,243,529,1540,122,519,202,211,106,346,143,176,27,533,413,120,20,20,91,43,48
"2021","Calderdale 007","E02002250",3866,1355,598,757,2379,405,1123,506,404,213,452,244,187,21,393,257,136,6,6,132,63,69
"2021","Calderdale 008","E02002251",4262,2182,599,1583,1914,203,763,328,321,114,457,263,164,30,471,319,152,20,20,166,66,100
"2021","Calderdale 009","E02002252",2811,754,363,391,1944,324,953,386,416,151,352,173,160,19,302,205,97,13,13,113,70,43
"2021","Calderdale 010","E02002253",3002,845,292,553,1913,123,956,224,609,123,280,112,149,19,521,398,123,33,33,244,157,87
"2021","Calderdale 011","E02002254",2710,779,372,407,1847,338,891,328,404,159,337,174,141,22,280,191,89,1,1,84,38,46
"2021","Calderdale 012","E02002255",2402,772,215,557,1235,51,750,116,509,125,106,49,51,6,304,204,100,24,24,395,280,115
"2021","Calderdale 013","E02002256",4237,1519,586,933,2513,325,1012,395,439,178,608,318,242,48,538,395,143,30,30,205,83,122
"2021","Calderdale 014","E02002257",2143,612,158,454,1288,57,737,142,490,105,152,77,66,9,322,246,76,20,20,243,164,79
"2021","Calderdale 015","E02002258",4049,1383,575,808,2554,394,1209,473,529,207,539,301,205,33,401,264,137,11,11,112,54,58
"2021","Calderdale 016","E02002259",3123,1116,455,661,1847,278,845,305,404,136,380,231,135,14,332,219,113,12,12,160,82,78
"2021","Calderdale 017","E02002260",4348,1663,591,1072,2505,346,1032,428,403,201,593,338,218,37,512,343,169,22,22,180,62,118
"2021","Calderdale 018","E02002261",3648,1275,509,766,2221,301,951,414,373,164,524,287,201,36,429,291,138,16,16,152,68,84
"2021","Calderdale 019","E02002262",3709,1427,594,833,2175,391,941,400,372,169,424,228,161,35,411,279,132,8,8,107,55,52
"2021","Calderdale 020","E02002263",2806,822,369,453,1872,241,859,350,353,156,400,206,166,28,364,241,123,8,8,112,57,55
"2021","Calderdale 021","E02002264",3084,1026,532,494,1942,352,1012,331,498,183,302,152,127,23,268,197,71,8,8,116,66,50
"2021","Calderdale 022","E02002265",2606,925,420,505,1566,243,680,287,273,120,334,182,130,22,295,204,91,14,14,115,43,72
"2021","Calderdale 023","E02002266",2565,828,382,446,1655,332,777,278,342,157,299,158,122,19,235,163,72,12,12,82,47,35
"2021","Calderdale 024","E02002267",3526,1114,525,589,2285,371,1058,395,465,198,440,218,189,33,404,266,138,12,12,127,62,65
"2021","Calderdale 025","E02002268",4666,1633,656,977,2859,403,1201,480,496,225,597,306,258,33,639,452,187,19,19,174,80,94
"2021","Calderdale 026","E02002269",4118,1207,485,722,2793,415,1361,530,581,250,563,315,225,23,441,313,128,13,13,118,46,72
"2021","Calderdale 027","E02002270",3580,906,400,506,2554,413,1394,531,642,221,448,261,161,26,291,199,92,8,8,120,44,76
"2021","Kirklees 001","E02002271",3203,883,461,422,2220,353,1093,380,522,191,461,237,204,20,310,205,105,3,3,100,49,51
"2021","Kirklees 002","E02002272",4242,1342,512,830,2748,393,1211,490,512,209,600,282,277,41,517,371,146,27,27,152,68,84
"2021","Kirklees 003","E02002273",2884,816,372,444,1970,308,935,353,411,171,432,236,158,38,286,191,95,9,9,98,43,55
"2021","Kirklees 004","E02002274",2900,795,393,402,2002,332,975,360,441,174,369,186,149,34,308,193,115,18,18,103,54,49
"2021","Kirklees 005","E02002275",4053,1572,636,936,2340,342,957,353,410,194,558,278,246,34,458,335,123,25,25,141,79,62
"2021","Kirklees 006","E02002276",3127,836,358,478,2144,295,1005,343,486,176,423,190,201,32,403,277,126,18,18,147,72,75
"2021","Kirklees 007","E02002277",2548,669,253,416,1714,211,939,265,519,155,287,145,114,28,267,175,92,10,10,165,92,73
"2021","Kirklees 008","E02002278",2794,771,352,419,1922,293,835,293,369,173,404,181,204,19,371,260,111,19,19,101,55,46
"2021","Kirklees 009","E02002279",2819,1002,385,617,1714,216,712,300,295,117,360,157,179,24,407,285,122,19,19,103,55,48
"2021","Kirklees 010","E02002280",2636,959,310,649,1476,92,815,165,500,150,202,125,65,12,341,232,109,26,26,201,119,82
"2021","Kirklees 011","E02002281",4429,1352,536,816,2750,340,1445,418,770,257,461,218,202,41,484,311,173,20,20,327,200,127
"2021","Kirklees 012","E02002282",2557,681,225,456,1666,121,1014,236,615,163,219,100,106,13,289,184,105,23,23,210,140,70
"2021","Kirklees 013","E02002283",2340,582,213,369,1516,127,967,190,538,239,156,71,73,12,241,117,124,25,25,242,157,85
"2021","Kirklees 014","E02002284",2701,833,378,455,1765,253,876,313,383,180,328,151,150,27,294,199,95,14,14,103,49,54
"2021","Kirklees 015","E02002285",3374,959,483,476,2278,396,1120,394,508,218,463,216,209,38,294,192,102,5,5,137,60,77
"2021","Kirklees 016","E02002286",2397,742,277,465,1508,123,794,216,450,128,218,91,113,14,351,254,97,22,22,147,85,62
"2021","Kirklees 017","E02002287",2758,1066,276,790,1463,107,823,174,507,142,251,140,100,11,258,164,94,24,24,229,139,90
"2021","Kirklees 018","E02002288",4101,1177,454,723,2731,255,1218,421,585,212,645,285,307,53,589,398,191,24,24,193,108,85
"2021","Kirklees 019","E02002289",2145,454,138,316,1437,70,849,160,572,117,181,67,91,23,320,226,94,17,17,254,178,76
"2021","Kirklees 020","E02002290",2751,770,450,320,1889,411,913,350,392,171,311,158,129,24,249,158,91,5,5,92,36,56
"2021","Kirklees 021","E02002291",2765,779,406,373,1907,331,925,328,414,183,340,149,172,19,298,186,112,13,13,79,37,42
"2021","Kirklees 022","E02002292",2362,678,304,374,1565,281,782,286,329,167,225,112,92,21,261,155,106,16,16,119,63,56
"2021","Kirklees 023","E02002293",2643,641,156,485,1664,73,1013,166,723,124,180,77,93,10,365,254,111,33,33,338,261,77
"2021","Kirklees 024","E02002294",3178,640,273,367,2065,155,1375,270,856,249,155,78,67,10,354,203,151,26,26,473,339,134
"2021","Kirklees 025","E02002295",3008,1013,325,688,1847,134,689,191,393,105,341,136,172,33,653,465,188,30,30,148,95,53
"2021","Kirklees 026","E02002296",3249,1175,573,602,1980,392,902,341,392,169,380,216,141,23,294,190,104,12,12,94,47,47
"2021","Kirklees 027","E02002297",2824,796,334,462,1847,315,1001,362,462,177,273,152,107,14,238,150,88,20,20,181,117,64
"2021","Kirklees 028","E02002298",2855,835,386,449,1897,307,829,368,306,155,383,165,165,53,366,239,127,12,12,123,67,56
"2021","Kirklees 029","E02002299",2953,1145,241,904,1576,69,599,133,371,95,286,156,113,17,589,419,170,33,33,232,83,149
"2021","Kirklees 030","E02002300",3688,1086,555,531,2491,403,1275,441,655,179,464,243,210,11,334,230,104,15,15,111,50,61
"2021","Kirklees 031","E02002301",2863,899,214,685,1622,68,910,177,591,142,226,115,102,9,384,240,144,34,34,342,199,143
"2021","Kirklees 032","E02002302",2610,711,345,366,1794,328,900,348,396,156,316,162,131,23,246,158,88,4,4,105,58,47
"2021","Kirklees 033","E02002303",2913,1042,396,646,1761,217,864,309,433,122,313,176,126,11,350,221,129,17,17,110,56,54
"2021","Kirklees 034","E02002304",3050,1420,322,1098,1390,152,634,227,304,103,329,231,86,12,243,153,90,32,32,240,75,165
"2021","Kirklees 035","E02002305",2665,953,328,625,1531,132,611,194,289,128,298,135,144,19,471,310,161,19,19,181,70,111
"2021","Kirklees 036","E02002306",2750,829,404,425,1833,307,959,410,359,190,325,176,124,25,231,140,91,11,11,88,44,44
"2021","Kirklees 037","E02002307",2632,921,411,510,1595,242,678,258,284,136,319,145,137,37,340,234,106,16,16,116,63,53
"2021","Kirklees 038","E02002308",3060,1015,334,681,1944,245,842,327,367,148,466,264,175,27,379,257,122,12,12,101,52,49
"2021","Kirklees 039","E02002309",2762,1087,293,794,1404,131,687,186,394,107,274,161,107,6,285,198,87,27,27,271,120,151
"2021","Kirklees 040","E02002310",2629,972,370,602,1522,185,592,243,231,118,342,171,158,13,386,268,118,17,17,135,52,83
"2021","Kirklees 041","E02002311",2923,993,365,628,1848,231,793,323,321,149,433,221,188,24,381,263,118,10,10,82,31,51
"2021","Kirklees 042","E02002312",2939,1119,281,838,1519,116,584,209,287,88,370,217,128,25,398,267,131,51,51,301,66,235
"2021","Kirklees 043","E02002313",2496,736,173,563,1395,56,781,121,539,121,186,104,70,12,333,243,90,39,39,365,241,124
"2021","Kirklees 044","E02002314",2584,813,459,354,1668,334,722,285,287,150,293,136,132,25,310,197,113,9,9,103,48,55
"2021","Kirklees 045","E02002315",3071,1158,325,833,1774,164,751,306,317,128,455,223,196,36,383,253,130,21,21,139,61,78
"2021","Kirklees 046","E02002316",2917,760,410,350,2056,402,971,381,408,182,410,229,141,40,263,161,102,10,10,101,41,60
"2021","Kirklees 047","E02002317",2959,985,403,582,1786,175,863,268,453,142,303,131,156,16,421,295,126,24,24,188,109,79
"2021","Kirklees 048","E02002318",2876,1113,425,688,1621,256,642,284,248,110,325,176,127,22,386,269,117,12,12,142,55,87
"2021","Kirklees 049","E02002319",3083,973,365,608,1993,263,911,344,419,148,469,260,182,27,341,235,106,9,9,117,50,67
"2021","Kirklees 050","E02002320",2944,1148,496,652,1709,372,766,328,293,145,325,182,132,11,242,160,82,4,4,87,36,51
"2021","Kirklees 051","E02002321",2671,766,393,373,1842,379,986,376,430,180,260,135,111,14,215,130,85,2,2,63,35,28
"2021","Kirklees 052","E02002322",2808,783,387,396,1935,330,932,402,377,153,387,210,152,25,276,163,113,10,10,90,35,55
"2021","Kirklees 053","E02002323",3640,1091,630,461,2437,477,1235,465,532,238,382,202,158,22,332,201,131,11,11,112,53,59
"2021","Kirklees 054","E02002324",2918,880,466,414,1956,404,975,372,403,200,326,165,137,24,250,156,94,1,1,82,34,48
"2021","Kirklees 055","E02002325",3883,1086,555,531,2685,478,1288,500,566,222,531,279,221,31,376,252,124,12,12,112,48,64
"2021","Kirklees 056","E02002326",2473,556,305,251,1841,344,1019,353,489,177,281,147,122,12,190,123,67,7,7,76,32,44
"2021","Kirklees 057","E02002327",4251,1083,562,521,3039,584,1611,622,718,271,481,250,194,37,356,219,137,7,7,129,57,72
"2021","Kirklees 058","E02002328",3068,851,403,448,2129,434,1105,449,485,171,334,184,130,20,245,152,93,11,11,88,40,48
"2021","Kirklees 059","E02002329",5266,1380,637,743,3715,641,1852,744,787,321,698,370,289,39,510,309,201,14,14,171,72,99
"2021","Leeds 001","E02002330",3032,723,458,265,2220,619,1155,460,517,178,231,131,85,15,202,107,95,13,13,89,32,57
"2021","Leeds 002","E02002331",3076,1109,642,467,1860,436,808,305,373,130,350,205,129,16,251,145,106,15,15,107,30,77
"2021","Leeds 003","E02002332",2880,871,470,401,1939,383,926,319,440,167,322,156,144,22,295,181,114,13,13,70,30,40
"2021","Leeds 004","E02002333",3726,1372,720,652,2246,426,1064,443,451,170,457,264,170,23,286,167,119,13,13,108,42,66
"2021","Leeds 005","E02002334",3337,996,600,396,2248,519,1180,393,611,176,310,185,112,13,237,149,88,2,2,93,40,53
"2021","Leeds 006","E02002335",3143,717,426,291,2317,577,1339,478,647,214,239,138,84,17,157,95,62,5,5,109,45,64
"2021","Leeds 007","E02002336",2896,746,473,273,2044,431,1197,387,639,171,257,148,95,14,153,91,62,6,6,106,46,60
"2021","Leeds 008","E02002337",3240,784,362,422,2346,434,1307,450,655,202,400,232,152,16,196,131,65,9,9,110,34,76
"2021","Leeds 009","E02002338",3092,881,489,392,2105,363,1056,319,586,151,403,229,158,16,274,185,89,9,9,106,42,64
"2021","Leeds 010","E02002339",2632,951,412,539,1566,203,633,250,271,112,376,205,152,19,343,244,99,11,11,115,35,80
"2021","Leeds 011","E02002340",2742,924,510,414,1708,323,792,336,313,143,361,212,129,20,225,135,90,7,7,110,44,66
"2021","Leeds 012","E02002341",2988,723,456,267,2129,489,1244,345,685,214,213,109,85,19,173,98,75,10,10,136,60,76
"2021","Leeds 013","E02002342",2729,870,446,424,1754,331,897,330,420,147,296,175,106,15,221,130,91,9,9,105,48,57
"2021","Leeds 014","E02002343",2524,659,330,329,1797,253,984,326,497,161,342,208,123,11,212,122,90,6,6,68,29,39
"2021","Leeds 015","E02002344",3456,1203,616,587,2116,366,1251,361,672,218,224,145,71,8,260,146,114,15,15,137,75,62
"2021","Leeds 016","E02002345",2521,647,319,328,1766,356,1021,325,521,175,201,117,69,15,155,93,62,33,33,108,39,69
"2021","Leeds 017","E02002346",2790,990,386,604,1709,198,796,265,402,129,351,209,131,11,346,225,121,18,18,91,40,51
"2021","Leeds 018","E02002347",2756,940,361,579,1682,146,797,222,467,108,202,89,98,15,518,342,176,19,19,134,70,64
"2021","Leeds 019","E02002348",2864,988,446,542,1759,239,873,253,477,143,319,205,98,16,311,193,118,17,17,117,40,77
"2021","Leeds 020","E02002349",2599,873,370,503,1586,252,819,255,463,101,308,226,76,6,194,123,71,13,13,140,46,94
"2021","Leeds 021","E02002350",2536,649,437,212,1798,397,991,276,562,153,257,150,101,6,145,92,53,8,8,89,33,56
"2021","Leeds 022","E02002351",2352,559,322,237,1721,395,941,318,459,164,243,129,100,14,137,71,66,5,5,72,34,38
"2021","Leeds 023","E02002352",3216,991,484,507,2006,263,1129,307,628,194,375,259,105,11,219,112,107,20,20,219,106,113
"2021","Leeds 024","E02002353",2317,566,244,322,1616,184,948,228,552,168,266,139,111,16,211,123,88,7,7,135,65,70
"2021","Leeds 025","E02002354",3323,1058,491,567,2046,247,1110,293,643,174,380,210,151,19,291,149,142,18,18,219,121,98
"2021","Leeds 027","E02002356",3817,964,446,518,2733,391,1471,406,886,179,572,362,197,13,286,192,94,13,13,120,46,74
"2021","Leeds 028","E02002357",3747,1247,518,729,2325,287,1004,312,541,151,609,401,181,27,406,271,135,19,19,175,64,111
"2021","Leeds 029","E02002358",3639,1093,502,591,2372,328,1086,346,528,212,497,235,232,30,441,291,150,20,20,174,78,96
"2021","Leeds 030","E02002359",2875,815,470,345,1986,443,1023,374,486,163,319,195,104,20,197,114,83,4,4,74,36,38
"2021","Leeds 031","E02002360",3067,960,355,605,1930,181,860,290,467,103,538,391,132,15,329,201,128,22,22,177,48,129
"2021","Leeds 032","E02002361",2472,784,257,527,1550,144,822,214,487,121,307,171,126,10,259,170,89,18,18,138,60,78
"2021","Leeds 033","E02002362",3595,1327,431,896,2059,157,824,293,398,133,472,281,164,27,564,356,208,42,42,209,86,123
"2021","Leeds 034","E02002363",3401,1238,389,849,1863,180,796,303,360,133,648,516,122,10,210,116,94,29,29,300,39,261
"2021","Leeds 035","E02002364",2786,1198,392,806,1454,108,481,167,197,117,326,161,137,28,521,378,143,18,18,134,70,64
"2021","Leeds 037","E02002366",2960,783,397,386,1879,255,1019,211,601,207,249,146,89,14,336,190,146,20,20,298,184,114
"2021","Leeds 038","E02002367",2689,949,276,673,1538,77,573,164,314,95,329,164,131,34,536,328,208,23,23,202,97,105
"2021","Leeds 039","E02002368",3717,1049,468,581,2558,372,1314,418,692,204,566,364,184,18,291,182,109,15,15,110,50,60
"2021","Leeds 040","E02002369",3229,1054,371,683,1962,136,774,230,409,135,440,184,209,47,577,387,190,35,35,213,120,93
"2021","Leeds 041","E02002370",3083,976,398,578,1945,154,663,223,307,133,475,170,265,40,633,452,181,20,20,162,72,90
"2021","Leeds 042","E02002371",4382,1838,388,1450,2053,100,834,195,492,147,404,270,115,19,652,356,296,63,63,491,226,265
"2021","Leeds 044","E02002373",2932,842,148,694,661,51,235,86,106,43,253,210,39,4,69,31,38,53,53,1429,38,1391
"2021","Leeds 045","E02002374",3130,1144,340,804,1615,155,594,221,285,88,539,421,102,16,295,202,93,32,32,371,57,314
"2021","Leeds 046","E02002375",2619,855,247,608,1611,108,564,206,268,90,421,216,177,28,496,376,120,22,22,153,74,79
"2021","Leeds 047","E02002376",2592,702,176,526,1627,63,831,153,549,129,228,89,117,22,480,315,165,25,25,263,187,76
"2021","Leeds 048","E02002377",2433,793,163,630,1299,33,711,90,527,94,140,70,57,13,351,209,142,64,64,341,215,126
"2021","Leeds 050","E02002379",2357,675,222,453,1519,92,533,180,257,96,350,137,191,22,526,388,138,18,18,163,90,73
"2021","Leeds 051","E02002380",2524,840,380,460,1581,214,693,273,270,150,378,223,132,23,284,191,93,12,12,103,38,65
"2021","Leeds 052","E02002381",3018,1068,321,747,1822,184,703,307,282,114,537,365,148,24,386,268,118,12,12,128,50,78
"2021","Leeds 053","E02002382",2402,672,121,551,1434,17,665,127,473,65,224,109,108,7,461,359,102,67,67,296,165,131
"2021","Leeds 054","E02002383",2512,521,59,462,507,12,156,40,91,25,171,145,22,4,112,72,40,56,56,1484,64,1420
"2021","Leeds 055","E02002384",4514,1974,342,1632,1898,52,785,182,549,54,365,282,70,13,602,425,177,94,94,642,131,511
"2021","Leeds 056","E02002385",3702,1327,213,1114,1236,55,367,134,190,43,519,450,63,6,228,142,86,67,67,1139,60,1079
"2021","Leeds 057","E02002386",4251,1395,726,669,2690,557,1280,520,503,257,509,290,182,37,333,199,134,11,11,166,72,94
"2021","Leeds 058","E02002387",2716,1033,344,689,1512,113,536,189,236,111,413,229,152,32,428,306,122,22,22,171,56,115
"2021","Leeds 059","E02002388",3486,1120,286,834,2148,151,798,276,382,140,562,297,242,23,592,450,142,45,45,218,73,145
"2021","Leeds 060","E02002389",2986,959,339,620,1841,138,747,207,438,102,330,158,138,34,584,402,182,42,42,186,119,67
"2021","Leeds 061","E02002390",3075,967,345,622,1937,179,811,297,338,176,483,266,186,31,440,281,159,24,24,171,85,86
"2021","Leeds 062","E02002391",3627,1228,444,784,2283,251,1086,406,533,147,592,356,208,28,326,208,118,28,28,116,35,81
"2021","Leeds 063","E02002392",2772,1317,90,1227,763,14,255,109,125,21,262,244,15,3,157,100,57,75,75,692,34,658
"2021","Leeds 064","E02002393",4013,1756,268,1488,1950,50,864,220,563,81,301,181,102,18,627,450,177,108,108,307,110,197
"2021","Leeds 065","E02002394",3229,1255,297,958,1733,69,645,148,419,78,301,140,140,21,655,497,158,63,63,241,97,144
"2021","Leeds 066","E02002395",2768,723,313,410,1826,214,981,263,521,197,323,206,105,12,291,168,123,17,17,219,144,75
"2021","Leeds 067","E02002396",4091,1461,400,1061,2342,255,982,380,403,199,626,373,223,30,435,294,141,44,44,288,69,219
"2021","Leeds 068","E02002397",3423,1124,441,683,2125,270,940,371,380,189,480,262,187,31,411,282,129,24,24,174,78,96
"2021","Leeds 069","E02002398",3309,967,521,446,2199,448,1093,413,451,229,399,225,147,27,244,138,106,15,15,143,58,85
"2021","Leeds 070","E02002399",2636,722,247,475,1747,133,643,221,285,137,353,151,177,25,592,425,167,26,26,167,76,91
"2021","Leeds 071","E02002400",4255,1784,341,1443,2110,72,726,237,411,78,550,296,212,42,658,485,173,104,104,361,117,244
"2021","Leeds 072","E02002401",2622,775,283,492,1676,117,568,161,292,115,317,101,188,28,651,478,173,23,23,171,97,74
"2021","Leeds 073","E02002402",2502,641,295,346,1787,316,934,375,354,205,339,196,123,20,189,99,90,9,9,74,27,47
"2021","Leeds 074","E02002403",2791,911,496,415,1742,329,782,271,357,154,334,209,108,17,280,161,119,17,17,138,56,82
"2021","Leeds 075","E02002404",5254,2233,357,1876,2496,105,787,274,425,88,855,684,151,20,673,538,135,76,76,525,96,429
"2021","Leeds 076","E02002405",3793,1102,536,566,2546,363,1284,391,665,228,503,235,224,44,380,257,123,16,16,145,68,77
"2021","Leeds 077","E02002406",3017,661,416,245,2256,481,1183,396,548,239,366,191,149,26,224,131,93,2,2,100,39,61
"2021","Leeds 078","E02002407",2862,1084,278,806,1614,91,488,152,233,103,409,187,194,28,602,451,151,24,24,164,73,91
"2021","Leeds 079","E02002408",3424,1196,500,696,2105,271,955,337,454,164,527,300,194,33,343,223,120,9,9,123,51,72
"2021","Leeds 080","E02002409",2691,898,347,551,1660,199,687,279,277,131,394,194,182,18,363,241,122,17,17,133,65,68
"2021","Leeds 081","E02002410",3158,1158,389,769,1844,219,796,318,331,147,462,248,183,31,343,222,121,24,24,156,76,80
"2021","Leeds 082","E02002411",4308,1876,275,1601,1983,61,714,255,383,76,645,490,141,14,484,376,108,79,79,449,116,333
"2021","Leeds 083","E02002412",3248,1045,388,657,2062,226,934,359,422,153,529,299,196,34,353,234,119,20,20,141,42,99
"2021","Leeds 085","E02002414",2815,1162,258,904,1413,76,616,174,379,63,248,136,96,16,434,309,125,39,39,240,106,134
"2021","Leeds 086","E02002415",2715,929,116,813,1424,20,642,100,470,72,212,89,115,8,493,395,98,57,57,362,209,153
"2021","Leeds 087","E02002416",3018,861,521,340,2056,417,941,358,391,192,390,195,173,22,300,180,120,8,8,101,44,57
"2021","Leeds 088","E02002417",3145,849,394,455,2175,377,959,355,426,178,512,269,213,30,311,217,94,16,16,121,55,66
"2021","Leeds 089","E02002418",3071,835,388,447,2115,340,1038,409,427,202,416,216,176,24,315,207,108,6,6,121,42,79
"2021","Leeds 090","E02002419",3589,1298,449,849,2056,169,862,306,417,139,399,177,180,42,587,400,187,39,39,235,114,121
"2021","Leeds 091","E02002420",3320,1011,345,666,2038,207,961,301,502,158,370,166,178,26,464,303,161,36,36,271,137,134
"2021","Leeds 092","E02002421",2647,872,318,554,1606,81,561,183,261,117,323,131,163,29,614,431,183,27,27,169,82,87
"2021","Leeds 093","E02002422",2817,755,343,412,1950,323,988,386,408,194,403,258,130,15,225,150,75,11,11,112,39,73
"2021","Leeds 094","E02002423",2464,769,315,454,1562,140,614,238,234,142,338,133,180,25,455,322,133,15,15,133,74,59
"2021","Leeds 095","E02002424",3290,971,403,568,2187,287,1031,365,473,193,525,282,213,30,328,216,112,16,16,132,58,74
"2021","Leeds 096","E02002425",3844,1173,542,631,2548,458,1170,459,503,208,527,289,212,26,377,224,153,16,16,123,57,66
"2021","Leeds 097","E02002426",3338,964,463,501,2244,381,1116,390,520,206,435,232,173,30,296,188,108,16,16,130,60,70
"2021","Leeds 098","E02002427",3036,959,499,460,1980,321,861,329,385,147,403,204,168,31,382,232,150,13,13,97,45,52
"2021","Leeds 099","E02002428",3419,1039,330,709,2195,223,1045,383,496,166,486,235,221,30,421,291,130,20,20,185,86,99
"2021","Leeds 100","E02002429",3655,1008,476,532,2525,360,1224,446,573,205,548,306,210,32,375,240,135,18,18,122,57,65
"2021","Leeds 101","E02002430",3240,894,318,576,2119,110,726,215,365,146,415,141,242,32,833,620,213,35,35,227,126,101
"2021","Leeds 102","E02002431",3988,1275,341,934,2557,219,1095,406,523,166,742,480,223,39,476,332,144,25,25,156,56,100
"2021","Leeds 103","E02002432",3172,846,399,447,2208,322,1065,382,493,190,477,237,214,26,332,223,109,12,12,118,61,57
"2021","Leeds 104","E02002433",3533,1581,540,1041,1802,221,718,316,278,124,518,333,173,12,327,218,109,18,18,150,37,113
"2021","Leeds 105","E02002434",4104,1032,332,700,2908,222,1519,485,818,216,687,363,292,32,457,339,118,23,23,164,80,84
"2021","Leeds 106","E02002435",3638,1089,456,633,2413,328,1156,414,559,183,544,299,217,28,372,240,132,13,13,136,59,77
"2021","Leeds 107","E02002436",2987,900,406,494,1964,260,856,324,365,167,462,235,186,41,372,242,130,14,14,123,63,60
"2021","Leeds 108","E02002437",2518,530,262,268,1886,288,1082,431,440,211,311,160,130,21,199,122,77,6,6,102,50,52
"2021","Leeds 109","E02006852",4937,1574,502,1072,2719,373,1325,431,727,167,717,556,144,17,263,153,110,41,41,644,83,561
"2021","Leeds 110","E02006861",4453,1682,246,1436,1185,51,406,174,195,37,509,449,49,11,155,94,61,64,64,1586,74,1512
"2021","Leeds 111","E02006875",3744,2153,40,2113,1139,4,287,203,77,7,724,713,11,0,33,19,14,91,91,452,6,446
"2021","Leeds 112","E02006876",3710,1505,243,1262,1830,95,628,266,284,78,697,570,109,18,370,262,108,40,40,375,65,310
"2021","Wakefield 001","E02002438",3664,955,430,525,2569,271,990,396,396,198,633,237,337,59,650,460,190,25,25,140,73,67
"2021","Wakefield 002","E02002439",4150,1569,523,1046,2404,250,930,408,352,170,665,393,232,40,528,337,191,31,31,177,56,121
"2021","Wakefield 003","E02002440",3268,830,420,410,2302,334,1056,422,402,232,488,200,247,41,403,249,154,21,21,136,67,69
"2021","Wakefield 004","E02002441",4357,1466,549,917,2722,306,1178,456,497,225,696,362,288,46,518,349,169,24,24,169,73,96
"2021","Wakefield 005","E02002442",3150,807,307,500,2189,279,1040,464,368,208,562,318,218,26,301,190,111,7,7,154,69,85
"2021","Wakefield 006","E02002443",2559,657,282,375,1801,239,950,335,426,189,341,188,127,26,261,153,108,10,10,101,43,58
"2021","Wakefield 007","E02002444",3043,881,334,547,2043,270,976,364,441,171,500,275,202,23,284,176,108,13,13,119,50,69
"2021","Wakefield 008","E02002445",3674,1109,559,550,2434,347,1191,436,533,222,498,271,196,31,381,231,150,17,17,131,67,64
"2021","Wakefield 009","E02002446",2651,762,405,357,1815,344,898,360,336,202,357,189,138,30,203,119,84,13,13,74,31,43
"2021","Wakefield 010","E02002447",2734,923,401,522,1688,213,763,342,279,142,348,151,175,22,342,209,133,22,22,123,59,64
"2021","Wakefield 011","E02002448",3602,1183,462,721,2257,279,871,377,315,179,593,279,282,32,494,341,153,20,20,162,68,94
"2021","Wakefield 012","E02002449",4072,900,355,545,3074,377,1470,611,626,233,787,421,323,43,423,282,141,17,17,98,55,43
"2021","Wakefield 013","E02002450",3340,886,358,528,2309,285,1100,422,476,202,580,307,233,40,330,217,113,14,14,145,71,74
"2021","Wakefield 014","E02002451",3461,956,513,443,2399,442,1208,446,514,248,431,219,180,32,305,196,109,13,13,106,41,65
"2021","Wakefield 015","E02002452",4290,1618,525,1093,2488,268,1054,388,475,191,670,379,247,44,469,316,153,27,27,184,71,113
"2021","Wakefield 016","E02002453",4298,1416,563,853,2641,298,1104,458,423,223,618,284,290,44,583,403,180,38,38,241,92,149
"2021","Wakefield 017","E02002454",4005,1704,407,1297,1931,163,954,289,516,149,443,323,111,9,302,179,123,69,69,370,175,195
"2021","Wakefield 018","E02002455",2707,797,378,419,1804,206,747,263,295,189,397,152,209,36,440,314,126,14,14,106,53,53
"2021","Wakefield 019","E02002456",3202,1099,294,805,1869,200,844,327,403,114,471,269,173,29,318,208,110,36,36,234,97,137
"2021","Wakefield 020","E02002457",3263,1108,401,707,1963,220,923,307,462,154,371,164,168,39,424,267,157,25,25,192,105,87
"2021","Wakefield 021","E02002458",3985,1177,568,609,2685,448,1243,485,532,226,554,269,247,38,427,280,147,13,13,123,56,67
"2021","Wakefield 022","E02002459",4144,1230,436,794,2687,283,1279,448,616,215,594,272,273,49,505,332,173,26,26,227,103,124
"2021","Wakefield 023","E02002460",3329,975,575,400,2259,484,1129,457,452,220,352,177,142,33,284,170,114,10,10,95,52,43
"2021","Wakefield 024","E02002461",4992,1316,517,799,3477,425,1602,632,704,266,834,418,366,50,590,404,186,26,26,199,99,100
"2021","Wakefield 025","E02002462",3461,1260,599,661,2101,365,1002,384,448,170,380,194,165,21,341,228,113,13,13,100,43,57
"2021","Wakefield 026","E02002463",4069,1147,469,678,2708,233,1132,340,596,196,601,229,320,52,716,471,245,26,26,214,135,79
"2021","Wakefield 027","E02002464",4000,1256,539,717,2573,311,1064,422,422,220,669,328,305,36,503,326,177,26,26,171,92,79
"2021","Wakefield 028","E02002465",2905,1045,494,551,1716,350,809,343,308,158,350,218,105,27,194,104,90,13,13,144,64,80
"2021","Wakefield 029","E02002466",4114,1311,700,611,2678,488,1209,474,528,207,517,245,242,30,455,274,181,9,9,125,45,80
"2021","Wakefield 030","E02002467",3826,1323,324,999,2178,165,879,294,437,148,616,334,237,45,451,287,164,67,67,325,156,169
"2021","Wakefield 031","E02002468",2742,832,389,443,1854,311,905,358,366,181,353,184,150,19,280,175,105,5,5,56,25,31
"2021","Wakefield 032","E02002469",2746,683,360,323,1965,343,999,372,425,202,329,160,140,29,287,169,118,7,7,98,49,49
"2021","Wakefield 033","E02002470",2669,700,456,244,1907,558,1026,414,431,181,195,101,80,14,123,62,61,5,5,62,31,31
"2021","Wakefield 034","E02002471",5002,1330,686,644,3480,674,1798,755,745,298,640,360,249,31,358,226,132,10,10,192,95,97
"2021","Wakefield 035","E02002472",2488,702,387,315,1706,325,862,378,313,171,301,163,111,27,213,132,81,5,5,80,34,46
"2021","Wakefield 036","E02002473",2997,857,413,444,2045,392,1010,448,384,178,404,219,159,26,233,140,93,6,6,95,37,58
"2021","Wakefield 037","E02002474",2997,847,390,457,2041,222,905,341,397,167,440,208,203,29,453,306,147,21,21,109,60,49
"2021","Wakefield 038","E02002475",2730,690,392,298,1954,468,993,424,424,145,296,172,111,13,195,121,74,2,2,86,37,49
"2021","Wakefield 039","E02002476",2736,758,327,431,1852,171,756,300,296,160,483,194,253,36,426,275,151,16,16,126,61,65
"2021","Wakefield 040","E02002477",2739,833,377,456,1792,268,812,341,302,169,382,172,172,38,322,220,102,8,8,114,57,57
"2021","Wakefield 041","E02002478",2633,685,287,398,1832,218,866,344,349,173,437,229,176,32,305,219,86,6,6,116,51,65
"2021","Wakefield 042","E02002479",3713,1217,572,645,2363,422,1020,446,361,213,453,203,214,36,447,254,193,21,21,133,61,72
"2021","Wakefield 043","E02002480",2636,966,427,539,1559,261,648,289,213,146,303,139,140,24,320,203,117,27,27,111,44,67
"2021","Wakefield 044","E02002481",3052,855,375,480,2040,220,959,372,368,219,439,174,232,33,397,262,135,25,25,157,80,77
"2021","Wakefield 045","E02002482",2876,801,362,439,1929,205,873,319,375,179,423,144,252,27,414,281,133,14,14,146,68,78
"2021","Derby 001","E02002796",2601,662,420,242,1879,443,1004,302,506,196,228,126,91,11,196,105,91,8,8,60,26,34
"2021","Derby 002","E02002797",3328,1056,701,355,2188,603,1129,373,517,239,265,140,110,15,183,86,97,8,8,84,30,54
"2021","Derby 003","E02002798",4470,1187,420,767,3097,414,1634,671,661,302,705,459,221,25,323,195,128,21,21,186,71,115
"2021","Derby 004","E02002799",2567,703,291,412,1735,154,701,244,318,139,454,231,187,36,407,275,132,19,19,129,49,80
"2021","Derby 005","E02002800",3174,1174,538,636,1830,332,937,302,508,127,330,206,108,16,215,138,77,16,16,170,41,129
"2021","Derby 006","E02002801",3175,923,478,445,2123,351,917,316,387,214,455,212,194,49,384,212,172,16,16,129,47,82
"2021","Derby 007","E02002802",3275,1044,364,680,2030,168,757,291,336,130,474,207,227,40,593,426,167,38,38,201,96,105
"2021","Derby 008","E02002803",3615,1805,433,1372,1476,137,459,203,194,62,528,421,94,13,308,201,107,44,44,334,41,293
"2021","Derby 009","E02002804",3761,1043,514,529,2504,263,1094,385,496,213,506,219,257,30,583,411,172,58,58,214,90,124
"2021","Derby 010","E02002805",2605,853,544,309,1683,428,797,301,344,152,272,153,99,20,180,104,76,6,6,69,31,38
"2021","Derby 011","E02002806",2823,1052,225,827,1265,73,391,156,168,67,429,286,124,19,320,202,118,52,52,506,44,462
"2021","Derby 012","E02002807",3737,1006,487,519,2543,386,1108,392,477,239,516,229,239,48,508,314,194,25,25,188,78,110
"2021","Derby 013","E02002808",5855,2750,389,2361,2433,90,820,338,388,94,819,573,218,28,588,402,186,116,116,672,123,549
"2021","Derby 014","E02002809",3013,935,445,490,1943,293,812,290,354,168,435,211,186,38,392,235,157,11,11,135,58,77
"2021","Derby 015","E02002810",3915,1012,549,463,2763,552,1390,523,619,248,462,254,196,12,346,214,132,13,13,140,58,82
"2021","Derby 016","E02002811",3631,1250,255,995,1796,51,1027,248,623,156,254,139,107,8,392,246,146,72,72,585,347,238
"2021","Derby 017","E02002812",3011,885,361,524,1834,268,950,350,432,168,265,169,77,19,324,189,135,27,27,292,136,156
"2021","Derby 018","E02002813",3953,1278,300,978,2134,63,1076,237,703,136,377,189,166,22,524,338,186,94,94,541,322,219
"2021","Derby 019","E02002814",3227,1033,612,421,2084,474,1131,438,460,233,250,133,97,20,219,112,107,10,10,110,52,58
"2021","Derby 020","E02002815",2508,554,149,405,1507,73,879,137,593,149,163,46,102,15,355,216,139,37,37,447,332,115
"2021","Derby 021","E02002816",3382,719,294,425,2412,321,1495,348,823,324,212,103,93,16,365,243,122,19,19,251,161,90
"2021","Derby 022","E02002817",2372,578,358,220,1597,315,881,251,401,229,187,91,82,14,207,107,100,7,7,197,108,89
"2021","Derby 023","E02002818",2898,865,329,536,1718,120,877,184,543,150,214,79,119,16,470,290,180,37,37,315,201,114
"2021","Derby 024","E02002819",3543,1391,447,944,1985,227,828,392,308,128,507,308,178,21,388,271,117,35,35,167,57,110
"2021","Derby 025","E02002820",4137,1299,507,792,2564,214,1112,372,538,202,602,273,295,34,592,385,207,44,44,274,106,168
"2021","Derby 026","E02002821",4536,1213,378,835,2958,153,1124,314,604,206,656,226,378,52,898,622,276,127,127,365,219,146
"2021","Derby 027","E02002822",2727,801,418,383,1723,233,826,243,397,186,274,136,117,21,373,219,154,17,17,203,118,85
"2021","Derby 028","E02002823",3272,1009,536,473,2100,367,872,301,364,207,408,172,203,33,437,263,174,16,16,163,71,92
"2021","Derby 029","E02002824",3987,1048,388,660,2622,272,1168,305,638,225,458,166,252,40,700,382,318,24,24,317,199,118
"2021","Derby 030","E02002825",3654,1169,568,601,2308,344,1194,348,648,198,403,219,160,24,338,218,120,29,29,177,78,99
"2021","Derby 031","E02002826",2908,759,322,437,2060,244,1093,365,533,195,363,167,166,30,354,229,125,6,6,89,49,40
"2021","Leicester 001","E02002827",2642,740,212,528,1702,147,828,243,418,167,305,132,151,22,400,262,138,22,22,200,126,74
"2021","Leicester 002","E02002828",3042,740,322,418,1962,286,1179,301,564,314,191,90,81,20,283,131,152,23,23,340,198,142
"2021","Leicester 003","E02002829",4350,1320,428,892,2611,129,1183,247,714,222,451,173,208,70,799,529,270,49,49,419,263,156
"2021","Leicester 004","E02002830",3934,1009,250,759,2553,167,1205,274,694,237,419,143,244,32,716,480,236,46,46,372,222,150
"2021","Leicester 005","E02002831",2389,482,236,246,1566,178,992,210,492,290,84,30,40,14,281,131,150,31,31,341,213,128
"2021","Leicester 006","E02002832",3314,811,407,404,1929,224,1202,263,598,341,114,60,41,13,354,142,212,35,35,574,402,172
"2021","Leicester 007","E02002833",2678,443,247,196,1698,140,1102,179,549,374,89,14,58,17,331,142,189,36,36,537,360,177
"2021","Leicester 008","E02002834",4701,1364,440,924,2808,324,1476,388,789,299,468,296,146,26,468,257,211,72,72,529,232,297
"2021","Leicester 010","E02002836",3286,667,397,270,1878,186,1210,196,593,421,82,27,42,13,375,117,258,25,25,741,527,214
"2021","Leicester 011","E02002837",2891,614,225,389,1799,76,1095,164,741,190,159,48,92,19,438,266,172,31,31,478,317,161
"2021","Leicester 012","E02002838",3090,889,354,535,1953,139,777,155,484,138,365,127,205,33,645,446,199,27,27,248,137,111
"2021","Leicester 013","E02002839",3035,795,382,413,1975,197,1142,260,610,272,234,81,125,28,377,222,155,25,25,265,176,89
"2021","Leicester 016","E02002842",3481,1098,194,904,1934,47,784,212,495,77,499,267,213,19,528,392,136,76,76,449,171,278
"2021","Leicester 017","E02002843",4031,636,302,334,2374,122,1734,254,1074,406,101,35,56,10,368,167,201,49,49,1021,751,270
"2021","Leicester 018","E02002844",3608,812,296,516,2245,103,1518,220,999,299,96,41,48,7,496,280,216,32,32,551,378,173
"2021","Leicester 019","E02002845",3864,1164,451,713,2292,170,1387,231,858,298,161,67,78,16,543,303,240,31,31,408,271,137
"2021","Leicester 020","E02002846",3049,828,323,505,1998,261,1045,344,495,206,399,205,164,30,268,155,113,25,25,223,107,116
"2021","Leicester 021","E02002847",2835,353,196,157,1919,159,1334,189,793,352,74,22,44,8,312,112,200,40,40,563,388,175
"2021","Leicester 022","E02002848",3276,732,221,511,1983,122,1305,173,860,272,128,59,59,10,372,209,163,56,56,561,337,224
"2021","Leicester 023","E02002849",5185,1918,373,1545,2286,109,917,288,537,92,686,482,169,35,447,306,141,127,127,981,158,823
"2021","Leicester 025","E02002851",2865,622,386,236,1869,318,1184,232,589,363,97,37,48,12,246,79,167,24,24,374,237,137
"2021","Leicester 026","E02002852",2604,713,315,398,1679,70,644,178,359,107,336,85,202,49,606,419,187,23,23,212,136,76
"2021","Leicester 027","E02002853",4048,928,293,635,2424,202,1674,257,1004,413,142,69,61,12,348,169,179,58,58,696,378,318
"2021","Leicester 028","E02002854",3144,923,350,573,1898,103,811,213,446,152,401,163,186,52,543,327,216,40,40,323,164,159
"2021","Leicester 029","E02002855",3016,806,179,627,1710,133,847,263,436,148,375,226,128,21,293,173,120,62,62,500,167,333
"2021","Leicester 030","E02002856",4953,1851,534,1317,2268,220,1072,397,528,147,646,517,111,18,268,149,119,62,62,834,89,745
"2021","Leicester 031","E02002857",3244,1119,206,913,1840,93,609,222,301,86,529,298,207,24,541,403,138,68,68,285,73,212
"2021","Leicester 032","E02002858",2951,817,395,422,1916,316,1125,334,608,183,269,164,89,16,191,109,82,15,15,218,79,139
"2021","Leicester 034","E02002860",3441,1048,450,598,2191,293,1015,355,464,196,475,236,209,30,384,244,140,24,24,202,98,104
"2021","Leicester 035","E02002861",2790,655,274,381,1884,95,735,156,422,157,357,102,195,60,669,412,257,28,28,251,158,93
"2021","Leicester 036","E02002862",3536,1179,512,667,2128,158,764,220,399,145,492,188,256,48,684,473,211,30,30,229,119,110
"2021","Leicester 037","E02006815",4128,1086,516,570,2676,233,1381,306,820,255,354,115,193,46,660,433,227,48,48,366,236,130
"2021","Leicester 038","E02006817",3205,901,294,607,1908,189,1017,267,546,204,307,159,126,22,359,215,144,36,36,396,142,254
"2021","Leicester 039","E02006819",3230,900,303,597,2054,142,808,183,484,141,421,132,255,34,643,436,207,40,40,276,158,118
"2021","Leicester 040","E02006850",2857,1251,169,1082,996,15,383,158,194,31,231,195,32,4,293,176,117,74,74,610,79,531
"2021","Leicester 041","E02006851",3679,1941,105,1836,1261,11,356,203,137,16,517,481,35,1,216,113,103,161,161,477,32,445
"2021","Leicester 042","E02006964",2212,404,71,333,1558,50,981,183,637,161,182,88,82,12,327,232,95,18,18,250,168,82
"2021","Leicester 043","E02006965",2803,611,259,352,1886,170,1149,224,643,282,145,53,76,16,370,217,153,52,52,306,199,107
"2021","Rutland 001","E02002863",2877,673,378,295,2104,450,1217,473,566,178,256,146,98,12,175,108,67,6,6,100,34,66
"2021","Rutland 002","E02002864",3554,964,463,501,2423,490,1219,455,596,168,418,255,144,19,284,186,98,12,12,167,68,99
"2021","Rutland 003","E02002865",3504,1178,664,514,2228,594,1054,418,444,192,315,195,104,16,259,162,97,6,6,98,33,65
"2021","Rutland 004","E02002866",3201,867,502,365,2216,551,1182,467,517,198,284,167,103,14,194,110,84,5,5,118,48,70
"2021","Rutland 005","E02002867",3566,1104,582,522,2354,569,1186,538,464,184,329,187,113,29,255,146,109,15,15,108,41,67
"2021","Nottingham 001","E02002868",2520,661,342,319,1700,355,734,269,269,196,265,109,132,24,331,202,129,15,15,159,61,98
"2021","Nottingham 002","E02002869",3287,1120,444,676,1983,147,708,302,269,137,435,192,205,38,665,488,177,28,28,184,81,103
"2021","Nottingham 004","E02002871",3515,1153,461,692,2174,298,834,351,311,172,474,210,232,32,544,383,161,24,24,188,73,115
"2021","Nottingham 005","E02002872",3758,1320,447,873,2231,224,813,330,325,158,470,197,219,54,695,507,188,29,29,207,95,112
"2021","Nottingham 006","E02002873",3849,1164,328,836,2410,142,930,302,455,173,549,259,249,41,743,513,230,46,46,275,140,135
"2021","Nottingham 007","E02002874",3070,920,399,521,1925,184,819,266,390,163,421,228,170,23,476,299,177,25,25,225,78,147
"2021","Nottingham 008","E02002875",3675,1247,442,805,2201,153,797,285,370,142,510,256,211,43,709,508,201,32,32,227,109,118
"2021","Nottingham 009","E02002876",3418,1159,403,756,2058,228,860,302,402,156,415,238,149,28,527,330,197,28,28,201,100,101
"2021","Nottingham 010","E02002877",3680,1481,491,990,1893,235,773,326,354,93,559,363,183,13,304,181,123,22,22,306,87,219
"2021","Nottingham 011","E02002878",3161,643,229,414,2221,80,779,180,471,128,407,109,243,55,884,674,210,71,71,297,197,100
"2021","Nottingham 012","E02002879",4039,1290,316,974,2367,132,1079,379,568,132,574,382,170,22,530,378,152,52,52,382,162,220
"2021","Nottingham 013","E02002880",3220,767,235,532,2203,103,826,189,489,148,406,133,222,51,835,618,217,33,33,250,145,105
"2021","Nottingham 014","E02002881",2763,851,341,510,1739,120,672,208,328,136,363,141,182,40,535,390,145,49,49,173,92,81
"2021","Nottingham 015","E02002882",3885,1644,368,1276,1838,171,791,336,353,102,544,413,110,21,285,186,99,47,47,403,80,323
"2021","Nottingham 016","E02002883",3503,1292,303,989,2017,133,757,283,370,104,559,364,177,18,534,363,171,34,34,194,83,111
"2021","Nottingham 017","E02002884",2516,766,168,598,1232,35,587,159,367,61,291,177,101,13,270,181,89,49,49,518,214,304
"2021","Nottingham 018","E02002885",3081,948,180,768,1507,32,749,144,527,78,274,161,101,12,393,267,126,59,59,626,202,424
"2021","Nottingham 019","E02002886",3671,1006,436,570,2266,234,1256,283,762,211,278,147,111,20,446,262,184,52,52,399,229,170
"2021","Nottingham 020","E02002887",2756,981,524,457,1599,200,743,216,358,169,253,122,108,23,371,211,160,32,32,176,91,85
"2021","Nottingham 021","E02002888",3364,1247,354,893,1866,80,747,169,480,98,384,175,188,21,603,418,185,52,52,251,95,156
"2021","Nottingham 022","E02002889",2672,1028,126,902,723,26,225,92,105,28,238,187,41,10,167,100,67,67,67,921,48,873
"2021","Nottingham 023","E02002890",4196,2086,362,1724,1462,68,493,185,234,74,397,296,86,15,425,286,139,79,79,648,84,564
"2021","Nottingham 024","E02002891",3291,962,379,583,2068,233,968,276,481,211,372,172,172,28,469,266,203,26,26,261,146,115
"2021","Nottingham 025","E02002892",2476,794,376,418,1491,145,653,209,311,133,291,139,126,26,360,194,166,42,42,191,108,83
"2021","Nottingham 026","E02002893",4131,1449,277,1172,1685,62,771,230,457,84,292,158,118,16,445,297,148,115,115,997,120,877
"2021","Nottingham 028","E02002895",3457,1190,199,991,1198,105,494,249,190,55,420,385,30,5,128,99,29,51,51,1069,63,1006
"2021","Nottingham 029","E02002896",4164,1540,346,1194,2047,66,778,213,477,88,527,347,153,27,589,419,170,87,87,577,190,387
"2021","Nottingham 030","E02002897",3238,904,526,378,2176,454,1220,342,680,198,233,123,99,11,260,134,126,9,9,158,83,75
"2021","Nottingham 031","E02002898",3297,811,214,597,897,56,342,126,174,42,230,185,32,13,210,144,66,59,59,1589,58,1531
"2021","Nottingham 034","E02002901",2685,821,374,447,1740,267,856,325,385,146,372,219,136,17,230,136,94,15,15,124,51,73
"2021","Nottingham 035","E02002902",3418,1057,448,609,2130,235,864,323,333,208,465,215,202,48,527,353,174,39,39,231,95,136
"2021","Nottingham 036","E02002903",2671,942,525,417,1551,230,617,268,217,132,325,155,137,33,359,251,108,20,20,178,56,122
"2021","Nottingham 037","E02002904",2601,757,338,419,1651,144,688,249,290,149,370,161,181,28,431,286,145,18,18,193,72,121
"2021","Nottingham 038","E02006834",3515,1492,627,865,1848,192,639,217,278,144,412,178,199,35,578,371,207,27,27,175,87,88
"2021","Nottingham 039","E02006904",4179,1908,156,1752,1552,52,478,231,214,33,717,633,77,7,204,124,80,101,101,719,37,682
"2021","Nottingham 040","E02006905",3319,1300,385,915,1698,72,677,183,388,106,362,238,108,16,540,368,172,47,47,321,118,203
"2021","Nottingham 041","E02007082",4724,1271,642,629,2970,411,1605,459,882,264,460,287,145,28,447,265,182,47,47,483,166,317
"2021","North Northamptonshire 002","E02005612",2981,721,359,362,2053,300,1013,414,410,189,387,187,169,31,330,223,107,23,23,207,94,113
"2021","North Northamptonshire 003","E02005613",3791,1042,463,579,2432,259,1084,359,482,243,525,225,257,43,518,285,233,46,46,317,137,180
"2021","North Northamptonshire 006","E02005614",5503,1244,395,849,3877,317,1840,648,972,220,1051,584,426,41,622,433,189,47,47,382,179,203
"2021","North Northamptonshire 004","E02005615",3975,1107,541,566,2568,362,1071,406,425,240,515,220,249,46,587,371,216,33,33,300,111,189
"2021","North Northamptonshire 005","E02005616",2419,680,264,416,1491,130,658,254,275,129,281,118,135,28,371,231,140,51,51,248,104,144
"2021","North Northamptonshire 007","E02005617",4361,1185,432,753,2647,261,1048,347,476,225,566,229,287,50,721,483,238,51,51,529,214,315
"2021","North Northamptonshire 001","E02005629",2748,667,355,312,1966,427,1048,439,450,159,271,154,98,19,213,110,103,7,7,115,54,61
"2021","North Northamptonshire 010","E02005630",4273,1220,648,572,2914,659,1585,626,709,250,368,221,122,25,292,168,124,10,10,139,49,90
"2021","North Northamptonshire 011","E02005631",4700,1235,606,629,3255,515,1739,661,797,281,629,362,224,43,356,213,143,16,16,210,83,127
"2021","North Northamptonshire 024","E02005632",2741,623,326,297,2017,434,1027,447,402,178,328,179,131,18,219,141,78,9,9,101,38,63
"2021","North Northamptonshire 025","E02005633",4165,1119,521,598,2851,476,1306,533,532,241,663,356,265,42,389,251,138,17,17,195,97,98
"2021","North Northamptonshire 027","E02005634",3957,1141,449,692,2611,348,1177,449,533,195,607,328,241,38,463,308,155,16,16,205,98,107
"2021","North Northamptonshire 035","E02005635",3911,1019,487,532,2702,418,1336,472,626,238,536,262,244,30,394,249,145,18,18,190,92,98
"2021","North Northamptonshire 034","E02005636",5103,1361,623,738,3466,508,1558,597,692,269,771,348,373,50,599,387,212,30,30,276,131,145
"2021","North Northamptonshire 037","E02005637",4383,1707,597,1110,2417,267,900,354,404,142,673,338,295,40,538,373,165,39,39,259,115,144
"2021","North Northamptonshire 039","E02005638",4099,966,521,445,2952,601,1551,563,667,321,502,238,225,39,288,141,147,10,10,181,87,94
"2021","North Northamptonshire 012","E02005639",2427,584,327,257,1748,387,898,401,354,143,276,164,97,15,179,82,97,8,8,95,32,63
"2021","North Northamptonshire 013","E02005640",4923,1280,581,699,3422,571,1660,631,751,278,730,342,353,35,447,291,156,14,14,221,93,128
"2021","North Northamptonshire 014","E02005641",3778,1148,468,680,2447,418,1064,427,443,194,557,282,237,38,389,267,122,19,19,183,82,101
"2021","North Northamptonshire 015","E02005642",3367,787,384,403,2383,392,1245,423,557,265,425,212,185,28,301,164,137,20,20,197,89,108
"2021","North Northamptonshire 016","E02005643",3543,1009,344,665,2310,212,906,269,480,157,544,213,279,52,623,423,200,25,25,224,103,121
"2021","North Northamptonshire 017","E02005644",3969,1381,265,1116,2158,100,865,294,459,112,607,311,266,30,515,353,162,71,71,430,158,272
"2021","North Northamptonshire 018","E02005645",5608,2121,818,1303,3136,366,1526,497,814,215,689,383,284,22,494,338,156,61,61,351,147,204
"2021","North Northamptonshire 019","E02005646",2729,695,426,269,1899,430,924,321,419,184,313,144,149,20,224,124,100,8,8,135,73,62
"2021","North Northamptonshire 022","E02005647",3277,1062,479,583,2045,291,916,314,421,181,411,201,177,33,406,275,131,21,21,170,54,116
"2021","North Northamptonshire 021","E02005648",3813,824,433,391,2839,491,1474,481,726,267,563,257,267,39,304,193,111,7,7,150,81,69
"2021","North Northamptonshire 026","E02005692",3144,960,479,481,2074,402,979,406,370,203,390,233,129,28,297,187,110,6,6,110,49,61
"2021","North Northamptonshire 028","E02005693",3328,802,354,448,2246,292,1077,340,520,217,388,169,193,26,469,295,174,20,20,280,149,131
"2021","North Northamptonshire 029","E02005694",3074,718,380,338,2152,410,1178,425,479,274,311,141,154,16,241,132,109,12,12,204,95,109
"2021","North Northamptonshire 030","E02005695",4114,1218,341,877,2432,154,1092,330,592,170,661,374,257,30,459,288,171,66,66,464,202,262
"2021","North Northamptonshire 031","E02005696",2584,761,330,431,1639,154,615,183,308,124,373,152,198,23,482,348,134,15,15,184,92,92
"2021","North Northamptonshire 032","E02005697",3364,1358,451,907,1761,206,693,256,312,125,403,228,154,21,420,263,157,39,39,245,101,144
"2021","North Northamptonshire 033","E02005698",2415,662,331,331,1559,250,699,243,306,150,286,129,146,11,310,190,120,14,14,194,103,91
"2021","North Northamptonshire 036","E02005699",3337,790,332,458,2312,190,1090,370,529,191,482,204,241,37,526,378,148,24,24,235,126,109
"2021","North Northamptonshire 038","E02005700",4527,1273,663,610,3100,646,1518,670,631,217,557,308,215,34,369,219,150,10,10,154,61,93
"2021","North Northamptonshire 040","E02005701",4835,1366,697,669,3262,622,1602,639,660,303,579,300,239,40,438,273,165,21,21,207,97,110
"2021","North Northamptonshire 009","E02006862",2667,619,290,329,1852,279,882,349,343,190,347,153,166,28,329,192,137,15,15,196,96,100
"2021","North Northamptonshire 008","E02006863",4171,645,169,476,3123,131,1796,466,1111,219,665,304,334,27,491,363,128,40,40,403,222,181
"2021","North Northamptonshire 020","E02007070",2578,569,288,281,1926,287,1111,416,545,150,338,195,130,13,182,113,69,8,8,83,35,48
"2021","North Northamptonshire 023","E02007071",4243,1047,462,585,3001,378,1434,502,692,240,662,322,314,26,503,347,156,24,24,195,87,108
"2021","West Northamptonshire 001","E02005619",2576,572,325,247,1891,339,1112,442,468,202,262,158,83,21,167,83,84,11,11,113,40,73
"2021","West Northamptonshire 002","E02005620",3479,834,429,405,2507,425,1386,511,638,237,418,218,171,29,265,174,91,13,13,138,65,73
"2021","West Northamptonshire 004","E02005621",3334,820,479,341,2372,531,1234,501,536,197,360,212,125,23,240,148,92,7,7,142,56,86
"2021","West Northamptonshire 005","E02005622",4084,925,483,442,2984,529,1650,630,736,284,493,266,190,37,303,204,99,9,9,175,71,104
"2021","West Northamptonshire 003","E02005623",4645,1048,532,516,3404,529,1742,603,845,294,712,404,280,28,403,259,144,18,18,193,84,109
"2021","West Northamptonshire 010","E02005624",4753,1132,379,753,3329,385,1694,616,797,281,765,440,282,43,456,303,153,29,29,292,120,172
"2021","West Northamptonshire 016","E02005625",4101,1322,593,729,2525,440,1149,412,518,219,501,271,201,29,412,253,159,23,23,254,115,139
"2021","West Northamptonshire 022","E02005626",2886,789,285,504,1862,203,826,276,401,149,414,175,210,29,390,245,145,29,29,235,124,111
"2021","West Northamptonshire 027","E02005627",3370,980,470,510,2241,432,1125,464,467,194,386,224,147,15,283,178,105,15,15,149,69,80
"2021","West Northamptonshire 042","E02005628",3635,963,454,509,2495,423,1340,575,524,241,444,255,155,34,271,164,107,17,17,177,72,105
"2021","West Northamptonshire 006","E02005650",2640,653,304,349,1802,305,840,275,401,164,373,198,145,30,263,156,107,21,21,185,89,96
"2021","West Northamptonshire 007","E02005651",2829,822,495,327,1865,413,903,350,356,197,303,169,114,20,231,125,106,15,15,142,59,83
"2021","West Northamptonshire 008","E02005652",2909,881,472,409,1874,408,864,295,394,175,353,161,170,22,236,135,101,13,13,154,72,82
"2021","West Northamptonshire 011","E02005653",3247,787,252,535,2080,143,903,233,495,175,423,148,240,35,582,410,172,29,29,380,194,186
"2021","West Northamptonshire 009","E02005654",3267,766,276,490,2195,197,922,291,468,163,462,199,223,40,577,396,181,37,37,306,164,142
"2021","West Northamptonshire 012","E02005655",2722,839,478,361,1722,377,836,272,389,175,247,115,113,19,248,149,99,14,14,161,74,87
"2021","West Northamptonshire 014","E02005656",2366,585,243,342,1476,119,646,180,326,140,275,93,160,22,413,288,125,23,23,305,173,132
"2021","West Northamptonshire 013","E02005657",2967,992,461,531,1811,315,861,306,378,177,363,211,132,20,255,143,112,17,17,164,70,94
"2021","West Northamptonshire 015","E02005658",2733,765,248,517,1657,94,671,196,366,109,350,157,166,27,499,350,149,43,43,311,125,186
"2021","West Northamptonshire 018","E02005659",2443,725,416,309,1553,266,782,230,417,135,275,130,128,17,212,118,94,18,18,165,86,79
"2021","West Northamptonshire 026","E02005660",2591,753,328,425,1603,199,720,251,332,137,326,142,161,23,343,215,128,15,15,235,126,109
"2021","West Northamptonshire 017","E02005661",2582,674,234,440,1655,119,748,163,423,162,299,113,151,35,459,300,159,30,30,253,135,118
"2021","West Northamptonshire 019","E02005662",2778,805,316,489,1707,212,817,250,398,169,341,157,160,24,300,182,118,37,37,266,93,173
"2021","West Northamptonshire 023","E02005663",2424,680,292,388,1659,295,838,319,364,155,325,181,128,16,194,119,75,7,7,85,41,44
"2021","West Northamptonshire 025","E02005664",2576,921,311,610,1360,107,599,237,271,91,356,204,131,21,247,160,87,51,51,295,110,185
"2021","West Northamptonshire 024","E02005665",3313,778,314,464,2233,306,1186,376,548,262,365,181,154,30,345,202,143,31,31,302,154,148
"2021","West Northamptonshire 021","E02005666",3404,993,296,697,2048,105,873,209,536,128,418,155,214,49,604,429,175,48,48,363,211,152
"2021","West Northamptonshire 020","E02005667",2868,919,398,521,1766,293,802,273,405,124,323,151,147,25,328,212,116,20,20,183,96,87
"2021","West Northamptonshire 028","E02005668",2740,728,451,277,1873,359,907,334,405,168,338,164,149,25,257,145,112,12,12,139,64,75
"2021","West Northamptonshire 029","E02005669",2393,551,352,199,1724,358,999,307,458,234,196,93,86,17,162,90,72,9,9,118,63,55
"2021","West Northamptonshire 032","E02005670",4406,1760,292,1468,2135,46,862,317,465,80,565,336,201,28,544,392,152,118,118,511,159,352
"2021","West Northamptonshire 030","E02005671",3255,1057,303,754,1712,112,717,228,378,111,491,314,156,21,323,220,103,69,69,486,170,316
"2021","West Northamptonshire 031","E02005672",3589,1166,190,976,1762,41,757,276,416,65,497,330,151,16,353,242,111,114,114,661,211,450
"2021","West Northamptonshire 033","E02005673",3379,1125,356,769,1888,187,824,307,406,111,471,279,170,22,357,222,135,49,49,366,141,225
"2021","West Northamptonshire 034","E02005674",3903,1574,364,1210,1908,142,872,335,450,87,496,342,135,19,335,226,109,63,63,421,114,307
"2021","West Northamptonshire 036","E02005675",2459,617,226,391,1616,119,741,225,404,112,332,156,154,22,396,290,106,28,28,226,121,105
"2021","West Northamptonshire 038","E02005676",2430,592,243,349,1617,151,793,249,391,153,315,137,151,27,334,192,142,24,24,221,102,119
"2021","West Northamptonshire 037","E02005677",3787,1035,350,685,2307,251,1074,346,578,150,510,299,187,24,405,261,144,67,67,445,131,314
"2021","West Northamptonshire 041","E02005679",3587,816,303,513,2531,280,1428,470,716,242,492,286,189,17,308,190,118,23,23,240,131,109
"2021","West Northamptonshire 044","E02005680",3033,473,200,273,2375,230,1495,343,891,261,318,143,151,24,324,218,106,8,8,185,107,78
"2021","West Northamptonshire 040","E02005681",3599,891,517,374,2558,553,1312,473,587,252,368,193,152,23,311,184,127,14,14,150,68,82
"2021","West Northamptonshire 043","E02005682",3161,768,423,345,2280,426,1235,482,552,201,353,192,141,20,255,162,93,11,11,113,58,55
"2021","West Northamptonshire 046","E02005683",5966,1359,663,696,4304,579,2361,764,1241,356,809,422,332,55,534,341,193,21,21,303,134,169
"2021","West Northamptonshire 045","E02005684",3654,870,420,450,2657,528,1434,554,649,231,440,258,162,20,244,134,110,11,11,127,41,86
"2021","West Northamptonshire 047","E02005685",4307,1167,492,675,2977,409,1482,546,690,246,700,424,241,35,367,218,149,19,19,163,57,106
"2021","West Northamptonshire 048","E02005686",3315,809,456,353,2390,468,1342,490,605,247,309,171,114,24,258,145,113,13,13,116,41,75
"2021","West Northamptonshire 049","E02005687",2743,625,303,322,2007,355,1173,465,503,205,285,157,110,18,186,118,68,8,8,111,36,75
"2021","West Northamptonshire 050","E02005688",4000,919,453,466,2922,482,1610,546,805,259,461,258,182,21,355,213,142,14,14,159,68,91
"2021","West Northamptonshire 051","E02005689",4176,850,338,512,3158,376,1770,554,926,290,694,386,276,32,308,194,114,10,10,168,67,101
"2021","West Northamptonshire 053","E02005690",2514,881,371,510,1509,218,719,280,294,145,332,204,112,16,227,141,86,13,13,124,45,79
"2021","West Northamptonshire 052","E02005691",2805,705,380,325,1985,382,1066,469,433,164,305,175,116,14,220,128,92,12,12,115,40,75
"2021","West Northamptonshire 035","E02007072",2909,778,269,509,1901,99,936,242,618,76,446,227,206,13,396,337,59,24,24,230,118,112
"2021","West Northamptonshire 039","E02007073",3000,634,231,403,2165,289,1172,385,593,194,393,215,163,15,295,214,81,16,16,201,95,106
"2021","Amber Valley 001","E02004029",3330,1104,471,633,2094,272,926,380,366,180,502,295,178,29,368,223,145,26,26,132,52,80
"2021","Amber Valley 002","E02004030",2739,769,446,323,1889,464,937,430,342,165,297,187,95,15,182,101,81,9,9,81,29,52
"2021","Amber Valley 003","E02004031",3284,1136,458,678,2006,209,737,296,287,154,528,225,264,39,504,365,139,28,28,142,54,88
"2021","Amber Valley 004","E02004032",3813,1092,606,486,2614,553,1245,523,461,261,489,257,198,34,317,190,127,10,10,107,44,63
"2021","Amber Valley 005","E02004033",4099,1386,522,864,2591,398,1138,497,400,241,625,333,243,49,406,254,152,24,24,122,50,72
"2021","Amber Valley 006","E02004034",3166,969,561,408,2119,499,1015,445,366,204,350,211,120,19,250,133,117,5,5,78,29,49
"2021","Amber Valley 007","E02004035",2820,714,435,279,1998,477,1052,491,370,191,288,158,102,28,172,96,76,9,9,108,44,64
"2021","Amber Valley 008","E02004036",4582,1413,660,753,2997,477,1328,531,521,276,636,347,245,44,543,348,195,13,13,172,73,99
"2021","Amber Valley 009","E02004037",3373,867,436,431,2405,449,1270,453,573,244,411,229,154,28,266,155,111,9,9,101,40,61
"2021","Amber Valley 010","E02004038",3670,1426,558,868,2134,353,994,457,379,158,502,328,145,29,268,158,110,17,17,110,39,71
"2021","Amber Valley 011","E02004039",3451,1013,457,556,2341,390,1188,490,474,224,449,262,158,29,304,198,106,10,10,97,35,62
"2021","Amber Valley 012","E02004040",4062,1108,441,667,2804,400,1411,567,579,265,557,288,235,34,412,269,143,24,24,150,63,87
"2021","Amber Valley 013","E02004041",3267,1021,393,628,2130,312,996,403,397,196,523,305,191,27,293,195,98,6,6,116,44,72
"2021","Amber Valley 015","E02004043",3242,920,457,463,2219,444,1025,428,414,183,428,240,171,17,310,193,117,12,12,103,45,58
"2021","Amber Valley 016","E02004044",3756,987,536,451,2635,544,1472,448,782,242,337,191,132,14,273,196,77,9,9,134,64,70
"2021","Amber Valley 017","E02006827",3623,1240,518,722,2213,287,816,344,307,165,557,283,241,33,536,350,186,17,17,170,76,94
"2021","Bolsover 001","E02004045",4313,1206,557,649,2965,526,1479,613,610,256,596,350,218,28,347,220,127,17,17,142,60,82
"2021","Bolsover 002","E02004046",2788,841,442,399,1860,328,870,378,302,190,384,186,167,31,269,152,117,9,9,87,36,51
"2021","Bolsover 003","E02004047",2757,922,342,580,1723,229,656,291,257,108,471,230,223,18,354,261,93,13,13,112,57,55
"2021","Bolsover 004","E02004048",3097,937,399,538,2029,268,898,379,358,161,478,240,218,20,368,245,123,17,17,131,48,83
"2021","Bolsover 005","E02004049",3603,1148,632,516,2367,438,1120,502,403,215,496,264,199,33,296,153,143,17,17,88,33,55
"2021","Bolsover 006","E02004050",3261,928,459,469,2158,232,954,341,425,188,526,235,256,35,423,258,165,23,23,175,88,87
"2021","Bolsover 007","E02004051",4223,1273,578,695,2693,351,1201,542,407,252,646,331,275,40,454,272,182,41,41,257,87,170
"2021","Bolsover 008","E02004052",3762,1031,471,560,2591,397,1263,520,500,243,569,290,255,24,341,204,137,21,21,140,59,81
"2021","Bolsover 009","E02004053",3426,1090,436,654,2203,288,1013,404,413,196,525,244,246,35,363,218,145,14,14,133,58,75
"2021","Bolsover 010","E02004054",4030,1162,486,676,2709,414,1290,574,463,253,651,341,259,51,342,206,136,12,12,159,65,94
"2021","Chesterfield 001","E02004055",3305,1211,496,715,2009,340,844,375,307,162,442,235,176,31,371,244,127,12,12,85,35,50
"2021","Chesterfield 002","E02004056",3326,998,409,589,2188,260,898,314,375,209,512,212,264,36,499,351,148,19,19,140,65,75
"2021","Chesterfield 003","E02004057",3549,1269,382,887,2150,238,941,374,412,155,576,312,241,23,375,259,116,20,20,130,50,80
"2021","Chesterfield 004","E02004058",3815,1475,537,938,2223,306,894,364,360,170,513,244,234,35,496,314,182,14,14,117,49,68
"2021","Chesterfield 005","E02004059",3315,1052,537,515,2168,406,1050,474,352,224,411,229,158,24,291,181,110,10,10,95,38,57
"2021","Chesterfield 006","E02004060",3224,976,540,436,2133,409,964,378,384,202,405,187,189,29,345,233,112,10,10,115,58,57
"2021","Chesterfield 007","E02004061",3558,1378,552,826,2088,306,937,353,390,194,476,281,166,29,354,217,137,15,15,92,29,63
"2021","Chesterfield 008","E02004062",3696,1468,587,881,2135,408,1052,436,404,212,377,192,158,27,291,179,112,7,7,93,34,59
"2021","Chesterfield 009","E02004063",3614,1215,646,569,2312,475,1096,448,442,206,435,244,166,25,294,170,124,12,12,87,34,53
"2021","Chesterfield 010","E02004064",4745,2099,488,1611,2413,185,927,385,412,130,719,445,242,32,552,376,176,30,30,233,71,162
"2021","Chesterfield 011","E02004065",3676,1046,676,370,2548,675,1299,526,538,235,342,183,136,23,225,107,118,7,7,82,29,53
"2021","Chesterfield 012","E02004066",5236,1682,693,989,3366,559,1546,655,619,272,716,403,278,35,522,315,207,23,23,188,71,117
"2021","Chesterfield 013","E02004067",3013,1197,429,768,1709,254,705,310,257,138,354,150,181,23,383,264,119,13,13,107,50,57
"2021","Derbyshire Dales 001","E02004068",3307,997,563,434,2210,480,1163,520,445,198,334,189,129,16,220,115,105,13,13,100,40,60
"2021","Derbyshire Dales 002","E02004069",2954,920,544,376,1969,546,1021,478,371,172,230,144,67,19,161,92,69,11,11,65,24,41
"2021","Derbyshire Dales 005","E02004072",4233,1226,672,554,2891,694,1414,620,566,228,466,264,175,27,306,187,119,11,11,116,38,78
"2021","Derbyshire Dales 006","E02004073",4182,1551,768,783,2517,544,1200,542,421,237,454,233,189,32,300,167,133,19,19,114,52,62
"2021","Derbyshire Dales 007","E02004074",2705,881,466,415,1740,376,792,358,296,138,316,167,124,25,245,133,112,11,11,84,32,52
"2021","Derbyshire Dales 008","E02004075",3229,947,493,454,2150,518,1177,571,391,215,282,159,98,25,164,91,73,9,9,132,57,75
"2021","Derbyshire Dales 009","E02004076",3336,1048,510,538,2199,358,1033,385,471,177,437,215,191,31,359,240,119,12,12,89,32,57
"2021","Derbyshire Dales 010","E02004077",3304,811,432,379,2359,510,1311,556,518,237,356,214,121,21,182,100,82,0,0,134,65,69
"2021","Derbyshire Dales 011","E02007029",5033,1509,908,601,3353,829,1635,758,571,306,495,254,212,29,379,207,172,15,15,171,63,108
"2021","Erewash 001","E02004078",3161,1073,455,618,1941,262,702,297,252,153,485,200,248,37,476,312,164,16,16,147,67,80
"2021","Erewash 003","E02004080",4578,1674,544,1130,2677,317,1036,446,397,193,739,418,275,46,558,366,192,27,27,227,79,148
"2021","Erewash 004","E02004081",2520,679,411,268,1755,393,906,350,390,166,278,155,99,24,175,92,83,3,3,86,37,49
"2021","Erewash 005","E02004082",2597,661,390,271,1855,417,984,398,373,213,282,154,105,23,164,87,77,8,8,81,26,55
"2021","Erewash 006","E02004083",3592,1012,354,658,2456,339,1047,392,438,217,659,344,282,33,399,267,132,12,12,124,63,61
"2021","Erewash 007","E02004084",2616,830,447,383,1704,253,736,276,293,167,396,172,192,32,308,179,129,11,11,82,31,51
"2021","Erewash 008","E02004085",3804,1096,548,548,2559,447,1199,460,501,238,520,264,219,37,376,234,142,17,17,149,62,87
"2021","Erewash 009","E02004086",3151,921,518,403,2136,434,1057,383,473,201,355,188,143,24,275,154,121,15,15,94,45,49
"2021","Erewash 010","E02004087",3442,1069,458,611,2226,284,961,359,420,182,558,281,238,39,412,252,160,11,11,147,59,88
"2021","Erewash 011","E02004088",3223,841,425,416,2280,458,1243,475,533,235,363,174,160,29,209,127,82,7,7,102,45,57
"2021","Erewash 012","E02004089",3477,1467,407,1060,1860,153,632,268,273,91,596,367,192,37,444,301,143,35,35,150,40,110
"2021","Erewash 013","E02004090",2796,949,455,494,1744,364,803,329,310,164,321,199,99,23,241,144,97,15,15,103,39,64
"2021","Erewash 014","E02004091",4180,1246,546,700,2797,438,1314,498,557,259,649,378,235,36,381,214,167,15,15,137,51,86
"2021","Erewash 015","E02004092",4186,1281,648,633,2752,463,1277,511,551,215,532,284,215,33,466,253,213,14,14,153,67,86
"2021","Erewash 016","E02006828",3020,752,313,439,2174,287,1064,424,423,217,491,254,207,30,322,215,107,10,10,94,39,55
"2021","High Peak 001","E02004093",2852,894,343,551,1865,221,882,357,360,165,395,211,155,29,352,230,122,15,15,93,42,51
"2021","High Peak 002","E02004094",3009,942,423,519,1952,224,806,303,340,163,416,163,213,40,492,329,163,14,14,115,50,65
"2021","High Peak 003","E02004095",4863,1785,680,1105,2911,349,1306,538,517,251,693,409,248,36,540,333,207,23,23,167,56,111
"2021","High Peak 004","E02004096",4074,928,531,397,3006,600,1634,599,738,297,470,252,187,31,292,155,137,10,10,140,56,84
"2021","High Peak 005","E02004097",3429,1073,453,620,2229,391,1112,474,436,202,445,282,143,20,270,144,126,11,11,127,58,69
"2021","High Peak 006","E02004098",3327,1114,551,563,2106,322,987,407,394,186,422,207,178,37,360,218,142,15,15,107,48,59
"2021","High Peak 008","E02004100",3554,1018,505,513,2418,434,1268,524,510,234,426,220,178,28,284,184,100,6,6,118,43,75
"2021","High Peak 010","E02004102",3860,1753,719,1034,1939,368,832,391,294,147,403,249,132,22,324,181,143,12,12,168,42,126
"2021","High Peak 011","E02004103",2900,885,385,500,1883,225,799,297,336,166,410,171,216,23,426,271,155,23,23,132,58,74
"2021","High Peak 012","E02004104",3109,831,396,435,2195,395,1189,459,503,227,367,184,160,23,238,155,83,6,6,83,35,48
"2021","High Peak 013","E02006872",5795,1723,903,820,3895,779,1905,857,738,310,702,368,299,35,492,286,206,17,17,177,73,104
"2021","North East Derbyshire 001","E02004105",3989,1096,542,554,2745,451,1348,549,491,308,509,227,234,48,420,261,159,17,17,148,70,78
"2021","North East Derbyshire 002","E02004106",3229,1085,619,466,2050,536,1016,418,396,202,282,168,91,23,210,109,101,6,6,94,33,61
"2021","North East Derbyshire 004","E02004108",3533,1321,619,702,2120,368,967,361,439,167,392,205,155,32,381,219,162,12,12,92,41,51
"2021","North East Derbyshire 005","E02004109",2932,724,468,256,2122,636,1071,395,491,185,230,122,95,13,185,112,73,0,0,86,36,50
"2021","North East Derbyshire 006","E02004110",3166,829,549,280,2248,533,1169,361,585,223,326,161,151,14,214,119,95,6,6,89,37,52
"2021","North East Derbyshire 007","E02004111",2565,806,423,383,1673,346,772,355,261,156,333,184,128,21,217,139,78,5,5,86,42,44
"2021","North East Derbyshire 008","E02004112",2865,795,527,268,1987,568,1014,462,368,184,231,146,67,18,168,81,87,6,6,83,29,54
"2021","North East Derbyshire 009","E02004113",4620,1582,557,1025,2871,339,1167,475,456,236,736,353,342,41,606,400,206,23,23,167,72,95
"2021","North East Derbyshire 010","E02004114",3806,1071,555,516,2607,630,1235,529,481,225,486,302,155,29,243,127,116,13,13,128,61,67
"2021","North East Derbyshire 011","E02004115",4059,1306,537,769,2627,466,1267,578,419,270,531,286,215,30,352,191,161,11,11,126,53,73
"2021","North East Derbyshire 012","E02004116",4027,1504,631,873,2417,357,1012,407,412,193,548,287,236,25,484,317,167,16,16,106,45,61
"2021","North East Derbyshire 013","E02004117",3540,979,468,511,2444,467,1135,494,422,219,486,255,204,27,336,224,112,20,20,117,57,60
"2021","North East Derbyshire 014","E02006804",3670,1207,522,685,2357,304,1049,399,435,215,523,245,227,51,469,309,160,12,12,106,49,57
"2021","South Derbyshire 001","E02004118",3128,779,319,460,2224,321,1192,470,531,191,451,253,170,28,251,156,95,9,9,125,57,68
"2021","South Derbyshire 002","E02004119",4895,1284,467,817,3464,438,1857,577,991,289,708,418,266,24,451,332,119,10,10,147,66,81
"2021","South Derbyshire 003","E02004120",4484,1136,410,726,3127,409,1621,531,794,296,630,375,221,34,448,310,138,19,19,221,122,99
"2021","South Derbyshire 004","E02004121",3871,934,421,513,2793,435,1470,547,690,233,548,329,194,25,327,230,97,13,13,144,64,80
"2021","South Derbyshire 005","E02004122",2728,650,335,315,1988,397,1075,435,448,192,315,189,104,22,194,121,73,7,7,90,43,47
"2021","South Derbyshire 006","E02004123",3048,964,520,444,1999,361,1064,409,462,193,330,213,100,17,235,140,95,9,9,85,35,50
"2021","South Derbyshire 007","E02004124",3191,810,400,410,2258,388,1055,427,421,207,436,205,198,33,374,227,147,5,5,123,58,65
"2021","South Derbyshire 008","E02004125",3797,1109,468,641,2540,414,1143,488,420,235,575,307,232,36,396,257,139,12,12,148,69,79
"2021","South Derbyshire 009","E02004126",3385,1137,549,588,2134,353,983,405,390,188,467,256,194,17,325,201,124,6,6,114,53,61
"2021","South Derbyshire 011","E02004128",4886,1264,581,683,3439,607,1686,709,661,316,700,377,281,42,430,241,189,16,16,183,93,90
"2021","South Derbyshire 012","E02006919",4479,1292,378,914,3049,287,1439,554,684,201,787,410,335,42,515,368,147,21,21,138,64,74
"2021","South Derbyshire 013","E02006920",3336,890,293,597,2305,205,1127,427,499,201,568,293,243,32,393,273,120,12,12,141,78,63
"2021","Blaby 002","E02005334",2346,501,258,243,1706,214,920,303,427,190,329,152,155,22,232,139,93,11,11,139,66,73
"2021","Blaby 003","E02005335",3080,803,465,338,2141,458,1150,357,578,215,318,175,126,17,205,118,87,10,10,136,72,64
"2021","Blaby 004","E02005336",2863,711,252,459,1899,153,973,302,502,169,440,210,199,31,311,197,114,22,22,253,126,127
"2021","Blaby 005","E02005337",3942,1078,587,491,2516,363,1316,399,586,331,401,182,189,30,400,223,177,36,36,348,184,164
"2021","Blaby 006","E02005338",4794,1349,621,728,3225,432,1580,560,726,294,719,350,311,58,476,306,170,18,18,220,89,131
"2021","Blaby 007","E02005339",3691,1017,497,520,2544,416,1265,423,601,241,499,274,202,23,353,201,152,11,11,130,64,66
"2021","Blaby 008","E02005340",3916,1162,610,552,2592,497,1105,389,483,233,574,288,241,45,406,253,153,10,10,162,64,98
"2021","Blaby 009","E02005341",3085,731,314,417,2249,301,1151,364,553,234,443,210,203,30,344,224,120,10,10,105,45,60
"2021","Blaby 010","E02005342",3136,784,410,374,2227,435,1063,415,449,199,417,186,199,32,305,199,106,7,7,125,57,68
"2021","Blaby 011","E02005343",3336,831,464,367,2418,499,1173,416,524,233,438,222,192,24,301,188,113,7,7,87,46,41
"2021","Blaby 012","E02005344",3898,945,464,481,2834,522,1380,528,639,213,553,295,222,36,360,236,124,19,19,119,44,75
"2021","Blaby 013","E02006820",4491,1181,698,483,3056,638,1514,482,689,343,487,232,217,38,397,227,170,20,20,254,107,147
"2021","Charnwood 001","E02005345",2811,782,329,453,1901,320,931,360,388,183,350,204,125,21,288,155,133,12,12,128,63,65
"2021","Charnwood 002","E02005346",5529,2231,506,1725,2736,153,1207,410,612,185,707,481,202,24,606,384,222,63,63,562,182,380
"2021","Charnwood 003","E02005347",3650,1000,325,675,1430,193,606,212,261,133,303,187,100,16,274,176,98,54,54,1220,83,1137
"2021","Charnwood 004","E02005348",2495,818,424,394,1565,372,789,319,283,187,228,121,97,10,165,78,87,11,11,112,37,75
"2021","Charnwood 005","E02005349",3435,954,444,510,2358,386,1130,430,481,219,490,252,216,22,332,212,120,20,20,123,48,75
"2021","Charnwood 006","E02005350",3059,986,385,601,1977,329,960,377,393,190,415,217,178,20,265,165,100,8,8,96,30,66
"2021","Charnwood 007","E02005351",2367,587,290,297,1406,205,708,200,358,150,215,96,102,17,250,142,108,28,28,374,56,318
"2021","Charnwood 008","E02005352",2527,572,334,238,1840,361,1095,403,504,188,242,149,77,16,135,79,56,7,7,115,45,70
"2021","Charnwood 009","E02005353",4152,1148,451,697,2685,283,1272,441,592,239,584,282,265,37,521,311,210,25,25,319,116,203
"2021","Charnwood 010","E02005354",4105,978,564,414,2911,570,1669,564,837,268,365,214,135,16,288,165,123,19,19,216,66,150
"2021","Charnwood 011","E02005355",3223,935,410,525,2162,400,1060,396,490,174,420,225,178,17,274,183,91,8,8,126,52,74
"2021","Charnwood 012","E02005356",3214,971,430,541,2146,427,1109,418,534,157,333,208,104,21,265,158,107,12,12,97,35,62
"2021","Charnwood 013","E02005357",3548,961,393,568,2434,271,1112,410,510,192,606,302,274,30,423,269,154,22,22,153,53,100
"2021","Charnwood 014","E02005358",5236,1434,609,825,3633,490,1760,632,851,277,797,460,295,42,573,388,185,13,13,169,74,95
"2021","Charnwood 015","E02005359",3036,643,372,271,2235,413,1194,382,555,257,369,174,167,28,251,155,96,8,8,158,73,85
"2021","Charnwood 016","E02005360",2600,622,388,234,1875,452,1053,392,461,200,239,141,82,16,125,68,57,6,6,103,37,66
"2021","Charnwood 017","E02005361",2785,938,414,524,1718,246,858,319,333,206,315,162,131,22,292,187,105,7,7,129,66,63
"2021","Charnwood 018","E02005362",2996,780,403,377,2094,346,1014,329,469,216,403,179,201,23,318,206,112,13,13,122,62,60
"2021","Charnwood 019","E02005363",3555,865,501,364,2476,463,1418,410,682,326,290,132,139,19,283,148,135,22,22,214,110,104
"2021","Charnwood 020","E02005364",2096,522,286,236,1448,208,805,246,366,193,207,88,96,23,216,96,120,12,12,126,62,64
"2021","Charnwood 021","E02005365",4026,1188,568,620,2575,422,1338,434,542,362,357,149,172,36,435,253,182,23,23,263,141,122
"2021","Charnwood 022","E02005366",3337,949,483,466,2261,392,1052,367,485,200,481,261,180,40,324,209,115,12,12,127,55,72
"2021","Harborough 002","E02005368",2662,656,350,306,1880,406,1086,429,458,199,218,122,86,10,159,93,66,11,11,126,51,75
"2021","Harborough 003","E02005369",5257,1408,706,702,3622,652,1897,594,974,329,576,300,241,35,481,308,173,16,16,227,117,110
"2021","Harborough 004","E02005370",3898,867,379,488,2895,426,1514,517,689,308,587,309,234,44,355,242,113,13,13,136,61,75
"2021","Harborough 005","E02005371",4419,1062,542,520,3144,580,1724,638,770,316,487,283,174,30,343,215,128,10,10,213,100,113
"2021","Harborough 006","E02005372",4146,886,481,405,3027,594,1710,708,716,286,457,279,155,23,252,130,122,14,14,233,97,136
"2021","Harborough 007","E02005373",4884,1182,614,568,3529,709,1900,659,945,296,579,347,206,26,325,207,118,16,16,173,56,117
"2021","Harborough 008","E02005374",3046,1218,643,575,1691,254,704,283,301,120,374,218,132,24,334,187,147,25,25,137,40,97
"2021","Harborough 009","E02005375",4045,1185,568,617,2741,473,1398,483,721,194,517,309,179,29,333,211,122,20,20,119,39,80
"2021","Harborough 010","E02005376",4561,1237,613,624,3134,586,1557,526,761,270,542,295,218,29,431,280,151,18,18,190,91,99
"2021","Harborough 011","E02006816",3492,813,439,374,2451,473,1345,428,621,296,326,180,125,21,297,191,106,10,10,228,121,107
"2021","Hinckley and Bosworth 001","E02005377",3906,1093,633,460,2655,515,1265,502,524,239,505,262,219,24,363,233,130,7,7,158,71,87
"2021","Hinckley and Bosworth 002","E02005378",2241,545,284,261,1618,318,823,283,375,165,249,109,116,24,221,124,97,7,7,78,39,39
"2021","Hinckley and Bosworth 003","E02005379",2641,704,366,338,1851,404,873,341,367,165,305,151,131,23,263,174,89,6,6,86,36,50
"2021","Hinckley and Bosworth 004","E02005380",3694,931,539,392,2620,606,1386,553,583,250,351,185,132,34,270,170,100,7,7,143,61,82
"2021","Hinckley and Bosworth 005","E02005381",3681,923,520,403,2606,557,1325,504,599,222,410,211,170,29,307,173,134,7,7,152,77,75
"2021","Hinckley and Bosworth 006","E02005382",4650,1376,526,850,3077,492,1383,569,544,270,689,397,257,35,487,314,173,26,26,197,92,105
"2021","Hinckley and Bosworth 007","E02005383",4071,1248,513,735,2673,428,1179,489,473,217,602,315,241,46,441,270,171,23,23,150,54,96
"2021","Hinckley and Bosworth 008","E02005384",3028,682,361,321,2207,444,1185,481,520,184,352,208,123,21,219,122,97,7,7,139,58,81
"2021","Hinckley and Bosworth 009","E02005385",2846,688,385,303,2034,431,1063,416,435,212,338,179,138,21,192,104,88,10,10,124,48,76
"2021","Hinckley and Bosworth 010","E02005386",4301,1621,543,1078,2459,288,1001,409,432,160,656,364,260,32,478,307,171,36,36,221,68,153
"2021","Hinckley and Bosworth 011","E02005387",4315,1185,432,753,2944,396,1364,510,639,215,732,406,298,28,431,272,159,21,21,186,76,110
"2021","Hinckley and Bosworth 012","E02005388",2815,905,381,524,1787,252,800,296,355,149,439,236,181,22,275,184,91,21,21,123,41,82
"2021","Hinckley and Bosworth 013","E02005389",2695,877,480,397,1710,354,774,294,340,140,305,163,122,20,271,157,114,6,6,108,35,73
"2021","Hinckley and Bosworth 014","E02005390",4557,1192,620,572,3226,623,1700,658,781,261,578,337,208,33,315,198,117,10,10,139,52,87
"2021","Melton 001","E02005391",4203,1082,629,453,2992,630,1628,671,654,303,428,256,145,27,294,180,114,12,12,129,63,66
"2021","Melton 002","E02005392",4057,1124,573,551,2785,539,1385,546,585,254,486,248,217,21,363,236,127,12,12,148,50,98
"2021","Melton 003","E02005393",3262,890,437,453,2244,418,1132,511,440,181,412,238,152,22,267,163,104,15,15,128,46,82
"2021","Melton 004","E02005394",4157,1265,584,681,2713,421,1135,440,495,200,596,271,287,38,532,352,180,29,29,179,72,107
"2021","Melton 005","E02005395",3972,1280,564,716,2523,453,1214,511,471,232,469,256,192,21,366,205,161,21,21,169,60,109
"2021","Melton 006","E02005396",2947,723,366,357,2107,447,1158,542,412,204,296,180,107,9,196,115,81,10,10,117,41,76
"2021","North West Leicestershire 001","E02005397",4087,1202,517,685,2712,460,1361,536,588,237,572,361,185,26,307,179,128,12,12,173,68,105
"2021","North West Leicestershire 002","E02005398",2961,852,406,446,1794,333,853,345,358,150,368,202,139,27,225,126,99,15,15,315,45,270
"2021","North West Leicestershire 003","E02005399",3644,1085,433,652,2442,361,1201,420,619,162,499,287,185,27,362,242,120,19,19,117,50,67
"2021","North West Leicestershire 004","E02005400",2589,735,390,345,1771,391,798,358,283,157,341,177,137,27,232,143,89,9,9,83,34,49
"2021","North West Leicestershire 005","E02005401",2706,613,333,280,1987,369,1092,454,450,188,327,183,126,18,198,123,75,1,1,106,47,59
"2021","North West Leicestershire 006","E02005402",2890,836,476,360,1983,394,1043,354,520,169,296,152,118,26,242,154,88,8,8,71,26,45
"2021","North West Leicestershire 007","E02005403",2992,935,457,478,1955,362,954,412,342,200,372,207,140,25,259,140,119,8,8,102,40,62
"2021","North West Leicestershire 008","E02005404",3694,947,403,544,2600,379,1305,518,557,230,546,296,211,39,362,224,138,8,8,147,61,86
"2021","North West Leicestershire 009","E02005405",3007,826,429,397,2043,365,886,358,328,200,398,179,184,35,374,230,144,20,20,138,78,60
"2021","North West Leicestershire 010","E02005406",3378,1071,349,722,2119,182,917,318,411,188,556,241,270,45,435,295,140,29,29,188,84,104
"2021","North West Leicestershire 011","E02005407",4546,1090,432,658,3268,372,1655,620,742,293,857,468,340,49,366,230,136,18,18,188,74,114
"2021","North West Leicestershire 012","E02005408",3379,923,397,526,2318,395,1176,465,486,225,427,248,161,18,310,192,118,10,10,138,55,83
"2021","North West Leicestershire 013","E02005409",5111,1385,620,765,3567,517,1690,647,748,295,807,397,354,56,524,335,189,29,29,159,64,95
"2021","Oadby and Wigston 003","E02005412",3556,1119,662,457,2209,397,1233,305,656,272,214,109,90,15,345,196,149,20,20,228,126,102
"2021","Oadby and Wigston 005","E02005414",3469,1172,582,590,2138,290,917,305,431,181,438,187,210,41,472,292,180,21,21,159,74,85
"2021","Oadby and Wigston 006","E02005415",3571,1172,494,678,2232,319,848,290,364,194,566,263,264,39,485,323,162,14,14,167,74,93
"2021","Oadby and Wigston 007","E02005416",3910,1091,602,489,2650,629,1295,480,518,297,400,202,163,35,318,175,143,8,8,169,68,101
"2021","Oadby and Wigston 008","E02006818",3318,830,512,318,2277,417,1228,374,567,287,299,115,158,26,320,163,157,13,13,211,109,102
"2021","Oadby and Wigston 010","E02006966",2036,417,227,190,1328,226,844,191,399,254,86,40,36,10,163,81,82,9,9,291,179,112
"2021","Oadby and Wigston 011","E02006967",2752,548,327,221,1999,297,1303,280,696,327,110,47,52,11,275,142,133,14,14,205,128,77
"2021","Boston 001","E02005417",3089,773,494,279,2126,505,1075,523,337,215,304,160,119,25,232,144,88,10,10,190,86,104
"2021","Boston 002","E02005418",4452,1294,565,729,2613,213,952,336,455,161,643,260,334,49,728,535,193,77,77,545,274,271
"2021","Boston 003","E02005419",3790,1264,353,911,2049,176,802,291,382,129,565,296,248,21,436,313,123,70,70,477,201,276
"2021","Boston 004","E02005420",3741,1145,602,543,2279,318,940,347,430,163,523,226,257,40,471,317,154,27,27,317,163,154
"2021","Boston 006","E02005422",2872,758,405,353,1963,403,914,425,322,167,393,225,142,26,243,151,92,10,10,151,67,84
"2021","Boston 007","E02005423",4391,1192,644,548,2954,517,1361,590,523,248,566,278,251,37,485,339,146,25,25,245,114,131
"2021","Boston 008","E02006864",3650,869,516,353,2552,519,1250,512,528,210,474,245,194,35,297,188,109,12,12,229,105,124
"2021","Boston 009","E02006865",3420,793,456,337,2405,465,1149,452,477,220,470,213,225,32,309,199,110,12,12,222,98,124
"2021","East Lindsey 001","E02005424",4524,1155,675,480,3194,822,1559,781,487,291,469,264,178,27,330,211,119,14,14,175,76,99
"2021","East Lindsey 002","E02005425",2854,695,427,268,1997,504,994,514,303,177,310,163,129,18,183,101,82,6,6,162,62,100
"2021","East Lindsey 003","E02005426",4603,1425,708,717,3026,519,1321,555,558,208,603,282,278,43,563,383,180,20,20,152,60,92
"2021","East Lindsey 004","E02005427",3483,1449,678,771,1940,373,783,384,283,116,396,235,138,23,377,255,122,11,11,94,28,66
"2021","East Lindsey 005","E02005428",3932,1277,752,525,2428,669,981,563,234,184,396,208,168,20,357,195,162,25,25,227,92,135
"2021","East Lindsey 006","E02005429",3196,1058,738,320,2009,811,793,558,111,124,216,135,68,13,181,85,96,8,8,129,39,90
"2021","East Lindsey 007","E02005430",3141,818,468,350,2187,572,1072,537,321,214,333,200,114,19,194,102,92,16,16,136,53,83
"2021","East Lindsey 008","E02005431",3982,1156,653,503,2629,676,1193,628,359,206,414,206,170,38,328,181,147,18,18,197,81,116
"2021","East Lindsey 009","E02005432",3459,827,496,331,2471,622,1244,676,387,181,375,246,114,15,220,126,94,10,10,161,59,102
"2021","East Lindsey 010","E02005433",3410,1112,704,408,2140,668,874,548,160,166,333,190,126,17,246,134,112,19,19,158,51,107
"2021","East Lindsey 011","E02005434",3540,1202,615,587,2230,471,979,464,374,141,421,229,172,20,345,227,118,14,14,108,39,69
"2021","East Lindsey 012","E02005435",3639,1129,629,500,2319,517,930,479,268,183,497,262,216,19,353,224,129,22,22,191,83,108
"2021","East Lindsey 013","E02005436",3671,1087,622,465,2433,581,1086,531,368,187,445,220,198,27,305,192,113,16,16,151,66,85
"2021","East Lindsey 014","E02005437",2941,1281,452,829,1456,203,576,271,202,103,395,210,166,19,260,170,90,22,22,204,88,116
"2021","East Lindsey 015","E02005438",3222,1094,634,460,1982,394,778,352,285,141,371,166,184,21,430,296,134,9,9,146,60,86
"2021","East Lindsey 016","E02005439",5046,1448,804,644,3411,849,1666,718,711,237,494,267,202,25,386,245,141,16,16,187,73,114
"2021","East Lindsey 017","E02005440",2376,628,368,260,1595,362,750,357,221,172,283,139,121,23,192,125,67,8,8,153,75,78
"2021","East Lindsey 018","E02005441",3713,957,547,410,2558,620,1274,637,414,223,399,244,127,28,248,135,113,17,17,198,90,108
"2021","Lincoln 001","E02005442",2944,1056,326,730,1731,146,615,224,274,117,401,180,202,19,532,375,157,37,37,157,51,106
"2021","Lincoln 002","E02005443",3381,1150,500,650,2072,271,891,370,378,143,522,281,218,23,371,252,119,17,17,159,53,106
"2021","Lincoln 003","E02005444",5785,1989,783,1206,3168,425,1425,585,644,196,810,592,196,22,454,289,165,54,54,628,95,533
"2021","Lincoln 004","E02005445",5106,1700,412,1288,2824,171,1086,370,549,167,751,406,296,49,748,511,237,68,68,582,151,431
"2021","Lincoln 005","E02005446",3064,1210,293,917,1078,89,402,190,157,55,392,332,54,6,155,96,59,40,40,776,37,739
"2021","Lincoln 006","E02005447",3564,1326,267,1059,1477,59,485,186,242,57,556,386,149,21,293,189,104,84,84,761,132,629
"2021","Lincoln 007","E02005448",3164,967,352,615,2029,206,736,280,316,140,532,264,227,41,545,401,144,10,10,168,73,95
"2021","Lincoln 008","E02005449",3295,1026,343,683,2002,254,834,332,344,158,522,327,173,22,351,231,120,41,41,267,69,198
"2021","Lincoln 009","E02005450",3797,1130,552,578,2531,518,1150,517,419,214,519,280,215,24,331,198,133,13,13,136,61,75
"2021","Lincoln 010","E02005451",3575,1298,396,902,2039,146,750,310,313,127,531,252,256,23,582,413,169,30,30,238,102,136
"2021","Lincoln 011","E02005452",4821,1288,674,614,3306,587,1606,624,649,333,615,299,276,40,490,288,202,8,8,227,94,133
"2021","North Kesteven 001","E02005453",4759,1222,711,511,3392,817,1725,739,684,302,498,298,183,17,331,203,128,21,21,145,55,90
"2021","North Kesteven 003","E02005455",5989,1427,662,765,4340,735,2313,897,1045,371,784,457,292,35,492,334,158,16,16,222,92,130
"2021","North Kesteven 004","E02005456",4561,1303,691,612,3097,472,1588,604,748,236,632,337,265,30,386,266,120,19,19,161,63,98
"2021","North Kesteven 005","E02005457",3802,1026,588,438,2663,529,1320,566,532,222,493,263,204,26,313,192,121,8,8,113,59,54
"2021","North Kesteven 006","E02005458",2950,773,452,321,2082,525,1081,466,409,206,300,164,124,12,173,94,79,3,3,95,33,62
"2021","North Kesteven 007","E02005459",3630,995,541,454,2474,500,1236,574,438,224,403,206,163,34,326,219,107,9,9,161,75,86
"2021","North Kesteven 008","E02005460",2438,592,253,339,1776,306,1050,419,495,136,240,149,84,7,167,113,54,13,13,70,25,45
"2021","North Kesteven 009","E02005461",2944,853,513,340,1999,536,1014,497,334,183,261,149,94,18,178,101,77,10,10,92,32,60
"2021","North Kesteven 010","E02005462",4539,1653,679,974,2711,394,1176,450,533,193,595,323,252,20,520,367,153,26,26,175,63,112
"2021","North Kesteven 011","E02005463",4121,1021,450,571,2940,451,1615,603,779,233,497,268,203,26,358,257,101,19,19,160,70,90
"2021","North Kesteven 012","E02005464",3867,1050,611,439,2669,659,1339,654,443,242,397,216,149,32,262,161,101,12,12,148,55,93
"2021","North Kesteven 013","E02006866",3695,952,434,518,2616,402,1295,482,637,176,526,299,205,22,385,262,123,8,8,127,46,81
"2021","North Kesteven 014","E02006867",3691,1122,661,461,2448,527,1175,487,489,199,435,236,175,24,300,187,113,11,11,121,40,81
"2021","South Holland 001","E02005465",3754,951,574,377,2597,556,1298,638,426,234,397,206,158,33,333,206,127,13,13,206,89,117
"2021","South Holland 002","E02005466",2898,714,419,295,2020,455,989,485,310,194,330,169,135,26,239,131,108,7,7,164,63,101
"2021","South Holland 003","E02005467",3533,1183,647,536,2165,434,958,422,353,183,438,199,211,28,320,213,107,15,15,185,90,95
"2021","South Holland 004","E02005468",3249,780,471,309,2310,509,1189,555,427,207,359,197,127,35,239,140,99,14,14,159,78,81
"2021","South Holland 005","E02005469",3305,777,413,364,2336,443,1135,482,457,196,459,229,204,26,286,179,107,13,13,192,85,107
"2021","South Holland 006","E02005470",5499,1573,733,840,3375,483,1536,549,765,222,798,422,342,34,494,337,157,64,64,551,221,330
"2021","South Holland 007","E02005471",3903,1167,598,569,2365,422,983,374,425,184,492,247,216,29,439,272,167,29,29,371,170,201
"2021","South Holland 008","E02005472",4457,1404,779,625,2815,616,1240,575,423,242,534,254,240,40,405,248,157,20,20,238,102,136
"2021","South Holland 009","E02005473",4028,1034,517,517,2655,476,1208,486,528,194,558,268,264,26,374,237,137,39,39,339,160,179
"2021","South Holland 010","E02005474",3054,730,414,316,2130,477,1029,515,310,204,405,241,147,17,204,116,88,15,15,194,86,108
"2021","South Holland 011","E02005475",3036,742,352,390,2172,384,1072,448,427,197,481,266,190,25,226,155,71,9,9,122,47,75
"2021","South Kesteven 001","E02005476",3100,755,462,293,2238,470,1229,555,465,209,316,188,107,21,214,126,88,9,9,107,44,63
"2021","South Kesteven 002","E02005477",4028,1090,713,377,2808,780,1460,631,589,240,336,199,119,18,224,135,89,8,8,130,47,83
"2021","South Kesteven 003","E02005478",4377,1390,768,622,2800,521,1294,503,550,241,459,201,216,42,504,328,176,22,22,187,83,104
"2021","South Kesteven 004","E02005479",4380,1341,564,777,2898,502,1442,562,639,241,576,308,240,28,363,252,111,15,15,141,61,80
"2021","South Kesteven 005","E02005480",2933,719,307,412,2049,214,828,282,386,160,407,127,236,44,580,432,148,20,20,165,77,88
"2021","South Kesteven 006","E02005481",5593,1977,610,1367,3288,346,1348,507,628,213,868,493,330,45,685,483,202,41,41,328,112,216
"2021","South Kesteven 007","E02005482",4164,996,510,486,2999,632,1529,699,585,245,521,295,188,38,306,186,120,11,11,169,80,89
"2021","South Kesteven 008","E02005483",3375,859,437,422,2365,528,1246,548,460,238,362,195,146,21,216,125,91,13,13,151,57,94
"2021","South Kesteven 009","E02005484",3184,872,450,422,2199,423,1103,510,416,177,416,239,157,20,247,148,99,10,10,113,38,75
"2021","South Kesteven 010","E02005485",3546,928,482,446,2463,434,1199,433,586,180,480,253,205,22,332,221,111,18,18,155,67,88
"2021","South Kesteven 011","E02005486",4172,1295,626,669,2715,465,1275,468,611,196,498,251,217,30,456,310,146,21,21,162,63,99
"2021","South Kesteven 012","E02005487",4150,960,535,425,3037,697,1721,751,687,283,368,205,142,21,243,133,110,8,8,153,52,101
"2021","South Kesteven 013","E02005488",3110,899,467,432,2089,430,1032,423,442,167,334,169,153,12,283,189,94,10,10,122,48,74
"2021","South Kesteven 014","E02005489",3131,834,388,446,2197,409,1117,459,466,192,386,199,173,14,274,164,110,11,11,100,42,58
"2021","South Kesteven 015","E02005490",4180,1355,624,731,2644,417,1141,441,503,197,565,309,218,38,499,325,174,22,22,181,57,124
"2021","South Kesteven 016","E02005491",5442,1957,892,1065,3349,644,1559,655,698,206,649,401,212,36,479,324,155,18,18,136,45,91
"2021","West Lindsey 001","E02005492",4384,1280,652,628,2937,604,1525,735,557,233,462,268,174,20,329,205,124,17,17,167,75,92
"2021","West Lindsey 002","E02005493",4331,1132,583,549,3021,592,1515,673,592,250,563,294,224,45,332,210,122,19,19,178,84,94
"2021","West Lindsey 003","E02005494",4510,1515,787,728,2836,618,1339,634,485,220,504,264,211,29,367,231,136,8,8,159,63,96
"2021","West Lindsey 004","E02005495",5064,2123,675,1448,2722,323,1012,459,359,194,658,310,308,40,700,491,209,29,29,219,85,134
"2021","West Lindsey 005","E02005496",2791,739,358,381,1938,394,1021,501,341,179,312,175,125,12,200,114,86,11,11,114,46,68
"2021","West Lindsey 006","E02005497",3141,955,453,502,2075,248,785,333,307,145,462,172,260,30,558,407,151,22,22,111,61,50
"2021","West Lindsey 007","E02005498",3370,922,541,381,2319,660,1123,597,351,175,335,211,96,28,197,116,81,4,4,129,57,72
"2021","West Lindsey 008","E02005499",3631,951,528,423,2562,513,1352,505,616,231,372,176,174,22,323,218,105,2,2,118,54,64
"2021","West Lindsey 009","E02005500",3285,946,459,487,2247,456,1141,510,448,183,386,254,120,12,253,169,84,11,11,92,23,69
"2021","West Lindsey 010","E02005501",3554,934,586,348,2520,618,1260,492,559,209,410,234,154,22,222,139,83,10,10,100,50,50
"2021","West Lindsey 011","E02005502",4288,1178,631,547,2948,675,1412,597,586,229,505,299,181,25,349,206,143,7,7,162,67,95
"2021","Ashfield 001","E02005819",2786,794,365,429,1876,363,795,394,250,151,391,179,194,18,311,188,123,16,16,116,56,60
"2021","Ashfield 002","E02005820",2497,723,381,342,1688,371,757,324,262,171,323,152,143,28,225,125,100,12,12,86,38,48
"2021","Ashfield 003","E02005821",2982,1009,434,575,1859,263,793,328,325,140,452,210,212,30,341,227,114,10,10,114,58,56
"2021","Ashfield 004","E02005822",4317,1305,394,911,2776,245,1163,425,510,228,698,320,317,61,630,436,194,40,40,236,115,121
"2021","Ashfield 005","E02005823",3277,1165,543,622,1935,205,751,287,324,140,444,195,200,49,512,341,171,23,23,177,81,96
"2021","Ashfield 006","E02005824",4205,1100,516,584,2938,479,1413,587,529,297,606,289,259,58,413,258,155,27,27,167,66,101
"2021","Ashfield 007","E02005825",3260,883,383,500,2236,381,1003,409,380,214,461,195,233,33,375,266,109,16,16,141,65,76
"2021","Ashfield 008","E02005826",2627,876,375,501,1626,165,626,222,275,129,406,154,218,34,419,284,135,10,10,125,63,62
"2021","Ashfield 009","E02005827",3976,1044,479,565,2753,381,1366,510,579,277,629,325,268,36,349,202,147,28,28,179,80,99
"2021","Ashfield 010","E02005828",3399,954,461,493,2309,419,1085,481,383,221,472,236,202,34,316,185,131,17,17,136,58,78
"2021","Ashfield 011","E02005829",2832,807,415,392,1938,354,905,369,323,213,358,166,157,35,312,189,123,9,9,87,41,46
"2021","Ashfield 012","E02005830",2691,817,429,388,1774,353,846,384,291,171,328,182,124,22,236,132,104,11,11,100,38,62
"2021","Ashfield 013","E02005831",4494,1198,500,698,3134,441,1545,585,736,224,671,358,269,44,457,311,146,20,20,162,76,86
"2021","Ashfield 014","E02005832",4276,1583,555,1028,2497,264,959,373,400,186,671,372,275,24,574,387,187,29,29,196,70,126
"2021","Ashfield 015","E02005833",3193,766,422,344,2306,458,1164,449,444,271,398,181,185,32,276,166,110,10,10,121,65,56
"2021","Ashfield 016","E02005834",3707,1025,403,622,2498,316,992,377,432,183,626,297,295,34,543,368,175,21,21,184,94,90
"2021","Bassetlaw 001","E02005835",4967,1528,655,873,3269,504,1455,642,550,263,748,374,326,48,540,381,159,22,22,170,78,92
"2021","Bassetlaw 002","E02005836",4021,1051,581,470,2838,655,1400,626,523,251,475,239,195,41,300,182,118,8,8,132,57,75
"2021","Bassetlaw 003","E02005837",3025,755,408,347,2164,490,1118,509,402,207,348,214,106,28,200,126,74,8,8,106,36,70
"2021","Bassetlaw 004","E02005838",3668,1107,588,519,2428,480,1092,473,386,233,467,206,230,31,375,237,138,14,14,133,73,60
"2021","Bassetlaw 005","E02005839",2997,1058,593,465,1864,378,815,367,287,161,387,199,157,31,280,173,107,4,4,75,27,48
"2021","Bassetlaw 006","E02005840",3884,892,352,540,2833,331,1486,497,706,283,577,301,236,40,428,289,139,11,11,159,77,82
"2021","Bassetlaw 008","E02005842",4050,1402,608,794,2500,463,1057,444,430,183,490,241,230,19,476,323,153,14,14,148,64,84
"2021","Bassetlaw 009","E02005843",3017,831,289,542,2074,246,1042,436,439,167,445,222,200,23,317,219,98,24,24,112,52,60
"2021","Bassetlaw 010","E02005844",4025,1418,579,839,2474,329,1117,468,468,181,517,258,233,26,498,341,157,13,13,133,64,69
"2021","Bassetlaw 012","E02005846",2945,1086,349,737,1648,113,620,220,283,117,419,194,192,33,449,334,115,47,47,211,88,123
"2021","Bassetlaw 013","E02005847",3128,944,414,530,2046,357,917,385,359,173,451,260,163,28,299,181,118,22,22,138,62,76
"2021","Bassetlaw 014","E02005848",2745,728,406,322,1915,400,935,403,331,201,358,169,152,37,210,126,84,12,12,102,53,49
"2021","Bassetlaw 015","E02005849",3940,1038,581,457,2725,590,1423,645,536,242,415,237,148,30,283,167,116,14,14,177,73,104
"2021","Bassetlaw 016","E02006903",5030,1650,855,795,3212,609,1485,614,565,306,598,302,254,42,497,305,192,23,23,168,79,89
"2021","Broxtowe 001","E02005850",2961,827,440,387,2058,423,956,431,325,200,384,216,140,28,289,164,125,6,6,76,32,44
"2021","Broxtowe 002","E02005851",2782,931,420,511,1745,266,676,281,246,149,414,204,190,20,381,267,114,8,8,106,39,67
"2021","Broxtowe 003","E02005852",3714,1020,548,472,2585,616,1202,496,457,249,469,265,176,28,281,167,114,17,17,109,45,64
"2021","Broxtowe 004","E02005853",4015,1159,585,574,2711,479,1358,511,567,280,483,263,185,35,376,236,140,15,15,145,59,86
"2021","Broxtowe 007","E02005856",3125,839,512,327,2148,544,1131,422,515,194,270,157,94,19,191,93,98,12,12,138,51,87
"2021","Broxtowe 008","E02005857",2813,927,390,537,1790,262,696,250,316,130,438,229,188,21,382,256,126,12,12,96,35,61
"2021","Broxtowe 009","E02005858",3114,906,365,541,1902,266,941,331,453,157,382,265,102,15,272,156,116,41,41,306,76,230
"2021","Broxtowe 010","E02005859",4092,1283,528,755,2633,364,1194,404,530,260,556,292,224,40,492,316,176,27,27,176,70,106
"2021","Broxtowe 011","E02005860",4047,1526,612,914,1960,232,945,436,397,112,503,371,115,17,234,135,99,46,46,561,45,516
"2021","Broxtowe 012","E02005861",2534,910,303,607,1441,165,634,277,255,102,413,281,113,19,205,130,75,24,24,183,37,146
"2021","Broxtowe 013","E02005862",3357,1019,497,522,2188,387,1008,364,471,173,368,214,123,31,412,277,135,13,13,150,57,93
"2021","Broxtowe 014","E02005863",3210,924,488,436,2166,438,1138,424,529,185,338,199,114,25,240,130,110,12,12,120,36,84
"2021","Broxtowe 015","E02005864",3393,928,463,465,2345,389,1349,466,651,232,357,209,124,24,238,142,96,12,12,120,52,68
"2021","Broxtowe 016","E02006906",5195,1383,692,691,3567,686,1777,650,762,365,660,376,239,45,421,242,179,23,23,245,113,132
"2021","Gedling 001","E02005865",3659,885,524,361,2606,628,1352,538,590,224,374,192,152,30,247,141,106,5,5,168,69,99
"2021","Gedling 002","E02005866",4050,1139,598,541,2784,612,1296,525,528,243,466,212,215,39,401,224,177,9,9,127,66,61
"2021","Gedling 004","E02005868",3117,862,428,434,2146,369,1017,356,464,197,391,199,166,26,360,219,141,9,9,109,42,67
"2021","Gedling 005","E02005869",2436,756,333,423,1550,189,631,201,300,130,373,152,195,26,350,230,120,7,7,130,67,63
"2021","Gedling 006","E02005870",3014,1066,390,676,1815,175,710,256,307,147,439,215,185,39,471,306,165,20,20,133,58,75
"2021","Gedling 007","E02005871",3219,982,513,469,2126,437,973,372,408,193,413,235,157,21,294,163,131,9,9,111,42,69
"2021","Gedling 008","E02005872",2871,805,466,339,1956,464,947,343,459,145,344,201,128,15,188,112,76,13,13,110,59,51
"2021","Gedling 009","E02005873",4302,1226,664,562,2904,637,1537,522,720,295,453,251,181,21,266,158,108,11,11,172,72,100
"2021","Gedling 010","E02005874",3779,1147,547,600,2482,401,1225,445,577,203,525,328,168,29,313,167,146,18,18,150,39,111
"2021","Gedling 011","E02005875",3464,917,381,536,2420,303,1086,386,474,226,542,289,213,40,476,315,161,13,13,127,64,63
"2021","Gedling 012","E02005876",3746,1012,515,497,2563,414,1167,419,496,252,533,248,247,38,426,249,177,23,23,171,76,95
"2021","Gedling 013","E02005877",3244,1001,428,573,2052,264,907,341,395,171,447,247,171,29,409,258,151,25,25,191,63,128
"2021","Gedling 014","E02005878",4539,1724,730,994,2627,338,1165,467,464,234,595,322,226,47,501,298,203,28,28,188,79,109
"2021","Gedling 015","E02005879",3496,1272,371,901,2081,169,763,307,323,133,604,332,250,22,524,371,153,21,21,143,50,93
"2021","Gedling 016","E02006835",2616,720,285,435,1797,276,855,364,323,168,335,148,163,24,322,195,127,9,9,99,41,58
"2021","Mansfield 001","E02005880",2643,717,373,344,1798,252,822,333,311,178,377,156,182,39,334,201,133,13,13,128,74,54
"2021","Mansfield 002","E02005881",2664,745,352,393,1786,256,844,391,312,141,361,165,177,19,312,199,113,13,13,133,64,69
"2021","Mansfield 003","E02005882",3432,911,533,378,2410,503,1171,500,422,249,427,185,213,29,306,182,124,3,3,111,52,59
"2021","Mansfield 004","E02005883",3599,1151,484,667,2263,262,985,360,413,212,526,224,269,33,471,289,182,19,19,185,82,103
"2021","Mansfield 005","E02005884",2782,869,349,520,1774,318,812,383,266,163,359,186,148,25,274,163,111,11,11,139,64,75
"2021","Mansfield 006","E02005885",3891,1188,570,618,2521,388,1081,468,405,208,588,286,268,34,437,271,166,27,27,182,83,99
"2021","Mansfield 007","E02005886",4737,1140,595,545,3395,541,1707,634,731,342,627,295,290,42,495,297,198,25,25,202,88,114
"2021","Mansfield 008","E02005887",4586,1684,536,1148,2505,195,944,370,422,152,706,392,281,33,582,392,190,78,78,397,140,257
"2021","Mansfield 009","E02005888",3830,1438,437,1001,2159,170,844,335,335,174,543,279,231,33,564,403,161,38,38,233,92,141
"2021","Mansfield 010","E02005889",4563,1354,626,728,2957,417,1401,545,545,311,602,264,294,44,505,332,173,32,32,252,116,136
"2021","Mansfield 011","E02005890",2853,738,383,355,1969,384,1011,445,369,197,372,192,141,39,193,109,84,9,9,146,67,79
"2021","Mansfield 012","E02005891",2833,1069,334,735,1606,195,618,247,251,120,370,172,164,34,406,270,136,17,17,158,79,79
"2021","Mansfield 013","E02005892",5622,1469,692,777,3944,690,2065,785,983,297,770,448,282,40,402,262,140,17,17,209,93,116
"2021","Newark and Sherwood 001","E02005893",4928,1528,647,881,3199,483,1372,546,490,336,748,345,353,50,572,349,223,24,24,201,96,105
"2021","Newark and Sherwood 002","E02005894",4890,1301,621,680,3385,474,1638,611,751,276,798,407,345,46,460,294,166,15,15,204,93,111
"2021","Newark and Sherwood 003","E02005895",3532,864,560,304,2527,599,1335,636,478,221,371,214,132,25,215,113,102,7,7,141,67,74
"2021","Newark and Sherwood 004","E02005896",3384,921,579,342,2340,628,1146,492,454,200,347,190,130,27,215,118,97,4,4,123,49,74
"2021","Newark and Sherwood 005","E02005897",3971,1005,554,451,2830,605,1422,583,571,268,453,220,193,40,341,206,135,9,9,136,58,78
"2021","Newark and Sherwood 006","E02005898",4937,1441,649,792,3306,408,1531,638,603,290,741,368,316,57,609,404,205,17,17,190,85,105
"2021","Newark and Sherwood 007","E02005899",5539,2190,733,1457,2973,318,1183,486,498,199,834,476,318,40,587,378,209,51,51,376,118,258
"2021","Newark and Sherwood 008","E02005900",3219,1048,646,402,2071,575,1035,391,475,169,220,123,87,10,230,139,91,11,11,100,28,72
"2021","Newark and Sherwood 009","E02005901",4221,1309,525,784,2704,379,1238,505,554,179,612,326,256,30,443,298,145,32,32,208,87,121
"2021","Newark and Sherwood 010","E02005902",3594,1137,581,556,2272,349,964,427,338,199,468,209,231,28,472,307,165,19,19,185,81,104
"2021","Newark and Sherwood 011","E02005903",4631,1394,726,668,3071,601,1358,532,568,258,613,337,239,37,482,263,219,17,17,166,69,97
"2021","Newark and Sherwood 012","E02005904",3954,970,479,491,2833,508,1495,613,664,218,495,290,187,18,317,199,118,18,18,151,68,83
"2021","Newark and Sherwood 013","E02005905",2529,641,402,239,1804,442,1022,414,405,203,207,97,93,17,128,68,60,5,5,84,25,59
"2021","Rushcliffe 001","E02005906",2781,679,397,282,1992,464,1072,467,427,178,266,145,97,24,181,103,78,9,9,110,37,73
"2021","Rushcliffe 002","E02005907",4403,1299,646,653,2996,544,1464,467,796,201,512,294,202,16,456,308,148,20,20,108,34,74
"2021","Rushcliffe 003","E02005908",4104,1259,756,503,2690,615,1349,483,656,210,406,232,148,26,303,195,108,17,17,155,59,96
"2021","Rushcliffe 004","E02005909",3261,780,318,462,2250,258,1349,344,835,170,428,257,159,12,196,113,83,19,19,231,41,190
"2021","Rushcliffe 005","E02005910",3924,1471,483,988,1995,178,1034,299,627,108,504,389,103,12,250,164,86,29,29,458,51,407
"2021","Rushcliffe 006","E02005911",3515,964,418,546,2392,324,1419,411,798,210,364,234,111,19,268,169,99,17,17,159,55,104
"2021","Rushcliffe 007","E02005912",3906,1139,586,553,2560,423,1494,466,779,249,350,229,104,17,281,159,122,12,12,207,82,125
"2021","Rushcliffe 008","E02005913",3461,901,438,463,2413,411,1361,372,786,203,351,204,134,13,281,196,85,9,9,147,69,78
"2021","Rushcliffe 009","E02005914",3419,844,358,486,2450,340,1132,467,489,176,557,292,232,33,409,268,141,12,12,125,51,74
"2021","Rushcliffe 010","E02005915",2487,618,324,294,1788,440,921,376,388,157,261,160,85,16,160,94,66,6,6,81,33,48
"2021","Rushcliffe 011","E02005916",3325,999,445,554,2194,337,1123,369,590,164,425,254,159,12,297,191,106,12,12,132,48,84
"2021","Rushcliffe 012","E02005917",2526,582,402,180,1865,560,1011,386,448,177,192,96,85,11,95,49,46,7,7,79,31,48
"2021","Rushcliffe 013","E02005918",2322,736,442,294,1512,373,711,258,317,136,211,117,81,13,209,126,83,8,8,74,23,51
"2021","Rushcliffe 014","E02005919",2756,680,368,312,1953,341,992,355,468,169,348,213,112,23,255,156,99,17,17,123,32,91
"2021","Rushcliffe 015","E02005920",3690,875,502,373,2701,578,1405,497,667,241,460,267,173,20,248,162,86,10,10,114,41,73
"2021","Herefordshire 001","E02002905",2772,733,424,309,1917,496,962,463,316,183,289,176,94,19,165,86,79,5,5,122,44,78
"2021","Herefordshire 002","E02002906",2516,823,434,389,1601,315,675,271,267,137,324,136,171,17,279,182,97,8,8,92,36,56
"2021","Herefordshire 003","E02002907",2936,1139,503,636,1679,310,709,284,292,133,348,182,141,25,299,185,114,13,13,118,49,69
"2021","Herefordshire 004","E02002908",3915,1016,641,375,2711,712,1332,641,443,248,401,242,137,22,256,140,116,10,10,188,83,105
"2021","Herefordshire 005","E02002909",4861,1413,753,660,3245,786,1531,735,523,273,512,308,171,33,390,221,169,26,26,203,82,121
"2021","Herefordshire 006","E02002910",3555,1097,582,515,2310,562,1119,543,370,206,371,195,152,24,248,130,118,10,10,148,61,87
"2021","Herefordshire 007","E02002911",3999,1053,637,416,2774,611,1514,606,642,266,341,177,134,30,299,176,123,9,9,172,63,109
"2021","Herefordshire 008","E02002912",3169,794,431,363,2228,443,1157,444,496,217,352,202,135,15,268,148,120,8,8,147,72,75
"2021","Herefordshire 009","E02002913",2535,654,383,271,1770,524,863,434,292,137,219,130,72,17,156,78,78,8,8,111,39,72
"2021","Herefordshire 010","E02002914",4128,1451,646,805,2486,406,1140,454,485,201,481,266,186,29,421,252,169,38,38,191,77,114
"2021","Herefordshire 011","E02002915",3418,1046,504,542,2194,395,1102,427,459,216,377,212,143,22,309,189,120,11,11,178,58,120
"2021","Herefordshire 012","E02002916",4730,2016,711,1305,2402,239,1060,400,474,186,567,344,192,31,492,321,171,44,44,312,75,237
"2021","Herefordshire 013","E02002917",3103,1125,480,645,1791,274,815,280,370,165,406,231,149,26,279,140,139,17,17,187,56,131
"2021","Herefordshire 014","E02002918",2418,642,405,237,1676,382,884,278,428,178,209,94,95,20,189,106,83,12,12,100,33,67
"2021","Herefordshire 015","E02002919",3891,1243,534,709,2435,283,1128,374,545,209,459,205,216,38,530,338,192,35,35,213,102,111
"2021","Herefordshire 016","E02002920",2849,793,370,423,1932,340,989,382,426,181,342,194,132,16,245,148,97,16,16,124,56,68
"2021","Herefordshire 017","E02002921",3267,988,350,638,2077,190,832,268,413,151,443,160,242,41,593,404,189,19,19,202,88,114
"2021","Herefordshire 018","E02002922",2791,718,400,318,1917,438,1029,444,384,201,243,150,78,15,196,107,89,11,11,156,63,93
"2021","Herefordshire 019","E02002923",4475,1600,957,643,2739,683,1227,516,491,220,416,240,145,31,395,222,173,18,18,136,54,82
"2021","Herefordshire 020","E02002924",2620,746,481,265,1739,416,901,378,347,176,234,112,108,14,181,99,82,7,7,135,56,79
"2021","Herefordshire 021","E02002925",4585,1152,543,609,3176,653,1599,680,615,304,514,296,192,26,394,253,141,16,16,257,106,151
"2021","Herefordshire 022","E02002926",5198,1923,1004,919,3069,676,1345,569,531,245,564,294,239,31,461,288,173,23,23,206,77,129
"2021","Herefordshire 023","E02002927",5101,1265,746,519,3572,918,1865,893,640,332,492,306,154,32,282,152,130,15,15,264,107,157
"2021","Telford and Wrekin 001","E02002928",2561,706,401,305,1682,336,852,322,390,140,231,115,99,17,252,147,105,11,11,173,42,131
"2021","Telford and Wrekin 002","E02002929",2452,539,312,227,1765,407,981,407,396,178,237,131,91,15,135,69,66,5,5,148,54,94
"2021","Telford and Wrekin 003","E02002930",3103,1043,502,541,1890,357,835,308,397,130,382,201,165,16,307,204,103,9,9,170,49,121
"2021","Telford and Wrekin 004","E02002931",2693,599,323,276,1969,365,1102,451,450,201,274,136,116,22,218,130,88,10,10,125,53,72
"2021","Telford and Wrekin 005","E02002932",3562,980,380,600,2314,234,961,309,452,200,550,226,268,56,543,370,173,26,26,268,109,159
"2021","Telford and Wrekin 006","E02002933",3473,1008,497,511,2318,420,1121,444,444,233,441,237,176,28,326,198,128,10,10,147,63,84
"2021","Telford and Wrekin 007","E02002934",2567,687,305,382,1746,257,890,329,389,172,316,163,138,15,270,149,121,13,13,134,53,81
"2021","Telford and Wrekin 008","E02002935",2880,784,402,382,1909,339,833,316,326,191,374,171,179,24,344,217,127,19,19,187,74,113
"2021","Telford and Wrekin 009","E02002936",4170,994,341,653,2802,175,1338,381,733,224,680,331,311,38,555,391,164,54,54,374,178,196
"2021","Telford and Wrekin 010","E02002937",4554,1109,537,572,3215,624,1696,735,635,326,569,342,197,30,315,169,146,11,11,230,88,142
"2021","Telford and Wrekin 011","E02002938",2866,869,324,545,1750,219,857,293,407,157,311,161,127,23,328,198,130,35,35,247,128,119
"2021","Telford and Wrekin 012","E02002939",3498,1283,550,733,2042,335,877,344,383,150,463,270,170,23,351,212,139,16,16,173,75,98
"2021","Telford and Wrekin 013","E02002940",2713,930,409,521,1672,229,731,311,269,151,375,218,137,20,322,196,126,15,15,111,40,71
"2021","Telford and Wrekin 014","E02002941",4653,1471,627,844,2939,410,1349,552,540,257,638,328,274,36,516,326,190,26,26,243,105,138
"2021","Telford and Wrekin 015","E02002942",3007,531,203,328,2337,294,1300,434,640,226,433,224,185,24,301,237,64,9,9,139,59,80
"2021","Telford and Wrekin 017","E02002944",3505,1094,395,699,2186,206,858,318,362,178,529,254,233,42,556,374,182,37,37,225,94,131
"2021","Telford and Wrekin 018","E02002945",3759,1008,411,597,2432,281,1169,409,521,239,452,194,215,43,486,302,184,44,44,319,128,191
"2021","Telford and Wrekin 019","E02002946",3488,1180,478,702,2169,283,1014,438,367,209,448,229,186,33,402,247,155,22,22,139,58,81
"2021","Telford and Wrekin 020","E02002947",2755,668,245,423,1890,242,770,309,331,130,362,141,189,32,487,358,129,29,29,197,85,112
"2021","Telford and Wrekin 021","E02002948",2774,630,242,388,1900,141,654,207,311,136,448,143,268,37,639,472,167,18,18,244,109,135
"2021","Telford and Wrekin 022","E02002949",2565,978,460,518,1500,268,648,263,234,151,301,173,107,21,267,158,109,16,16,87,35,52
"2021","Telford and Wrekin 023","E02002950",2393,673,315,358,1566,242,556,221,212,123,299,120,153,26,444,300,144,25,25,154,61,93
"2021","Telford and Wrekin 024","E02007050",3250,762,213,549,2306,122,1133,344,642,147,643,316,300,27,389,274,115,19,19,182,97,85
"2021","Telford and Wrekin 025","E02007051",3269,680,175,505,2439,178,1223,381,695,147,651,338,285,28,372,269,103,15,15,150,77,73
"2021","Stoke-on-Trent 001","E02002951",3355,983,498,485,2243,382,1039,441,364,234,459,185,227,47,346,239,107,17,17,129,74,55
"2021","Stoke-on-Trent 002","E02002952",3090,891,382,509,2093,210,939,329,457,153,534,246,250,38,392,280,112,18,18,106,56,50
"2021","Stoke-on-Trent 003","E02002953",3153,996,533,463,2034,336,838,336,317,185,404,159,195,50,442,289,153,14,14,123,65,58
"2021","Stoke-on-Trent 004","E02002954",3600,1132,501,631,2330,314,1012,400,406,206,493,217,246,30,495,350,145,16,16,138,56,82
"2021","Stoke-on-Trent 005","E02002955",3043,1134,300,834,1691,112,753,231,425,97,360,174,170,16,430,306,124,36,36,218,127,91
"2021","Stoke-on-Trent 006","E02002956",3796,1118,420,698,2508,283,1066,401,456,209,510,212,266,32,616,383,233,33,33,170,83,87
"2021","Stoke-on-Trent 007","E02002957",4225,1217,662,555,2870,562,1381,558,558,265,530,265,235,30,381,230,151,16,16,138,56,82
"2021","Stoke-on-Trent 008","E02002958",3759,1268,519,749,2353,280,997,359,458,180,557,289,242,26,497,335,162,22,22,138,63,75
"2021","Stoke-on-Trent 009","E02002959",3991,1642,449,1193,2141,158,864,268,477,119,554,282,253,19,526,365,161,39,39,208,93,115
"2021","Stoke-on-Trent 010","E02002960",2464,667,324,343,1706,271,853,345,303,205,313,157,134,22,249,127,122,20,20,91,47,44
"2021","Stoke-on-Trent 011","E02002961",3005,1058,322,736,1739,152,838,238,472,128,368,197,152,19,350,236,114,31,31,208,106,102
"2021","Stoke-on-Trent 012","E02002962",3362,1097,519,578,2147,208,753,285,313,155,530,177,318,35,631,433,198,25,25,118,58,60
"2021","Stoke-on-Trent 013","E02002963",3414,1401,376,1025,1826,151,731,316,292,123,469,255,190,24,437,282,155,38,38,187,62,125
"2021","Stoke-on-Trent 014","E02002964",3874,1250,671,579,2472,450,1016,442,350,224,489,215,232,42,493,327,166,24,24,152,85,67
"2021","Stoke-on-Trent 015","E02002965",2923,1048,255,793,1599,65,835,164,558,113,262,176,78,8,376,265,111,61,61,276,126,150
"2021","Stoke-on-Trent 016","E02002966",4218,1676,408,1268,1873,129,825,252,488,85,503,312,176,15,348,250,98,68,68,669,114,555
"2021","Stoke-on-Trent 017","E02002967",4251,1390,460,930,2653,165,964,315,471,178,619,214,360,45,874,654,220,31,31,208,108,100
"2021","Stoke-on-Trent 018","E02002968",4154,1409,430,979,2434,269,1091,411,509,171,588,386,182,20,448,272,176,38,38,311,89,222
"2021","Stoke-on-Trent 019","E02002969",4323,1734,477,1257,2268,212,875,324,427,124,623,371,215,37,507,348,159,51,51,321,84,237
"2021","Stoke-on-Trent 020","E02002970",3793,1524,513,1011,2078,198,715,289,305,121,530,270,232,28,589,397,192,46,46,191,83,108
"2021","Stoke-on-Trent 023","E02002973",3427,1084,390,694,2140,199,990,306,469,215,434,223,184,27,490,296,194,27,27,203,78,125
"2021","Stoke-on-Trent 024","E02002974",2610,729,416,313,1792,360,816,329,331,156,348,142,185,21,261,143,118,7,7,89,38,51
"2021","Stoke-on-Trent 025","E02002975",3146,823,386,437,2236,346,1125,522,384,219,507,276,195,36,248,152,96,10,10,87,42,45
"2021","Stoke-on-Trent 026","E02002976",2388,592,304,288,1668,258,754,255,329,170,350,144,182,24,299,187,112,7,7,128,65,63
"2021","Stoke-on-Trent 027","E02002977",2699,1083,582,501,1522,336,592,264,200,128,306,160,122,24,275,173,102,13,13,94,42,52
"2021","Stoke-on-Trent 028","E02002978",2948,1013,386,627,1824,181,681,250,301,130,427,174,238,15,490,355,135,45,45,111,57,54
"2021","Stoke-on-Trent 029","E02002979",2160,654,222,432,1287,124,670,180,373,117,199,100,87,12,280,196,84,14,14,219,154,65
"2021","Stoke-on-Trent 030","E02002980",2670,783,469,314,1820,421,866,363,359,144,295,162,121,12,233,132,101,5,5,67,31,36
"2021","Stoke-on-Trent 031","E02002981",3332,869,391,478,2272,227,1068,355,524,189,434,172,230,32,529,402,127,14,14,191,112,79
"2021","Stoke-on-Trent 032","E02002982",3652,1093,379,714,2394,174,975,329,489,157,541,250,262,29,647,492,155,57,57,165,80,85
"2021","Stoke-on-Trent 033","E02002983",2254,537,289,248,1642,339,854,332,356,166,249,124,105,20,197,123,74,3,3,75,41,34
"2021","Stoke-on-Trent 034","E02002984",2259,521,293,228,1683,362,885,350,374,161,286,154,116,16,144,67,77,6,6,55,27,28
"2021","Stoke-on-Trent 035","E02006974",5055,1766,703,1063,3108,416,1284,547,465,272,688,305,343,40,687,436,251,33,33,181,70,111
"2021","Shropshire 025","E02006008",4519,1232,553,679,3124,484,1541,565,733,243,675,407,246,22,410,241,169,14,14,163,65,98
"2021","Shropshire 027","E02006009",2733,762,457,305,1811,424,918,337,391,190,259,146,93,20,197,110,87,13,13,160,64,96
"2021","Shropshire 029","E02006010",5176,1464,798,666,3477,747,1715,750,630,335,557,281,227,49,446,280,166,12,12,235,133,102
"2021","Shropshire 031","E02006011",2637,920,547,373,1645,414,794,302,351,141,239,123,100,16,190,102,88,8,8,72,25,47
"2021","Shropshire 033","E02006012",2925,1006,534,472,1829,436,831,393,271,167,315,185,102,28,234,147,87,13,13,90,38,52
"2021","Shropshire 034","E02006013",3239,727,441,286,2354,582,1255,541,441,273,301,162,109,30,209,116,93,7,7,158,71,87
"2021","Shropshire 035","E02006014",4126,1068,653,415,2837,705,1373,606,454,313,454,227,176,51,287,147,140,18,18,221,126,95
"2021","Shropshire 001","E02006015",4573,1491,725,766,2918,538,1337,592,499,246,608,321,262,25,409,254,155,26,26,164,82,82
"2021","Shropshire 002","E02006016",3412,763,429,334,2455,554,1286,579,474,233,408,248,134,26,196,95,101,11,11,194,81,113
"2021","Shropshire 004","E02006017",3541,1075,550,525,2318,557,1113,465,422,226,349,196,132,21,284,154,130,15,15,148,78,70
"2021","Shropshire 005","E02006018",5466,1682,833,849,3481,690,1535,624,623,288,736,349,325,62,494,314,180,26,26,303,183,120
"2021","Shropshire 008","E02006019",2830,1014,549,465,1721,379,818,312,343,163,283,131,130,22,231,129,102,10,10,95,35,60
"2021","Shropshire 009","E02006020",2596,525,264,261,1904,341,1050,472,394,184,319,162,128,29,187,107,80,7,7,167,83,84
"2021","Shropshire 010","E02006021",3534,735,411,324,2596,499,1449,592,567,290,399,226,152,21,238,143,95,11,11,203,87,116
"2021","Shropshire 013","E02006022",2452,551,320,231,1787,340,1014,427,418,169,261,139,103,19,161,95,66,11,11,114,50,64
"2021","Shropshire 003","E02006023",4183,1146,635,511,2854,554,1393,586,544,263,498,249,222,27,393,228,165,16,16,183,92,91
"2021","Shropshire 006","E02006024",4253,1320,681,639,2708,397,1228,473,499,256,567,249,274,44,494,285,209,22,22,225,96,129
"2021","Shropshire 007","E02006025",4475,1656,764,892,2593,499,1095,430,472,193,495,283,170,42,465,304,161,39,39,226,67,159
"2021","Shropshire 011","E02006026",3071,751,419,332,2168,441,1153,469,456,228,332,190,120,22,236,125,111,6,6,152,72,80
"2021","Shropshire 012","E02006027",2294,540,324,216,1620,386,818,355,283,180,272,150,110,12,139,71,68,5,5,134,61,73
"2021","Shropshire 014","E02006028",4005,1044,581,463,2741,572,1411,551,541,319,432,239,156,37,310,172,138,16,16,220,118,102
"2021","Shropshire 015","E02006029",3276,887,383,504,2187,303,918,322,374,222,487,224,225,38,453,291,162,26,26,202,90,112
"2021","Shropshire 016","E02006030",3387,833,342,491,2317,268,1036,356,426,254,586,280,265,41,407,266,141,20,20,237,99,138
"2021","Shropshire 017","E02006031",3841,1507,493,1014,2094,249,864,376,355,133,558,381,150,27,399,262,137,24,24,240,49,191
"2021","Shropshire 018","E02006032",3701,1132,540,592,2374,345,1031,365,464,202,486,219,231,36,488,317,171,24,24,195,75,120
"2021","Shropshire 019","E02006033",4356,1978,796,1182,2115,410,907,418,371,118,483,363,108,12,294,176,118,21,21,263,47,216
"2021","Shropshire 020","E02006034",4698,1463,591,872,3038,522,1577,555,808,214,546,318,208,20,375,226,149,18,18,197,64,133
"2021","Shropshire 021","E02006035",2727,880,534,346,1765,484,786,315,319,152,307,191,102,14,180,91,89,8,8,82,35,47
"2021","Shropshire 022","E02006036",3242,1258,542,716,1856,309,772,321,309,142,433,277,123,33,332,195,137,10,10,128,45,83
"2021","Shropshire 023","E02006037",4079,1211,629,582,2738,506,1432,484,683,265,396,188,154,54,394,239,155,10,10,130,44,86
"2021","Shropshire 024","E02006038",3597,949,537,412,2496,526,1213,451,523,239,447,238,193,16,302,175,127,8,8,152,63,89
"2021","Shropshire 026","E02006039",3547,939,552,387,2455,584,1194,516,467,211,399,218,152,29,268,158,110,10,10,153,59,94
"2021","Shropshire 028","E02006040",3163,778,409,369,2182,489,1188,544,433,211,323,192,112,19,171,84,87,11,11,203,112,91
"2021","Shropshire 030","E02006041",2516,718,401,317,1673,382,802,376,256,170,292,165,105,22,189,100,89,8,8,125,56,69
"2021","Shropshire 032","E02006042",2737,889,603,286,1746,608,748,382,220,146,210,128,66,16,174,91,83,6,6,102,38,64
"2021","Shropshire 036","E02006043",2950,784,441,343,2005,464,939,460,293,186,362,197,146,19,229,120,109,11,11,161,69,92
"2021","Shropshire 037","E02006044",2743,740,479,261,1910,554,963,480,267,216,267,144,107,16,117,63,54,9,9,93,40,53
"2021","Shropshire 038","E02006045",5100,1968,1126,842,2983,754,1251,558,431,262,560,273,231,56,403,231,172,15,15,149,58,91
"2021","Shropshire 039","E02006046",3876,1035,608,427,2641,649,1330,604,437,289,372,188,152,32,279,170,109,11,11,200,89,111
"2021","Cannock Chase 001","E02006118",3164,729,423,306,2312,548,1120,480,407,233,392,185,171,36,243,121,122,9,9,123,65,58
"2021","Cannock Chase 002","E02006119",3590,1224,511,713,2192,284,937,362,369,206,489,215,240,34,469,287,182,13,13,174,83,91
"2021","Cannock Chase 003","E02006120",3919,1083,508,575,2650,402,1206,469,498,239,572,243,292,37,448,276,172,22,22,186,85,101
"2021","Cannock Chase 004","E02006121",2538,662,286,376,1773,237,847,368,321,158,418,225,176,17,254,150,104,17,17,103,43,60
"2021","Cannock Chase 005","E02006122",3536,1032,363,669,2381,295,1089,422,458,209,630,329,267,34,346,217,129,21,21,123,61,62
"2021","Cannock Chase 006","E02006123",2668,671,265,406,1873,256,1002,366,410,226,369,202,145,22,239,146,93,7,7,124,59,65
"2021","Cannock Chase 007","E02006124",3110,940,424,516,2042,214,890,343,346,201,463,201,227,35,452,269,183,23,23,128,55,73
"2021","Cannock Chase 008","E02006125",3310,1089,467,622,2081,309,853,345,293,215,491,229,226,36,410,259,151,18,18,140,62,78
"2021","Cannock Chase 009","E02006126",3558,990,434,556,2418,372,1183,425,508,250,522,271,221,30,332,204,128,9,9,150,58,92
"2021","Cannock Chase 010","E02006127",2780,528,149,379,2170,189,1215,396,553,266,485,257,203,25,273,193,80,8,8,82,44,38
"2021","Cannock Chase 011","E02006128",3914,1306,689,617,2456,594,1132,443,426,263,421,223,174,24,288,157,131,21,21,152,72,80
"2021","Cannock Chase 012","E02006129",3838,1409,519,890,2277,272,865,322,345,198,642,302,306,34,460,301,159,38,38,152,63,89
"2021","Cannock Chase 013","E02006130",3525,906,418,488,2483,374,1140,443,472,225,596,310,250,36,362,241,121,11,11,136,68,68
"2021","East Staffordshire 001","E02006131",3192,802,422,380,2260,450,1208,501,451,256,354,182,152,20,236,129,107,12,12,130,58,72
"2021","East Staffordshire 002","E02006132",2931,769,370,399,2063,263,988,354,446,188,458,224,207,27,341,231,110,13,13,99,38,61
"2021","East Staffordshire 003","E02006133",3078,1004,463,541,1957,287,979,362,439,178,422,241,158,23,258,164,94,11,11,117,41,76
"2021","East Staffordshire 004","E02006134",4515,1164,654,510,3207,656,1655,647,718,290,522,291,202,29,355,211,144,19,19,144,66,78
"2021","East Staffordshire 005","E02006135",3412,927,508,419,2386,474,1287,561,484,242,370,205,145,20,251,142,109,4,4,99,50,49
"2021","East Staffordshire 006","E02006136",3380,795,505,290,2451,562,1389,589,552,248,288,163,94,31,198,98,100,14,14,134,63,71
"2021","East Staffordshire 007","E02006137",3787,1175,526,649,2378,263,1102,413,498,191,446,200,223,23,535,357,178,32,32,234,108,126
"2021","East Staffordshire 008","E02006138",3076,863,247,616,1947,105,910,253,517,140,481,236,219,26,421,293,128,30,30,266,144,122
"2021","East Staffordshire 009","E02006139",3325,1099,313,786,1927,145,942,252,540,150,412,246,154,12,375,249,126,53,53,299,151,148
"2021","East Staffordshire 010","E02006140",3452,976,471,505,2301,366,1086,403,471,212,446,215,201,30,389,256,133,14,14,175,87,88
"2021","East Staffordshire 011","E02006141",4889,1624,420,1204,2718,150,1202,355,678,169,691,391,271,29,583,411,172,92,92,547,251,296
"2021","East Staffordshire 012","E02006142",2250,592,312,280,1562,305,830,347,316,167,267,138,109,20,158,94,64,2,2,96,45,51
"2021","East Staffordshire 013","E02006143",3776,917,391,526,2669,328,1390,495,671,224,620,366,235,19,313,194,119,18,18,190,96,94
"2021","East Staffordshire 014","E02006144",3688,1358,538,820,2153,261,882,352,352,178,475,206,227,42,501,308,193,34,34,177,83,94
"2021","East Staffordshire 015","E02006145",2539,697,427,270,1771,393,998,328,492,178,214,109,92,13,162,93,69,4,4,71,39,32
"2021","Lichfield 001","E02006146",3771,1016,464,552,2599,439,1286,504,571,211,512,292,196,24,343,205,138,19,19,156,74,82
"2021","Lichfield 002","E02006147",3464,794,434,360,2544,488,1367,494,646,227,402,219,156,27,270,155,115,17,17,126,55,71
"2021","Lichfield 003","E02006148",3012,692,386,306,2206,568,1184,433,465,286,269,126,120,23,179,97,82,6,6,114,57,57
"2021","Lichfield 004","E02006149",5052,1962,933,1029,2923,470,1189,453,511,225,592,308,244,40,651,432,219,21,21,167,74,93
"2021","Lichfield 005","E02006150",5118,1534,784,750,3402,869,1701,661,717,323,490,292,178,20,322,144,178,20,20,182,70,112
"2021","Lichfield 006","E02006151",4252,1232,586,646,2881,488,1335,486,587,262,605,286,277,42,441,254,187,12,12,139,60,79
"2021","Lichfield 007","E02006152",4547,1337,611,726,3043,570,1493,465,770,258,559,328,204,27,402,252,150,19,19,167,64,103
"2021","Lichfield 008","E02006153",3762,815,377,438,2816,472,1450,532,681,237,574,330,221,23,304,198,106,16,16,131,55,76
"2021","Lichfield 009","E02006154",4229,1123,729,394,2966,803,1359,488,536,335,452,244,162,46,338,148,190,14,14,140,61,79
"2021","Lichfield 010","E02006155",2422,717,312,405,1616,190,672,241,275,156,370,151,191,28,372,247,125,12,12,89,49,40
"2021","Lichfield 011","E02006156",3166,687,438,249,2302,606,1277,441,556,280,248,125,97,26,160,75,85,11,11,177,96,81
"2021","Lichfield 012","E02006157",2823,752,370,382,1941,332,930,349,361,220,359,166,165,28,309,191,118,11,11,130,61,69
"2021","Newcastle-under-Lyme 001","E02006158",3528,862,438,424,2552,528,1306,565,460,281,456,252,170,34,255,135,120,7,7,114,55,59
"2021","Newcastle-under-Lyme 002","E02006159",2489,784,387,397,1622,250,705,275,254,176,359,159,178,22,303,207,96,5,5,83,43,40
"2021","Newcastle-under-Lyme 003","E02006160",3820,1154,563,591,2488,421,1052,443,390,219,555,259,266,30,448,281,167,12,12,178,78,100
"2021","Newcastle-under-Lyme 004","E02006161",2780,705,372,333,1986,343,1090,451,399,240,332,167,137,28,217,121,96,4,4,89,44,45
"2021","Newcastle-under-Lyme 005","E02006162",3701,1113,555,558,2447,444,1167,500,431,236,493,244,201,48,332,195,137,11,11,141,62,79
"2021","Newcastle-under-Lyme 006","E02006163",3197,805,358,447,2262,294,1015,349,418,248,469,202,222,45,465,300,165,19,19,130,58,72
"2021","Newcastle-under-Lyme 007","E02006164",3100,1012,389,623,1931,200,752,303,297,152,500,193,267,40,457,306,151,22,22,157,63,94
"2021","Newcastle-under-Lyme 008","E02006165",3521,1339,527,812,2062,275,885,342,364,179,547,305,216,26,341,215,126,14,14,120,57,63
"2021","Newcastle-under-Lyme 009","E02006166",3150,954,438,516,2102,365,1024,411,423,190,421,234,156,31,274,162,112,18,18,94,33,61
"2021","Newcastle-under-Lyme 010","E02006167",4309,1429,572,857,2569,268,1020,348,484,188,655,299,305,51,603,433,170,23,23,311,95,216
"2021","Newcastle-under-Lyme 011","E02006168",3993,1850,592,1258,1754,253,723,307,292,124,387,252,120,15,347,210,137,44,44,389,46,343
"2021","Newcastle-under-Lyme 012","E02006169",2428,767,348,419,1520,225,713,287,306,120,311,140,149,22,256,168,88,15,15,141,53,88
"2021","Newcastle-under-Lyme 013","E02006170",2323,713,403,310,1526,340,735,281,287,167,245,128,102,15,200,112,88,6,6,84,39,45
"2021","Newcastle-under-Lyme 014","E02006171",3983,1277,652,625,2512,485,1167,407,540,220,438,210,193,35,409,249,160,13,13,194,59,135
"2021","Newcastle-under-Lyme 015","E02006172",4110,1145,698,447,2803,702,1510,558,654,298,333,179,129,25,244,125,119,14,14,162,67,95
"2021","Newcastle-under-Lyme 016","E02006173",2994,677,401,276,2177,553,1154,538,407,209,296,173,97,26,161,78,83,13,13,140,60,80
"2021","South Staffordshire 001","E02006174",4699,1218,702,516,3303,752,1613,590,667,356,507,252,216,39,418,244,174,13,13,178,74,104
"2021","South Staffordshire 002","E02006175",2783,657,315,342,1994,238,974,405,361,208,451,188,226,37,318,179,139,13,13,132,70,62
"2021","South Staffordshire 003","E02006176",3186,853,528,325,2235,548,1176,498,429,249,286,158,107,21,214,114,100,11,11,98,51,47
"2021","South Staffordshire 004","E02006177",4200,1061,636,425,2986,612,1514,579,578,357,471,215,215,41,384,223,161,5,5,153,59,94
"2021","South Staffordshire 005","E02006178",3228,865,475,390,2228,439,1069,415,389,265,364,167,164,33,339,184,155,17,17,135,66,69
"2021","South Staffordshire 006","E02006179",2855,781,459,322,1980,418,1025,417,364,244,341,189,137,15,188,101,87,8,8,94,47,47
"2021","South Staffordshire 007","E02006180",2778,695,379,316,1952,314,958,345,376,237,351,149,170,32,314,200,114,15,15,131,58,73
"2021","South Staffordshire 008","E02006181",2554,857,452,405,1615,309,683,253,271,159,301,136,143,22,309,192,117,13,13,82,37,45
"2021","South Staffordshire 009","E02006182",2916,728,475,253,2072,462,1101,340,547,214,309,171,123,15,196,108,88,4,4,116,58,58
"2021","South Staffordshire 012","E02006185",3187,1055,633,422,2035,397,958,339,375,244,333,147,163,23,332,185,147,15,15,97,46,51
"2021","South Staffordshire 013","E02006186",5283,1392,840,552,3666,806,2056,753,822,481,472,264,164,44,315,170,145,17,17,225,88,137
"2021","South Staffordshire 014","E02006187",3123,855,552,303,2152,606,1048,435,370,243,290,160,101,29,198,103,95,10,10,116,51,65
"2021","South Staffordshire 015","E02006982",5336,1542,798,744,3623,665,1880,732,734,414,580,284,255,41,485,287,198,13,13,171,70,101
"2021","Stafford 001","E02006188",2573,642,354,288,1846,463,894,362,341,191,292,158,112,22,190,110,80,7,7,85,39,46
"2021","Stafford 002","E02006189",3113,817,490,327,2178,536,1103,505,404,194,318,188,110,20,210,115,95,11,11,118,56,62
"2021","Stafford 003","E02006190",5104,1803,833,970,3135,493,1398,537,639,222,673,378,256,39,550,355,195,21,21,166,62,104
"2021","Stafford 004","E02006191",3472,813,446,367,2562,554,1395,570,573,252,363,214,132,17,244,143,101,6,6,97,34,63
"2021","Stafford 005","E02006192",3950,1026,523,503,2776,579,1438,659,552,227,488,285,177,26,263,159,104,8,8,148,71,77
"2021","Stafford 006","E02006193",3246,840,453,387,2284,449,1133,439,493,201,472,287,163,22,223,135,88,7,7,122,55,67
"2021","Stafford 007","E02006194",3624,1063,481,582,2431,315,1005,397,415,193,568,279,248,41,520,358,162,23,23,130,55,75
"2021","Stafford 008","E02006195",3863,990,562,428,2757,687,1434,611,564,259,385,215,146,24,242,134,108,9,9,116,40,76
"2021","Stafford 009","E02006196",2918,986,336,650,1761,126,791,264,402,125,433,253,158,22,394,262,132,17,17,171,69,102
"2021","Stafford 010","E02006197",4883,2345,626,1719,2327,171,938,346,498,94,754,510,227,17,413,288,125,51,51,211,53,158
"2021","Stafford 011","E02006198",3683,945,413,532,2603,438,1391,521,652,218,469,286,166,17,298,190,108,7,7,135,54,81
"2021","Stafford 012","E02006199",3579,896,458,438,2545,512,1358,587,519,252,411,250,143,18,252,132,120,12,12,138,52,86
"2021","Stafford 013","E02006200",3463,1172,495,677,2156,263,839,334,350,155,482,206,235,41,551,368,183,21,21,135,59,76
"2021","Stafford 014","E02006201",5097,1194,787,407,3750,951,1968,643,988,337,437,221,193,23,386,230,156,8,8,153,69,84
"2021","Stafford 015","E02006202",4050,1058,602,456,2834,648,1488,674,509,305,456,260,158,38,233,133,100,9,9,158,56,102
"2021","Stafford 016","E02006203",3417,1161,474,687,2113,292,923,370,386,167,470,224,211,35,406,257,149,22,22,143,71,72
"2021","Staffordshire Moorlands 001","E02006204",3206,978,536,442,2098,343,970,409,359,202,433,205,195,33,339,199,140,13,13,130,63,67
"2021","Staffordshire Moorlands 002","E02006205",3191,829,524,305,2248,607,1163,502,407,254,329,186,118,25,141,62,79,8,8,114,53,61
"2021","Staffordshire Moorlands 003","E02006206",3400,1071,454,617,2192,204,989,355,421,213,491,216,236,39,491,337,154,17,17,137,66,71
"2021","Staffordshire Moorlands 004","E02006207",2849,822,509,313,1951,558,909,388,309,212,294,144,120,30,180,94,86,10,10,76,36,40
"2021","Staffordshire Moorlands 005","E02006208",3990,1737,607,1130,2141,286,863,370,352,141,537,290,224,23,431,279,152,24,24,112,51,61
"2021","Staffordshire Moorlands 006","E02006209",4615,1318,743,575,3148,680,1623,635,689,299,537,276,224,37,296,165,131,12,12,149,64,85
"2021","Staffordshire Moorlands 007","E02006210",2262,578,317,261,1567,381,832,382,282,168,215,135,65,15,133,62,71,6,6,117,66,51
"2021","Staffordshire Moorlands 008","E02006211",2742,693,458,235,1973,521,992,373,404,215,270,136,118,16,182,87,95,8,8,76,28,48
"2021","Staffordshire Moorlands 009","E02006212",3333,877,534,343,2344,559,1177,487,463,227,379,190,164,25,224,108,116,5,5,112,52,60
"2021","Staffordshire Moorlands 010","E02006213",2866,821,421,400,1922,377,907,394,319,194,373,209,137,27,256,144,112,9,9,123,52,71
"2021","Staffordshire Moorlands 011","E02006214",2887,1016,481,535,1792,359,785,327,291,167,327,157,141,29,315,207,108,6,6,79,35,44
"2021","Staffordshire Moorlands 012","E02006215",3420,896,519,377,2382,555,1190,505,436,249,387,202,155,30,242,121,121,8,8,142,56,86
"2021","Staffordshire Moorlands 013","E02006216",3594,899,499,400,2573,566,1390,559,547,284,361,176,157,28,248,143,105,8,8,122,60,62
"2021","Tamworth 001","E02006217",4188,1020,612,408,2986,555,1433,527,602,304,571,277,258,36,412,251,161,15,15,182,89,93
"2021","Tamworth 002","E02006218",4108,1674,804,870,2224,268,878,353,351,174,531,296,206,29,513,339,174,34,34,210,71,139
"2021","Tamworth 003","E02006219",3392,808,332,476,2395,359,1175,425,490,260,464,233,199,32,374,247,127,23,23,189,92,97
"2021","Tamworth 004","E02006220",3182,873,479,394,2166,409,1018,383,393,242,389,181,186,22,339,203,136,11,11,143,58,85
"2021","Tamworth 005","E02006221",2507,687,249,438,1721,203,919,360,374,185,333,178,134,21,246,159,87,20,20,99,43,56
"2021","Tamworth 006","E02006222",2794,728,363,365,1899,258,848,303,348,197,390,174,185,31,375,228,147,28,28,167,70,97
"2021","Tamworth 007","E02006223",2653,704,283,421,1799,152,666,194,318,154,372,120,227,25,590,411,179,19,19,150,78,72
"2021","Tamworth 008","E02006224",3009,653,233,420,2204,273,1160,462,461,237,479,223,223,33,278,166,112,14,14,152,78,74
"2021","Tamworth 009","E02006225",3042,681,370,311,2249,432,1164,434,489,241,397,206,175,16,243,142,101,13,13,112,54,58
"2021","Tamworth 010","E02006226",4022,959,376,583,2882,312,1344,469,598,277,653,291,319,43,554,364,190,19,19,181,77,104
"2021","North Warwickshire 001","E02006468",4521,1108,577,531,3188,573,1609,591,648,370,577,259,264,54,421,237,184,8,8,225,101,124
"2021","North Warwickshire 002","E02006469",3603,902,469,433,2496,352,1122,437,448,237,531,212,270,49,473,300,173,18,18,205,76,129
"2021","North Warwickshire 003","E02006470",5242,1782,761,1021,3229,516,1385,532,563,290,705,359,294,52,599,383,216,24,24,231,103,128
"2021","North Warwickshire 004","E02006471",2922,695,390,305,2062,429,1046,403,373,270,333,182,125,26,244,138,106,10,10,165,82,83
"2021","North Warwickshire 005","E02006472",4102,1070,476,594,2833,405,1293,529,490,274,629,302,284,43,494,303,191,12,12,199,93,106
"2021","North Warwickshire 006","E02006473",4528,1403,664,739,2963,516,1424,501,577,346,563,291,228,44,454,272,182,6,6,162,89,73
"2021","North Warwickshire 007","E02006474",2659,683,313,370,1826,330,915,389,343,183,363,194,144,25,209,117,92,9,9,150,65,85
"2021","Nuneaton and Bedworth 001","E02006475",4025,1026,528,498,2862,486,1438,502,708,228,526,282,207,37,400,269,131,12,12,137,72,65
"2021","Nuneaton and Bedworth 002","E02006476",3980,1120,372,748,2643,212,1063,392,486,185,637,291,300,46,693,494,199,38,38,217,104,113
"2021","Nuneaton and Bedworth 003","E02006477",3473,762,371,391,2534,439,1374,472,624,278,412,202,191,19,293,199,94,16,16,177,93,84
"2021","Nuneaton and Bedworth 004","E02006478",3402,804,302,502,2429,261,1264,474,518,272,530,254,246,30,364,239,125,10,10,169,87,82
"2021","Nuneaton and Bedworth 005","E02006479",4120,1614,456,1158,2198,210,1003,325,454,224,451,244,189,18,492,338,154,42,42,308,135,173
"2021","Nuneaton and Bedworth 006","E02006480",3216,957,402,555,2067,253,920,356,359,205,460,211,217,32,415,286,129,19,19,192,93,99
"2021","Nuneaton and Bedworth 007","E02006481",3035,897,369,528,1993,299,815,277,369,169,438,192,221,25,425,285,140,16,16,145,76,69
"2021","Nuneaton and Bedworth 008","E02006482",3029,827,331,496,2048,281,985,335,438,212,424,215,184,25,344,218,126,14,14,154,80,74
"2021","Nuneaton and Bedworth 009","E02006483",3193,1015,455,560,1956,219,895,264,424,207,353,141,178,34,455,282,173,34,34,222,113,109
"2021","Nuneaton and Bedworth 010","E02006484",3383,1127,427,700,2093,255,942,323,413,206,425,230,170,25,447,285,162,24,24,163,66,97
"2021","Nuneaton and Bedworth 011","E02006485",2808,645,421,224,2044,510,1130,455,399,276,252,141,94,17,139,61,78,13,13,119,49,70
"2021","Nuneaton and Bedworth 012","E02006486",3074,901,443,458,2025,350,970,363,355,252,355,158,175,22,338,208,130,12,12,148,77,71
"2021","Nuneaton and Bedworth 013","E02006487",3053,998,487,511,1922,331,758,276,297,185,376,161,184,31,430,290,140,27,27,133,70,63
"2021","Nuneaton and Bedworth 014","E02006488",2806,890,606,284,1802,524,822,341,282,199,250,125,107,18,197,99,98,9,9,114,41,73
"2021","Nuneaton and Bedworth 015","E02006489",3369,991,380,611,2181,227,993,322,454,217,451,217,206,28,484,332,152,26,26,197,101,96
"2021","Nuneaton and Bedworth 016","E02006490",3117,786,406,380,2157,309,1018,359,441,218,400,174,197,29,408,250,158,22,22,174,96,78
"2021","Nuneaton and Bedworth 018","E02006806",3493,983,432,551,2285,308,1066,363,456,247,423,184,205,34,469,309,160,19,19,225,124,101
"2021","Rugby 002","E02006493",4369,1097,317,780,2968,288,1563,550,752,261,617,349,242,26,463,300,163,37,37,304,123,181
"2021","Rugby 003","E02006494",3282,1255,462,793,1769,158,705,252,333,120,437,252,168,17,420,258,162,49,49,258,82,176
"2021","Rugby 004","E02006495",3326,893,459,434,2279,523,1123,410,504,209,358,180,148,30,263,142,121,12,12,154,72,82
"2021","Rugby 005","E02006496",2965,923,235,688,1675,105,738,226,386,126,438,273,146,19,347,216,131,47,47,367,119,248
"2021","Rugby 006","E02006497",3454,1088,357,731,2038,155,889,314,423,152,535,322,191,22,422,277,145,37,37,328,102,226
"2021","Rugby 007","E02006498",5341,1134,485,649,3962,493,2147,612,1223,312,664,329,305,30,638,453,185,20,20,245,116,129
"2021","Rugby 008","E02006499",2603,657,341,316,1825,298,1037,291,557,189,278,148,120,10,198,117,81,14,14,121,60,61
"2021","Rugby 009","E02006500",2448,864,444,420,1476,271,695,235,324,136,264,155,80,29,225,135,90,21,21,108,39,69
"2021","Rugby 010","E02006501",4208,1110,600,510,2922,504,1506,463,768,275,466,223,215,28,429,273,156,17,17,176,87,89
"2021","Rugby 011","E02006502",4716,1371,846,525,3135,722,1566,561,698,307,419,215,174,30,403,231,172,25,25,210,106,104
"2021","Rugby 012","E02006503",4226,1061,594,467,2997,628,1550,554,759,237,433,247,171,15,378,264,114,8,8,168,90,78
"2021","Rugby 013","E02007048",3027,706,386,320,2156,415,1197,493,496,208,350,215,117,18,180,91,89,14,14,165,77,88
"2021","Rugby 014","E02007049",3045,616,161,455,2248,141,1261,378,745,138,550,351,180,19,274,214,60,22,22,181,88,93
"2021","Stratford-on-Avon 001","E02006504",2378,494,287,207,1740,441,950,374,366,210,210,124,72,14,133,69,64,6,6,144,61,83
"2021","Stratford-on-Avon 002","E02006505",3233,1058,694,364,2062,522,1037,418,419,200,258,151,96,11,235,131,104,10,10,113,47,66
"2021","Stratford-on-Avon 003","E02006506",2646,814,441,373,1729,343,807,281,360,166,283,154,109,20,286,182,104,10,10,103,45,58
"2021","Stratford-on-Avon 004","E02006507",4803,1353,589,764,3291,519,1631,587,754,290,652,415,203,34,475,300,175,14,14,159,54,105
"2021","Stratford-on-Avon 005","E02006508",4680,1108,569,539,3379,620,1795,681,815,299,576,350,201,25,367,220,147,21,21,193,86,107
"2021","Stratford-on-Avon 006","E02006509",2803,1023,558,465,1688,387,753,296,313,144,268,143,103,22,269,153,116,11,11,92,27,65
"2021","Stratford-on-Avon 007","E02006510",2963,786,455,331,2031,564,1033,455,425,153,253,150,83,20,174,104,70,7,7,146,54,92
"2021","Stratford-on-Avon 008","E02006511",4549,1195,668,527,3188,633,1683,622,804,257,481,277,185,19,373,226,147,18,18,166,64,102
"2021","Stratford-on-Avon 009","E02006512",5708,1970,769,1201,3370,538,1508,614,649,245,725,489,207,29,546,342,204,53,53,368,92,276
"2021","Stratford-on-Avon 010","E02006513",3650,1046,592,454,2437,514,1279,448,631,200,319,192,116,11,306,191,115,19,19,167,53,114
"2021","Stratford-on-Avon 011","E02006514",4236,1599,866,733,2462,559,1226,468,552,206,366,236,110,20,292,138,154,19,19,175,54,121
"2021","Stratford-on-Avon 012","E02006515",4778,1229,617,612,3358,646,1759,724,774,261,558,310,216,32,378,226,152,17,17,191,82,109
"2021","Stratford-on-Avon 013","E02006516",4183,1098,518,580,2921,577,1565,642,656,267,474,297,149,28,287,162,125,18,18,164,50,114
"2021","Stratford-on-Avon 014","E02006517",4139,1032,494,538,2952,530,1555,579,724,252,514,295,209,10,345,239,106,8,8,155,58,97
"2021","Stratford-on-Avon 015","E02006518",4697,1499,813,686,3025,704,1467,636,581,250,489,296,163,30,349,204,145,16,16,173,51,122
"2021","Warwick 001","E02006519",3674,1205,656,549,2330,503,1149,437,546,166,398,249,134,15,262,149,113,18,18,139,36,103
"2021","Warwick 002","E02006520",3637,1045,532,513,2451,512,1341,440,669,232,334,193,120,21,257,147,110,7,7,141,39,102
"2021","Warwick 003","E02006521",3207,973,615,358,2138,534,1157,377,576,204,224,117,86,21,217,115,102,6,6,96,28,68
"2021","Warwick 004","E02006522",2455,613,333,280,1731,371,990,370,437,183,221,125,77,19,142,64,78,7,7,111,47,64
"2021","Warwick 005","E02006523",4331,1044,588,456,3090,620,1672,571,795,306,452,275,155,22,336,200,136,10,10,197,61,136
"2021","Warwick 006","E02006524",2364,716,300,416,1503,202,662,204,324,134,280,146,110,24,336,200,136,23,23,145,53,92
"2021","Warwick 007","E02006525",5903,2113,882,1231,3302,542,1722,574,926,222,660,505,130,25,326,172,154,52,52,488,61,427
"2021","Warwick 008","E02006526",3889,1247,534,713,2446,406,1180,420,527,233,468,275,173,20,361,206,155,31,31,196,59,137
"2021","Warwick 009","E02006527",4191,1472,500,972,2370,352,1191,411,622,158,547,404,126,17,260,149,111,20,20,349,64,285
"2021","Warwick 010","E02006528",4821,1681,483,1198,2492,260,1194,390,613,191,599,426,156,17,379,231,148,60,60,648,119,529
"2021","Warwick 011","E02006529",5603,1889,687,1202,3447,336,1700,548,909,243,787,494,257,36,592,396,196,32,32,267,91,176
"2021","Warwick 012","E02006530",5575,1607,674,933,3664,494,1999,613,1099,287,659,429,208,22,482,331,151,30,30,304,114,190
"2021","Warwick 013","E02006531",4070,1296,423,873,2053,130,1026,331,497,198,415,227,158,30,433,256,177,49,49,721,118,603
"2021","Warwick 014","E02006532",4735,1059,443,616,3489,477,1883,596,1028,259,645,400,222,23,468,345,123,16,16,187,74,113
"2021","Warwick 015","E02006533",4165,1039,453,586,2850,322,1625,501,811,313,489,299,171,19,391,219,172,23,23,276,103,173
"2021","Bromsgrove 001","E02006696",2873,705,423,282,2062,438,1143,265,705,173,227,120,100,7,251,157,94,3,3,106,59,47
"2021","Bromsgrove 002","E02006697",3086,829,477,352,2105,425,1214,473,485,256,279,143,117,19,182,102,80,5,5,152,71,81
"2021","Bromsgrove 003","E02006698",2690,677,400,277,1906,362,910,324,361,225,328,152,140,36,290,170,120,16,16,107,49,58
"2021","Bromsgrove 004","E02006699",2557,709,460,249,1770,401,860,282,380,198,238,122,102,14,263,169,94,8,8,78,39,39
"2021","Bromsgrove 005","E02006700",2575,646,394,252,1810,431,993,358,434,201,201,103,85,13,179,93,86,6,6,119,58,61
"2021","Bromsgrove 006","E02006701",2915,597,343,254,2233,412,1312,420,665,227,305,179,106,20,199,111,88,5,5,85,43,42
"2021","Bromsgrove 007","E02006702",2590,780,374,406,1712,270,782,293,327,162,313,161,121,31,337,214,123,10,10,98,44,54
"2021","Bromsgrove 008","E02006703",3229,724,404,320,2376,445,1300,446,619,235,373,209,144,20,253,135,118,5,5,129,62,67
"2021","Bromsgrove 009","E02006704",2880,787,444,343,1965,428,1029,372,481,176,274,147,100,27,222,133,89,12,12,128,66,62
"2021","Bromsgrove 010","E02006705",3160,972,431,541,2057,281,967,328,451,188,392,185,177,30,399,269,130,18,18,131,64,67
"2021","Bromsgrove 011","E02006706",3268,1411,694,717,1759,354,777,305,299,173,330,187,124,19,292,177,115,6,6,98,33,65
"2021","Bromsgrove 012","E02006707",2674,551,320,231,2042,371,1177,321,660,196,267,132,122,13,222,156,66,5,5,81,35,46
"2021","Bromsgrove 013","E02006708",3454,1082,421,661,2223,225,949,286,485,178,503,248,229,26,532,367,165,14,14,149,63,86
"2021","Bromsgrove 014","E02006709",3313,821,360,461,2382,420,1242,469,530,243,430,263,145,22,282,167,115,8,8,110,49,61
"2021","Malvern Hills 001","E02006710",3656,983,571,412,2504,597,1262,545,464,253,367,184,162,21,263,141,122,15,15,169,58,111
"2021","Malvern Hills 002","E02006711",3523,840,500,340,2522,550,1394,541,587,266,318,176,118,24,251,136,115,9,9,161,65,96
"2021","Malvern Hills 003","E02006712",3186,705,399,306,2320,568,1189,489,478,222,340,176,141,23,211,115,96,12,12,161,63,98
"2021","Malvern Hills 004","E02006713",3036,1151,671,480,1776,360,783,368,283,132,335,197,116,22,289,159,130,9,9,109,40,69
"2021","Malvern Hills 005","E02006714",2504,625,389,236,1777,458,919,386,357,176,222,132,76,14,166,87,79,12,12,102,43,59
"2021","Malvern Hills 006","E02006715",3797,1097,454,643,2541,439,1262,503,546,213,480,239,205,36,342,205,137,18,18,159,53,106
"2021","Malvern Hills 007","E02006716",2799,916,423,493,1779,236,713,261,294,158,377,150,204,23,441,298,143,12,12,104,51,53
"2021","Malvern Hills 008","E02006717",2943,691,434,257,2136,470,1088,470,455,163,351,200,136,15,219,145,74,8,8,116,53,63
"2021","Malvern Hills 009","E02006718",2803,1029,586,443,1672,434,721,319,277,125,273,142,107,24,236,130,106,8,8,102,30,72
"2021","Malvern Hills 010","E02006719",3420,1279,659,620,1999,583,894,431,315,148,303,194,88,21,212,107,105,7,7,142,37,105
"2021","Malvern Hills 011","E02006720",3230,983,547,436,2089,508,1052,462,393,197,297,178,100,19,212,128,84,20,20,158,53,105
"2021","Redditch 001","E02006721",2791,669,333,336,2004,416,996,395,404,197,346,187,134,25,240,164,76,6,6,118,54,64
"2021","Redditch 002","E02006722",2324,737,239,498,1453,132,573,189,294,90,344,166,161,17,389,273,116,15,15,134,50,84
"2021","Redditch 003","E02006723",3859,1132,405,727,2549,186,1157,381,596,180,615,320,263,32,572,409,163,19,19,178,86,92
"2021","Redditch 004","E02006724",2792,852,326,526,1623,111,707,206,364,137,358,187,148,23,401,268,133,46,46,317,145,172
"2021","Redditch 005","E02006725",2399,710,289,421,1566,220,703,271,304,128,306,157,131,18,325,188,137,12,12,123,58,65
"2021","Redditch 006","E02006726",2637,811,306,505,1621,202,798,263,357,178,322,176,129,17,278,175,103,21,21,205,78,127
"2021","Redditch 007","E02006727",2492,634,345,289,1712,337,851,311,369,171,280,149,119,12,230,118,112,14,14,146,67,79
"2021","Redditch 008","E02006728",3268,871,466,405,2268,384,1217,452,528,237,401,207,170,24,257,149,108,9,9,129,58,71
"2021","Redditch 009","E02006729",3034,632,320,312,2205,347,1042,356,470,216,458,211,209,38,343,209,134,15,15,197,92,105
"2021","Redditch 010","E02006730",2608,632,222,410,1769,172,691,189,362,140,439,194,214,31,447,317,130,20,20,207,94,113
"2021","Redditch 011","E02006731",2602,902,405,497,1618,258,756,321,279,156,323,168,132,23,271,161,110,10,10,82,26,56
"2021","Redditch 012","E02006732",2994,815,405,410,2079,366,1099,375,481,243,356,196,141,19,252,135,117,6,6,100,50,50
"2021","Redditch 013","E02006733",2586,705,346,359,1761,328,915,339,393,183,284,158,108,18,222,131,91,12,12,120,52,68
"2021","Worcester 001","E02006734",3550,990,540,450,2433,491,1279,453,636,190,406,241,140,25,239,130,109,18,18,127,37,90
"2021","Worcester 002","E02006735",2422,842,296,546,1474,116,526,183,219,124,328,116,179,33,483,362,121,21,21,106,51,55
"2021","Worcester 003","E02006736",2808,769,244,525,1931,172,1059,385,500,174,447,290,139,18,243,138,105,10,10,108,38,70
"2021","Worcester 004","E02006737",3718,1200,520,680,2325,289,1132,436,513,183,503,301,172,30,381,221,160,20,20,193,69,124
"2021","Worcester 005","E02006738",3719,1067,384,683,2389,190,996,336,485,175,598,287,263,48,569,373,196,36,36,263,116,147
"2021","Worcester 006","E02006739",2109,590,339,251,1289,315,586,212,229,145,243,138,88,17,128,75,53,17,17,230,26,204
"2021","Worcester 007","E02006740",3846,1867,532,1335,1686,170,640,305,253,82,589,471,109,9,243,139,104,44,44,293,44,249
"2021","Worcester 008","E02006741",2457,554,182,372,1783,182,1021,352,506,163,325,175,132,18,249,167,82,6,6,120,51,69
"2021","Worcester 009","E02006742",3771,1185,539,646,2157,299,880,294,418,168,500,249,212,39,449,288,161,29,29,429,94,335
"2021","Worcester 010","E02006743",2692,694,302,392,1759,192,869,255,437,177,328,169,134,25,341,220,121,29,29,239,120,119
"2021","Worcester 011","E02006744",3458,1476,406,1070,1724,188,757,258,384,115,441,309,116,16,299,214,85,39,39,258,94,164
"2021","Worcester 012","E02006745",3733,1026,523,503,2494,491,1182,423,532,227,473,273,165,35,333,205,128,15,15,213,76,137
"2021","Worcester 013","E02006746",3959,1214,449,765,2516,424,1175,437,564,174,557,357,174,26,343,200,143,17,17,229,67,162
"2021","Worcester 014","E02006747",2479,685,303,382,1710,244,901,343,368,190,350,200,129,21,207,123,84,8,8,84,31,53
"2021","Wychavon 001","E02006748",3652,906,421,485,2566,480,1293,478,584,231,473,275,176,22,314,216,98,6,6,180,81,99
"2021","Wychavon 002","E02006749",2240,670,308,362,1459,182,633,237,288,108,302,135,143,24,331,208,123,11,11,111,45,66
"2021","Wychavon 003","E02006750",2674,1089,631,458,1497,350,660,274,269,117,247,139,94,14,229,142,87,11,11,88,36,52
"2021","Wychavon 004","E02006751",2605,862,458,404,1654,337,745,260,312,173,288,122,142,24,277,158,119,7,7,89,42,47
"2021","Wychavon 005","E02006752",3452,752,407,345,2580,490,1329,484,608,237,444,238,180,26,308,213,95,9,9,120,43,77
"2021","Wychavon 006","E02006753",3072,719,403,316,2199,427,1194,475,533,186,326,174,129,23,251,153,98,1,1,154,67,87
"2021","Wychavon 007","E02006754",2425,512,280,232,1798,449,988,401,408,179,222,130,79,13,132,76,56,7,7,115,49,66
"2021","Wychavon 008","E02006755",2474,536,313,223,1807,471,1005,435,380,190,205,127,61,17,125,61,64,1,1,131,53,78
"2021","Wychavon 009","E02006756",2719,583,251,332,2023,313,1084,393,521,170,342,193,124,25,278,187,91,6,6,113,52,61
"2021","Wychavon 010","E02006757",3147,805,455,350,2217,555,1146,518,408,220,301,178,97,26,207,98,109,8,8,125,40,85
"2021","Wychavon 011","E02006758",2499,556,293,263,1844,361,931,401,355,175,332,187,125,20,214,127,87,6,6,99,36,63
"2021","Wychavon 012","E02006759",3969,1396,802,594,2446,574,1017,444,398,175,438,228,179,31,398,267,131,19,19,127,50,77
"2021","Wychavon 013","E02006760",3883,1016,568,448,2690,599,1335,596,509,230,434,229,171,34,314,178,136,8,8,177,55,122
"2021","Wychavon 014","E02006761",3062,1279,506,773,1538,171,607,233,279,95,409,246,145,18,306,196,110,45,45,245,87,158
"2021","Wychavon 015","E02006762",3109,855,399,456,2113,391,997,377,450,170,430,248,164,18,274,178,96,21,21,141,51,90
"2021","Wychavon 016","E02006763",3466,836,409,427,2432,417,1196,395,573,228,481,246,213,22,321,208,113,17,17,198,87,111
"2021","Wychavon 017","E02006764",2463,706,307,399,1614,218,780,286,361,133,337,176,144,17,265,155,110,14,14,143,57,86
"2021","Wychavon 018","E02006765",2993,930,574,356,1987,606,910,426,315,169,285,178,91,16,176,97,79,10,10,76,29,47
"2021","Wychavon 019","E02006766",3439,837,508,329,2487,690,1320,583,519,218,285,172,94,19,187,100,87,5,5,115,46,69
"2021","Wyre Forest 001","E02006767",4082,1160,693,467,2729,646,1339,533,535,271,426,236,153,37,305,184,121,13,13,193,91,102
"2021","Wyre Forest 002","E02006768",2995,781,442,339,2104,454,949,338,379,232,414,206,175,33,283,159,124,4,4,110,48,62
"2021","Wyre Forest 003","E02006769",3059,877,439,438,2045,375,976,364,423,189,424,233,169,22,260,140,120,10,10,137,52,85
"2021","Wyre Forest 004","E02006770",3810,1467,439,1028,2156,164,827,303,372,152,567,297,247,23,576,410,166,22,22,187,80,107
"2021","Wyre Forest 005","E02006771",3101,942,550,392,2056,536,898,384,345,169,312,176,109,27,301,170,131,9,9,103,44,59
"2021","Wyre Forest 006","E02006772",2919,900,485,415,1918,386,879,320,384,175,377,171,182,24,267,141,126,9,9,101,35,66
"2021","Wyre Forest 007","E02006773",3792,1374,708,666,2246,470,917,358,380,179,435,216,190,29,399,261,138,25,25,172,67,105
"2021","Wyre Forest 008","E02006774",3447,1177,473,704,2114,277,894,346,383,165,501,269,195,37,418,247,171,24,24,156,61,95
"2021","Wyre Forest 009","E02006775",2528,840,358,482,1546,167,616,233,249,134,405,160,215,30,350,229,121,8,8,142,61,81
"2021","Wyre Forest 010","E02006776",2845,799,381,418,1947,396,913,371,339,203,338,189,129,20,281,170,111,19,19,99,43,56
"2021","Wyre Forest 011","E02006777",3362,1067,612,455,2167,606,1007,492,311,204,296,179,94,23,247,135,112,11,11,128,61,67
"2021","Wyre Forest 012","E02006778",3013,777,471,306,2110,472,959,334,422,203,358,163,167,28,312,172,140,9,9,126,57,69
"2021","Wyre Forest 013","E02006779",3644,1364,670,694,2149,464,955,383,377,195,391,217,144,30,321,189,132,18,18,131,49,82
"2021","Wyre Forest 014","E02006780",2722,852,532,320,1780,440,712,305,242,165,301,142,136,23,315,175,140,12,12,90,34,56
"2021","Birmingham 001","E02001827",2633,736,455,281,1783,348,977,246,539,192,190,95,74,21,255,158,97,13,13,114,65,49
"2021","Birmingham 002","E02001828",3130,1049,621,428,1970,447,1021,279,551,191,238,123,97,18,254,163,91,10,10,111,50,61
"2021","Birmingham 003","E02001829",3573,825,478,347,2613,470,1534,375,910,249,293,148,124,21,310,184,126,6,6,135,77,58
"2021","Birmingham 004","E02001830",3991,1032,562,470,2767,669,1543,479,733,331,313,196,98,19,225,123,102,17,17,192,98,94
"2021","Birmingham 005","E02001831",4491,1419,641,778,2867,323,1288,343,681,264,455,209,208,38,768,469,299,33,33,205,98,107
"2021","Birmingham 006","E02001832",3435,1035,530,505,2261,456,1205,347,581,277,317,182,113,22,272,167,105,11,11,139,67,72
"2021","Birmingham 007","E02001833",2289,503,291,212,1645,280,881,265,396,220,204,72,107,25,265,151,114,15,15,141,78,63
"2021","Birmingham 008","E02001834",2408,663,278,385,1599,135,645,184,312,149,293,106,150,37,502,318,184,24,24,146,78,68
"2021","Birmingham 009","E02001835",3657,1259,514,745,2245,316,1193,340,628,225,434,266,133,35,286,175,111,16,16,153,54,99
"2021","Birmingham 010","E02001836",3701,958,532,426,2538,507,1384,417,671,296,343,182,131,30,281,158,123,23,23,205,99,106
"2021","Birmingham 011","E02001837",4039,1194,445,749,2493,142,959,244,481,234,434,141,232,61,895,584,311,63,63,352,190,162
"2021","Birmingham 012","E02001838",3166,840,466,374,2197,432,1212,400,549,263,317,183,121,13,228,117,111,8,8,129,55,74
"2021","Birmingham 013","E02001839",2825,972,447,525,1694,197,737,219,337,181,314,149,150,15,422,269,153,24,24,159,82,77
"2021","Birmingham 014","E02001840",3808,1292,494,798,2238,158,854,217,446,191,359,141,190,28,830,551,279,37,37,278,163,115
"2021","Birmingham 015","E02001841",2375,568,362,206,1674,440,932,282,429,221,150,79,60,11,141,67,74,11,11,133,71,62
"2021","Birmingham 016","E02001842",3179,849,371,478,2084,244,1028,295,502,231,288,138,126,24,492,278,214,32,32,246,126,120
"2021","Birmingham 017","E02001843",2837,903,428,475,1758,222,746,247,332,167,330,140,169,21,437,283,154,23,23,176,72,104
"2021","Birmingham 018","E02001844",4431,1787,790,997,2418,364,1209,425,539,245,426,259,135,32,396,231,165,23,23,226,89,137
"2021","Birmingham 019","E02001845",2723,789,312,477,1784,177,807,196,421,190,331,134,175,22,444,284,160,25,25,150,83,67
"2021","Birmingham 020","E02001846",3294,1104,397,707,1916,149,797,216,414,167,349,156,156,37,595,392,203,26,26,274,147,127
"2021","Birmingham 021","E02001847",2355,658,354,304,1592,311,795,252,369,174,240,122,93,25,235,137,98,11,11,105,54,51
"2021","Birmingham 022","E02001848",2597,664,216,448,1721,125,693,157,396,140,233,75,133,25,623,449,174,47,47,212,129,83
"2021","Birmingham 023","E02001849",3721,1307,339,968,2156,110,739,220,422,97,463,220,218,25,794,608,186,50,50,258,90,168
"2021","Birmingham 024","E02001850",3029,790,361,429,1881,198,996,209,575,212,202,75,106,21,437,245,192,48,48,358,219,139
"2021","Birmingham 025","E02001851",3851,1298,528,770,2318,221,1014,347,461,206,450,210,202,38,599,384,215,34,34,235,131,104
"2021","Birmingham 026","E02001852",2854,1023,377,646,1518,142,679,179,363,137,247,120,99,28,408,263,145,42,42,313,148,165
"2021","Birmingham 029","E02001855",4213,1482,589,893,2476,217,755,223,309,223,430,148,221,61,1031,679,352,43,43,255,150,105
"2021","Birmingham 030","E02001856",3607,1115,271,844,2023,105,959,240,551,168,302,136,153,13,596,370,226,61,61,469,198,271
"2021","Birmingham 031","E02001857",5575,2208,484,1724,2754,160,1091,304,581,206,509,283,189,37,900,562,338,94,94,613,254,359
"2021","Birmingham 032","E02001858",3231,1335,313,1022,1510,88,770,190,413,167,155,83,64,8,456,312,144,41,41,386,219,167
"2021","Birmingham 033","E02001859",2933,630,236,394,1750,81,1061,134,714,213,113,53,54,6,427,232,195,68,68,553,374,179
"2021","Birmingham 034","E02001860",2734,698,215,483,1578,93,807,90,538,179,129,37,78,14,497,289,208,52,52,458,287,171
"2021","Birmingham 035","E02001861",3480,1044,227,817,1894,77,965,133,641,191,135,54,70,11,657,447,210,60,60,542,361,181
"2021","Birmingham 036","E02001862",3231,808,283,525,1956,93,996,123,635,238,167,66,79,22,641,388,253,59,59,467,273,194
"2021","Birmingham 037","E02001863",2445,685,213,472,1341,50,765,75,559,131,75,28,35,12,403,218,185,48,48,419,304,115
"2021","Birmingham 039","E02001865",3374,773,213,560,1926,80,1003,131,659,213,125,38,72,15,623,382,241,95,95,675,429,246
"2021","Birmingham 040","E02001866",2803,816,184,632,1473,40,822,105,575,142,90,40,45,5,463,275,188,58,58,514,310,204
"2021","Birmingham 041","E02001867",2590,787,242,545,1421,34,774,77,588,109,79,16,60,3,483,261,222,51,51,382,272,110
"2021","Birmingham 042","E02001868",2630,463,248,215,1700,166,1080,141,737,202,122,43,58,21,300,194,106,32,32,467,336,131
"2021","Birmingham 043","E02001869",2488,856,246,610,1413,46,530,68,406,56,114,29,69,16,668,494,174,55,55,219,127,92
"2021","Birmingham 044","E02001870",3593,649,270,379,2434,108,1482,217,1021,244,146,44,80,22,649,415,234,49,49,510,360,150
"2021","Birmingham 045","E02001871",3558,1301,540,761,2056,189,754,215,380,159,377,147,189,41,700,489,211,36,36,201,109,92
"2021","Birmingham 046","E02001872",3080,1011,418,593,1872,152,642,195,318,129,394,155,201,38,669,458,211,15,15,197,104,93
"2021","Birmingham 047","E02001873",3983,1214,315,899,2259,90,929,151,614,164,210,89,97,24,919,646,273,111,111,510,259,251
"2021","Birmingham 048","E02001874",2681,559,182,377,1684,44,986,115,727,144,110,34,65,11,488,314,174,56,56,438,309,129
"2021","Birmingham 049","E02001875",3291,1168,234,934,1742,27,746,119,535,92,314,224,78,12,588,417,171,67,67,381,187,194
"2021","Birmingham 050","E02001876",3669,1565,261,1304,1712,27,669,152,467,50,289,201,81,7,622,445,177,105,105,392,140,252
"2021","Birmingham 051","E02001877",3157,592,187,405,1985,57,1212,129,867,216,84,20,55,9,585,376,209,47,47,580,424,156
"2021","Birmingham 052","E02001878",2708,655,138,517,1545,30,844,103,605,136,100,28,61,11,531,327,204,40,40,508,322,186
"2021","Birmingham 053","E02001879",3049,924,202,722,1610,57,790,106,534,150,168,79,80,9,537,339,198,58,58,515,260,255
"2021","Birmingham 054","E02001880",3430,855,292,563,2277,108,922,198,569,155,346,110,198,38,862,567,295,39,39,298,182,116
"2021","Birmingham 055","E02001881",2895,618,197,421,1855,76,1125,140,833,152,125,46,60,19,487,303,184,42,42,422,303,119
"2021","Birmingham 056","E02001882",3166,1070,410,660,1736,148,855,191,490,174,192,83,87,22,500,360,140,41,41,360,240,120
"2021","Birmingham 057","E02001883",3624,1314,464,850,2104,145,758,220,365,173,373,146,179,48,803,532,271,25,25,206,113,93
"2021","Birmingham 058","E02001884",2484,392,147,245,1666,36,1101,98,871,132,75,22,44,9,421,280,141,33,33,426,313,113
"2021","Birmingham 060","E02001886",3469,1103,242,861,1819,151,990,230,574,186,252,165,76,11,371,222,149,55,55,547,243,304
"2021","Birmingham 062","E02001888",2546,677,316,361,1653,114,724,173,405,146,228,83,107,38,555,346,209,32,32,216,136,80
"2021","Birmingham 063","E02001889",2238,353,123,230,1493,70,960,106,688,166,50,11,29,10,380,225,155,33,33,392,283,109
"2021","Birmingham 064","E02001890",4402,1970,511,1459,1926,182,991,336,513,142,377,313,56,8,285,171,114,91,91,506,117,389
"2021","Birmingham 066","E02001892",3467,788,268,520,2258,88,1253,189,890,174,174,68,78,28,698,463,235,45,45,421,315,106
"2021","Birmingham 067","E02001893",3162,901,432,469,1952,214,1068,260,575,233,233,106,95,32,397,198,199,40,40,309,201,108
"2021","Birmingham 069","E02001895",3535,1102,466,636,2183,195,846,247,421,178,367,148,180,39,739,492,247,36,36,250,133,117
"2021","Birmingham 070","E02001896",2569,484,155,329,1523,44,965,83,703,179,65,19,37,9,403,231,172,46,46,562,401,161
"2021","Birmingham 071","E02001897",2888,1062,269,793,1513,42,768,103,552,113,115,58,52,5,536,327,209,52,52,313,219,94
"2021","Birmingham 072","E02001898",2633,751,385,366,1728,262,869,258,389,222,290,127,135,28,291,155,136,16,16,154,92,62
"2021","Birmingham 073","E02001899",3550,1159,651,508,2089,388,1179,324,666,189,264,186,70,8,245,152,93,13,13,302,148,154
"2021","Birmingham 074","E02001900",2743,1108,357,751,1357,116,652,196,370,86,162,106,51,5,388,225,163,39,39,278,100,178
"2021","Birmingham 075","E02001901",3750,1365,459,906,2080,205,1095,336,628,131,502,404,86,12,244,154,90,34,34,305,40,265
"2021","Birmingham 076","E02001902",2461,688,311,377,1612,148,809,217,402,190,291,134,140,17,337,208,129,27,27,161,86,75
"2021","Birmingham 077","E02001903",2121,443,144,299,1249,39,749,79,550,120,39,12,17,10,389,206,183,33,33,429,315,114
"2021","Birmingham 078","E02001904",2622,750,298,452,1575,88,817,153,557,107,183,81,78,24,446,296,150,41,41,297,182,115
"2021","Birmingham 079","E02001905",2648,904,293,611,1429,188,783,258,411,114,241,186,48,7,169,98,71,48,48,315,91,224
"2021","Birmingham 080","E02001906",3878,1102,455,647,2526,310,1220,365,586,269,396,204,170,22,563,338,225,37,37,250,138,112
"2021","Birmingham 081","E02001907",4396,1410,570,840,2706,355,1223,383,544,296,519,272,208,39,563,329,234,46,46,280,148,132
"2021","Birmingham 082","E02001908",2208,372,134,238,1349,29,891,91,634,166,50,16,29,5,345,188,157,34,34,487,349,138
"2021","Birmingham 083","E02001909",2369,616,138,478,1378,46,778,86,529,163,89,32,48,9,419,244,175,46,46,375,282,93
"2021","Birmingham 084","E02001910",2338,814,192,622,1172,48,590,78,402,110,116,54,53,9,386,210,176,32,32,352,243,109
"2021","Birmingham 085","E02001911",3533,1219,453,766,2120,159,864,201,501,162,290,128,141,21,764,562,202,43,43,194,97,97
"2021","Birmingham 087","E02001913",3172,1243,477,766,1453,147,651,196,369,86,294,212,68,14,313,182,131,48,48,476,66,410
"2021","Birmingham 088","E02001914",2313,658,185,473,1276,125,699,158,408,133,209,121,81,7,227,128,99,16,16,379,202,177
"2021","Birmingham 089","E02001915",4920,1845,592,1253,2653,219,1282,354,674,254,461,252,184,25,637,387,250,54,54,422,201,221
"2021","Birmingham 090","E02001916",3380,921,306,615,2133,128,1149,217,755,177,237,110,100,27,569,371,198,50,50,326,190,136
"2021","Birmingham 092","E02001918",3975,1918,504,1414,1710,164,817,297,413,107,396,288,94,14,298,196,102,35,35,347,118,229
"2021","Birmingham 093","E02001919",2619,1140,273,867,1105,123,586,133,328,125,180,148,29,3,196,106,90,20,20,374,210,164
"2021","Birmingham 094","E02001920",3236,1102,408,694,1935,217,749,226,354,169,276,109,145,22,667,445,222,26,26,199,100,99
"2021","Birmingham 095","E02001921",3179,974,357,617,1966,205,874,222,493,159,353,181,141,31,496,319,177,38,38,239,89,150
"2021","Birmingham 096","E02001922",3501,621,125,496,728,32,264,62,173,29,159,113,40,6,221,158,63,52,52,2152,83,2069
"2021","Birmingham 097","E02001923",3368,831,410,421,2015,197,1188,188,740,260,146,68,57,21,448,229,219,36,36,522,369,153
"2021","Birmingham 098","E02001924",2502,700,285,415,1561,122,905,197,503,205,169,81,66,22,338,200,138,27,27,241,164,77
"2021","Birmingham 099","E02001925",2836,991,470,521,1569,217,790,241,431,118,271,149,112,10,272,155,117,19,19,276,64,212
"2021","Birmingham 100","E02001926",3091,981,333,648,1681,169,812,270,431,111,352,244,101,7,317,186,131,31,31,429,100,329
"2021","Birmingham 101","E02001927",3010,941,400,541,1852,136,789,240,388,161,300,112,161,27,598,392,206,29,29,217,118,99
"2021","Birmingham 102","E02001928",3000,1075,421,654,1791,232,701,236,286,179,274,103,144,27,564,361,203,20,20,134,78,56
"2021","Birmingham 103","E02001929",3727,973,329,644,2445,117,1080,216,662,202,331,114,170,47,878,595,283,39,39,309,196,113
"2021","Birmingham 104","E02001930",3213,1011,392,619,1919,166,962,286,524,152,453,316,123,14,308,181,127,30,30,283,94,189
"2021","Birmingham 105","E02001931",3166,945,431,514,1928,281,1084,273,567,244,206,119,72,15,340,177,163,17,17,293,176,117
"2021","Birmingham 106","E02001932",3075,1063,409,654,1852,138,717,212,378,127,335,157,149,29,638,451,187,24,24,160,80,80
"2021","Birmingham 107","E02001933",3152,1035,379,656,1892,157,831,228,461,142,382,219,136,27,480,293,187,42,42,225,114,111
"2021","Birmingham 108","E02001934",2289,492,245,247,1504,173,890,158,496,236,145,59,69,17,276,150,126,20,20,293,191,102
"2021","Birmingham 109","E02001935",3279,980,525,455,2141,326,997,271,494,232,284,116,137,31,517,333,184,17,17,158,85,73
"2021","Birmingham 110","E02001936",2557,712,386,326,1676,280,931,248,508,175,190,94,80,16,262,142,120,13,13,169,85,84
"2021","Birmingham 111","E02001937",3259,1084,396,688,1921,158,904,204,540,160,254,113,109,32,574,365,209,31,31,254,136,118
"2021","Birmingham 112","E02001938",3513,1181,352,829,2072,176,904,321,450,133,570,388,159,23,386,234,152,36,36,260,67,193
"2021","Birmingham 113","E02001939",3102,1377,589,788,1622,309,695,227,324,144,211,107,91,13,394,255,139,13,13,103,40,63
"2021","Birmingham 115","E02001941",2522,772,300,472,1558,124,619,159,340,120,253,112,121,20,531,346,185,31,31,192,108,84
"2021","Birmingham 116","E02001942",3008,1107,447,660,1756,195,765,240,364,161,316,170,128,18,462,324,138,18,18,145,62,83
"2021","Birmingham 117","E02001943",2638,831,328,503,1633,170,723,194,369,160,308,134,136,38,409,255,154,23,23,174,81,93
"2021","Birmingham 118","E02001944",3409,1118,398,720,2101,210,931,245,505,181,432,239,161,32,513,308,205,15,15,190,93,97
"2021","Birmingham 119","E02001945",3052,852,291,561,1956,128,717,211,350,156,357,135,178,44,721,483,238,33,33,244,128,116
"2021","Birmingham 120","E02001946",3208,967,469,498,2085,337,1039,346,460,233,343,174,145,24,350,199,151,16,16,156,76,80
"2021","Birmingham 121","E02001947",2664,1016,369,647,1495,119,480,141,248,91,230,96,105,29,637,414,223,29,29,153,81,72
"2021","Birmingham 122","E02001948",3051,932,396,536,1972,219,871,289,377,205,429,191,195,43,436,259,177,17,17,147,80,67
"2021","Birmingham 123","E02001949",2650,871,294,577,1653,160,603,208,288,107,367,182,167,18,503,362,141,20,20,126,64,62
"2021","Birmingham 124","E02001950",3707,1139,490,649,2393,330,1072,381,458,233,455,229,185,41,506,322,184,30,30,175,77,98
"2021","Birmingham 125","E02001951",3915,1285,489,796,2382,204,791,260,362,169,471,186,240,45,883,607,276,33,33,248,131,117
"2021","Birmingham 126","E02001952",4104,1637,579,1058,2260,179,719,240,345,134,417,183,197,37,898,612,286,47,47,207,113,94
"2021","Birmingham 127","E02001953",2924,840,442,398,1926,346,880,281,408,191,314,155,141,18,361,203,158,25,25,158,72,86
"2021","Birmingham 128","E02001954",3261,1213,472,741,1838,167,600,196,275,129,357,155,170,32,689,513,176,25,25,210,127,83
"2021","Birmingham 129","E02001955",3536,1236,509,727,2104,212,759,253,350,156,503,247,223,33,612,430,182,18,18,196,104,92
"2021","Birmingham 130","E02001956",2849,878,337,541,1818,194,790,257,370,163,393,186,174,33,428,285,143,13,13,153,82,71
"2021","Birmingham 131","E02001957",3348,965,435,530,2232,288,967,353,382,232,480,235,218,27,471,317,154,26,26,151,57,94
"2021","Birmingham 132","E02006807",3029,742,371,371,2086,271,1206,327,652,227,256,132,100,24,341,198,143,12,12,201,112,89
"2021","Birmingham 133","E02006809",3142,629,287,342,1967,216,1233,210,620,403,118,45,54,19,367,145,222,33,33,546,361,185
"2021","Birmingham 134","E02006895",4161,1855,245,1610,1865,31,692,267,386,39,477,400,70,7,556,399,157,109,109,441,76,365
"2021","Birmingham 135","E02006896",3158,1593,142,1451,1228,23,421,191,195,35,443,394,49,0,240,177,63,101,101,337,34,303
"2021","Birmingham 136","E02006897",4161,2257,205,2052,1574,26,569,230,304,35,451,381,65,5,418,295,123,110,110,330,59,271
"2021","Birmingham 137","E02006898",4245,1917,184,1733,1828,32,565,278,247,40,791,724,60,7,332,201,131,108,108,500,58,442
"2021","Birmingham 138","E02006899",4066,2387,91,2296,1329,12,411,283,113,15,698,669,26,3,96,68,28,112,112,350,12,338
"2021","Birmingham 139","E02006900",4055,748,236,512,2613,71,1618,189,1161,268,116,37,64,15,739,445,294,69,69,694,499,195
"2021","Birmingham 141","E02007038",5265,1633,608,1025,3223,257,1430,375,775,280,456,185,230,41,1012,643,369,68,68,409,225,184
"2021","Birmingham 142","E02007039",2171,380,148,232,1356,78,840,91,604,145,70,19,48,3,331,198,133,37,37,435,280,155
"2021","Birmingham 143","E02007040",2077,382,88,294,1382,46,865,103,665,97,90,31,47,12,357,239,118,24,24,313,199,114
"2021","Coventry 001","E02001958",3399,1175,401,774,1964,191,853,273,405,175,438,200,216,22,439,284,155,43,43,260,128,132
"2021","Coventry 002","E02001959",2583,592,305,287,1776,207,889,221,451,217,289,119,145,25,369,201,168,22,22,215,122,93
"2021","Coventry 004","E02001961",3268,1058,375,683,1963,152,792,219,395,178,325,137,160,28,663,442,221,31,31,247,122,125
"2021","Coventry 005","E02001962",2497,593,202,391,1593,86,805,168,477,160,274,116,133,25,397,236,161,31,31,311,176,135
"2021","Coventry 006","E02001963",2539,755,398,357,1645,225,792,246,339,207,313,159,134,20,305,169,136,10,10,139,70,69
"2021","Coventry 007","E02001964",4132,1102,400,702,2691,128,1069,276,636,157,535,197,295,43,914,690,224,45,45,339,204,135
"2021","Coventry 008","E02001965",3388,1027,460,567,2147,296,1086,367,469,250,324,149,148,27,418,269,149,23,23,214,95,119
"2021","Coventry 009","E02001966",2243,525,141,384,1339,51,758,107,517,134,138,57,76,5,356,243,113,36,36,379,212,167
"2021","Coventry 010","E02001967",2868,791,463,328,1937,420,974,290,481,203,297,142,133,22,239,122,117,7,7,140,70,70
"2021","Coventry 011","E02001968",2898,735,241,494,1912,149,949,207,536,206,298,124,153,21,479,303,176,37,37,251,133,118
"2021","Coventry 012","E02001969",2681,859,336,523,1576,139,700,186,367,147,283,129,123,31,431,245,186,23,23,246,146,100
"2021","Coventry 013","E02001970",2537,877,435,442,1515,261,665,207,325,133,275,144,113,18,297,155,142,17,17,145,66,79
"2021","Coventry 014","E02001971",2482,643,314,329,1701,217,853,266,407,180,305,127,148,30,309,176,133,17,17,138,71,67
"2021","Coventry 015","E02001972",4066,1193,282,911,2389,77,1247,208,868,171,356,155,186,15,637,440,197,72,72,484,263,221
"2021","Coventry 016","E02001973",3491,1111,328,783,2050,153,904,242,474,188,361,192,145,24,573,369,204,59,59,330,172,158
"2021","Coventry 017","E02001974",3943,1130,549,581,2585,347,1321,409,640,272,455,236,183,36,433,255,178,29,29,228,78,150
"2021","Coventry 018","E02001975",2905,708,339,369,1969,188,1013,269,520,224,351,154,172,25,402,234,168,15,15,228,124,104
"2021","Coventry 019","E02001976",3132,1039,464,575,1888,274,936,272,481,183,260,121,123,16,393,253,140,25,25,205,115,90
"2021","Coventry 020","E02001977",4190,1614,377,1237,1996,78,780,231,404,145,406,270,119,17,642,370,272,90,90,580,209,371
"2021","Coventry 021","E02001978",2584,672,256,416,1684,185,870,210,482,178,276,136,115,25,322,188,134,31,31,228,103,125
"2021","Coventry 022","E02001979",2416,719,390,329,1591,286,770,249,364,157,301,156,133,12,221,130,91,13,13,106,33,73
"2021","Coventry 023","E02001980",2566,750,446,304,1724,454,837,301,356,180,254,130,100,24,176,89,87,3,3,92,44,48
"2021","Coventry 024","E02001981",4359,1412,285,1127,2227,57,1009,194,670,145,374,170,189,15,679,506,173,108,108,720,244,476
"2021","Coventry 025","E02001982",3583,1069,410,659,2355,349,1125,360,577,188,453,255,173,25,412,273,139,16,16,159,57,102
"2021","Coventry 026","E02001983",3248,1010,394,616,2027,244,962,318,451,193,407,210,171,26,382,213,169,32,32,211,82,129
"2021","Coventry 027","E02001984",3959,999,337,662,2484,237,1266,381,635,250,454,212,202,40,473,289,184,54,54,476,210,266
"2021","Coventry 028","E02001985",3089,885,169,716,1180,46,380,110,200,70,225,124,89,12,348,229,119,181,181,1024,94,930
"2021","Coventry 029","E02001986",3655,1480,439,1041,1955,209,787,271,365,151,396,192,177,27,532,361,171,31,31,220,104,116
"2021","Coventry 030","E02001987",2781,1117,368,749,1191,131,374,157,174,43,376,272,96,8,267,170,97,43,43,473,44,429
"2021","Coventry 031","E02001988",3436,1828,353,1475,1208,77,433,171,206,56,307,238,60,9,295,195,100,96,96,400,58,342
"2021","Coventry 032","E02001989",2532,684,274,410,1618,175,760,239,371,150,334,170,144,20,328,207,121,21,21,230,58,172
"2021","Coventry 033","E02001990",3705,929,485,444,2565,465,1336,428,619,289,380,175,170,35,362,189,173,22,22,211,105,106
"2021","Coventry 034","E02001991",3625,1123,573,550,2170,412,1175,404,547,224,326,199,106,21,234,131,103,23,23,332,65,267
"2021","Coventry 035","E02001992",4182,1174,479,695,2691,222,1170,355,620,195,440,174,209,57,820,558,262,39,39,317,173,144
"2021","Coventry 036","E02001993",3313,955,365,590,1832,204,846,277,381,188,276,127,120,29,478,340,138,28,28,526,129,397
"2021","Coventry 037","E02001994",3253,960,459,501,2027,285,1104,308,574,222,258,146,100,12,352,181,171,28,28,266,108,158
"2021","Coventry 038","E02001995",4004,1328,414,914,2233,170,1133,344,669,120,457,287,146,24,378,233,145,95,95,443,115,328
"2021","Coventry 039","E02001996",3329,1287,358,929,1847,122,692,178,385,129,341,144,167,30,657,486,171,35,35,195,95,100
"2021","Coventry 040","E02001997",3410,875,521,354,2332,478,1374,384,699,291,200,109,74,17,264,130,134,16,16,203,91,112
"2021","Coventry 041","E02001998",2372,597,382,215,1641,303,945,237,506,202,188,75,100,13,192,89,103,13,13,134,66,68
"2021","Coventry 042","E02001999",2190,531,294,237,1281,255,746,239,336,171,106,47,43,16,156,82,74,18,18,378,89,289
"2021","Coventry 043","E02006805",3323,864,338,526,2146,149,1020,225,569,226,373,133,198,42,574,381,193,30,30,313,162,151
"2021","Dudley 001","E02002000",3630,1103,437,666,2394,301,949,304,407,238,499,188,273,38,635,395,240,10,10,133,80,53
"2021","Dudley 002","E02002001",2594,806,405,401,1663,236,772,252,311,209,308,123,153,32,334,191,143,13,13,125,65,60
"2021","Dudley 003","E02002002",3025,849,551,298,2074,624,1032,328,432,272,232,122,90,20,181,86,95,5,5,102,46,56
"2021","Dudley 004","E02002003",3817,1139,563,576,2508,440,1195,396,479,320,448,198,212,38,401,224,177,24,24,170,82,88
"2021","Dudley 005","E02002004",3123,898,401,497,2090,261,924,315,375,234,414,156,214,44,471,290,181,20,20,135,83,52
"2021","Dudley 006","E02002005",3625,821,356,465,2572,220,1079,316,543,220,486,161,273,52,758,537,221,29,29,232,147,85
"2021","Dudley 007","E02002006",2892,960,373,587,1819,206,786,276,316,194,358,157,178,23,456,320,136,13,13,113,56,57
"2021","Dudley 008","E02002007",3966,1220,722,498,2626,551,1206,403,488,315,491,200,261,30,368,203,165,10,10,120,53,67
"2021","Dudley 009","E02002008",3196,670,237,433,2377,269,1370,453,580,337,382,192,154,36,341,196,145,15,15,149,83,66
"2021","Dudley 010","E02002009",2636,743,241,502,1695,135,772,202,407,163,292,108,163,21,465,312,153,31,31,198,131,67
"2021","Dudley 011","E02002010",3626,1496,407,1089,1875,139,752,231,373,148,340,178,146,16,595,389,206,49,49,255,149,106
"2021","Dudley 012","E02002011",2603,760,434,326,1760,379,867,313,378,176,298,167,111,20,208,123,85,8,8,83,39,44
"2021","Dudley 013","E02002012",3615,1294,582,712,2152,243,905,296,412,197,417,188,197,32,559,351,208,28,28,169,104,65
"2021","Dudley 014","E02002013",2819,776,499,277,1962,474,1019,342,432,245,250,117,116,17,214,126,88,5,5,81,30,51
"2021","Dudley 015","E02002014",3171,973,253,720,1907,166,865,249,448,168,372,164,188,20,474,332,142,30,30,291,174,117
"2021","Dudley 016","E02002015",2950,794,377,417,2037,292,985,339,410,236,431,206,196,29,319,209,110,10,10,119,60,59
"2021","Dudley 017","E02002016",3317,1014,391,623,2157,216,819,276,337,206,442,161,242,39,639,428,211,41,41,146,84,62
"2021","Dudley 018","E02002017",3419,1162,457,705,2082,266,904,296,387,221,442,214,200,28,452,282,170,18,18,175,108,67
"2021","Dudley 019","E02002018",3707,914,622,292,2688,622,1394,430,603,361,364,154,176,34,299,158,141,9,9,105,55,50
"2021","Dudley 020","E02002019",3093,800,365,435,2138,254,920,292,388,240,408,176,200,32,539,362,177,17,17,155,87,68
"2021","Dudley 021","E02002020",4231,1304,654,650,2782,577,1299,488,548,263,533,286,216,31,359,221,138,14,14,145,63,82
"2021","Dudley 022","E02002021",3737,1703,423,1280,1881,157,675,265,296,114,494,287,186,21,520,371,149,35,35,153,79,74
"2021","Dudley 023","E02002022",3723,1069,398,671,2535,244,1049,373,474,202,629,282,301,46,597,398,199,16,16,119,64,55
"2021","Dudley 024","E02002023",2328,604,320,284,1662,327,716,253,293,170,337,169,145,23,275,126,149,7,7,62,31,31
"2021","Dudley 025","E02002024",3647,1025,421,604,2445,350,1142,428,494,220,518,219,263,36,420,252,168,15,15,177,86,91
"2021","Dudley 026","E02002025",3673,1127,451,676,2328,261,1094,366,507,221,459,229,195,35,488,326,162,26,26,218,123,95
"2021","Dudley 027","E02002026",2865,745,426,319,2009,390,997,393,371,233,324,131,159,34,289,163,126,9,9,111,73,38
"2021","Dudley 028","E02002027",2246,524,202,322,1655,290,979,373,370,236,252,136,103,13,129,64,65,5,5,67,33,34
"2021","Dudley 029","E02002028",2627,842,445,397,1699,361,780,310,306,164,305,167,118,20,239,138,101,14,14,86,44,42
"2021","Dudley 030","E02002029",2593,691,399,292,1804,350,859,274,385,200,260,120,123,17,326,192,134,9,9,98,48,50
"2021","Dudley 031","E02002030",3026,1046,411,635,1835,252,783,279,340,164,390,205,165,20,394,250,144,16,16,145,59,86
"2021","Dudley 032","E02002031",2562,841,333,508,1548,221,783,252,350,181,312,176,114,22,214,129,85,18,18,173,82,91
"2021","Dudley 033","E02002032",4269,1261,542,719,2788,323,1163,412,509,242,625,309,282,34,651,419,232,26,26,220,101,119
"2021","Dudley 034","E02002033",3304,987,530,457,2189,379,1056,312,475,269,386,192,173,21,352,210,142,16,16,128,58,70
"2021","Dudley 035","E02002034",3897,1543,600,943,2239,291,975,340,449,186,577,362,190,25,380,231,149,16,16,115,50,65
"2021","Dudley 036","E02002035",2515,663,405,258,1737,405,941,297,405,239,205,85,102,18,182,99,83,4,4,115,67,48
"2021","Dudley 037","E02002036",2880,1098,412,686,1583,180,662,202,304,156,335,143,159,33,390,248,142,16,16,199,110,89
"2021","Dudley 038","E02002037",2538,709,400,309,1746,337,838,259,378,201,307,138,137,32,255,139,116,9,9,83,39,44
"2021","Dudley 039","E02002038",4413,1615,726,889,2617,422,1114,388,502,224,494,271,197,26,558,331,227,29,29,181,73,108
"2021","Dudley 040","E02002039",2655,882,433,449,1688,331,821,272,375,174,301,187,101,13,219,124,95,16,16,85,48,37
"2021","Dudley 041","E02002040",2555,699,457,242,1747,507,923,306,430,187,178,100,61,17,134,74,60,5,5,109,48,61
"2021","Dudley 042","E02002041",2633,684,488,196,1834,461,889,315,373,201,205,105,79,21,269,169,100,10,10,115,71,44
"2021","Dudley 043","E02002042",3340,856,529,327,2364,512,1246,384,590,272,317,150,139,28,278,138,140,11,11,120,68,52
"2021","Sandwell 001","E02002043",3224,803,345,458,2206,232,1050,328,478,244,464,159,262,43,432,263,169,28,28,215,126,89
"2021","Sandwell 002","E02002044",2941,700,276,424,1977,151,977,239,511,227,328,126,169,33,498,333,165,23,23,264,184,80
"2021","Sandwell 003","E02002045",3184,951,408,543,2063,236,952,301,432,219,425,151,223,51,430,281,149,20,20,170,117,53
"2021","Sandwell 004","E02002046",2051,461,221,240,1461,114,625,176,282,167,268,53,182,33,434,298,136,20,20,129,73,56
"2021","Sandwell 005","E02002047",3090,1036,448,588,1858,284,821,317,325,179,356,153,175,28,383,254,129,14,14,196,132,64
"2021","Sandwell 006","E02002048",2720,737,408,329,1758,339,910,250,400,260,232,109,103,20,263,123,140,14,14,225,124,101
"2021","Sandwell 007","E02002049",2508,655,259,396,1712,206,786,282,285,219,331,118,182,31,376,263,113,13,13,141,90,51
"2021","Sandwell 009","E02002051",2241,520,247,273,1575,139,624,197,275,152,333,88,223,22,463,330,133,16,16,146,92,54
"2021","Sandwell 010","E02002052",4236,1121,431,690,2760,264,1260,337,602,321,449,134,278,37,757,512,245,30,30,355,223,132
"2021","Sandwell 011","E02002053",2537,744,334,410,1622,220,796,213,384,199,202,75,107,20,389,217,172,15,15,171,117,54
"2021","Sandwell 012","E02002054",2314,667,333,334,1489,235,679,163,316,200,197,87,88,22,354,189,165,24,24,158,94,64
"2021","Sandwell 013","E02002055",4180,1193,453,740,2574,252,1295,308,696,291,400,154,215,31,601,356,245,26,26,413,270,143
"2021","Sandwell 014","E02002056",3858,1161,395,766,2475,198,1035,283,511,241,527,187,290,50,680,444,236,35,35,222,147,75
"2021","Sandwell 015","E02002057",4275,1488,576,912,2454,215,1201,361,591,249,453,196,225,32,548,361,187,37,37,333,233,100
"2021","Sandwell 016","E02002058",4974,1436,446,990,3034,213,1527,387,801,339,505,231,246,28,724,446,278,65,65,504,347,157
"2021","Sandwell 017","E02002059",4572,1583,553,1030,2550,238,1298,318,669,311,360,178,153,29,619,349,270,35,35,439,284,155
"2021","Sandwell 018","E02002060",2632,740,283,457,1659,139,825,184,459,182,229,74,121,34,427,270,157,39,39,233,156,77
"2021","Sandwell 019","E02002061",2421,762,315,447,1299,122,729,179,387,163,153,64,83,6,270,174,96,25,25,360,239,121
"2021","Sandwell 020","E02002062",3492,1223,403,820,1884,123,893,219,486,188,293,135,133,25,543,328,215,32,32,385,236,149
"2021","Sandwell 021","E02002063",3936,1198,309,889,2408,174,1198,321,680,197,420,178,212,30,581,351,230,35,35,330,191,139
"2021","Sandwell 022","E02002064",4815,1221,453,768,3307,323,1592,459,752,381,605,231,325,49,750,531,219,37,37,287,178,109
"2021","Sandwell 023","E02002065",4144,812,293,519,2538,138,1538,203,1011,324,225,70,136,19,561,319,242,76,76,794,533,261
"2021","Sandwell 024","E02002066",2923,880,308,572,1725,126,880,171,537,172,200,86,100,14,460,278,182,59,59,318,188,130
"2021","Sandwell 025","E02002067",2501,618,333,285,1761,249,836,261,392,183,355,157,171,27,311,190,121,10,10,122,72,50
"2021","Sandwell 027","E02002069",3167,1141,417,724,1863,213,755,235,348,172,355,149,173,33,516,367,149,24,24,163,99,64
"2021","Sandwell 028","E02002070",3596,1157,411,746,1969,128,958,169,615,174,233,107,110,16,594,379,215,56,56,470,316,154
"2021","Sandwell 029","E02002071",2734,768,390,378,1818,235,736,231,317,188,369,136,195,38,459,321,138,19,19,148,82,66
"2021","Sandwell 030","E02002072",3610,1178,435,743,2148,233,1033,288,501,244,371,182,161,28,476,295,181,35,35,284,155,129
"2021","Sandwell 031","E02002073",2934,726,357,369,1927,166,961,211,512,238,262,93,128,41,510,300,210,28,28,281,177,104
"2021","Sandwell 032","E02002074",3162,876,420,456,2080,241,1011,264,492,255,316,114,157,45,486,265,221,26,26,206,126,80
"2021","Sandwell 033","E02002075",3683,1167,526,641,2281,275,1000,341,434,225,437,210,195,32,543,315,228,26,26,235,134,101
"2021","Sandwell 034","E02002076",4530,1421,459,962,2724,210,1212,380,635,197,632,379,226,27,605,373,232,65,65,385,147,238
"2021","Sandwell 035","E02002077",4514,1545,610,935,2690,290,1177,391,522,264,532,253,242,37,666,416,250,25,25,279,168,111
"2021","Sandwell 036","E02002078",2592,705,379,326,1716,267,900,240,450,210,227,98,112,17,304,149,155,18,18,171,108,63
"2021","Sandwell 037","E02002079",3533,1088,552,536,2237,263,1045,319,484,242,383,150,200,33,516,319,197,30,30,208,126,82
"2021","Sandwell 038","E02002080",3086,983,404,579,1975,230,869,307,392,170,398,178,191,29,464,319,145,14,14,128,71,57
"2021","Sandwell 039","E02006810",4315,1203,514,689,2797,465,1299,379,560,360,418,198,185,35,568,338,230,47,47,315,173,142
"2021","Sandwell 040","E02006943",2645,901,240,661,1442,46,727,112,508,107,184,87,85,12,443,290,153,42,42,302,197,105
"2021","Sandwell 041","E02006944",2356,466,79,387,1504,32,823,101,599,123,164,66,90,8,448,322,126,37,37,386,236,150
"2021","Solihull 001","E02002081",2365,746,406,340,1502,330,713,257,278,178,235,107,99,29,215,117,98,9,9,117,61,56
"2021","Solihull 002","E02002082",2316,673,270,403,1480,142,496,155,219,122,250,84,137,29,576,393,183,16,16,163,93,70
"2021","Solihull 003","E02002083",2416,574,389,185,1724,318,941,304,366,271,268,95,139,34,189,98,91,8,8,118,58,60
"2021","Solihull 004","E02002084",2757,830,305,525,1777,198,619,178,287,154,340,109,187,44,600,400,200,20,20,150,71,79
"2021","Solihull 005","E02002085",2653,735,355,380,1758,179,679,193,325,161,349,119,187,43,540,364,176,11,11,160,83,77
"2021","Solihull 006","E02002086",2652,1030,376,654,1503,150,487,153,191,143,295,102,166,27,561,415,146,10,10,119,55,64
"2021","Solihull 007","E02002087",2684,900,346,554,1664,139,543,162,229,152,306,88,174,44,659,473,186,17,17,120,62,58
"2021","Solihull 008","E02002088",4140,1394,501,893,2528,240,794,250,353,191,475,173,257,45,979,678,301,40,40,218,109,109
"2021","Solihull 009","E02002089",3254,895,439,456,2170,348,1004,314,419,271,440,209,177,54,369,232,137,9,9,189,93,96
"2021","Solihull 010","E02002090",2323,552,262,290,1651,194,902,257,433,212,277,135,125,17,262,127,135,16,16,120,67,53
"2021","Solihull 011","E02002091",3127,876,499,377,2073,316,1064,321,494,249,362,180,152,30,319,170,149,12,12,178,86,92
"2021","Solihull 012","E02002092",3038,969,484,485,1912,285,935,262,456,217,316,151,142,23,359,198,161,17,17,157,89,68
"2021","Solihull 013","E02002093",2949,1054,436,618,1742,281,873,272,412,189,277,171,92,14,291,178,113,20,20,153,63,90
"2021","Solihull 014","E02002094",2397,667,448,219,1605,353,950,277,464,209,152,77,64,11,140,75,65,10,10,125,66,59
"2021","Solihull 015","E02002095",3631,1082,518,564,2366,428,1215,373,599,243,327,167,135,25,378,223,155,18,18,183,87,96
"2021","Solihull 016","E02002096",4274,1258,737,521,2785,596,1500,398,807,295,323,198,106,19,349,189,160,17,17,231,128,103
"2021","Solihull 017","E02002097",3115,883,459,424,2090,405,1166,418,516,232,276,179,80,17,229,131,98,14,14,142,70,72
"2021","Solihull 018","E02002098",3904,1103,608,495,2596,431,1465,360,807,298,277,119,135,23,407,226,181,16,16,205,114,91
"2021","Solihull 019","E02002099",2808,752,443,309,1930,453,1198,353,608,237,139,85,37,17,132,68,64,8,8,126,59,67
"2021","Solihull 021","E02002101",2863,1028,509,519,1733,297,824,265,367,192,279,146,115,18,326,201,125,7,7,102,44,58
"2021","Solihull 022","E02002102",3529,1012,537,475,2333,367,1265,297,701,267,298,157,128,13,383,225,158,20,20,184,101,83
"2021","Solihull 023","E02002103",2545,690,449,241,1742,385,956,284,452,220,204,114,77,13,188,79,109,9,9,113,55,58
"2021","Solihull 024","E02002104",2377,570,315,255,1729,346,1052,336,487,229,142,78,54,10,183,93,90,6,6,78,37,41
"2021","Solihull 025","E02002105",3341,804,482,322,2396,540,1346,405,671,270,271,142,108,21,235,131,104,4,4,141,69,72
"2021","Solihull 026","E02002106",4083,1139,737,402,2831,738,1558,459,815,284,231,116,99,16,294,173,121,10,10,113,53,60
"2021","Solihull 027","E02002107",2255,548,260,288,1623,334,935,300,435,200,160,104,49,7,190,105,85,4,4,84,35,49
"2021","Solihull 028","E02002108",3978,1009,685,324,2864,624,1702,473,944,285,238,127,98,13,291,182,109,9,9,105,50,55
"2021","Solihull 029","E02002109",5048,1344,415,929,3515,458,1863,528,1012,323,670,443,213,14,503,365,138,21,21,189,79,110
"2021","Solihull 030","E02006808",2672,735,355,380,1799,240,1016,255,552,209,288,148,128,12,241,136,105,14,14,138,72,66
"2021","Walsall 001","E02002110",2830,735,306,429,1958,250,943,328,400,215,420,203,187,30,334,206,128,11,11,137,81,56
"2021","Walsall 002","E02002111",2765,920,445,475,1730,265,687,248,259,180,380,154,185,41,382,267,115,16,16,115,69,46
"2021","Walsall 003","E02002112",2211,570,332,238,1563,280,778,279,312,187,269,119,121,29,223,128,95,13,13,78,38,40
"2021","Walsall 004","E02002113",2692,770,337,433,1789,265,773,279,318,176,353,152,180,21,378,255,123,20,20,133,62,71
"2021","Walsall 005","E02002114",2678,833,503,330,1732,359,779,282,313,184,304,141,130,33,279,148,131,11,11,113,54,59
"2021","Walsall 006","E02002115",2840,854,482,372,1860,271,798,256,325,217,363,128,189,46,416,262,154,12,12,126,60,66
"2021","Walsall 007","E02002116",2910,793,453,340,2027,431,989,357,411,221,336,159,146,31,258,121,137,13,13,90,38,52
"2021","Walsall 008","E02002117",2781,950,408,542,1729,267,829,314,316,199,360,183,144,33,251,146,105,22,22,102,41,61
"2021","Walsall 009","E02002118",3031,885,457,428,1990,223,751,243,308,200,457,156,253,48,529,338,191,30,30,156,88,68
"2021","Walsall 010","E02002119",2441,621,333,288,1676,257,809,261,328,220,282,115,140,27,313,168,145,15,15,144,78,66
"2021","Walsall 011","E02002120",2356,493,251,242,1754,285,913,309,358,246,291,98,164,29,260,166,94,5,5,109,67,42
"2021","Walsall 012","E02002121",2559,736,327,409,1680,150,685,208,324,153,368,140,193,35,450,307,143,27,27,143,88,55
"2021","Walsall 013","E02002122",2494,548,213,335,1784,96,736,193,418,125,416,133,250,33,518,395,123,18,18,162,106,56
"2021","Walsall 014","E02002123",2694,740,336,404,1817,257,742,228,327,187,393,142,217,34,407,266,141,18,18,137,70,67
"2021","Walsall 015","E02002124",3194,1166,673,493,1916,344,802,285,329,188,363,174,163,26,385,246,139,22,22,112,48,64
"2021","Walsall 016","E02002125",2745,839,350,489,1780,219,742,258,312,172,360,164,171,25,399,252,147,60,60,126,74,52
"2021","Walsall 017","E02002126",2731,854,339,515,1726,130,614,211,253,150,405,128,234,43,565,399,166,12,12,151,91,60
"2021","Walsall 018","E02002127",3440,872,300,572,2252,136,1059,281,604,174,400,150,207,43,620,450,170,37,37,316,222,94
"2021","Walsall 019","E02002128",2424,755,376,379,1549,310,658,220,263,175,287,108,157,22,289,165,124,5,5,120,61,59
"2021","Walsall 020","E02002129",2570,735,375,360,1741,314,791,286,295,210,321,136,160,25,300,154,146,15,15,94,58,36
"2021","Walsall 021","E02002130",2583,683,310,373,1722,155,762,216,388,158,319,113,182,24,462,302,160,24,24,178,109,69
"2021","Walsall 022","E02002131",3179,810,545,265,2245,493,1226,367,545,314,273,124,120,29,239,99,140,14,14,124,69,55
"2021","Walsall 023","E02002132",2576,715,347,368,1722,205,715,227,337,151,308,103,182,23,476,311,165,18,18,139,85,54
"2021","Walsall 024","E02002133",3059,1219,399,820,1628,254,763,266,340,157,268,138,104,26,318,182,136,25,25,212,112,100
"2021","Walsall 025","E02002134",3619,997,328,669,2369,191,969,296,449,224,506,196,281,29,672,411,261,31,31,253,161,92
"2021","Walsall 026","E02002135",2924,905,244,661,1729,111,806,204,471,131,292,136,134,22,454,289,165,66,66,290,177,113
"2021","Walsall 027","E02002136",3262,1015,317,698,2006,188,884,260,428,196,416,171,224,21,461,293,168,57,57,241,136,105
"2021","Walsall 028","E02002137",2567,726,491,235,1733,413,965,288,470,207,179,94,68,17,166,78,88,10,10,108,59,49
"2021","Walsall 029","E02002138",2261,638,283,355,1373,182,794,184,422,188,149,75,59,15,234,140,94,14,14,250,174,76
"2021","Walsall 030","E02002139",4315,1745,407,1338,2202,127,975,248,556,171,394,235,140,19,649,465,184,57,57,368,231,137
"2021","Walsall 031","E02002140",2959,783,331,452,1886,132,1046,220,645,181,206,92,97,17,466,312,154,36,36,290,181,109
"2021","Walsall 032","E02002141",2601,627,362,265,1843,372,993,284,474,235,256,111,123,22,211,102,109,11,11,131,70,61
"2021","Walsall 033","E02002142",2714,708,233,475,1795,114,796,184,432,180,317,132,171,14,547,391,156,21,21,211,147,64
"2021","Walsall 034","E02002143",3129,695,266,429,2049,119,1236,181,848,207,164,66,89,9,495,319,176,35,35,385,265,120
"2021","Walsall 035","E02002144",2476,585,411,174,1594,372,954,233,462,259,88,47,30,11,164,83,81,16,16,297,187,110
"2021","Walsall 036","E02002145",3269,949,308,641,2119,145,922,238,496,188,376,131,221,24,646,456,190,30,30,201,120,81
"2021","Walsall 037","E02002146",2180,521,270,251,1424,156,757,157,423,177,179,72,84,23,311,199,112,21,21,235,167,68
"2021","Walsall 038","E02002147",3482,884,356,528,2377,199,987,277,491,219,511,174,290,47,648,457,191,32,32,221,129,92
"2021","Walsall 039","E02002148",4695,1260,719,541,3216,515,1592,466,745,381,565,258,264,43,526,301,225,18,18,219,137,82
"2021","Wolverhampton 001","E02002149",4268,1261,661,600,2790,385,1256,485,493,278,513,192,264,57,615,341,274,21,21,217,109,108
"2021","Wolverhampton 002","E02002150",2261,590,283,307,1512,159,730,233,326,171,250,101,117,32,356,221,135,17,17,159,95,64
"2021","Wolverhampton 003","E02002151",2455,897,325,572,1449,124,615,234,242,139,295,132,145,18,398,247,151,17,17,109,65,44
"2021","Wolverhampton 004","E02002152",2302,576,261,315,1560,124,621,175,294,152,253,73,150,30,536,361,175,26,26,166,97,69
"2021","Wolverhampton 005","E02002153",3350,1123,524,599,2108,302,856,312,322,222,453,197,220,36,478,301,177,19,19,119,58,61
"2021","Wolverhampton 006","E02002154",2939,838,293,545,1916,127,907,273,458,176,432,213,198,21,430,273,157,20,20,185,110,75
"2021","Wolverhampton 007","E02002155",2348,560,270,290,1627,100,525,124,285,116,291,65,200,26,691,510,181,20,20,161,103,58
"2021","Wolverhampton 008","E02002156",3333,981,497,484,2141,253,1085,312,469,304,371,144,180,47,422,250,172,10,10,211,112,99
"2021","Wolverhampton 009","E02002157",3182,878,400,478,2121,328,1056,325,505,226,356,177,155,24,366,187,179,15,15,183,104,79
"2021","Wolverhampton 010","E02002158",3282,1095,548,547,2006,340,832,278,319,235,366,139,198,29,457,280,177,11,11,181,106,75
"2021","Wolverhampton 011","E02002159",2233,552,198,354,1482,93,620,135,348,137,279,84,173,22,461,317,144,29,29,199,125,74
"2021","Wolverhampton 012","E02002160",2930,773,364,409,1945,266,1005,287,482,236,312,129,155,28,343,211,132,19,19,212,119,93
"2021","Wolverhampton 013","E02002161",2550,699,186,513,1582,66,778,145,478,155,266,93,157,16,407,244,163,65,65,269,142,127
"2021","Wolverhampton 014","E02002162",3363,1120,697,423,2070,483,980,317,430,233,278,135,125,18,314,176,138,15,15,173,101,72
"2021","Wolverhampton 015","E02002163",5017,1902,504,1398,2735,153,1119,280,662,177,445,189,224,32,930,643,287,88,88,380,217,163
"2021","Wolverhampton 016","E02002164",2361,898,180,718,1117,43,505,92,330,83,163,76,71,16,338,220,118,68,68,346,141,205
"2021","Wolverhampton 017","E02002165",3655,1705,326,1379,1651,100,722,217,347,158,359,216,135,8,436,283,153,34,34,299,138,161
"2021","Wolverhampton 018","E02002166",3808,1265,487,778,2318,230,910,250,437,223,421,144,229,48,725,474,251,32,32,225,138,87
"2021","Wolverhampton 019","E02002167",2963,974,477,497,1831,347,849,295,367,187,307,167,121,19,317,184,133,11,11,158,79,79
"2021","Wolverhampton 020","E02002168",4635,1945,420,1525,2239,105,932,225,547,160,464,280,166,18,666,434,232,72,72,451,193,258
"2021","Wolverhampton 021","E02002169",3560,1011,571,440,2313,479,1261,396,571,294,272,108,141,23,287,149,138,14,14,236,139,97
"2021","Wolverhampton 022","E02002170",2415,639,312,327,1577,193,764,210,347,207,264,72,161,31,347,212,135,9,9,199,122,77
"2021","Wolverhampton 023","E02002171",3100,934,409,525,1932,238,797,235,366,196,354,128,199,27,514,293,221,29,29,234,130,104
"2021","Wolverhampton 026","E02002174",3011,877,404,473,1860,241,1005,289,435,281,272,122,125,25,322,152,170,20,20,274,149,125
"2021","Wolverhampton 027","E02002175",3070,980,377,603,1844,190,824,241,379,204,326,131,165,30,482,311,171,22,22,246,161,85
"2021","Wolverhampton 028","E02002176",3313,1058,459,599,2105,299,940,303,420,217,360,148,182,30,488,312,176,18,18,150,73,77
"2021","Wolverhampton 029","E02002177",4531,1359,405,954,2793,167,1208,317,661,230,550,264,250,36,788,524,264,80,80,379,236,143
"2021","Wolverhampton 030","E02002178",2742,601,303,298,1777,283,1062,234,477,351,145,65,70,10,260,101,159,27,27,364,238,126
"2021","Wolverhampton 031","E02002179",2609,705,382,323,1756,301,979,295,468,216,232,108,107,17,230,126,104,14,14,148,92,56
"2021","Wolverhampton 032","E02002180",2595,739,392,347,1696,257,812,234,371,207,241,83,130,28,372,213,159,14,14,160,104,56
"2021","Wolverhampton 033","E02002181",3368,965,378,587,2191,204,948,279,481,188,466,182,249,35,550,360,190,23,23,212,117,95
"2021","Wolverhampton 034","E02002182",2481,649,279,370,1628,198,760,211,314,235,270,93,153,24,389,234,155,11,11,204,119,85
"2021","Wolverhampton 035","E02006894",5104,1329,488,841,3184,200,1551,291,911,349,419,180,204,35,912,578,334,102,102,591,357,234
"2021","Peterborough 001","E02003237",2670,693,379,314,1867,422,975,409,367,199,268,142,117,9,195,118,77,7,7,110,50,60
"2021","Peterborough 002","E02003238",2466,701,250,451,1646,165,835,313,351,171,320,174,120,26,310,191,119,16,16,119,59,60
"2021","Peterborough 003","E02003239",3546,892,449,443,2502,494,1217,485,485,247,463,242,189,32,317,198,119,11,11,152,70,82
"2021","Peterborough 004","E02003240",2708,650,282,368,1934,298,1097,398,568,131,309,174,119,16,226,169,57,4,4,124,49,75
"2021","Peterborough 005","E02003241",3049,817,367,450,2060,334,1014,412,443,159,365,199,143,23,332,213,119,15,15,172,76,96
"2021","Peterborough 006","E02003242",3770,1184,620,564,2385,477,1063,419,446,198,427,205,185,37,401,245,156,17,17,201,97,104
"2021","Peterborough 007","E02003243",4812,1439,443,996,2945,185,1150,365,641,144,701,292,369,40,860,631,229,49,49,428,223,205
"2021","Peterborough 008","E02003244",3790,1108,502,606,2296,204,1050,283,602,165,405,138,228,39,593,407,186,44,44,386,240,146
"2021","Peterborough 009","E02003245",3057,818,306,512,1871,121,750,190,417,143,351,118,205,28,605,413,192,44,44,368,185,183
"2021","Peterborough 010","E02003246",3200,790,239,551,1865,112,882,199,535,148,321,140,156,25,477,329,148,73,73,545,326,219
"2021","Peterborough 011","E02003247",3503,1032,418,614,2121,255,915,303,464,148,395,173,191,31,516,355,161,40,40,350,177,173
"2021","Peterborough 012","E02003248",3468,752,296,456,2002,153,1104,259,674,171,281,125,140,16,404,269,135,60,60,714,463,251
"2021","Peterborough 013","E02003249",5018,1512,547,965,2976,251,1289,392,714,183,574,299,248,27,793,583,210,69,69,530,300,230
"2021","Peterborough 014","E02003250",4694,1627,413,1214,2358,103,1099,339,628,132,519,335,163,21,514,349,165,123,123,709,357,352
"2021","Peterborough 015","E02003251",3058,786,472,314,2034,484,1128,382,520,226,195,102,76,17,213,114,99,14,14,238,140,98
"2021","Peterborough 016","E02003252",4763,1340,365,975,2898,172,1461,412,876,173,595,327,242,26,602,434,168,68,68,525,266,259
"2021","Peterborough 017","E02003253",4543,1508,413,1095,2681,205,1101,395,542,164,713,435,249,29,607,429,178,55,55,354,134,220
"2021","Peterborough 018","E02003254",4067,1113,579,534,2772,561,1471,604,623,244,421,243,154,24,302,194,108,17,17,182,74,108
"2021","Peterborough 019","E02003255",5586,1438,603,835,3792,440,1794,582,942,270,846,416,390,40,679,467,212,33,33,356,172,184
"2021","Peterborough 021","E02003257",3776,1223,468,755,2193,158,916,268,491,157,431,184,214,33,636,464,172,52,52,360,186,174
"2021","Peterborough 022","E02006877",4384,1155,378,777,2909,299,1418,447,803,168,684,364,296,24,473,321,152,35,35,320,151,169
"2021","Peterborough 023","E02006878",4613,944,135,809,3255,107,1761,392,1204,165,735,367,340,28,619,478,141,33,33,414,229,185
"2021","Luton 001","E02003258",3488,990,471,519,2249,414,1226,365,576,285,331,172,132,27,256,140,116,22,22,249,142,107
"2021","Luton 002","E02003259",2610,589,255,334,1850,213,875,231,446,198,241,94,128,19,489,322,167,32,32,171,89,82
"2021","Luton 003","E02003260",3259,897,322,575,2078,127,888,168,545,175,275,92,151,32,755,528,227,33,33,284,167,117
"2021","Luton 004","E02003261",2475,709,352,357,1562,258,790,219,376,195,206,85,91,30,284,143,141,24,24,204,120,84
"2021","Luton 005","E02003262",4066,1200,510,690,2468,234,1248,267,712,269,302,127,147,28,650,388,262,34,34,398,259,139
"2021","Luton 006","E02003263",4493,1059,446,613,2994,319,1693,377,964,352,290,127,128,35,632,354,278,60,60,440,272,168
"2021","Luton 007","E02003264",3201,585,315,270,2261,272,1432,316,814,302,224,123,84,17,315,170,145,18,18,355,232,123
"2021","Luton 008","E02003265",3498,1063,544,519,2220,349,1152,370,505,277,371,169,161,41,326,163,163,22,22,215,110,105
"2021","Luton 009","E02003266",3653,1024,424,600,2298,134,1184,251,720,213,314,111,166,37,621,330,291,45,45,331,215,116
"2021","Luton 010","E02003267",3685,521,202,319,2386,126,1674,259,1162,253,146,60,72,14,400,252,148,40,40,778,595,183
"2021","Luton 011","E02003268",3746,762,289,473,2334,122,1408,212,987,209,207,76,111,20,534,296,238,63,63,650,457,193
"2021","Luton 012","E02003269",4200,1187,476,711,2583,299,1284,358,673,253,447,224,191,32,515,322,193,38,38,430,219,211
"2021","Luton 013","E02003270",3091,774,416,358,1951,266,1112,248,629,235,186,91,75,20,343,165,178,44,44,366,209,157
"2021","Luton 014","E02003271",4022,954,320,634,2759,287,1454,468,675,311,536,291,217,28,445,263,182,37,37,309,154,155
"2021","Luton 015","E02003272",2831,462,115,347,1670,63,1091,145,762,184,106,41,58,7,357,218,139,53,53,699,519,180
"2021","Luton 016","E02003273",4310,1061,335,726,2737,239,1377,336,780,261,450,212,192,46,624,359,265,47,47,512,259,253
"2021","Luton 017","E02003274",3362,873,156,717,1965,55,1293,172,977,144,181,92,78,11,387,249,138,49,49,524,351,173
"2021","Luton 019","E02003276",2727,626,127,499,1589,56,956,159,682,115,172,100,61,11,336,235,101,69,69,512,290,222
"2021","Luton 020","E02003277",3967,1029,372,657,2428,138,1206,218,790,198,350,134,183,33,657,407,250,77,77,510,280,230
"2021","Luton 021","E02003278",5258,1817,326,1491,2816,106,1311,378,759,174,557,321,212,24,704,515,189,138,138,625,219,406
"2021","Luton 022","E02006937",4039,1451,263,1188,2019,52,834,255,503,76,484,314,158,12,502,371,131,147,147,569,207,362
"2021","Luton 023","E02006938",2962,1435,264,1171,1288,25,497,179,286,32,289,204,77,8,379,299,80,98,98,239,63,176
"2021","Southend-on-Sea 001","E02003279",4058,1119,706,413,2757,596,1304,463,524,317,467,214,210,43,375,197,178,15,15,182,74,108
"2021","Southend-on-Sea 002","E02003280",4481,1300,729,571,2934,466,1374,483,641,250,567,262,254,51,503,278,225,24,24,247,118,129
"2021","Southend-on-Sea 003","E02003281",4200,1341,842,499,2709,618,1259,419,587,253,415,208,169,38,399,201,198,18,18,150,57,93
"2021","Southend-on-Sea 004","E02003282",4443,1334,618,716,2869,485,1447,413,732,302,460,235,192,33,457,274,183,20,20,240,127,113
"2021","Southend-on-Sea 005","E02003283",4445,1251,637,614,2932,394,1402,383,741,278,569,268,267,34,547,305,242,20,20,262,121,141
"2021","Southend-on-Sea 006","E02003284",4640,1347,540,807,3031,278,1384,424,661,299,651,300,291,60,692,425,267,26,26,262,113,149
"2021","Southend-on-Sea 007","E02003285",4627,1435,389,1046,2845,140,1284,388,673,223,680,341,302,37,705,454,251,36,36,347,132,215
"2021","Southend-on-Sea 008","E02003286",3852,993,527,466,2739,521,1539,437,830,272,416,209,181,26,249,145,104,14,14,120,46,74
"2021","Southend-on-Sea 009","E02003287",4196,1188,647,541,2796,562,1248,399,584,265,389,162,193,34,575,366,209,22,22,212,108,104
"2021","Southend-on-Sea 010","E02003288",5971,2422,665,1757,3185,156,1187,381,625,181,790,433,315,42,996,705,291,56,56,364,145,219
"2021","Southend-on-Sea 011","E02003289",4708,1820,653,1167,2700,302,1242,415,647,180,707,459,214,34,423,271,152,26,26,188,52,136
"2021","Southend-on-Sea 012","E02003290",4475,1816,578,1238,2452,357,1172,346,624,202,546,358,162,26,350,213,137,27,27,207,69,138
"2021","Southend-on-Sea 013","E02003291",5141,1694,734,960,3221,403,1362,482,574,306,666,321,280,65,767,463,304,23,23,226,104,122
"2021","Southend-on-Sea 014","E02003292",5555,2277,611,1666,2927,136,1035,359,511,165,776,413,325,38,942,677,265,38,38,351,142,209
"2021","Southend-on-Sea 015","E02003293",5670,2647,781,1866,2589,215,924,376,428,120,727,444,257,26,654,444,210,69,69,434,110,324
"2021","Southend-on-Sea 016","E02003294",3954,1162,771,391,2591,638,1269,425,557,287,365,182,149,34,303,161,142,16,16,201,81,120
"2021","Southend-on-Sea 017","E02003295",3924,956,494,462,2747,450,1298,388,602,308,455,179,216,60,519,321,198,25,25,221,111,110
"2021","Thurrock 001","E02003296",2763,553,335,218,2041,454,1047,325,451,271,320,125,158,37,205,93,112,15,15,169,69,100
"2021","Thurrock 002","E02003297",2910,756,470,286,1975,357,894,251,396,247,323,90,197,36,382,214,168,19,19,179,85,94
"2021","Thurrock 003","E02003298",2833,722,451,271,1942,351,922,271,396,255,330,126,150,54,324,175,149,15,15,169,92,77
"2021","Thurrock 004","E02003299",2459,511,274,237,1754,328,909,300,376,233,316,136,146,34,187,98,89,14,14,194,92,102
"2021","Thurrock 005","E02003300",3590,908,404,504,2455,309,1160,324,566,270,547,243,271,33,422,280,142,17,17,227,92,135
"2021","Thurrock 006","E02003301",4511,1097,438,659,3010,261,1493,387,849,257,581,271,262,48,626,412,214,49,49,404,244,160
"2021","Thurrock 007","E02003302",4026,1185,421,764,2507,139,1145,284,636,225,494,179,260,55,697,442,255,32,32,334,185,149
"2021","Thurrock 008","E02003303",3540,863,397,466,2378,213,1167,298,630,239,494,178,272,44,472,288,184,32,32,299,182,117
"2021","Thurrock 009","E02003304",3641,965,643,322,2399,334,1311,329,658,324,333,101,174,58,405,216,189,16,16,277,161,116
"2021","Thurrock 010","E02003305",2658,563,347,216,1905,318,1015,268,507,240,289,97,153,39,274,179,95,9,9,190,113,77
"2021","Thurrock 012","E02003307",3963,999,560,439,2632,317,1189,332,577,280,443,135,255,53,672,444,228,11,11,332,197,135
"2021","Thurrock 013","E02003308",2805,528,221,307,2058,199,1012,288,486,238,413,160,219,34,418,310,108,16,16,219,123,96
"2021","Thurrock 014","E02003309",3003,770,418,352,1968,289,1058,299,489,270,333,140,168,25,267,138,129,21,21,265,139,126
"2021","Thurrock 016","E02003311",3443,851,270,581,2185,149,1133,304,614,215,415,235,157,23,421,270,151,67,67,407,203,204
"2021","Thurrock 017","E02003312",3766,1061,200,861,2370,58,1028,275,636,117,573,262,288,23,650,487,163,61,61,335,169,166
"2021","Thurrock 018","E02003313",5217,1217,467,750,3455,193,1464,381,787,296,656,201,388,67,1081,790,291,61,61,545,312,233
"2021","Thurrock 019","E02006859",2654,463,62,401,1938,58,1162,225,775,162,365,188,160,17,324,241,83,29,29,253,155,98
"2021","Thurrock 020","E02006926",2846,574,145,429,2038,116,1236,277,736,223,375,158,192,25,289,187,102,22,22,234,132,102
"2021","Thurrock 021","E02007004",2651,840,129,711,1572,41,730,211,433,86,336,151,168,17,433,327,106,32,32,239,130,109
"2021","Thurrock 022","E02007005",3114,752,150,602,2024,68,977,238,605,134,489,231,231,27,448,317,131,42,42,338,194,144
"2021","Bedford 001","E02003616",2346,530,292,238,1730,382,955,378,407,170,201,121,65,15,185,118,67,7,7,86,29,57
"2021","Bedford 002","E02003617",3823,1034,578,456,2610,552,1400,534,608,258,364,210,131,23,283,164,119,11,11,179,88,91
"2021","Bedford 003","E02003618",3623,992,560,432,2475,425,1291,420,643,228,364,182,159,23,378,256,122,17,17,156,82,74
"2021","Bedford 004","E02003619",4717,1032,488,544,3427,590,1828,687,817,324,575,305,237,33,417,276,141,17,17,258,123,135
"2021","Bedford 005","E02003620",3504,1055,575,480,2290,495,1132,368,529,235,302,138,141,23,345,190,155,16,16,159,82,77
"2021","Bedford 006","E02003621",3302,842,560,282,2303,552,1201,355,564,282,260,128,112,20,275,111,164,15,15,157,67,90
"2021","Bedford 007","E02003622",3814,1161,533,628,2429,292,1029,279,519,231,402,150,209,43,672,410,262,34,34,224,108,116
"2021","Bedford 008","E02003623",5082,1145,492,653,3692,546,2033,633,1114,286,611,331,259,21,481,311,170,21,21,245,117,128
"2021","Bedford 009","E02003624",2466,1045,334,711,1298,197,609,200,316,93,264,176,76,12,192,126,66,36,36,123,38,85
"2021","Bedford 010","E02003625",4206,1989,565,1424,1965,159,832,291,414,127,493,364,121,8,419,279,140,62,62,252,71,181
"2021","Bedford 011","E02003626",2363,667,246,421,1547,181,807,301,366,140,298,154,127,17,234,140,94,27,27,149,56,93
"2021","Bedford 012","E02003627",5042,2131,553,1578,2543,181,1155,407,617,131,686,489,174,23,451,294,157,70,70,368,113,255
"2021","Bedford 013","E02003628",3056,662,200,462,1911,90,1072,192,694,186,263,115,133,15,438,268,170,48,48,483,298,185
"2021","Bedford 014","E02003629",4304,1318,466,852,2631,181,1173,310,666,197,494,261,198,35,739,454,285,44,44,355,165,190
"2021","Bedford 015","E02003630",4302,1229,306,923,2494,108,1219,283,706,230,448,240,175,33,644,395,249,75,75,579,258,321
"2021","Bedford 016","E02003631",2270,680,277,403,1415,197,653,209,279,165,227,131,73,23,324,171,153,14,14,175,92,83
"2021","Bedford 017","E02003632",2528,725,296,429,1605,185,754,225,360,169,291,148,124,19,353,198,155,22,22,198,118,80
"2021","Bedford 018","E02003633",4027,962,331,631,2757,291,1396,397,715,284,515,255,226,34,532,333,199,23,23,308,160,148
"2021","Bedford 020","E02003635",3951,840,390,450,2937,306,1506,406,869,231,685,341,316,28,426,321,105,14,14,174,93,81
"2021","Bedford 021","E02007010",3462,848,342,506,2423,325,1176,400,594,182,545,297,216,32,369,236,133,8,8,191,103,88
"2021","Bedford 022","E02007011",2775,558,225,333,2024,181,1060,263,675,122,452,230,207,15,312,229,83,19,19,193,106,87
"2021","Central Bedfordshire 001","E02003599",2312,584,268,316,1638,202,857,287,423,147,320,153,151,16,246,146,100,13,13,90,45,45
"2021","Central Bedfordshire 002","E02003600",2700,746,329,417,1830,297,868,330,361,177,400,219,156,25,256,167,89,9,9,124,47,77
"2021","Central Bedfordshire 003","E02003601",3490,908,412,496,2451,425,1256,490,551,215,477,273,180,24,281,178,103,12,12,131,56,75
"2021","Central Bedfordshire 004","E02003602",2717,624,370,254,1949,392,1020,428,392,200,311,171,115,25,220,118,102,6,6,144,56,88
"2021","Central Bedfordshire 005","E02003603",4966,1559,596,963,3203,397,1501,531,722,248,788,451,292,45,494,319,175,23,23,204,76,128
"2021","Central Bedfordshire 006","E02003604",4469,989,402,587,3274,371,1711,591,838,282,744,391,315,38,416,245,171,32,32,206,91,115
"2021","Central Bedfordshire 007","E02003605",3827,866,427,439,2710,397,1420,479,704,237,544,302,217,25,332,231,101,17,17,251,79,172
"2021","Central Bedfordshire 008","E02003606",3834,865,453,412,2802,501,1469,536,644,289,512,294,189,29,302,207,95,18,18,167,63,104
"2021","Central Bedfordshire 009","E02003607",4512,1069,483,586,3230,389,1778,579,923,276,611,326,251,34,436,284,152,16,16,213,101,112
"2021","Central Bedfordshire 010","E02003608",5133,1391,571,820,3528,503,1774,648,806,320,715,402,271,42,513,312,201,23,23,214,97,117
"2021","Central Bedfordshire 011","E02003609",4672,1207,498,709,3267,420,1761,568,922,271,645,324,280,41,425,281,144,16,16,198,79,119
"2021","Central Bedfordshire 012","E02003610",3748,1006,489,517,2618,400,1416,425,760,231,429,233,171,25,356,241,115,17,17,124,55,69
"2021","Central Bedfordshire 013","E02003611",4014,956,433,523,2912,473,1557,556,766,235,537,289,219,29,335,208,127,10,10,146,70,76
"2021","Central Bedfordshire 014","E02003612",4943,1171,509,662,3592,477,1982,583,1099,300,658,307,319,32,463,303,160,12,12,180,79,101
"2021","Central Bedfordshire 015","E02003613",2438,704,321,383,1644,241,827,301,356,170,299,163,108,28,265,148,117,12,12,90,39,51
"2021","Central Bedfordshire 016","E02003614",3447,872,321,551,2451,305,1339,469,630,240,500,292,187,21,294,170,124,13,13,124,46,78
"2021","Central Bedfordshire 017","E02003615",4158,877,435,442,3091,548,1740,598,837,305,443,207,197,39,342,219,123,18,18,190,79,111
"2021","Central Bedfordshire 018","E02003636",3011,774,384,390,2101,341,1090,336,499,255,358,186,146,26,300,171,129,12,12,136,64,72
"2021","Central Bedfordshire 019","E02003637",4411,1017,530,487,3178,542,1714,633,751,330,564,319,214,31,351,203,148,7,7,216,92,124
"2021","Central Bedfordshire 020","E02003638",3058,644,347,297,2281,452,1191,402,547,242,343,164,146,33,282,165,117,13,13,133,60,73
"2021","Central Bedfordshire 021","E02003639",4356,1587,646,941,2579,261,1155,389,575,191,604,350,222,32,532,329,203,27,27,190,68,122
"2021","Central Bedfordshire 022","E02003640",2694,792,333,459,1802,352,850,304,405,141,345,218,112,15,235,126,109,20,20,100,29,71
"2021","Central Bedfordshire 023","E02003641",2224,550,259,291,1595,291,891,286,458,147,254,135,105,14,149,78,71,10,10,79,27,52
"2021","Central Bedfordshire 025","E02003642",3545,868,302,566,2349,165,1148,305,623,220,447,171,230,46,558,363,195,31,31,328,189,139
"2021","Central Bedfordshire 024","E02003643",5478,1294,461,833,3974,330,1998,571,1181,246,1020,530,453,37,595,430,165,31,31,210,97,113
"2021","Central Bedfordshire 026","E02003644",4006,1006,377,629,2723,248,1336,438,656,242,559,262,259,38,537,325,212,43,43,277,131,146
"2021","Central Bedfordshire 027","E02003645",2690,627,338,289,1848,295,999,282,468,249,285,126,124,35,247,109,138,22,22,215,96,119
"2021","Central Bedfordshire 028","E02003646",4163,1035,447,588,2847,330,1429,400,770,259,547,256,245,46,504,303,201,37,37,281,137,144
"2021","Central Bedfordshire 029","E02003647",4625,1574,607,967,2758,299,1284,425,641,218,648,360,263,25,469,291,178,58,58,293,125,168
"2021","Central Bedfordshire 030","E02003648",2282,674,299,375,1448,146,639,190,318,131,263,107,131,25,382,248,134,18,18,160,82,78
"2021","Central Bedfordshire 031","E02003649",2823,741,354,387,1946,377,1007,377,414,216,292,148,130,14,254,116,138,16,16,136,62,74
"2021","Central Bedfordshire 032","E02003650",3028,797,457,340,2083,498,1048,433,401,214,292,162,107,23,235,122,113,10,10,148,67,81
"2021","Central Bedfordshire 033","E02003651",2990,794,458,336,2062,423,984,354,454,176,347,178,139,30,289,153,136,19,19,134,55,79
"2021","Cambridge 001","E02003719",4006,1285,370,915,2103,163,975,332,480,163,460,285,151,24,462,286,176,43,43,618,177,441
"2021","Cambridge 002","E02003720",3904,1256,436,820,2167,231,1078,321,607,150,460,291,153,16,348,205,143,50,50,481,121,360
"2021","Cambridge 003","E02003721",4083,1340,484,856,2248,238,988,356,467,165,572,360,181,31,408,247,161,42,42,495,93,402
"2021","Cambridge 004","E02003722",3771,1372,448,924,2019,293,1100,398,557,145,413,330,72,11,174,103,71,39,39,380,61,319
"2021","Cambridge 005","E02003723",2933,1049,301,748,1581,172,899,334,474,91,348,286,57,5,136,79,57,26,26,303,31,272
"2021","Cambridge 006","E02003724",4233,1292,355,937,2391,189,1090,396,549,145,578,355,201,22,474,302,172,60,60,550,95,455
"2021","Cambridge 007","E02003725",3554,1307,481,826,1787,289,917,355,480,82,397,331,63,3,155,87,68,29,29,460,44,416
"2021","Cambridge 008","E02003726",3385,1209,338,871,1698,152,795,305,411,79,501,407,84,10,225,143,82,25,25,478,26,452
"2021","Cambridge 009","E02003727",4035,1241,311,930,1981,143,897,330,472,95,632,504,122,6,245,145,100,64,64,813,123,690
"2021","Cambridge 010","E02003728",4081,1282,420,862,2155,183,1179,370,627,182,478,340,122,16,275,168,107,40,40,644,95,549
"2021","Cambridge 011","E02003729",3747,987,434,553,2378,295,1351,371,764,216,351,250,91,10,350,201,149,31,31,382,115,267
"2021","Cambridge 013","E02003731",4011,1014,400,614,2388,350,1303,440,662,201,419,299,104,16,284,161,123,32,32,609,112,497
"2021","Cambridge 015","E02007086",4274,1008,230,778,2834,148,1516,418,981,117,603,384,207,12,546,423,123,21,21,432,165,267
"2021","Cambridge 014","E02007087",2434,1012,245,767,1188,150,557,227,280,50,299,246,46,7,158,97,61,24,24,234,27,207
"2021","East Cambridgeshire 001","E02003732",4101,1111,469,642,2766,367,1379,507,649,223,632,358,242,32,374,239,135,14,14,224,91,133
"2021","East Cambridgeshire 002","E02003733",3507,827,394,433,2528,468,1363,496,640,227,413,230,158,25,273,155,118,11,11,152,51,101
"2021","East Cambridgeshire 003","E02003734",5208,1589,669,920,3414,539,1733,582,933,218,620,391,201,28,496,327,169,26,26,205,72,133
"2021","East Cambridgeshire 004","E02003735",3765,1214,580,634,2400,392,1294,446,684,164,457,320,119,18,242,155,87,15,15,151,46,105
"2021","East Cambridgeshire 005","E02003736",4305,1100,547,553,3019,601,1650,621,738,291,446,257,154,35,314,198,116,8,8,186,80,106
"2021","East Cambridgeshire 006","E02003737",5607,1619,679,940,3712,492,1834,633,897,304,782,408,334,40,571,387,184,33,33,276,111,165
"2021","East Cambridgeshire 007","E02003738",2700,700,330,370,1882,325,1030,397,470,163,311,163,123,25,204,120,84,12,12,118,48,70
"2021","East Cambridgeshire 008","E02003739",2762,772,404,368,1896,358,996,346,480,170,316,174,118,24,220,131,89,6,6,94,26,68
"2021","East Cambridgeshire 009","E02003740",2523,619,326,293,1779,359,954,305,483,166,250,132,99,19,211,136,75,5,5,125,49,76
"2021","East Cambridgeshire 011","E02006825",2732,740,363,377,1871,382,1024,410,465,149,260,171,75,14,192,123,69,13,13,121,30,91
"2021","Fenland 001","E02003742",3002,821,485,336,2012,477,923,445,296,182,328,174,128,26,272,152,120,12,12,169,69,100
"2021","Fenland 002","E02003743",4489,1213,531,682,2821,381,1071,416,467,188,692,323,310,59,628,437,191,49,49,455,232,223
"2021","Fenland 003","E02003744",5990,1992,894,1098,3483,535,1432,599,532,301,793,380,362,51,646,411,235,77,77,515,234,281
"2021","Fenland 004","E02003745",4451,1184,609,575,2989,599,1371,635,463,273,593,294,255,44,409,245,164,17,17,278,126,152
"2021","Fenland 005","E02003746",3108,861,449,412,2072,348,959,374,390,195,432,209,193,30,322,197,125,11,11,175,72,103
"2021","Fenland 006","E02003747",5536,1637,823,814,3635,636,1661,711,646,304,770,383,332,55,551,358,193,17,17,264,118,146
"2021","Fenland 007","E02003748",3556,1170,622,548,2196,467,841,383,306,152,466,233,206,27,406,285,121,16,16,190,71,119
"2021","Fenland 008","E02003749",2613,637,297,340,1853,340,920,426,349,145,363,207,132,24,220,129,91,10,10,123,56,67
"2021","Fenland 009","E02003750",3331,1059,573,486,2102,477,933,413,327,193,377,189,169,19,305,196,109,10,10,170,78,92
"2021","Fenland 010","E02003751",3141,738,413,325,2244,462,1119,488,453,178,420,220,178,22,228,143,85,15,15,159,75,84
"2021","Fenland 011","E02003752",4877,1473,664,809,3155,491,1467,613,593,261,717,361,307,49,460,297,163,20,20,249,106,143
"2021","Huntingdonshire 001","E02003753",4637,1165,524,641,3226,498,1642,588,785,269,586,293,253,40,480,307,173,20,20,246,122,124
"2021","Huntingdonshire 002","E02003754",2446,623,304,319,1726,344,957,400,383,174,237,126,89,22,181,101,80,7,7,97,30,67
"2021","Huntingdonshire 003","E02003755",3821,1198,533,665,2471,406,1207,493,495,219,508,283,203,22,340,214,126,10,10,152,58,94
"2021","Huntingdonshire 004","E02003756",3045,788,386,402,2140,370,1114,459,451,204,390,217,153,20,252,159,93,14,14,117,49,68
"2021","Huntingdonshire 005","E02003757",2952,766,401,365,2070,342,1107,474,456,177,365,197,145,23,248,147,101,8,8,116,53,63
"2021","Huntingdonshire 006","E02003758",3984,1004,470,534,2830,478,1563,651,688,224,461,264,176,21,315,183,132,13,13,150,60,90
"2021","Huntingdonshire 007","E02003759",2483,559,320,239,1835,379,1037,416,436,185,247,140,91,16,167,80,87,5,5,89,32,57
"2021","Huntingdonshire 008","E02003760",3408,897,329,568,2118,125,966,273,523,170,441,165,245,31,540,346,194,46,46,393,163,230
"2021","Huntingdonshire 009","E02003761",2468,605,333,272,1702,366,869,370,352,147,245,135,91,19,211,120,91,11,11,161,58,103
"2021","Huntingdonshire 010","E02003762",4792,1231,584,647,3355,518,1743,601,886,256,629,364,240,25,444,305,139,21,21,206,97,109
"2021","Huntingdonshire 011","E02003763",4178,1165,429,736,2824,462,1362,507,631,224,567,340,200,27,407,242,165,26,26,189,61,128
"2021","Huntingdonshire 012","E02003764",4645,1607,437,1170,2758,237,1451,500,741,210,616,399,195,22,416,277,139,38,38,280,104,176
"2021","Huntingdonshire 013","E02003765",3348,1229,561,668,1968,388,899,316,422,161,374,250,115,9,282,162,120,25,25,151,56,95
"2021","Huntingdonshire 014","E02003766",3468,1121,438,683,2203,278,1113,392,563,158,487,281,193,13,307,198,109,18,18,144,64,80
"2021","Huntingdonshire 015","E02003767",2664,595,307,288,1968,387,1164,495,461,208,253,145,85,23,157,100,57,7,7,101,38,63
"2021","Huntingdonshire 016","E02003768",4348,1124,597,527,3061,725,1546,594,717,235,461,262,178,21,316,192,124,13,13,163,39,124
"2021","Huntingdonshire 017","E02003769",2810,769,416,353,1954,442,1009,422,415,172,292,174,99,19,202,113,89,9,9,87,25,62
"2021","Huntingdonshire 018","E02003770",4400,1073,430,643,3168,446,1709,551,967,191,600,327,252,21,397,281,116,16,16,159,61,98
"2021","Huntingdonshire 019","E02003771",2958,1088,485,603,1749,272,826,328,349,149,340,194,119,27,291,182,109,20,20,121,42,79
"2021","Huntingdonshire 020","E02003772",2943,790,367,423,2043,498,1024,363,463,198,328,185,125,18,181,102,79,12,12,110,36,74
"2021","Huntingdonshire 021","E02003773",4598,1377,537,840,2991,364,1409,514,620,275,699,383,270,46,496,295,201,23,23,230,75,155
"2021","Huntingdonshire 022","E02003774",2498,789,365,424,1585,282,709,253,324,132,338,181,141,16,246,125,121,10,10,124,41,83
"2021","South Cambridgeshire 001","E02003775",3004,719,362,357,2169,377,1160,411,575,174,354,191,143,20,261,162,99,17,17,116,45,71
"2021","South Cambridgeshire 002","E02003776",2915,897,425,472,1902,346,1012,311,526,175,316,176,121,19,221,131,90,7,7,116,41,75
"2021","South Cambridgeshire 003","E02003777",4017,1006,334,672,2839,343,1570,480,918,172,563,340,215,8,344,243,101,19,19,172,67,105
"2021","South Cambridgeshire 004","E02003778",2784,793,311,482,1870,248,993,344,509,140,386,251,120,15,232,156,76,11,11,121,37,84
"2021","South Cambridgeshire 006","E02003780",4689,1332,578,754,2990,478,1593,487,897,209,499,281,190,28,391,249,142,29,29,367,70,297
"2021","South Cambridgeshire 007","E02003781",2707,827,293,534,1711,258,929,345,431,153,335,238,79,18,168,98,70,21,21,169,41,128
"2021","South Cambridgeshire 010","E02003784",3592,856,434,422,2570,450,1498,468,766,264,326,198,110,18,290,175,115,6,6,166,64,102
"2021","South Cambridgeshire 011","E02003785",3840,1153,440,713,2480,388,1388,450,730,208,416,263,132,21,262,164,98,26,26,207,59,148
"2021","South Cambridgeshire 012","E02003786",2849,870,462,408,1887,390,1058,332,567,159,257,183,68,6,174,110,64,8,8,92,31,61
"2021","South Cambridgeshire 013","E02003787",3310,875,443,432,2310,530,1174,442,540,192,353,192,131,30,243,132,111,10,10,125,52,73
"2021","South Cambridgeshire 014","E02003788",3369,834,404,430,2401,416,1369,437,737,195,313,182,114,17,289,195,94,14,14,134,42,92
"2021","South Cambridgeshire 015","E02003789",3055,826,472,354,2081,378,1082,339,571,172,287,155,110,22,321,178,143,13,13,148,42,106
"2021","South Cambridgeshire 016","E02003790",3918,993,613,380,2759,577,1484,539,686,259,365,199,134,32,318,181,137,15,15,166,54,112
"2021","South Cambridgeshire 017","E02003791",3416,849,444,405,2411,414,1407,479,716,212,345,213,116,16,231,134,97,14,14,156,47,109
"2021","South Cambridgeshire 018","E02003792",4131,1090,584,506,2862,574,1552,542,769,241,403,214,169,20,319,176,143,14,14,179,68,111
"2021","South Cambridgeshire 019","E02003793",2869,635,340,295,2119,362,1175,421,552,202,334,163,139,32,242,140,102,6,6,115,42,73
"2021","South Cambridgeshire 020","E02006873",3511,708,157,551,2622,85,1636,330,1186,120,449,223,208,18,434,354,80,18,18,181,80,101
"2021","South Cambridgeshire 021","E02006874",4036,904,321,583,2954,365,1763,544,990,229,451,264,157,30,361,225,136,14,14,178,80,98
"2021","South Cambridgeshire 022","E02007085",4990,1413,793,620,3320,645,1799,629,876,294,496,284,188,24,365,201,164,15,15,257,68,189
"2021","Basildon 001","E02004424",2736,530,323,207,2122,428,1242,307,657,278,261,120,121,20,185,109,76,6,6,84,47,37
"2021","Basildon 002","E02004425",3160,948,463,485,2111,320,1112,339,579,194,381,221,143,17,291,166,125,7,7,101,45,56
"2021","Basildon 003","E02004426",3351,911,503,408,2298,374,1236,357,637,242,401,231,153,17,278,161,117,9,9,142,60,82
"2021","Basildon 004","E02004427",3436,998,637,361,2324,509,1253,350,647,256,309,154,138,17,245,125,120,8,8,114,50,64
"2021","Basildon 005","E02004428",2963,896,435,461,1930,318,935,308,432,195,369,180,164,25,291,144,147,17,17,137,62,75
"2021","Basildon 006","E02004429",3122,793,542,251,2153,493,1088,358,442,288,303,138,141,24,262,127,135,7,7,176,81,95
"2021","Basildon 007","E02004430",3298,744,378,366,2389,354,1300,354,648,298,430,201,205,24,301,177,124,4,4,165,83,82
"2021","Basildon 008","E02004431",4035,1168,435,733,2684,258,1357,379,703,275,623,329,268,26,437,281,156,9,9,183,94,89
"2021","Basildon 009","E02004432",2558,608,326,282,1813,377,981,300,459,222,264,116,125,23,180,100,80,11,11,137,61,76
"2021","Basildon 010","E02004433",3667,1125,433,692,2348,278,1094,364,510,220,482,250,192,40,467,290,177,27,27,194,89,105
"2021","Basildon 011","E02004434",3516,1039,405,634,2231,242,1016,351,436,229,477,225,202,50,483,299,184,13,13,246,128,118
"2021","Basildon 012","E02004435",3811,991,411,580,2550,192,1164,348,592,224,556,222,289,45,614,409,205,24,24,270,149,121
"2021","Basildon 013","E02004436",3146,965,391,574,1977,197,715,221,342,152,374,111,218,45,668,478,190,23,23,204,89,115
"2021","Basildon 014","E02004437",4284,1341,559,782,2696,308,1220,403,595,222,618,315,268,35,528,334,194,22,22,247,125,122
"2021","Basildon 015","E02004438",3888,1207,481,726,2366,194,973,286,490,197,478,185,263,30,676,481,195,45,45,315,155,160
"2021","Basildon 016","E02004439",3797,1046,327,719,2487,137,992,239,556,197,493,161,281,51,827,568,259,38,38,264,151,113
"2021","Basildon 017","E02004440",3651,1013,398,615,2362,215,1098,272,607,219,474,211,229,34,532,340,192,43,43,276,135,141
"2021","Basildon 018","E02004441",3284,1067,495,572,2000,277,883,299,397,187,357,144,174,39,462,273,189,21,21,217,109,108
"2021","Basildon 019","E02004442",3302,939,345,594,2119,160,820,235,414,171,450,153,251,46,658,447,211,31,31,244,123,121
"2021","Basildon 020","E02004443",4337,1238,439,799,2788,316,1413,447,688,278,561,311,216,34,459,293,166,39,39,311,125,186
"2021","Basildon 021","E02004444",3566,829,308,521,2551,370,1403,420,686,297,473,252,192,29,295,164,131,10,10,186,80,106
"2021","Basildon 022","E02004445",3453,1076,404,672,2143,245,936,307,433,196,461,212,210,39,481,306,175,20,20,234,131,103
"2021","Braintree 001","E02004446",2880,623,342,281,2126,418,1164,481,440,243,338,182,132,24,196,120,76,10,10,131,58,73
"2021","Braintree 002","E02004447",2588,618,351,267,1855,450,968,453,329,186,291,176,97,18,139,77,62,7,7,115,36,79
"2021","Braintree 003","E02004448",3281,869,446,423,2273,395,1142,450,499,193,444,211,201,32,280,175,105,12,12,139,50,89
"2021","Braintree 004","E02004449",3901,1341,571,770,2411,331,1071,370,513,188,546,260,246,40,444,270,174,19,19,149,52,97
"2021","Braintree 005","E02004450",2676,656,370,286,1880,410,1045,427,386,232,250,144,90,16,173,86,87,2,2,140,44,96
"2021","Braintree 006","E02004451",3984,1040,618,422,2796,547,1431,519,622,290,484,239,216,29,325,211,114,9,9,148,59,89
"2021","Braintree 007","E02004452",3684,857,446,411,2651,487,1427,505,653,269,413,182,200,31,306,162,144,18,18,176,87,89
"2021","Braintree 008","E02004453",3089,893,411,482,2027,252,843,280,388,175,462,189,235,38,458,292,166,12,12,169,78,91
"2021","Braintree 009","E02004454",4379,1612,603,1009,2518,337,1070,357,530,183,638,392,214,32,444,295,149,29,29,249,76,173
"2021","Braintree 010","E02004455",3073,596,332,264,2341,425,1288,380,633,275,368,181,157,30,253,149,104,7,7,136,62,74
"2021","Braintree 011","E02004456",4159,1237,470,767,2709,298,1219,418,577,224,621,304,270,47,543,328,215,28,28,213,88,125
"2021","Braintree 012","E02004457",4162,974,468,506,2972,377,1460,475,692,293,633,290,294,49,484,284,200,18,18,216,84,132
"2021","Braintree 013","E02004458",3758,882,486,396,2724,412,1503,431,788,284,463,218,212,33,341,218,123,5,5,152,81,71
"2021","Braintree 014","E02004459",4431,1220,720,500,3060,597,1590,509,767,314,466,266,172,28,393,219,174,14,14,151,54,97
"2021","Braintree 015","E02004460",4032,1072,530,542,2761,452,1279,416,578,285,589,303,248,38,430,249,181,11,11,199,87,112
"2021","Braintree 016","E02004461",2242,556,233,323,1543,149,687,204,350,133,340,143,169,28,355,216,139,12,12,143,54,89
"2021","Braintree 017","E02004462",5273,1848,746,1102,3234,377,1456,538,707,211,816,492,300,24,550,344,206,35,35,191,68,123
"2021","Braintree 018","E02004463",3396,880,455,425,2354,414,1247,492,521,234,373,197,152,24,306,171,135,14,14,162,70,92
"2021","Brentwood 001","E02004464",3833,803,511,292,2825,641,1561,489,674,398,319,127,157,35,292,142,150,12,12,205,94,111
"2021","Brentwood 002","E02004465",2779,856,502,354,1826,349,900,276,441,183,289,156,109,24,284,151,133,4,4,97,34,63
"2021","Brentwood 003","E02004466",3369,935,465,470,2299,315,1173,324,602,247,384,182,168,34,414,252,162,13,13,135,55,80
"2021","Brentwood 004","E02004467",3318,917,417,500,2244,292,1022,228,594,200,427,198,190,39,473,283,190,30,30,157,83,74
"2021","Brentwood 005","E02004468",4201,997,596,401,3025,618,1821,473,989,359,315,177,117,21,259,133,126,12,12,179,84,95
"2021","Brentwood 006","E02004469",2892,729,360,369,1988,335,1071,294,559,218,318,157,140,21,248,122,126,16,16,175,78,97
"2021","Brentwood 007","E02004470",5716,2287,736,1551,3190,271,1356,433,734,189,885,662,196,27,619,438,181,59,59,239,67,172
"2021","Brentwood 008","E02004471",3647,1160,465,695,2328,292,1139,346,577,216,448,254,163,31,423,267,156,26,26,159,79,80
"2021","Brentwood 009","E02004472",2590,717,363,354,1764,270,987,297,444,246,283,155,121,7,215,118,97,9,9,109,55,54
"2021","Castle Point 001","E02004473",3123,736,467,269,2236,436,1079,330,490,259,388,158,195,35,321,180,141,12,12,151,72,79
"2021","Castle Point 002","E02004474",3304,857,515,342,2286,475,1131,384,494,253,364,183,151,30,307,160,147,9,9,161,79,82
"2021","Castle Point 003","E02004475",2648,607,401,206,1900,416,976,273,437,266,271,128,117,26,231,122,109,6,6,141,81,60
"2021","Castle Point 004","E02004476",3220,720,456,264,2348,516,1251,384,567,300,362,160,171,31,210,112,98,9,9,152,66,86
"2021","Castle Point 005","E02004477",2636,682,462,220,1845,492,901,323,365,213,242,127,98,17,202,83,119,8,8,109,42,67
"2021","Castle Point 006","E02004478",2966,995,544,451,1836,326,797,271,353,173,342,161,154,27,362,238,124,9,9,135,58,77
"2021","Castle Point 007","E02004479",3314,873,493,380,2281,442,1153,357,494,302,398,199,167,32,272,153,119,16,16,160,76,84
"2021","Castle Point 008","E02004480",2690,645,330,315,1888,296,953,283,439,231,335,162,139,34,294,177,117,10,10,157,74,83
"2021","Castle Point 009","E02004481",3190,1157,804,353,1900,580,730,273,266,191,313,175,120,18,265,120,145,12,12,133,54,79
"2021","Castle Point 010","E02004482",3172,766,425,341,2174,273,908,261,392,255,392,130,216,46,572,329,243,29,29,232,132,100
"2021","Castle Point 011","E02004483",3392,984,596,388,2216,524,1048,387,365,296,334,134,163,37,300,172,128,10,10,192,85,107
"2021","Castle Point 012","E02004484",3734,1199,652,547,2363,518,1004,370,374,260,425,209,171,45,401,236,165,15,15,172,87,85
"2021","Chelmsford 001","E02004485",3882,838,410,428,2869,383,1464,433,829,202,516,285,205,26,490,358,132,16,16,175,74,101
"2021","Chelmsford 002","E02004486",3536,922,448,474,2444,483,1353,409,733,211,323,190,117,16,274,144,130,11,11,170,65,105
"2021","Chelmsford 003","E02004487",3044,796,412,384,2085,335,1036,326,531,179,327,144,161,22,376,235,141,11,11,163,61,102
"2021","Chelmsford 004","E02004488",4111,1096,467,629,2844,390,1563,429,880,254,465,274,167,24,406,258,148,20,20,171,76,95
"2021","Chelmsford 005","E02004489",3643,835,361,474,2664,380,1495,438,794,263,410,207,170,33,365,226,139,14,14,144,63,81
"2021","Chelmsford 006","E02004490",3274,1095,487,608,1976,174,840,219,462,159,340,149,147,44,586,371,215,36,36,203,89,114
"2021","Chelmsford 007","E02004491",3010,722,355,367,2149,343,1200,354,623,223,330,180,126,24,262,147,115,14,14,139,48,91
"2021","Chelmsford 008","E02004492",3962,1144,382,762,2639,250,1401,435,710,256,582,363,190,29,387,218,169,19,19,179,62,117
"2021","Chelmsford 009","E02004493",4233,1218,405,813,2684,262,1332,373,728,231,599,372,194,33,450,283,167,41,41,331,103,228
"2021","Chelmsford 011","E02004495",3532,1044,639,405,2333,550,1198,417,528,253,313,172,123,18,258,137,121,14,14,155,55,100
"2021","Chelmsford 012","E02004496",3237,798,351,447,2275,332,1242,303,734,205,417,238,160,19,276,147,129,8,8,164,54,110
"2021","Chelmsford 013","E02004497",3365,989,617,372,2253,530,1166,350,604,212,313,172,110,31,230,113,117,14,14,123,51,72
"2021","Chelmsford 014","E02004498",4269,1347,578,769,2696,401,1298,359,674,265,490,247,209,34,484,302,182,23,23,226,82,144
"2021","Chelmsford 015","E02004499",2699,575,322,253,2010,338,1043,287,507,249,323,161,131,31,298,154,144,8,8,114,52,62
"2021","Chelmsford 016","E02004500",3736,833,478,355,2746,622,1508,499,712,297,290,141,123,26,313,161,152,13,13,157,60,97
"2021","Chelmsford 017","E02004501",2957,775,432,343,2066,443,1009,338,464,207,296,141,131,24,301,168,133,17,17,116,53,63
"2021","Chelmsford 018","E02004502",2918,821,501,320,1945,460,1071,382,462,227,211,100,90,21,193,104,89,10,10,152,54,98
"2021","Chelmsford 019","E02004503",3277,847,443,404,2312,423,1208,366,592,250,391,186,173,32,284,147,137,6,6,118,56,62
"2021","Chelmsford 020","E02004504",3320,902,360,542,2286,319,1282,406,597,279,366,223,122,21,314,191,123,5,5,132,56,76
"2021","Chelmsford 021","E02004505",2685,645,416,229,1905,433,947,357,396,194,308,165,114,29,207,109,98,10,10,135,65,70
"2021","Chelmsford 022","E02006978",3355,1446,399,1047,1683,129,664,252,341,71,602,473,117,12,238,167,71,50,50,226,41,185
"2021","Chelmsford 023","E02006979",3352,1460,307,1153,1684,82,636,253,340,43,655,526,122,7,247,164,83,64,64,208,47,161
"2021","Colchester 001","E02004506",2879,665,381,284,2053,416,1130,402,515,213,276,133,127,16,216,135,81,15,15,161,69,92
"2021","Colchester 002","E02004507",4130,1316,379,937,2635,223,1337,388,761,188,548,317,206,25,499,354,145,28,28,179,76,103
"2021","Colchester 003","E02004508",2674,621,379,242,1927,398,1049,354,478,217,267,132,125,10,206,95,111,7,7,126,56,70
"2021","Colchester 007","E02004512",5557,2298,704,1594,2892,279,1155,461,560,134,795,553,215,27,599,426,173,64,64,367,85,282
"2021","Colchester 008","E02004513",4295,1374,464,910,2155,188,755,253,337,165,480,262,189,29,653,457,196,79,79,766,91,675
"2021","Colchester 009","E02004514",2410,677,358,319,1612,293,844,259,420,165,237,109,105,23,229,143,86,9,9,121,52,69
"2021","Colchester 010","E02004515",3865,852,396,456,2847,453,1535,513,759,263,507,289,195,23,339,224,115,13,13,166,66,100
"2021","Colchester 011","E02004516",5606,1948,453,1495,3178,154,1255,455,670,130,893,549,320,24,816,614,202,60,60,480,143,337
"2021","Colchester 012","E02004517",4009,1146,602,544,2684,456,1315,430,660,225,506,260,220,26,393,260,133,14,14,179,87,92
"2021","Colchester 013","E02004518",3348,982,346,636,2147,238,1106,284,681,141,437,249,179,9,343,230,113,23,23,219,68,151
"2021","Colchester 014","E02004519",3104,810,552,258,2147,490,1127,372,524,231,272,124,119,29,249,135,114,9,9,147,56,91
"2021","Colchester 015","E02004520",3461,773,283,490,2464,149,1374,368,813,193,382,151,206,25,545,390,155,14,14,224,116,108
"2021","Colchester 016","E02004521",4229,1421,556,865,2563,298,1153,442,503,208,584,324,227,33,496,322,174,32,32,245,88,157
"2021","Colchester 017","E02004522",3405,1068,561,507,2166,476,1084,406,509,169,346,198,132,16,247,161,86,13,13,171,41,130
"2021","Colchester 018","E02004523",4152,1066,397,669,2819,258,1268,435,608,225,597,301,262,34,656,436,220,40,40,267,111,156
"2021","Colchester 019","E02004524",3311,671,426,245,2497,534,1425,543,612,270,330,164,135,31,199,107,92,9,9,143,59,84
"2021","Colchester 020","E02004525",3537,1027,622,405,2369,549,1109,389,461,259,379,191,157,31,318,149,169,14,14,141,62,79
"2021","Colchester 021","E02004526",3362,1056,722,334,2167,684,970,414,336,220,252,122,105,25,252,119,133,9,9,139,40,99
"2021","Colchester 022","E02006922",5885,1689,867,822,3800,717,1791,639,771,381,679,333,289,57,578,330,248,35,35,396,135,261
"2021","Colchester 023","E02007056",3391,796,197,599,2424,163,1283,349,813,121,629,378,242,9,332,247,85,17,17,171,69,102
"2021","Colchester 024","E02007057",3077,821,181,640,2023,133,1021,327,579,115,481,315,157,9,358,248,110,30,30,233,66,167
"2021","Epping Forest 001","E02004527",3951,1169,576,593,2618,421,1288,421,585,282,512,280,190,42,384,216,168,13,13,164,76,88
"2021","Epping Forest 002","E02004528",3500,796,523,273,2415,476,1318,470,523,325,344,180,126,38,256,127,129,21,21,289,120,169
"2021","Epping Forest 003","E02004529",2840,574,284,290,2055,402,1101,379,442,280,290,137,118,35,247,119,128,15,15,211,89,122
"2021","Epping Forest 004","E02004530",2924,794,482,312,2009,357,969,298,451,220,341,136,178,27,332,234,98,10,10,121,62,59
"2021","Epping Forest 005","E02004531",2923,797,451,346,1997,305,1006,302,511,193,349,167,154,28,325,163,162,12,12,129,59,70
"2021","Epping Forest 006","E02004532",2821,847,425,422,1852,299,870,301,416,153,404,236,146,22,264,142,122,15,15,122,54,68
"2021","Epping Forest 007","E02004533",3106,943,479,464,1970,253,913,257,434,222,351,125,184,42,443,243,200,10,10,193,93,100
"2021","Epping Forest 008","E02004534",3679,1019,387,632,2460,271,1114,300,584,230,473,204,234,35,575,342,233,27,27,200,103,97
"2021","Epping Forest 009","E02004535",2724,1044,463,581,1487,231,670,232,291,147,284,145,115,24,280,167,113,22,22,193,79,114
"2021","Epping Forest 010","E02004536",2528,688,408,280,1702,339,897,263,432,202,230,119,93,18,226,109,117,10,10,138,55,83
"2021","Epping Forest 011","E02004537",3992,1316,514,802,2441,145,1150,315,603,232,510,231,237,42,605,366,239,31,31,235,107,128
"2021","Epping Forest 012","E02004538",3827,897,431,466,2715,396,1508,412,767,329,422,247,149,26,368,192,176,21,21,215,105,110
"2021","Epping Forest 013","E02004539",3211,849,397,452,2144,223,1034,283,555,196,420,211,169,40,437,238,199,30,30,218,100,118
"2021","Epping Forest 014","E02004540",2436,623,320,303,1661,244,908,257,488,163,265,151,93,21,234,127,107,10,10,152,74,78
"2021","Epping Forest 015","E02004541",4878,1413,657,756,3201,455,1669,415,916,338,568,320,214,34,477,271,206,32,32,264,120,144
"2021","Epping Forest 016","E02004542",2546,531,294,237,1799,319,1067,291,510,266,185,90,75,20,212,103,109,16,16,216,120,96
"2021","Epping Forest 017","E02004543",2670,525,240,285,1821,227,937,206,509,222,218,92,110,16,408,247,161,31,31,324,198,126
"2021","Harlow 001","E02004544",4632,1252,471,781,3118,325,1460,454,802,204,755,420,291,44,555,375,180,23,23,262,128,134
"2021","Harlow 002","E02004545",3218,984,411,573,2000,177,849,255,401,193,378,144,189,45,569,379,190,27,27,234,99,135
"2021","Harlow 003","E02004546",3551,1176,436,740,2111,180,926,288,455,183,461,218,205,38,507,333,174,37,37,264,114,150
"2021","Harlow 004","E02004547",3907,1066,354,712,2470,176,1144,340,587,217,473,228,215,30,638,455,183,39,39,371,177,194
"2021","Harlow 005","E02004548",3479,768,272,496,2539,227,1336,359,737,240,576,253,279,44,379,234,145,21,21,172,89,83
"2021","Harlow 006","E02004549",3220,881,392,489,2116,210,946,254,469,223,401,140,218,43,535,327,208,24,24,223,109,114
"2021","Harlow 007","E02004550",3744,1274,508,766,2235,228,985,296,533,156,390,149,200,41,585,401,184,47,47,235,103,132
"2021","Harlow 008","E02004551",3178,1003,480,523,1987,224,867,242,437,188,396,167,198,31,472,306,166,28,28,188,86,102
"2021","Harlow 009","E02004552",2776,815,385,430,1804,292,881,266,388,227,299,128,138,33,316,185,131,16,16,157,69,88
"2021","Harlow 010","E02004553",3089,831,345,486,2020,211,863,237,460,166,409,164,207,38,508,343,165,29,29,238,105,133
"2021","Harlow 011","E02004554",3062,870,358,512,1959,214,907,273,448,186,361,154,185,22,446,284,162,31,31,233,108,125
"2021","Maldon 001","E02004555",2637,633,379,254,1869,419,1002,379,400,223,237,135,81,21,203,111,92,8,8,135,53,82
"2021","Maldon 002","E02004556",3041,649,428,221,2257,568,1249,458,561,230,256,138,103,15,178,99,79,6,6,135,64,71
"2021","Maldon 003","E02004557",3679,958,475,483,2561,376,1264,437,588,239,522,265,219,38,392,226,166,7,7,160,73,87
"2021","Maldon 004","E02004558",3319,1284,736,548,1923,362,765,300,314,151,417,232,149,36,365,228,137,14,14,112,36,76
"2021","Maldon 005","E02004559",3374,832,470,362,2390,518,1159,386,488,285,411,212,169,30,295,160,135,7,7,152,67,85
"2021","Maldon 006","E02004560",3681,922,507,415,2521,460,1238,470,504,264,489,243,198,48,321,180,141,13,13,238,104,134
"2021","Maldon 007","E02004561",4206,953,556,397,2977,615,1694,659,627,408,394,191,159,44,264,137,127,10,10,276,121,155
"2021","Maldon 008","E02004562",3968,1189,656,533,2621,549,1255,510,506,239,447,253,164,30,356,220,136,14,14,158,66,92
"2021","Rochford 001","E02004563",2905,833,582,251,1944,538,963,389,344,230,225,108,94,23,213,112,101,5,5,128,52,76
"2021","Rochford 002","E02004564",3241,770,507,263,2308,490,1259,443,519,297,304,137,137,30,250,125,125,5,5,163,71,92
"2021","Rochford 004","E02004566",2416,777,342,435,1523,174,643,217,283,143,320,144,149,27,374,248,126,12,12,116,49,67
"2021","Rochford 005","E02004567",3260,753,498,255,2357,519,1282,380,573,329,318,142,152,24,229,127,102,9,9,150,61,89
"2021","Rochford 006","E02004568",3589,924,403,521,2520,309,1292,376,664,252,524,263,226,35,375,240,135,20,20,145,63,82
"2021","Rochford 007","E02004569",3736,1185,533,652,2367,323,1130,384,529,217,529,279,222,28,373,222,151,12,12,184,81,103
"2021","Rochford 008","E02004570",3694,1070,669,401,2482,518,1253,393,593,267,352,166,157,29,350,212,138,9,9,142,60,82
"2021","Rochford 009","E02004571",3183,712,492,220,2347,547,1248,378,569,301,278,124,130,24,261,151,110,13,13,124,53,71
"2021","Rochford 010","E02004572",3253,826,464,362,2268,381,1102,396,474,232,430,194,199,37,340,189,151,15,15,159,67,92
"2021","Rochford 011","E02006980",2981,625,436,189,2226,476,1262,382,579,301,295,146,124,25,188,99,89,5,5,130,70,60
"2021","Rochford 012","E02006981",3291,884,535,349,2275,439,1221,370,553,298,346,162,144,40,258,138,120,11,11,132,57,75
"2021","Tendring 001","E02004573",3056,1294,472,822,1618,237,613,251,224,138,323,155,147,21,424,288,136,21,21,144,60,84
"2021","Tendring 002","E02004574",3401,1106,574,532,2148,347,859,311,356,192,446,189,233,24,483,348,135,13,13,147,81,66
"2021","Tendring 003","E02004575",5328,1651,828,823,3451,640,1714,667,744,303,687,404,245,38,392,222,170,18,18,226,92,134
"2021","Tendring 004","E02004576",3903,1040,630,410,2676,643,1338,573,508,257,395,163,197,35,294,162,132,6,6,187,88,99
"2021","Tendring 005","E02004577",2439,535,285,250,1778,312,1003,351,445,207,273,162,96,15,177,87,90,13,13,126,54,72
"2021","Tendring 006","E02004578",3766,1482,904,578,2121,671,811,428,234,149,306,152,132,22,321,196,125,12,12,163,65,98
"2021","Tendring 007","E02004579",3472,996,593,403,2285,570,1086,459,414,213,361,207,119,35,253,150,103,15,15,191,87,104
"2021","Tendring 008","E02004580",5786,1887,1386,501,3679,1255,1532,723,482,327,470,241,188,41,402,230,172,20,20,220,81,139
"2021","Tendring 009","E02004581",3533,838,504,334,2531,606,1256,511,520,225,397,186,186,25,260,127,133,12,12,164,71,93
"2021","Tendring 010","E02004582",3304,1098,720,378,2049,614,787,372,218,197,322,163,133,26,309,143,166,17,17,157,57,100
"2021","Tendring 011","E02004583",4078,1428,767,661,2446,563,1094,422,462,210,418,221,163,34,359,223,136,12,12,204,81,123
"2021","Tendring 012","E02004584",3288,1143,853,290,2004,777,750,394,177,179,228,124,85,19,240,99,141,9,9,141,47,94
"2021","Tendring 013","E02004585",3849,1120,643,477,2507,554,1033,371,398,264,463,201,218,44,445,254,191,12,12,222,104,118
"2021","Tendring 014","E02004586",3788,1407,821,586,2182,508,849,373,291,185,365,174,157,34,442,288,154,18,18,199,77,122
"2021","Tendring 015","E02004587",3393,1177,595,582,2036,346,742,295,269,178,389,135,218,36,529,340,189,30,30,180,82,98
"2021","Tendring 016","E02004588",3490,1796,701,1095,1498,174,433,167,182,84,375,167,185,23,485,330,155,31,31,196,82,114
"2021","Tendring 017","E02004589",3262,1136,608,528,1956,375,750,286,276,188,351,153,161,37,459,281,178,21,21,170,82,88
"2021","Tendring 018","E02004590",4323,1938,1067,871,2163,587,813,436,201,176,327,162,132,33,411,229,182,25,25,222,77,145
"2021","Uttlesford 001","E02004591",3096,723,399,324,2237,398,1248,413,647,188,338,204,114,20,246,147,99,7,7,136,62,74
"2021","Uttlesford 002","E02004592",5810,2003,1029,974,3606,519,1886,588,1006,292,645,351,266,28,538,331,207,18,18,201,62,139
"2021","Uttlesford 003","E02004593",3668,808,471,337,2716,528,1537,557,704,276,375,194,156,25,267,148,119,9,9,144,50,94
"2021","Uttlesford 004","E02004594",3287,723,401,322,2406,432,1368,464,669,235,363,205,127,31,233,131,102,10,10,158,65,93
"2021","Uttlesford 005","E02004595",5949,1367,629,738,4275,642,2332,748,1218,366,766,422,304,40,509,312,197,26,26,307,106,201
"2021","Uttlesford 006","E02004596",4008,845,383,462,2909,384,1569,449,826,294,545,232,274,39,396,268,128,15,15,254,110,144
"2021","Uttlesford 007","E02004597",3853,1142,513,629,2567,362,1321,426,642,253,480,242,205,33,393,250,143,11,11,144,51,93
"2021","Uttlesford 008","E02004598",4251,941,495,446,3124,558,1717,552,847,318,454,209,218,27,377,223,154,18,18,186,89,97
"2021","Uttlesford 009","E02004599",3035,676,370,306,2174,380,1252,393,599,260,292,150,120,22,243,138,105,7,7,185,81,104
"2021","Broxbourne 001","E02004843",2699,512,327,185,2040,411,1038,234,534,270,288,114,145,29,290,171,119,13,13,147,71,76
"2021","Broxbourne 002","E02004844",2884,695,317,378,1989,193,979,247,503,229,354,157,170,27,443,242,201,20,20,200,94,106
"2021","Broxbourne 003","E02004845",3634,1370,578,792,2077,288,920,281,461,178,441,244,168,29,402,273,129,26,26,187,68,119
"2021","Broxbourne 004","E02004846",2462,549,351,198,1772,360,1036,259,510,267,186,84,82,20,174,91,83,16,16,141,65,76
"2021","Broxbourne 005","E02004847",4253,1180,463,717,2864,314,1238,330,654,254,505,233,237,35,779,541,238,28,28,209,116,93
"2021","Broxbourne 006","E02004848",2930,659,303,356,2077,295,1061,249,535,277,313,111,164,38,387,223,164,21,21,194,104,90
"2021","Broxbourne 007","E02004849",2574,520,277,243,1903,324,1130,289,522,319,215,88,92,35,225,108,117,9,9,151,75,76
"2021","Broxbourne 008","E02004850",3055,894,410,484,1963,260,956,260,446,250,305,129,148,28,420,238,182,22,22,198,107,91
"2021","Broxbourne 009","E02004851",2431,727,332,395,1578,202,752,192,393,167,247,81,134,32,360,201,159,17,17,126,78,48
"2021","Broxbourne 010","E02004852",3302,947,444,503,2143,269,1001,279,481,241,350,164,156,30,476,296,180,47,47,212,111,101
"2021","Broxbourne 011","E02004853",2779,779,382,397,1843,226,901,204,484,213,278,124,130,24,427,256,171,11,11,157,92,65
"2021","Broxbourne 012","E02004854",3279,935,483,452,2081,271,981,261,472,248,358,171,157,30,434,253,181,37,37,263,150,113
"2021","Broxbourne 013","E02004855",3578,1203,403,800,2053,129,869,235,439,195,375,191,161,23,625,432,193,55,55,322,155,167
"2021","Dacorum 001","E02004856",2365,619,244,375,1660,231,889,288,446,155,305,159,128,18,227,129,98,8,8,86,36,50
"2021","Dacorum 002","E02004857",2526,760,371,389,1673,283,916,295,473,148,270,157,100,13,192,122,70,12,12,93,24,69
"2021","Dacorum 003","E02004858",2077,605,291,314,1398,201,738,205,404,129,233,112,107,14,216,130,86,10,10,74,35,39
"2021","Dacorum 004","E02004859",2236,626,339,287,1538,297,875,288,443,144,207,122,70,15,155,86,69,4,4,72,27,45
"2021","Dacorum 005","E02004860",2432,679,198,481,1634,139,780,248,403,129,307,156,133,18,383,259,124,25,25,119,58,61
"2021","Dacorum 006","E02004861",2396,713,461,252,1600,358,900,300,436,164,182,99,68,15,153,92,61,7,7,83,28,55
"2021","Dacorum 007","E02004862",3097,911,385,526,1930,230,926,297,436,193,325,141,151,33,431,270,161,18,18,256,118,138
"2021","Dacorum 008","E02004863",3164,952,395,557,1967,164,838,249,445,144,389,179,178,32,546,356,190,30,30,245,111,134
"2021","Dacorum 009","E02004864",2896,948,467,481,1872,345,1053,334,572,147,324,219,93,12,142,86,56,8,8,76,26,50
"2021","Dacorum 010","E02004865",2411,780,301,479,1511,143,732,217,356,159,319,169,128,22,300,196,104,17,17,120,36,84
"2021","Dacorum 011","E02004866",2745,745,356,389,1842,190,885,260,419,206,348,160,153,35,405,250,155,14,14,158,64,94
"2021","Dacorum 012","E02004867",2572,624,319,305,1867,272,1078,235,672,171,235,117,107,11,282,173,109,0,0,81,32,49
"2021","Dacorum 013","E02004868",3065,791,332,459,2073,183,956,282,518,156,417,202,201,14,493,377,116,24,24,201,89,112
"2021","Dacorum 014","E02004869",2370,626,291,335,1678,214,963,262,567,134,256,148,96,12,232,133,99,13,13,66,22,44
"2021","Dacorum 015","E02004870",5028,1727,539,1188,2970,248,1422,440,756,226,663,371,258,34,594,393,201,43,43,331,121,210
"2021","Dacorum 016","E02004871",2041,535,271,264,1422,170,697,193,337,167,278,134,121,23,265,149,116,12,12,84,42,42
"2021","Dacorum 017","E02004872",2926,642,345,297,2107,409,1081,316,512,253,263,113,124,26,343,203,140,11,11,177,93,84
"2021","Dacorum 018","E02004873",5104,1520,552,968,3344,359,1705,525,910,270,770,499,237,34,471,310,161,39,39,240,85,155
"2021","Dacorum 019","E02004874",2396,609,254,355,1628,173,864,265,406,193,268,122,126,20,310,172,138,13,13,159,60,99
"2021","Dacorum 020","E02004875",3959,994,433,561,2684,221,1381,337,785,259,530,272,217,41,532,308,224,20,20,281,112,169
"2021","Dacorum 021","E02004876",3474,894,497,397,2400,480,1321,408,668,245,322,173,123,26,269,146,123,8,8,180,76,104
"2021","Dacorum 022","E02004877",2138,551,308,243,1471,237,820,237,425,158,221,99,103,19,186,96,90,7,7,116,46,70
"2021","Hertsmere 001","E02004896",3382,995,620,375,2150,450,1141,340,530,271,271,153,89,29,268,141,127,20,20,237,70,167
"2021","Hertsmere 002","E02004897",2611,616,394,222,1818,289,1022,226,559,237,198,93,85,20,300,167,133,9,9,177,80,97
"2021","Hertsmere 003","E02004898",3186,947,454,493,2004,251,983,247,494,242,252,125,101,26,486,265,221,32,32,235,104,131
"2021","Hertsmere 004","E02004899",2105,487,215,272,1518,217,853,242,453,158,172,84,72,16,265,168,97,11,11,100,36,64
"2021","Hertsmere 005","E02004900",3188,743,400,343,2264,456,1362,332,746,284,180,107,61,12,248,138,110,18,18,181,95,86
"2021","Hertsmere 006","E02004901",4074,1253,466,787,2511,157,1257,316,704,237,432,196,193,43,621,385,236,44,44,310,143,167
"2021","Hertsmere 007","E02004902",3059,766,360,406,1991,192,1058,247,615,196,249,120,113,16,465,296,169,27,27,302,136,166
"2021","Hertsmere 008","E02004903",2881,695,261,434,1968,207,1093,287,603,203,273,137,119,17,377,219,158,18,18,218,103,115
"2021","Hertsmere 009","E02004904",2862,917,297,620,1782,134,906,241,481,184,297,160,108,29,416,286,130,29,29,163,76,87
"2021","Hertsmere 010","E02004905",2420,550,256,294,1700,272,1057,283,558,216,164,95,60,9,193,110,83,14,14,170,83,87
"2021","Hertsmere 011","E02004906",4205,1087,392,695,2729,237,1520,351,937,232,385,200,152,33,534,328,206,53,53,389,177,212
"2021","Hertsmere 012","E02004907",4411,1299,655,644,2875,411,1562,411,850,301,397,224,149,24,488,302,186,17,17,237,108,129
"2021","Hertsmere 013","E02004908",4313,1172,727,445,2923,609,1708,452,922,334,219,117,80,22,366,198,168,21,21,218,98,120
"2021","North Hertfordshire 001","E02004909",2532,800,301,499,1629,191,839,279,420,140,373,209,140,24,209,139,70,17,17,103,37,66
"2021","North Hertfordshire 002","E02004910",4958,1356,636,720,3444,658,1816,575,916,325,585,344,208,33,369,226,143,16,16,158,50,108
"2021","North Hertfordshire 003","E02004911",3039,1038,495,543,1888,254,897,303,437,157,379,188,171,20,341,204,137,17,17,113,54,59
"2021","North Hertfordshire 004","E02004912",4677,1577,670,907,2942,368,1478,484,719,275,593,356,203,34,487,298,189,16,16,158,55,103
"2021","North Hertfordshire 006","E02004914",3469,1106,403,703,2210,251,1041,326,546,169,500,280,199,21,397,274,123,21,21,153,65,88
"2021","North Hertfordshire 007","E02004915",2468,835,349,486,1523,193,689,219,329,141,315,178,110,27,315,189,126,11,11,110,56,54
"2021","North Hertfordshire 008","E02004916",3084,863,478,385,2046,449,1058,339,514,205,260,147,105,8,269,145,124,10,10,175,68,107
"2021","North Hertfordshire 009","E02004917",2698,817,419,398,1736,346,810,234,379,197,262,115,123,24,306,181,125,12,12,145,60,85
"2021","North Hertfordshire 010","E02004918",3676,1268,349,919,2202,174,1118,348,620,150,590,428,143,19,295,186,109,25,25,206,69,137
"2021","North Hertfordshire 011","E02004919",3213,876,348,528,2204,251,1147,329,620,198,447,290,139,18,339,193,146,20,20,133,49,84
"2021","North Hertfordshire 012","E02004920",5045,1707,786,921,3156,490,1537,475,806,256,588,349,211,28,503,302,201,38,38,182,65,117
"2021","North Hertfordshire 013","E02004921",3308,982,441,541,2207,342,1239,346,717,176,387,224,147,16,229,147,82,10,10,119,40,79
"2021","North Hertfordshire 014","E02004922",4159,1039,555,484,2934,524,1529,554,708,267,481,246,191,44,385,245,140,15,15,186,83,103
"2021","North Hertfordshire 015","E02004923",4435,1257,669,588,3013,523,1633,565,779,289,475,294,156,25,368,232,136,14,14,165,61,104
"2021","North Hertfordshire 016","E02007088",3160,758,415,343,2249,463,1244,459,571,214,293,149,118,26,243,150,93,6,6,153,62,91
"2021","North Hertfordshire 017","E02007089",2818,623,190,433,2017,136,1162,339,661,162,407,226,165,16,303,208,95,9,9,178,81,97
"2021","Three Rivers 001","E02004956",3859,1214,604,610,2441,354,1271,343,656,272,412,244,140,28,381,212,169,23,23,204,80,124
"2021","Three Rivers 002","E02004957",4204,1084,420,664,2890,274,1571,364,916,291,458,212,215,31,568,358,210,19,19,230,113,117
"2021","Three Rivers 003","E02004958",3072,713,382,331,2198,378,1302,364,672,266,241,116,107,18,264,149,115,13,13,161,62,99
"2021","Three Rivers 004","E02004959",2422,701,389,312,1566,286,989,275,491,223,160,113,39,8,125,67,58,6,6,155,76,79
"2021","Three Rivers 005","E02004960",2190,466,300,166,1628,285,1017,243,573,201,152,89,56,7,164,100,64,10,10,96,36,60
"2021","Three Rivers 006","E02004961",3776,909,544,365,2685,379,1626,390,949,287,351,155,162,34,315,163,152,14,14,182,93,89
"2021","Three Rivers 007","E02004962",3663,1024,452,572,2441,291,1363,340,789,234,415,224,164,27,354,200,154,18,18,198,86,112
"2021","Three Rivers 008","E02004963",2785,626,317,309,1928,205,1080,231,608,241,231,88,114,29,393,238,155,19,19,231,124,107
"2021","Three Rivers 009","E02004964",2317,640,307,333,1545,153,761,203,421,137,281,128,137,16,336,182,154,14,14,132,53,79
"2021","Three Rivers 010","E02004965",2745,750,444,306,1798,341,989,243,513,233,175,62,89,24,284,116,168,9,9,197,112,85
"2021","Three Rivers 011","E02004966",2599,500,304,196,1839,377,1194,337,565,292,124,76,41,7,132,62,70,12,12,260,140,120
"2021","Three Rivers 012","E02004967",3224,1065,322,743,1964,106,1051,264,602,185,341,142,167,32,429,272,157,37,37,195,100,95
"2021","Watford 001","E02004968",3020,888,356,532,1918,179,997,228,562,207,293,127,137,29,426,258,168,23,23,214,104,110
"2021","Watford 002","E02004969",2821,678,281,397,1957,239,1085,314,546,225,247,107,109,31,364,211,153,22,22,186,99,87
"2021","Watford 003","E02004970",3266,913,430,483,2116,210,1088,246,612,230,311,134,142,35,475,300,175,32,32,237,121,116
"2021","Watford 004","E02004971",3093,789,294,495,2004,132,1144,248,708,188,294,161,116,17,408,229,179,26,26,300,175,125
"2021","Watford 005","E02004972",2395,577,277,300,1636,225,1002,275,523,204,214,127,71,16,176,84,92,19,19,182,96,86
"2021","Watford 006","E02004973",3416,980,198,782,2012,90,1049,300,622,127,457,290,158,9,371,209,162,45,45,424,204,220
"2021","Watford 007","E02004974",3592,1004,378,626,2308,290,1361,368,784,209,363,234,108,21,273,163,110,21,21,280,122,158
"2021","Watford 008","E02004975",2938,602,298,304,2073,296,1343,288,782,273,207,116,74,17,206,116,90,21,21,263,127,136
"2021","Watford 009","E02004976",5150,2000,386,1614,2642,91,1282,421,740,121,714,532,167,15,464,308,156,91,91,508,165,343
"2021","Watford 010","E02004977",3161,787,182,605,1872,77,1102,245,694,163,301,162,125,14,342,205,137,50,50,502,260,242
"2021","Watford 011","E02004978",3852,1067,286,781,2393,119,1264,278,771,215,356,198,130,28,616,405,211,38,38,392,206,186
"2021","Watford 012","E02004979",2922,860,374,486,1866,227,1036,258,601,177,308,189,102,17,275,144,131,20,20,196,92,104
"2021","Breckland 001","E02005503",3122,777,442,335,2205,501,1120,504,450,166,356,195,147,14,213,117,96,15,15,140,56,84
"2021","Breckland 002","E02005504",3990,974,587,387,2827,704,1388,644,469,275,425,235,167,23,297,173,124,13,13,189,81,108
"2021","Breckland 003","E02005505",3226,911,510,401,2171,442,1031,393,437,201,376,203,153,20,313,202,111,9,9,144,69,75
"2021","Breckland 004","E02005506",3008,774,439,335,2087,494,997,427,365,205,360,182,155,23,222,136,86,14,14,147,62,85
"2021","Breckland 005","E02005507",5282,1762,814,948,3303,684,1324,506,577,241,676,337,302,37,594,371,223,25,25,217,87,130
"2021","Breckland 006","E02005508",3057,754,462,292,2121,495,1090,501,389,200,354,223,106,25,168,94,74,14,14,182,71,111
"2021","Breckland 007","E02005509",3972,1300,747,553,2529,669,1035,482,366,187,432,225,180,27,377,241,136,16,16,143,53,90
"2021","Breckland 008","E02005510",3271,905,556,349,2223,579,1079,515,346,218,360,205,126,29,195,120,75,10,10,143,52,91
"2021","Breckland 009","E02005511",4002,1187,679,508,2556,654,1089,519,383,187,484,269,189,26,305,177,128,24,24,259,95,164
"2021","Breckland 010","E02005512",3746,793,350,443,2721,477,1363,606,512,245,595,310,250,35,269,164,105,17,17,232,100,132
"2021","Breckland 011","E02005513",4677,1433,743,690,3028,531,1367,545,594,228,694,397,262,35,418,273,145,18,18,216,103,113
"2021","Breckland 012","E02005514",3040,796,411,385,2100,462,1037,509,358,170,371,212,137,22,216,123,93,14,14,144,51,93
"2021","Breckland 013","E02005515",2668,628,344,284,1905,383,1014,405,424,185,315,184,105,26,182,110,72,11,11,135,52,83
"2021","Breckland 014","E02005516",3003,717,384,333,2137,496,1063,432,429,202,361,198,140,23,213,120,93,4,4,149,47,102
"2021","Breckland 015","E02005517",2339,674,258,416,1447,134,573,189,274,110,345,138,182,25,368,253,115,27,27,218,99,119
"2021","Breckland 016","E02005518",4531,1280,548,732,2914,400,1413,533,628,252,701,392,270,39,363,224,139,37,37,337,142,195
"2021","Breckland 017","E02005519",3411,881,429,452,2216,244,965,384,380,201,444,147,265,32,535,350,185,28,28,314,143,171
"2021","Broadland 001","E02005520",4077,1263,743,520,2687,664,1195,498,500,197,444,237,183,24,375,257,118,9,9,127,58,69
"2021","Broadland 002","E02005521",3801,1036,570,466,2595,575,1243,535,473,235,445,231,177,37,319,191,128,13,13,170,66,104
"2021","Broadland 003","E02005522",2365,611,332,279,1655,356,840,351,319,170,266,152,99,15,185,107,78,8,8,99,41,58
"2021","Broadland 004","E02005523",3517,804,384,420,2570,410,1337,488,604,245,470,256,179,35,344,217,127,9,9,143,51,92
"2021","Broadland 005","E02005524",2376,671,387,284,1636,373,829,341,321,167,265,141,104,20,160,90,70,9,9,69,22,47
"2021","Broadland 006","E02005525",4174,1132,549,583,2914,556,1527,560,703,264,475,252,198,25,347,224,123,9,9,128,47,81
"2021","Broadland 007","E02005526",2309,653,330,323,1571,314,796,286,368,142,261,146,104,11,193,104,89,7,7,85,29,56
"2021","Broadland 008","E02005527",3814,900,480,420,2754,605,1375,522,637,216,469,263,172,34,297,178,119,8,8,160,53,107
"2021","Broadland 009","E02005528",3808,1096,578,518,2560,532,1223,512,502,209,471,263,182,26,322,183,139,12,12,152,53,99
"2021","Broadland 010","E02005529",2617,839,527,312,1683,442,783,331,286,166,270,136,113,21,178,96,82,10,10,95,40,55
"2021","Broadland 011","E02005530",2390,708,401,307,1570,334,778,303,328,147,295,174,104,17,158,74,84,5,5,112,41,71
"2021","Broadland 012","E02005531",2368,709,342,367,1564,324,725,295,297,133,296,164,116,16,213,122,91,6,6,95,38,57
"2021","Broadland 013","E02005532",4357,1334,643,691,2878,606,1277,507,542,228,655,393,227,35,321,202,119,19,19,145,56,89
"2021","Broadland 014","E02005533",3916,980,580,400,2792,653,1349,569,565,215,446,248,164,34,321,203,118,23,23,144,65,79
"2021","Broadland 015","E02005534",3397,1077,621,456,2216,471,1106,463,457,186,370,197,149,24,261,138,123,8,8,104,34,70
"2021","Broadland 016","E02005535",3054,872,373,499,2064,294,1050,407,495,148,404,233,146,25,303,184,119,13,13,118,40,78
"2021","Broadland 017","E02005536",2720,737,412,325,1884,439,943,392,379,172,309,184,102,23,189,117,72,4,4,99,38,61
"2021","Broadland 018","E02005537",2699,818,491,327,1779,407,817,363,297,157,316,163,131,22,228,135,93,11,11,102,38,64
"2021","Great Yarmouth 001","E02005538",4344,1213,701,512,2959,749,1366,672,391,303,482,260,189,33,346,182,164,16,16,172,61,111
"2021","Great Yarmouth 002","E02005539",3415,820,489,331,2425,555,1175,547,379,249,407,213,167,27,271,163,108,17,17,170,66,104
"2021","Great Yarmouth 003","E02005540",4165,1346,870,476,2647,676,1098,518,349,231,489,268,180,41,367,193,174,17,17,172,82,90
"2021","Great Yarmouth 004","E02005541",2551,861,471,390,1533,288,613,226,236,151,300,112,146,42,314,217,97,18,18,157,77,80
"2021","Great Yarmouth 005","E02005542",3393,1404,393,1011,1747,147,537,212,215,110,469,226,213,30,556,413,143,38,38,242,103,139
"2021","Great Yarmouth 006","E02005543",4156,1707,467,1240,2135,136,598,246,256,96,596,282,283,31,759,584,175,46,46,314,133,181
"2021","Great Yarmouth 007","E02005544",3113,1093,350,743,1806,149,644,232,279,133,469,201,248,20,513,361,152,31,31,214,104,110
"2021","Great Yarmouth 008","E02005545",2844,774,455,319,1984,516,921,363,366,192,326,162,134,30,215,127,88,6,6,86,36,50
"2021","Great Yarmouth 009","E02005546",3739,1400,587,813,2172,289,755,298,282,175,487,210,225,52,624,441,183,17,17,167,64,103
"2021","Great Yarmouth 010","E02005547",3806,1227,578,649,2386,465,1041,423,412,206,422,205,180,37,438,263,175,20,20,193,92,101
"2021","Great Yarmouth 011","E02005548",3090,883,506,377,2055,299,853,328,356,169,409,139,220,50,479,300,179,15,15,152,62,90
"2021","Great Yarmouth 012","E02005549",2486,720,399,321,1647,377,792,398,242,152,305,152,131,22,173,95,78,0,0,119,45,74
"2021","Great Yarmouth 013","E02005550",3434,1041,597,444,2264,433,1041,422,426,193,486,227,223,36,295,188,107,9,9,129,53,76
"2021","King's Lynn and West Norfolk 001","E02005551",2702,1089,696,393,1529,550,571,334,129,108,212,137,61,14,183,106,77,13,13,84,32,52
"2021","King's Lynn and West Norfolk 002","E02005552",3127,1009,606,403,2009,594,866,447,257,162,309,175,111,23,225,128,97,15,15,109,39,70
"2021","King's Lynn and West Norfolk 003","E02005553",4253,1425,950,475,2697,931,1097,607,289,201,368,210,140,18,297,150,147,4,4,131,51,80
"2021","King's Lynn and West Norfolk 004","E02005554",3333,1073,726,347,2153,675,908,432,302,174,332,178,120,34,231,131,100,7,7,107,43,64
"2021","King's Lynn and West Norfolk 005","E02005555",2842,633,421,212,2092,557,1054,416,430,208,283,126,123,34,192,101,91,6,6,117,57,60
"2021","King's Lynn and West Norfolk 006","E02005556",3328,917,467,450,2272,381,1095,425,452,218,474,218,223,33,314,174,140,8,8,139,65,74
"2021","King's Lynn and West Norfolk 007","E02005557",2750,742,281,461,1799,116,693,225,342,126,445,172,234,39,508,360,148,37,37,209,89,120
"2021","King's Lynn and West Norfolk 008","E02005558",3049,734,453,281,2121,491,1006,430,380,196,388,187,159,42,226,122,104,10,10,194,88,106
"2021","King's Lynn and West Norfolk 009","E02005559",3068,952,421,531,1875,252,871,318,382,171,397,194,173,30,333,206,127,22,22,241,111,130
"2021","King's Lynn and West Norfolk 010","E02005560",3670,987,376,611,2421,222,1147,369,613,165,520,225,259,36,497,342,155,35,35,262,115,147
"2021","King's Lynn and West Norfolk 011","E02005561",5255,2271,784,1487,2622,283,942,380,419,143,749,389,323,37,598,428,170,50,50,362,118,244
"2021","King's Lynn and West Norfolk 012","E02005562",3307,911,526,385,2261,532,1055,476,374,205,392,200,153,39,272,161,111,10,10,135,50,85
"2021","King's Lynn and West Norfolk 013","E02005563",3262,767,439,328,2255,433,1102,489,366,247,462,215,213,34,247,143,104,11,11,240,119,121
"2021","King's Lynn and West Norfolk 014","E02005564",3827,874,512,362,2785,586,1500,631,612,257,415,229,166,20,269,148,121,15,15,168,68,100
"2021","King's Lynn and West Norfolk 015","E02005565",3124,785,405,380,2172,424,1015,413,408,194,461,249,188,24,257,138,119,15,15,167,58,109
"2021","King's Lynn and West Norfolk 016","E02005566",4357,1088,590,498,2993,567,1482,672,478,332,576,284,255,37,340,192,148,28,28,276,126,150
"2021","King's Lynn and West Norfolk 017","E02005567",5294,1828,1061,767,3259,793,1362,591,558,213,648,366,258,24,444,274,170,12,12,207,83,124
"2021","King's Lynn and West Norfolk 018","E02005568",3336,866,484,382,2302,508,1187,578,396,213,371,206,148,17,229,119,110,7,7,168,66,102
"2021","King's Lynn and West Norfolk 019","E02005569",3591,884,431,453,2515,420,1364,594,573,197,455,228,194,33,260,160,100,16,16,192,78,114
"2021","North Norfolk 001","E02005570",3420,1213,789,424,2092,704,868,436,284,148,270,132,124,14,238,134,104,12,12,115,35,80
"2021","North Norfolk 002","E02005571",2830,1002,617,385,1750,519,750,400,233,117,273,139,113,21,197,109,88,11,11,78,22,56
"2021","North Norfolk 003","E02005572",3860,1644,931,713,2064,614,772,404,240,128,358,196,134,28,296,172,124,24,24,152,51,101
"2021","North Norfolk 004","E02005573",2871,1115,755,360,1666,607,630,369,173,88,233,126,96,11,190,112,78,6,6,90,19,71
"2021","North Norfolk 005","E02005574",3244,965,544,421,2127,606,998,553,276,169,320,179,116,25,191,105,86,12,12,152,46,106
"2021","North Norfolk 006","E02005575",3177,895,550,345,2157,600,1026,483,334,209,317,183,112,22,204,122,82,10,10,125,41,84
"2021","North Norfolk 007","E02005576",3158,1051,584,467,1962,610,852,443,259,150,268,150,101,17,227,118,109,5,5,145,59,86
"2021","North Norfolk 008","E02005577",2722,807,451,356,1798,442,823,405,286,132,301,163,116,22,218,131,87,14,14,117,41,76
"2021","North Norfolk 009","E02005578",2654,789,388,401,1771,352,815,391,286,138,381,213,150,18,215,116,99,8,8,94,33,61
"2021","North Norfolk 011","E02005580",3773,1349,739,610,2285,547,940,423,350,167,446,218,193,35,336,192,144,16,16,139,60,79
"2021","North Norfolk 012","E02005581",3235,864,422,442,2219,474,1105,572,365,168,394,233,144,17,232,134,98,14,14,152,57,95
"2021","North Norfolk 013","E02005582",3249,1153,587,566,1955,476,842,433,261,148,365,210,128,27,260,152,108,12,12,141,56,85
"2021","North Norfolk 014","E02005583",4056,1227,777,450,2680,846,1200,637,342,221,390,216,148,26,231,106,125,13,13,149,50,99
"2021","North Norfolk 015","E02007032",3246,1186,656,530,1948,456,822,363,282,177,332,169,143,20,329,217,112,9,9,112,45,67
"2021","North Norfolk 016","E02007033",2884,1056,521,535,1733,374,712,296,275,141,358,202,144,12,279,174,105,10,10,95,34,61
"2021","Norwich 001","E02005584",4958,1776,539,1237,2855,300,1212,417,602,193,687,365,288,34,614,419,195,42,42,327,101,226
"2021","Norwich 002","E02005585",4865,1668,518,1150,2799,232,1045,354,536,155,780,376,348,56,702,466,236,40,40,398,99,299
"2021","Norwich 003","E02005586",5086,1989,422,1567,2659,167,965,422,422,121,982,706,257,19,482,327,155,63,63,438,88,350
"2021","Norwich 004","E02005587",4287,1428,622,806,2632,353,1070,382,497,191,581,271,260,50,600,393,207,28,28,227,73,154
"2021","Norwich 005","E02005588",5020,1431,544,887,2849,280,1223,422,600,201,681,311,311,59,627,429,198,38,38,740,119,621
"2021","Norwich 006","E02005589",4944,1514,494,1020,2752,272,1064,346,531,187,695,352,307,36,684,476,208,37,37,678,109,569
"2021","Norwich 009","E02005592",4190,1415,394,1021,2216,254,956,387,479,90,688,509,157,22,289,206,83,29,29,559,31,528
"2021","Norwich 010","E02005593",2892,844,416,428,1493,189,596,153,317,126,290,114,156,20,389,243,146,29,29,555,45,510
"2021","Norwich 011","E02005594",5621,2552,916,1636,2532,321,1041,422,486,133,697,519,146,32,428,271,157,45,45,537,68,469
"2021","Norwich 012","E02005595",4124,1263,777,486,2525,638,1227,457,587,183,377,225,137,15,263,169,94,20,20,336,57,279
"2021","Norwich 013","E02005596",4553,1703,713,990,2589,313,925,327,440,158,694,341,310,43,622,434,188,35,35,261,86,175
"2021","Norwich 014","E02006907",4308,2465,485,1980,1536,123,553,298,218,37,600,531,62,7,211,138,73,49,49,307,26,281
"2021","Norwich 015","E02006908",3019,1384,357,1027,1458,147,497,251,206,40,481,341,121,19,308,198,110,25,25,177,27,150
"2021","Norwich 016","E02007052",3701,2012,597,1415,1417,116,422,191,190,41,495,341,141,13,343,254,89,41,41,272,43,229
"2021","Norwich 017","E02007053",2897,1658,421,1237,1013,124,303,181,105,17,392,345,43,4,164,106,58,30,30,226,16,210
"2021","South Norfolk 002","E02005598",4107,996,455,541,2918,565,1529,540,789,200,503,284,194,25,305,203,102,16,16,193,68,125
"2021","South Norfolk 003","E02005599",3102,845,443,402,2161,422,1031,363,522,146,421,234,162,25,276,181,95,11,11,96,43,53
"2021","South Norfolk 004","E02005600",2469,623,376,247,1745,398,902,376,381,145,252,142,90,20,183,111,72,10,10,101,41,60
"2021","South Norfolk 005","E02005601",2759,1101,617,484,1584,382,720,317,275,128,260,168,78,14,211,117,94,11,11,74,27,47
"2021","South Norfolk 006","E02005602",5611,1546,813,733,3858,803,1900,752,855,293,692,386,269,37,447,274,173,16,16,207,88,119
"2021","South Norfolk 007","E02005603",5275,1361,573,788,3739,483,1916,618,1041,257,745,415,302,28,575,408,167,20,20,175,79,96
"2021","South Norfolk 008","E02005604",3811,1041,599,442,2641,592,1308,533,526,249,407,229,151,27,323,179,144,11,11,129,56,73
"2021","South Norfolk 009","E02005605",4500,1107,589,518,3225,678,1699,660,753,286,499,273,203,23,330,203,127,19,19,168,62,106
"2021","South Norfolk 010","E02005606",2496,598,322,276,1772,390,915,405,324,186,295,184,100,11,163,84,79,9,9,126,52,74
"2021","South Norfolk 011","E02005607",4844,1163,602,561,3488,664,1800,772,708,320,603,318,248,37,401,241,160,20,20,193,75,118
"2021","South Norfolk 012","E02005608",3328,910,538,372,2290,530,1159,509,407,243,372,234,110,28,220,123,97,9,9,128,50,78
"2021","South Norfolk 013","E02005609",3483,1105,602,503,2248,562,956,432,361,163,424,207,196,21,300,203,97,6,6,130,46,84
"2021","South Norfolk 014","E02005610",3529,914,527,387,2444,549,1217,600,400,217,415,248,138,29,251,148,103,12,12,171,66,105
"2021","South Norfolk 015","E02005611",5098,1731,933,798,3147,664,1337,551,550,236,650,376,237,37,463,283,180,33,33,220,74,146
"2021","South Norfolk 016","E02007054",3548,864,235,629,2467,242,1239,406,718,115,632,371,237,24,334,240,94,20,20,217,96,121
"2021","South Norfolk 017","E02007055",3440,1083,565,518,2188,464,1013,431,403,179,408,230,154,24,294,161,133,9,9,169,49,120
"2021","Babergh 001","E02006227",2992,929,550,379,1949,526,930,463,285,182,296,157,118,21,188,96,92,9,9,114,47,67
"2021","Babergh 002","E02006228",2643,683,363,320,1868,397,922,382,353,187,333,180,134,19,210,124,86,6,6,92,36,56
"2021","Babergh 003","E02006229",2805,817,484,333,1907,533,875,366,339,170,290,164,108,18,208,115,93,1,1,81,28,53
"2021","Babergh 004","E02006230",4664,1272,795,477,3233,717,1667,629,730,308,438,231,177,30,401,247,154,10,10,159,64,95
"2021","Babergh 005","E02006231",3767,1058,465,593,2559,410,1312,531,560,221,529,334,165,30,297,186,111,11,11,150,64,86
"2021","Babergh 006","E02006232",2606,629,389,240,1843,440,903,372,363,168,284,140,121,23,207,116,91,9,9,134,46,88
"2021","Babergh 007","E02006233",5465,2081,986,1095,3141,586,1281,543,470,268,704,365,292,47,550,321,229,20,20,243,77,166
"2021","Babergh 008","E02006234",4049,1020,478,542,2845,438,1287,432,594,261,599,266,287,46,505,314,191,16,16,184,79,105
"2021","Babergh 009","E02006235",3542,902,530,372,2488,584,1311,578,517,216,371,202,154,15,211,124,87,11,11,152,58,94
"2021","Babergh 010","E02006236",4420,1059,690,369,3196,822,1638,640,667,331,425,211,185,29,298,173,125,13,13,165,68,97
"2021","Babergh 011","E02006237",3239,930,551,379,2200,502,1097,485,428,184,350,177,142,31,245,132,113,6,6,109,43,66
"2021","Ipswich 001","E02006245",3263,827,507,320,2248,401,990,317,457,216,399,153,211,35,436,251,185,22,22,188,94,94
"2021","Ipswich 002","E02006246",3063,752,459,293,2178,398,1126,423,486,217,419,206,187,26,230,121,109,5,5,133,53,80
"2021","Ipswich 003","E02006247",3855,1162,389,773,2490,256,1050,371,479,200,596,282,277,37,555,387,168,33,33,203,75,128
"2021","Ipswich 004","E02006248",3366,894,466,428,2304,336,1176,324,667,185,393,156,208,29,393,228,165,6,6,168,84,84
"2021","Ipswich 005","E02006249",3662,1189,541,648,2281,380,1186,415,602,169,392,230,140,22,297,190,107,26,26,192,71,121
"2021","Ipswich 006","E02006250",4517,1703,366,1337,2416,128,996,344,497,155,663,378,269,16,560,389,171,69,69,398,168,230
"2021","Ipswich 007","E02006251",5201,2318,435,1883,2479,142,1028,390,505,133,749,491,242,16,499,341,158,61,61,404,99,305
"2021","Ipswich 008","E02006252",4163,1377,542,835,2582,259,1266,409,683,174,608,304,273,31,428,301,127,21,21,204,74,130
"2021","Ipswich 009","E02006253",3183,908,507,401,2128,519,1098,374,514,210,289,141,126,22,209,120,89,13,13,147,68,79
"2021","Ipswich 010","E02006254",4013,1466,434,1032,2270,205,950,288,486,176,557,287,233,37,514,337,177,44,44,277,132,145
"2021","Ipswich 011","E02006255",3530,1179,359,820,2121,222,1010,388,473,149,517,333,165,19,342,204,138,30,30,230,78,152
"2021","Ipswich 012","E02006256",4300,1536,405,1131,2493,203,964,336,477,151,638,352,247,39,647,489,158,41,41,271,112,159
"2021","Ipswich 013","E02006257",2957,978,479,499,1859,328,825,285,360,180,369,166,179,24,329,176,153,8,8,120,56,64
"2021","Ipswich 014","E02006258",3749,1007,424,583,2487,223,1127,356,577,194,524,264,224,36,575,349,226,38,38,255,131,124
"2021","Ipswich 015","E02006259",3171,1010,457,553,2011,341,778,300,315,163,364,142,190,32,522,374,148,6,6,150,77,73
"2021","Ipswich 016","E02006260",3525,967,466,501,2317,275,1032,350,504,178,481,176,268,37,513,341,172,16,16,241,118,123
"2021","Mid Suffolk 001","E02006261",3439,911,546,365,2363,598,1155,497,431,227,327,196,113,18,273,151,122,10,10,165,69,96
"2021","Mid Suffolk 002","E02006262",3849,982,569,413,2690,610,1419,625,531,263,388,218,140,30,263,135,128,10,10,177,75,102
"2021","Mid Suffolk 003","E02006263",3288,809,477,332,2355,622,1147,525,415,207,344,208,109,27,236,123,113,6,6,124,50,74
"2021","Mid Suffolk 004","E02006264",3763,945,518,427,2659,556,1387,544,606,237,448,259,160,29,259,160,99,9,9,159,72,87
"2021","Mid Suffolk 005","E02006265",3262,855,495,360,2283,507,1140,525,409,206,383,219,139,25,244,141,103,9,9,124,45,79
"2021","Mid Suffolk 006","E02006266",4155,1082,643,439,2907,698,1491,678,533,280,412,222,161,29,291,180,111,15,15,166,53,113
"2021","Mid Suffolk 007","E02006267",3503,819,480,339,2515,562,1386,587,536,263,325,180,118,27,223,134,89,19,19,169,73,96
"2021","Mid Suffolk 008","E02006268",2774,923,546,377,1761,352,722,277,280,165,342,153,157,32,329,190,139,16,16,90,37,53
"2021","Mid Suffolk 009","E02006269",3228,853,397,456,2245,413,1188,470,490,228,426,249,153,24,212,123,89,6,6,130,55,75
"2021","Mid Suffolk 010","E02006270",5578,1653,553,1100,3740,417,1792,694,861,237,962,567,350,45,541,379,162,28,28,185,66,119
"2021","Mid Suffolk 011","E02006271",4171,1218,568,650,2816,485,1354,597,571,186,655,391,239,25,305,165,140,17,17,137,56,81
"2021","Mid Suffolk 012","E02006272",3326,931,532,399,2243,532,1100,456,429,215,362,198,138,26,241,136,105,8,8,152,73,79
"2021","St Albans 001","E02004924",2870,599,315,284,2173,300,1413,306,903,204,216,113,85,18,233,141,92,11,11,98,43,55
"2021","St Albans 002","E02004925",2938,718,320,398,2119,245,1358,281,902,175,231,117,102,12,275,181,94,10,10,101,44,57
"2021","St Albans 003","E02004926",3291,913,484,429,2273,398,1412,336,896,180,256,178,74,4,200,134,66,7,7,105,33,72
"2021","St Albans 004","E02004927",2651,616,372,244,1932,395,1046,272,608,166,235,114,108,13,245,160,85,11,11,103,45,58
"2021","St Albans 005","E02004928",2654,550,342,208,2017,377,1269,345,723,201,199,108,80,11,172,108,64,0,0,87,41,46
"2021","St Albans 006","E02004929",2576,655,391,264,1811,362,985,260,575,150,216,117,83,16,233,146,87,15,15,110,35,75
"2021","St Albans 007","E02004930",2828,802,365,437,1909,244,1093,291,650,152,302,179,105,18,263,160,103,7,7,117,53,64
"2021","St Albans 008","E02004931",2718,711,374,337,1878,260,1154,239,736,179,198,100,85,13,254,154,100,12,12,129,58,71
"2021","St Albans 009","E02004932",2956,732,317,415,2080,185,1164,269,717,178,300,156,128,16,415,255,160,16,16,144,71,73
"2021","St Albans 010","E02004933",2529,440,243,197,1992,297,1345,307,852,186,217,123,88,6,127,72,55,6,6,97,36,61
"2021","St Albans 011","E02004934",3292,987,253,734,2130,166,1164,322,719,123,512,384,114,14,262,174,88,26,26,175,48,127
"2021","St Albans 012","E02004935",4370,1643,395,1248,2508,119,1227,448,683,96,831,679,144,8,294,195,99,37,37,219,32,187
"2021","St Albans 013","E02004936",2428,538,194,344,1778,163,1139,234,756,149,241,139,95,7,222,128,94,13,13,112,51,61
"2021","St Albans 014","E02004937",3000,788,449,339,2123,427,1207,328,708,171,290,195,84,11,187,105,82,12,12,89,30,59
"2021","St Albans 016","E02004939",2693,803,407,396,1731,209,960,214,613,133,226,125,88,13,326,189,137,10,10,159,57,102
"2021","St Albans 017","E02004940",3000,848,329,519,1963,153,1091,268,682,141,369,218,134,17,327,193,134,23,23,189,84,105
"2021","St Albans 018","E02004941",3893,1064,444,620,2571,251,1366,362,703,301,433,219,184,30,502,287,215,19,19,258,123,135
"2021","St Albans 019","E02004942",2625,733,403,330,1757,304,939,240,502,197,245,132,89,24,257,148,109,12,12,135,52,83
"2021","St Albans 020","E02004943",3303,837,447,390,2288,506,1301,336,676,289,232,128,84,20,239,116,123,10,10,178,76,102
"2021","St Albans 021","E02007090",2365,550,235,315,1695,209,950,237,541,172,247,117,111,19,277,172,105,12,12,120,55,65
"2021","Welwyn Hatfield 001","E02004980",2428,524,299,225,1777,381,1084,354,510,220,188,96,74,18,124,62,62,0,0,127,47,80
"2021","Welwyn Hatfield 002","E02004981",3231,819,412,407,2218,357,1186,334,655,197,349,169,153,27,307,188,119,19,19,194,85,109
"2021","Welwyn Hatfield 003","E02004982",2400,593,354,239,1710,262,950,272,511,167,244,99,125,20,248,161,87,6,6,97,43,54
"2021","Welwyn Hatfield 004","E02004983",2604,824,396,428,1654,206,811,228,438,145,319,147,154,18,310,189,121,8,8,126,43,83
"2021","Welwyn Hatfield 005","E02004984",2893,1066,397,669,1732,215,906,323,403,180,338,218,108,12,260,148,112,13,13,95,39,56
"2021","Welwyn Hatfield 006","E02004985",3099,1091,634,457,1897,362,1067,319,562,186,245,146,82,17,212,117,95,11,11,111,30,81
"2021","Welwyn Hatfield 007","E02004986",3733,1224,313,911,2269,100,985,313,524,148,553,308,209,36,605,411,194,26,26,240,118,122
"2021","Welwyn Hatfield 008","E02004987",3042,757,287,470,2117,188,1107,304,642,161,408,193,187,28,403,268,135,11,11,168,85,83
"2021","Welwyn Hatfield 009","E02004988",3113,842,332,510,2094,177,1046,265,611,170,417,205,184,28,433,275,158,21,21,177,75,102
"2021","Welwyn Hatfield 010","E02004989",3987,955,306,649,2310,213,1102,292,623,187,418,226,163,29,492,326,166,85,85,722,166,556
"2021","Welwyn Hatfield 011","E02004990",2913,845,367,478,1766,217,911,295,456,160,299,175,98,26,299,183,116,40,40,302,81,221
"2021","Welwyn Hatfield 012","E02004991",3093,888,274,614,1723,114,777,193,451,133,363,173,163,27,406,270,136,63,63,482,143,339
"2021","Welwyn Hatfield 013","E02004992",2837,711,275,436,1567,106,759,186,423,150,270,112,132,26,374,233,141,58,58,559,141,418
"2021","Welwyn Hatfield 015","E02004994",2336,503,301,202,1697,341,1000,270,505,225,171,93,66,12,171,84,87,14,14,136,45,91
"2021","Welwyn Hatfield 016","E02004995",2200,509,320,189,1531,359,875,254,388,233,145,58,71,16,142,75,67,10,10,160,81,79
"2021","Welwyn Hatfield 017","E02007092",2300,776,386,390,1358,193,676,210,298,168,223,118,91,14,249,139,110,17,17,166,51,115
"2021","East Hertfordshire 001","E02004878",3696,851,473,378,2703,442,1432,451,724,257,487,239,217,31,331,214,117,11,11,142,57,85
"2021","East Hertfordshire 003","E02004880",4197,906,386,520,3114,409,1889,539,1013,337,458,260,169,29,334,221,113,24,24,177,72,105
"2021","East Hertfordshire 004","E02004881",2990,958,444,514,1851,270,984,265,579,140,355,246,101,8,207,147,60,35,35,181,45,136
"2021","East Hertfordshire 005","E02004882",3200,742,331,411,2189,286,1195,310,663,222,365,205,138,22,318,193,125,25,25,269,69,200
"2021","East Hertfordshire 006","E02004883",2524,624,338,286,1804,292,994,324,485,185,285,133,133,19,222,141,81,11,11,96,38,58
"2021","East Hertfordshire 007","E02004884",4534,1401,589,812,2831,255,1425,449,736,240,645,421,191,33,461,279,182,45,45,302,91,211
"2021","East Hertfordshire 008","E02004885",3244,686,339,347,2395,283,1528,396,838,294,309,166,120,23,263,154,109,12,12,163,73,90
"2021","East Hertfordshire 009","E02004886",2571,580,307,273,1856,305,1027,329,494,204,312,177,124,11,207,116,91,5,5,135,47,88
"2021","East Hertfordshire 010","E02004887",3086,727,368,359,2229,434,1219,399,578,242,311,172,115,24,254,155,99,11,11,130,52,78
"2021","East Hertfordshire 011","E02004888",3656,1018,522,496,2497,492,1323,397,672,254,365,176,153,36,306,187,119,11,11,141,60,81
"2021","East Hertfordshire 012","E02004889",4721,1476,628,848,3075,378,1529,445,812,272,631,358,234,39,515,323,192,22,22,170,50,120
"2021","East Hertfordshire 013","E02004890",3802,1215,457,758,2444,344,1183,420,556,207,578,369,190,19,321,191,130,18,18,143,45,98
"2021","East Hertfordshire 014","E02004891",3386,994,455,539,2281,382,1179,348,652,179,426,257,158,11,288,164,124,6,6,111,43,68
"2021","East Hertfordshire 015","E02004892",2532,765,268,497,1668,181,770,230,399,141,349,176,151,22,355,245,110,13,13,99,44,55
"2021","East Hertfordshire 016","E02004893",2372,603,182,421,1682,120,942,217,540,185,356,189,139,28,251,177,74,13,13,87,41,46
"2021","East Hertfordshire 017","E02004894",4530,1632,613,1019,2693,331,1223,399,655,169,703,502,186,15,401,259,142,35,35,205,40,165
"2021","East Hertfordshire 018","E02004895",3687,1054,474,580,2481,422,1327,423,643,261,373,213,136,24,346,205,141,13,13,152,64,88
"2021","East Hertfordshire 019","E02007093",3293,723,370,353,2414,489,1296,441,583,272,350,182,143,25,272,160,112,7,7,156,54,102
"2021","Stevenage 001","E02004944",3096,828,229,599,2022,166,974,246,551,177,428,205,189,34,432,302,130,22,22,246,121,125
"2021","Stevenage 002","E02004945",4852,1205,498,707,3309,404,1705,528,844,333,626,326,260,40,547,335,212,27,27,338,95,243
"2021","Stevenage 003","E02004946",2629,856,271,585,1602,182,757,239,362,156,313,150,144,19,338,187,151,12,12,171,69,102
"2021","Stevenage 005","E02004948",2673,873,402,471,1678,209,790,273,359,158,341,170,142,29,310,200,110,28,28,122,45,77
"2021","Stevenage 006","E02004949",3895,1428,600,828,2238,271,980,315,473,192,482,254,203,25,471,315,156,34,34,229,82,147
"2021","Stevenage 007","E02004950",2665,649,296,353,1818,187,889,255,474,160,335,133,171,31,393,227,166,14,14,198,90,108
"2021","Stevenage 008","E02004951",3420,1156,401,755,1997,156,914,264,480,170,408,219,169,20,471,299,172,48,48,267,106,161
"2021","Stevenage 009","E02004952",2766,763,331,432,1861,183,981,318,447,216,349,165,154,30,336,202,134,12,12,142,63,79
"2021","Stevenage 010","E02004953",2496,610,266,344,1702,158,844,248,444,152,305,126,141,38,379,214,165,16,16,184,90,94
"2021","Stevenage 011","E02004954",2913,878,340,538,1859,190,922,270,460,192,370,173,169,28,353,216,137,24,24,176,77,99
"2021","Stevenage 012","E02004955",2414,634,290,344,1621,207,858,291,390,177,279,132,129,18,264,152,112,13,13,159,74,85
"2021","Stevenage 013","E02007091",2689,689,285,404,1884,250,1061,364,491,206,367,222,127,18,197,100,97,9,9,116,50,66
"2021","East Suffolk 016","E02006287",2903,856,535,321,1930,563,902,493,253,156,293,175,99,19,163,80,83,9,9,117,48,69
"2021","East Suffolk 017","E02006288",4303,1216,691,525,2934,666,1450,624,562,264,450,227,191,32,352,238,114,16,16,153,57,96
"2021","East Suffolk 018","E02006289",4451,1435,767,668,2848,708,1259,586,472,201,485,248,207,30,380,230,150,16,16,168,64,104
"2021","East Suffolk 019","E02006290",3942,1527,849,678,2264,578,942,475,306,161,456,246,189,21,273,169,104,15,15,151,49,102
"2021","East Suffolk 020","E02006291",3595,1155,656,499,2357,578,1063,453,409,201,404,223,161,20,300,189,111,12,12,83,31,52
"2021","East Suffolk 021","E02006292",2834,666,403,263,2037,475,1110,457,456,197,272,151,103,18,175,97,78,5,5,131,53,78
"2021","East Suffolk 023","E02006293",4332,1118,554,564,3052,626,1645,682,705,258,454,246,180,28,320,206,114,7,7,162,62,100
"2021","East Suffolk 022","E02006294",3827,1483,947,536,2252,602,942,370,397,175,351,201,130,20,350,207,143,7,7,92,41,51
"2021","East Suffolk 024","E02006295",3990,1126,653,473,2695,627,1353,440,647,266,361,175,160,26,346,213,133,8,8,169,74,95
"2021","East Suffolk 025","E02006296",5472,1443,697,746,3830,744,2099,703,1041,355,521,257,226,38,444,299,145,22,22,199,94,105
"2021","East Suffolk 026","E02006297",3351,807,460,347,2392,577,1371,505,562,304,286,158,101,27,155,85,70,3,3,152,53,99
"2021","East Suffolk 027","E02006298",4043,1135,525,610,2770,529,1407,604,541,262,507,289,183,35,314,191,123,13,13,138,49,89
"2021","East Suffolk 028","E02006299",3883,1176,799,377,2592,942,1166,567,365,234,264,144,100,20,213,117,96,7,7,115,40,75
"2021","East Suffolk 029","E02006300",3783,1481,638,843,2164,294,898,373,369,156,452,230,196,26,499,315,184,21,21,138,50,88
"2021","East Suffolk 030","E02006301",3014,1255,605,650,1584,334,645,296,225,124,302,182,98,22,283,185,98,20,20,175,66,109
"2021","East Suffolk 001","E02006302",3002,845,489,356,2040,589,984,466,328,190,305,167,114,24,157,62,95,5,5,117,45,72
"2021","East Suffolk 002","E02006303",3323,1095,523,572,2050,279,832,287,385,160,464,159,266,39,449,295,154,26,26,178,85,93
"2021","East Suffolk 003","E02006304",3675,1058,678,380,2500,675,1061,459,386,216,471,239,211,21,285,156,129,8,8,117,49,68
"2021","East Suffolk 004","E02006305",4370,1660,491,1169,2479,196,825,325,359,141,689,294,359,36,742,507,235,27,27,231,83,148
"2021","East Suffolk 005","E02006306",3326,1155,588,567,2025,430,845,332,332,181,434,203,191,40,302,185,117,14,14,146,56,90
"2021","East Suffolk 007","E02006307",3236,871,544,327,2241,687,1025,421,371,233,329,161,134,34,196,96,100,4,4,124,40,84
"2021","East Suffolk 006","E02006308",3846,1917,664,1253,1752,209,629,263,256,110,425,220,182,23,467,320,147,22,22,177,68,109
"2021","East Suffolk 009","E02006309",3019,1088,649,439,1782,400,749,305,265,179,313,143,142,28,312,206,106,8,8,149,71,78
"2021","East Suffolk 008","E02006310",3444,942,464,478,2374,387,1125,410,494,221,484,231,230,23,366,249,117,12,12,128,48,80
"2021","East Suffolk 010","E02006311",3907,1466,747,719,2329,574,953,391,370,192,393,202,169,22,394,239,155,15,15,112,49,63
"2021","East Suffolk 011","E02006312",3744,1004,570,434,2604,617,1296,559,476,261,402,203,170,29,282,154,128,7,7,136,52,84
"2021","East Suffolk 012","E02006313",4625,1490,885,605,2960,730,1295,589,468,238,488,251,196,41,434,246,188,13,13,175,74,101
"2021","East Suffolk 013","E02006314",3327,1134,615,519,2042,496,939,426,333,180,344,166,157,21,246,159,87,17,17,151,56,95
"2021","East Suffolk 014","E02006315",2808,974,617,357,1744,519,741,391,207,143,268,141,106,21,203,120,83,13,13,90,35,55
"2021","East Suffolk 015","E02006316",3400,1242,752,490,2055,551,864,415,298,151,370,194,152,24,264,154,110,6,6,103,36,67
"2021","West Suffolk 002","E02006238",4501,1580,715,865,2714,527,1256,577,465,214,518,274,204,40,395,255,140,18,18,207,85,122
"2021","West Suffolk 001","E02006239",3328,1006,295,711,2214,289,1353,448,780,125,317,176,126,15,242,146,96,13,13,108,42,66
"2021","West Suffolk 003","E02006240",4228,1241,361,880,2771,321,1585,647,745,193,537,306,199,32,318,224,94,10,10,216,110,106
"2021","West Suffolk 004","E02006241",4048,1495,569,926,2390,385,1194,485,529,180,421,218,160,43,366,240,126,24,24,163,67,96
"2021","West Suffolk 007","E02006242",4543,1246,349,897,3147,343,1709,682,860,167,707,426,261,20,373,275,98,15,15,150,54,96
"2021","West Suffolk 008","E02006243",4422,1684,546,1138,2478,320,1131,438,535,158,585,364,206,15,409,265,144,33,33,260,82,178
"2021","West Suffolk 005","E02006273",3054,893,536,357,2051,508,1003,439,371,193,317,154,136,27,221,134,87,2,2,110,48,62
"2021","West Suffolk 006","E02006274",2651,788,407,381,1769,334,933,378,401,154,289,158,114,17,205,133,72,8,8,94,41,53
"2021","West Suffolk 009","E02006275",2926,859,413,446,1899,229,810,278,362,170,396,164,189,43,439,280,159,25,25,168,60,108
"2021","West Suffolk 016","E02006276",3522,939,426,513,2467,583,1184,442,536,206,400,230,143,27,285,181,104,15,15,116,38,78
"2021","West Suffolk 012","E02006277",3274,952,338,614,2184,239,1266,423,657,186,386,233,141,12,278,207,71,15,15,138,51,87
"2021","West Suffolk 011","E02006278",4523,2168,664,1504,2158,364,921,441,367,113,477,355,107,15,362,235,127,34,34,197,40,157
"2021","West Suffolk 014","E02006279",4068,1409,689,720,2494,574,1173,482,492,199,393,206,159,28,337,177,160,17,17,165,48,117
"2021","West Suffolk 010","E02006280",4030,997,596,401,2856,683,1499,559,656,284,375,189,157,29,292,154,138,7,7,177,73,104
"2021","West Suffolk 013","E02006281",4040,1557,809,748,2306,623,1016,425,433,158,342,206,115,21,305,169,136,20,20,177,33,144
"2021","West Suffolk 017","E02006282",3003,953,515,438,1931,538,953,441,341,171,244,135,97,12,189,121,68,7,7,119,36,83
"2021","West Suffolk 018","E02006283",2911,659,356,303,2110,430,1115,471,461,183,352,202,136,14,202,122,80,11,11,142,54,88
"2021","West Suffolk 019","E02006284",3282,965,453,512,2155,313,1031,364,466,201,457,223,200,34,337,231,106,17,17,162,67,95
"2021","West Suffolk 021","E02006285",3024,781,291,490,2082,226,1079,329,555,195,441,215,203,23,318,208,110,18,18,161,72,89
"2021","West Suffolk 020","E02006286",4571,1310,547,763,2945,408,1346,430,659,257,630,292,292,46,532,340,192,29,29,316,124,192
"2021","West Suffolk 015","E02006826",4804,2011,610,1401,2475,353,1104,426,533,145,571,389,159,23,407,259,148,40,40,318,81,237
"2021","City of London 001","E02000001",4916,2506,494,2012,1983,201,846,523,253,70,665,598,57,10,175,90,85,96,96,427,31,396
"2021","Barking and Dagenham 001","E02000002",2871,725,333,392,1833,136,820,123,563,134,225,52,143,30,623,436,187,29,29,313,208,105
"2021","Barking and Dagenham 002","E02000003",3931,974,443,531,2350,150,1269,272,733,264,237,98,116,23,624,413,211,70,70,607,398,209
"2021","Barking and Dagenham 003","E02000004",2309,540,284,256,1490,151,798,189,398,211,194,64,98,32,324,178,146,23,23,279,161,118
"2021","Barking and Dagenham 004","E02000005",3627,706,269,437,2453,111,1286,208,862,216,295,94,167,34,709,451,258,52,52,468,324,144
"2021","Barking and Dagenham 006","E02000007",3674,1071,341,730,2208,118,942,199,552,191,288,88,177,23,814,572,242,46,46,395,249,146
"2021","Barking and Dagenham 007","E02000008",4622,1078,418,660,2987,139,1357,272,829,256,455,160,245,50,979,582,397,57,57,557,354,203
"2021","Barking and Dagenham 008","E02000009",4257,1013,316,697,2663,103,1298,206,865,227,367,121,208,38,830,535,295,65,65,581,386,195
"2021","Barking and Dagenham 009","E02000010",3327,783,264,519,2108,93,969,195,565,209,282,77,170,35,716,463,253,48,48,436,270,166
"2021","Barking and Dagenham 010","E02000011",2354,530,221,309,1522,137,773,155,443,175,191,49,112,30,385,255,130,36,36,302,181,121
"2021","Barking and Dagenham 011","E02000012",3290,694,335,359,1936,143,1209,173,737,299,149,51,78,20,390,254,136,45,45,660,459,201
"2021","Barking and Dagenham 012","E02000013",3261,790,328,462,2054,112,939,191,567,181,284,69,184,31,680,404,276,39,39,417,262,155
"2021","Barking and Dagenham 013","E02000014",3387,758,316,442,2152,130,944,185,552,207,306,83,186,37,709,440,269,63,63,477,283,194
"2021","Barking and Dagenham 014","E02000015",3034,938,276,662,1740,93,714,134,463,117,269,80,163,26,617,431,186,47,47,356,236,120
"2021","Barking and Dagenham 015","E02000016",3811,1042,97,945,2328,22,1268,287,869,112,334,167,158,9,609,461,148,95,95,441,260,181
"2021","Barking and Dagenham 016","E02000017",2767,621,156,465,1495,73,863,136,526,201,152,57,82,13,318,182,136,89,89,651,409,242
"2021","Barking and Dagenham 017","E02000018",3234,718,276,442,2060,97,938,159,600,179,273,75,166,32,709,482,227,43,43,456,273,183
"2021","Barking and Dagenham 018","E02000019",3205,588,215,373,2211,107,1035,189,612,234,293,83,173,37,730,502,228,46,46,406,265,141
"2021","Barking and Dagenham 019","E02000020",4675,1048,311,737,2958,106,1573,290,1085,198,385,152,203,30,796,563,233,98,98,669,407,262
"2021","Barking and Dagenham 020","E02000021",2930,663,248,415,1889,99,873,161,526,186,239,73,150,16,625,414,211,53,53,378,259,119
"2021","Barking and Dagenham 021","E02000022",2796,756,105,651,1798,13,809,168,566,75,264,130,124,10,641,497,144,71,71,242,144,98
"2021","Barking and Dagenham 022","E02000023",2663,625,112,513,1720,38,785,113,575,97,232,85,134,13,622,476,146,43,43,318,204,114
"2021","Barking and Dagenham 023","E02006799",3889,847,330,517,2521,96,1406,218,929,259,304,95,163,46,669,436,233,46,46,521,338,183
"2021","Barnet 001","E02000024",4478,1300,613,687,2868,396,1566,435,822,309,440,245,172,23,423,227,196,43,43,310,89,221
"2021","Barnet 002","E02000025",3748,1314,499,815,2151,204,1108,303,583,222,374,243,113,18,417,255,162,48,48,283,134,149
"2021","Barnet 003","E02000026",2512,652,302,350,1672,249,951,204,521,226,185,105,70,10,272,149,123,15,15,188,87,101
"2021","Barnet 004","E02000027",3687,1002,481,521,2395,251,1234,249,689,296,288,132,113,43,588,339,249,34,34,290,153,137
"2021","Barnet 005","E02000028",2688,769,314,455,1727,208,943,252,499,192,232,146,72,14,306,200,106,38,38,192,81,111
"2021","Barnet 006","E02000029",3706,991,367,624,2444,185,1294,315,757,222,360,153,184,23,567,388,179,38,38,271,137,134
"2021","Barnet 007","E02000030",3518,765,461,304,2445,407,1453,359,758,336,175,85,75,15,385,154,231,25,25,308,130,178
"2021","Barnet 008","E02000031",3325,933,393,540,2139,292,1257,326,681,250,251,173,66,12,306,161,145,33,33,253,100,153
"2021","Barnet 009","E02000032",2742,489,289,200,1950,273,1261,229,670,362,130,48,71,11,277,125,152,9,9,303,137,166
"2021","Barnet 010","E02000033",3494,977,359,618,2204,213,1146,293,598,255,292,126,139,27,514,274,240,39,39,313,149,164
"2021","Barnet 011","E02000034",3590,975,403,572,2278,249,1249,287,699,263,275,163,94,18,456,276,180,49,49,337,136,201
"2021","Barnet 012","E02000035",3532,1113,415,698,2095,237,1139,315,613,211,309,237,58,14,361,179,182,49,49,324,122,202
"2021","Barnet 013","E02000036",3947,932,405,527,2591,291,1519,305,874,340,174,71,87,16,557,312,245,50,50,424,229,195
"2021","Barnet 014","E02000037",3721,778,393,385,2629,396,1632,342,945,345,146,82,53,11,421,231,190,34,34,314,169,145
"2021","Barnet 015","E02000038",4006,1018,320,698,2564,244,1386,320,759,307,338,177,140,21,555,347,208,41,41,424,186,238
"2021","Barnet 016","E02000039",2674,671,273,398,1758,263,1071,207,647,217,159,104,47,8,234,125,109,31,31,245,106,139
"2021","Barnet 017","E02000040",3513,996,402,594,2215,251,1249,323,751,175,273,180,77,16,398,230,168,44,44,302,136,166
"2021","Barnet 018","E02000041",3329,782,347,435,2063,219,1194,279,641,274,151,85,55,11,443,263,180,56,56,484,240,244
"2021","Barnet 019","E02000042",4716,1544,491,1053,2668,228,1445,344,833,268,419,287,115,17,481,271,210,95,95,504,200,304
"2021","Barnet 020","E02000043",2664,516,228,288,1875,240,1223,223,779,221,170,100,60,10,224,105,119,18,18,273,110,163
"2021","Barnet 021","E02000044",3069,681,214,467,1972,126,1028,218,574,236,190,92,72,26,581,317,264,47,47,416,221,195
"2021","Barnet 022","E02000045",4203,1289,373,916,2531,155,1221,254,745,222,385,180,167,38,710,435,275,60,60,383,154,229
"2021","Barnet 023","E02000046",2879,820,256,564,1683,142,907,249,507,151,328,216,106,6,242,147,95,64,64,376,113,263
"2021","Barnet 024","E02000047",4211,961,365,596,2565,134,1258,214,745,299,225,97,100,28,874,554,320,74,74,685,363,322
"2021","Barnet 025","E02000048",3951,1044,475,569,2505,347,1486,321,880,285,231,147,79,5,407,242,165,34,34,402,163,239
"2021","Barnet 026","E02000049",3802,1024,224,800,2330,60,1111,230,666,215,277,133,125,19,815,520,295,67,67,448,232,216
"2021","Barnet 027","E02000050",4036,1147,415,732,2472,206,1323,271,750,302,329,204,106,19,569,314,255,45,45,417,168,249
"2021","Barnet 028","E02000051",3793,1197,518,679,2226,373,1207,281,705,221,262,199,55,8,335,204,131,49,49,370,119,251
"2021","Barnet 029","E02000052",4193,1321,539,782,2450,193,1287,330,805,152,475,343,116,16,439,253,186,56,56,422,102,320
"2021","Barnet 031","E02000054",2971,926,261,665,1571,133,863,218,480,165,211,142,59,10,300,157,143,64,64,474,182,292
"2021","Barnet 032","E02000055",4504,1335,411,924,2433,224,1320,324,761,235,266,200,56,10,493,293,200,130,130,736,199,537
"2021","Barnet 033","E02000056",3441,844,483,361,2249,390,1388,310,862,216,181,122,49,10,259,142,117,31,31,348,134,214
"2021","Barnet 034","E02000057",2704,686,223,463,1644,153,1030,189,675,166,124,77,42,5,288,154,134,49,49,374,124,250
"2021","Barnet 035","E02000058",4097,1331,634,697,2380,325,1442,381,870,191,228,160,56,12,336,191,145,49,49,386,115,271
"2021","Barnet 036","E02000059",4438,1334,338,996,2410,151,1357,407,642,308,347,230,98,19,473,249,224,82,82,694,301,393
"2021","Barnet 037","E02000060",3694,1106,462,644,2173,225,1495,285,1006,204,118,79,34,5,278,146,132,57,57,415,135,280
"2021","Barnet 038","E02000061",3572,1303,319,984,1859,235,1041,291,587,163,274,216,51,7,256,132,124,53,53,410,117,293
"2021","Barnet 039","E02000062",2612,814,201,613,1436,55,708,145,417,146,166,92,60,14,461,258,203,46,46,362,142,220
"2021","Barnet 040","E02000063",2831,855,210,645,1606,103,857,179,488,190,186,113,61,12,397,243,154,63,63,370,145,225
"2021","Barnet 041","E02000064",2762,833,255,578,1594,115,719,181,428,110,204,147,46,11,498,315,183,58,58,335,80,255
"2021","Barnet 042","E02006953",3855,1275,87,1188,2261,33,1160,434,638,88,476,389,78,9,477,329,148,115,115,319,99,220
"2021","Barnet 043","E02006954",3720,1015,191,824,2158,96,1199,310,683,206,297,197,86,14,436,277,159,130,130,547,229,318
"2021","Bexley 001","E02000065",2777,658,145,513,1777,56,808,201,446,161,237,73,143,21,616,464,152,60,60,342,203,139
"2021","Bexley 002","E02000066",3545,1129,356,773,2004,105,850,209,430,211,292,105,158,29,712,453,259,45,45,412,228,184
"2021","Bexley 003","E02000067",3984,1129,375,754,2402,132,1037,285,555,197,456,222,194,40,717,496,221,60,60,453,222,231
"2021","Bexley 004","E02000068",3197,960,314,646,1950,91,799,191,452,156,318,120,178,20,698,534,164,44,44,287,161,126
"2021","Bexley 005","E02000069",2815,781,350,431,1765,203,816,230,414,172,318,147,151,20,401,252,149,27,27,269,146,123
"2021","Bexley 006","E02000070",3141,790,440,350,2105,337,1123,292,541,290,277,121,122,34,350,189,161,18,18,246,138,108
"2021","Bexley 007","E02000071",2836,655,343,312,1956,211,967,239,465,263,302,98,167,37,460,275,185,16,16,225,120,105
"2021","Bexley 008","E02000072",4691,1149,361,788,3129,141,1390,308,825,257,524,196,273,55,995,699,296,79,79,413,247,166
"2021","Bexley 009","E02000073",3956,809,511,298,2853,483,1646,384,834,428,344,129,164,51,355,168,187,25,25,294,163,131
"2021","Bexley 010","E02000074",3504,1040,430,610,2178,189,921,261,434,226,382,152,193,37,655,428,227,31,31,286,175,111
"2021","Bexley 011","E02000075",3149,727,475,252,2210,446,1191,304,566,321,263,123,112,28,295,140,155,15,15,212,108,104
"2021","Bexley 013","E02000077",2940,622,327,295,2039,250,1126,248,587,291,279,116,134,29,359,193,166,25,25,279,150,129
"2021","Bexley 014","E02000078",3020,653,334,319,2140,328,1130,311,556,263,361,167,163,31,303,164,139,18,18,227,116,111
"2021","Bexley 015","E02000079",3587,1049,534,515,2279,300,1134,299,620,215,391,217,149,25,426,251,175,28,28,259,117,142
"2021","Bexley 016","E02000080",3818,933,511,422,2512,323,1359,330,696,333,341,139,163,39,454,254,200,35,35,373,181,192
"2021","Bexley 017","E02000081",3279,901,517,384,2165,308,1136,292,583,261,309,135,143,31,388,233,155,24,24,213,127,86
"2021","Bexley 018","E02000082",3448,726,405,321,2456,308,1425,343,713,369,364,140,181,43,345,185,160,14,14,266,152,114
"2021","Bexley 019","E02000083",4445,1196,476,720,2922,258,1384,350,778,256,611,330,246,35,631,389,242,38,38,327,167,160
"2021","Bexley 020","E02000084",4196,936,529,407,2962,443,1680,425,853,402,424,193,186,45,396,202,194,19,19,298,160,138
"2021","Bexley 021","E02000085",3070,745,420,325,2104,295,1087,269,569,249,363,152,176,35,354,190,164,5,5,221,114,107
"2021","Bexley 022","E02000086",2787,626,335,291,2000,323,1087,271,508,308,314,128,161,25,266,124,142,10,10,161,91,70
"2021","Bexley 023","E02000087",3322,872,507,365,2262,392,1215,317,661,237,370,190,155,25,270,135,135,15,15,188,74,114
"2021","Bexley 024","E02000088",2980,625,369,256,2180,336,1200,324,601,275,334,152,158,24,292,141,151,18,18,175,76,99
"2021","Bexley 025","E02000089",2906,582,361,221,2155,342,1266,290,682,294,268,110,137,21,275,137,138,4,4,169,69,100
"2021","Bexley 026","E02000090",4197,1485,655,830,2395,312,1059,302,539,218,544,353,167,24,437,258,179,43,43,317,78,239
"2021","Bexley 027","E02000091",4451,1538,900,638,2637,407,1347,375,664,308,429,228,174,27,427,250,177,27,27,276,106,170
"2021","Bexley 028","E02000092",2715,778,352,426,1738,194,756,207,373,176,265,119,122,24,496,316,180,27,27,199,93,106
"2021","Bexley 029","E02006785",2576,671,344,327,1650,223,873,261,425,187,223,98,97,28,308,148,160,23,23,255,145,110
"2021","Brent 001","E02000093",3738,690,295,395,2252,241,1306,259,612,435,173,103,56,14,438,204,234,94,94,796,445,351
"2021","Brent 002","E02000094",3467,732,230,502,2107,141,1218,256,634,328,223,137,74,12,471,279,192,54,54,628,310,318
"2021","Brent 003","E02000095",3184,574,290,284,1847,216,1130,185,568,377,104,51,35,18,355,142,213,42,42,763,410,353
"2021","Brent 004","E02000096",2496,467,289,178,1569,272,1022,209,494,319,55,32,19,4,186,78,108,34,34,460,243,217
"2021","Brent 005","E02000097",3037,636,302,334,1799,184,1080,209,543,328,127,64,49,14,363,158,205,45,45,602,324,278
"2021","Brent 006","E02000098",2872,619,315,304,1772,186,974,177,540,257,110,59,42,9,448,204,244,54,54,481,244,237
"2021","Brent 007","E02000099",2915,557,219,338,1760,137,1044,184,614,246,137,66,58,13,382,235,147,60,60,598,307,291
"2021","Brent 008","E02000100",2570,512,219,293,1485,231,906,165,414,327,80,43,26,11,241,83,158,27,27,573,270,303
"2021","Brent 009","E02000101",3388,870,314,556,2015,113,1093,220,605,268,165,92,57,16,587,348,239,57,57,503,245,258
"2021","Brent 010","E02000102",2684,692,223,469,1577,93,832,147,473,212,177,60,96,21,432,259,173,43,43,415,232,183
"2021","Brent 011","E02000103",3462,884,287,597,2111,133,1067,221,573,273,225,122,74,29,627,388,239,59,59,467,189,278
"2021","Brent 012","E02000104",2417,615,227,388,1314,116,745,138,365,242,102,48,42,12,308,132,176,43,43,488,225,263
"2021","Brent 013","E02000105",3110,685,263,422,1753,115,1048,213,606,229,132,67,54,11,400,219,181,58,58,672,388,284
"2021","Brent 014","E02000106",3584,1019,304,715,1924,134,905,196,478,231,215,115,82,18,592,380,212,78,78,641,299,342
"2021","Brent 015","E02000107",4362,1498,321,1177,2110,115,995,287,555,153,372,269,90,13,540,317,223,88,88,754,228,526
"2021","Brent 016","E02000108",2270,436,185,251,1384,106,829,158,479,192,99,51,35,13,293,148,145,57,57,450,241,209
"2021","Brent 018","E02000110",3096,928,326,602,1645,120,851,209,462,180,281,179,88,14,340,167,173,53,53,523,162,361
"2021","Brent 019","E02000111",3189,592,200,392,1756,109,1104,202,636,266,98,38,55,5,381,187,194,64,64,841,485,356
"2021","Brent 020","E02000112",3496,649,219,430,1928,130,1078,250,545,283,206,152,46,8,418,222,196,96,96,919,496,423
"2021","Brent 021","E02000113",3289,838,273,565,2047,65,812,105,499,208,131,47,55,29,947,502,445,92,92,404,228,176
"2021","Brent 022","E02000114",3707,1245,279,966,1877,74,817,289,403,125,380,292,77,11,505,287,218,101,101,585,148,437
"2021","Brent 023","E02000115",3874,1488,428,1060,1893,105,818,263,478,77,462,359,92,11,431,205,226,77,77,493,85,408
"2021","Brent 024","E02000116",3235,948,257,691,1856,43,819,191,487,141,228,135,80,13,700,472,228,66,66,431,167,264
"2021","Brent 025","E02000117",4757,1611,392,1219,2647,92,1058,176,667,215,247,104,115,28,1153,674,479,97,97,499,261,238
"2021","Brent 026","E02000118",3156,605,209,396,1642,108,990,184,484,322,110,51,42,17,386,165,221,48,48,909,529,380
"2021","Brent 027","E02000119",3954,1255,263,992,2285,44,919,188,578,153,272,174,82,16,965,606,359,85,85,414,214,200
"2021","Brent 028","E02000120",4244,1699,378,1321,1994,82,817,309,427,81,550,440,96,14,430,255,175,115,115,551,120,431
"2021","Brent 029","E02000121",3626,735,200,535,2049,103,1182,257,618,307,212,125,78,9,482,258,224,70,70,842,495,347
"2021","Brent 030","E02000122",3159,947,342,605,1710,133,876,183,524,169,262,158,87,17,394,210,184,45,45,502,172,330
"2021","Brent 031","E02000123",5537,1874,440,1434,2964,99,1081,239,652,190,398,216,149,33,1242,777,465,144,144,699,259,440
"2021","Brent 032","E02000124",4163,1287,324,963,2284,165,1039,275,639,125,501,343,141,17,506,309,197,73,73,592,170,422
"2021","Brent 033","E02000125",3939,1182,355,827,2149,122,1044,211,643,190,394,252,127,15,507,275,232,82,82,608,180,428
"2021","Brent 034","E02000126",3402,1269,254,1015,1758,40,704,152,433,119,289,208,71,10,641,335,306,84,84,375,129,246
"2021","Brent 035","E02006955",2709,826,69,757,1584,20,857,367,418,72,366,331,31,4,268,195,73,73,73,299,112,187
"2021","Brent 036","E02006956",2504,515,218,297,1445,112,806,195,389,222,169,110,47,12,313,148,165,45,45,544,284,260
"2021","Bromley 001","E02000127",3787,1152,420,732,2318,169,990,271,521,198,410,182,194,34,713,475,238,36,36,317,167,150
"2021","Bromley 002","E02000128",3063,776,365,411,2131,279,1125,291,608,226,360,187,146,27,356,218,138,11,11,156,75,81
"2021","Bromley 004","E02000130",3666,1148,400,748,2267,192,1118,377,583,158,469,301,149,19,445,268,177,43,43,251,79,172
"2021","Bromley 005","E02000131",5069,1876,297,1579,2852,74,1012,430,483,99,990,772,209,9,702,527,175,74,74,341,81,260
"2021","Bromley 006","E02000132",4939,2039,675,1364,2630,210,1186,482,592,112,691,528,154,9,487,334,153,56,56,270,75,195
"2021","Bromley 007","E02000133",4329,1083,581,502,3039,492,1808,531,988,289,409,260,138,11,308,183,125,22,22,207,87,120
"2021","Bromley 008","E02000134",5298,1840,593,1247,3104,222,1499,489,825,185,716,483,215,18,623,439,184,44,44,354,118,236
"2021","Bromley 009","E02000135",4447,1680,370,1310,2437,70,832,295,392,145,518,322,157,39,950,622,328,67,67,330,128,202
"2021","Bromley 010","E02000136",2296,665,379,286,1494,257,755,214,372,169,192,78,92,22,278,161,117,12,12,137,66,71
"2021","Bromley 011","E02000137",3672,1218,513,705,2287,332,1169,330,667,172,461,306,138,17,299,185,114,26,26,167,72,95
"2021","Bromley 012","E02000138",4139,1599,778,821,2338,406,1152,423,577,152,476,343,119,14,271,149,122,33,33,202,77,125
"2021","Bromley 013","E02000139",3305,1040,317,723,2082,157,1102,336,635,131,459,286,150,23,334,193,141,30,30,183,70,113
"2021","Bromley 014","E02000140",3335,989,348,641,2101,153,925,205,505,215,348,115,191,42,658,451,207,17,17,245,132,113
"2021","Bromley 015","E02000141",3090,962,302,660,1894,126,874,255,474,145,443,235,171,37,420,256,164,31,31,234,98,136
"2021","Bromley 016","E02000142",3451,898,409,489,2349,280,1327,299,774,254,385,205,152,28,333,199,134,24,24,204,88,116
"2021","Bromley 018","E02000144",4314,1298,443,855,2696,250,1478,419,845,214,542,369,157,16,374,227,147,52,52,320,115,205
"2021","Bromley 019","E02000145",3515,1041,393,648,2228,180,903,233,489,181,384,165,184,35,724,482,242,37,37,246,142,104
"2021","Bromley 020","E02000146",4040,1243,507,736,2569,185,1401,343,870,188,522,307,179,36,426,236,190,35,35,228,83,145
"2021","Bromley 021","E02000147",3166,781,468,313,2226,395,1388,330,762,296,219,100,100,19,215,119,96,9,9,159,87,72
"2021","Bromley 022","E02000148",2695,670,408,262,1891,337,1091,280,606,205,212,113,83,16,235,134,101,16,16,134,59,75
"2021","Bromley 023","E02000149",3284,895,385,510,2161,231,1056,288,545,223,396,193,171,32,460,257,203,18,18,228,114,114
"2021","Bromley 024","E02000150",3115,654,395,259,2253,287,1337,289,716,332,257,83,140,34,358,193,165,14,14,208,101,107
"2021","Bromley 025","E02000151",2968,646,406,240,2198,442,1339,325,773,241,233,119,98,16,176,90,86,8,8,124,54,70
"2021","Bromley 026","E02000152",3097,826,424,402,2060,158,1011,230,593,188,308,135,137,36,556,346,210,27,27,211,123,88
"2021","Bromley 027","E02000153",2896,517,352,165,2203,373,1376,239,825,312,214,64,119,31,229,108,121,11,11,176,83,93
"2021","Bromley 028","E02000154",3570,997,470,527,2355,347,1307,373,682,252,351,218,118,15,326,187,139,24,24,218,80,138
"2021","Bromley 029","E02000155",3044,901,519,382,1958,362,981,307,450,224,284,147,108,29,313,141,172,18,18,185,88,97
"2021","Bromley 030","E02000156",4864,1195,802,393,3397,630,1978,512,1008,458,336,154,149,33,430,217,213,23,23,272,115,157
"2021","Bromley 031","E02000157",3276,732,495,237,2409,485,1412,330,773,309,230,109,106,15,276,141,135,6,6,135,54,81
"2021","Bromley 032","E02000158",3034,715,409,306,2153,380,1106,300,604,202,241,104,111,26,409,243,166,17,17,166,90,76
"2021","Bromley 033","E02000159",2822,661,427,234,1992,409,1056,283,519,254,248,109,114,25,265,137,128,14,14,169,67,102
"2021","Bromley 034","E02000160",3042,657,412,245,2216,379,1291,299,681,311,269,100,145,24,262,145,117,15,15,169,73,96
"2021","Bromley 035","E02000161",3340,737,447,290,2448,402,1487,325,890,272,265,146,99,20,284,140,144,10,10,155,75,80
"2021","Bromley 036","E02000162",2964,932,586,346,1882,337,970,232,533,205,226,96,103,27,330,192,138,19,19,150,69,81
"2021","Bromley 037","E02000163",3068,734,449,285,2139,398,1245,360,656,229,230,114,92,24,257,135,122,9,9,195,89,106
"2021","Bromley 039","E02000165",2741,565,290,275,1988,296,1034,315,497,222,341,133,181,27,305,156,149,12,12,188,83,105
"2021","Bromley 040","E02006782",3192,826,372,454,2117,290,1069,286,557,226,261,114,116,31,470,257,213,27,27,249,108,141
"2021","Bromley 041","E02006787",3088,777,360,417,2123,231,1233,280,754,199,310,152,138,20,321,190,131,28,28,188,86,102
"2021","Bromley 042","E02006789",2786,698,469,229,1907,473,897,298,363,236,262,135,110,17,268,164,104,7,7,181,92,89
"2021","Camden 001","E02000166",3395,1197,473,724,1861,229,810,251,416,143,329,212,101,16,465,254,211,28,28,337,97,240
"2021","Camden 002","E02000167",3372,1273,488,785,1878,257,1047,379,572,96,357,282,64,11,194,122,72,23,23,221,50,171
"2021","Camden 003","E02000168",3494,1256,341,915,1821,134,818,249,437,132,467,351,98,18,360,207,153,42,42,417,78,339
"2021","Camden 004","E02000169",3027,878,307,571,1923,247,1093,316,658,119,298,216,73,9,259,155,104,26,26,226,73,153
"2021","Camden 005","E02000170",3463,1159,308,851,1875,157,981,296,572,113,406,345,57,4,285,156,129,46,46,429,93,336
"2021","Camden 006","E02000171",3330,1209,405,804,1767,137,815,284,433,98,418,310,86,22,349,188,161,48,48,354,83,271
"2021","Camden 007","E02000172",4035,1452,399,1053,2089,83,832,192,510,130,412,278,112,22,708,410,298,54,54,494,135,359
"2021","Camden 008","E02000173",3500,1426,357,1069,1783,157,987,315,607,65,384,315,65,4,208,129,79,47,47,291,64,227
"2021","Camden 009","E02000174",3549,1273,329,944,1829,106,675,228,344,103,465,353,99,13,532,318,214,51,51,447,87,360
"2021","Camden 010","E02000175",4308,1708,351,1357,2069,91,932,356,482,94,592,508,79,5,379,215,164,75,75,531,67,464
"2021","Camden 011","E02000176",3000,1345,336,1009,1476,96,794,313,436,45,360,295,63,2,184,102,82,42,42,179,42,137
"2021","Camden 012","E02000177",3654,1328,419,909,1828,93,686,209,371,106,397,315,70,12,579,314,265,73,73,498,128,370
"2021","Camden 013","E02000178",4165,1611,370,1241,1988,69,780,279,403,98,572,486,74,12,483,296,187,84,84,566,100,466
"2021","Camden 014","E02000179",2547,972,353,619,1345,87,700,209,399,92,241,186,45,10,287,162,125,30,30,230,68,162
"2021","Camden 015","E02000180",3519,1288,309,979,1664,83,653,230,322,101,451,358,72,21,404,238,166,73,73,567,74,493
"2021","Camden 016","E02000181",3750,1295,331,964,2024,101,1010,364,571,75,556,471,74,11,283,154,129,74,74,431,51,380
"2021","Camden 017","E02000182",3088,1100,304,796,1653,123,891,234,563,94,250,188,54,8,336,207,129,53,53,335,66,269
"2021","Camden 018","E02000183",3618,1537,550,987,1765,142,856,298,435,123,377,309,61,7,355,184,171,35,35,316,79,237
"2021","Camden 019","E02000184",3634,1322,250,1072,1686,56,655,220,310,125,333,272,47,14,543,293,250,99,99,626,91,535
"2021","Camden 020","E02000185",4066,1749,571,1178,1886,95,766,224,443,99,335,236,78,21,611,379,232,79,79,431,114,317
"2021","Camden 021","E02000186",2934,1212,233,979,1274,69,523,223,221,79,313,270,39,4,289,156,133,80,80,448,68,380
"2021","Camden 022","E02000187",3814,1373,332,1041,1926,64,757,178,451,128,297,216,60,21,719,419,300,89,89,515,128,387
"2021","Camden 023","E02000188",2719,937,244,693,1323,40,544,100,333,111,211,142,55,14,470,248,222,58,58,459,130,329
"2021","Camden 026","E02000191",2105,1069,180,889,722,56,283,147,91,45,210,191,16,3,124,63,61,49,49,314,43,271
"2021","Camden 027","E02000192",3088,1305,316,989,1383,62,561,199,264,98,312,254,49,9,370,193,177,78,78,400,85,315
"2021","Camden 028","E02000193",3100,1630,330,1300,1101,72,408,223,134,51,280,247,21,12,259,117,142,82,82,369,47,322
"2021","Camden 029","E02007115",4468,2031,534,1497,1767,101,653,208,301,144,360,289,57,14,524,265,259,129,129,670,127,543
"2021","Croydon 001","E02000194",4203,1523,418,1105,2371,128,923,317,506,100,662,463,181,18,606,401,205,52,52,309,98,211
"2021","Croydon 002","E02000195",3491,827,320,507,2204,292,1099,248,585,266,296,141,129,26,473,257,216,44,44,460,226,234
"2021","Croydon 003","E02000196",2816,707,296,411,1637,157,731,173,346,212,214,103,88,23,474,276,198,61,61,472,234,238
"2021","Croydon 004","E02000197",3317,843,314,529,2029,157,927,199,469,259,278,142,111,25,589,325,264,78,78,445,222,223
"2021","Croydon 005","E02000198",3504,1100,269,831,2000,89,799,181,439,179,303,144,135,24,751,491,260,58,58,404,179,225
"2021","Croydon 006","E02000199",3205,830,242,588,1976,108,878,207,474,197,329,141,159,29,600,329,271,61,61,399,158,241
"2021","Croydon 007","E02000200",4001,1433,312,1121,2236,108,933,327,469,137,503,312,173,18,611,400,211,81,81,332,123,209
"2021","Croydon 008","E02000201",3823,1377,303,1074,2133,83,803,251,428,124,380,216,140,24,803,530,273,64,64,313,124,189
"2021","Croydon 009","E02000202",3037,724,279,445,1766,111,925,213,464,248,171,83,75,13,503,279,224,56,56,547,294,253
"2021","Croydon 010","E02000203",3121,1049,274,775,1671,91,735,183,391,161,229,121,92,16,563,360,203,53,53,401,187,214
"2021","Croydon 011","E02000204",3224,744,254,490,1872,131,917,173,471,273,154,50,74,30,579,314,265,91,91,608,313,295
"2021","Croydon 013","E02000206",4465,1496,319,1177,2510,86,887,226,478,183,485,236,224,25,964,665,299,88,88,459,215,244
"2021","Croydon 014","E02000207",3558,1089,278,811,2100,93,811,194,426,191,370,202,137,31,775,469,306,51,51,369,174,195
"2021","Croydon 015","E02000208",4097,1275,269,1006,2291,63,956,193,597,166,284,120,129,35,929,669,260,59,59,531,293,238
"2021","Croydon 016","E02000209",3062,639,189,450,1997,95,1053,189,586,278,164,57,92,15,611,364,247,74,74,426,231,195
"2021","Croydon 017","E02000210",3446,934,278,656,2176,113,1022,304,520,198,396,246,125,25,590,351,239,55,55,336,172,164
"2021","Croydon 018","E02000211",3299,861,505,356,2183,357,1118,288,541,289,302,138,128,36,386,190,196,20,20,255,126,129
"2021","Croydon 019","E02000212",3266,718,214,504,2073,65,968,187,570,211,250,98,128,24,726,439,287,64,64,475,267,208
"2021","Croydon 020","E02000213",5392,1886,337,1549,2934,77,1163,348,667,148,569,352,194,23,1003,681,322,122,122,572,229,343
"2021","Croydon 021","E02000214",2330,485,248,237,1621,241,896,235,421,240,199,97,83,19,264,122,142,21,21,224,117,107
"2021","Croydon 022","E02000215",5250,1920,532,1388,2794,147,1213,476,606,131,654,435,190,29,674,465,209,106,106,536,206,330
"2021","Croydon 023","E02000216",2943,941,470,471,1770,189,1020,256,633,131,266,179,76,11,253,135,118,42,42,232,104,128
"2021","Croydon 024","E02000217",5024,1650,378,1272,2842,79,1244,379,706,159,596,363,202,31,827,584,243,96,96,532,216,316
"2021","Croydon 025","E02000218",2352,457,228,229,1684,207,759,156,393,210,148,48,80,20,549,352,197,21,21,211,131,80
"2021","Croydon 026","E02000219",2980,714,472,242,2018,460,1074,318,444,312,201,83,92,26,262,117,145,21,21,248,131,117
"2021","Croydon 028","E02000221",3993,1099,348,751,2471,127,1162,250,665,247,323,143,139,41,817,528,289,42,42,423,251,172
"2021","Croydon 029","E02000222",3637,1176,295,881,2210,195,1012,305,551,156,546,365,165,16,425,295,130,32,32,251,102,149
"2021","Croydon 030","E02000223",2792,579,282,297,1954,78,695,115,409,171,233,53,143,37,924,645,279,24,24,259,156,103
"2021","Croydon 031","E02000224",3272,940,263,677,2054,137,1028,268,600,160,392,255,122,15,447,280,167,50,50,278,112,166
"2021","Croydon 032","E02000225",2663,581,307,274,1849,179,826,183,403,240,257,81,134,42,556,333,223,31,31,233,127,106
"2021","Croydon 033","E02000226",2779,560,353,207,1952,412,1146,300,545,301,150,61,71,18,229,109,120,15,15,267,142,125
"2021","Croydon 034","E02000227",4838,1475,674,801,3044,385,1401,398,684,319,490,239,204,47,730,407,323,38,38,319,181,138
"2021","Croydon 035","E02000228",3007,627,415,212,2168,458,1318,329,703,286,175,82,77,16,207,97,110,10,10,212,96,116
"2021","Croydon 036","E02000229",2237,561,266,295,1473,95,610,143,307,160,190,49,109,32,551,357,194,27,27,203,122,81
"2021","Croydon 037","E02000230",4233,1217,495,722,2668,328,1465,422,748,295,375,244,115,16,467,287,180,33,33,348,136,212
"2021","Croydon 038","E02000231",2747,496,230,266,1963,329,1214,304,604,306,174,90,67,17,222,113,109,24,24,288,137,151
"2021","Croydon 039","E02000232",2370,524,353,171,1653,341,864,208,440,216,181,57,96,28,254,119,135,13,13,193,99,94
"2021","Croydon 040","E02000233",2398,527,209,318,1690,195,855,219,498,138,295,163,115,17,329,191,138,16,16,181,92,89
"2021","Croydon 041","E02000234",3720,967,428,539,2499,273,1312,376,702,234,378,212,144,22,523,332,191,13,13,254,135,119
"2021","Croydon 042","E02000235",2658,544,231,313,1938,309,1060,319,515,226,265,124,108,33,293,163,130,11,11,176,79,97
"2021","Croydon 043","E02000236",3307,562,302,260,2521,300,1493,387,851,255,364,171,162,31,347,185,162,17,17,224,124,100
"2021","Croydon 044","E02000237",3033,757,506,251,2121,401,1135,313,580,242,274,110,137,27,299,149,150,12,12,155,72,83
"2021","Croydon 045","E02006788",2893,694,234,460,1900,92,762,173,418,171,291,138,121,32,721,409,312,34,34,299,152,147
"2021","Croydon 046","E02006987",3878,1650,164,1486,1936,40,751,361,333,57,648,551,89,8,390,262,128,107,107,292,65,227
"2021","Croydon 047","E02006988",3306,1344,306,1038,1702,75,701,231,411,59,408,270,130,8,460,348,112,58,58,260,105,155
"2021","Ealing 001","E02000238",3735,881,266,615,2283,129,1278,252,716,310,275,137,115,23,490,255,235,111,111,571,316,255
"2021","Ealing 002","E02000239",2929,535,257,278,1767,206,1040,202,534,304,162,84,64,14,298,123,175,61,61,627,323,304
"2021","Ealing 003","E02000240",3899,862,362,500,2492,151,1229,269,695,265,237,78,117,42,828,490,338,47,47,545,315,230
"2021","Ealing 004","E02000241",2602,580,213,367,1613,122,922,198,495,229,168,76,60,32,363,220,143,38,38,409,214,195
"2021","Ealing 005","E02000242",2235,409,156,253,1378,118,833,166,424,243,140,75,50,15,253,107,146,34,34,448,204,244
"2021","Ealing 006","E02000243",3125,848,332,516,1756,141,954,203,516,235,173,82,77,14,436,220,216,52,52,521,249,272
"2021","Ealing 007","E02000244",2938,826,247,579,1694,146,972,201,538,233,197,111,67,19,343,182,161,36,36,418,176,242
"2021","Ealing 008","E02000245",3354,865,249,616,2120,72,1050,191,642,217,197,99,84,14,723,494,229,78,78,369,207,162
"2021","Ealing 009","E02000246",3074,634,255,379,2007,104,1049,159,636,254,168,58,82,28,633,372,261,53,53,433,254,179
"2021","Ealing 010","E02000247",3893,962,314,648,2491,144,1313,250,793,270,260,94,139,27,716,435,281,58,58,440,248,192
"2021","Ealing 011","E02000248",2988,881,309,572,1686,132,935,214,566,155,208,127,71,10,338,213,125,73,73,421,126,295
"2021","Ealing 012","E02000249",2910,735,308,427,1675,128,900,151,535,214,173,67,85,21,413,195,218,61,61,500,277,223
"2021","Ealing 013","E02000250",2546,660,366,294,1642,215,988,221,608,159,200,132,59,9,215,118,97,24,24,244,72,172
"2021","Ealing 014","E02000251",2543,463,215,248,1547,153,945,153,484,308,90,32,44,14,328,130,198,31,31,533,304,229
"2021","Ealing 015","E02000252",4410,1640,292,1348,2175,131,926,291,471,164,384,279,84,21,644,385,259,90,90,595,160,435
"2021","Ealing 016","E02000253",3840,1090,519,571,2390,148,1146,188,716,242,259,104,127,28,768,419,349,69,69,360,199,161
"2021","Ealing 017","E02000254",2610,384,200,184,1584,115,1049,153,520,376,68,19,34,15,306,115,191,46,46,642,404,238
"2021","Ealing 018","E02000255",3790,1042,361,681,2398,226,1253,279,740,234,354,233,101,20,513,315,198,52,52,350,120,230
"2021","Ealing 019","E02000256",4026,1261,341,920,2295,180,1233,389,641,203,465,380,79,6,342,216,126,75,75,470,77,393
"2021","Ealing 021","E02000258",2602,740,224,516,1493,79,850,200,519,131,218,162,52,4,294,170,124,52,52,369,118,251
"2021","Ealing 022","E02000259",2394,498,177,321,1617,133,888,182,521,185,221,124,87,10,353,203,150,22,22,279,109,170
"2021","Ealing 023","E02000260",2752,492,245,247,1603,128,1003,143,566,294,62,24,38,0,369,138,231,41,41,657,414,243
"2021","Ealing 024","E02000261",4977,1536,376,1160,2719,130,1201,311,672,218,533,372,149,12,725,405,320,130,130,722,184,538
"2021","Ealing 025","E02000262",3946,1368,345,1023,2092,81,1031,278,610,143,475,338,121,16,412,244,168,93,93,486,126,360
"2021","Ealing 026","E02000263",3647,633,240,393,1974,117,1255,149,740,366,103,39,51,13,432,191,241,67,67,1040,684,356
"2021","Ealing 027","E02000264",3543,1140,297,843,1885,187,975,293,513,169,363,281,69,13,275,152,123,85,85,518,74,444
"2021","Ealing 028","E02000265",4735,1546,482,1064,2667,120,1283,360,733,190,519,378,129,12,678,416,262,67,67,522,133,389
"2021","Ealing 029","E02000266",4295,1070,269,801,2572,113,1317,248,777,292,257,137,100,20,823,424,399,62,62,653,396,257
"2021","Ealing 030","E02000267",3221,852,294,558,1974,103,1006,262,607,137,387,217,155,15,435,291,144,43,43,395,127,268
"2021","Ealing 031","E02000268",3862,1166,404,762,2237,209,1151,352,603,196,415,306,87,22,405,187,218,57,57,459,106,353
"2021","Ealing 032","E02000269",3302,883,312,571,2085,155,1273,344,741,188,376,267,93,16,251,146,105,30,30,334,66,268
"2021","Ealing 033","E02000270",4116,1389,320,1069,2302,68,1055,319,620,116,550,412,124,14,534,324,210,95,95,425,110,315
"2021","Ealing 034","E02000271",2979,865,315,550,1854,165,1114,391,606,117,330,253,68,9,213,129,84,32,32,260,78,182
"2021","Ealing 035","E02000272",2540,625,296,329,1687,186,999,208,599,192,222,128,80,14,252,123,129,28,28,228,83,145
"2021","Ealing 038","E02000275",2347,441,164,277,1329,107,816,157,421,238,77,35,33,9,298,161,137,31,31,577,376,201
"2021","Ealing 039","E02000276",2724,707,279,428,1668,92,939,263,569,107,332,232,94,6,273,169,104,32,32,349,66,283
"2021","Ealing 040","E02006791",3446,1225,333,892,1922,101,994,333,548,113,509,404,91,14,259,128,131,59,59,299,75,224
"2021","Ealing 041","E02006968",3562,1211,434,777,1954,183,1154,334,665,155,304,251,47,6,274,171,103,39,39,397,100,297
"2021","Ealing 042","E02006969",2976,1089,254,835,1561,77,811,307,438,66,426,378,45,3,189,106,83,58,58,326,47,279
"2021","Ealing 043","E02006970",2030,327,90,237,1222,51,820,98,542,180,68,25,38,5,252,134,118,31,31,481,309,172
"2021","Ealing 044","E02006971",2222,298,122,176,1330,83,848,113,485,250,54,10,29,15,300,142,158,45,45,594,394,200
"2021","Enfield 001","E02000277",2623,537,216,321,1804,148,759,159,372,228,174,56,97,21,653,431,222,70,70,282,184,98
"2021","Enfield 002","E02000278",3341,826,280,546,2178,124,917,180,483,254,202,69,104,29,892,584,308,43,43,337,208,129
"2021","Enfield 003","E02000279",4413,1089,287,802,2864,112,1142,215,652,275,348,138,170,40,1204,896,308,58,58,460,288,172
"2021","Enfield 004","E02000280",3413,927,451,476,2250,256,1082,269,600,213,311,128,159,24,584,338,246,17,17,236,111,125
"2021","Enfield 005","E02000281",3548,943,320,623,2313,168,1011,227,592,192,312,120,164,28,784,526,258,38,38,292,187,105
"2021","Enfield 006","E02000282",3469,863,258,605,2280,117,907,161,527,219,188,50,110,28,1012,754,258,56,56,326,205,121
"2021","Enfield 007","E02000283",2798,478,198,280,2002,147,917,163,488,266,157,54,81,22,733,483,250,48,48,318,175,143
"2021","Enfield 008","E02000284",3617,1088,447,641,2286,231,1098,285,623,190,371,201,142,28,549,354,195,37,37,243,112,131
"2021","Enfield 009","E02000285",2462,496,282,214,1777,262,1048,242,518,288,176,78,84,14,270,132,138,21,21,189,103,86
"2021","Enfield 010","E02000286",4003,1475,625,850,2325,362,1124,338,607,179,354,225,118,11,457,301,156,28,28,203,85,118
"2021","Enfield 011","E02000287",2872,769,440,329,1880,332,1081,240,567,274,169,97,57,15,273,155,118,25,25,223,111,112
"2021","Enfield 012","E02000288",4051,971,323,648,2551,145,1229,182,730,317,216,79,106,31,919,647,272,42,42,529,331,198
"2021","Enfield 013","E02000289",2426,466,315,151,1759,296,1058,224,546,288,139,58,63,18,251,114,137,15,15,201,108,93
"2021","Enfield 014","E02000290",2515,726,185,541,1570,56,608,127,356,125,165,70,81,14,691,528,163,50,50,219,135,84
"2021","Enfield 015","E02000291",4329,1467,499,968,2535,226,1087,307,599,181,416,259,135,22,771,510,261,35,35,327,165,162
"2021","Enfield 016","E02000292",3566,832,356,476,2351,200,1172,222,650,300,264,125,124,15,683,426,257,32,32,383,210,173
"2021","Enfield 017","E02000293",2489,618,340,278,1699,342,972,225,506,241,160,72,74,14,217,113,104,8,8,172,75,97
"2021","Enfield 018","E02000294",3087,636,299,337,2070,174,972,159,517,296,163,58,93,12,706,450,256,55,55,381,223,158
"2021","Enfield 019","E02000295",3352,929,407,522,2119,220,1166,239,658,269,237,123,93,21,469,294,175,27,27,304,174,130
"2021","Enfield 020","E02000296",4040,1175,503,672,2430,216,1267,305,732,230,327,175,130,22,565,364,201,55,55,435,207,228
"2021","Enfield 021","E02000297",3475,864,481,383,2259,363,1309,314,596,399,208,102,84,22,360,177,183,19,19,352,178,174
"2021","Enfield 022","E02000298",3055,731,364,367,2049,277,1247,281,673,293,234,135,76,23,264,137,127,27,27,275,125,150
"2021","Enfield 023","E02000299",3315,848,331,517,2068,104,924,155,528,241,213,66,124,23,768,503,265,59,59,399,222,177
"2021","Enfield 024","E02000300",3002,758,238,520,1829,124,839,160,441,238,187,59,106,22,638,399,239,41,41,415,261,154
"2021","Enfield 025","E02000301",3725,1030,349,681,2318,119,937,200,495,242,210,65,111,34,989,660,329,63,63,377,221,156
"2021","Enfield 026","E02000302",3115,753,340,413,1958,245,1024,212,555,257,215,83,113,19,432,219,213,42,42,404,208,196
"2021","Enfield 027","E02000303",2978,864,308,556,1747,98,773,148,440,185,172,46,104,22,641,392,249,63,63,367,216,151
"2021","Enfield 028","E02000304",2910,608,317,291,1994,314,1223,269,645,309,188,100,77,11,245,104,141,24,24,308,143,165
"2021","Enfield 029","E02000305",3456,924,316,608,2137,185,1139,309,598,232,397,223,154,20,355,206,149,61,61,395,160,235
"2021","Enfield 030","E02000306",3397,1027,338,689,2057,65,815,156,467,192,209,68,112,29,915,584,331,53,53,313,185,128
"2021","Enfield 031","E02000307",3350,666,299,367,2217,179,1165,202,611,352,179,62,92,25,652,392,260,42,42,467,262,205
"2021","Enfield 032","E02000308",3230,830,246,584,1914,170,892,197,505,190,267,146,102,19,527,311,216,58,58,486,213,273
"2021","Enfield 033","E02000309",3988,977,324,653,2449,109,1114,198,687,229,219,66,124,29,918,588,330,89,89,562,327,235
"2021","Enfield 035","E02000311",3637,824,321,503,2192,196,1076,212,540,324,216,106,88,22,636,358,278,68,68,621,329,292
"2021","Enfield 036","E02000312",4498,1272,395,877,2576,165,1273,368,648,257,489,307,166,16,548,328,220,101,101,650,222,428
"2021","Enfield 037","E02006793",3390,872,252,620,2089,76,886,157,516,213,207,70,117,20,849,516,333,71,71,429,260,169
"2021","Greenwich 001","E02000313",2591,964,202,762,1355,55,525,113,291,121,174,53,99,22,561,394,167,40,40,272,141,131
"2021","Greenwich 002","E02000314",4531,1130,197,933,2845,47,1305,294,805,206,409,143,241,25,986,708,278,98,98,556,312,244
"2021","Greenwich 003","E02000315",3491,916,284,632,2110,86,860,160,524,176,299,106,175,18,793,514,279,72,72,465,261,204
"2021","Greenwich 005","E02000317",2822,785,179,606,1707,73,671,167,364,140,271,129,119,23,629,414,215,63,63,330,159,171
"2021","Greenwich 006","E02000318",3582,922,290,632,1920,117,900,241,444,215,232,132,82,18,580,362,218,91,91,740,450,290
"2021","Greenwich 007","E02000319",3919,1115,256,859,2197,67,947,268,512,167,440,252,169,19,663,394,269,80,80,607,279,328
"2021","Greenwich 008","E02000320",2558,677,207,470,1558,96,698,164,340,194,271,125,127,19,455,302,153,38,38,323,174,149
"2021","Greenwich 009","E02000321",2959,933,229,704,1643,71,620,155,337,128,279,140,121,18,626,411,215,47,47,383,193,190
"2021","Greenwich 011","E02000323",4821,1507,257,1250,2655,77,1073,286,627,160,529,298,205,26,879,591,288,97,97,659,317,342
"2021","Greenwich 012","E02000324",2853,814,272,542,1658,102,718,182,389,147,294,160,117,17,503,318,185,41,41,381,196,185
"2021","Greenwich 014","E02000326",3049,859,271,588,1825,88,913,261,521,131,377,232,127,18,401,231,170,46,46,365,109,256
"2021","Greenwich 015","E02000327",2635,919,181,738,1467,37,631,197,351,83,273,173,80,20,493,320,173,33,33,249,122,127
"2021","Greenwich 016","E02000328",2948,1032,351,681,1710,138,862,313,445,104,401,296,94,11,285,160,125,24,24,206,56,150
"2021","Greenwich 017","E02000329",2464,677,249,428,1519,150,718,186,359,173,211,92,93,26,417,246,171,23,23,268,130,138
"2021","Greenwich 019","E02000331",3191,958,316,642,1852,96,845,224,457,164,367,175,161,31,504,318,186,40,40,381,178,203
"2021","Greenwich 020","E02000332",2999,859,320,539,1859,173,931,314,453,164,337,145,169,23,368,232,136,50,50,281,121,160
"2021","Greenwich 021","E02000333",2882,1032,337,695,1676,171,858,322,450,86,384,288,75,21,235,148,87,28,28,174,51,123
"2021","Greenwich 022","E02000334",2545,690,243,447,1575,137,808,217,400,191,233,107,107,19,371,212,159,26,26,280,122,158
"2021","Greenwich 023","E02000335",2591,610,326,284,1812,218,1001,254,543,204,292,126,143,23,286,135,151,15,15,169,82,87
"2021","Greenwich 025","E02000337",3085,736,347,389,1996,152,925,234,492,199,333,171,125,37,553,275,278,33,33,353,197,156
"2021","Greenwich 027","E02000339",2591,817,409,408,1583,209,867,221,442,204,251,134,100,17,242,132,110,14,14,191,86,105
"2021","Greenwich 028","E02000340",3022,1079,460,619,1721,253,841,247,418,176,327,183,121,23,268,168,100,32,32,222,98,124
"2021","Greenwich 029","E02000341",2945,735,276,459,1887,150,795,180,449,166,261,107,124,30,642,412,230,39,39,323,186,137
"2021","Greenwich 030","E02000342",2342,698,256,442,1449,124,684,198,358,128,274,126,129,19,352,216,136,15,15,195,84,111
"2021","Greenwich 031","E02000343",2694,751,349,402,1705,160,857,233,421,203,247,102,119,26,421,215,206,20,20,238,128,110
"2021","Greenwich 032","E02000344",2446,597,289,308,1662,234,902,234,474,194,256,121,112,23,261,136,125,9,9,187,95,92
"2021","Greenwich 033","E02006786",2871,777,232,545,1738,107,742,188,366,188,269,122,123,24,588,401,187,32,32,356,197,159
"2021","Greenwich 034","E02006927",5084,1537,577,960,3078,235,1568,492,848,228,619,432,155,32,582,363,219,74,74,469,197,272
"2021","Greenwich 035","E02006928",5267,1724,175,1549,2894,60,1091,511,509,71,908,790,107,11,719,521,198,116,116,649,99,550
"2021","Greenwich 037","E02006930",4230,1236,240,996,2445,88,1155,404,663,88,716,582,125,9,430,260,170,56,56,549,94,455
"2021","Greenwich 038","E02006931",4140,1315,385,930,2373,157,1109,449,570,90,643,520,109,14,401,251,150,63,63,452,84,368
"2021","Greenwich 039","E02006991",3237,1162,105,1057,1743,44,737,438,263,36,698,614,77,7,194,129,65,70,70,332,56,276
"2021","Greenwich 040","E02006992",3769,1217,220,997,2214,61,944,422,460,62,689,569,115,5,465,313,152,55,55,338,84,254
"2021","Greenwich 041","E02006993",3626,1102,90,1012,2087,31,851,373,425,53,684,563,115,6,438,336,102,83,83,437,97,340
"2021","Greenwich 042","E02006994",3285,1175,206,969,1725,35,714,199,412,103,387,239,129,19,511,362,149,78,78,385,140,245
"2021","Hackney 001","E02000345",2589,746,244,502,1620,119,1019,187,732,100,145,93,46,6,282,184,98,55,55,223,102,121
"2021","Hackney 002","E02000346",3973,1229,260,969,2205,53,728,269,361,98,532,424,88,20,803,552,251,89,89,539,158,381
"2021","Hackney 003","E02000347",2585,714,210,504,1571,80,902,148,660,94,204,146,51,7,337,192,145,48,48,300,107,193
"2021","Hackney 004","E02000348",2721,830,238,592,1635,64,875,136,645,94,162,86,66,10,479,317,162,55,55,256,104,152
"2021","Hackney 006","E02000350",3694,1102,188,914,1884,67,892,210,558,124,486,361,113,12,359,205,154,80,80,708,165,543
"2021","Hackney 007","E02000351",4231,1470,248,1222,2060,67,766,260,405,101,664,538,118,8,482,301,181,81,81,701,96,605
"2021","Hackney 008","E02000352",2686,858,257,601,1504,66,633,142,412,79,343,225,105,13,430,274,156,32,32,324,50,274
"2021","Hackney 009","E02000353",3158,910,205,705,1718,79,761,193,457,111,495,363,119,13,334,154,180,49,49,530,97,433
"2021","Hackney 010","E02000354",3990,1434,290,1144,1918,51,703,207,379,117,498,347,138,13,599,366,233,67,67,638,177,461
"2021","Hackney 011","E02000355",3111,900,180,720,1611,67,667,149,393,125,419,263,131,25,405,242,163,53,53,600,136,464
"2021","Hackney 012","E02000356",3061,952,195,757,1719,67,716,233,410,73,553,415,116,22,342,185,157,41,41,390,65,325
"2021","Hackney 013","E02000357",2721,937,343,594,1430,55,419,79,250,90,201,104,80,17,696,421,275,59,59,354,140,214
"2021","Hackney 014","E02000358",4819,1612,306,1306,2359,52,885,308,461,116,610,468,131,11,730,397,333,82,82,848,147,701
"2021","Hackney 015","E02000359",2438,607,164,443,1368,60,546,102,358,86,299,198,93,8,414,234,180,49,49,463,132,331
"2021","Hackney 016","E02000360",4850,1668,383,1285,2567,49,867,200,526,141,565,393,140,32,987,641,346,99,99,615,172,443
"2021","Hackney 017","E02000361",3676,1327,201,1126,1656,39,517,164,266,87,534,409,115,10,480,296,184,86,86,693,114,579
"2021","Hackney 018","E02000362",2804,856,227,629,1504,52,479,135,272,72,405,323,70,12,528,325,203,40,40,444,99,345
"2021","Hackney 019","E02000363",4439,1346,299,1047,2514,62,812,201,485,126,436,244,168,24,1132,728,404,72,72,579,162,417
"2021","Hackney 020","E02000364",4101,1456,371,1085,2029,103,702,225,390,87,553,422,115,16,601,323,278,70,70,616,120,496
"2021","Hackney 022","E02000366",3540,1306,351,955,1772,86,633,172,352,109,387,260,110,17,611,341,270,55,55,462,126,336
"2021","Hackney 023","E02000367",4595,1508,248,1260,2300,56,751,249,404,98,753,586,148,19,631,388,243,109,109,787,99,688
"2021","Hackney 024","E02000368",4149,1416,377,1039,2076,69,717,200,392,125,445,316,112,17,761,416,345,84,84,657,146,511
"2021","Hackney 025","E02000369",5925,1927,349,1578,3066,68,1006,340,520,146,951,756,166,29,925,565,360,116,116,932,163,769
"2021","Hackney 026","E02000370",3991,1414,214,1200,1966,38,663,249,306,108,513,423,75,15,671,424,247,81,81,611,119,492
"2021","Hackney 028","E02006918",3168,1024,202,822,1732,22,628,145,403,80,399,285,102,12,629,412,217,54,54,412,163,249
"2021","Hackney 029","E02006921",2782,897,251,646,1553,61,808,110,623,75,193,110,73,10,440,281,159,51,51,332,139,193
"2021","Hackney 030","E02007108",2801,971,136,835,1251,24,430,211,181,38,508,436,67,5,217,132,85,72,72,579,30,549
"2021","Hackney 031","E02007109",3302,1071,263,808,1720,69,626,218,309,99,501,392,93,16,471,258,213,53,53,511,96,415
"2021","Hackney 032","E02007110",3362,1382,208,1174,1473,27,545,198,248,99,409,338,55,16,403,256,147,89,89,507,59,448
"2021","Hackney 033","E02007111",2815,1054,76,978,1190,13,362,210,129,23,503,455,43,5,225,134,91,87,87,571,36,535
"2021","Hammersmith and Fulham 001","E02000372",3878,1408,301,1107,1950,65,778,230,372,176,296,195,71,30,704,357,347,107,107,520,133,387
"2021","Hammersmith and Fulham 002","E02000373",2538,659,167,492,1525,45,590,106,360,124,149,67,63,19,677,388,289,64,64,354,132,222
"2021","Hammersmith and Fulham 003","E02000374",2618,758,254,504,1415,67,619,152,364,103,215,146,57,12,449,243,206,65,65,445,117,328
"2021","Hammersmith and Fulham 004","E02000375",3498,1407,263,1144,1616,46,627,209,322,96,354,286,58,10,515,325,190,74,74,475,91,384
"2021","Hammersmith and Fulham 005","E02000376",3183,1262,239,1023,1487,38,536,221,243,72,426,362,46,18,375,180,195,112,112,434,82,352
"2021","Hammersmith and Fulham 006","E02000377",3447,1317,330,987,1672,54,691,213,386,92,390,303,66,21,470,255,215,67,67,458,82,376
"2021","Hammersmith and Fulham 007","E02000378",3251,1379,280,1099,1498,54,587,249,274,64,448,393,51,4,324,179,145,85,85,374,60,314
"2021","Hammersmith and Fulham 008","E02000379",3107,1036,323,713,1747,117,911,252,560,99,317,239,71,7,360,193,167,42,42,324,92,232
"2021","Hammersmith and Fulham 009","E02000380",2500,907,286,621,1327,80,681,232,367,82,284,224,53,7,237,138,99,45,45,266,56,210
"2021","Hammersmith and Fulham 010","E02000381",3547,1373,319,1054,1835,108,885,300,492,93,431,343,73,15,350,214,136,61,61,339,79,260
"2021","Hammersmith and Fulham 011","E02000382",2774,1037,278,759,1447,77,708,258,360,90,312,252,53,7,299,163,136,51,51,290,57,233
"2021","Hammersmith and Fulham 012","E02000383",4111,1703,444,1259,1816,113,760,297,367,96,425,364,46,15,389,189,200,129,129,592,73,519
"2021","Hammersmith and Fulham 013","E02000384",3808,1507,332,1175,1793,78,683,271,321,91,426,342,65,19,514,308,206,92,92,508,84,424
"2021","Hammersmith and Fulham 014","E02000385",2850,1188,215,973,1131,50,440,192,210,38,410,374,31,5,160,91,69,71,71,531,25,506
"2021","Hammersmith and Fulham 015","E02000386",3368,1238,308,930,1652,58,565,171,277,117,347,285,48,14,600,318,282,82,82,478,104,374
"2021","Hammersmith and Fulham 016","E02000387",2586,933,247,686,1168,49,496,162,258,76,210,155,42,13,354,184,170,59,59,485,59,426
"2021","Hammersmith and Fulham 017","E02000388",4133,1592,405,1187,1885,89,807,324,387,96,503,429,56,18,345,188,157,141,141,656,78,578
"2021","Hammersmith and Fulham 018","E02000389",3680,1128,411,717,1985,154,1067,358,572,137,391,303,75,13,292,149,143,81,81,567,83,484
"2021","Hammersmith and Fulham 019","E02000390",2719,901,229,672,1322,56,604,189,344,71,338,279,48,11,262,132,130,62,62,496,60,436
"2021","Hammersmith and Fulham 020","E02000391",3281,1109,328,781,1707,117,901,268,519,114,311,262,43,6,315,158,157,63,63,465,101,364
"2021","Hammersmith and Fulham 021","E02000392",4039,1396,307,1089,2042,80,984,292,584,108,475,392,64,19,407,242,165,96,96,601,100,501
"2021","Hammersmith and Fulham 022","E02000393",2588,759,211,548,1422,87,725,218,446,61,370,312,57,1,177,103,74,63,63,407,54,353
"2021","Hammersmith and Fulham 023","E02000394",4348,1647,305,1342,2201,83,921,298,511,112,507,412,81,14,582,368,214,108,108,500,90,410
"2021","Hammersmith and Fulham 024","E02000395",2642,895,334,561,1354,169,674,230,362,82,289,256,29,4,163,91,72,59,59,393,51,342
"2021","Hammersmith and Fulham 025","E02000396",2774,789,235,554,1584,101,811,225,474,112,254,175,63,16,364,199,165,54,54,401,103,298
"2021","Haringey 001","E02000397",3471,1231,317,914,1833,70,779,271,420,88,403,257,128,18,497,319,178,84,84,407,122,285
"2021","Haringey 002","E02000398",2880,941,250,691,1540,55,559,120,324,115,175,65,89,21,678,411,267,73,73,399,188,211
"2021","Haringey 004","E02000400",3118,872,309,563,1902,117,847,170,500,177,290,141,120,29,592,340,252,56,56,344,120,224
"2021","Haringey 005","E02000401",2477,614,216,398,1548,51,671,145,340,186,181,77,77,27,578,287,291,67,67,315,160,155
"2021","Haringey 006","E02000402",2427,673,218,455,1447,48,560,102,296,162,166,80,64,22,626,373,253,47,47,307,172,135
"2021","Haringey 007","E02000403",2990,884,242,642,1587,67,717,227,376,114,367,246,111,10,349,199,150,87,87,519,182,337
"2021","Haringey 008","E02000404",2664,738,199,539,1452,95,623,158,312,153,199,120,68,11,441,248,193,94,94,474,176,298
"2021","Haringey 009","E02000405",2461,583,235,348,1654,135,1013,209,643,161,242,140,96,6,227,137,90,37,37,224,90,134
"2021","Haringey 010","E02000406",2597,727,201,526,1418,50,524,108,298,118,229,137,64,28,529,231,298,86,86,452,131,321
"2021","Haringey 011","E02000407",3006,960,243,717,1578,38,567,141,324,102,293,180,97,16,613,380,233,67,67,468,193,275
"2021","Haringey 012","E02000408",2998,852,254,598,1710,61,630,154,353,123,220,116,90,14,690,385,305,109,109,436,216,220
"2021","Haringey 013","E02000409",2371,710,187,523,1347,74,514,115,261,138,219,114,73,32,479,270,209,61,61,314,118,196
"2021","Haringey 014","E02000410",2616,752,227,525,1635,150,878,214,554,110,330,225,92,13,240,143,97,37,37,229,62,167
"2021","Haringey 015","E02000411",3953,1104,253,851,2227,53,807,246,416,145,445,265,159,21,818,511,307,104,104,622,253,369
"2021","Haringey 016","E02000412",2870,969,192,777,1409,56,537,167,249,121,280,190,78,12,457,260,197,79,79,492,114,378
"2021","Haringey 017","E02000413",2963,753,311,442,1973,153,1098,226,711,161,321,197,103,21,376,220,156,25,25,237,91,146
"2021","Haringey 018","E02000414",2719,768,206,562,1421,61,579,140,318,121,282,178,93,11,442,250,192,57,57,530,170,360
"2021","Haringey 019","E02000415",2834,841,216,625,1452,83,649,176,355,118,311,201,94,16,348,210,138,61,61,541,163,378
"2021","Haringey 020","E02000416",3919,1425,323,1102,2156,97,808,263,418,127,651,502,140,9,543,314,229,57,57,338,86,252
"2021","Haringey 021","E02000417",2867,951,361,590,1667,201,853,238,496,119,363,264,81,18,229,131,98,21,21,249,60,189
"2021","Haringey 022","E02000418",2211,525,233,292,1468,212,781,226,431,124,264,176,73,15,193,110,83,18,18,218,60,158
"2021","Haringey 023","E02000419",3644,1110,214,896,1896,66,786,257,434,95,511,380,121,10,457,245,212,76,76,638,140,498
"2021","Haringey 024","E02000420",3438,1186,361,825,1718,56,636,203,303,130,397,284,91,22,541,313,228,88,88,534,150,384
"2021","Haringey 025","E02000421",3139,1013,238,775,1634,42,585,161,325,99,260,158,87,15,659,390,269,88,88,492,164,328
"2021","Haringey 026","E02000422",2888,880,239,641,1559,47,642,132,377,133,288,168,100,20,499,300,199,83,83,449,159,290
"2021","Haringey 027","E02000423",2675,754,173,581,1270,45,535,147,280,108,298,206,78,14,324,155,169,68,68,651,133,518
"2021","Haringey 028","E02000424",2985,984,259,725,1693,84,770,270,413,87,482,344,120,18,332,182,150,25,25,308,75,233
"2021","Haringey 029","E02000425",2162,464,132,332,1411,60,847,98,654,95,128,63,60,5,315,151,164,61,61,287,125,162
"2021","Haringey 030","E02000426",2748,859,328,531,1627,221,829,225,485,119,309,214,83,12,235,127,108,33,33,262,70,192
"2021","Haringey 031","E02000427",2870,928,171,757,1446,47,652,251,317,84,402,301,93,8,281,130,151,64,64,496,76,420
"2021","Haringey 032","E02000428",2924,849,234,615,1552,47,626,120,381,125,260,167,77,16,555,313,242,64,64,523,139,384
"2021","Haringey 033","E02000429",3201,1216,410,806,1757,161,918,289,538,91,453,355,86,12,201,120,81,24,24,228,54,174
"2021","Haringey 034","E02000430",3249,1217,279,938,1690,105,724,236,413,75,573,454,104,15,258,154,104,30,30,342,63,279
"2021","Haringey 035","E02000431",2845,1013,261,752,1533,128,691,273,354,64,504,435,66,3,175,114,61,35,35,299,30,269
"2021","Haringey 036","E02000432",2798,982,221,761,1422,64,576,217,290,69,455,375,68,12,279,117,162,48,48,394,47,347
"2021","Haringey 037","E02006794",3122,966,247,719,1765,40,637,142,387,108,221,100,105,16,798,538,260,69,69,391,187,204
"2021","Harrow 001","E02000433",3546,1099,638,461,2167,481,1160,322,600,238,148,107,34,7,336,159,177,42,42,280,138,142
"2021","Harrow 002","E02000434",3636,919,394,525,2275,321,1395,335,734,326,166,95,56,15,336,166,170,57,57,442,208,234
"2021","Harrow 003","E02000435",2812,671,331,340,1770,293,1007,230,546,231,104,61,27,16,321,141,180,45,45,371,210,161
"2021","Harrow 004","E02000436",2044,339,241,98,1487,348,904,203,450,251,65,32,24,9,156,56,100,14,14,218,94,124
"2021","Harrow 005","E02000437",3085,751,423,328,1952,270,1120,246,561,313,129,57,55,17,397,194,203,36,36,382,220,162
"2021","Harrow 006","E02000438",3048,756,434,322,1969,224,1189,262,664,263,147,78,54,15,382,180,202,27,27,323,177,146
"2021","Harrow 007","E02000439",2948,614,241,373,1733,160,1048,185,596,267,116,71,29,16,351,183,168,58,58,601,349,252
"2021","Harrow 008","E02000440",3056,475,262,213,2081,274,1427,261,761,405,80,40,30,10,267,113,154,33,33,500,283,217
"2021","Harrow 009","E02000441",2790,730,376,354,1785,246,1052,225,604,223,135,77,50,8,328,171,157,24,24,275,141,134
"2021","Harrow 010","E02000442",2667,405,178,227,1540,142,1027,176,524,327,85,34,40,11,250,107,143,36,36,722,405,317
"2021","Harrow 011","E02000443",3549,785,347,438,2213,143,1295,230,765,300,197,102,74,21,522,298,224,56,56,551,291,260
"2021","Harrow 012","E02000444",2671,419,228,191,1741,206,1153,188,614,351,80,34,37,9,264,139,125,38,38,511,293,218
"2021","Harrow 013","E02000445",3823,875,308,567,2325,153,1370,246,786,338,199,105,76,18,543,311,232,60,60,623,358,265
"2021","Harrow 015","E02000447",2744,461,246,215,1946,205,1302,237,726,339,122,66,43,13,296,143,153,21,21,337,188,149
"2021","Harrow 016","E02000448",2758,726,420,306,1833,331,1123,253,674,196,146,97,44,5,222,118,104,11,11,199,111,88
"2021","Harrow 017","E02000449",2528,444,249,195,1489,159,902,162,402,338,83,36,33,14,302,124,178,43,43,595,325,270
"2021","Harrow 019","E02000451",2327,457,276,181,1579,216,1069,233,555,281,91,46,38,7,184,82,102,19,19,291,151,140
"2021","Harrow 020","E02000452",3451,905,208,697,2034,94,1209,315,706,188,284,194,82,8,376,239,137,71,71,512,235,277
"2021","Harrow 021","E02000453",3048,692,216,476,1972,166,1222,296,680,246,213,139,67,7,325,207,118,46,46,384,180,204
"2021","Harrow 022","E02000454",2524,423,263,160,1882,307,1305,218,795,292,70,35,27,8,189,83,106,11,11,219,122,97
"2021","Harrow 023","E02000455",4759,1464,444,1020,2782,159,1755,544,1005,206,345,257,72,16,403,230,173,120,120,513,204,309
"2021","Harrow 024","E02000456",2719,720,252,468,1596,153,1005,211,515,279,140,69,55,16,267,123,144,31,31,403,231,172
"2021","Harrow 025","E02000457",2564,556,238,318,1719,220,1064,222,564,278,142,95,35,12,255,121,134,38,38,289,140,149
"2021","Harrow 027","E02000459",3417,870,336,534,2142,142,1167,242,682,243,281,201,62,18,481,270,211,71,71,405,230,175
"2021","Harrow 028","E02000460",2413,489,173,316,1618,81,998,181,598,219,128,44,62,22,378,195,183,33,33,306,179,127
"2021","Harrow 029","E02000461",2559,731,272,459,1541,134,912,273,476,163,188,138,41,9,255,147,108,52,52,287,124,163
"2021","Harrow 030","E02000462",2289,498,222,276,1377,140,852,148,461,243,110,53,46,11,245,131,114,30,30,414,237,177
"2021","Harrow 031","E02000463",2832,522,256,266,1918,153,1165,215,639,311,123,44,59,20,440,212,228,37,37,392,244,148
"2021","Harrow 032","E02006795",2643,411,227,184,1820,177,1260,222,694,344,106,42,45,19,245,99,146,32,32,412,240,172
"2021","Harrow 033","E02006882",4397,644,351,293,2748,387,1756,329,789,638,116,52,48,16,428,146,282,61,61,1005,523,482
"2021","Havering 001","E02000464",2873,739,356,383,1862,183,866,209,455,202,310,111,158,41,487,301,186,16,16,272,158,114
"2021","Havering 002","E02000465",3492,945,349,596,2231,126,1072,255,571,246,426,152,225,49,574,367,207,33,33,316,192,124
"2021","Havering 003","E02000466",3287,708,359,349,2317,271,1031,257,495,279,360,135,187,38,629,360,269,26,26,262,150,112
"2021","Havering 004","E02000467",4292,1292,453,839,2625,118,1076,260,593,223,501,171,287,43,902,663,239,28,28,375,223,152
"2021","Havering 005","E02000468",3165,728,362,366,2173,273,1090,259,567,264,298,117,147,34,486,265,221,26,26,264,169,95
"2021","Havering 006","E02000469",2699,713,321,392,1699,164,729,163,419,147,285,91,163,31,498,293,205,23,23,287,161,126
"2021","Havering 007","E02000470",4130,1190,546,644,2667,376,1289,406,637,246,571,337,194,40,390,225,165,41,41,273,122,151
"2021","Havering 008","E02000471",2943,616,447,169,2096,454,1180,323,537,320,200,67,101,32,251,116,135,11,11,231,114,117
"2021","Havering 009","E02000472",3527,772,459,313,2459,352,1329,345,664,320,305,124,145,36,438,248,190,35,35,296,169,127
"2021","Havering 010","E02000473",4025,962,445,517,2789,368,1510,382,783,345,450,214,199,37,432,257,175,29,29,274,154,120
"2021","Havering 011","E02000474",3533,1001,494,507,2211,204,1099,276,603,220,381,156,183,42,500,312,188,27,27,321,194,127
"2021","Havering 012","E02000475",3958,1114,497,617,2602,465,1285,354,632,299,377,197,154,26,437,271,166,38,38,242,97,145
"2021","Havering 013","E02000476",4198,1534,498,1036,2344,194,1037,326,556,155,482,281,180,21,564,397,167,67,67,320,135,185
"2021","Havering 014","E02000477",3714,830,471,359,2625,435,1424,384,681,359,391,189,157,45,352,169,183,23,23,259,127,132
"2021","Havering 015","E02000478",2155,449,307,142,1483,396,850,208,362,280,100,42,40,18,129,56,73,8,8,223,141,82
"2021","Havering 016","E02000479",3790,1129,374,755,2332,155,1139,323,604,212,465,243,193,29,542,375,167,31,31,329,152,177
"2021","Havering 017","E02000480",5012,1206,333,873,3248,227,1561,378,862,321,548,248,250,50,851,559,292,61,61,558,310,248
"2021","Havering 018","E02000481",3243,819,530,289,2249,405,1132,284,564,284,298,103,157,38,400,211,189,14,14,175,91,84
"2021","Havering 019","E02000482",2577,635,446,189,1836,397,1100,238,601,261,180,87,79,14,153,66,87,6,6,106,50,56
"2021","Havering 020","E02000483",3476,1138,677,461,2115,295,1034,302,467,265,352,170,156,26,407,230,177,27,27,223,101,122
"2021","Havering 021","E02000484",3253,776,420,356,2243,312,1279,335,585,359,313,133,147,33,315,155,160,24,24,234,129,105
"2021","Havering 022","E02000485",3457,886,470,416,2358,351,1189,292,611,286,397,242,131,24,393,228,165,28,28,213,94,119
"2021","Havering 023","E02000486",2991,823,425,398,1992,321,1050,319,439,292,325,166,125,34,280,137,143,16,16,176,91,85
"2021","Havering 024","E02000487",2942,520,387,133,2270,531,1360,330,644,386,203,87,87,29,166,67,99,10,10,152,70,82
"2021","Havering 025","E02000488",3013,719,442,277,2125,415,1161,328,488,345,307,137,141,29,234,107,127,8,8,169,93,76
"2021","Havering 026","E02000489",3261,760,414,346,2232,281,1138,325,532,281,312,118,162,32,460,254,206,41,41,269,147,122
"2021","Havering 027","E02000490",3225,832,488,344,2129,302,1035,249,514,272,309,109,169,31,457,237,220,26,26,264,150,114
"2021","Havering 028","E02000491",3934,1012,393,619,2521,225,1149,274,610,265,405,161,199,45,703,458,245,39,39,401,228,173
"2021","Havering 029","E02000492",2620,645,395,250,1774,327,869,224,379,266,267,101,125,41,293,160,133,18,18,201,106,95
"2021","Havering 030","E02000493",2497,639,280,359,1609,140,746,189,382,175,278,93,152,33,420,278,142,25,25,249,152,97
"2021","Hillingdon 001","E02000494",3216,917,457,460,2058,429,1256,338,667,251,132,88,35,9,224,113,111,17,17,241,129,112
"2021","Hillingdon 002","E02000495",4301,1363,647,716,2578,348,1411,381,800,230,306,175,114,17,460,273,187,53,53,360,172,188
"2021","Hillingdon 003","E02000496",3176,941,443,498,2029,247,993,318,460,215,377,187,156,34,390,239,151,22,22,206,81,125
"2021","Hillingdon 004","E02000497",3692,988,490,498,2441,310,1380,348,736,296,282,129,114,39,448,240,208,21,21,263,130,133
"2021","Hillingdon 005","E02000498",2642,765,413,352,1716,278,910,246,484,180,234,127,90,17,279,144,135,15,15,161,79,82
"2021","Hillingdon 006","E02000499",3013,722,449,273,2068,364,1271,323,664,284,179,104,63,12,230,88,142,24,24,223,107,116
"2021","Hillingdon 007","E02000500",3308,844,462,382,2215,391,1306,362,611,333,237,140,73,24,251,131,120,30,30,249,102,147
"2021","Hillingdon 008","E02000501",3271,779,410,369,2252,275,1343,341,726,276,281,166,99,16,327,177,150,26,26,240,107,133
"2021","Hillingdon 009","E02000502",3531,990,457,533,2270,228,1280,316,745,219,366,205,143,18,360,212,148,36,36,271,137,134
"2021","Hillingdon 010","E02000503",3255,663,324,339,2308,222,1385,355,754,276,352,191,125,36,312,153,159,37,37,284,141,143
"2021","Hillingdon 011","E02000504",2923,677,411,266,2051,345,1256,310,671,275,215,99,92,24,216,90,126,19,19,195,95,100
"2021","Hillingdon 013","E02000506",2897,625,340,285,1957,328,1202,310,571,321,162,86,49,27,249,110,139,16,16,315,159,156
"2021","Hillingdon 014","E02000507",2782,506,260,246,1977,160,1207,254,689,264,228,90,112,26,353,186,167,29,29,299,161,138
"2021","Hillingdon 015","E02000508",4344,1347,406,941,2570,130,1396,402,827,167,487,325,142,20,445,287,158,112,112,427,142,285
"2021","Hillingdon 016","E02000509",3399,1079,327,752,1863,124,907,262,501,144,371,224,126,21,411,266,145,50,50,457,155,302
"2021","Hillingdon 017","E02000510",3256,798,396,402,2100,229,1261,293,662,306,219,104,97,18,366,186,180,25,25,358,187,171
"2021","Hillingdon 018","E02000511",3262,678,302,376,2129,206,1303,205,764,334,188,77,82,29,399,215,184,33,33,455,283,172
"2021","Hillingdon 019","E02000512",3108,758,295,463,1952,128,1017,202,599,216,233,107,103,23,521,301,220,53,53,398,219,179
"2021","Hillingdon 020","E02000513",3318,728,226,502,2222,87,1171,187,785,199,246,84,132,30,672,427,245,46,46,368,216,152
"2021","Hillingdon 021","E02000514",3176,496,208,288,2033,169,1315,203,802,310,142,48,79,15,370,191,179,37,37,647,395,252
"2021","Hillingdon 022","E02000515",5344,1664,423,1241,3122,151,1582,437,917,228,581,341,209,31,726,507,219,82,82,558,197,361
"2021","Hillingdon 023","E02000516",2815,547,189,358,1785,108,994,199,575,220,163,81,64,18,483,267,216,37,37,483,305,178
"2021","Hillingdon 024","E02000517",3319,658,269,389,2169,121,1211,213,755,243,259,98,104,57,545,307,238,33,33,492,318,174
"2021","Hillingdon 025","E02000518",3330,754,381,373,2153,137,1043,233,568,242,265,108,121,36,652,422,230,56,56,423,206,217
"2021","Hillingdon 026","E02000519",3020,653,319,334,1858,138,1035,171,597,267,138,56,68,14,503,279,224,44,44,509,343,166
"2021","Hillingdon 027","E02000520",4453,964,295,669,2688,105,1520,313,883,324,307,156,121,30,673,398,275,83,83,801,492,309
"2021","Hillingdon 028","E02000521",4353,861,224,637,2909,108,1686,299,1043,344,362,179,142,41,684,391,293,69,69,583,324,259
"2021","Hillingdon 029","E02000522",3487,846,307,539,2220,150,1159,274,654,231,316,167,129,20,557,349,208,38,38,421,212,209
"2021","Hillingdon 030","E02000523",3683,760,203,557,2235,117,1365,291,752,322,228,126,81,21,460,243,217,65,65,688,379,309
"2021","Hillingdon 031","E02000524",2640,697,225,472,1504,89,803,235,401,167,231,136,86,9,341,200,141,40,40,439,211,228
"2021","Hillingdon 032","E02000525",3320,717,235,482,2019,102,1139,233,686,220,230,111,107,12,504,309,195,44,44,584,327,257
"2021","Hillingdon 033","E02006796",3579,846,348,498,2434,196,1416,334,815,267,334,165,136,33,453,243,210,35,35,299,154,145
"2021","Hounslow 001","E02000526",3615,1120,343,777,2136,220,1262,397,740,125,363,278,74,11,239,124,115,52,52,359,75,284
"2021","Hounslow 004","E02000529",3039,591,194,397,1856,113,1153,166,690,297,128,44,66,18,418,225,193,44,44,592,355,237
"2021","Hounslow 005","E02000530",2519,523,168,355,1590,63,862,112,548,202,94,23,53,18,520,278,242,51,51,406,263,143
"2021","Hounslow 006","E02000531",4940,1610,434,1176,2853,181,1413,480,755,178,603,414,153,36,576,349,227,80,80,477,158,319
"2021","Hounslow 007","E02000532",3819,1195,467,728,2314,270,1224,366,690,168,399,289,92,18,382,222,160,39,39,310,103,207
"2021","Hounslow 008","E02000533",3689,1216,474,742,2163,222,1114,321,667,126,418,287,123,8,355,213,142,54,54,310,73,237
"2021","Hounslow 009","E02000534",2999,671,219,452,1850,192,1135,214,648,273,225,135,81,9,269,133,136,29,29,478,200,278
"2021","Hounslow 010","E02000535",3004,592,338,254,1688,165,1096,161,582,353,79,26,44,9,305,122,183,43,43,724,426,298
"2021","Hounslow 011","E02000536",3244,592,209,383,1934,141,1214,175,687,352,119,47,63,9,413,210,203,47,47,718,434,284
"2021","Hounslow 012","E02000537",3159,586,224,362,1830,193,1115,204,608,303,124,64,55,5,315,134,181,83,83,743,353,390
"2021","Hounslow 013","E02000538",3004,526,228,298,1714,94,1050,196,564,290,165,95,57,13,352,176,176,53,53,764,432,332
"2021","Hounslow 014","E02000539",4734,1256,380,876,3061,144,1569,394,947,228,582,351,202,29,694,402,292,72,72,417,172,245
"2021","Hounslow 015","E02000540",4486,1176,401,775,2681,145,1476,372,873,231,367,212,137,18,604,406,198,89,89,629,294,335
"2021","Hounslow 016","E02000541",3281,661,269,392,1889,119,1030,178,591,261,160,74,76,10,536,214,322,44,44,731,439,292
"2021","Hounslow 017","E02000542",3950,963,325,638,2235,131,1379,225,906,248,194,95,81,18,469,279,190,62,62,752,444,308
"2021","Hounslow 018","E02000543",4893,1098,261,837,3013,134,1865,447,1172,246,309,189,105,15,626,419,207,79,79,782,382,400
"2021","Hounslow 019","E02000544",2922,563,265,298,1904,216,1204,267,629,308,173,87,68,18,260,106,154,51,51,455,227,228
"2021","Hounslow 020","E02000545",3550,1008,323,685,2179,149,1063,244,648,171,377,227,135,15,564,369,195,26,26,363,164,199
"2021","Hounslow 021","E02000546",3161,556,223,333,1971,133,1178,183,701,294,176,83,85,8,435,222,213,49,49,634,369,265
"2021","Hounslow 022","E02000547",3852,999,513,486,2251,172,1216,243,672,301,255,94,138,23,565,322,243,43,43,602,328,274
"2021","Hounslow 023","E02000548",3724,1034,333,701,2212,137,1129,271,612,246,344,151,158,35,554,354,200,48,48,478,279,199
"2021","Hounslow 024","E02000549",4083,880,401,479,2475,202,1425,306,746,373,263,114,108,41,533,284,249,52,52,728,371,357
"2021","Hounslow 025","E02000550",3723,755,220,535,2484,99,1374,300,832,242,328,113,164,51,630,358,272,53,53,484,251,233
"2021","Hounslow 026","E02000551",3416,876,328,548,2091,124,980,183,577,220,295,118,145,32,650,398,252,42,42,449,252,197
"2021","Hounslow 027","E02000552",3356,829,251,578,2168,124,1224,318,709,197,329,153,161,15,455,280,175,36,36,359,180,179
"2021","Hounslow 028","E02000553",2599,661,285,376,1676,161,897,199,486,212,215,69,124,22,378,224,154,25,25,262,143,119
"2021","Hounslow 029","E02006792",4145,1583,548,1035,2134,165,1134,376,637,121,495,407,76,12,271,173,98,69,69,428,66,362
"2021","Hounslow 030","E02006972",2334,775,150,625,1387,73,657,241,328,88,240,167,65,8,386,264,122,31,31,172,55,117
"2021","Hounslow 031","E02006973",3727,1314,400,914,2092,100,917,305,496,116,427,281,126,20,594,339,255,54,54,321,103,218
"2021","Islington 001","E02000554",4197,1558,367,1191,2157,63,732,192,407,133,498,336,147,15,774,456,318,90,90,482,98,384
"2021","Islington 002","E02000555",4035,1281,369,912,2158,114,852,279,447,126,508,383,107,18,612,336,276,72,72,596,111,485
"2021","Islington 003","E02000556",4950,1751,363,1388,2378,80,811,302,402,107,798,671,111,16,596,327,269,93,93,821,155,666
"2021","Islington 004","E02000557",4140,1631,396,1235,1980,85,697,266,327,104,545,434,95,16,576,311,265,77,77,529,78,451
"2021","Islington 005","E02000558",3958,1424,329,1095,2001,67,704,214,369,121,398,285,95,18,745,478,267,87,87,533,135,398
"2021","Islington 006","E02000559",3995,1223,237,986,2238,87,1038,334,599,105,645,506,127,12,404,222,182,64,64,534,80,454
"2021","Islington 007","E02000560",3275,1101,219,882,1599,57,538,234,240,64,577,485,83,9,344,207,137,83,83,575,68,507
"2021","Islington 008","E02000561",3157,1038,263,775,1694,124,745,236,402,107,509,393,103,13,274,155,119,42,42,425,72,353
"2021","Islington 009","E02000562",3489,1230,331,899,1849,87,750,252,402,96,520,414,91,15,442,245,197,50,50,410,79,331
"2021","Islington 010","E02000563",3856,1428,363,1065,1916,61,645,214,327,104,453,343,90,20,682,429,253,75,75,512,84,428
"2021","Islington 011","E02000564",5664,2022,320,1702,2738,80,948,400,433,115,944,776,150,18,627,404,223,139,139,904,96,808
"2021","Islington 012","E02000565",3494,1162,247,915,1818,66,603,176,339,88,488,373,97,18,609,373,236,52,52,514,85,429
"2021","Islington 013","E02000566",3836,1305,293,1012,2066,122,880,302,458,120,604,480,112,12,375,220,155,85,85,465,60,405
"2021","Islington 014","E02000567",4893,1707,375,1332,2554,100,925,352,412,161,820,673,127,20,638,353,285,71,71,632,117,515
"2021","Islington 015","E02000568",4670,1739,423,1316,2242,81,804,281,398,125,504,386,95,23,736,464,272,117,117,689,111,578
"2021","Islington 016","E02000569",4605,1643,447,1196,2436,129,847,286,439,122,613,463,129,21,758,464,294,89,89,526,85,441
"2021","Islington 017","E02000570",3990,1464,277,1187,2091,174,875,406,372,97,619,510,95,14,365,212,153,58,58,435,69,366
"2021","Islington 018","E02000571",4122,1517,345,1172,2118,90,812,293,422,97,574,456,100,18,584,372,212,58,58,487,103,384
"2021","Islington 019","E02000572",3524,1181,303,878,1717,74,571,130,325,116,331,226,82,23,678,376,302,63,63,626,118,508
"2021","Islington 020","E02000573",4922,1861,331,1530,2500,144,980,473,405,102,800,667,116,17,479,287,192,97,97,561,56,505
"2021","Islington 021","E02000574",3605,1498,249,1249,1643,104,589,278,228,83,506,420,64,22,379,209,170,65,65,464,58,406
"2021","Islington 022","E02000575",5171,2108,381,1727,2413,86,910,423,378,109,723,601,96,26,595,374,221,99,99,650,63,587
"2021","Islington 023","E02000576",4956,1927,410,1517,2432,94,859,364,367,128,568,428,117,23,804,550,254,107,107,597,89,508
"2021","Kensington and Chelsea 001","E02000577",3172,1238,327,911,1627,76,612,147,281,184,192,131,47,14,688,320,368,59,59,307,122,185
"2021","Kensington and Chelsea 002","E02000578",2307,823,232,591,1200,56,422,86,209,127,133,64,56,13,540,309,231,49,49,284,162,122
"2021","Kensington and Chelsea 003","E02000579",3817,1492,434,1058,1874,118,842,249,407,186,327,230,79,18,505,265,240,82,82,451,224,227
"2021","Kensington and Chelsea 004","E02000580",3990,1951,489,1462,1611,65,598,225,253,120,330,249,64,17,551,248,303,67,67,428,114,314
"2021","Kensington and Chelsea 005","E02000581",3010,1154,430,724,1513,87,604,147,297,160,220,111,87,22,560,277,283,42,42,343,128,215
"2021","Kensington and Chelsea 006","E02000582",3269,1660,412,1248,1337,89,678,254,342,82,315,276,32,7,211,117,94,44,44,272,53,219
"2021","Kensington and Chelsea 007","E02000583",3116,1326,359,967,1526,122,840,339,376,125,255,223,27,5,271,120,151,38,38,264,79,185
"2021","Kensington and Chelsea 008","E02000584",3329,1326,381,945,1748,191,976,358,537,81,259,212,42,5,272,162,110,50,50,255,69,186
"2021","Kensington and Chelsea 009","E02000585",3386,1253,359,894,1686,151,889,279,467,143,276,233,37,6,298,160,138,72,72,447,222,225
"2021","Kensington and Chelsea 010","E02000586",2881,1147,274,873,1425,141,836,347,405,84,213,186,24,3,175,95,80,60,60,309,58,251
"2021","Kensington and Chelsea 011","E02000587",3025,1157,327,830,1606,166,952,358,433,161,214,179,34,1,195,106,89,79,79,262,67,195
"2021","Kensington and Chelsea 012","E02000588",3076,1357,305,1052,1447,128,807,375,353,79,238,208,26,4,195,99,96,79,79,272,63,209
"2021","Kensington and Chelsea 013","E02000589",3657,1795,313,1482,1479,77,787,349,363,75,311,265,42,4,200,87,113,104,104,383,57,326
"2021","Kensington and Chelsea 014","E02000590",3052,1584,408,1176,1194,134,540,195,236,109,180,132,30,18,277,121,156,63,63,274,112,162
"2021","Kensington and Chelsea 015","E02000591",3244,1589,351,1238,1352,62,609,243,282,84,293,256,31,6,295,149,146,93,93,303,51,252
"2021","Kensington and Chelsea 016","E02000592",2837,1287,263,1024,1300,108,718,261,372,85,260,233,25,2,148,93,55,66,66,250,50,200
"2021","Kensington and Chelsea 017","E02000593",3690,1726,412,1314,1501,75,736,266,401,69,349,300,44,5,224,134,90,117,117,463,100,363
"2021","Kensington and Chelsea 018","E02000594",2920,1334,479,855,1320,186,701,292,301,108,184,152,27,5,207,114,93,42,42,266,57,209
"2021","Kensington and Chelsea 019","E02000595",3030,1441,437,1004,1301,161,681,224,333,124,225,187,30,8,177,95,82,57,57,288,100,188
"2021","Kensington and Chelsea 020","E02000596",3073,1303,319,984,1384,110,653,240,341,72,342,299,32,11,206,115,91,73,73,386,88,298
"2021","Kensington and Chelsea 021","E02000597",2997,1290,439,851,1432,86,622,181,287,154,196,129,57,10,479,220,259,49,49,275,87,188
"2021","Kingston upon Thames 001","E02000598",2969,623,345,278,2157,252,1431,291,909,231,179,92,71,16,283,165,118,12,12,189,85,104
"2021","Kingston upon Thames 002","E02000599",2351,435,256,179,1649,275,1065,241,549,275,105,53,43,9,187,85,102,17,17,267,128,139
"2021","Kingston upon Thames 003","E02000600",3378,973,373,600,2050,172,1141,249,768,124,306,208,90,8,390,257,133,41,41,355,91,264
"2021","Kingston upon Thames 004","E02000601",4857,1311,400,911,3227,217,1935,511,1219,205,548,373,158,17,462,307,155,65,65,319,104,215
"2021","Kingston upon Thames 005","E02000602",4043,1302,413,889,2312,126,1175,334,715,126,443,291,138,14,506,329,177,62,62,429,108,321
"2021","Kingston upon Thames 006","E02000603",2953,621,214,407,1943,146,1059,193,621,245,248,110,120,18,450,265,185,40,40,389,170,219
"2021","Kingston upon Thames 007","E02000604",3558,893,352,541,2345,225,1447,352,854,241,311,186,113,12,322,209,113,40,40,320,118,202
"2021","Kingston upon Thames 008","E02000605",3113,732,374,358,2100,242,1301,286,777,238,255,138,100,17,267,147,120,35,35,281,113,168
"2021","Kingston upon Thames 009","E02000606",4809,1760,472,1288,2520,202,1206,442,641,123,709,590,113,6,315,197,118,88,88,529,80,449
"2021","Kingston upon Thames 010","E02000607",2583,737,267,470,1604,149,973,267,573,133,293,185,93,15,168,92,76,21,21,242,57,185
"2021","Kingston upon Thames 011","E02000608",3408,1365,334,1031,1806,80,801,309,420,72,657,557,99,1,210,138,72,58,58,237,31,206
"2021","Kingston upon Thames 012","E02000609",2737,645,349,296,1776,266,1074,212,552,310,133,55,62,16,265,146,119,38,38,316,150,166
"2021","Kingston upon Thames 013","E02000610",3870,1603,477,1126,1982,131,861,307,470,84,628,509,110,9,325,221,104,37,37,285,62,223
"2021","Kingston upon Thames 014","E02000611",2651,487,313,174,1946,336,1244,256,702,286,165,63,85,17,187,75,112,14,14,218,108,110
"2021","Kingston upon Thames 015","E02000612",3076,651,356,295,2181,386,1339,342,702,295,205,104,84,17,234,112,122,17,17,244,99,145
"2021","Kingston upon Thames 016","E02000613",3195,810,293,517,2157,204,1178,282,732,164,410,252,146,12,331,218,113,34,34,228,74,154
"2021","Kingston upon Thames 017","E02000614",3373,736,310,426,2252,205,1276,289,715,272,327,170,123,34,411,225,186,33,33,385,176,209
"2021","Kingston upon Thames 018","E02000615",2956,660,353,307,2015,247,1143,290,623,230,303,149,122,32,304,176,128,18,18,281,120,161
"2021","Kingston upon Thames 019","E02000616",2391,559,254,305,1674,177,895,233,479,183,291,153,113,25,292,153,139,19,19,158,65,93
"2021","Kingston upon Thames 020","E02000617",3342,812,388,424,2224,237,1153,267,611,275,385,175,173,37,424,226,198,25,25,306,155,151
"2021","Lambeth 002","E02000619",4055,1542,411,1131,1954,76,681,248,326,107,403,310,68,25,698,414,284,96,96,559,148,411
"2021","Lambeth 003","E02000620",4585,1735,384,1351,2126,75,706,335,271,100,555,457,77,21,671,402,269,119,119,724,114,610
"2021","Lambeth 004","E02000621",6009,2440,359,2081,2538,70,879,461,331,87,827,719,90,18,586,351,235,176,176,1031,92,939
"2021","Lambeth 005","E02000622",3633,1179,265,914,1682,58,565,205,262,98,468,382,72,14,488,269,219,103,103,772,96,676
"2021","Lambeth 006","E02000623",3331,1103,270,833,1679,73,542,165,242,135,294,193,69,32,679,381,298,91,91,549,110,439
"2021","Lambeth 007","E02000624",4272,1453,259,1194,2059,42,598,219,282,97,630,514,94,22,656,391,265,133,133,760,113,647
"2021","Lambeth 008","E02000625",3797,1158,180,978,1870,31,551,163,272,116,430,317,84,29,710,447,263,148,148,769,161,608
"2021","Lambeth 009","E02000626",3446,1165,234,931,1788,27,564,146,291,127,332,216,95,21,769,473,296,96,96,493,156,337
"2021","Lambeth 010","E02000627",3916,1164,265,899,1849,59,591,221,278,92,466,363,86,17,626,347,279,107,107,903,144,759
"2021","Lambeth 011","E02000628",4483,1540,318,1222,2116,36,605,188,268,149,520,402,86,32,818,476,342,137,137,827,183,644
"2021","Lambeth 012","E02000629",4016,1199,243,956,1825,55,631,218,318,95,621,543,64,14,392,187,205,126,126,992,99,893
"2021","Lambeth 013","E02000630",3431,1118,243,875,1670,113,647,260,311,76,507,431,58,18,334,183,151,69,69,643,57,586
"2021","Lambeth 014","E02000631",3735,1002,261,741,1992,98,848,247,458,143,534,397,113,24,440,254,186,72,72,741,175,566
"2021","Lambeth 015","E02000632",4261,1191,187,1004,1733,38,458,207,190,61,739,663,65,11,370,180,190,128,128,1337,49,1288
"2021","Lambeth 016","E02000633",3963,1403,335,1068,1721,33,521,204,222,95,430,335,79,16,624,358,266,113,113,839,166,673
"2021","Lambeth 017","E02000634",3110,1124,253,871,1323,49,414,159,195,60,374,315,52,7,428,245,183,58,58,663,71,592
"2021","Lambeth 018","E02000635",4337,1447,264,1183,2106,43,720,248,378,94,685,555,109,21,564,323,241,94,94,784,113,671
"2021","Lambeth 019","E02000636",3078,752,179,573,1635,100,799,232,462,105,458,388,62,8,213,114,99,65,65,691,93,598
"2021","Lambeth 020","E02000637",3705,1117,200,917,1720,70,583,228,295,60,631,523,95,13,329,170,159,107,107,868,120,748
"2021","Lambeth 021","E02000638",4109,1270,262,1008,2021,47,707,237,361,109,509,397,91,21,646,411,235,112,112,818,113,705
"2021","Lambeth 022","E02000639",3726,1314,223,1091,1744,47,561,183,275,103,396,302,76,18,616,342,274,124,124,668,126,542
"2021","Lambeth 023","E02000640",3805,984,281,703,2076,95,891,244,545,102,602,452,135,15,409,252,157,79,79,745,80,665
"2021","Lambeth 024","E02000641",3392,1024,222,802,1860,29,589,168,317,104,309,190,102,17,864,512,352,69,69,508,171,337
"2021","Lambeth 025","E02000642",4170,1288,396,892,2397,143,952,281,539,132,558,401,136,21,677,386,291,67,67,485,126,359
"2021","Lambeth 026","E02000643",3950,1255,282,973,1985,62,778,249,426,103,574,456,100,18,498,287,211,73,73,710,144,566
"2021","Lambeth 027","E02000644",3497,985,221,764,1951,83,821,221,478,122,509,360,134,15,487,316,171,51,51,561,134,427
"2021","Lambeth 028","E02000645",4050,1212,249,963,2389,117,985,262,592,131,614,422,166,26,569,374,195,104,104,449,112,337
"2021","Lambeth 029","E02000646",3905,1141,288,853,2057,109,927,295,513,119,558,420,129,9,393,248,145,70,70,707,143,564
"2021","Lambeth 030","E02000647",3423,991,351,640,2047,130,960,270,546,144,442,279,136,27,475,298,177,40,40,385,129,256
"2021","Lambeth 031","E02000648",3188,1012,270,742,1880,62,663,185,382,96,338,183,125,30,766,473,293,51,51,296,129,167
"2021","Lambeth 032","E02000649",5302,1669,303,1366,2797,62,1076,377,596,103,865,678,173,14,615,429,186,179,179,836,158,678
"2021","Lambeth 033","E02000650",3274,1040,240,800,1909,76,696,195,382,119,508,355,138,15,590,354,236,39,39,325,122,203
"2021","Lambeth 034","E02000651",3478,1035,289,746,1949,107,869,244,476,149,465,320,130,15,440,265,175,68,68,494,163,331
"2021","Lambeth 035","E02000652",2544,574,219,355,1438,106,684,132,391,161,179,97,64,18,421,207,214,48,48,532,224,308
"2021","Lambeth 036","E02006801",3718,1524,325,1199,1579,107,547,263,205,79,404,334,55,15,372,200,172,149,149,615,100,515
"2021","Lewisham 001","E02000653",5293,1679,235,1444,2820,36,1103,426,537,140,783,622,131,30,759,463,296,139,139,794,174,620
"2021","Lewisham 002","E02000654",3592,1132,204,928,1956,44,588,175,289,124,475,324,105,46,781,511,270,68,68,504,150,354
"2021","Lewisham 003","E02000655",4011,1239,186,1053,2059,34,697,231,373,93,595,417,146,32,648,401,247,85,85,713,174,539
"2021","Lewisham 005","E02000657",3992,1291,265,1026,2012,63,729,267,362,100,582,444,119,19,563,347,216,75,75,689,147,542
"2021","Lewisham 006","E02000658",3458,961,205,756,1880,83,727,277,336,114,504,352,125,27,499,278,221,67,67,617,138,479
"2021","Lewisham 007","E02000659",3543,1091,239,852,2128,106,860,346,419,95,584,455,113,16,520,305,215,58,58,324,75,249
"2021","Lewisham 008","E02000660",3603,1145,185,960,2007,71,762,263,404,95,700,567,116,17,417,265,152,57,57,451,87,364
"2021","Lewisham 009","E02000661",3043,1136,312,824,1619,134,705,231,374,100,430,319,100,11,317,191,126,33,33,288,76,212
"2021","Lewisham 010","E02000662",3300,924,178,746,1905,43,712,190,420,102,498,320,164,14,596,347,249,56,56,471,147,324
"2021","Lewisham 011","E02000663",2817,843,205,638,1612,73,716,226,359,131,403,290,97,16,366,204,162,54,54,362,95,267
"2021","Lewisham 013","E02000665",3412,1035,314,721,2054,109,991,278,595,118,495,340,140,15,412,248,164,47,47,323,99,224
"2021","Lewisham 014","E02000666",2730,672,171,501,1666,94,759,188,435,136,374,234,128,12,407,217,190,32,32,392,115,277
"2021","Lewisham 015","E02000667",2525,585,210,375,1593,97,813,206,507,100,363,204,144,15,296,159,137,24,24,347,104,243
"2021","Lewisham 016","E02000668",2725,724,262,462,1755,128,927,211,598,118,319,195,107,17,356,218,138,25,25,246,101,145
"2021","Lewisham 017","E02000669",3308,1005,172,833,1922,82,759,255,403,101,568,420,133,15,446,308,138,67,67,381,126,255
"2021","Lewisham 018","E02000670",2783,903,250,653,1459,49,521,166,260,95,292,183,93,16,557,379,178,40,40,421,144,277
"2021","Lewisham 019","E02000671",3685,1087,277,810,2195,115,950,275,564,111,580,356,199,25,498,301,197,52,52,403,102,301
"2021","Lewisham 020","E02000672",4203,1407,237,1170,2296,79,927,268,529,130,537,349,169,19,690,480,210,63,63,500,190,310
"2021","Lewisham 021","E02000673",3496,1037,262,775,2098,124,935,296,517,122,597,428,154,15,405,252,153,37,37,361,81,280
"2021","Lewisham 022","E02000674",3057,780,245,535,1880,131,938,205,552,181,297,148,121,28,455,237,218,59,59,397,177,220
"2021","Lewisham 023","E02000675",3422,961,326,635,2133,181,989,281,508,200,382,217,140,25,531,308,223,50,50,328,134,194
"2021","Lewisham 024","E02000676",3188,856,235,621,2032,90,916,263,534,119,523,343,158,22,460,273,187,43,43,300,94,206
"2021","Lewisham 025","E02000677",2644,721,238,483,1562,144,768,171,395,202,246,118,105,23,367,199,168,37,37,361,143,218
"2021","Lewisham 026","E02000678",2614,737,221,516,1561,68,657,169,338,150,223,102,98,23,575,360,215,38,38,316,172,144
"2021","Lewisham 027","E02000679",3376,1079,326,753,1928,109,790,202,455,133,449,276,147,26,539,341,198,41,41,369,127,242
"2021","Lewisham 028","E02000680",2911,884,209,675,1729,93,679,168,409,102,379,246,117,16,543,336,207,35,35,298,97,201
"2021","Lewisham 029","E02000681",3350,1039,365,674,1966,108,842,225,435,182,304,157,119,28,667,384,283,45,45,345,178,167
"2021","Lewisham 030","E02000682",3218,833,305,528,2026,113,844,148,480,216,242,89,117,36,773,492,281,54,54,359,189,170
"2021","Lewisham 031","E02000683",2725,856,345,511,1576,81,659,160,344,155,284,152,108,24,519,309,210,33,33,293,135,158
"2021","Lewisham 033","E02000685",3421,1120,376,744,1987,105,798,217,452,129,420,266,129,25,627,382,245,37,37,314,125,189
"2021","Lewisham 034","E02000686",3044,1007,246,761,1752,39,606,145,339,122,270,120,117,33,753,482,271,84,84,285,173,112
"2021","Lewisham 035","E02000687",3450,1056,352,704,2065,121,823,243,436,144,497,338,135,24,578,359,219,46,46,329,134,195
"2021","Lewisham 037","E02006783",2895,682,212,470,1933,80,749,161,448,140,296,122,130,44,773,449,324,35,35,280,147,133
"2021","Lewisham 038","E02006784",3125,969,425,544,1848,128,774,173,414,187,267,120,117,30,616,335,281,63,63,308,174,134
"2021","Lewisham 039","E02006798",3778,1304,196,1108,1883,42,612,231,283,98,491,365,103,23,638,411,227,100,100,591,155,436
"2021","Lewisham 040","E02007008",2662,919,56,863,1449,10,518,269,210,39,503,422,76,5,346,248,98,72,72,294,52,242
"2021","Lewisham 041","E02007009",3986,1450,323,1127,2009,76,754,301,338,115,467,341,108,18,625,412,213,87,87,527,177,350
"2021","Merton 001","E02000689",3513,764,214,550,2400,157,1420,358,884,178,448,344,97,7,328,236,92,47,47,349,105,244
"2021","Merton 002","E02000690",2229,595,340,255,1456,316,864,261,456,147,140,91,45,4,126,69,57,10,10,178,61,117
"2021","Merton 003","E02000691",2957,771,255,516,1838,122,1053,289,628,136,409,322,76,11,213,122,91,41,41,348,70,278
"2021","Merton 004","E02000692",3568,1308,532,776,1980,223,1096,411,573,112,435,353,75,7,187,106,81,39,39,280,61,219
"2021","Merton 005","E02000693",4282,1229,223,1006,2452,89,1096,409,538,149,841,694,133,14,347,184,163,79,79,601,128,473
"2021","Merton 006","E02000694",3832,1050,312,738,2361,101,1295,396,778,121,603,479,113,11,318,200,118,44,44,421,81,340
"2021","Merton 007","E02000695",2938,609,240,369,1674,143,899,204,449,246,244,136,93,15,321,129,192,67,67,655,272,383
"2021","Merton 008","E02000696",3273,839,180,659,1864,81,899,254,493,152,400,273,103,24,420,226,194,64,64,570,206,364
"2021","Merton 009","E02000697",3665,980,263,717,2274,97,1280,408,755,117,631,527,95,9,215,134,81,51,51,411,85,326
"2021","Merton 010","E02000698",3181,791,369,422,2159,280,1348,318,849,181,242,165,70,7,263,147,116,26,26,231,92,139
"2021","Merton 011","E02000699",3258,798,313,485,2154,191,1302,320,860,122,419,311,99,9,211,103,108,31,31,306,84,222
"2021","Merton 012","E02000700",3357,900,236,664,2016,88,895,249,479,167,394,236,134,24,568,332,236,71,71,441,177,264
"2021","Merton 013","E02000701",3113,711,301,410,1825,125,963,191,543,229,242,121,107,14,425,226,199,70,70,577,288,289
"2021","Merton 014","E02000702",3367,861,247,614,2048,98,944,179,575,190,314,169,127,18,634,394,240,58,58,458,244,214
"2021","Merton 015","E02000703",2933,606,353,253,1991,296,1216,269,709,238,223,137,75,11,229,112,117,27,27,336,116,220
"2021","Merton 016","E02000704",3572,1052,345,707,2120,136,1109,340,639,130,472,351,101,20,360,212,148,43,43,400,124,276
"2021","Merton 017","E02000705",3116,640,273,367,1920,175,976,192,530,254,279,132,111,36,429,192,237,61,61,556,284,272
"2021","Merton 018","E02000706",3533,852,251,601,2146,83,1016,214,605,197,315,132,148,35,680,421,259,52,52,535,279,256
"2021","Merton 019","E02000707",2782,617,221,396,1689,88,772,135,423,214,185,56,95,34,593,358,235,51,51,476,259,217
"2021","Merton 020","E02000708",3260,714,309,405,2193,227,1391,283,824,284,259,144,97,18,278,141,137,38,38,353,134,219
"2021","Merton 021","E02000709",2870,590,360,230,1971,267,1228,277,671,280,204,96,97,11,247,93,154,25,25,309,135,174
"2021","Merton 022","E02000710",3438,970,408,562,2053,187,1037,259,570,208,295,160,115,20,485,266,219,49,49,415,216,199
"2021","Merton 023","E02000711",3460,839,275,564,2124,96,1127,281,635,211,362,218,115,29,475,261,214,64,64,497,230,267
"2021","Merton 024","E02000712",3404,825,374,451,2135,176,1147,241,636,270,288,122,129,37,480,248,232,44,44,444,226,218
"2021","Merton 025","E02000713",2830,553,310,243,2007,246,1138,263,584,291,279,122,135,22,314,149,165,30,30,270,137,133
"2021","Newham 001","E02000714",2647,617,143,474,1569,45,764,167,463,134,276,167,97,12,429,215,214,55,55,461,228,233
"2021","Newham 002","E02000715",2087,406,128,278,1319,37,768,88,527,153,98,34,49,15,381,232,149,35,35,362,245,117
"2021","Newham 003","E02000716",2300,500,145,355,1400,44,773,122,498,153,150,87,55,8,373,249,124,60,60,400,225,175
"2021","Newham 004","E02000717",2394,459,162,297,1420,47,835,115,580,140,123,71,46,6,374,228,146,41,41,515,339,176
"2021","Newham 005","E02000718",2248,490,159,331,1403,34,812,83,613,116,102,39,56,7,429,261,168,26,26,355,205,150
"2021","Newham 006","E02000719",2874,795,194,601,1528,49,704,175,418,111,255,154,76,25,446,239,207,74,74,551,230,321
"2021","Newham 007","E02000720",2125,411,131,280,1178,66,688,125,419,144,134,79,48,7,249,123,126,41,41,536,308,228
"2021","Newham 008","E02000721",2764,603,135,468,1543,44,926,125,599,202,155,87,55,13,352,203,149,66,66,618,381,237
"2021","Newham 009","E02000722",2935,850,197,653,1515,36,679,166,386,127,298,179,97,22,390,215,175,112,112,570,200,370
"2021","Newham 010","E02000723",2862,416,151,265,1584,78,999,146,595,258,97,35,45,17,328,158,170,82,82,862,538,324
"2021","Newham 011","E02000724",2535,384,139,245,1477,56,961,115,611,235,115,50,62,3,288,151,137,57,57,674,465,209
"2021","Newham 012","E02000725",3998,1142,265,877,2054,49,845,271,452,122,423,312,89,22,604,398,206,133,133,802,215,587
"2021","Newham 014","E02000727",2291,359,122,237,1308,62,845,112,573,160,104,42,54,8,236,117,119,61,61,624,387,237
"2021","Newham 015","E02000728",2343,349,104,245,1366,67,909,125,589,195,119,67,43,9,233,125,108,38,38,628,365,263
"2021","Newham 016","E02000729",2196,526,155,371,1135,60,588,111,363,114,158,100,56,2,268,128,140,61,61,535,279,256
"2021","Newham 017","E02000730",2565,456,153,303,1304,73,791,106,503,182,76,39,32,5,302,146,156,62,62,805,502,303
"2021","Newham 018","E02000731",2767,492,187,305,1595,75,1035,161,656,218,127,55,62,10,304,163,141,54,54,680,405,275
"2021","Newham 019","E02000732",2752,593,146,447,1698,49,988,142,670,176,180,120,47,13,416,235,181,65,65,461,250,211
"2021","Newham 020","E02000733",3467,879,212,667,1882,77,782,177,465,140,291,152,100,39,643,345,298,89,89,706,278,428
"2021","Newham 021","E02000734",2496,687,188,499,1303,41,623,144,352,127,200,130,58,12,387,232,155,52,52,506,251,255
"2021","Newham 022","E02000735",2663,623,229,394,1446,64,794,173,481,140,178,99,67,12,355,220,135,55,55,594,346,248
"2021","Newham 023","E02000736",2652,427,130,297,1711,47,972,107,679,186,166,79,67,20,463,281,182,63,63,514,309,205
"2021","Newham 024","E02000737",3066,597,198,399,1915,85,1104,170,737,197,185,82,80,23,491,253,238,50,50,554,376,178
"2021","Newham 025","E02000738",2783,508,158,350,1709,64,1054,157,712,185,235,110,109,16,300,180,120,56,56,566,344,222
"2021","Newham 026","E02000739",2478,611,159,452,1336,39,662,113,426,123,195,84,96,15,369,199,170,71,71,531,274,257
"2021","Newham 027","E02000740",2494,687,161,526,1388,32,564,124,327,113,205,124,57,24,501,249,252,86,86,419,183,236
"2021","Newham 028","E02000741",2687,587,152,435,1642,56,865,152,555,158,228,101,103,24,426,247,179,67,67,458,249,209
"2021","Newham 029","E02000742",2526,481,149,332,1518,48,795,94,559,142,189,73,79,37,441,275,166,45,45,527,338,189
"2021","Newham 030","E02000743",3576,923,224,699,2007,44,866,215,511,140,306,200,88,18,688,400,288,103,103,646,265,381
"2021","Newham 031","E02000744",3324,883,214,669,1894,57,803,204,465,134,301,163,117,21,661,424,237,72,72,547,250,297
"2021","Newham 032","E02000745",2878,646,179,467,1653,55,748,157,433,158,251,129,101,21,543,319,224,56,56,579,314,265
"2021","Newham 033","E02000746",3394,899,163,736,2021,64,933,239,547,147,398,266,111,21,544,322,222,82,82,474,219,255
"2021","Newham 034","E02000747",5446,1606,261,1345,2980,66,1338,528,652,158,688,536,128,24,692,346,346,196,196,860,208,652
"2021","Newham 035","E02000748",2206,501,144,357,1362,58,638,160,378,100,195,95,88,12,417,234,183,54,54,343,170,173
"2021","Newham 036","E02000749",3332,867,228,639,1899,49,757,172,425,160,278,120,130,28,745,456,289,70,70,566,280,286
"2021","Newham 038","E02006995",3235,610,12,598,1754,6,704,284,396,24,635,541,88,6,311,242,69,98,98,871,91,780
"2021","Newham 039","E02006996",3158,918,128,790,1625,31,648,233,350,65,504,427,66,11,326,206,120,116,116,615,129,486
"2021","Newham 040","E02006997",3228,1055,69,986,1617,18,572,249,282,41,588,525,61,2,316,194,122,123,123,556,73,483
"2021","Newham 041","E02006998",2667,726,151,575,1598,29,695,187,409,99,281,151,111,19,515,348,167,78,78,343,150,193
"2021","Newham 042","E02006999",5051,1465,55,1410,2937,21,1401,595,735,71,899,764,121,14,434,307,127,182,182,649,142,507
"2021","Redbridge 001","E02000751",4437,1187,689,498,2872,506,1676,448,895,333,323,199,105,19,340,182,158,27,27,378,164,214
"2021","Redbridge 002","E02000752",3266,904,317,587,2001,122,1042,226,620,196,305,130,132,43,498,263,235,34,34,361,219,142
"2021","Redbridge 003","E02000753",2475,599,240,359,1589,131,793,157,466,170,169,76,65,28,463,267,196,33,33,287,183,104
"2021","Redbridge 004","E02000754",2590,638,267,371,1685,163,891,226,484,181,295,158,120,17,311,157,154,25,25,267,124,143
"2021","Redbridge 005","E02000755",2185,650,247,403,1346,141,681,138,382,161,213,111,91,11,295,157,138,16,16,189,109,80
"2021","Redbridge 006","E02000756",5259,1338,583,755,3245,285,1902,397,1085,420,344,174,131,39,651,372,279,63,63,676,419,257
"2021","Redbridge 007","E02000757",5181,1556,542,1014,3179,309,1770,482,1011,277,568,345,200,23,481,282,199,51,51,446,173,273
"2021","Redbridge 008","E02000758",2315,548,245,303,1432,148,887,145,499,243,95,40,43,12,288,148,140,14,14,335,206,129
"2021","Redbridge 009","E02000759",4820,1122,416,706,3206,252,1815,401,1080,334,463,252,180,31,625,380,245,51,51,492,239,253
"2021","Redbridge 010","E02000760",2628,636,302,334,1683,165,967,164,581,222,120,55,54,11,411,217,194,20,20,309,188,121
"2021","Redbridge 012","E02000762",2104,434,278,156,1315,177,885,158,457,270,60,31,20,9,170,82,88,23,23,355,199,156
"2021","Redbridge 013","E02000763",2574,506,236,270,1700,132,1114,162,622,330,126,53,56,17,301,154,147,27,27,368,240,128
"2021","Redbridge 014","E02000764",5370,1849,853,996,3094,314,1632,520,860,252,663,495,146,22,422,233,189,63,63,427,158,269
"2021","Redbridge 015","E02000765",2429,491,189,302,1544,116,1011,169,578,264,69,32,28,9,318,195,123,30,30,394,247,147
"2021","Redbridge 017","E02000767",2769,588,297,291,1806,150,1232,189,785,258,119,68,39,12,281,129,152,24,24,375,235,140
"2021","Redbridge 018","E02000768",2200,537,280,257,1479,194,874,182,525,167,197,137,54,6,200,93,107,14,14,184,82,102
"2021","Redbridge 020","E02000770",2490,524,210,314,1505,113,993,138,584,271,82,31,48,3,283,156,127,34,34,461,302,159
"2021","Redbridge 022","E02000772",2538,526,144,382,1569,85,1027,153,672,202,107,45,53,9,308,189,119,42,42,443,282,161
"2021","Redbridge 023","E02000773",3112,488,155,333,2114,121,1401,193,898,310,103,46,47,10,446,257,189,43,43,510,307,203
"2021","Redbridge 024","E02000774",2459,487,173,314,1511,78,936,119,608,209,137,44,85,8,320,191,129,40,40,461,279,182
"2021","Redbridge 026","E02000776",2082,403,116,287,1330,74,901,142,571,188,91,43,34,14,231,136,95,33,33,349,218,131
"2021","Redbridge 027","E02000777",2324,631,287,344,1521,161,857,219,461,177,242,110,113,19,239,124,115,22,22,172,90,82
"2021","Redbridge 029","E02000779",2774,670,172,498,1659,74,1019,212,653,154,151,77,70,4,361,249,112,54,54,445,258,187
"2021","Redbridge 031","E02000781",4431,774,394,380,2687,217,1755,236,1079,440,129,43,63,23,518,286,232,68,68,970,640,330
"2021","Redbridge 032","E02000782",3577,727,148,579,2308,50,1384,207,954,223,218,113,88,17,580,420,160,76,76,542,322,220
"2021","Redbridge 033","E02000783",2116,416,162,254,1272,35,713,87,473,153,83,26,48,9,377,221,156,64,64,428,305,123
"2021","Redbridge 034","E02006800",4513,977,312,665,2651,117,1720,271,1089,360,218,92,92,34,532,324,208,64,64,885,527,358
"2021","Redbridge 035","E02006924",4096,801,330,471,2469,219,1599,261,931,407,158,89,52,17,431,201,230,62,62,826,467,359
"2021","Redbridge 036","E02006925",4187,616,345,271,2768,335,1866,251,991,624,107,43,44,20,423,217,206,37,37,803,487,316
"2021","Redbridge 037","E02007017",2758,528,266,262,1856,145,1160,165,761,234,115,33,66,16,399,242,157,37,37,374,242,132
"2021","Redbridge 038","E02007018",2530,657,166,491,1597,49,930,166,617,147,162,62,81,19,419,293,126,37,37,276,159,117
"2021","Redbridge 039","E02007019",2405,614,157,457,1460,28,1074,187,791,96,119,57,56,6,206,138,68,33,33,331,181,150
"2021","Redbridge 040","E02007020",2722,462,152,310,1629,98,1030,108,640,282,93,28,54,11,362,204,158,46,46,631,414,217
"2021","Richmond upon Thames 001","E02000784",4175,1239,587,652,2646,366,1541,415,880,246,319,198,94,27,387,217,170,33,33,290,90,200
"2021","Richmond upon Thames 002","E02000785",4163,1247,532,715,2654,349,1604,498,880,226,460,351,95,14,220,111,109,21,21,262,94,168
"2021","Richmond upon Thames 003","E02000786",4947,1589,634,955,3016,278,1673,482,1041,150,558,388,156,14,471,293,178,36,36,342,103,239
"2021","Richmond upon Thames 004","E02000787",5173,1574,559,1015,3273,227,1821,517,1077,227,628,463,144,21,543,338,205,54,54,326,126,200
"2021","Richmond upon Thames 005","E02000788",3626,1000,442,558,2399,269,1515,341,1003,171,325,199,110,16,269,159,110,21,21,227,93,134
"2021","Richmond upon Thames 006","E02000789",2842,1032,404,628,1639,168,957,314,537,106,317,242,68,7,174,111,63,23,23,171,59,112
"2021","Richmond upon Thames 007","E02000790",2704,738,236,502,1814,153,1089,292,683,114,349,234,103,12,200,120,80,23,23,152,49,103
"2021","Richmond upon Thames 008","E02000791",2968,1056,397,659,1766,184,1011,350,575,86,394,310,76,8,155,98,57,22,22,146,42,104
"2021","Richmond upon Thames 009","E02000792",3101,1041,398,643,1893,213,1093,316,653,124,368,279,80,9,201,127,74,18,18,167,49,118
"2021","Richmond upon Thames 010","E02000793",3135,813,409,404,2030,241,1133,281,617,235,279,150,110,19,338,170,168,39,39,292,108,184
"2021","Richmond upon Thames 011","E02000794",2760,671,305,366,1899,182,1185,295,703,187,315,209,91,15,192,120,72,25,25,190,61,129
"2021","Richmond upon Thames 012","E02000795",2588,627,366,261,1796,317,1146,223,755,168,146,72,57,17,182,104,78,5,5,165,76,89
"2021","Richmond upon Thames 013","E02000796",3981,922,454,468,2628,314,1490,300,825,365,274,101,142,31,523,290,233,27,27,431,228,203
"2021","Richmond upon Thames 014","E02000797",3478,1163,380,783,2115,135,1169,353,717,99,543,412,127,4,231,152,79,37,37,200,47,153
"2021","Richmond upon Thames 015","E02000798",4322,1014,454,560,3005,241,1733,393,1131,209,504,265,216,23,495,286,209,32,32,303,114,189
"2021","Richmond upon Thames 016","E02000799",2441,685,309,376,1589,220,917,232,551,134,258,173,69,16,178,104,74,16,16,167,55,112
"2021","Richmond upon Thames 017","E02000800",2159,639,302,337,1369,128,722,164,451,107,172,66,92,14,333,202,131,14,14,151,69,82
"2021","Richmond upon Thames 018","E02000801",3020,901,354,547,1998,222,1161,300,715,146,356,237,110,9,233,148,85,26,26,121,41,80
"2021","Richmond upon Thames 019","E02000802",2976,915,402,513,1903,240,1096,300,612,184,317,214,92,11,231,154,77,19,19,158,49,109
"2021","Richmond upon Thames 020","E02000803",4096,1310,582,728,2515,327,1304,341,700,263,374,183,153,38,490,303,187,20,20,271,118,153
"2021","Richmond upon Thames 021","E02000804",3171,1068,431,637,1927,213,1091,355,596,140,378,261,107,10,228,138,90,17,17,176,49,127
"2021","Richmond upon Thames 022","E02000805",4634,1462,556,906,2937,362,1625,469,937,219,497,331,155,11,431,271,160,22,22,235,71,164
"2021","Richmond upon Thames 023","E02000806",4254,1168,549,619,2858,395,1656,470,900,286,407,259,126,22,373,207,166,27,27,228,96,132
"2021","Southwark 001","E02000807",3732,1164,197,967,1952,96,892,378,418,96,575,456,100,19,308,179,129,81,81,616,82,534
"2021","Southwark 002","E02000808",4693,2000,320,1680,2037,82,716,399,238,79,683,605,62,16,398,218,180,158,158,656,67,589
"2021","Southwark 004","E02000810",5395,1903,361,1542,2741,70,910,369,436,105,734,576,126,32,850,552,298,177,177,751,152,599
"2021","Southwark 006","E02000812",4535,1642,302,1340,2059,46,675,263,310,102,533,398,107,28,665,424,241,140,140,834,169,665
"2021","Southwark 007","E02000813",4485,1481,308,1173,2279,63,756,312,324,120,599,445,131,23,726,460,266,135,135,725,116,609
"2021","Southwark 008","E02000814",4588,1456,210,1246,2372,69,1023,436,476,111,752,616,116,20,403,250,153,125,125,760,118,642
"2021","Southwark 009","E02000815",3232,1089,135,954,1364,32,462,175,242,45,391,340,47,4,364,209,155,115,115,779,70,709
"2021","Southwark 010","E02000816",4147,1405,272,1133,2165,83,766,273,354,139,525,361,142,22,685,415,270,106,106,577,135,442
"2021","Southwark 011","E02000817",2921,1099,342,757,1361,75,449,117,243,89,261,175,62,24,504,343,161,72,72,461,111,350
"2021","Southwark 012","E02000818",4492,1619,351,1268,2104,58,665,263,297,105,580,488,74,18,656,401,255,145,145,769,107,662
"2021","Southwark 013","E02000819",3556,1290,280,1010,1715,33,588,174,304,110,352,210,118,24,653,414,239,89,89,551,145,406
"2021","Southwark 014","E02000820",4228,1720,367,1353,1816,53,572,222,274,76,474,359,101,14,620,406,214,97,97,692,102,590
"2021","Southwark 015","E02000821",3133,804,205,599,1730,49,513,116,281,116,357,220,115,22,720,469,251,91,91,599,255,344
"2021","Southwark 016","E02000822",2768,890,208,682,1420,33,424,118,230,76,276,170,81,25,602,387,215,85,85,458,121,337
"2021","Southwark 017","E02000823",3637,1193,333,860,1742,50,512,169,252,91,373,266,80,27,712,373,339,95,95,702,157,545
"2021","Southwark 018","E02000824",3792,1127,293,834,2064,58,602,151,320,131,316,149,135,32,991,597,394,97,97,601,194,407
"2021","Southwark 019","E02000825",3890,1179,220,959,2131,60,646,153,352,141,377,227,113,37,948,577,371,100,100,580,222,358
"2021","Southwark 020","E02000826",4023,1352,360,992,2040,51,630,217,319,94,570,421,119,30,703,424,279,86,86,631,157,474
"2021","Southwark 021","E02000827",5018,1818,406,1412,2476,64,778,302,370,106,552,397,132,23,950,605,345,132,132,724,192,532
"2021","Southwark 022","E02000828",3595,1184,220,964,1815,43,589,158,291,140,395,256,131,8,707,426,281,81,81,596,146,450
"2021","Southwark 023","E02000829",4735,1681,398,1283,2373,64,756,242,389,125,651,488,140,23,821,511,310,81,81,681,159,522
"2021","Southwark 024","E02000830",3761,1142,264,878,1955,100,718,234,395,89,627,504,110,13,445,258,187,65,65,664,108,556
"2021","Southwark 025","E02000831",4051,1226,293,933,2192,80,865,260,486,119,652,513,123,16,506,307,199,89,89,633,98,535
"2021","Southwark 026","E02000832",4100,1366,429,937,2201,73,773,215,410,148,539,387,135,17,748,384,364,68,68,533,136,397
"2021","Southwark 027","E02000833",3046,940,222,718,1705,46,645,172,394,79,344,217,114,13,612,352,260,58,58,401,117,284
"2021","Southwark 028","E02000834",4102,1277,293,984,2313,107,986,282,596,108,809,646,148,15,348,194,154,63,63,512,88,424
"2021","Southwark 029","E02000835",3030,781,241,540,1858,61,861,203,549,109,424,273,128,23,473,300,173,39,39,391,124,267
"2021","Southwark 030","E02000836",3337,855,264,591,2135,122,1093,293,689,111,560,408,137,15,310,173,137,50,50,347,100,247
"2021","Southwark 031","E02000837",3153,618,318,300,2247,265,1365,321,854,190,314,172,121,21,283,171,112,20,20,288,82,206
"2021","Southwark 032","E02000838",3921,1110,277,833,2372,122,1105,291,675,139,586,418,155,13,508,270,238,51,51,439,124,315
"2021","Southwark 033","E02000839",3428,979,353,626,2130,193,902,243,528,131,420,267,138,15,569,389,180,46,46,319,122,197
"2021","Southwark 034","E02006802",3937,1437,216,1221,1920,44,622,283,238,101,543,444,85,14,581,370,211,130,130,580,97,483
"2021","Southwark 035","E02006941",2986,1282,93,1189,1334,44,522,366,137,19,605,568,36,1,94,50,44,69,69,370,10,360
"2021","Southwark 036","E02006942",3364,1242,160,1082,1569,31,496,238,208,50,555,486,58,11,384,250,134,103,103,553,51,502
"2021","Sutton 001","E02000840",3476,874,308,566,2302,97,1097,265,628,204,395,167,181,47,678,423,255,35,35,300,171,129
"2021","Sutton 002","E02000841",3300,746,282,464,2228,123,1099,249,615,235,321,112,160,49,642,359,283,43,43,326,196,130
"2021","Sutton 003","E02000842",2954,594,333,261,2084,274,1239,266,647,326,246,100,121,25,297,144,153,28,28,276,137,139
"2021","Sutton 004","E02000843",3980,1201,318,883,2581,131,1373,417,785,171,571,328,224,19,476,322,154,30,30,198,83,115
"2021","Sutton 005","E02000844",3217,771,347,424,2180,160,1130,281,608,241,347,154,161,32,515,311,204,28,28,266,144,122
"2021","Sutton 006","E02000845",3606,826,370,456,2541,192,1467,379,856,232,427,221,170,36,432,238,194,23,23,239,111,128
"2021","Sutton 007","E02000846",2783,612,339,273,1928,225,1154,242,658,254,255,115,108,32,274,140,134,20,20,243,137,106
"2021","Sutton 008","E02000847",3686,952,535,417,2477,362,1439,327,794,318,335,184,122,29,312,162,150,29,29,257,130,127
"2021","Sutton 009","E02000848",2917,607,335,272,2075,241,1258,239,758,261,268,115,123,30,292,142,150,16,16,235,124,111
"2021","Sutton 010","E02000849",3251,874,360,514,2170,206,1143,273,654,216,352,177,146,29,436,252,184,33,33,207,103,104
"2021","Sutton 011","E02000850",4090,939,431,508,2837,320,1619,368,866,385,381,180,171,30,489,261,228,28,28,314,170,144
"2021","Sutton 012","E02000851",5039,1705,531,1174,2947,171,1417,415,867,135,636,415,196,25,658,480,178,65,65,387,162,225
"2021","Sutton 013","E02000852",3250,895,358,537,2112,185,1211,298,687,226,351,198,131,22,340,215,125,25,25,243,119,124
"2021","Sutton 014","E02000853",3199,825,367,458,2129,168,1193,269,730,194,324,174,131,19,419,255,164,25,25,245,123,122
"2021","Sutton 015","E02000854",3084,815,370,445,2106,226,1171,314,662,195,371,215,139,17,318,195,123,20,20,163,74,89
"2021","Sutton 016","E02000855",3213,842,482,360,2150,347,1288,329,683,276,223,110,100,13,263,135,128,29,29,221,98,123
"2021","Sutton 017","E02000856",3801,1131,416,715,2413,283,1355,339,769,247,358,209,133,16,390,250,140,27,27,257,126,131
"2021","Sutton 018","E02000857",4082,1547,570,977,2294,164,1178,343,725,110,515,352,144,19,394,264,130,43,43,241,98,143
"2021","Sutton 019","E02000858",3308,957,315,642,2090,127,922,200,535,187,294,130,131,33,723,490,233,24,24,261,149,112
"2021","Sutton 020","E02000859",3491,1118,629,489,2159,307,1189,298,656,235,266,128,116,22,371,230,141,26,26,214,97,117
"2021","Sutton 021","E02000860",4120,1718,593,1125,2167,124,1075,334,647,94,506,321,170,15,429,288,141,33,33,235,89,146
"2021","Sutton 022","E02000861",2861,501,303,198,2185,441,1365,334,721,310,161,80,68,13,202,103,99,16,16,175,75,100
"2021","Sutton 024","E02000863",2420,465,259,206,1736,285,1034,242,539,253,185,82,71,32,220,120,100,12,12,219,115,104
"2021","Sutton 025","E02006836",3210,684,351,333,2273,452,1363,317,771,275,225,123,84,18,222,120,102,11,11,253,129,124
"2021","Tower Hamlets 001","E02000864",4663,1526,341,1185,2473,62,972,304,559,109,743,559,162,22,611,348,263,85,85,664,143,521
"2021","Tower Hamlets 002","E02000865",2892,986,216,770,1349,29,555,108,359,88,320,225,79,16,363,205,158,82,82,557,172,385
"2021","Tower Hamlets 003","E02000866",4153,1210,326,884,2100,87,943,295,535,113,578,430,118,30,399,231,168,93,93,843,183,660
"2021","Tower Hamlets 004","E02000867",4869,1509,229,1280,2492,54,922,312,486,124,873,756,106,11,522,338,184,121,121,868,113,755
"2021","Tower Hamlets 005","E02000868",2783,835,153,682,1368,41,576,160,349,67,455,387,68,0,231,126,105,65,65,580,97,483
"2021","Tower Hamlets 006","E02000869",2532,952,229,723,1141,40,511,129,329,53,298,237,52,9,254,149,105,38,38,439,86,353
"2021","Tower Hamlets 007","E02000870",2420,716,179,537,1265,42,569,122,364,83,288,213,62,13,309,168,141,57,57,439,84,355
"2021","Tower Hamlets 008","E02000871",4228,1247,160,1087,2273,34,1066,243,712,111,456,348,98,10,616,385,231,101,101,708,244,464
"2021","Tower Hamlets 009","E02000872",3192,994,105,889,1488,14,652,171,422,59,398,345,48,5,336,217,119,88,88,710,109,601
"2021","Tower Hamlets 010","E02000873",2923,779,140,639,1621,32,802,161,527,114,346,259,81,6,383,235,148,58,58,523,141,382
"2021","Tower Hamlets 011","E02000874",2524,685,125,560,1383,28,671,135,472,64,264,196,59,9,365,201,164,55,55,456,126,330
"2021","Tower Hamlets 012","E02000875",5079,1508,181,1327,2809,49,1345,292,906,147,598,467,120,11,680,442,238,137,137,762,223,539
"2021","Tower Hamlets 013","E02000876",2776,967,108,859,1245,19,556,156,338,62,335,286,47,2,242,156,86,93,93,564,127,437
"2021","Tower Hamlets 014","E02000877",4914,1258,189,1069,2657,44,1313,274,919,120,592,468,112,12,596,370,226,112,112,999,259,740
"2021","Tower Hamlets 015","E02000878",4014,1439,156,1283,1673,30,788,261,421,106,449,390,48,11,293,145,148,113,113,902,176,726
"2021","Tower Hamlets 016","E02000879",3047,969,318,651,1539,47,788,145,527,116,276,213,50,13,368,174,194,60,60,539,162,377
"2021","Tower Hamlets 017","E02000880",2281,675,137,538,1087,21,554,113,385,56,197,155,33,9,244,148,96,71,71,519,135,384
"2021","Tower Hamlets 018","E02000881",3852,1022,172,850,2192,36,988,214,681,93,419,313,94,12,619,429,190,130,130,638,188,450
"2021","Tower Hamlets 019","E02000882",3807,1033,180,853,2102,43,996,174,675,147,411,298,105,8,570,359,211,82,82,672,302,370
"2021","Tower Hamlets 020","E02000883",3032,804,205,599,1659,49,885,189,581,115,235,139,66,30,438,281,157,52,52,569,221,348
"2021","Tower Hamlets 021","E02000884",5113,1801,129,1672,2212,14,969,304,584,81,629,572,54,3,366,254,112,234,234,1100,200,900
"2021","Tower Hamlets 022","E02000885",2391,757,219,538,1204,33,621,121,409,91,187,137,42,8,304,170,134,59,59,430,158,272
"2021","Tower Hamlets 023","E02000886",3823,1217,164,1053,1895,46,919,323,512,84,515,437,74,4,340,217,123,75,75,711,145,566
"2021","Tower Hamlets 024","E02000887",3945,1144,197,947,2189,44,1111,246,737,128,347,269,68,10,584,388,196,103,103,612,172,440
"2021","Tower Hamlets 025","E02000888",3355,1074,131,943,1732,38,878,251,555,72,443,380,60,3,297,183,114,76,76,549,146,403
"2021","Tower Hamlets 026","E02000889",3805,1365,162,1203,1882,45,914,350,493,71,601,540,58,3,242,155,87,80,80,558,87,471
"2021","Tower Hamlets 027","E02000890",2892,1113,184,929,1459,74,668,370,256,42,526,450,62,14,131,64,67,60,60,320,56,264
"2021","Tower Hamlets 030","E02000893",2987,874,244,630,1679,50,849,263,499,87,328,231,82,15,392,206,186,60,60,434,100,334
"2021","Tower Hamlets 031","E02000894",4463,1274,163,1111,2514,65,1322,483,734,105,638,503,123,12,405,255,150,84,84,675,159,516
"2021","Tower Hamlets 032","E02006853",5041,1989,138,1851,2434,41,1187,526,587,74,593,507,68,18,466,341,125,147,147,618,137,481
"2021","Tower Hamlets 033","E02006854",3530,1454,60,1394,1689,29,866,464,345,57,507,455,46,6,188,135,53,99,99,387,57,330
"2021","Tower Hamlets 034","E02007112",2918,1175,9,1166,1341,7,574,346,215,13,561,526,35,0,113,84,29,86,86,402,62,340
"2021","Tower Hamlets 035","E02007113",3268,1112,39,1073,1675,24,831,376,413,42,419,351,61,7,310,207,103,91,91,481,90,391
"2021","Tower Hamlets 036","E02007114",3033,1066,96,970,1503,30,720,292,373,55,375,314,53,8,283,197,86,95,95,464,89,375
"2021","Waltham Forest 001","E02000895",3279,964,590,374,2039,312,990,208,521,261,269,111,116,42,441,216,225,27,27,276,152,124
"2021","Waltham Forest 002","E02000896",3839,1195,529,666,2374,315,1251,337,635,279,381,203,147,31,400,208,192,27,27,270,126,144
"2021","Waltham Forest 003","E02000897",3370,982,440,542,2114,195,993,238,528,227,325,141,151,33,566,295,271,35,35,274,142,132
"2021","Waltham Forest 004","E02000898",3199,945,467,478,1963,233,953,233,481,239,282,130,119,33,469,241,228,26,26,291,160,131
"2021","Waltham Forest 005","E02000899",3226,817,422,395,2062,235,1127,260,577,290,262,113,117,32,403,218,185,35,35,347,191,156
"2021","Waltham Forest 006","E02000900",3119,731,315,416,1958,169,956,193,540,223,226,84,112,30,564,308,256,43,43,430,250,180
"2021","Waltham Forest 007","E02000901",3853,804,300,504,2722,271,1478,369,783,326,463,225,204,34,469,258,211,41,41,327,164,163
"2021","Waltham Forest 008","E02000902",3521,797,234,563,2313,140,1169,240,686,243,367,173,163,31,598,385,213,39,39,411,230,181
"2021","Waltham Forest 009","E02000903",3466,709,255,454,2228,75,1032,215,615,202,410,198,176,36,651,363,288,60,60,529,276,253
"2021","Waltham Forest 010","E02000904",3105,796,201,595,1899,111,946,208,579,159,365,217,131,17,434,258,176,43,43,410,189,221
"2021","Waltham Forest 011","E02000905",3628,748,260,488,2292,87,1211,281,761,169,462,253,196,13,480,292,188,52,52,588,284,304
"2021","Waltham Forest 012","E02000906",3626,838,215,623,2305,61,967,272,572,123,617,418,183,16,593,342,251,67,67,483,193,290
"2021","Waltham Forest 013","E02000907",4066,1285,333,952,2369,67,986,229,625,132,498,302,178,18,760,520,240,58,58,412,203,209
"2021","Waltham Forest 014","E02000908",5240,1570,310,1260,3041,68,1243,416,685,142,932,714,202,16,686,480,206,112,112,629,212,417
"2021","Waltham Forest 015","E02000909",3568,929,253,676,2239,98,1117,317,644,156,565,347,202,16,419,262,157,40,40,400,171,229
"2021","Waltham Forest 016","E02000910",4407,1159,273,886,2588,97,1176,332,661,183,727,515,199,13,508,316,192,80,80,660,218,442
"2021","Waltham Forest 017","E02000911",4848,1243,244,999,2804,73,1216,366,674,176,776,589,172,15,618,388,230,121,121,801,336,465
"2021","Waltham Forest 018","E02000912",3267,716,209,507,1981,107,931,210,548,173,420,263,143,14,475,235,240,48,48,570,292,278
"2021","Waltham Forest 019","E02000913",3116,715,231,484,1865,126,983,210,546,227,336,172,147,17,355,184,171,65,65,536,288,248
"2021","Waltham Forest 020","E02000914",3972,1037,241,796,2281,77,1049,255,600,194,356,209,131,16,719,427,292,80,80,654,348,306
"2021","Waltham Forest 021","E02000915",3284,1008,248,760,1846,96,815,231,436,148,511,338,160,13,355,203,152,69,69,430,150,280
"2021","Waltham Forest 022","E02000916",3981,1077,195,882,2270,70,1008,249,567,192,544,358,171,15,567,351,216,81,81,634,264,370
"2021","Waltham Forest 023","E02000917",3651,887,213,674,2187,64,1029,303,592,134,597,425,159,13,423,240,183,74,74,577,232,345
"2021","Waltham Forest 024","E02000918",3408,917,244,673,1946,78,898,262,498,138,417,277,121,19,470,309,161,83,83,545,230,315
"2021","Waltham Forest 025","E02000919",3358,800,190,610,1895,90,897,279,474,144,437,293,134,10,390,188,202,81,81,663,243,420
"2021","Waltham Forest 026","E02000920",3815,1102,298,804,2048,61,890,215,494,181,403,274,111,18,614,361,253,80,80,665,235,430
"2021","Waltham Forest 027","E02000921",4057,1068,289,779,2307,88,895,212,498,185,486,285,144,57,745,398,347,93,93,682,282,400
"2021","Waltham Forest 028","E02000922",3634,858,256,602,2080,84,961,234,576,151,442,268,150,24,531,291,240,62,62,696,326,370
"2021","Wandsworth 001","E02000923",3468,1254,455,799,1637,157,698,270,344,84,429,367,54,8,283,182,101,70,70,577,75,502
"2021","Wandsworth 003","E02000925",3363,1062,272,790,1788,66,684,194,393,97,341,254,68,19,624,378,246,73,73,513,82,431
"2021","Wandsworth 004","E02000926",5554,2013,367,1646,2711,110,1093,463,512,118,866,750,107,9,513,297,216,129,129,830,73,757
"2021","Wandsworth 005","E02000927",3233,1008,310,698,1657,87,638,233,316,89,449,375,62,12,411,219,192,72,72,568,63,505
"2021","Wandsworth 006","E02000928",3615,1078,383,695,2073,203,1113,321,657,135,465,401,57,7,260,133,127,32,32,464,67,397
"2021","Wandsworth 007","E02000929",3496,1176,334,842,1859,36,613,214,308,91,355,280,61,14,765,461,304,90,90,461,104,357
"2021","Wandsworth 008","E02000930",4261,1211,272,939,2032,67,859,318,470,71,661,589,65,7,314,195,119,131,131,1018,62,956
"2021","Wandsworth 009","E02000931",3484,802,186,616,1983,84,1108,292,732,84,518,424,86,8,196,110,86,77,77,699,81,618
"2021","Wandsworth 010","E02000932",5931,1800,330,1470,3235,173,1414,524,750,140,1126,983,136,7,375,224,151,147,147,896,71,825
"2021","Wandsworth 011","E02000933",3930,1260,447,813,2225,210,1171,386,609,176,525,449,72,4,256,131,125,63,63,445,80,365
"2021","Wandsworth 012","E02000934",4195,1409,251,1158,2071,92,809,340,390,79,775,703,61,11,294,134,160,101,101,715,60,655
"2021","Wandsworth 013","E02000935",2436,794,289,505,1370,66,553,117,348,88,140,52,72,16,586,416,170,25,25,272,90,182
"2021","Wandsworth 014","E02000936",4383,1565,458,1107,2186,120,1012,383,512,117,655,573,72,10,301,178,123,98,98,632,69,563
"2021","Wandsworth 015","E02000937",3127,712,194,518,1962,80,1151,265,764,122,460,339,110,11,228,133,95,43,43,453,82,371
"2021","Wandsworth 016","E02000938",4347,1344,497,847,2485,199,1193,323,718,152,419,276,127,16,618,345,273,56,56,518,156,362
"2021","Wandsworth 017","E02000939",2836,619,245,374,1831,138,1171,248,778,145,282,202,74,6,207,134,73,33,33,386,92,294
"2021","Wandsworth 018","E02000940",4213,1367,244,1123,2274,70,858,310,430,118,748,641,96,11,500,311,189,98,98,572,97,475
"2021","Wandsworth 019","E02000941",4137,1085,277,808,2438,140,1312,354,823,135,618,515,92,11,304,164,140,64,64,614,136,478
"2021","Wandsworth 020","E02000942",3819,899,336,563,2381,203,1432,391,845,196,440,343,88,9,243,137,106,63,63,539,113,426
"2021","Wandsworth 021","E02000943",3809,1137,246,891,1938,91,927,290,526,111,605,529,71,5,254,133,121,61,61,734,65,669
"2021","Wandsworth 022","E02000944",2888,820,258,562,1706,64,753,213,446,94,331,216,97,18,496,317,179,62,62,362,93,269
"2021","Wandsworth 023","E02000945",2761,768,313,455,1504,65,688,171,413,104,188,118,58,12,513,322,191,50,50,489,134,355
"2021","Wandsworth 024","E02000946",3109,803,226,577,1786,62,817,200,498,119,520,423,87,10,329,179,150,58,58,520,72,448
"2021","Wandsworth 025","E02000947",3920,1001,303,698,2478,120,1354,414,834,106,696,549,135,12,254,149,105,54,54,441,74,367
"2021","Wandsworth 026","E02000948",4382,1324,300,1024,2152,79,961,333,534,94,733,658,70,5,290,168,122,89,89,906,98,808
"2021","Wandsworth 027","E02000949",4254,1251,321,930,2347,160,1248,412,668,168,665,528,124,13,217,109,108,57,57,656,66,590
"2021","Wandsworth 028","E02000950",3107,912,303,609,1794,130,900,263,508,129,356,244,96,16,345,184,161,63,63,401,83,318
"2021","Wandsworth 029","E02000951",2825,907,229,678,1395,55,606,199,312,95,435,377,53,5,242,138,104,57,57,523,66,457
"2021","Wandsworth 030","E02000952",2657,882,204,678,1304,69,593,178,322,93,375,324,42,9,221,127,94,46,46,471,75,396
"2021","Wandsworth 031","E02000953",3211,1112,166,946,1689,64,861,255,540,66,488,419,62,7,233,144,89,43,43,410,67,343
"2021","Wandsworth 032","E02000954",2245,474,178,296,1232,76,611,147,345,119,266,204,55,7,232,107,125,47,47,539,95,444
"2021","Wandsworth 033","E02000955",2677,635,220,415,1461,76,625,171,338,116,292,223,61,8,419,257,162,49,49,581,98,483
"2021","Wandsworth 034","E02000956",3032,842,207,635,1450,49,546,178,285,83,386,314,60,12,409,231,178,60,60,740,86,654
"2021","Wandsworth 035","E02000957",4422,1237,331,906,2317,97,993,264,561,168,609,489,103,17,468,291,177,150,150,868,127,741
"2021","Wandsworth 036","E02000958",2916,711,315,396,1790,137,950,199,543,208,293,163,104,26,374,191,183,36,36,415,134,281
"2021","Wandsworth 037","E02000959",3102,897,249,648,1716,50,773,211,435,127,373,260,100,13,450,290,160,70,70,489,163,326
"2021","Wandsworth 038","E02007083",4105,1681,83,1598,2006,33,798,411,348,39,723,668,54,1,306,228,78,146,146,418,38,380
"2021","Wandsworth 039","E02007084",4135,1284,283,1001,2072,54,689,243,314,132,506,402,84,20,713,436,277,110,110,779,147,632
"2021","Westminster 001","E02000960",2781,1043,325,718,1427,163,791,256,420,115,202,156,37,9,207,99,108,64,64,311,72,239
"2021","Westminster 002","E02000961",4068,1277,415,862,2264,120,1150,340,683,127,372,294,66,12,530,273,257,92,92,527,145,382
"2021","Westminster 003","E02000962",3856,1794,545,1249,1693,154,888,343,434,111,265,222,33,10,295,142,153,91,91,369,65,304
"2021","Westminster 004","E02000963",4133,1285,347,938,2359,85,917,231,499,187,367,256,81,30,890,431,459,100,100,489,201,288
"2021","Westminster 005","E02000964",5358,2046,508,1538,2627,74,979,280,511,188,516,374,89,53,925,528,397,133,133,685,149,536
"2021","Westminster 006","E02000965",3621,1277,277,1000,1796,53,907,336,459,112,430,360,60,10,328,190,138,78,78,548,56,492
"2021","Westminster 007","E02000966",4109,1555,406,1149,2151,142,1226,481,645,100,438,370,54,14,271,129,142,74,74,403,67,336
"2021","Westminster 008","E02000967",3015,1299,258,1041,1306,137,659,286,300,73,257,212,40,5,148,81,67,105,105,410,46,364
"2021","Westminster 009","E02000968",5617,2026,664,1362,2747,145,1045,233,557,255,322,183,112,27,1113,568,545,122,122,844,345,499
"2021","Westminster 010","E02000969",3718,1275,306,969,2015,63,818,157,485,176,269,171,77,21,795,447,348,70,70,428,120,308
"2021","Westminster 011","E02000970",3553,1679,368,1311,1545,122,751,322,317,112,358,312,44,2,168,89,79,146,146,329,52,277
"2021","Westminster 012","E02000971",3722,1723,310,1413,1500,113,733,350,289,94,367,328,38,1,150,79,71,137,137,499,88,411
"2021","Westminster 013","E02000972",4253,2258,365,1893,1510,69,548,284,198,66,413,364,40,9,272,125,147,208,208,485,84,401
"2021","Westminster 014","E02000973",4796,2252,448,1804,2056,107,1006,424,457,125,512,448,52,12,331,177,154,100,100,488,128,360
"2021","Westminster 015","E02000974",3983,1774,390,1384,1732,122,819,333,397,89,332,304,20,8,321,177,144,138,138,477,91,386
"2021","Westminster 016","E02000975",3801,1725,261,1464,1588,123,716,364,282,70,432,390,41,1,187,111,76,130,130,488,72,416
"2021","Westminster 017","E02000976",4207,1927,382,1545,1708,92,786,332,375,79,403,364,33,6,301,146,155,126,126,572,77,495
"2021","Westminster 018","E02000977",3435,1940,359,1581,1162,102,448,242,149,57,328,277,45,6,197,78,119,87,87,333,44,289
"2021","Westminster 019","E02000978",2764,1064,305,759,1360,189,721,323,291,107,161,120,34,7,210,92,118,79,79,340,127,213
"2021","Westminster 020","E02000979",3923,1817,399,1418,1697,141,814,374,346,94,325,285,36,4,327,174,153,90,90,409,56,353
"2021","Westminster 021","E02000980",4325,1927,537,1390,1956,125,814,314,367,133,407,309,84,14,496,248,248,114,114,442,75,367
"2021","Westminster 022","E02000981",4159,1908,377,1531,1753,100,756,393,286,77,492,430,57,5,312,136,176,93,93,498,56,442
"2021","Westminster 023","E02000982",3844,1874,437,1437,1637,123,684,241,336,107,240,189,38,13,485,269,216,105,105,333,88,245
"2021","Westminster 024","E02000983",3756,1696,507,1189,1658,110,692,238,336,118,348,285,49,14,435,224,211,73,73,402,79,323
"2021","Medway 001","E02003314",2866,834,458,376,1833,329,882,371,319,192,355,177,153,25,252,120,132,15,15,199,121,78
"2021","Medway 002","E02003315",2225,455,238,217,1650,289,891,298,383,210,262,109,119,34,195,112,83,13,13,120,69,51
"2021","Medway 003","E02003316",4664,1005,518,487,3346,439,1677,512,830,335,697,327,318,52,519,338,181,14,14,313,167,146
"2021","Medway 004","E02003317",2756,659,343,316,1921,274,965,266,491,208,374,172,178,24,294,190,104,14,14,176,83,93
"2021","Medway 005","E02003318",2282,464,301,163,1658,317,930,292,404,234,224,102,97,25,177,81,96,10,10,160,80,80
"2021","Medway 006","E02003319",3303,957,304,653,2093,154,946,294,467,185,459,216,213,30,509,346,163,25,25,253,140,113
"2021","Medway 007","E02003320",3793,1232,311,921,2294,190,1067,362,560,145,510,279,203,28,490,348,142,37,37,267,103,164
"2021","Medway 008","E02003321",2492,634,315,319,1672,218,735,200,363,172,310,106,170,34,390,237,153,19,19,186,97,89
"2021","Medway 009","E02003322",3139,1113,243,870,1685,104,666,218,326,122,428,235,173,20,429,287,142,58,58,341,106,235
"2021","Medway 010","E02003323",2821,695,259,436,1893,133,876,270,438,168,396,166,196,34,474,314,160,14,14,233,120,113
"2021","Medway 011","E02003324",3861,954,319,635,2641,207,1216,355,630,231,643,300,298,45,549,364,185,26,26,266,149,117
"2021","Medway 012","E02003325",3008,1044,296,748,1674,76,668,181,362,125,366,143,190,33,532,387,145,32,32,290,132,158
"2021","Medway 013","E02003326",2962,743,289,454,1949,165,912,255,453,204,388,159,184,45,452,263,189,32,32,270,122,148
"2021","Medway 014","E02003327",3662,1504,507,997,1955,199,791,333,357,101,515,345,147,23,423,303,120,27,27,203,61,142
"2021","Medway 015","E02003328",4333,1704,401,1303,2248,103,920,313,507,100,567,321,218,28,604,445,159,54,54,381,140,241
"2021","Medway 016","E02003329",2639,735,230,505,1622,97,775,222,422,131,336,139,173,24,392,257,135,22,22,282,121,161
"2021","Medway 017","E02003330",2731,702,263,439,1815,168,792,258,380,154,409,214,166,29,419,274,145,27,27,214,94,120
"2021","Medway 018","E02003331",3668,1090,586,504,2325,298,1027,329,471,227,439,173,214,52,543,299,244,18,18,253,124,129
"2021","Medway 019","E02003332",2316,488,237,251,1630,229,829,255,353,221,255,107,118,30,300,176,124,17,17,198,92,106
"2021","Medway 020","E02003333",2788,951,243,708,1568,69,616,199,314,103,381,170,186,25,471,359,112,31,31,269,128,141
"2021","Medway 021","E02003334",2312,605,209,396,1493,127,733,170,423,140,265,120,124,21,347,216,131,21,21,214,116,98
"2021","Medway 022","E02003335",2699,661,205,456,1817,69,756,193,440,123,385,133,220,32,584,410,174,23,23,221,128,93
"2021","Medway 023","E02003336",2635,663,435,228,1839,364,918,308,411,199,305,136,137,32,239,121,118,13,13,133,56,77
"2021","Medway 024","E02003337",2676,678,337,341,1848,228,908,268,481,159,348,173,149,26,347,186,161,17,17,150,69,81
"2021","Medway 025","E02003338",3176,1028,511,517,1984,256,842,290,375,177,454,213,209,32,413,241,172,19,19,164,88,76
"2021","Medway 026","E02003339",2433,588,324,264,1683,242,913,272,407,234,273,106,136,31,249,125,124,6,6,162,83,79
"2021","Medway 027","E02003340",3218,946,444,502,2083,225,1026,327,479,220,396,170,196,30,418,255,163,18,18,189,121,68
"2021","Medway 028","E02003341",2659,628,329,299,1889,298,985,344,453,188,355,163,164,28,246,131,115,5,5,142,78,64
"2021","Medway 029","E02003342",2572,641,414,227,1799,345,898,263,442,193,305,128,147,30,244,121,123,7,7,132,64,68
"2021","Medway 030","E02003343",2374,506,374,132,1738,448,986,300,417,269,187,91,81,15,113,44,69,4,4,130,63,67
"2021","Medway 031","E02003344",2695,721,332,389,1794,203,849,260,399,190,350,153,164,33,382,218,164,10,10,180,105,75
"2021","Medway 032","E02003345",2456,544,256,288,1797,230,963,290,472,201,358,177,158,23,239,163,76,7,7,115,59,56
"2021","Medway 033","E02003346",2873,801,426,375,1903,326,978,296,466,216,309,141,145,23,276,152,124,14,14,169,97,72
"2021","Medway 034","E02003347",2438,601,186,415,1711,147,885,296,431,158,431,214,195,22,241,162,79,7,7,126,56,70
"2021","Medway 035","E02003348",3190,679,448,231,2358,559,1321,445,601,275,282,129,126,27,188,78,110,8,8,153,67,86
"2021","Medway 036","E02003349",3070,832,491,341,2098,393,963,307,460,196,404,185,184,35,330,171,159,8,8,140,69,71
"2021","Medway 037","E02003350",2517,595,343,252,1772,280,885,255,435,195,306,123,158,25,290,161,129,11,11,150,73,77
"2021","Medway 038","E02003351",3166,781,409,372,2227,318,1066,318,502,246,468,185,253,30,365,200,165,10,10,158,79,79
"2021","Bracknell Forest 001","E02003352",2506,715,415,300,1672,368,961,347,446,168,179,119,51,9,156,75,81,8,8,119,49,70
"2021","Bracknell Forest 002","E02003353",4936,1187,430,757,3505,356,1970,672,1057,241,782,508,250,24,383,251,132,14,14,244,102,142
"2021","Bracknell Forest 003","E02003354",4129,985,371,614,2931,319,1729,534,893,302,532,326,174,32,325,198,127,26,26,213,80,133
"2021","Bracknell Forest 004","E02003355",2879,852,267,585,1840,136,853,262,442,149,432,223,181,28,391,250,141,28,28,187,85,102
"2021","Bracknell Forest 005","E02003356",2850,707,347,360,1972,290,1142,369,577,196,302,171,110,21,229,134,95,9,9,171,65,106
"2021","Bracknell Forest 006","E02003357",4328,1389,465,924,2608,212,1278,401,700,177,586,316,234,36,497,338,159,35,35,331,126,205
"2021","Bracknell Forest 007","E02003358",5041,1620,417,1203,3064,233,1519,485,798,236,702,417,258,27,568,393,175,42,42,357,132,225
"2021","Bracknell Forest 008","E02003359",2797,847,224,623,1803,109,914,357,420,137,495,326,152,17,269,156,113,16,16,147,50,97
"2021","Bracknell Forest 009","E02003360",4339,878,359,519,3145,307,1678,482,907,289,588,260,295,33,551,361,190,21,21,316,136,180
"2021","Bracknell Forest 010","E02003361",3071,871,335,536,1976,202,1023,348,494,181,385,212,153,20,348,195,153,18,18,224,88,136
"2021","Bracknell Forest 011","E02003362",2732,762,319,443,1772,204,910,277,469,164,310,161,133,16,330,196,134,18,18,198,76,122
"2021","Bracknell Forest 012","E02003363",2672,803,427,376,1745,369,905,297,458,150,268,157,101,10,195,109,86,8,8,124,48,76
"2021","Bracknell Forest 013","E02003364",2712,618,236,382,1940,231,1088,324,533,231,340,194,121,25,269,161,108,12,12,154,73,81
"2021","Bracknell Forest 014","E02003365",2745,643,301,342,1932,325,1056,314,551,191,324,173,128,23,221,140,81,6,6,170,66,104
"2021","Bracknell Forest 015","E02003366",2520,584,282,302,1758,216,1057,344,506,207,266,150,105,11,204,105,99,15,15,178,82,96
"2021","West Berkshire 001","E02003367",2477,507,256,251,1848,318,1094,379,538,177,230,130,87,13,200,121,79,6,6,122,37,85
"2021","West Berkshire 002","E02003368",2506,719,336,383,1643,334,825,355,334,136,296,174,108,14,175,97,78,13,13,144,39,105
"2021","West Berkshire 003","E02003369",2564,586,308,278,1867,354,1094,407,505,182,224,135,73,16,183,104,79,12,12,111,34,77
"2021","West Berkshire 004","E02003370",2722,630,311,319,1953,406,1088,361,514,213,245,133,97,15,199,101,98,15,15,139,60,79
"2021","West Berkshire 005","E02003371",2344,529,338,191,1702,300,978,291,453,234,241,114,115,12,177,91,86,6,6,113,48,65
"2021","West Berkshire 006","E02003372",3093,695,433,262,2216,381,1229,364,578,287,303,128,151,24,290,167,123,13,13,182,81,101
"2021","West Berkshire 007","E02003373",3045,561,275,286,2328,396,1423,429,757,237,291,151,118,22,215,146,69,3,3,156,62,94
"2021","West Berkshire 008","E02003374",2448,664,223,441,1676,233,854,281,368,205,329,196,119,14,245,147,98,15,15,108,42,66
"2021","West Berkshire 009","E02003375",2692,819,334,485,1731,219,884,301,416,167,351,218,120,13,267,172,95,10,10,142,54,88
"2021","West Berkshire 010","E02003376",2691,937,467,470,1656,306,793,330,325,138,302,174,114,14,242,154,88,13,13,98,37,61
"2021","West Berkshire 011","E02003377",3972,1029,537,492,2761,515,1565,541,753,271,403,226,153,24,265,156,109,13,13,182,71,111
"2021","West Berkshire 012","E02003378",3597,1249,610,639,2144,382,1092,406,510,176,324,197,112,15,317,189,128,29,29,204,70,134
"2021","West Berkshire 013","E02003379",2826,748,293,455,1853,196,941,313,474,154,396,240,141,15,298,189,109,22,22,225,88,137
"2021","West Berkshire 014","E02003380",3363,824,323,501,2328,315,1231,448,534,249,452,245,179,28,309,167,142,21,21,211,72,139
"2021","West Berkshire 015","E02003381",2380,519,261,258,1761,257,1053,339,564,150,225,111,101,13,213,141,72,13,13,100,31,69
"2021","West Berkshire 016","E02003382",3209,983,470,513,2059,259,991,344,458,189,406,202,186,18,384,246,138,19,19,167,74,93
"2021","West Berkshire 017","E02003383",2764,650,302,348,2003,210,1177,387,586,204,342,185,140,17,261,167,94,13,13,111,43,68
"2021","West Berkshire 018","E02003384",2707,642,370,272,1940,373,1132,482,468,182,237,152,73,12,192,103,89,6,6,125,41,84
"2021","West Berkshire 019","E02003385",5353,2014,587,1427,3042,265,1460,534,768,158,825,592,214,19,453,321,132,39,39,297,69,228
"2021","West Berkshire 020","E02003386",3660,1192,484,708,2294,295,1194,410,612,172,425,252,150,23,353,226,127,27,27,174,65,109
"2021","West Berkshire 021","E02003387",3746,844,472,372,2721,550,1526,417,836,273,353,177,161,15,281,167,114,11,11,181,75,106
"2021","West Berkshire 022","E02003388",2498,664,329,335,1725,320,963,323,489,151,236,128,94,14,199,125,74,7,7,109,40,69
"2021","Reading 001","E02003389",3186,786,461,325,2184,404,1250,341,680,229,252,136,98,18,261,143,118,17,17,216,76,140
"2021","Reading 002","E02003390",2894,501,340,161,2258,403,1456,399,808,249,211,110,89,12,179,97,82,9,9,135,54,81
"2021","Reading 003","E02003391",3410,923,508,415,2288,312,1334,342,805,187,335,205,111,19,295,162,133,12,12,199,74,125
"2021","Reading 004","E02003392",3768,1121,382,739,2346,168,1021,345,545,131,651,431,187,33,478,300,178,28,28,301,68,233
"2021","Reading 005","E02003393",3278,800,409,391,2274,353,1185,369,551,265,385,188,169,28,330,211,119,21,21,204,77,127
"2021","Reading 006","E02003394",3206,754,307,447,2125,133,1028,284,562,182,391,194,160,37,535,344,191,38,38,327,158,169
"2021","Reading 007","E02003395",4298,1132,195,937,2399,83,1195,362,674,159,559,385,152,22,471,320,151,91,91,767,261,506
"2021","Reading 008","E02003396",4071,1283,332,951,2329,170,1119,347,600,172,540,319,203,18,445,283,162,55,55,459,159,300
"2021","Reading 009","E02003397",3248,858,455,403,2168,285,988,288,494,206,348,157,165,26,530,348,182,17,17,222,107,115
"2021","Reading 010","E02003398",4274,1205,248,957,2211,88,1085,289,644,152,559,415,130,14,406,270,136,73,73,858,247,611
"2021","Reading 012","E02003400",3094,829,199,630,1421,140,741,213,428,100,336,249,75,12,174,100,74,30,30,844,106,738
"2021","Reading 013","E02003401",3855,1280,376,904,2216,185,1067,327,602,138,470,315,140,15,438,293,145,56,56,359,115,244
"2021","Reading 014","E02003402",4059,1262,250,1012,2029,126,972,319,551,102,575,455,112,8,281,158,123,75,75,768,212,556
"2021","Reading 015","E02003403",3822,1149,512,637,2372,269,1142,319,591,232,388,217,141,30,542,333,209,31,31,301,131,170
"2021","Reading 016","E02003404",2280,629,287,342,1312,126,645,158,376,111,206,110,80,16,305,191,114,30,30,339,135,204
"2021","Reading 017","E02003405",4908,1278,333,945,3055,134,1405,376,778,251,652,376,215,61,801,522,279,63,63,575,278,297
"2021","Reading 018","E02003406",3049,738,343,395,1940,170,962,288,465,209,309,134,132,43,460,256,204,39,39,371,178,193
"2021","Reading 019","E02006939",3377,1291,126,1165,1687,52,807,348,415,44,531,454,70,7,224,153,71,73,73,399,68,331
"2021","Reading 020","E02006940",3610,1441,167,1274,1774,46,846,313,478,55,596,515,72,9,209,140,69,77,77,395,66,329
"2021","Slough 001","E02003407",3708,848,300,548,2501,105,1339,242,889,208,330,98,197,35,688,447,241,39,39,359,221,138
"2021","Slough 002","E02003408",3526,711,243,468,2219,138,1311,214,799,298,238,102,115,21,462,296,166,70,70,596,364,232
"2021","Slough 003","E02003409",3983,1064,338,726,2570,171,1384,320,810,254,361,182,152,27,606,382,224,48,48,349,175,174
"2021","Slough 004","E02003410",3397,555,230,325,2122,98,1324,191,849,284,179,52,104,23,481,260,221,40,40,720,473,247
"2021","Slough 005","E02003411",3742,793,351,442,2299,135,1409,223,910,276,167,54,97,16,539,301,238,49,49,650,427,223
"2021","Slough 006","E02003412",3621,832,344,488,2423,161,1471,320,901,250,301,139,129,33,452,248,204,38,38,366,221,145
"2021","Slough 008","E02003414",4734,1119,283,836,3158,128,1885,385,1256,244,447,203,214,30,642,434,208,56,56,457,288,169
"2021","Slough 009","E02003415",4260,972,211,761,2565,84,1466,290,978,198,348,150,182,16,600,416,184,67,67,723,425,298
"2021","Slough 010","E02003416",3314,696,243,453,2239,159,1443,267,919,257,229,120,91,18,375,241,134,33,33,379,239,140
"2021","Slough 011","E02003417",4584,1238,320,918,2780,170,1728,368,1120,240,365,233,122,10,467,309,158,50,50,566,296,270
"2021","Slough 012","E02003418",3373,724,257,467,2192,142,1360,208,899,253,190,61,99,30,471,258,213,29,29,457,279,178
"2021","Slough 013","E02003419",3146,788,324,464,1987,129,1168,207,736,225,214,82,107,25,450,279,171,26,26,371,212,159
"2021","Slough 014","E02003420",2395,648,158,490,1467,69,804,204,450,150,230,103,112,15,337,215,122,27,27,280,153,127
"2021","Slough 015","E02007068",2341,549,101,448,1430,43,878,198,561,119,169,109,56,4,305,195,110,35,35,362,207,155
"2021","Slough 016","E02007069",2298,410,136,274,1355,84,839,138,531,170,118,64,47,7,284,150,134,30,30,533,323,210
"2021","Windsor and Maidenhead 001","E02003421",2150,473,282,191,1497,286,841,242,456,143,175,101,65,9,186,85,101,9,9,180,87,93
"2021","Windsor and Maidenhead 002","E02003422",4852,1235,669,566,3351,645,1920,629,965,326,419,267,129,23,338,183,155,29,29,266,97,169
"2021","Windsor and Maidenhead 003","E02003423",2380,517,251,266,1683,190,935,195,545,195,235,111,99,25,306,175,131,17,17,180,86,94
"2021","Windsor and Maidenhead 004","E02003424",3900,1069,446,623,2561,446,1437,472,737,228,410,285,110,15,240,143,97,28,28,270,96,174
"2021","Windsor and Maidenhead 005","E02003425",5621,1965,635,1330,3227,251,1727,522,1015,190,723,511,182,30,489,331,158,37,37,429,170,259
"2021","Windsor and Maidenhead 006","E02003426",3769,832,411,421,2722,392,1652,457,916,279,362,199,140,23,289,151,138,27,27,215,100,115
"2021","Windsor and Maidenhead 007","E02003427",3038,732,297,435,2003,172,1108,268,652,188,335,199,118,18,365,210,155,23,23,303,138,165
"2021","Windsor and Maidenhead 008","E02003428",3562,801,427,374,2539,402,1421,375,784,262,311,130,152,29,390,224,166,15,15,222,104,118
"2021","Windsor and Maidenhead 009","E02003429",2962,717,395,322,2049,386,1200,356,624,220,221,114,85,22,225,108,117,17,17,196,82,114
"2021","Windsor and Maidenhead 010","E02003430",2588,943,341,602,1476,151,796,306,350,140,318,219,78,21,195,110,85,16,16,169,54,115
"2021","Windsor and Maidenhead 011","E02003431",2798,791,314,477,1769,233,956,285,451,220,283,162,100,21,283,154,129,14,14,238,125,113
"2021","Windsor and Maidenhead 012","E02003432",3137,1102,430,672,1852,159,984,321,545,118,425,299,117,9,266,168,98,18,18,183,53,130
"2021","Windsor and Maidenhead 013","E02003433",2665,785,441,344,1709,289,942,255,502,185,246,125,101,20,217,113,104,15,15,171,69,102
"2021","Windsor and Maidenhead 014","E02003434",3772,1158,473,685,2353,257,1212,342,655,215,374,189,159,26,476,288,188,34,34,261,124,137
"2021","Windsor and Maidenhead 015","E02003435",2927,747,314,433,2016,283,1198,372,651,175,299,198,87,14,215,134,81,21,21,164,57,107
"2021","Windsor and Maidenhead 016","E02003436",3503,880,497,383,2299,422,1349,425,624,300,277,143,100,34,236,114,122,15,15,324,138,186
"2021","Windsor and Maidenhead 017","E02003437",2955,807,344,463,2009,322,1178,351,615,212,244,132,92,20,257,149,108,8,8,139,58,81
"2021","Windsor and Maidenhead 018","E02003438",4353,1159,639,520,2971,535,1734,496,925,313,310,173,118,19,367,214,153,25,25,223,90,133
"2021","Wokingham 001","E02003439",2318,621,369,252,1616,348,926,323,462,141,191,115,67,9,144,81,63,7,7,81,27,54
"2021","Wokingham 002","E02003440",3784,971,526,445,2666,413,1556,433,910,213,409,257,136,16,278,171,107,10,10,147,60,87
"2021","Wokingham 003","E02003441",3015,704,417,287,2136,424,1243,377,612,254,228,98,106,24,235,135,100,6,6,175,76,99
"2021","Wokingham 004","E02003442",3335,712,283,429,2462,280,1472,421,816,235,408,248,145,15,291,190,101,11,11,161,67,94
"2021","Wokingham 005","E02003443",2785,838,496,342,1755,262,931,208,551,172,252,115,119,18,285,163,122,25,25,192,94,98
"2021","Wokingham 006","E02003444",3280,636,339,297,2300,306,1526,351,895,280,197,102,78,17,255,120,135,16,16,344,158,186
"2021","Wokingham 007","E02003445",3423,777,464,313,2449,390,1458,390,783,285,297,166,117,14,290,168,122,14,14,197,90,107
"2021","Wokingham 008","E02003446",3129,657,364,293,2293,401,1507,371,863,273,213,121,71,21,158,86,72,14,14,179,81,98
"2021","Wokingham 009","E02003447",3947,800,326,474,2877,292,1802,452,1067,283,411,236,149,26,341,199,142,31,31,270,124,146
"2021","Wokingham 010","E02003448",3135,657,295,362,2320,375,1360,381,786,193,308,181,117,10,260,164,96,17,17,158,70,88
"2021","Wokingham 011","E02003449",3154,957,256,701,2058,138,1289,373,723,193,386,266,102,18,234,145,89,11,11,139,61,78
"2021","Wokingham 012","E02003450",5013,1049,387,662,3602,342,2104,587,1252,265,639,380,227,32,478,304,174,39,39,362,143,219
"2021","Wokingham 013","E02003451",4534,1689,798,891,2661,375,1204,404,634,166,611,415,163,33,440,283,157,31,31,184,48,136
"2021","Wokingham 014","E02003452",3694,798,298,500,2738,346,1608,429,984,195,443,275,155,13,322,218,104,19,19,158,53,105
"2021","Wokingham 015","E02003453",2656,458,239,219,2104,337,1368,426,722,220,218,126,82,10,179,97,82,2,2,94,48,46
"2021","Wokingham 016","E02003454",3571,966,407,559,2433,374,1391,392,825,174,387,260,109,18,257,168,89,24,24,172,57,115
"2021","Wokingham 017","E02003455",4218,954,364,590,3062,341,1753,528,999,226,626,378,224,24,327,226,101,15,15,202,87,115
"2021","Wokingham 018","E02003456",3173,683,257,426,2313,252,1230,360,735,135,468,281,171,16,348,248,100,15,15,177,82,95
"2021","Wokingham 019","E02003457",3790,672,357,315,2967,598,1855,549,955,351,289,156,106,27,211,103,108,14,14,151,50,101
"2021","Wokingham 020","E02003458",3217,668,404,264,2382,489,1390,392,754,244,263,144,96,23,222,117,105,18,18,167,73,94
"2021","Milton Keynes 001","E02003459",3879,1093,587,506,2661,520,1394,487,681,226,431,243,168,20,305,188,117,11,11,125,53,72
"2021","Milton Keynes 002","E02003460",4839,1158,544,614,3436,605,1778,672,834,272,605,353,228,24,424,279,145,24,24,245,96,149
"2021","Milton Keynes 003","E02003461",3020,743,436,307,2123,431,1038,330,499,209,316,143,144,29,322,208,114,16,16,154,75,79
"2021","Milton Keynes 004","E02003462",3494,1022,434,588,2327,308,1166,386,582,198,470,269,171,30,359,222,137,24,24,145,58,87
"2021","Milton Keynes 005","E02003463",2744,689,333,356,1805,319,880,335,374,171,302,148,123,31,284,162,122,20,20,250,117,133
"2021","Milton Keynes 006","E02003464",2675,679,263,416,1740,151,784,231,397,156,300,126,142,32,474,312,162,31,31,256,129,127
"2021","Milton Keynes 007","E02003465",2732,857,491,366,1701,312,919,384,352,183,251,152,71,28,205,107,98,14,14,174,74,100
"2021","Milton Keynes 008","E02003466",3096,824,247,577,1972,150,934,303,477,154,456,277,163,16,390,248,142,42,42,300,119,181
"2021","Milton Keynes 009","E02003467",2572,774,359,415,1505,172,690,232,318,140,252,131,104,17,351,226,125,40,40,293,133,160
"2021","Milton Keynes 010","E02003468",3770,1198,550,648,2358,360,1079,384,534,161,506,292,194,20,391,237,154,22,22,214,76,138
"2021","Milton Keynes 011","E02003469",2420,649,275,374,1617,260,838,322,346,170,283,161,101,21,220,129,91,16,16,154,74,80
"2021","Milton Keynes 012","E02003470",2234,624,217,407,1400,77,583,153,339,91,215,74,113,28,499,356,143,26,26,210,114,96
"2021","Milton Keynes 013","E02003471",2578,736,322,414,1536,164,777,254,364,159,232,126,85,21,337,187,150,26,26,306,136,170
"2021","Milton Keynes 014","E02003472",4461,1700,217,1483,2175,92,974,382,489,103,530,372,140,18,479,337,142,100,100,586,170,416
"2021","Milton Keynes 015","E02003473",2338,646,210,436,1550,196,909,295,458,156,223,132,79,12,214,134,80,8,8,142,56,86
"2021","Milton Keynes 016","E02003474",3414,796,276,520,2283,218,1234,354,657,223,365,188,159,18,429,301,128,37,37,335,155,180
"2021","Milton Keynes 018","E02003476",3180,882,291,591,1849,111,779,233,401,145,323,127,175,21,595,417,178,41,41,449,197,252
"2021","Milton Keynes 020","E02003478",2717,725,292,433,1821,174,1092,347,594,151,271,162,96,13,276,166,110,8,8,171,81,90
"2021","Milton Keynes 021","E02003479",2868,731,227,504,1775,110,846,236,482,128,293,141,130,22,481,304,177,45,45,362,164,198
"2021","Milton Keynes 022","E02003480",3440,932,239,693,2317,152,1176,400,554,222,470,266,182,22,504,345,159,15,15,191,80,111
"2021","Milton Keynes 023","E02003481",3359,1101,322,779,1929,138,742,215,402,125,353,172,158,23,651,478,173,45,45,329,149,180
"2021","Milton Keynes 024","E02003482",3610,922,366,556,2534,319,1364,465,680,219,476,292,161,23,352,260,92,23,23,154,74,80
"2021","Milton Keynes 025","E02003483",4018,773,201,572,2968,115,1930,480,1149,301,433,199,193,41,465,324,141,25,25,277,142,135
"2021","Milton Keynes 026","E02003484",2922,822,320,502,1907,186,1058,317,550,191,278,146,116,16,362,225,137,23,23,193,83,110
"2021","Milton Keynes 027","E02003485",3222,738,361,377,2231,329,1044,333,468,243,328,145,154,29,510,335,175,20,20,253,136,117
"2021","Milton Keynes 028","E02003486",3798,826,232,594,2746,172,1679,432,1010,237,440,228,187,25,439,318,121,16,16,226,128,98
"2021","Milton Keynes 029","E02003487",2950,718,433,285,2036,358,960,314,404,242,275,101,138,36,436,275,161,7,7,196,95,101
"2021","Milton Keynes 030","E02003488",3345,953,462,491,2070,286,963,296,453,214,383,207,151,25,390,248,142,48,48,322,172,150
"2021","Milton Keynes 031","E02003489",3124,809,411,398,2086,325,1022,360,455,207,383,203,152,28,330,206,124,26,26,229,111,118
"2021","Milton Keynes 032","E02003490",3988,865,249,616,2784,143,1190,304,722,164,608,295,283,30,806,573,233,37,37,339,186,153
"2021","Milton Keynes 033","E02007012",2996,642,112,530,2132,117,1240,263,863,114,349,183,156,10,399,328,71,27,27,222,96,126
"2021","Milton Keynes 034","E02007013",3490,682,51,631,2450,26,1434,251,1104,79,534,279,235,20,419,341,78,37,37,358,175,183
"2021","Milton Keynes 035","E02007014",2822,808,153,655,1818,88,1011,303,571,137,353,197,142,14,348,266,82,18,18,196,92,104
"2021","Milton Keynes 036","E02007015",3735,922,173,749,2559,179,1384,325,948,111,575,336,214,25,389,289,100,32,32,254,111,143
"2021","Milton Keynes 037","E02007016",3245,754,323,431,2277,178,1424,321,940,163,383,191,177,15,274,190,84,18,18,214,121,93
"2021","Brighton and Hove 001","E02003491",3058,742,425,317,2079,259,1071,300,566,205,377,169,179,29,360,207,153,12,12,237,91,146
"2021","Brighton and Hove 002","E02003492",2078,510,243,267,1163,112,517,136,224,157,225,92,103,30,293,161,132,16,16,405,71,334
"2021","Brighton and Hove 003","E02003493",3368,924,562,362,2205,372,1178,368,602,208,333,182,130,21,306,199,107,16,16,239,69,170
"2021","Brighton and Hove 004","E02003494",2641,620,350,270,1830,267,1003,325,520,158,289,125,145,19,260,136,124,11,11,191,74,117
"2021","Brighton and Hove 005","E02003495",2944,744,411,333,2030,240,940,292,457,191,408,185,190,33,425,246,179,17,17,170,60,110
"2021","Brighton and Hove 006","E02003496",3133,870,478,392,2045,325,957,258,483,216,325,127,176,22,419,256,163,19,19,218,109,109
"2021","Brighton and Hove 007","E02003497",2877,587,335,252,2108,331,1280,370,685,225,260,124,119,17,228,128,100,9,9,182,64,118
"2021","Brighton and Hove 008","E02003498",3437,1160,392,768,1756,143,636,185,306,145,390,170,191,29,555,373,182,32,32,521,82,439
"2021","Brighton and Hove 009","E02003499",2760,603,242,361,1581,122,646,206,254,186,329,118,171,40,449,257,192,35,35,576,114,462
"2021","Brighton and Hove 010","E02003500",2952,588,208,380,2015,143,1127,279,685,163,455,219,213,23,279,181,98,11,11,349,69,280
"2021","Brighton and Hove 011","E02003501",3665,1091,397,694,2272,232,1161,377,619,165,548,387,141,20,309,205,104,22,22,302,60,242
"2021","Brighton and Hove 012","E02003502",3226,922,411,511,2060,199,960,303,463,194,436,213,189,34,449,290,159,16,16,244,93,151
"2021","Brighton and Hove 013","E02003503",3455,834,493,341,2318,239,1206,289,640,277,397,147,208,42,453,248,205,23,23,303,113,190
"2021","Brighton and Hove 014","E02003504",3901,1344,357,987,2109,137,942,362,489,91,709,541,158,10,287,198,89,34,34,448,55,393
"2021","Brighton and Hove 015","E02003505",3832,1244,228,1016,1655,67,634,267,291,76,633,500,123,10,267,174,93,54,54,933,45,888
"2021","Brighton and Hove 016","E02003506",2965,801,239,562,1913,88,928,266,581,81,542,323,197,22,335,224,111,20,20,251,59,192
"2021","Brighton and Hove 017","E02003507",3914,935,547,388,2672,413,1271,469,552,250,473,222,196,55,489,274,215,26,26,307,109,198
"2021","Brighton and Hove 018","E02003508",3405,834,235,599,1772,105,748,251,398,99,571,358,193,20,311,203,108,37,37,799,45,754
"2021","Brighton and Hove 019","E02003509",4598,1968,502,1466,2176,127,801,322,413,66,818,663,147,8,383,251,132,47,47,454,35,419
"2021","Brighton and Hove 020","E02003510",4140,1569,507,1062,2141,162,938,333,493,112,665,499,156,10,320,222,98,56,56,430,58,372
"2021","Brighton and Hove 021","E02003511",3526,1020,409,611,2216,170,1159,290,692,177,502,285,204,13,362,222,140,23,23,290,84,206
"2021","Brighton and Hove 022","E02003512",3722,1218,297,921,1760,64,693,260,361,72,634,420,196,18,316,211,105,53,53,744,44,700
"2021","Brighton and Hove 023","E02003513",2818,1003,392,611,1615,184,847,262,467,118,308,170,133,5,250,160,90,26,26,200,38,162
"2021","Brighton and Hove 024","E02003514",4729,2224,374,1850,2012,79,669,324,300,45,987,857,124,6,223,162,61,54,54,493,27,466
"2021","Brighton and Hove 025","E02003515",3705,1188,423,765,2110,139,753,204,360,189,422,170,196,56,766,478,288,30,30,407,121,286
"2021","Brighton and Hove 026","E02003516",4703,2279,464,1815,1927,94,624,343,246,35,854,729,113,12,295,197,98,60,60,497,31,466
"2021","Brighton and Hove 027","E02003517",5399,2329,447,1882,2126,107,729,410,264,55,797,663,120,14,344,223,121,149,149,944,57,887
"2021","Brighton and Hove 028","E02003518",4134,2051,584,1467,1797,190,683,330,284,69,616,502,105,9,276,179,97,32,32,286,33,253
"2021","Brighton and Hove 029","E02003519",4793,2429,357,2072,1849,72,566,347,186,33,904,791,105,8,234,146,88,73,73,515,33,482
"2021","Brighton and Hove 030","E02003520",4692,2212,474,1738,1866,94,578,267,246,65,690,567,109,14,422,233,189,82,82,614,57,557
"2021","Brighton and Hove 031","E02003521",4341,2169,708,1461,1716,158,609,335,229,45,641,532,94,15,238,152,86,70,70,456,38,418
"2021","Brighton and Hove 032","E02003522",3825,1638,553,1085,1812,177,753,336,341,76,480,348,94,38,345,215,130,57,57,375,54,321
"2021","Brighton and Hove 033","E02003523",4653,1447,829,618,2938,636,1401,640,508,253,487,293,169,25,390,217,173,24,24,268,66,202
"2021","Portsmouth 001","E02003524",3063,773,354,419,2009,176,855,274,375,206,418,155,216,47,529,315,214,31,31,281,130,151
"2021","Portsmouth 002","E02003525",2583,698,265,433,1655,150,639,225,285,129,335,142,159,34,492,341,151,39,39,230,77,153
"2021","Portsmouth 003","E02003526",2804,754,544,210,1895,447,1037,347,468,222,239,113,108,18,160,100,60,12,12,155,57,98
"2021","Portsmouth 004","E02003527",2727,756,362,394,1799,250,839,324,368,147,385,216,149,20,307,204,103,18,18,172,73,99
"2021","Portsmouth 006","E02003529",3246,779,383,396,2227,258,1204,316,650,238,385,179,174,32,361,194,167,19,19,240,95,145
"2021","Portsmouth 007","E02003530",3316,965,444,521,2158,265,1108,409,517,182,384,215,152,17,384,266,118,17,17,193,77,116
"2021","Portsmouth 008","E02003531",3315,954,430,524,2193,335,1115,398,473,244,417,200,185,32,311,170,141,15,15,168,65,103
"2021","Portsmouth 009","E02003532",3261,1031,331,700,1921,187,962,320,478,164,430,229,171,30,323,202,121,19,19,309,110,199
"2021","Portsmouth 010","E02003533",2486,776,314,462,1505,118,608,225,280,103,373,191,159,23,387,237,150,19,19,205,56,149
"2021","Portsmouth 011","E02003534",3485,857,279,578,2283,223,1117,357,523,237,519,247,234,38,395,253,142,29,29,345,132,213
"2021","Portsmouth 012","E02003535",3825,980,291,689,2481,140,1069,310,551,208,611,308,271,32,620,424,196,41,41,364,146,218
"2021","Portsmouth 013","E02003536",3326,1212,494,718,1826,114,622,190,321,111,311,106,169,36,738,507,231,41,41,288,111,177
"2021","Portsmouth 014","E02003537",4164,1100,487,613,2766,337,1336,417,621,298,601,300,263,38,466,283,183,26,26,298,117,181
"2021","Portsmouth 015","E02003538",4351,1351,432,919,2505,114,1049,357,536,156,692,370,286,36,580,392,188,70,70,495,117,378
"2021","Portsmouth 017","E02003540",4095,1325,663,662,2487,358,1196,430,564,202,503,246,224,33,410,259,151,20,20,283,96,187
"2021","Portsmouth 018","E02003541",4225,1624,654,970,1810,121,682,189,411,82,382,228,127,27,563,414,149,62,62,791,134,657
"2021","Portsmouth 019","E02003542",3562,971,369,602,1974,147,880,284,462,134,523,325,180,18,367,225,142,57,57,617,80,537
"2021","Portsmouth 020","E02003543",3521,1085,265,820,1574,128,662,249,324,89,441,303,126,12,292,200,92,51,51,862,92,770
"2021","Portsmouth 021","E02003544",2849,914,276,638,1724,108,753,306,352,95,484,284,184,16,358,234,124,21,21,211,52,159
"2021","Portsmouth 022","E02003545",3491,1608,482,1126,1525,159,594,290,226,78,518,425,82,11,216,130,86,38,38,358,35,323
"2021","Portsmouth 023","E02003546",3717,1312,517,795,2150,321,976,421,415,140,487,311,156,20,334,205,129,32,32,255,66,189
"2021","Portsmouth 024","E02003547",4387,2124,782,1342,1895,358,776,424,273,79,493,416,72,5,211,122,89,57,57,368,54,314
"2021","Portsmouth 025","E02003548",2780,1040,282,758,1424,153,677,269,312,96,386,279,93,14,170,105,65,38,38,316,52,264
"2021","Portsmouth 026","E02006821",2622,588,338,250,1891,341,1038,292,556,190,281,141,109,31,224,141,83,7,7,143,60,83
"2021","Portsmouth 027","E02006975",2652,1151,270,881,1188,66,385,154,166,65,310,208,91,11,351,254,97,76,76,313,47,266
"2021","Portsmouth 028","E02006976",2289,882,368,514,1183,61,409,113,222,74,203,80,99,24,472,332,140,38,38,224,89,135
"2021","Southampton 001","E02003549",2655,676,323,353,1635,238,907,329,409,169,266,170,77,19,191,90,101,33,33,344,91,253
"2021","Southampton 002","E02003550",3289,888,393,495,2189,322,1027,344,492,191,425,223,183,19,385,236,149,30,30,212,80,132
"2021","Southampton 003","E02003551",2304,917,360,557,1225,143,510,177,243,90,283,159,105,19,265,168,97,24,24,162,73,89
"2021","Southampton 004","E02003552",2642,888,485,403,1567,205,740,248,335,157,294,144,119,31,314,181,133,14,14,187,75,112
"2021","Southampton 005","E02003553",2395,537,198,339,1252,89,636,166,367,103,208,120,72,16,289,169,120,30,30,606,103,503
"2021","Southampton 006","E02003554",2637,855,391,464,1558,267,731,267,340,124,337,223,103,11,204,98,106,19,19,224,72,152
"2021","Southampton 007","E02003555",3612,1067,452,615,2286,232,1034,333,521,180,490,250,214,26,496,339,157,34,34,259,108,151
"2021","Southampton 008","E02003556",2382,623,281,342,1613,252,796,265,380,151,320,147,152,21,238,150,88,7,7,146,52,94
"2021","Southampton 009","E02003557",2759,916,387,529,1313,236,671,241,343,87,252,197,49,6,131,79,52,23,23,530,53,477
"2021","Southampton 010","E02003558",3060,1007,356,651,1780,150,763,246,431,86,366,198,147,21,459,331,128,42,42,273,101,172
"2021","Southampton 011","E02003559",3041,708,361,347,2078,308,1229,349,682,198,299,168,111,20,224,134,90,18,18,255,89,166
"2021","Southampton 012","E02003560",3063,946,341,605,1934,128,772,250,370,152,426,173,214,39,582,419,163,26,26,183,79,104
"2021","Southampton 013","E02003561",3203,1257,331,926,1393,112,578,207,287,84,396,278,98,20,274,159,115,33,33,553,85,468
"2021","Southampton 014","E02003562",3720,1263,410,853,2229,247,1090,361,567,162,519,334,167,18,335,239,96,38,38,228,68,160
"2021","Southampton 015","E02003563",3561,1278,534,744,2037,188,955,327,490,138,471,275,179,17,390,275,115,33,33,246,77,169
"2021","Southampton 016","E02003564",3430,1054,499,555,2179,290,956,331,448,177,448,207,213,28,464,328,136,21,21,197,82,115
"2021","Southampton 017","E02003565",2712,935,167,768,1091,42,452,187,225,40,373,295,69,9,178,111,67,46,46,686,68,618
"2021","Southampton 018","E02003566",2726,835,447,388,1718,244,760,269,335,156,331,177,135,19,364,203,161,19,19,173,81,92
"2021","Southampton 019","E02003567",3067,770,301,469,2012,194,943,284,473,186,410,183,182,45,444,291,153,21,21,285,138,147
"2021","Southampton 020","E02003568",3769,1507,252,1255,1854,138,884,330,458,96,576,463,101,12,207,122,85,49,49,408,78,330
"2021","Southampton 021","E02003569",3733,1474,345,1129,1940,103,809,312,409,88,606,429,161,16,362,233,129,60,60,319,83,236
"2021","Southampton 022","E02003570",4074,1475,169,1306,1917,29,918,197,606,115,444,316,115,13,424,287,137,102,102,682,241,441
"2021","Southampton 023","E02003571",3212,1281,313,968,1172,70,450,188,224,38,395,323,69,3,197,128,69,60,60,759,50,709
"2021","Southampton 024","E02003572",2499,658,286,372,1683,225,907,293,454,160,295,157,125,13,234,141,93,22,22,158,66,92
"2021","Southampton 025","E02003573",3321,1027,462,565,2102,274,887,324,387,176,375,173,168,34,541,377,164,25,25,192,82,110
"2021","Southampton 026","E02003574",3430,1109,511,598,2158,344,1080,431,453,196,428,232,161,35,290,159,131,16,16,163,53,110
"2021","Southampton 027","E02003575",2836,956,333,623,1749,167,616,222,284,110,366,163,191,12,592,444,148,8,8,131,54,77
"2021","Southampton 028","E02003576",3455,1089,390,699,2122,195,975,323,482,170,456,243,172,41,469,322,147,27,27,244,89,155
"2021","Southampton 030","E02003578",2745,843,353,490,1740,219,844,311,369,164,387,212,149,26,277,161,116,13,13,162,51,111
"2021","Southampton 031","E02003579",4276,1434,363,1071,2576,258,1084,417,505,162,745,464,256,25,462,308,154,27,27,266,88,178
"2021","Southampton 032","E02003580",2618,853,308,545,1627,145,623,201,311,111,356,137,196,23,488,344,144,15,15,138,53,85
"2021","Southampton 033","E02007074",3015,1183,226,957,1505,36,616,171,398,47,412,306,100,6,368,264,104,73,73,327,76,251
"2021","Southampton 034","E02007075",3050,1407,127,1280,1363,86,498,280,180,38,588,529,52,7,125,75,50,66,66,280,21,259
"2021","Isle of Wight 001","E02003581",3671,1395,592,803,2058,306,851,361,341,149,478,264,184,30,407,271,136,16,16,218,71,147
"2021","Isle of Wight 002","E02003582",3739,1070,633,437,2498,540,1248,498,541,209,383,185,163,35,318,179,139,9,9,171,70,101
"2021","Isle of Wight 003","E02003583",3520,1168,619,549,2196,493,927,434,353,140,432,210,190,32,333,224,109,11,11,156,67,89
"2021","Isle of Wight 004","E02003584",3278,1705,598,1107,1406,204,546,272,177,97,341,228,94,19,304,201,103,11,11,167,66,101
"2021","Isle of Wight 005","E02003585",3097,986,635,351,1989,616,904,428,315,161,279,152,106,21,183,110,73,7,7,122,45,77
"2021","Isle of Wight 006","E02003586",3400,1103,601,502,2157,406,970,384,410,176,354,179,145,30,417,266,151,10,10,140,53,87
"2021","Isle of Wight 007","E02003587",3838,1318,539,779,2318,351,945,377,388,180,494,225,237,32,511,350,161,17,17,202,81,121
"2021","Isle of Wight 008","E02003588",3626,1107,477,630,2329,334,1002,372,422,208,518,248,246,24,459,306,153,16,16,190,72,118
"2021","Isle of Wight 009","E02003589",3470,1331,531,800,1945,214,751,301,312,138,494,252,206,36,461,318,143,25,25,194,72,122
"2021","Isle of Wight 010","E02003590",3556,1172,813,359,2242,781,989,494,299,196,230,132,84,14,235,128,107,7,7,142,44,98
"2021","Isle of Wight 011","E02003591",4030,1194,608,586,2621,500,1197,456,502,239,507,246,235,26,404,263,141,13,13,215,97,118
"2021","Isle of Wight 012","E02003592",4772,1730,1077,653,2856,936,1129,626,297,206,369,220,124,25,409,231,178,13,13,186,74,112
"2021","Isle of Wight 013","E02003593",2403,673,384,289,1602,460,785,410,215,160,205,133,61,11,144,71,73,8,8,128,60,68
"2021","Isle of Wight 014","E02003594",4236,1466,728,738,2491,527,1053,492,349,212,426,215,176,35,476,304,172,9,9,279,96,183
"2021","Isle of Wight 015","E02003595",3718,1104,695,409,2436,730,1122,540,319,263,308,179,112,17,269,141,128,7,7,178,81,97
"2021","Isle of Wight 016","E02003596",4212,1759,917,842,2232,538,948,469,293,186,350,201,128,21,387,248,139,9,9,221,78,143
"2021","Isle of Wight 017","E02003597",2595,784,480,304,1669,457,819,421,248,150,225,112,91,22,163,85,78,5,5,142,67,75
"2021","Isle of Wight 018","E02003598",3617,1422,743,679,2043,533,848,455,231,162,306,159,121,26,349,197,152,7,7,152,46,106
"2021","Buckinghamshire 001","E02003652",3923,921,417,504,2835,409,1608,522,826,260,436,227,188,21,365,252,113,17,17,167,69,98
"2021","Buckinghamshire 002","E02003653",2940,921,395,526,1894,322,876,280,434,162,344,190,133,21,328,203,125,24,24,125,38,87
"2021","Buckinghamshire 003","E02003654",2370,508,297,211,1748,346,1010,384,449,177,246,144,86,16,144,72,72,2,2,114,40,74
"2021","Buckinghamshire 004","E02003655",4169,939,443,496,3027,499,1708,640,799,269,469,252,192,25,339,211,128,12,12,203,86,117
"2021","Buckinghamshire 005","E02003656",2926,836,429,407,1981,357,1002,412,410,180,350,200,135,15,257,169,88,15,15,109,42,67
"2021","Buckinghamshire 006","E02003657",2952,597,311,286,2205,386,1245,472,567,206,335,186,127,22,232,120,112,7,7,150,62,88
"2021","Buckinghamshire 007","E02003658",4008,884,445,439,2961,421,1587,533,795,259,578,315,235,28,364,246,118,11,11,163,62,101
"2021","Buckinghamshire 009","E02003659",3809,836,384,452,2749,381,1513,499,785,229,430,236,169,25,388,280,108,37,37,224,97,127
"2021","Buckinghamshire 008","E02003660",4370,959,524,435,3250,563,1846,634,916,296,487,272,183,32,342,199,143,12,12,161,70,91
"2021","Buckinghamshire 010","E02003661",2246,543,258,285,1591,277,924,335,439,150,245,133,98,14,142,74,68,3,3,112,48,64
"2021","Buckinghamshire 012","E02003662",2625,877,278,599,1592,140,845,295,391,159,326,191,116,19,259,151,108,22,22,156,80,76
"2021","Buckinghamshire 011","E02003663",5029,914,203,711,3766,126,2087,515,1347,225,803,428,343,32,710,525,185,40,40,349,184,165
"2021","Buckinghamshire 013","E02003664",3184,937,320,617,2014,115,987,250,602,135,413,235,155,23,457,310,147,42,42,233,110,123
"2021","Buckinghamshire 014","E02003665",2421,688,261,427,1618,194,812,220,447,145,330,183,132,15,258,170,88,24,24,115,49,66
"2021","Buckinghamshire 015","E02003666",3499,1463,432,1031,1756,130,827,284,430,113,420,289,120,11,327,217,110,52,52,280,119,161
"2021","Buckinghamshire 016","E02003667",3992,1191,312,879,2592,202,1371,436,783,152,627,416,195,16,353,214,139,39,39,209,84,125
"2021","Buckinghamshire 018","E02003668",3496,857,553,304,2466,502,1405,389,720,296,301,135,144,22,249,128,121,9,9,173,77,96
"2021","Buckinghamshire 017","E02003669",2694,752,272,480,1675,103,858,196,512,150,313,149,131,33,360,205,155,41,41,267,126,141
"2021","Buckinghamshire 019","E02003670",3813,1120,362,758,2465,294,1331,437,676,218,445,247,171,27,377,232,145,18,18,228,84,144
"2021","Buckinghamshire 020","E02003671",2459,769,222,547,1543,100,797,255,405,137,309,151,135,23,316,182,134,21,21,147,71,76
"2021","Buckinghamshire 021","E02003672",4906,1059,512,547,3640,652,2000,637,1027,336,576,305,236,35,395,257,138,17,17,207,84,123
"2021","Buckinghamshire 022","E02003673",3957,990,555,435,2803,570,1546,546,787,213,386,233,140,13,289,181,108,12,12,164,53,111
"2021","Buckinghamshire 023","E02003674",2281,515,315,200,1678,352,972,336,475,161,195,110,70,15,156,91,65,3,3,88,34,54
"2021","Buckinghamshire 024","E02003675",3763,1091,579,512,2506,420,1427,398,832,197,368,216,130,22,278,183,95,13,13,166,57,109
"2021","Buckinghamshire 029","E02003676",3250,706,415,291,2385,500,1450,483,678,289,236,133,86,17,188,94,94,11,11,159,70,89
"2021","Buckinghamshire 027","E02003677",3981,1019,473,546,2702,356,1440,407,782,251,421,199,186,36,460,287,173,25,25,260,145,115
"2021","Buckinghamshire 028","E02003678",2300,593,269,324,1570,245,899,256,493,150,236,126,95,15,180,100,80,10,10,137,61,76
"2021","Buckinghamshire 030","E02003679",3109,1118,466,652,1838,194,865,297,442,126,411,260,129,22,340,214,126,28,28,153,69,84
"2021","Buckinghamshire 031","E02003680",4095,1100,649,451,2857,627,1568,460,810,298,326,167,139,20,323,192,131,13,13,138,51,87
"2021","Buckinghamshire 032","E02003681",4221,1068,627,441,2990,510,1779,461,1055,263,323,186,120,17,324,190,134,54,54,163,63,100
"2021","Buckinghamshire 034","E02003682",3091,829,427,402,2153,364,1296,311,766,219,263,155,93,15,217,120,97,13,13,109,44,65
"2021","Buckinghamshire 035","E02003683",2802,630,333,297,2059,347,1245,309,737,199,194,115,69,10,257,181,76,16,16,113,59,54
"2021","Buckinghamshire 047","E02003685",3179,752,490,262,2290,427,1397,425,738,234,245,123,101,21,213,138,75,8,8,137,73,64
"2021","Buckinghamshire 050","E02003686",2996,748,467,281,2097,416,1187,360,603,224,219,122,87,10,265,151,114,10,10,151,62,89
"2021","Buckinghamshire 054","E02003687",2217,508,318,190,1615,251,999,248,543,208,155,66,80,9,204,111,93,6,6,94,53,41
"2021","Buckinghamshire 053","E02003688",4883,1300,704,596,3312,569,1922,477,1139,306,386,229,125,32,411,254,157,24,24,271,98,173
"2021","Buckinghamshire 058","E02003689",3359,775,408,367,2292,457,1433,349,782,302,195,116,66,13,188,127,61,19,19,292,162,130
"2021","Buckinghamshire 059","E02003690",3223,1049,543,506,1923,305,977,327,429,221,309,157,127,25,310,170,140,22,22,251,122,129
"2021","Buckinghamshire 063","E02003691",2818,722,394,328,1896,336,1108,337,566,205,210,90,96,24,226,138,88,16,16,200,85,115
"2021","Buckinghamshire 064","E02003692",3428,921,445,476,2184,378,1254,405,582,267,241,118,98,25,297,149,148,14,14,323,158,165
"2021","Buckinghamshire 065","E02003693",2962,727,382,345,2009,408,1113,377,532,204,284,194,76,14,199,102,97,5,5,226,73,153
"2021","Buckinghamshire 066","E02003694",3475,1011,447,564,2286,303,1241,312,675,254,344,183,130,31,377,210,167,21,21,178,77,101
"2021","Buckinghamshire 067","E02003695",4127,1056,479,577,2689,338,1552,426,736,390,378,197,141,40,401,209,192,20,20,382,195,187
"2021","Buckinghamshire 026","E02003696",3815,1220,787,433,2434,551,1214,429,577,208,360,209,129,22,292,148,144,17,17,161,67,94
"2021","Buckinghamshire 025","E02003697",2556,538,311,227,1918,378,1104,402,512,190,264,172,81,11,172,112,60,0,0,100,42,58
"2021","Buckinghamshire 033","E02003698",3318,644,412,232,2530,599,1454,478,682,294,286,177,88,21,184,90,94,7,7,144,61,83
"2021","Buckinghamshire 037","E02003699",2381,627,305,322,1636,274,866,305,395,166,288,153,119,16,191,98,93,17,17,118,47,71
"2021","Buckinghamshire 038","E02003701",4604,1233,593,640,3030,399,1699,416,989,294,433,234,171,28,468,282,186,31,31,341,170,171
"2021","Buckinghamshire 040","E02003702",3259,721,343,378,2341,403,1362,549,581,232,347,211,120,16,221,113,108,8,8,197,68,129
"2021","Buckinghamshire 041","E02003703",3502,974,259,715,2200,235,1186,352,650,184,447,287,145,15,308,183,125,24,24,328,156,172
"2021","Buckinghamshire 045","E02003704",2330,538,275,263,1697,331,974,274,541,159,227,125,86,16,157,82,75,8,8,95,40,55
"2021","Buckinghamshire 042","E02003705",2494,618,201,417,1576,83,872,198,516,158,301,181,106,14,299,178,121,21,21,300,153,147
"2021","Buckinghamshire 043","E02003706",2671,750,302,448,1717,158,909,266,497,146,306,160,121,25,326,193,133,18,18,204,87,117
"2021","Buckinghamshire 044","E02003707",2561,688,181,507,1620,104,883,242,492,149,300,175,103,22,318,195,123,15,15,253,123,130
"2021","Buckinghamshire 046","E02003708",3217,902,203,699,1726,64,976,204,621,151,271,151,106,14,355,207,148,60,60,589,312,277
"2021","Buckinghamshire 048","E02003709",2263,632,232,400,1459,107,693,188,403,102,268,130,125,13,369,233,136,22,22,172,82,90
"2021","Buckinghamshire 049","E02003710",4434,1153,303,850,2735,226,1563,432,877,254,478,312,153,13,406,273,133,62,62,546,272,274
"2021","Buckinghamshire 051","E02003711",4264,1471,368,1103,2554,195,1201,370,688,143,663,435,201,27,452,297,155,43,43,239,93,146
"2021","Buckinghamshire 052","E02003712",3279,968,531,437,2082,327,1076,315,551,210,314,138,147,29,349,178,171,16,16,229,105,124
"2021","Buckinghamshire 055","E02003713",2377,561,384,177,1697,367,908,273,449,186,220,86,117,17,193,103,90,9,9,119,47,72
"2021","Buckinghamshire 056","E02003714",2877,884,356,528,1859,243,918,255,510,153,371,228,124,19,313,180,133,14,14,134,48,86
"2021","Buckinghamshire 057","E02003715",2579,541,331,210,1946,427,1220,356,670,194,156,83,61,12,137,65,72,6,6,92,38,54
"2021","Buckinghamshire 060","E02003716",2610,820,447,373,1682,304,849,283,413,153,338,175,152,11,180,86,94,11,11,108,43,65
"2021","Buckinghamshire 062","E02003717",3869,1132,691,441,2581,519,1389,369,809,211,304,181,109,14,358,228,130,11,11,156,59,97
"2021","Buckinghamshire 061","E02003718",2379,697,355,342,1582,232,812,226,473,113,262,166,84,12,263,154,109,13,13,100,32,68
"2021","Buckinghamshire 039","E02006823",3531,813,496,317,2578,598,1523,442,805,276,223,123,89,11,222,103,119,12,12,140,56,84
"2021","Buckinghamshire 036","E02006824",3800,957,608,349,2686,540,1515,418,784,313,301,126,154,21,309,161,148,21,21,157,75,82
"2021","Eastbourne 001","E02004356",2966,774,392,382,1998,280,869,297,385,187,373,156,174,43,455,262,193,21,21,194,86,108
"2021","Eastbourne 002","E02004357",3015,727,350,377,2089,288,862,275,413,174,425,173,210,42,502,319,183,12,12,199,105,94
"2021","Eastbourne 003","E02004358",3527,1140,687,453,2223,471,898,313,415,170,385,157,199,29,454,285,169,15,15,164,62,102
"2021","Eastbourne 004","E02004359",3432,1080,593,487,2204,477,944,352,362,230,358,163,171,24,407,237,170,18,18,148,53,95
"2021","Eastbourne 006","E02004361",3310,905,521,384,2219,431,1150,371,561,218,302,127,143,32,324,208,116,12,12,186,98,88
"2021","Eastbourne 007","E02004362",3615,1060,531,529,2280,266,1118,342,577,199,443,211,212,20,423,274,149,30,30,275,101,174
"2021","Eastbourne 008","E02004363",3266,1384,591,793,1666,286,759,305,334,120,344,223,113,8,244,165,79,33,33,216,54,162
"2021","Eastbourne 009","E02004364",3870,1550,864,686,2103,380,950,346,465,139,401,224,148,29,353,216,137,19,19,217,67,150
"2021","Eastbourne 010","E02004365",4020,1733,402,1331,1864,81,640,247,314,79,577,359,196,22,506,371,135,60,60,423,90,333
"2021","Eastbourne 011","E02004366",4042,2117,984,1133,1685,346,584,284,259,41,424,331,85,8,295,173,122,36,36,240,46,194
"2021","Eastbourne 012","E02004367",3329,1401,980,421,1781,702,683,330,239,114,221,140,68,13,159,102,57,16,16,147,32,115
"2021","Eastbourne 013","E02006857",3939,1237,698,539,2487,498,1118,403,504,211,444,209,195,40,413,248,165,14,14,215,80,135
"2021","Eastbourne 014","E02006858",3269,1094,531,563,2010,527,770,358,246,166,343,217,109,17,357,225,132,13,13,165,58,107
"2021","Hastings 001","E02004368",3349,896,418,478,2231,318,1188,401,523,264,398,169,193,36,314,195,119,13,13,222,105,117
"2021","Hastings 002","E02004369",4346,1220,832,388,2877,789,1343,561,499,283,426,207,187,32,306,156,150,13,13,249,110,139
"2021","Hastings 003","E02004370",3262,954,444,510,2055,201,801,291,346,164,434,150,251,33,604,378,226,15,15,253,135,118
"2021","Hastings 004","E02004371",2968,829,395,434,1940,268,746,283,338,125,427,168,223,36,478,326,152,21,21,199,88,111
"2021","Hastings 005","E02004372",2919,898,351,547,1797,155,651,232,300,119,391,149,210,32,585,424,161,15,15,224,119,105
"2021","Hastings 006","E02004373",3650,1109,545,564,2259,326,1000,344,451,205,458,207,218,33,455,276,179,20,20,282,118,164
"2021","Hastings 007","E02004374",3326,1199,512,687,1885,244,782,324,302,156,471,258,169,44,376,235,141,12,12,242,87,155
"2021","Hastings 008","E02004375",3915,1572,564,1008,2068,233,873,383,356,134,515,302,176,37,422,274,148,25,25,275,98,177
"2021","Hastings 009","E02004376",3576,1748,523,1225,1561,123,529,247,216,66,497,315,163,19,378,247,131,34,34,267,67,200
"2021","Hastings 010","E02004377",4496,1440,654,786,2766,453,1275,500,534,241,568,311,232,25,444,283,161,26,26,290,115,175
"2021","Hastings 011","E02004378",4653,2576,792,1784,1828,117,628,324,245,59,553,391,153,9,496,335,161,34,34,249,59,190
"2021","Lewes 001","E02004379",3127,735,409,326,2243,477,1187,419,560,208,313,158,143,12,260,156,104,6,6,149,57,92
"2021","Lewes 002","E02004380",3937,1018,648,370,2707,597,1467,557,676,234,377,206,144,27,252,132,120,14,14,212,72,140
"2021","Lewes 003","E02004381",4385,1642,781,861,2509,369,1133,419,535,179,501,283,181,37,491,316,175,15,15,234,66,168
"2021","Lewes 004","E02004382",2782,778,506,272,1879,421,918,333,424,161,286,137,124,25,242,149,93,12,12,125,39,86
"2021","Lewes 005","E02004383",3004,907,520,387,1935,311,974,311,513,150,313,149,142,22,328,209,119,9,9,162,48,114
"2021","Lewes 006","E02004384",3168,962,561,401,2004,344,990,342,443,205,343,176,142,25,314,168,146,13,13,202,73,129
"2021","Lewes 007","E02004385",3421,1089,641,448,2117,422,994,400,392,202,350,180,151,19,335,207,128,16,16,215,84,131
"2021","Lewes 008","E02004386",2985,955,516,439,1868,326,783,307,322,154,364,187,156,21,381,256,125,14,14,162,50,112
"2021","Lewes 009","E02004387",2412,679,302,377,1556,147,679,242,327,110,332,138,170,24,389,281,108,9,9,177,91,86
"2021","Lewes 010","E02004388",3372,1019,538,481,2120,332,945,369,390,186,371,176,161,34,456,276,180,16,16,233,92,141
"2021","Lewes 011","E02004389",4170,1205,849,356,2764,873,1214,544,433,237,397,220,146,31,272,148,124,8,8,201,75,126
"2021","Lewes 012","E02004390",3536,1011,719,292,2340,725,1005,398,408,199,319,148,151,20,280,164,116,11,11,185,72,113
"2021","Lewes 013","E02004391",3382,1537,835,702,1703,366,668,296,245,127,367,236,117,14,293,182,111,9,9,142,28,114
"2021","Rother 001","E02004392",3783,999,586,413,2603,495,1373,511,610,252,378,203,147,28,348,218,130,9,9,181,82,99
"2021","Rother 002","E02004393",2892,852,547,305,1883,537,857,426,277,154,258,122,114,22,217,119,98,14,14,157,53,104
"2021","Rother 003","E02004394",3301,829,480,349,2269,557,1155,502,417,236,316,169,117,30,235,129,106,6,6,203,83,120
"2021","Rother 004","E02004395",3637,1319,790,529,2118,527,878,424,288,166,367,199,135,33,339,195,144,7,7,200,77,123
"2021","Rother 005","E02004396",4016,1043,698,345,2731,850,1253,593,406,254,355,174,146,35,265,123,142,8,8,242,101,141
"2021","Rother 006","E02004397",3396,943,569,374,2270,492,1068,407,478,183,343,171,145,27,349,221,128,18,18,183,77,106
"2021","Rother 007","E02004398",3931,1261,643,618,2449,312,967,344,427,196,513,218,255,40,643,416,227,14,14,221,114,107
"2021","Rother 008","E02004399",3687,1297,848,449,2195,616,936,403,350,183,314,170,124,20,316,165,151,13,13,195,82,113
"2021","Rother 009","E02004400",4880,1398,1013,385,3216,1249,1350,692,382,276,343,209,104,30,264,128,136,10,10,266,100,166
"2021","Rother 010","E02004401",3806,1384,998,386,2270,826,918,434,267,217,268,169,84,15,247,127,120,11,11,152,53,99
"2021","Rother 011","E02004402",4776,2389,1212,1177,2158,404,703,374,235,94,485,288,165,32,534,355,179,32,32,229,81,148
"2021","Wealden 001","E02004403",2679,725,413,312,1768,351,917,292,423,202,214,110,87,17,277,163,114,9,9,186,84,102
"2021","Wealden 002","E02004404",2627,617,346,271,1875,382,1072,402,494,176,255,139,94,22,154,75,79,12,12,135,53,82
"2021","Wealden 003","E02004405",2487,635,412,223,1735,412,875,284,417,174,211,102,91,18,225,142,83,12,12,117,54,63
"2021","Wealden 004","E02004406",3094,807,503,304,2148,626,1079,441,432,206,247,142,89,16,187,102,85,9,9,139,52,87
"2021","Wealden 005","E02004407",3469,976,591,385,2367,531,1308,530,570,208,274,158,97,19,247,128,119,7,7,126,47,79
"2021","Wealden 006","E02004408",3354,895,430,465,2298,326,1197,394,585,218,417,230,154,33,341,184,157,17,17,161,54,107
"2021","Wealden 007","E02004409",2154,505,291,214,1501,357,850,346,344,160,173,100,56,17,114,51,63,7,7,148,50,98
"2021","Wealden 008","E02004410",3318,776,469,307,2370,563,1312,555,507,250,299,164,114,21,185,97,88,11,11,172,67,105
"2021","Wealden 009","E02004411",3705,1130,666,464,2400,415,1200,445,553,202,400,217,154,29,367,213,154,18,18,175,76,99
"2021","Wealden 010","E02004412",3561,1115,615,500,2297,474,1180,428,527,225,359,205,132,22,274,158,116,10,10,149,59,90
"2021","Wealden 011","E02004413",3093,813,470,343,2143,464,1123,448,457,218,328,183,129,16,218,113,105,10,10,137,55,82
"2021","Wealden 012","E02004414",2751,748,325,423,1886,260,980,338,451,191,341,198,128,15,297,178,119,8,8,117,33,84
"2021","Wealden 013","E02004415",2747,627,343,284,1973,431,1050,458,392,200,286,149,119,18,202,127,75,4,4,147,56,91
"2021","Wealden 014","E02004416",2758,680,412,268,1921,468,971,412,348,211,269,149,102,18,205,130,75,8,8,157,63,94
"2021","Wealden 015","E02004417",2897,909,563,346,1870,405,879,330,382,167,343,198,127,18,234,134,100,9,9,118,44,74
"2021","Wealden 016","E02004418",2476,731,459,272,1615,324,763,281,318,164,262,134,106,22,258,168,90,8,8,130,50,80
"2021","Wealden 017","E02004419",2729,848,442,406,1746,277,741,292,302,147,342,155,168,19,362,231,131,24,24,135,56,79
"2021","Wealden 018","E02004420",5890,1539,896,643,4046,985,1896,801,798,297,654,373,251,30,496,307,189,15,15,305,122,183
"2021","Wealden 019","E02004421",4207,1348,775,573,2688,545,1216,488,519,209,486,267,198,21,419,255,164,22,22,171,75,96
"2021","Wealden 020","E02004422",4769,1238,765,473,3289,713,1608,636,670,302,545,284,227,34,407,233,174,16,16,242,94,148
"2021","Wealden 021","E02004423",3503,1080,751,329,2287,676,1080,461,395,224,309,178,107,24,214,103,111,8,8,136,55,81
"2021","Basingstoke and Deane 001","E02004675",3217,878,450,428,2188,352,1116,369,527,220,388,198,171,19,322,181,141,10,10,151,62,89
"2021","Basingstoke and Deane 002","E02004676",3400,899,464,435,2328,503,1264,472,546,246,351,207,124,20,194,101,93,16,16,173,74,99
"2021","Basingstoke and Deane 003","E02004677",2914,537,296,241,2211,442,1273,476,582,215,276,153,103,20,214,120,94,6,6,166,62,104
"2021","Basingstoke and Deane 004","E02004678",3227,846,446,400,2215,412,1247,514,527,206,322,189,106,27,223,126,97,11,11,166,54,112
"2021","Basingstoke and Deane 005","E02004679",4481,950,389,561,3358,419,1843,690,918,235,689,423,241,25,383,263,120,24,24,173,75,98
"2021","Basingstoke and Deane 006","E02004680",3314,831,234,597,2362,211,1361,463,708,190,507,348,146,13,270,196,74,13,13,121,48,73
"2021","Basingstoke and Deane 007","E02004681",5782,1493,426,1067,3813,255,1795,497,1038,260,923,493,382,48,783,536,247,57,57,476,202,274
"2021","Basingstoke and Deane 008","E02004682",3389,883,307,576,2310,247,1257,425,610,222,447,242,180,25,337,205,132,22,22,196,71,125
"2021","Basingstoke and Deane 009","E02004683",3422,1057,373,684,2099,187,1018,324,497,197,454,268,158,28,411,247,164,29,29,266,103,163
"2021","Basingstoke and Deane 010","E02004684",4593,1199,332,867,3056,285,1549,476,830,243,681,373,275,33,508,326,182,33,33,338,122,216
"2021","Basingstoke and Deane 011","E02004685",3782,1517,395,1122,2035,197,1020,367,505,148,526,418,95,13,254,133,121,38,38,230,62,168
"2021","Basingstoke and Deane 012","E02004686",3856,1291,400,891,2205,196,1075,343,565,167,539,380,141,18,352,222,130,43,43,360,119,241
"2021","Basingstoke and Deane 013","E02004687",2877,650,251,399,1984,214,895,276,456,163,452,195,218,39,405,274,131,18,18,243,102,141
"2021","Basingstoke and Deane 014","E02004688",3413,1091,467,624,2096,262,917,326,407,184,434,194,203,37,445,268,177,38,38,226,93,133
"2021","Basingstoke and Deane 015","E02004689",2385,536,343,193,1745,476,921,344,397,180,201,117,74,10,141,72,69,6,6,104,49,55
"2021","Basingstoke and Deane 016","E02004690",3343,897,346,551,2242,314,1186,401,552,233,427,238,160,29,291,163,128,24,24,204,67,137
"2021","Basingstoke and Deane 017","E02004691",3347,852,489,363,2373,526,1375,560,571,244,267,159,94,14,195,99,96,10,10,122,46,76
"2021","Basingstoke and Deane 018","E02004692",3020,685,504,181,2211,617,1258,452,528,278,198,92,88,18,134,60,74,4,4,124,53,71
"2021","Basingstoke and Deane 019","E02004693",3188,971,396,575,2028,188,960,310,461,189,440,229,180,31,421,261,160,19,19,189,69,120
"2021","Basingstoke and Deane 020","E02004694",3190,894,429,465,2157,362,1188,426,581,181,378,213,155,10,221,130,91,8,8,139,46,93
"2021","Basingstoke and Deane 021","E02004695",3331,639,157,482,2551,182,1624,509,849,266,436,245,177,14,295,193,102,14,14,141,67,74
"2021","Basingstoke and Deane 022","E02004696",3193,813,406,407,2261,399,1217,418,613,186,406,238,145,23,232,139,93,7,7,119,37,82
"2021","East Hampshire 001","E02004697",2670,578,303,275,1974,376,1125,419,547,159,256,152,92,12,206,116,90,11,11,118,46,72
"2021","East Hampshire 002","E02004698",2976,1117,529,588,1721,199,764,242,380,142,371,231,118,22,368,244,124,19,19,138,48,90
"2021","East Hampshire 003","E02004699",4708,1370,695,675,3160,656,1636,579,748,309,472,288,160,24,376,193,183,20,20,178,67,111
"2021","East Hampshire 004","E02004700",2755,642,202,440,1962,122,1000,341,528,131,509,287,202,20,307,196,111,24,24,151,55,96
"2021","East Hampshire 006","E02004702",3323,891,369,522,2231,271,1171,449,507,215,458,233,196,29,313,175,138,18,18,201,71,130
"2021","East Hampshire 007","E02004703",5028,945,503,442,3805,863,2176,846,940,390,435,239,166,30,318,201,117,13,13,278,106,172
"2021","East Hampshire 008","E02004704",2590,620,339,281,1815,314,1004,387,427,190,302,181,93,28,184,105,79,11,11,155,57,98
"2021","East Hampshire 009","E02004705",4056,1133,624,509,2741,531,1492,468,793,231,366,199,148,19,336,208,128,16,16,182,68,114
"2021","East Hampshire 010","E02004706",3111,810,443,367,2174,430,1193,439,561,193,303,181,98,24,235,137,98,13,13,127,45,82
"2021","East Hampshire 011","E02004707",4649,1204,663,541,3282,745,1826,674,839,313,385,225,133,27,310,162,148,16,16,163,61,102
"2021","East Hampshire 012","E02004708",4359,1521,788,733,2680,415,1323,427,684,212,466,270,179,17,457,280,177,19,19,158,47,111
"2021","East Hampshire 013","E02004709",3587,782,441,341,2660,518,1469,566,649,254,388,196,169,23,277,166,111,8,8,145,51,94
"2021","East Hampshire 014","E02004710",2705,633,353,280,1931,401,1074,398,469,207,259,143,92,24,188,97,91,9,9,141,53,88
"2021","East Hampshire 016","E02006829",3210,897,497,400,2213,495,1199,499,486,214,292,169,107,16,211,128,83,16,16,100,40,60
"2021","East Hampshire 017","E02006838",3000,773,501,272,2095,536,1114,441,463,210,258,165,80,13,177,90,87,10,10,132,46,86
"2021","Eastleigh 001","E02004712",3415,689,477,212,2579,660,1488,391,873,224,202,110,84,8,220,146,74,9,9,147,46,101
"2021","Eastleigh 002","E02004713",3269,768,466,302,2367,480,1303,409,649,245,301,146,133,22,268,147,121,15,15,134,60,74
"2021","Eastleigh 003","E02004714",3336,971,557,414,2235,489,1180,452,531,197,321,196,115,10,232,125,107,13,13,130,35,95
"2021","Eastleigh 004","E02004715",3874,1137,517,620,2517,320,1251,442,595,214,529,309,201,19,394,263,131,23,23,220,69,151
"2021","Eastleigh 005","E02004716",3605,903,464,439,2545,397,1306,464,591,251,468,235,198,35,362,209,153,12,12,157,60,97
"2021","Eastleigh 006","E02004717",5226,1398,512,886,3466,270,1590,511,829,250,838,421,366,51,731,509,222,37,37,362,142,220
"2021","Eastleigh 007","E02004718",3835,1274,371,903,2247,163,997,374,463,160,587,356,208,23,462,292,170,38,38,314,85,229
"2021","Eastleigh 008","E02004719",4617,997,511,486,3422,550,1845,629,866,350,648,356,261,31,370,222,148,9,9,198,84,114
"2021","Eastleigh 009","E02004720",5033,1565,743,822,3270,625,1643,653,684,306,619,401,189,29,364,205,159,19,19,198,81,117
"2021","Eastleigh 010","E02004721",4456,874,274,600,3385,246,1926,528,1160,238,688,396,273,19,512,388,124,13,13,197,83,114
"2021","Eastleigh 011","E02004722",3060,986,557,429,1961,348,1001,337,464,200,333,175,143,15,275,162,113,4,4,113,52,61
"2021","Eastleigh 012","E02004723",4082,984,539,445,2932,587,1531,537,747,247,485,267,185,33,321,186,135,8,8,166,64,102
"2021","Eastleigh 013","E02004724",3978,964,385,579,2785,346,1363,502,651,210,627,342,248,37,437,293,144,12,12,229,83,146
"2021","Eastleigh 014","E02004725",2449,840,425,415,1509,264,711,268,315,128,282,155,110,17,238,140,98,14,14,100,42,58
"2021","Eastleigh 015","E02004726",2703,758,365,393,1831,340,884,388,371,125,340,201,114,25,248,160,88,19,19,114,35,79
"2021","Fareham 001","E02004727",3859,663,260,403,3012,383,1796,560,982,254,476,261,197,18,347,222,125,10,10,184,74,110
"2021","Fareham 002","E02004728",3803,1020,519,501,2591,407,1388,469,677,242,433,255,149,29,352,227,125,11,11,192,64,128
"2021","Fareham 003","E02004729",3073,829,429,400,2083,358,979,359,406,214,378,188,161,29,356,197,159,12,12,161,52,109
"2021","Fareham 004","E02004730",3600,884,547,337,2541,612,1384,553,564,267,352,210,118,24,187,89,98,6,6,175,72,103
"2021","Fareham 005","E02004731",3270,899,527,372,2230,443,1270,485,552,233,307,172,116,19,200,106,94,10,10,141,50,91
"2021","Fareham 006","E02004732",3713,932,515,417,2619,501,1423,501,667,255,387,215,159,13,299,179,120,9,9,162,49,113
"2021","Fareham 007","E02004733",3431,917,437,480,2382,423,1264,488,548,228,398,244,140,14,278,165,113,19,19,132,50,82
"2021","Fareham 008","E02004734",4493,1400,672,728,2868,530,1430,535,631,264,536,334,168,34,348,203,145,24,24,225,78,147
"2021","Fareham 009","E02004735",3259,821,521,300,2326,612,1269,533,506,230,267,152,93,22,169,80,89,9,9,112,39,73
"2021","Fareham 010","E02004736",3525,899,585,314,2464,582,1254,507,501,246,377,215,138,24,239,138,101,12,12,162,56,106
"2021","Fareham 011","E02004737",3378,1158,528,630,2045,223,900,306,436,158,475,268,168,39,435,278,157,12,12,175,55,120
"2021","Fareham 012","E02004738",3172,896,568,328,2122,408,1095,438,428,229,323,175,123,25,290,136,154,6,6,154,61,93
"2021","Fareham 013","E02004739",2926,864,651,213,1931,564,971,424,347,200,193,92,82,19,201,103,98,2,2,131,60,71
"2021","Fareham 014","E02004740",3134,828,583,245,2215,644,1156,457,483,216,210,122,78,10,200,111,89,5,5,91,36,55
"2021","Gosport 001","E02004741",3150,885,550,335,2051,395,990,399,392,199,335,147,166,22,316,163,153,15,15,214,87,127
"2021","Gosport 002","E02004742",3148,1057,540,517,1905,342,928,385,357,186,314,146,143,25,305,166,139,16,16,186,67,119
"2021","Gosport 003","E02004743",3104,818,449,369,2111,306,1083,431,431,221,397,204,167,26,310,184,126,15,15,175,80,95
"2021","Gosport 004","E02004744",3798,934,256,678,2589,136,1140,362,636,142,571,251,284,36,710,542,168,32,32,275,142,133
"2021","Gosport 005","E02004745",3807,1276,470,806,2332,259,1011,441,379,191,559,296,227,36,479,318,161,24,24,199,79,120
"2021","Gosport 006","E02004746",4863,1439,895,544,3257,771,1671,658,727,286,412,215,177,20,392,253,139,11,11,167,69,98
"2021","Gosport 007","E02004747",2859,968,417,551,1760,266,788,329,321,138,381,233,130,18,300,177,123,25,25,131,43,88
"2021","Gosport 008","E02004748",4795,2113,757,1356,2465,287,864,420,314,130,600,354,221,25,679,472,207,35,35,217,72,145
"2021","Gosport 009","E02004749",3044,864,582,282,2064,545,1089,415,468,206,239,106,114,19,187,104,83,4,4,116,45,71
"2021","Gosport 010","E02004750",3357,1091,550,541,2108,426,1023,438,394,191,348,191,137,20,296,165,131,15,15,158,54,104
"2021","Hart 001","E02004751",3533,891,550,341,2480,519,1253,407,591,255,375,192,154,29,322,160,162,11,11,162,66,96
"2021","Hart 002","E02004752",3196,710,368,342,2347,459,1336,428,649,259,297,143,124,30,248,123,125,7,7,139,59,80
"2021","Hart 003","E02004753",4302,967,511,456,3043,529,1530,466,718,346,550,302,208,40,414,225,189,20,20,292,118,174
"2021","Hart 004","E02004754",3087,857,490,367,2124,407,1174,413,579,182,294,167,105,22,240,147,93,9,9,106,36,70
"2021","Hart 005","E02004755",5154,1566,594,972,3356,354,1932,549,1128,255,664,432,212,20,369,245,124,37,37,232,73,159
"2021","Hart 006","E02004756",3882,884,359,525,2849,361,1626,505,870,251,505,312,175,18,342,215,127,15,15,149,63,86
"2021","Hart 007","E02004757",3165,687,460,227,2365,582,1426,402,753,271,174,95,65,14,177,84,93,6,6,113,45,68
"2021","Hart 008","E02004758",3728,915,443,472,2647,494,1544,476,813,255,292,158,117,17,306,180,126,11,11,166,58,108
"2021","Hart 009","E02004759",3314,837,485,352,2336,423,1352,370,764,218,320,189,116,15,230,127,103,11,11,141,58,83
"2021","Hart 010","E02004760",4058,838,342,496,3037,342,1764,516,1011,237,504,278,206,20,411,304,107,16,16,183,90,93
"2021","Hart 011","E02004761",2549,684,344,340,1779,321,1007,369,507,131,244,143,83,18,199,138,61,8,8,86,30,56
"2021","Havant 003","E02004764",3657,1058,662,396,2400,618,1160,518,388,254,351,197,121,33,263,138,125,8,8,199,66,133
"2021","Havant 004","E02004765",2712,806,397,409,1797,385,890,351,359,180,334,189,120,25,183,104,79,5,5,109,43,66
"2021","Havant 005","E02004766",2979,968,502,466,1802,238,841,305,355,181,345,160,165,20,352,226,126,26,26,209,90,119
"2021","Havant 006","E02004767",2261,631,290,341,1505,134,637,215,286,136,343,134,176,33,376,239,137,15,15,125,62,63
"2021","Havant 007","E02004768",2250,668,317,351,1448,194,718,272,311,135,270,146,110,14,258,150,108,8,8,134,66,68
"2021","Havant 008","E02004769",2487,618,263,355,1692,119,655,225,285,145,392,167,190,35,506,345,161,20,20,177,89,88
"2021","Havant 009","E02004770",2821,866,402,464,1780,170,724,257,300,167,412,159,213,40,460,304,156,14,14,175,70,105
"2021","Havant 010","E02004771",3662,1029,457,572,2382,216,992,369,423,200,507,219,240,48,639,416,223,28,28,251,111,140
"2021","Havant 011","E02004772",3989,1105,626,479,2669,492,1445,594,549,302,416,214,177,25,307,166,141,9,9,215,95,120
"2021","Havant 013","E02004774",4674,1514,976,538,2977,787,1411,602,577,232,409,239,145,25,357,196,161,13,13,183,64,119
"2021","Havant 014","E02004775",4615,1492,769,723,2899,549,1422,568,608,246,540,308,198,34,374,224,150,14,14,224,87,137
"2021","Havant 015","E02004776",2635,707,472,235,1784,574,816,403,251,162,212,121,76,15,173,88,85,9,9,144,68,76
"2021","Havant 016","E02004777",2598,1003,626,377,1491,469,589,282,185,122,210,114,80,16,215,133,82,8,8,104,36,68
"2021","Havant 017","E02004778",2959,1009,608,401,1810,512,776,392,236,148,279,165,98,16,231,136,95,12,12,140,42,98
"2021","Havant 018","E02006822",3812,934,523,411,2651,470,1326,523,523,280,491,266,191,34,349,184,165,15,15,227,99,128
"2021","Havant 019","E02006830",2795,848,366,482,1784,264,771,266,350,155,347,152,168,27,390,269,121,12,12,163,73,90
"2021","Havant 020","E02006831",2687,705,487,218,1864,459,931,361,367,203,277,145,104,28,188,113,75,9,9,118,51,67
"2021","New Forest 001","E02004779",4863,1413,824,589,3229,805,1606,690,630,286,498,310,164,24,302,177,125,18,18,221,78,143
"2021","New Forest 002","E02004780",2505,717,380,337,1655,271,794,292,329,173,302,142,134,26,273,149,124,15,15,133,50,83
"2021","New Forest 003","E02004781",3330,887,360,527,2304,310,1227,424,539,264,436,247,174,15,320,189,131,11,11,139,69,70
"2021","New Forest 004","E02004782",3455,1105,586,519,2190,374,1005,386,418,201,424,226,168,30,367,241,126,20,20,160,67,93
"2021","New Forest 005","E02004783",2994,786,376,410,2084,287,1103,406,504,193,387,208,156,23,297,173,124,10,10,124,41,83
"2021","New Forest 006","E02004784",2279,524,348,176,1625,444,890,363,339,188,175,97,57,21,112,56,56,4,4,130,52,78
"2021","New Forest 007","E02004785",2404,651,380,271,1603,436,799,344,304,151,231,157,57,17,132,65,67,5,5,150,52,98
"2021","New Forest 008","E02004786",3517,963,386,577,2415,363,1283,489,584,210,420,243,157,20,334,207,127,15,15,139,59,80
"2021","New Forest 009","E02004787",3451,1110,709,401,2223,645,1029,453,391,185,318,189,117,12,221,125,96,10,10,118,44,74
"2021","New Forest 010","E02004788",2898,632,393,239,2108,481,1157,436,506,215,247,133,94,20,216,124,92,7,7,158,62,96
"2021","New Forest 011","E02004789",4377,1153,697,456,2985,601,1475,566,633,276,435,201,202,32,450,276,174,24,24,239,87,152
"2021","New Forest 012","E02004790",3695,1296,713,583,2219,417,925,324,434,167,457,254,176,27,402,223,179,18,18,180,78,102
"2021","New Forest 013","E02004791",2225,510,294,216,1585,248,718,292,286,140,266,96,146,24,340,229,111,13,13,130,62,68
"2021","New Forest 014","E02004792",3744,1054,638,416,2489,619,1227,561,437,229,361,194,146,21,272,145,127,10,10,201,81,120
"2021","New Forest 015","E02004793",3098,821,582,239,2133,604,1119,447,447,225,209,110,81,18,191,94,97,10,10,144,67,77
"2021","New Forest 016","E02004794",2876,685,441,244,2048,500,1119,463,446,210,220,115,97,8,204,116,88,5,5,143,46,97
"2021","New Forest 017","E02004795",4073,1499,878,621,2421,676,1114,511,425,178,349,221,100,28,266,144,122,16,16,153,65,88
"2021","New Forest 018","E02004796",4309,1126,810,316,2970,972,1350,588,489,273,369,188,148,33,265,127,138,14,14,213,72,141
"2021","New Forest 019","E02004797",3669,1164,625,539,2323,425,1076,448,456,172,417,235,147,35,393,239,154,12,12,182,66,116
"2021","New Forest 020","E02004798",2673,845,427,418,1715,334,738,255,309,174,289,141,121,27,334,196,138,20,20,113,50,63
"2021","New Forest 021","E02004799",3831,1453,918,535,2195,622,879,361,351,167,351,203,122,26,330,194,136,13,13,183,58,125
"2021","New Forest 022","E02004800",3543,1098,780,318,2306,1008,952,509,247,196,184,114,51,19,148,61,87,14,14,139,36,103
"2021","New Forest 023","E02004801",3747,1243,915,328,2357,958,989,488,335,166,222,134,74,14,178,87,91,10,10,147,39,108
"2021","Rushmoor 001","E02004802",2546,604,292,312,1675,201,803,255,338,210,293,123,141,29,367,205,162,11,11,267,122,145
"2021","Rushmoor 002","E02004803",2649,623,274,349,1649,123,803,196,374,233,271,99,145,27,437,263,174,15,15,377,169,208
"2021","Rushmoor 003","E02004804",2821,638,290,348,1965,303,1045,331,479,235,334,182,131,21,265,129,136,18,18,218,92,126
"2021","Rushmoor 004","E02004805",3506,896,401,495,2372,369,1371,457,693,221,358,237,103,18,256,134,122,18,18,238,86,152
"2021","Rushmoor 005","E02004806",3180,724,280,444,2274,279,1326,414,669,243,411,234,152,25,248,140,108,10,10,182,81,101
"2021","Rushmoor 006","E02004807",3927,1160,498,662,2478,314,1267,392,606,269,455,254,182,19,427,264,163,15,15,289,128,161
"2021","Rushmoor 007","E02004808",4930,1579,462,1117,3072,234,1677,493,945,239,657,411,218,28,466,314,152,38,38,279,88,191
"2021","Rushmoor 008","E02004809",3984,964,173,791,2647,139,1527,408,939,180,544,347,183,14,400,301,99,37,37,373,181,192
"2021","Rushmoor 009","E02004810",3207,866,281,585,2026,149,981,297,479,205,448,234,196,18,419,259,160,29,29,315,141,174
"2021","Rushmoor 010","E02004811",3426,1174,478,696,1953,247,1028,361,451,216,348,201,133,14,305,168,137,25,25,299,115,184
"2021","Rushmoor 011","E02004812",2569,557,190,367,1788,240,1013,310,469,234,286,170,97,19,227,127,100,22,22,224,104,120
"2021","Rushmoor 012","E02004813",2560,718,337,381,1618,159,786,230,368,188,305,142,138,25,353,186,167,15,15,224,102,122
"2021","Test Valley 001","E02004814",2945,697,345,352,2106,362,1230,478,531,221,298,187,98,13,203,101,102,13,13,142,56,86
"2021","Test Valley 002","E02004815",2861,745,251,494,1852,124,774,268,358,148,435,184,216,35,501,332,169,18,18,264,98,166
"2021","Test Valley 004","E02004817",3314,1066,508,558,2067,272,982,376,435,171,436,260,151,25,359,221,138,18,18,181,62,119
"2021","Test Valley 005","E02004818",4160,1109,586,523,2813,563,1548,533,700,315,400,232,135,33,281,167,114,21,21,238,84,154
"2021","Test Valley 006","E02004819",3378,998,467,531,2206,401,1144,449,487,208,392,240,130,22,249,154,95,20,20,174,62,112
"2021","Test Valley 007","E02004820",2946,620,334,286,2191,393,1282,535,570,177,296,177,103,16,212,129,83,8,8,135,49,86
"2021","Test Valley 008","E02004821",2203,510,318,192,1609,401,907,378,385,144,184,123,53,8,107,53,54,10,10,84,19,65
"2021","Test Valley 009","E02004822",3387,783,434,349,2440,531,1374,592,550,232,332,199,119,14,197,99,98,6,6,164,66,98
"2021","Test Valley 010","E02004823",3861,1130,624,506,2602,634,1305,445,619,241,366,221,126,19,290,170,120,7,7,129,49,80
"2021","Test Valley 011","E02004824",3046,1374,863,511,1563,408,635,279,234,122,277,180,85,12,232,126,106,11,11,109,29,80
"2021","Test Valley 012","E02004825",4625,1191,701,490,3266,727,1772,644,812,316,422,225,176,21,327,201,126,18,18,168,62,106
"2021","Test Valley 013","E02004826",3927,858,423,435,2869,546,1553,555,765,233,436,254,154,28,325,188,137,9,9,200,77,123
"2021","Test Valley 014","E02004827",2826,512,226,286,2210,284,1413,427,733,253,286,167,105,14,218,130,88,9,9,104,48,56
"2021","Test Valley 015","E02004828",2924,647,368,279,2124,457,1147,438,507,202,317,173,125,19,191,116,75,12,12,153,75,78
"2021","Test Valley 016","E02007076",2991,680,121,559,2120,109,1139,370,658,111,543,300,229,14,313,231,82,16,16,191,85,106
"2021","Test Valley 017","E02007077",2849,597,126,471,2101,106,1028,291,639,98,588,298,273,17,362,280,82,17,17,151,64,87
"2021","Test Valley 018","E02007078",2458,944,443,501,1390,223,624,271,247,106,298,185,104,9,225,141,84,20,20,124,40,84
"2021","Winchester 001","E02004829",2397,534,273,261,1776,325,1076,368,544,164,221,134,81,6,153,100,53,1,1,87,38,49
"2021","Winchester 002","E02004830",2791,687,367,320,1984,356,1150,417,571,162,284,172,100,12,190,114,76,4,4,120,38,82
"2021","Winchester 003","E02004831",3891,900,574,326,2817,577,1618,483,913,222,339,199,130,10,272,177,95,11,11,174,55,119
"2021","Winchester 004","E02004832",3754,1116,722,394,2505,620,1305,503,573,229,309,187,99,23,265,141,124,6,6,133,41,92
"2021","Winchester 005","E02004833",3608,931,465,466,2423,391,1413,419,802,192,329,196,119,14,268,169,99,22,22,254,65,189
"2021","Winchester 006","E02004834",3344,1241,536,705,1789,209,803,313,359,131,406,243,139,24,336,207,129,35,35,314,41,273
"2021","Winchester 007","E02004835",4657,1977,768,1209,2397,326,1226,472,644,110,557,447,95,15,256,151,105,32,32,283,21,262
"2021","Winchester 008","E02004836",2228,568,270,298,1187,140,562,167,271,124,196,70,112,14,271,175,96,18,18,473,42,431
"2021","Winchester 009","E02004837",3339,788,441,347,2336,441,1311,444,677,190,309,204,95,10,263,158,105,12,12,215,53,162
"2021","Winchester 010","E02004838",3964,993,560,433,2806,554,1634,523,871,240,350,208,118,24,254,155,99,14,14,165,57,108
"2021","Winchester 011","E02004839",3663,782,460,322,2713,591,1559,636,665,258,324,177,128,19,230,146,84,9,9,168,61,107
"2021","Winchester 012","E02004840",4485,1334,728,606,2972,636,1566,572,746,248,464,276,165,23,297,172,125,9,9,179,67,112
"2021","Winchester 013","E02004841",4929,1343,557,786,3348,442,1825,694,849,282,635,382,223,30,412,282,130,34,34,238,82,156
"2021","Winchester 014","E02004842",4658,1137,559,578,3315,533,1791,688,806,297,584,324,238,22,390,256,134,17,17,206,81,125
"2021","Ashford 001","E02004996",3492,940,524,416,2376,408,1229,442,599,188,378,194,169,15,349,213,136,12,12,176,70,106
"2021","Ashford 002","E02004997",3435,878,505,373,2392,551,1223,489,489,245,360,202,126,32,246,137,109,12,12,165,69,96
"2021","Ashford 003","E02004998",2713,638,386,252,1936,369,1032,326,481,225,271,133,122,16,255,143,112,9,9,139,69,70
"2021","Ashford 005","E02005000",4961,1551,404,1147,2952,238,1312,408,662,242,714,393,291,30,636,447,189,52,52,458,161,297
"2021","Ashford 006","E02005001",3789,896,454,442,2669,432,1411,493,650,268,454,205,215,34,360,207,153,12,12,224,94,130
"2021","Ashford 007","E02005002",4078,1167,503,664,2609,256,1112,353,533,226,581,273,278,30,632,448,184,28,28,302,140,162
"2021","Ashford 008","E02005003",3288,759,293,466,2235,162,1070,280,562,228,487,173,267,47,490,344,146,26,26,294,155,139
"2021","Ashford 009","E02005004",4478,978,369,609,3201,263,1732,499,902,331,666,315,297,54,513,360,153,27,27,299,121,178
"2021","Ashford 010","E02005005",4124,872,416,456,3025,498,1683,626,825,232,510,276,208,26,325,211,114,9,9,227,108,119
"2021","Ashford 011","E02005006",2501,568,303,265,1792,431,907,345,390,172,236,123,92,21,212,121,91,6,6,141,57,84
"2021","Ashford 012","E02005007",3818,943,500,443,2649,516,1358,499,625,234,443,227,182,34,322,203,119,10,10,226,96,130
"2021","Ashford 013","E02005008",4105,1337,860,477,2605,769,1106,488,405,213,356,183,141,32,357,203,154,17,17,163,56,107
"2021","Ashford 014","E02005009",2503,649,394,255,1724,398,879,348,351,180,245,116,105,24,191,117,74,11,11,130,64,66
"2021","Ashford 015","E02007046",2926,916,453,463,1810,313,793,235,381,177,315,156,137,22,375,250,125,14,14,200,88,112
"2021","Ashford 016","E02007047",3366,769,254,515,2335,186,1231,318,711,202,530,277,229,24,367,260,107,21,21,262,125,137
"2021","Canterbury 001","E02005010",3671,1663,663,1000,1823,261,717,283,307,127,371,216,142,13,457,338,119,17,17,185,69,116
"2021","Canterbury 002","E02005011",3336,972,681,291,2178,698,998,435,343,220,276,129,126,21,200,106,94,6,6,186,77,109
"2021","Canterbury 003","E02005012",3804,1154,688,466,2443,509,1110,368,470,272,385,187,167,31,424,249,175,15,15,207,81,126
"2021","Canterbury 004","E02005013",3663,1184,706,478,2270,533,988,411,359,218,364,156,171,37,372,197,175,13,13,209,90,119
"2021","Canterbury 005","E02005014",3731,976,685,291,2581,795,1256,531,477,248,293,160,106,27,227,107,120,10,10,174,73,101
"2021","Canterbury 006","E02005015",3825,905,482,423,2710,471,1379,468,658,253,460,212,221,27,389,245,144,11,11,210,94,116
"2021","Canterbury 007","E02005016",3429,1060,628,432,2203,440,1041,378,457,206,362,183,157,22,346,199,147,14,14,166,67,99
"2021","Canterbury 008","E02005017",3167,1175,515,660,1841,315,795,331,345,119,409,257,129,23,311,192,119,11,11,151,50,101
"2021","Canterbury 009","E02005018",3708,978,587,391,2513,580,1236,499,502,235,356,177,149,30,334,211,123,7,7,217,92,125
"2021","Canterbury 010","E02005019",2551,586,282,304,1786,334,873,324,372,177,309,150,131,28,257,157,100,13,13,179,75,104
"2021","Canterbury 011","E02005020",3084,822,480,342,2035,354,948,297,432,219,353,191,138,24,359,217,142,21,21,227,98,129
"2021","Canterbury 012","E02005021",2666,663,413,250,1753,424,906,324,420,162,241,155,65,21,167,94,73,15,15,250,70,180
"2021","Canterbury 013","E02005022",2961,672,290,382,1428,212,652,203,309,140,231,119,94,18,301,192,109,32,32,861,66,795
"2021","Canterbury 014","E02005023",3559,1207,395,812,1779,113,678,199,375,104,389,230,137,22,542,392,150,57,57,573,103,470
"2021","Canterbury 016","E02005025",3627,1143,516,627,1966,371,932,309,473,150,352,251,91,10,280,164,116,31,31,518,70,448
"2021","Canterbury 017","E02005026",3204,699,352,347,2273,353,1214,433,585,196,388,210,157,21,300,188,112,18,18,232,115,117
"2021","Canterbury 018","E02005027",2271,602,403,199,1549,340,839,324,369,146,210,129,70,11,153,91,62,7,7,120,42,78
"2021","Canterbury 019","E02006855",2555,743,226,517,1383,93,579,191,312,76,380,243,123,14,287,189,98,44,44,429,88,341
"2021","Canterbury 020","E02006856",4979,1840,708,1132,2317,257,878,328,428,122,689,517,146,26,414,255,159,79,79,822,79,743
"2021","Dartford 001","E02005028",5308,1325,344,981,3606,143,1917,393,1352,172,722,313,373,36,774,561,213,50,50,377,205,172
"2021","Dartford 002","E02005029",5930,1489,242,1247,4106,148,2073,585,1277,211,1183,659,482,42,649,491,158,53,53,335,171,164
"2021","Dartford 003","E02005030",4924,1405,414,991,3156,230,1606,411,969,226,668,371,260,37,582,383,199,70,70,363,182,181
"2021","Dartford 004","E02005031",3328,1008,317,691,2087,142,928,305,474,149,526,252,226,48,473,323,150,18,18,233,128,105
"2021","Dartford 005","E02005032",3961,1189,318,871,2470,131,1205,357,638,210,562,277,247,38,535,342,193,37,37,302,144,158
"2021","Dartford 006","E02005033",3157,994,317,677,1965,141,902,242,490,170,458,233,192,33,441,290,151,23,23,198,97,101
"2021","Dartford 007","E02005034",2825,504,307,197,2135,336,1234,315,604,315,314,125,148,41,238,122,116,13,13,186,104,82
"2021","Dartford 008","E02005035",3137,696,349,347,2255,299,1306,303,738,265,316,140,143,33,320,185,135,14,14,186,119,67
"2021","Dartford 009","E02005036",2596,738,337,401,1654,134,764,179,428,157,317,118,169,30,420,247,173,19,19,204,112,92
"2021","Dartford 010","E02005037",2780,641,416,225,1982,421,1039,299,500,240,245,100,126,19,264,137,127,13,13,157,80,77
"2021","Dartford 011","E02005038",2350,597,359,238,1631,299,839,235,412,192,277,112,138,27,207,99,108,9,9,122,55,67
"2021","Dartford 012","E02005039",2672,611,293,318,1926,291,931,266,455,210,348,171,154,23,340,188,152,16,16,135,71,64
"2021","Dartford 013","E02005040",2733,626,405,221,1971,460,1076,363,459,254,244,117,91,36,182,98,84,9,9,136,57,79
"2021","Dover 001","E02005041",3004,718,395,323,2123,452,1116,465,459,192,304,165,113,26,235,122,113,16,16,163,67,96
"2021","Dover 002","E02005042",4015,1238,767,471,2591,631,1227,538,423,266,380,202,160,18,338,192,146,15,15,186,66,120
"2021","Dover 003","E02005043",3338,1181,679,502,2023,434,897,394,311,192,339,178,132,29,345,194,151,8,8,134,47,87
"2021","Dover 004","E02005044",3222,1461,753,708,1628,377,718,375,198,145,273,177,80,16,238,139,99,22,22,133,45,88
"2021","Dover 005","E02005045",3895,1055,568,487,2619,405,1221,455,518,248,520,218,259,43,462,308,154,11,11,221,98,123
"2021","Dover 006","E02005046",3452,821,401,420,2412,267,1092,356,554,182,593,281,269,43,438,298,140,22,22,219,107,112
"2021","Dover 007","E02005047",3442,1120,662,458,2179,456,897,372,330,195,359,157,172,30,456,285,171,11,11,143,62,81
"2021","Dover 008","E02005048",2748,634,345,289,1927,463,986,463,342,181,302,169,109,24,169,76,93,7,7,187,80,107
"2021","Dover 009","E02005049",3186,944,630,314,2092,689,981,490,322,169,250,155,73,22,168,97,71,4,4,150,58,92
"2021","Dover 010","E02005050",4031,1028,595,433,2823,598,1387,551,562,274,492,231,215,46,330,197,133,16,16,180,78,102
"2021","Dover 011","E02005051",5591,1695,605,1090,3540,284,1396,469,637,290,841,342,432,67,993,678,315,26,26,356,165,191
"2021","Dover 012","E02005052",3724,1577,619,958,1908,245,815,321,379,115,434,241,176,17,390,242,148,24,24,239,87,152
"2021","Dover 013","E02005053",3956,1399,468,931,2310,203,886,328,383,175,596,275,282,39,578,417,161,47,47,247,93,154
"2021","Dover 014","E02005054",2936,782,457,325,1994,458,1007,464,343,200,320,173,116,31,204,107,97,5,5,160,61,99
"2021","Gravesham 001","E02005055",3209,871,254,617,2048,108,877,230,499,148,428,172,230,26,600,437,163,35,35,290,162,128
"2021","Gravesham 002","E02005056",4653,2060,588,1472,2141,143,883,281,458,144,537,314,211,12,520,372,148,58,58,452,229,223
"2021","Gravesham 003","E02005057",4362,1152,391,761,2806,257,1434,357,799,278,528,234,259,35,540,359,181,47,47,404,225,179
"2021","Gravesham 004","E02005058",2958,738,330,408,1910,158,884,220,475,189,385,153,199,33,452,279,173,31,31,310,197,113
"2021","Gravesham 005","E02005059",3778,982,507,475,2507,361,1392,400,670,322,397,195,171,31,339,179,160,18,18,289,157,132
"2021","Gravesham 006","E02005060",3349,864,436,428,2255,267,1086,324,525,237,432,189,213,30,454,295,159,16,16,230,121,109
"2021","Gravesham 007","E02005061",2819,761,379,382,1844,244,845,212,429,204,279,85,167,27,443,279,164,33,33,214,136,78
"2021","Gravesham 008","E02005062",2589,507,338,169,1876,327,978,249,478,251,264,95,140,29,297,155,142,10,10,206,121,85
"2021","Gravesham 009","E02005063",2679,554,314,240,1896,235,1039,296,491,252,290,116,145,29,322,201,121,10,10,229,134,95
"2021","Gravesham 010","E02005064",2662,658,443,215,1862,443,978,342,424,212,223,96,106,21,205,103,102,13,13,142,75,67
"2021","Gravesham 011","E02005065",3162,840,385,455,2105,193,961,234,518,209,399,139,210,50,528,332,196,24,24,217,116,101
"2021","Gravesham 012","E02005066",3186,734,510,224,2293,585,1212,410,511,291,259,131,106,22,232,114,118,5,5,159,86,73
"2021","Gravesham 013","E02005067",2321,492,286,206,1670,365,892,289,393,210,237,115,101,21,174,88,86,2,2,159,87,72
"2021","Maidstone 001","E02005068",2824,590,246,344,2073,284,1189,431,546,212,404,222,157,25,186,109,77,10,10,161,81,80
"2021","Maidstone 002","E02005069",3595,823,390,433,2518,415,1323,393,680,250,406,203,165,38,354,213,141,20,20,254,103,151
"2021","Maidstone 003","E02005070",4049,1030,693,337,2846,678,1478,450,741,287,404,203,179,22,270,146,124,16,16,173,83,90
"2021","Maidstone 004","E02005071",5477,2248,549,1699,2792,167,1147,431,566,150,811,552,234,25,597,403,194,70,70,437,142,295
"2021","Maidstone 005","E02005072",3176,688,426,262,2339,509,1330,398,691,241,278,124,140,14,215,136,79,7,7,149,70,79
"2021","Maidstone 006","E02005073",5396,1922,423,1499,3045,204,1391,441,754,196,809,485,289,35,578,387,191,63,63,429,118,311
"2021","Maidstone 007","E02005074",3373,885,525,360,2356,550,1203,380,597,226,351,174,161,16,246,137,109,6,6,132,54,78
"2021","Maidstone 008","E02005075",4221,996,383,613,2904,282,1457,386,806,265,571,280,261,30,555,385,170,39,39,321,137,184
"2021","Maidstone 009","E02005076",3912,1024,310,714,2521,180,1193,356,662,175,586,349,207,30,521,338,183,41,41,367,165,202
"2021","Maidstone 010","E02005077",3108,770,431,339,2096,325,1049,285,507,257,366,149,173,44,340,205,135,16,16,242,110,132
"2021","Maidstone 011","E02005078",3986,941,523,418,2775,616,1382,555,563,264,483,269,188,26,284,174,110,10,10,270,108,162
"2021","Maidstone 012","E02005079",3561,823,497,326,2537,542,1312,402,667,243,369,174,166,29,307,181,126,7,7,201,104,97
"2021","Maidstone 013","E02005080",4775,1361,603,758,3110,308,1261,351,635,275,637,200,382,55,860,590,270,44,44,304,166,138
"2021","Maidstone 014","E02005081",2996,816,471,345,2048,503,1038,374,456,208,312,171,119,22,187,87,100,8,8,132,59,73
"2021","Maidstone 015","E02005082",4661,1014,430,584,3384,477,1778,648,834,296,647,303,310,34,463,284,179,19,19,263,127,136
"2021","Maidstone 016","E02005083",3235,797,451,346,2274,448,1145,379,540,226,376,205,149,22,287,169,118,18,18,164,75,89
"2021","Maidstone 017","E02005084",3062,768,416,352,2139,393,1071,423,468,180,351,212,110,29,308,183,125,16,16,155,70,85
"2021","Maidstone 018","E02005085",3140,725,359,366,2229,306,1228,449,564,215,417,253,150,14,265,149,116,13,13,186,89,97
"2021","Maidstone 019","E02005086",2664,579,325,254,1948,340,1017,325,499,193,313,182,115,16,264,148,116,14,14,137,58,79
"2021","Sevenoaks 001","E02005087",2862,705,429,276,2010,365,1048,322,449,277,323,150,147,26,261,150,111,13,13,147,65,82
"2021","Sevenoaks 002","E02005088",4031,1205,591,614,2568,299,1133,332,561,240,439,180,220,39,665,395,270,32,32,258,137,121
"2021","Sevenoaks 003","E02005089",2813,728,394,334,1944,299,976,313,457,206,363,191,142,30,293,162,131,13,13,141,69,72
"2021","Sevenoaks 004","E02005090",2427,635,465,170,1675,455,880,313,366,201,163,74,71,18,169,82,87,8,8,117,66,51
"2021","Sevenoaks 005","E02005091",2905,875,490,385,1892,335,952,337,416,199,327,184,124,19,264,159,105,14,14,138,66,72
"2021","Sevenoaks 007","E02005093",2586,741,456,285,1668,407,821,315,313,193,250,121,110,19,184,85,99,6,6,177,67,110
"2021","Sevenoaks 008","E02005094",4061,1114,500,614,2753,415,1437,427,780,230,512,291,191,30,372,216,156,17,17,194,75,119
"2021","Sevenoaks 009","E02005095",2985,678,436,242,2180,436,1249,326,682,241,227,96,112,19,259,141,118,9,9,127,50,77
"2021","Sevenoaks 010","E02005096",4029,1163,542,621,2669,353,1385,351,838,196,490,268,199,23,417,274,143,24,24,197,81,116
"2021","Sevenoaks 011","E02005097",3447,644,384,260,2655,444,1776,383,1139,254,235,108,111,16,194,125,69,6,6,148,80,68
"2021","Sevenoaks 012","E02005098",4071,1238,655,583,2671,446,1598,458,924,216,335,217,105,13,281,160,121,11,11,162,63,99
"2021","Sevenoaks 013","E02005099",3351,872,437,435,2349,412,1226,425,586,215,376,216,137,23,321,203,118,14,14,130,55,75
"2021","Sevenoaks 014","E02005100",4167,1168,597,571,2811,424,1329,444,666,219,564,271,256,37,478,311,167,16,16,188,80,108
"2021","Sevenoaks 015","E02005101",2828,628,336,292,2083,367,1235,432,596,207,267,154,97,16,207,111,96,7,7,117,55,62
"2021","Sevenoaks 016","E02006832",2460,596,342,254,1736,322,813,239,399,175,294,132,135,27,298,163,135,9,9,128,63,65
"2021","Folkestone and Hythe 001","E02005102",2701,727,471,256,1817,524,875,388,309,178,233,134,82,17,176,85,91,9,9,157,63,94
"2021","Folkestone and Hythe 002","E02005103",3879,886,421,465,2759,407,1399,433,718,248,520,230,244,46,420,273,147,13,13,234,126,108
"2021","Folkestone and Hythe 003","E02005104",3354,981,525,456,2203,339,961,333,418,210,424,186,197,41,452,287,165,27,27,170,70,100
"2021","Folkestone and Hythe 004","E02005105",3207,1057,368,689,1911,135,759,244,391,124,441,191,229,21,553,391,162,23,23,239,105,134
"2021","Folkestone and Hythe 005","E02005106",4020,1080,537,543,2679,303,1322,448,640,234,561,241,281,39,475,257,218,18,18,261,127,134
"2021","Folkestone and Hythe 006","E02005107",5403,1594,819,775,3505,681,1659,604,750,305,614,297,277,40,530,304,226,21,21,304,140,164
"2021","Folkestone and Hythe 008","E02005109",2977,882,620,262,1973,630,971,421,368,182,205,122,68,15,161,87,74,6,6,122,50,72
"2021","Folkestone and Hythe 009","E02005110",3033,762,462,300,2105,492,1076,473,397,206,328,162,134,32,200,96,104,9,9,166,73,93
"2021","Folkestone and Hythe 010","E02005111",3689,1545,930,615,2026,556,779,387,263,129,336,176,123,37,339,195,144,16,16,118,34,84
"2021","Folkestone and Hythe 011","E02005112",3116,904,592,312,2015,533,924,459,271,194,315,171,117,27,231,101,130,12,12,197,76,121
"2021","Folkestone and Hythe 012","E02005113",3177,906,564,342,2097,583,917,425,285,207,311,163,121,27,276,146,130,10,10,174,68,106
"2021","Folkestone and Hythe 013","E02005114",2735,778,425,353,1786,389,763,371,223,169,339,158,147,34,284,181,103,11,11,171,79,92
"2021","Folkestone and Hythe 014","E02006879",3543,1901,522,1379,1453,128,430,191,184,55,450,296,143,11,417,315,102,28,28,189,63,126
"2021","Folkestone and Hythe 015","E02006880",3506,1723,659,1064,1553,221,545,290,187,68,447,340,99,8,319,211,108,21,21,230,59,171
"2021","Swale 001","E02005115",2618,783,232,551,1632,91,562,181,280,101,438,166,245,27,521,380,141,20,20,203,93,110
"2021","Swale 002","E02005116",2629,819,391,428,1615,144,568,193,240,135,375,143,188,44,504,334,170,24,24,195,98,97
"2021","Swale 003","E02005117",2777,744,446,298,1843,451,911,402,302,207,277,132,123,22,195,99,96,9,9,190,93,97
"2021","Swale 004","E02005118",4321,1079,474,605,2953,383,1337,476,605,256,667,305,311,51,545,359,186,21,21,289,139,150
"2021","Swale 005","E02005119",2669,736,374,362,1732,309,747,300,274,173,354,135,184,35,310,198,112,12,12,201,103,98
"2021","Swale 006","E02005120",3191,940,492,448,2032,391,968,447,317,204,341,159,153,29,316,192,124,16,16,219,105,114
"2021","Swale 007","E02005121",5223,1037,369,668,3786,336,1957,638,990,329,859,399,411,49,608,384,224,26,26,400,213,187
"2021","Swale 008","E02005122",3101,697,394,303,2227,408,1149,430,484,235,407,206,163,38,252,146,106,11,11,177,91,86
"2021","Swale 009","E02005123",4892,1088,449,639,3467,437,1708,542,843,323,755,381,321,53,548,362,186,19,19,337,182,155
"2021","Swale 010","E02005124",3803,1403,610,793,2104,196,816,262,375,179,561,238,275,48,494,327,167,37,37,296,152,144
"2021","Swale 011","E02005125",3379,884,413,471,2225,263,1030,362,499,169,528,234,253,41,387,234,153,17,17,270,152,118
"2021","Swale 012","E02005126",3297,848,513,335,2285,475,1065,342,486,237,393,172,192,29,331,196,135,21,21,164,79,85
"2021","Swale 013","E02005127",3491,754,448,306,2556,547,1396,460,630,306,367,155,176,36,241,139,102,5,5,181,94,87
"2021","Swale 014","E02005128",3729,950,505,445,2590,443,1205,442,541,222,500,246,218,36,431,278,153,11,11,189,88,101
"2021","Swale 015","E02005129",5089,1662,873,789,3157,495,1315,513,588,214,718,377,295,46,606,351,255,23,23,270,113,157
"2021","Swale 016","E02005130",3863,924,509,415,2655,425,1261,494,507,260,561,283,232,46,391,231,160,17,17,284,130,154
"2021","Swale 017","E02005131",2410,604,365,239,1670,323,848,337,351,160,292,145,103,44,199,101,98,8,8,136,54,82
"2021","Thanet 001","E02005132",4955,2177,657,1520,2399,151,740,273,372,95,693,350,319,24,772,610,162,43,43,379,135,244
"2021","Thanet 002","E02005133",3847,1134,753,381,2514,721,1139,480,432,227,394,220,152,22,247,126,121,13,13,199,81,118
"2021","Thanet 003","E02005134",3538,1300,336,964,1982,112,738,296,326,116,562,288,242,32,532,355,177,38,38,256,108,148
"2021","Thanet 004","E02005135",3193,909,383,526,2023,237,848,312,389,147,461,185,237,39,460,299,161,17,17,261,112,149
"2021","Thanet 005","E02005136",3263,892,507,385,2125,378,1032,335,441,256,389,175,181,33,317,164,153,9,9,246,112,134
"2021","Thanet 006","E02005137",3102,880,466,414,2031,234,825,274,388,163,395,124,218,53,559,355,204,18,18,191,94,97
"2021","Thanet 007","E02005138",4179,1562,780,782,2424,481,956,388,391,177,520,268,210,42,449,267,182,18,18,193,84,109
"2021","Thanet 008","E02005139",4286,1501,1058,443,2590,885,1056,528,343,185,331,194,118,19,310,152,158,8,8,195,87,108
"2021","Thanet 009","E02005140",3441,1104,743,361,2185,589,999,419,405,175,289,118,148,23,297,168,129,11,11,152,68,84
"2021","Thanet 010","E02005141",3238,1141,575,566,1939,457,903,367,371,165,312,170,115,27,253,155,98,14,14,158,61,97
"2021","Thanet 011","E02005142",3188,948,595,353,2068,483,926,360,370,196,314,145,142,27,332,171,161,13,13,172,75,97
"2021","Thanet 012","E02005143",3500,1007,495,512,2255,340,930,358,405,167,435,205,189,41,534,340,194,16,16,238,102,136
"2021","Thanet 013","E02005144",3535,1013,439,574,2255,231,889,289,393,207,471,159,270,42,642,405,237,22,22,267,150,117
"2021","Thanet 014","E02005145",3473,947,525,422,2336,450,1139,518,435,186,428,235,165,28,313,193,120,6,6,190,71,119
"2021","Thanet 015","E02005146",3315,964,346,618,2106,189,920,296,450,174,473,202,239,32,501,338,163,23,23,245,104,141
"2021","Thanet 016","E02005147",4643,2305,871,1434,2071,225,667,324,246,97,553,313,220,20,588,430,158,38,38,267,89,178
"2021","Thanet 017","E02005148",3511,1056,696,360,2278,558,1090,469,403,218,348,159,159,30,275,140,135,7,7,177,70,107
"2021","Tonbridge and Malling 001","E02005149",4945,1176,513,663,3542,443,1789,619,830,340,783,434,296,53,506,322,184,21,21,227,99,128
"2021","Tonbridge and Malling 002","E02005150",4942,1428,561,867,3290,372,1548,570,712,266,747,342,357,48,600,385,215,23,23,224,102,122
"2021","Tonbridge and Malling 003","E02005151",5148,1250,693,557,3669,570,1884,622,883,379,663,315,303,45,538,303,235,14,14,229,94,135
"2021","Tonbridge and Malling 005","E02005153",3808,890,500,390,2732,498,1273,428,607,238,475,205,241,29,472,322,150,14,14,186,85,101
"2021","Tonbridge and Malling 006","E02005154",4635,1041,604,437,3369,611,1843,572,941,330,486,234,216,36,409,237,172,20,20,225,95,130
"2021","Tonbridge and Malling 007","E02005155",4663,907,367,540,3566,469,2121,516,1317,288,496,223,237,36,467,324,143,13,13,190,94,96
"2021","Tonbridge and Malling 008","E02005156",2940,755,438,317,2024,419,1034,369,437,228,272,126,124,22,281,146,135,18,18,161,65,96
"2021","Tonbridge and Malling 009","E02005157",2743,770,480,290,1835,363,863,239,424,200,248,104,117,27,351,211,140,10,10,138,64,74
"2021","Tonbridge and Malling 010","E02005158",2589,588,362,226,1871,383,1107,313,609,185,216,104,93,19,158,77,81,7,7,130,55,75
"2021","Tonbridge and Malling 011","E02005159",3135,797,552,245,2214,494,1142,302,605,235,266,115,125,26,305,173,132,7,7,124,65,59
"2021","Tonbridge and Malling 012","E02005160",5373,1827,714,1113,3304,335,1642,478,897,267,733,469,229,35,558,374,184,36,36,242,78,164
"2021","Tonbridge and Malling 013","E02005161",3503,935,375,560,2405,212,1362,384,771,207,450,259,166,25,355,199,156,26,26,163,50,113
"2021","Tonbridge and Malling 014","E02006833",5149,1334,672,662,3557,607,1818,648,864,306,660,359,267,34,457,283,174,15,15,258,107,151
"2021","Tunbridge Wells 001","E02005162",4331,1102,574,528,3034,540,1565,509,718,338,496,252,208,36,411,245,166,22,22,195,84,111
"2021","Tunbridge Wells 002","E02005163",3129,706,308,398,2308,299,1280,321,724,235,354,169,153,32,359,211,148,16,16,115,54,61
"2021","Tunbridge Wells 003","E02005164",3742,1105,436,669,2492,276,1290,366,748,176,527,302,202,23,374,240,134,25,25,145,54,91
"2021","Tunbridge Wells 004","E02005165",3091,832,474,358,2107,424,1142,339,552,251,283,143,120,20,248,125,123,10,10,152,56,96
"2021","Tunbridge Wells 005","E02005166",2801,852,332,520,1788,172,864,246,480,138,345,162,162,21,387,236,151,20,20,161,81,80
"2021","Tunbridge Wells 006","E02005167",2939,646,394,252,2194,466,1308,345,742,221,204,98,89,17,211,129,82,5,5,99,43,56
"2021","Tunbridge Wells 007","E02005168",3194,1015,467,548,2051,251,1205,350,724,131,344,225,107,12,233,150,83,18,18,128,41,87
"2021","Tunbridge Wells 008","E02005169",4636,2051,492,1559,2326,172,1067,376,587,104,683,534,137,12,350,247,103,54,54,259,58,201
"2021","Tunbridge Wells 009","E02005170",4138,1217,595,622,2772,363,1503,444,891,168,516,304,200,12,366,238,128,24,24,149,47,102
"2021","Tunbridge Wells 010","E02005171",2688,887,387,500,1666,203,754,234,401,119,322,163,138,21,372,249,123,15,15,135,48,87
"2021","Tunbridge Wells 011","E02005172",3270,768,382,386,2347,437,1355,419,682,254,287,155,115,17,264,145,119,4,4,155,67,88
"2021","Tunbridge Wells 012","E02005173",3699,1162,494,668,2387,448,1342,435,742,165,351,244,90,17,234,135,99,12,12,150,47,103
"2021","Tunbridge Wells 013","E02005174",3076,868,520,348,2050,404,1044,385,473,186,248,125,101,22,345,212,133,9,9,158,84,74
"2021","Tunbridge Wells 014","E02005175",3492,989,546,443,2377,477,1227,451,561,215,383,186,162,35,277,184,93,13,13,126,52,74
"2021","Cherwell 001","E02005921",2962,722,343,379,2125,368,1150,512,486,152,416,254,145,17,176,96,80,15,15,115,39,76
"2021","Cherwell 002","E02005922",3629,903,280,623,2511,231,1241,410,624,207,604,327,246,31,403,267,136,32,32,215,77,138
"2021","Cherwell 003","E02005923",2335,675,288,387,1401,136,655,186,352,117,279,146,113,20,305,183,122,26,26,259,119,140
"2021","Cherwell 004","E02005924",5632,2103,580,1523,3000,165,1338,487,665,186,910,617,263,30,505,330,175,82,82,529,179,350
"2021","Cherwell 005","E02005925",3263,759,378,381,2194,192,981,300,501,180,427,162,232,33,558,361,197,36,36,310,146,164
"2021","Cherwell 006","E02005926",3870,1173,593,580,2489,524,1215,449,529,237,415,257,121,37,315,169,146,20,20,208,71,137
"2021","Cherwell 007","E02005927",2436,701,314,387,1583,257,810,278,384,148,301,188,92,21,202,120,82,13,13,152,53,99
"2021","Cherwell 008","E02005928",4375,972,446,526,3214,560,1659,520,904,235,542,291,220,31,435,314,121,18,18,189,79,110
"2021","Cherwell 009","E02005929",3124,788,429,359,2206,445,1188,487,517,184,320,186,116,18,245,152,93,8,8,130,51,79
"2021","Cherwell 010","E02005930",3851,927,449,478,2710,452,1470,513,762,195,489,278,191,20,288,165,123,11,11,214,85,129
"2021","Cherwell 011","E02005931",4347,911,345,566,3217,316,1888,691,929,268,644,383,225,36,350,239,111,19,19,219,84,135
"2021","Cherwell 012","E02005932",2681,598,184,414,1929,150,1106,350,576,180,408,249,143,16,241,150,91,24,24,154,46,108
"2021","Cherwell 013","E02005933",3106,737,309,428,2110,260,1113,389,494,230,421,225,168,28,294,158,136,22,22,259,106,153
"2021","Cherwell 014","E02005934",3522,772,394,378,2477,406,1252,434,538,280,407,201,177,29,384,206,178,28,28,273,103,170
"2021","Cherwell 015","E02005935",3772,1213,427,786,2324,168,1226,408,643,175,588,402,171,15,304,213,91,38,38,235,68,167
"2021","Cherwell 016","E02005936",4896,1055,468,587,3529,478,1980,684,1041,255,650,357,265,28,393,246,147,28,28,312,127,185
"2021","Cherwell 017","E02005937",2929,923,541,382,1824,386,905,319,400,186,284,180,82,22,225,105,120,24,24,182,65,117
"2021","Cherwell 018","E02005938",2256,566,313,253,1449,216,779,253,347,179,208,113,77,18,224,117,107,22,22,241,104,137
"2021","Cherwell 019","E02005939",2898,839,393,446,1871,336,939,342,418,179,343,220,108,15,233,132,101,20,20,188,67,121
"2021","Oxford 001","E02005940",2601,795,420,375,1612,283,872,252,495,125,195,105,77,13,245,148,97,17,17,194,66,128
"2021","Oxford 002","E02005941",2748,909,431,478,1614,254,846,266,463,117,255,181,70,4,242,156,86,17,17,225,64,161
"2021","Oxford 003","E02005942",2283,731,324,407,1377,251,774,256,422,96,173,122,48,3,167,121,46,12,12,175,34,141
"2021","Oxford 004","E02005943",2635,657,350,307,1602,220,907,218,547,142,228,139,79,10,222,115,107,25,25,376,89,287
"2021","Oxford 005","E02005944",3110,818,276,542,1891,128,874,220,496,158,344,192,118,34,507,331,176,38,38,401,140,261
"2021","Oxford 006","E02005945",3837,1102,442,660,2127,324,1184,331,705,148,358,270,80,8,206,111,95,55,55,608,90,518
"2021","Oxford 007","E02005946",3397,903,396,507,2106,243,1152,342,651,159,430,289,123,18,246,126,120,35,35,388,107,281
"2021","Oxford 008","E02005947",2477,1021,259,762,1062,104,540,237,254,49,268,243,25,0,129,83,46,21,21,394,27,367
"2021","Oxford 009","E02005948",2734,942,298,644,1331,111,608,249,299,60,331,270,52,9,206,126,80,75,75,461,69,392
"2021","Oxford 010","E02005949",2456,713,212,501,1284,93,616,193,322,101,224,129,80,15,314,199,115,37,37,459,108,351
"2021","Oxford 011","E02005950",3858,1154,331,823,1478,104,668,280,294,94,464,359,95,10,204,120,84,38,38,1226,91,1135
"2021","Oxford 012","E02005951",2422,843,306,537,1234,119,586,168,350,68,307,216,79,12,185,98,87,37,37,345,49,296
"2021","Oxford 014","E02005953",2267,629,197,432,1151,84,588,237,277,74,255,170,76,9,192,106,86,32,32,487,84,403
"2021","Oxford 015","E02005954",3864,1096,450,646,2122,252,1085,327,576,182,408,257,131,20,319,179,140,58,58,646,225,421
"2021","Oxford 016","E02005955",4119,1052,385,667,2536,212,1163,347,630,186,494,276,179,39,607,385,222,60,60,531,200,331
"2021","Oxford 017","E02005956",2393,631,246,385,1437,88,640,191,280,169,237,100,104,33,433,273,160,39,39,325,156,169
"2021","Oxford 018","E02005957",2593,703,217,486,1613,57,664,189,348,127,309,110,155,44,554,347,207,29,29,277,140,137
"2021","Oxford 020","E02007021",2674,645,244,401,1556,130,831,234,444,153,260,138,105,17,297,170,127,38,38,473,138,335
"2021","Oxford 019","E02007116",2754,747,171,576,1374,65,627,207,320,100,394,300,81,13,237,151,86,51,51,633,161,472
"2021","South Oxfordshire 001","E02005958",2335,655,315,340,1592,248,833,294,367,172,284,146,125,13,221,117,104,6,6,88,27,61
"2021","South Oxfordshire 002","E02005959",2413,615,337,278,1645,306,895,333,382,180,273,156,93,24,163,84,79,8,8,153,47,106
"2021","South Oxfordshire 003","E02005960",3264,883,481,402,2241,406,1155,332,644,179,360,218,125,17,305,211,94,15,15,140,47,93
"2021","South Oxfordshire 004","E02005961",2877,795,427,368,1921,395,1007,382,451,174,309,189,101,19,202,96,106,8,8,161,43,118
"2021","South Oxfordshire 005","E02005962",4116,884,458,426,3041,525,1603,532,761,310,567,316,223,28,332,204,128,14,14,191,77,114
"2021","South Oxfordshire 006","E02005963",3312,900,450,450,2226,384,1200,468,508,224,344,200,119,25,277,141,136,21,21,186,82,104
"2021","South Oxfordshire 007","E02005964",3041,732,452,280,2167,442,1220,458,534,228,287,157,113,17,205,98,107,13,13,142,53,89
"2021","South Oxfordshire 008","E02005965",2339,652,375,277,1588,289,912,332,418,162,219,129,77,13,163,89,74,5,5,99,36,63
"2021","South Oxfordshire 009","E02005966",3332,746,183,563,2412,124,1368,463,700,205,608,409,184,15,291,176,115,21,21,174,40,134
"2021","South Oxfordshire 010","E02005967",3738,886,340,546,2594,244,1368,452,728,188,596,342,230,24,357,241,116,29,29,258,79,179
"2021","South Oxfordshire 011","E02005968",2877,670,343,327,2059,317,1240,409,683,148,309,191,106,12,182,109,73,11,11,148,51,97
"2021","South Oxfordshire 012","E02005969",4197,1307,666,641,2704,475,1426,439,774,213,437,250,164,23,353,211,142,13,13,186,51,135
"2021","South Oxfordshire 013","E02005970",2435,803,199,604,1436,118,687,248,322,117,359,242,95,22,253,150,103,19,19,196,59,137
"2021","South Oxfordshire 014","E02005971",2601,698,387,311,1712,232,888,294,414,180,323,167,141,15,244,133,111,25,25,191,60,131
"2021","South Oxfordshire 015","E02005972",4835,1076,518,558,3546,510,1845,586,1056,203,747,451,259,37,436,298,138,8,8,213,77,136
"2021","South Oxfordshire 016","E02005973",2783,1063,557,506,1567,333,724,235,363,126,260,168,78,14,235,144,91,15,15,153,40,113
"2021","South Oxfordshire 017","E02005974",2807,941,454,487,1729,305,897,281,478,138,274,177,88,9,231,127,104,22,22,137,43,94
"2021","South Oxfordshire 018","E02005975",3278,742,463,279,2405,555,1377,443,691,243,246,142,86,18,216,123,93,11,11,131,56,75
"2021","South Oxfordshire 019","E02005976",2443,479,279,200,1853,422,1076,351,540,185,195,108,72,15,151,79,72,9,9,111,41,70
"2021","South Oxfordshire 020","E02005977",2489,580,355,225,1789,407,958,301,484,173,205,105,81,19,211,120,91,8,8,120,47,73
"2021","Vale of White Horse 001","E02005978",3053,728,374,354,2126,436,1199,419,571,209,288,192,81,15,191,108,83,12,12,199,77,122
"2021","Vale of White Horse 002","E02005979",4106,1094,523,571,2682,438,1495,493,762,240,452,271,151,30,267,147,120,30,30,330,74,256
"2021","Vale of White Horse 003","E02005980",4188,993,502,491,2947,575,1725,601,856,268,371,197,153,21,265,157,108,11,11,248,86,162
"2021","Vale of White Horse 004","E02005981",3534,807,356,451,2572,452,1512,505,713,294,357,229,109,19,236,114,122,15,15,155,49,106
"2021","Vale of White Horse 005","E02005982",2423,659,298,361,1633,305,899,282,468,149,245,143,86,16,172,105,67,12,12,131,40,91
"2021","Vale of White Horse 006","E02005983",5067,1884,647,1237,2886,386,1340,483,678,179,643,425,194,24,483,306,177,34,34,297,66,231
"2021","Vale of White Horse 007","E02005984",3725,787,393,394,2773,476,1581,606,752,223,442,275,149,18,265,192,73,9,9,165,64,101
"2021","Vale of White Horse 008","E02005985",3392,993,513,480,2186,379,1022,345,473,204,407,216,158,33,358,216,142,20,20,213,57,156
"2021","Vale of White Horse 009","E02005986",4229,1287,549,738,2792,437,1374,504,656,214,575,342,205,28,390,249,141,16,16,150,54,96
"2021","Vale of White Horse 010","E02005987",4174,991,454,537,2949,431,1549,496,812,241,552,309,219,24,396,263,133,21,21,234,81,153
"2021","Vale of White Horse 011","E02005988",3818,959,408,551,2710,390,1346,483,649,214,581,341,218,22,376,249,127,17,17,149,40,109
"2021","Vale of White Horse 014","E02005991",4468,1415,672,743,2861,489,1414,515,667,232,525,305,188,32,412,248,164,21,21,192,49,143
"2021","Vale of White Horse 015","E02005992",5683,1459,660,799,3967,551,2244,716,1225,303,689,397,273,19,468,311,157,15,15,257,99,158
"2021","Vale of White Horse 016","E02006886",5634,1378,647,731,4023,667,2288,879,1096,313,610,346,243,21,445,310,135,13,13,233,91,142
"2021","West Oxfordshire 001","E02005993",3251,1068,549,519,2059,396,934,349,416,169,388,220,146,22,319,209,110,22,22,124,48,76
"2021","West Oxfordshire 002","E02005994",2558,689,330,359,1739,344,938,373,403,162,263,141,100,22,183,101,82,11,11,130,38,92
"2021","West Oxfordshire 003","E02005995",2728,748,423,325,1878,427,1025,394,446,185,234,124,89,21,176,98,78,16,16,102,42,60
"2021","West Oxfordshire 004","E02005996",3883,1111,597,514,2604,490,1353,466,670,217,437,252,163,22,312,194,118,12,12,168,58,110
"2021","West Oxfordshire 005","E02005997",2623,751,439,312,1764,384,925,366,392,167,254,121,111,22,197,99,98,4,4,108,36,72
"2021","West Oxfordshire 006","E02005998",2922,734,396,338,2062,422,1104,386,519,199,295,168,118,9,232,149,83,9,9,126,43,83
"2021","West Oxfordshire 007","E02005999",2718,627,338,289,1964,403,1080,420,427,233,265,151,103,11,201,113,88,15,15,127,49,78
"2021","West Oxfordshire 008","E02006000",4980,1396,623,773,3343,514,1728,589,851,288,622,343,249,30,456,288,168,23,23,241,82,159
"2021","West Oxfordshire 009","E02006001",2952,802,340,462,2017,221,988,337,488,163,466,265,175,26,323,219,104,19,19,133,43,90
"2021","West Oxfordshire 010","E02006002",4879,1645,831,814,2899,504,1284,482,553,249,599,362,202,35,467,275,192,45,45,335,84,251
"2021","West Oxfordshire 011","E02006003",2539,692,378,314,1732,327,852,313,371,168,281,153,113,15,266,157,109,6,6,115,38,77
"2021","West Oxfordshire 012","E02006004",2646,736,370,366,1806,358,947,409,371,167,303,191,100,12,186,111,75,12,12,104,31,73
"2021","West Oxfordshire 013","E02006005",3873,763,213,550,2946,235,1724,535,980,209,569,329,216,24,394,276,118,24,24,164,65,99
"2021","West Oxfordshire 014","E02006006",2403,689,321,368,1594,246,903,326,399,178,251,142,98,11,188,102,86,6,6,120,35,85
"2021","West Oxfordshire 015","E02006007",3032,757,439,318,2143,440,1153,410,532,211,327,188,114,25,207,121,86,16,16,132,43,89
"2021","Elmbridge 001","E02006317",2538,647,373,274,1733,243,960,269,536,155,234,113,103,18,285,153,132,11,11,158,62,96
"2021","Elmbridge 002","E02006318",2930,787,335,452,1997,315,1137,344,624,169,319,210,103,6,207,127,80,19,19,146,39,107
"2021","Elmbridge 003","E02006319",2906,880,416,464,1863,166,1021,259,592,170,318,167,137,14,341,203,138,17,17,163,76,87
"2021","Elmbridge 004","E02006320",3068,929,304,625,1968,156,935,276,524,135,414,241,157,16,442,281,161,21,21,171,69,102
"2021","Elmbridge 005","E02006321",2488,552,285,267,1836,218,1143,269,732,142,279,156,117,6,187,116,71,9,9,100,33,67
"2021","Elmbridge 006","E02006322",2523,616,319,297,1786,198,1121,288,694,139,238,145,81,12,214,133,81,15,15,121,49,72
"2021","Elmbridge 007","E02006323",3391,1156,507,649,2071,314,1085,307,633,145,374,256,104,14,279,186,93,19,19,164,45,119
"2021","Elmbridge 008","E02006324",2924,582,266,316,2202,221,1319,318,799,202,314,171,122,21,330,216,114,18,18,140,56,84
"2021","Elmbridge 009","E02006325",3330,624,379,245,2549,351,1748,372,1105,271,221,110,95,16,222,125,97,7,7,157,62,95
"2021","Elmbridge 010","E02006326",3121,881,392,489,2093,257,1175,298,733,144,357,232,113,12,277,176,101,27,27,147,62,85
"2021","Elmbridge 011","E02006327",2799,837,456,381,1870,325,1108,245,706,157,212,138,67,7,210,135,75,15,15,92,42,50
"2021","Elmbridge 012","E02006328",4183,1420,580,840,2583,262,1501,414,915,172,433,292,126,15,348,210,138,39,39,180,58,122
"2021","Elmbridge 013","E02006329",2795,683,318,365,1964,339,1171,328,654,189,230,127,84,19,212,118,94,12,12,148,64,84
"2021","Elmbridge 014","E02006330",4025,1207,708,499,2595,361,1475,355,892,228,385,210,158,17,354,206,148,20,20,223,110,113
"2021","Elmbridge 015","E02006331",2806,655,421,234,2033,335,1246,299,736,211,220,128,78,14,224,119,105,8,8,118,53,65
"2021","Elmbridge 016","E02006332",2626,716,250,466,1772,237,1110,327,618,165,236,148,76,12,178,122,56,11,11,138,61,77
"2021","Elmbridge 017","E02006333",3902,1139,617,522,2551,396,1466,355,874,237,319,177,124,18,346,234,112,24,24,212,96,116
"2021","Elmbridge 018","E02006334",3228,658,374,284,2406,428,1584,428,927,229,198,115,72,11,186,121,65,10,10,164,83,81
"2021","Epsom and Ewell 001","E02006335",3125,761,447,314,2121,391,1209,329,599,281,256,130,98,28,247,113,134,18,18,243,105,138
"2021","Epsom and Ewell 002","E02006336",2736,668,302,366,1864,170,1007,226,550,231,300,114,156,30,364,204,160,23,23,204,115,89
"2021","Epsom and Ewell 003","E02006337",3302,603,400,203,2484,473,1521,362,835,324,252,117,104,31,223,81,142,15,15,215,94,121
"2021","Epsom and Ewell 004","E02006338",2577,521,328,193,1881,308,1091,269,602,220,239,99,119,21,227,118,109,16,16,175,62,113
"2021","Epsom and Ewell 005","E02006339",4017,897,340,557,2815,227,1624,363,1029,232,425,214,189,22,511,325,186,28,28,305,132,173
"2021","Epsom and Ewell 007","E02006341",4110,1096,508,588,2690,323,1418,388,815,215,429,241,170,18,491,282,209,29,29,324,105,219
"2021","Epsom and Ewell 008","E02006342",3699,1411,669,742,2038,233,1047,331,600,116,405,280,118,7,330,223,107,23,23,250,57,193
"2021","Epsom and Ewell 009","E02006343",3312,713,421,292,2429,368,1476,359,848,269,314,168,125,21,259,129,130,12,12,170,64,106
"2021","Epsom and Ewell 010","E02006837",4440,955,543,412,3197,569,1960,495,1081,384,344,188,124,32,306,177,129,18,18,288,136,152
"2021","Guildford 001","E02006344",3468,886,507,379,2391,489,1357,474,638,245,295,159,114,22,241,133,108,9,9,191,67,124
"2021","Guildford 002","E02006345",2446,545,301,244,1752,321,1045,357,538,150,247,138,101,8,135,78,57,4,4,149,62,87
"2021","Guildford 003","E02006346",3901,835,548,287,2886,645,1710,508,904,298,254,133,109,12,256,139,117,21,21,180,57,123
"2021","Guildford 004","E02006347",3073,848,357,491,2090,344,1050,381,485,184,420,232,166,22,266,144,122,10,10,135,54,81
"2021","Guildford 005","E02006348",3455,879,468,411,2297,421,1298,449,635,214,312,174,116,22,254,148,106,12,12,279,75,204
"2021","Guildford 006","E02006349",3126,857,359,498,1953,195,1104,318,640,146,371,239,107,25,267,166,101,16,16,316,68,248
"2021","Guildford 007","E02006350",2455,633,260,373,1516,144,803,238,409,156,257,134,106,17,294,184,110,18,18,306,69,237
"2021","Guildford 008","E02006351",3390,931,425,506,2304,288,1361,328,822,211,348,218,119,11,295,190,105,12,12,155,51,104
"2021","Guildford 009","E02006352",2291,467,232,235,1399,181,773,231,401,141,222,132,75,15,202,101,101,21,21,425,50,375
"2021","Guildford 010","E02006353",2602,785,375,410,1684,234,819,279,403,137,334,198,113,23,280,153,127,17,17,133,48,85
"2021","Guildford 011","E02006354",3812,905,478,427,2705,502,1656,380,1006,270,293,176,100,17,241,159,82,13,13,202,67,135
"2021","Guildford 012","E02006355",2366,547,209,338,1264,108,592,176,283,133,214,98,95,21,327,199,128,23,23,555,83,472
"2021","Guildford 013","E02006356",5359,1965,493,1472,2756,207,1283,474,668,141,839,683,146,10,357,221,136,70,70,638,65,573
"2021","Guildford 014","E02006357",3019,736,313,423,2142,313,1160,416,539,205,414,248,148,18,241,134,107,14,14,141,49,92
"2021","Guildford 015","E02006358",2753,792,299,493,1522,169,874,269,488,117,276,202,66,8,157,95,62,46,46,439,41,398
"2021","Guildford 016","E02006359",2620,767,356,411,1677,290,994,330,535,129,247,182,56,9,134,78,56,12,12,176,37,139
"2021","Guildford 017","E02006360",3289,890,473,417,2224,402,1302,429,665,208,283,186,80,17,224,131,93,13,13,175,67,108
"2021","Guildford 018","E02006361",2325,569,314,255,1628,343,935,336,436,163,180,105,57,18,163,80,83,7,7,128,44,84
"2021","Mole Valley 001","E02006362",2741,689,451,238,1929,398,1161,304,646,211,175,88,74,13,191,106,85,4,4,123,62,61
"2021","Mole Valley 002","E02006363",2379,610,355,255,1649,308,984,261,563,160,187,98,79,10,165,93,72,5,5,120,52,68
"2021","Mole Valley 003","E02006364",3451,1247,411,836,2017,168,853,299,423,131,561,343,193,25,416,283,133,19,19,187,66,121
"2021","Mole Valley 004","E02006365",2749,885,481,404,1748,371,962,323,476,163,228,147,64,17,177,105,72,10,10,116,37,79
"2021","Mole Valley 005","E02006366",3180,686,441,245,2352,525,1391,433,673,285,246,124,106,16,185,85,100,5,5,142,62,80
"2021","Mole Valley 006","E02006367",2586,761,426,335,1743,446,911,284,440,187,187,93,77,17,186,112,74,13,13,82,34,48
"2021","Mole Valley 007","E02006368",2418,726,483,243,1608,374,874,264,432,178,171,85,71,15,183,87,96,6,6,84,43,41
"2021","Mole Valley 008","E02006369",2835,878,542,336,1842,464,967,396,393,178,219,139,57,23,185,83,102,7,7,115,46,69
"2021","Mole Valley 009","E02006370",2840,972,462,510,1757,274,998,345,493,160,301,214,78,9,171,84,87,13,13,111,32,79
"2021","Mole Valley 010","E02006371",3198,1077,510,567,1945,329,1046,341,532,173,330,208,106,16,225,130,95,15,15,176,54,122
"2021","Mole Valley 011","E02006372",2712,816,371,445,1766,247,853,272,419,162,319,169,127,23,339,212,127,8,8,130,62,68
"2021","Mole Valley 012","E02006373",3094,832,447,385,2088,370,1185,417,531,237,297,181,103,13,222,109,113,14,14,174,70,104
"2021","Mole Valley 013","E02006374",2959,874,456,418,1924,377,1070,394,448,228,287,174,94,19,180,84,96,10,10,161,53,108
"2021","Reigate and Banstead 001","E02006375",2559,542,314,228,1877,338,1147,286,605,256,178,83,79,16,205,113,92,9,9,140,60,80
"2021","Reigate and Banstead 002","E02006376",3351,1012,620,392,2191,454,1146,331,570,245,276,136,118,22,302,181,121,13,13,148,52,96
"2021","Reigate and Banstead 003","E02006377",2380,491,319,172,1756,371,1018,295,478,245,188,84,84,20,172,83,89,7,7,133,55,78
"2021","Reigate and Banstead 004","E02006378",3366,665,326,339,2506,356,1447,452,731,264,355,173,145,37,328,183,145,20,20,195,86,109
"2021","Reigate and Banstead 005","E02006379",2812,810,353,457,1836,111,884,242,496,146,361,153,181,27,463,333,130,17,17,166,77,89
"2021","Reigate and Banstead 006","E02006380",2900,751,494,257,2016,470,1160,379,555,226,193,105,67,21,180,98,82,13,13,133,49,84
"2021","Reigate and Banstead 007","E02006381",2891,709,408,301,1993,375,1161,383,530,248,249,128,98,23,191,99,92,17,17,189,82,107
"2021","Reigate and Banstead 008","E02006382",2670,687,273,414,1838,147,987,255,583,149,363,179,156,28,324,213,111,17,17,145,67,78
"2021","Reigate and Banstead 009","E02006383",4019,1232,569,663,2592,419,1485,404,888,193,437,300,126,11,241,150,91,10,10,195,70,125
"2021","Reigate and Banstead 010","E02006384",4502,1326,511,815,2896,339,1534,417,899,218,507,314,168,25,475,317,158,41,41,280,98,182
"2021","Reigate and Banstead 011","E02006385",4757,1437,325,1112,2995,209,1646,464,995,187,680,442,218,20,423,273,150,37,37,325,107,218
"2021","Reigate and Banstead 012","E02006386",3329,914,430,484,2280,289,1372,323,882,167,347,208,125,14,254,154,100,18,18,135,47,88
"2021","Reigate and Banstead 013","E02006387",2646,638,315,323,1911,232,1049,262,625,162,278,130,128,20,340,206,134,12,12,97,42,55
"2021","Reigate and Banstead 014","E02006388",3798,1042,417,625,2480,267,1347,381,723,243,452,272,163,17,390,228,162,24,24,276,108,168
"2021","Reigate and Banstead 015","E02006389",2844,694,390,304,1973,275,1098,330,567,201,321,143,138,40,271,158,113,8,8,177,84,93
"2021","Reigate and Banstead 016","E02006390",4076,910,428,482,2917,343,1490,420,835,235,580,292,258,30,476,306,170,28,28,249,105,144
"2021","Reigate and Banstead 017","E02006391",3001,638,294,344,2207,260,1316,384,718,214,382,211,151,20,240,165,75,9,9,156,70,86
"2021","Reigate and Banstead 018","E02006392",3950,1298,557,741,2345,265,1158,390,580,188,497,304,171,22,387,248,139,38,38,307,112,195
"2021","Runnymede 001","E02006393",2846,893,363,530,1432,148,733,229,391,113,322,237,72,13,205,121,84,24,24,521,56,465
"2021","Runnymede 002","E02006394",3494,1016,454,562,1921,274,994,309,527,158,342,214,105,23,282,167,115,29,29,557,65,492
"2021","Runnymede 003","E02006395",3885,1030,427,603,2546,260,1333,367,715,251,481,281,159,41,446,254,192,26,26,309,133,176
"2021","Runnymede 004","E02006396",2446,727,399,328,1539,291,810,268,376,166,242,138,82,22,189,80,109,7,7,180,75,105
"2021","Runnymede 005","E02006397",2483,609,299,310,1691,293,1018,326,548,144,172,118,48,6,198,112,86,10,10,183,91,92
"2021","Runnymede 006","E02006398",3789,1212,450,762,2355,227,1103,368,566,169,570,352,190,28,427,262,165,28,28,222,72,150
"2021","Runnymede 007","E02006399",5116,1487,631,856,3312,400,1719,495,944,280,614,337,243,34,538,330,208,41,41,317,114,203
"2021","Runnymede 008","E02006400",2376,698,320,378,1545,284,832,284,417,131,248,138,89,21,168,84,84,13,13,133,36,97
"2021","Runnymede 009","E02006401",4481,1375,593,782,2834,364,1435,451,714,270,511,265,216,30,499,327,172,25,25,272,101,171
"2021","Runnymede 010","E02006402",3917,889,525,364,2801,473,1586,425,844,317,403,222,154,27,321,161,160,18,18,227,85,142
"2021","Spelthorne 001","E02006403",2710,859,246,613,1572,148,771,242,377,152,273,143,98,32,355,234,121,25,25,279,156,123
"2021","Spelthorne 002","E02006404",2765,639,262,377,1809,125,975,227,542,206,268,116,135,17,408,262,146,33,33,317,168,149
"2021","Spelthorne 003","E02006405",4441,1108,466,642,2978,391,1623,429,846,348,468,246,194,28,467,279,188,29,29,355,146,209
"2021","Spelthorne 004","E02006406",4005,1298,375,923,2393,211,1262,448,620,194,521,365,148,8,349,205,144,50,50,314,92,222
"2021","Spelthorne 005","E02006407",3675,989,513,476,2390,358,1263,340,625,298,385,179,180,26,359,207,152,25,25,296,127,169
"2021","Spelthorne 006","E02006408",3708,1133,450,683,2329,291,1196,314,630,252,442,233,183,26,368,216,152,32,32,246,110,136
"2021","Spelthorne 007","E02006409",2707,748,411,337,1771,199,908,239,476,193,290,119,138,33,355,190,165,19,19,188,91,97
"2021","Spelthorne 008","E02006410",3256,796,318,478,2205,198,1085,282,581,222,394,177,182,35,502,328,174,26,26,255,107,148
"2021","Spelthorne 009","E02006411",3060,857,477,380,2040,389,1136,355,581,200,290,177,90,23,200,106,94,25,25,163,58,105
"2021","Spelthorne 010","E02006412",3163,801,460,341,2180,370,1222,359,654,209,279,156,101,22,296,179,117,13,13,182,70,112
"2021","Spelthorne 011","E02006413",2629,749,418,331,1748,288,915,260,454,201,276,132,112,32,257,143,114,12,12,132,62,70
"2021","Spelthorne 012","E02006414",2539,663,360,303,1750,275,936,293,456,187,263,124,128,11,266,131,135,10,10,126,48,78
"2021","Spelthorne 013","E02006415",3143,1024,606,418,1961,463,989,339,473,177,289,168,111,10,208,115,93,12,12,158,53,105
"2021","Surrey Heath 001","E02006416",3553,923,476,447,2477,491,1392,487,677,228,317,185,108,24,264,151,113,13,13,153,53,100
"2021","Surrey Heath 002","E02006417",2585,784,357,427,1665,240,870,284,450,136,317,189,113,15,227,143,84,11,11,136,67,69
"2021","Surrey Heath 003","E02006418",2794,750,406,344,1930,396,1075,354,504,217,257,159,84,14,196,98,98,6,6,114,46,68
"2021","Surrey Heath 004","E02006419",3247,865,371,494,2108,203,1085,344,556,185,392,205,158,29,408,242,166,20,20,274,103,171
"2021","Surrey Heath 005","E02006420",3086,739,389,350,2132,438,1223,366,595,262,232,147,70,15,229,139,90,10,10,215,88,127
"2021","Surrey Heath 006","E02006421",3577,709,339,370,2697,357,1628,442,924,262,378,211,140,27,326,212,114,8,8,171,76,95
"2021","Surrey Heath 007","E02006422",2458,541,291,250,1823,318,1062,312,572,178,217,116,92,9,217,141,76,9,9,94,41,53
"2021","Surrey Heath 008","E02006423",4598,1345,520,825,2840,364,1443,453,713,277,552,335,191,26,434,261,173,47,47,413,169,244
"2021","Surrey Heath 009","E02006424",2429,463,292,171,1804,402,1074,273,592,209,160,80,64,16,157,77,80,11,11,162,79,83
"2021","Surrey Heath 010","E02006425",2527,629,294,335,1692,257,941,279,476,186,243,124,102,17,240,134,106,11,11,206,90,116
"2021","Surrey Heath 011","E02006426",2253,551,305,246,1587,276,901,283,437,181,239,118,103,18,161,89,72,10,10,115,44,71
"2021","Surrey Heath 012","E02006427",2899,768,367,401,1963,246,1147,354,583,210,342,199,130,13,222,124,98,6,6,168,71,97
"2021","Tandridge 002","E02006429",3616,1140,395,745,2302,297,1127,358,583,186,481,299,161,21,369,257,112,28,28,174,72,102
"2021","Tandridge 003","E02006430",3755,1004,455,549,2564,280,1340,330,755,255,424,181,212,31,501,331,170,19,19,187,91,96
"2021","Tandridge 004","E02006431",4574,1305,616,689,3038,415,1555,465,837,253,540,294,221,25,502,330,172,26,26,231,96,135
"2021","Tandridge 005","E02006432",2303,647,351,296,1547,286,882,250,453,179,182,80,92,10,185,95,90,12,12,109,45,64
"2021","Tandridge 006","E02006433",3874,1041,632,409,2655,540,1519,429,816,274,327,191,119,17,248,154,94,21,21,178,76,102
"2021","Tandridge 007","E02006434",2554,599,303,296,1840,294,949,262,511,176,304,137,147,20,281,167,114,12,12,115,47,68
"2021","Tandridge 008","E02006435",2496,656,314,342,1700,284,909,312,440,157,267,140,114,13,224,127,97,16,16,140,54,86
"2021","Tandridge 009","E02006436",2541,697,365,332,1691,255,844,276,394,174,318,148,146,24,260,176,84,14,14,153,62,91
"2021","Tandridge 010","E02006437",3410,923,552,371,2324,453,1215,419,563,233,341,186,129,26,308,189,119,7,7,163,65,98
"2021","Tandridge 011","E02006438",3336,826,480,346,2272,465,1220,424,516,280,333,169,130,34,245,138,107,9,9,238,100,138
"2021","Tandridge 012","E02006790",3162,864,536,328,2091,413,1061,333,507,221,294,132,131,31,308,178,130,15,15,207,100,107
"2021","Waverley 001","E02006439",2692,806,403,403,1770,317,902,277,464,161,325,203,101,21,215,118,97,11,11,116,48,68
"2021","Waverley 002","E02006440",2889,664,334,330,2044,376,1115,340,580,195,279,146,111,22,256,140,116,18,18,181,60,121
"2021","Waverley 003","E02006441",3735,1381,646,735,2035,313,926,334,471,121,453,297,141,15,317,202,115,26,26,319,54,265
"2021","Waverley 004","E02006442",2399,500,298,202,1784,384,1107,279,652,176,176,99,67,10,109,72,37,8,8,115,54,61
"2021","Waverley 005","E02006443",3268,1025,520,505,2056,251,1054,348,551,155,398,237,138,23,342,194,148,11,11,187,74,113
"2021","Waverley 006","E02006444",2785,681,349,332,1978,298,1161,288,713,160,236,111,113,12,268,168,100,15,15,126,44,82
"2021","Waverley 007","E02006445",3503,1145,415,730,2215,301,1153,391,643,119,454,341,103,10,284,173,111,23,23,143,39,104
"2021","Waverley 008","E02006446",2834,771,426,345,1942,379,1153,339,626,188,210,110,81,19,189,94,95,11,11,121,45,76
"2021","Waverley 009","E02006447",2603,630,328,302,1872,345,1066,266,615,185,219,118,92,9,230,132,98,12,12,101,38,63
"2021","Waverley 010","E02006448",2890,650,325,325,2118,311,1283,372,734,177,281,173,99,9,234,143,91,9,9,122,36,86
"2021","Waverley 011","E02006449",2996,923,555,368,1966,379,1097,323,566,208,242,134,95,13,240,142,98,8,8,107,26,81
"2021","Waverley 012","E02006450",2766,638,334,304,1998,357,1217,387,631,199,228,142,74,12,190,120,70,6,6,130,46,84
"2021","Waverley 013","E02006451",4908,1427,796,631,3306,798,1660,562,811,287,441,255,159,27,394,224,170,13,13,175,70,105
"2021","Waverley 015","E02006453",3436,950,607,343,2326,535,1293,426,632,235,270,176,86,8,222,110,112,6,6,160,55,105
"2021","Waverley 016","E02006454",2837,783,453,330,1957,382,1113,341,618,154,242,143,83,16,211,117,94,9,9,97,34,63
"2021","Waverley 017","E02006455",2482,741,318,423,1650,221,928,297,494,137,281,187,81,13,206,123,83,14,14,91,33,58
"2021","Waverley 018","E02006839",3434,929,482,447,2350,500,1354,452,672,230,284,179,87,18,206,107,99,6,6,155,64,91
"2021","Woking 001","E02006456",3251,899,484,415,2145,263,1123,314,601,208,368,180,162,26,369,206,163,22,22,207,83,124
"2021","Woking 002","E02006457",3734,901,475,426,2663,550,1588,449,872,267,287,169,104,14,220,119,101,18,18,170,58,112
"2021","Woking 003","E02006458",3534,710,343,367,2657,510,1592,440,871,281,285,174,97,14,248,135,113,22,22,167,64,103
"2021","Woking 004","E02006459",3491,897,276,621,1986,102,1142,232,695,215,311,192,90,29,382,212,170,49,49,608,355,253
"2021","Woking 005","E02006460",3932,1232,541,691,2486,242,1328,405,697,226,463,283,157,23,431,253,178,22,22,214,115,99
"2021","Woking 006","E02006461",2768,780,344,436,1782,315,1000,304,537,159,258,190,56,12,191,102,89,18,18,206,89,117
"2021","Woking 007","E02006462",3374,884,366,518,2289,269,1260,363,684,213,397,223,148,26,342,209,133,21,21,201,85,116
"2021","Woking 008","E02006463",5036,1888,596,1292,2835,198,1502,497,867,138,744,612,125,7,326,199,127,65,65,313,73,240
"2021","Woking 009","E02006464",2900,865,434,431,1898,264,1028,304,549,175,320,177,119,24,270,158,112,16,16,137,62,75
"2021","Woking 010","E02006465",2491,631,307,324,1718,296,1046,287,570,189,231,158,66,7,134,74,60,11,11,142,64,78
"2021","Woking 011","E02006466",4152,895,383,512,2895,215,1601,434,934,233,506,272,205,29,549,363,186,24,24,362,179,183
"2021","Woking 012","E02006467",2777,543,298,245,2065,288,1300,367,723,210,281,173,89,19,188,108,80,8,8,169,60,109
"2021","Adur 001","E02006534",3611,895,540,355,2459,407,1219,336,589,294,439,175,226,38,374,189,185,20,20,257,114,143
"2021","Adur 002","E02006535",3018,761,503,258,2112,446,1102,344,581,177,314,150,147,17,236,133,103,14,14,145,53,92
"2021","Adur 003","E02006536",2908,657,408,249,2068,401,1081,379,493,209,332,150,155,27,243,119,124,11,11,183,59,124
"2021","Adur 004","E02006537",4361,1321,682,639,2735,336,1182,359,603,220,561,230,276,55,633,407,226,23,23,305,115,190
"2021","Adur 005","E02006538",4356,1575,787,788,2542,449,1126,421,552,153,560,342,192,26,383,234,149,24,24,239,57,182
"2021","Adur 006","E02006539",3116,928,517,411,1989,395,901,316,387,198,376,178,169,29,303,165,138,14,14,199,76,123
"2021","Adur 007","E02006540",2613,866,505,361,1599,331,673,266,258,149,330,164,140,26,255,145,110,10,10,148,62,86
"2021","Adur 008","E02006541",3692,1413,774,639,2074,433,840,317,347,176,442,245,174,23,345,196,149,14,14,205,78,127
"2021","Arun 001","E02006542",2643,898,572,326,1617,404,780,331,294,155,244,157,71,16,175,101,74,14,14,128,48,80
"2021","Arun 002","E02006543",2492,693,454,239,1675,406,789,333,279,177,273,156,102,15,202,92,110,5,5,124,43,81
"2021","Arun 003","E02006544",4738,1173,648,525,3310,678,1717,621,753,343,512,271,207,34,388,225,163,15,15,255,86,169
"2021","Arun 004","E02006545",4788,1190,495,695,3286,351,1497,495,775,227,732,300,385,47,685,444,241,21,21,312,148,164
"2021","Arun 005","E02006546",4707,1316,885,431,3145,688,1482,508,698,276,500,259,205,36,456,265,191,19,19,246,89,157
"2021","Arun 006","E02006547",2723,740,411,329,1829,362,884,348,372,164,316,151,135,30,261,162,99,6,6,154,71,83
"2021","Arun 007","E02006548",4249,1245,740,505,2796,511,1309,470,583,256,490,244,211,35,465,261,204,21,21,208,81,127
"2021","Arun 008","E02006549",3008,931,694,237,1959,781,840,431,240,169,191,112,58,21,142,75,67,5,5,118,36,82
"2021","Arun 009","E02006550",4224,1283,878,405,2703,723,1226,464,441,321,378,176,157,45,354,195,159,22,22,238,92,146
"2021","Arun 010","E02006551",4189,1650,1231,419,2404,1083,884,473,221,190,243,168,66,9,183,78,105,11,11,135,43,92
"2021","Arun 011","E02006552",3630,1684,593,1091,1734,222,645,287,259,99,452,256,170,26,371,249,122,44,44,212,76,136
"2021","Arun 012","E02006553",4049,1028,567,461,2747,453,1261,467,579,215,595,317,243,35,422,260,162,16,16,274,121,153
"2021","Arun 013","E02006554",3141,1061,719,342,1940,566,845,376,318,151,295,173,99,23,229,124,105,5,5,140,51,89
"2021","Arun 014","E02006555",3234,994,464,530,1925,241,815,287,382,146,415,219,167,29,425,249,176,29,29,315,113,202
"2021","Arun 015","E02006556",4514,1241,832,409,3035,824,1399,501,613,285,455,241,189,25,348,216,132,9,9,238,94,144
"2021","Arun 016","E02006557",3016,810,366,444,1896,192,837,268,395,174,404,167,195,42,426,255,171,37,37,310,112,198
"2021","Arun 017","E02006558",5049,2321,943,1378,2321,366,803,357,316,130,639,416,199,24,442,289,153,71,71,407,115,292
"2021","Arun 018","E02006559",3852,1106,834,272,2584,1040,1101,518,358,225,265,158,85,22,163,72,91,15,15,162,56,106
"2021","Arun 019","E02006560",4426,1410,967,443,2817,854,1209,540,442,227,405,234,140,31,333,179,154,16,16,199,74,125
"2021","Chichester 001","E02006561",2645,638,322,316,1903,341,1125,394,564,167,237,131,90,16,195,116,79,5,5,104,36,68
"2021","Chichester 002","E02006562",2537,551,323,228,1875,426,1042,380,451,211,242,129,99,14,158,88,70,7,7,111,39,72
"2021","Chichester 003","E02006563",2428,620,359,261,1691,391,937,383,386,168,182,98,74,10,175,87,88,6,6,117,33,84
"2021","Chichester 004","E02006564",3816,1334,777,557,2356,580,1083,461,461,161,394,244,136,14,282,190,92,17,17,126,30,96
"2021","Chichester 005","E02006565",3552,1082,649,433,2325,556,1174,514,441,219,317,161,134,22,261,129,132,17,17,145,50,95
"2021","Chichester 006","E02006566",3668,1088,671,417,2399,654,1132,471,473,188,332,182,127,23,268,153,115,13,13,181,51,130
"2021","Chichester 007","E02006567",3344,920,506,414,2271,494,1154,455,491,208,317,178,112,27,295,180,115,11,11,153,48,105
"2021","Chichester 008","E02006568",5394,1949,868,1081,2955,431,1175,442,549,184,642,363,250,29,670,415,255,37,37,490,71,419
"2021","Chichester 009","E02006569",3726,1066,614,452,2489,584,1268,509,596,163,343,197,120,26,285,172,113,9,9,171,71,100
"2021","Chichester 010","E02006570",4347,1916,981,935,2156,400,862,378,360,124,508,366,125,17,333,186,147,53,53,275,53,222
"2021","Chichester 011","E02006571",3637,1058,604,454,2402,522,1221,454,568,199,348,188,136,24,288,175,113,23,23,177,52,125
"2021","Chichester 012","E02006572",4729,1385,666,719,3026,464,1428,511,658,259,594,292,264,38,513,318,195,27,27,318,104,214
"2021","Chichester 013","E02006573",5213,1558,1008,550,3388,901,1572,719,567,286,441,235,177,29,445,259,186,29,29,267,84,183
"2021","Chichester 014","E02006574",5078,1675,1130,545,3111,918,1329,659,412,258,427,219,175,33,416,200,216,21,21,292,97,195
"2021","Crawley 001","E02006575",3014,669,255,414,1866,145,1020,235,585,200,265,98,141,26,395,235,160,41,41,479,215,264
"2021","Crawley 002","E02006576",4190,910,374,536,3018,292,1640,491,887,262,627,352,250,25,435,310,125,24,24,262,111,151
"2021","Crawley 003","E02006577",3539,1007,474,533,2199,218,1116,329,599,188,385,173,179,33,454,296,158,26,26,333,139,194
"2021","Crawley 004","E02006578",5039,1447,454,993,2959,254,1430,391,822,217,625,373,227,25,558,389,169,92,92,633,229,404
"2021","Crawley 005","E02006579",3306,870,371,499,2108,247,1095,315,560,220,390,215,145,30,347,191,156,29,29,328,123,205
"2021","Crawley 006","E02006580",3265,795,393,402,2232,278,1140,337,559,244,403,220,158,25,384,213,171,27,27,238,100,138
"2021","Crawley 007","E02006581",4214,1274,468,806,2473,219,1140,347,600,193,539,304,212,23,534,361,173,41,41,467,165,302
"2021","Crawley 008","E02006582",2977,562,226,336,2242,234,1340,383,715,242,374,189,165,20,278,177,101,16,16,173,69,104
"2021","Crawley 009","E02006583",3812,1000,469,531,2494,329,1306,398,645,263,419,214,181,24,406,245,161,34,34,318,124,194
"2021","Crawley 010","E02006584",2952,739,207,532,1927,116,932,266,482,184,374,166,184,24,474,280,194,31,31,286,144,142
"2021","Crawley 011","E02006585",3086,767,430,337,1995,196,1017,247,567,203,345,149,167,29,409,237,172,28,28,324,151,173
"2021","Crawley 012","E02006586",2664,449,157,292,1817,115,902,220,469,213,327,125,174,28,435,269,166,38,38,398,178,220
"2021","Crawley 013","E02006587",3452,1027,301,726,2143,146,974,324,473,177,443,242,172,29,546,336,210,34,34,282,126,156
"2021","Horsham 001","E02006588",4484,1358,463,895,2881,380,1474,497,743,234,656,436,204,16,354,216,138,17,17,245,75,170
"2021","Horsham 002","E02006589",4635,1069,519,550,3409,597,1998,698,944,356,496,274,195,27,307,162,145,11,11,157,55,102
"2021","Horsham 003","E02006590",3812,1146,509,637,2504,397,1270,433,606,231,458,274,174,10,360,219,141,19,19,162,45,117
"2021","Horsham 004","E02006591",3652,1210,514,696,2277,337,1177,387,570,220,473,291,161,21,279,170,109,11,11,165,52,113
"2021","Horsham 005","E02006592",2560,581,323,258,1830,363,1062,378,494,190,261,158,87,16,135,77,58,9,9,149,55,94
"2021","Horsham 006","E02006593",5234,2024,878,1146,2930,397,1399,446,758,195,609,398,189,22,486,300,186,39,39,280,62,218
"2021","Horsham 007","E02006594",4526,1161,509,652,3180,417,1675,499,941,235,641,374,238,29,425,305,120,22,22,185,71,114
"2021","Horsham 008","E02006595",3363,750,439,311,2456,547,1396,515,642,239,327,194,113,20,173,94,79,13,13,157,57,100
"2021","Horsham 009","E02006596",3776,906,437,469,2761,353,1668,515,847,306,419,238,154,27,307,180,127,14,14,109,29,80
"2021","Horsham 010","E02006597",5152,1367,675,692,3561,524,1907,637,986,284,672,382,264,26,441,278,163,17,17,224,103,121
"2021","Horsham 011","E02006598",2258,532,267,265,1612,298,930,376,384,170,233,143,73,17,148,79,69,3,3,114,34,80
"2021","Horsham 012","E02006599",3104,714,525,189,2257,809,1139,580,359,200,182,105,61,16,126,49,77,1,1,133,44,89
"2021","Horsham 013","E02006600",4665,1622,956,666,2874,714,1291,553,532,206,466,281,165,20,391,235,156,12,12,169,46,123
"2021","Horsham 014","E02006601",3896,1193,717,476,2523,553,1219,473,534,212,385,203,156,26,352,209,143,14,14,180,66,114
"2021","Horsham 015","E02006602",3430,662,362,300,2604,524,1435,556,619,260,358,193,141,24,276,161,115,11,11,164,60,104
"2021","Horsham 016","E02006603",3815,1238,805,433,2433,637,1202,454,526,222,329,173,127,29,258,136,122,7,7,144,52,92
"2021","Mid Sussex 001","E02006604",5949,2054,867,1187,3619,505,1755,568,898,289,755,458,252,45,563,330,233,41,41,276,87,189
"2021","Mid Sussex 002","E02006605",2476,570,285,285,1733,303,947,315,441,191,261,141,99,21,207,123,84,15,15,173,83,90
"2021","Mid Sussex 003","E02006606",3412,854,447,407,2399,425,1295,450,603,242,376,206,141,29,294,186,108,9,9,159,69,90
"2021","Mid Sussex 004","E02006607",3217,775,427,348,2294,509,1281,390,650,241,280,158,99,23,213,110,103,11,11,148,58,90
"2021","Mid Sussex 005","E02006608",2609,642,411,231,1850,421,996,323,482,191,237,113,107,17,188,98,90,8,8,117,49,68
"2021","Mid Sussex 006","E02006609",2732,654,361,293,1934,386,1071,400,493,178,288,167,103,18,184,111,73,5,5,144,50,94
"2021","Mid Sussex 007","E02006610",3185,823,350,473,2202,336,1216,426,605,185,400,239,145,16,241,156,85,9,9,160,59,101
"2021","Mid Sussex 008","E02006611",4657,1152,726,426,3344,714,1842,495,1082,265,431,220,203,8,341,221,120,16,16,161,71,90
"2021","Mid Sussex 009","E02006612",5397,1966,757,1209,3174,405,1607,511,932,164,732,490,225,17,393,235,158,37,37,257,71,186
"2021","Mid Sussex 010","E02006613",3283,1012,417,595,2114,256,1097,330,578,189,402,246,137,19,345,204,141,14,14,157,64,93
"2021","Mid Sussex 011","E02006614",5222,1299,581,718,3671,533,1985,549,1134,302,630,372,233,25,504,314,190,19,19,252,93,159
"2021","Mid Sussex 012","E02006615",2781,605,274,331,2045,225,1132,345,586,201,404,225,154,25,271,160,111,13,13,131,50,81
"2021","Mid Sussex 013","E02006616",4060,986,490,496,2895,426,1513,480,772,261,583,329,221,33,362,216,146,11,11,179,59,120
"2021","Mid Sussex 014","E02006617",4067,1415,679,736,2430,314,1242,402,612,228,467,268,175,24,378,209,169,29,29,222,68,154
"2021","Mid Sussex 015","E02006618",2576,577,340,237,1881,408,1079,360,511,208,231,115,98,18,158,89,69,5,5,118,43,75
"2021","Mid Sussex 016","E02006619",3459,843,396,447,2442,381,1341,401,734,206,386,192,173,21,324,202,122,10,10,174,73,101
"2021","Mid Sussex 017","E02006620",4257,1193,791,402,2915,618,1576,463,890,223,405,216,163,26,303,161,142,13,13,149,55,94
"2021","Worthing 001","E02006621",3361,862,606,256,2312,742,1119,473,408,238,280,161,96,23,166,58,108,5,5,187,73,114
"2021","Worthing 002","E02006622",3435,1032,595,437,2215,464,1065,396,492,177,373,190,157,26,306,187,119,7,7,188,79,109
"2021","Worthing 003","E02006623",3456,1044,562,482,2219,383,995,346,454,195,399,184,197,18,419,252,167,23,23,193,68,125
"2021","Worthing 004","E02006624",2864,615,345,270,2065,386,1199,354,613,232,276,149,114,13,187,106,81,17,17,184,71,113
"2021","Worthing 005","E02006625",3307,924,424,500,2175,197,1135,333,581,221,462,234,200,28,361,211,150,20,20,208,81,127
"2021","Worthing 006","E02006626",3911,901,369,532,2757,230,1360,391,754,215,569,243,290,36,579,375,204,19,19,253,132,121
"2021","Worthing 007","E02006627",4242,1316,644,672,2707,452,1252,435,611,206,556,311,222,23,424,263,161,23,23,219,75,144
"2021","Worthing 008","E02006628",3956,1416,510,906,2292,150,1060,336,567,157,530,278,227,25,523,352,171,29,29,248,92,156
"2021","Worthing 009","E02006629",3299,1075,468,607,2019,255,923,280,475,168,385,201,161,23,424,245,179,32,32,205,87,118
"2021","Worthing 010","E02006630",4524,2266,952,1314,2038,317,799,363,327,109,553,382,160,11,335,224,111,34,34,220,51,169
"2021","Worthing 011","E02006631",5444,2739,852,1887,2380,246,822,346,385,91,764,551,195,18,490,320,170,58,58,325,79,246
"2021","Worthing 012","E02006632",3891,1412,726,686,2286,527,1033,396,458,179,425,258,141,26,286,172,114,15,15,193,59,134
"2021","Worthing 013","E02006633",3840,1158,790,368,2494,756,1131,445,475,211,299,169,115,15,289,160,129,19,19,188,64,124
"2021","Bath and North East Somerset 001","E02002985",2866,802,387,415,1914,319,891,305,440,146,396,226,151,19,288,182,106,20,20,150,48,102
"2021","Bath and North East Somerset 002","E02002986",3138,998,493,505,2033,265,884,288,439,157,499,297,184,18,367,218,149,18,18,107,42,65
"2021","Bath and North East Somerset 003","E02002987",2481,682,419,263,1712,426,891,262,444,185,216,134,64,18,172,102,70,7,7,87,23,64
"2021","Bath and North East Somerset 004","E02002988",2454,796,386,410,1522,245,809,254,436,119,242,148,83,11,214,131,83,12,12,136,30,106
"2021","Bath and North East Somerset 005","E02002989",2361,714,389,325,1480,250,776,226,424,126,208,117,79,12,227,148,79,19,19,167,41,126
"2021","Bath and North East Somerset 006","E02002990",2782,981,281,700,1555,174,691,265,340,86,430,325,92,13,234,146,88,26,26,246,40,206
"2021","Bath and North East Somerset 007","E02002991",5467,2322,808,1514,2597,399,1110,504,492,114,735,629,93,13,279,155,124,74,74,548,43,505
"2021","Bath and North East Somerset 008","E02002992",2427,763,442,321,1478,224,840,245,460,135,240,151,80,9,155,88,67,19,19,186,29,157
"2021","Bath and North East Somerset 009","E02002993",2565,988,263,725,1196,135,524,216,244,64,371,317,53,1,141,76,65,25,25,381,15,366
"2021","Bath and North East Somerset 010","E02002994",4320,1170,658,512,2920,617,1624,542,810,272,375,217,133,25,294,172,122,10,10,230,74,156
"2021","Bath and North East Somerset 011","E02002995",2398,805,252,553,1338,93,497,167,220,110,311,145,144,22,413,277,136,24,24,255,40,215
"2021","Bath and North East Somerset 012","E02002996",3587,1017,521,496,2021,377,1054,416,501,137,357,262,83,12,198,117,81,35,35,549,49,500
"2021","Bath and North East Somerset 013","E02002997",3125,893,237,656,1461,173,619,246,298,75,438,335,86,17,193,111,82,38,38,771,28,743
"2021","Bath and North East Somerset 014","E02002998",2273,626,266,360,1131,143,555,191,269,95,206,126,72,8,207,122,85,20,20,516,34,482
"2021","Bath and North East Somerset 015","E02002999",2336,681,372,309,1404,229,666,232,296,138,246,120,107,19,243,140,103,20,20,251,61,190
"2021","Bath and North East Somerset 016","E02003000",4016,1021,666,355,2822,693,1499,543,638,318,363,199,144,20,257,126,131,10,10,173,52,121
"2021","Bath and North East Somerset 017","E02003001",2232,565,303,262,1504,263,893,276,496,121,205,132,63,10,130,71,59,13,13,163,27,136
"2021","Bath and North East Somerset 018","E02003002",2663,820,415,405,1625,235,788,240,426,122,257,131,112,14,327,228,99,18,18,218,49,169
"2021","Bath and North East Somerset 019","E02003003",2363,616,285,331,1489,193,755,244,369,142,272,146,106,20,252,131,121,17,17,258,51,207
"2021","Bath and North East Somerset 020","E02003004",2885,586,294,292,2135,378,1109,382,498,229,412,202,187,23,227,134,93,9,9,164,53,111
"2021","Bath and North East Somerset 021","E02003005",2678,568,356,212,1941,432,1108,380,529,199,215,114,95,6,175,100,75,11,11,169,60,109
"2021","Bath and North East Somerset 022","E02003006",3605,927,446,481,2437,382,1338,460,599,279,366,184,156,26,340,206,134,11,11,241,94,147
"2021","Bath and North East Somerset 023","E02003007",3948,1027,520,507,2753,483,1370,458,641,271,516,261,222,33,364,232,132,20,20,168,71,97
"2021","Bath and North East Somerset 024","E02003008",2557,688,293,395,1736,202,808,278,386,144,399,189,189,21,317,212,105,10,10,133,45,88
"2021","Bath and North East Somerset 025","E02003009",2663,759,362,397,1797,313,907,320,389,198,352,190,142,20,213,138,75,12,12,107,44,63
"2021","Bath and North East Somerset 026","E02003010",2609,628,294,334,1872,267,899,279,419,201,400,194,179,27,285,171,114,21,21,109,49,60
"2021","Bath and North East Somerset 027","E02003011",2464,640,375,265,1720,369,834,284,367,183,260,114,115,31,250,153,97,7,7,104,36,68
"2021","Bristol 001","E02003012",5057,1507,568,939,3162,354,1327,395,693,239,660,355,259,46,764,515,249,57,57,388,134,254
"2021","Bristol 002","E02003013",4806,1365,661,704,2883,249,1352,340,727,285,538,253,237,48,700,400,300,44,44,558,183,375
"2021","Bristol 003","E02003014",3358,953,407,546,2120,142,797,248,413,136,410,153,220,37,721,537,184,50,50,285,137,148
"2021","Bristol 004","E02003015",2772,721,333,388,1691,184,828,215,476,137,311,204,92,15,337,179,158,31,31,360,64,296
"2021","Bristol 005","E02003016",3064,785,239,546,1686,119,700,219,348,133,406,285,109,12,431,289,142,30,30,593,103,490
"2021","Bristol 006","E02003017",2743,926,515,411,1670,291,936,265,545,126,232,160,67,5,200,109,91,11,11,147,42,105
"2021","Bristol 007","E02003018",2497,639,344,295,1698,243,840,258,417,165,266,140,108,18,335,203,132,14,14,160,57,103
"2021","Bristol 008","E02003019",4258,1276,584,692,2624,316,1164,392,547,225,594,319,244,31,502,291,211,48,48,358,136,222
"2021","Bristol 009","E02003020",2502,663,465,198,1751,374,1069,282,656,131,195,115,70,10,107,62,45,6,6,88,31,57
"2021","Bristol 010","E02003021",2732,629,229,400,1537,127,751,198,466,87,425,281,132,12,209,137,72,25,25,566,65,501
"2021","Bristol 011","E02003022",2442,550,387,163,1782,371,1128,310,680,138,155,83,67,5,121,67,54,7,7,110,25,85
"2021","Bristol 012","E02003023",2612,850,364,486,1483,221,706,238,328,140,279,165,102,12,254,145,109,23,23,279,84,195
"2021","Bristol 013","E02003024",4015,1238,549,689,2272,251,953,272,514,167,570,355,179,36,461,304,157,37,37,505,118,387
"2021","Bristol 014","E02003025",2904,812,345,467,1685,134,737,182,418,137,371,195,155,21,410,249,161,33,33,407,106,301
"2021","Bristol 015","E02003026",3295,877,520,357,2235,519,1238,407,669,162,271,182,76,13,194,115,79,13,13,183,51,132
"2021","Bristol 016","E02003027",5025,1273,429,844,2928,213,1568,394,1033,141,808,541,237,30,288,174,114,51,51,824,75,749
"2021","Bristol 017","E02003028",3441,925,382,543,2106,265,1268,349,763,156,406,294,106,6,153,107,46,14,14,410,53,357
"2021","Bristol 018","E02003029",2516,665,308,357,1583,115,723,187,385,151,322,149,148,25,399,239,160,24,24,268,110,158
"2021","Bristol 019","E02003030",3251,1082,280,802,1748,143,794,241,406,147,467,274,175,18,309,199,110,35,35,421,113,308
"2021","Bristol 020","E02003031",4103,1087,258,829,2268,188,1186,352,705,129,685,524,144,17,165,106,59,44,44,748,66,682
"2021","Bristol 021","E02003032",3371,986,329,657,2000,170,906,268,494,144,482,279,183,20,413,248,165,29,29,385,128,257
"2021","Bristol 022","E02003033",3501,1032,239,793,1552,146,625,242,311,72,629,551,66,12,111,69,42,41,41,917,45,872
"2021","Bristol 025","E02003036",3612,1299,196,1103,1612,106,581,245,274,62,709,637,63,9,155,110,45,61,61,701,30,671
"2021","Bristol 026","E02003037",3987,1325,295,1030,1715,132,671,298,313,60,767,700,62,5,99,61,38,46,46,947,39,908
"2021","Bristol 027","E02003038",2951,900,334,566,1782,155,840,268,402,170,462,269,163,30,288,180,108,37,37,269,95,174
"2021","Bristol 028","E02003039",3773,1251,368,883,2166,214,923,267,480,176,577,376,181,20,426,278,148,26,26,356,104,252
"2021","Bristol 029","E02003040",4643,1645,355,1290,2392,132,797,308,399,90,977,713,249,15,413,263,150,73,73,606,70,536
"2021","Bristol 030","E02003041",2878,1044,355,689,1365,198,535,242,232,61,511,460,51,0,90,65,25,31,31,469,23,446
"2021","Bristol 033","E02003044",2655,730,260,470,1725,242,774,263,352,159,441,282,136,23,246,139,107,22,22,200,48,152
"2021","Bristol 034","E02003045",2842,1056,278,778,1301,144,492,232,208,52,491,430,57,4,154,109,45,20,20,485,23,462
"2021","Bristol 035","E02003046",4357,1281,379,902,2702,188,1157,421,557,179,882,597,248,37,435,275,160,40,40,374,100,274
"2021","Bristol 036","E02003047",4741,1382,398,984,2650,183,1196,346,721,129,928,691,209,28,308,185,123,35,35,709,62,647
"2021","Bristol 037","E02003048",3156,1019,185,834,1740,73,719,293,376,50,689,544,135,10,218,122,96,41,41,397,56,341
"2021","Bristol 038","E02003049",3299,908,392,516,2147,257,1020,333,487,200,473,276,166,31,371,242,129,26,26,244,77,167
"2021","Bristol 039","E02003050",4940,1761,467,1294,2487,153,861,371,392,98,1079,921,138,20,316,197,119,78,78,692,71,621
"2021","Bristol 040","E02003051",2998,713,214,499,1864,89,816,238,478,100,569,369,177,23,353,229,124,37,37,421,75,346
"2021","Bristol 041","E02003052",3030,767,300,467,1928,214,906,275,465,166,510,339,151,20,271,155,116,27,27,335,56,279
"2021","Bristol 042","E02003053",3446,928,397,531,2209,234,1155,328,654,173,534,318,192,24,258,136,122,28,28,309,96,213
"2021","Bristol 043","E02003054",2823,787,269,518,1842,229,921,306,458,157,406,233,157,16,267,154,113,19,19,194,68,126
"2021","Bristol 044","E02003055",3292,755,332,423,2217,145,950,263,483,204,498,226,219,53,587,391,196,37,37,320,138,182
"2021","Bristol 045","E02003056",2924,764,311,453,1864,153,718,208,345,165,407,154,201,52,553,356,197,33,33,296,145,151
"2021","Bristol 046","E02003057",2548,654,324,330,1722,238,778,243,360,175,415,235,160,20,265,150,115,26,26,172,64,108
"2021","Bristol 047","E02003058",4075,1152,497,655,2638,352,1089,351,492,246,589,277,271,41,574,375,199,34,34,285,125,160
"2021","Bristol 048","E02003059",2875,890,396,494,1801,218,745,254,333,158,453,278,146,29,364,237,127,21,21,184,62,122
"2021","Bristol 049","E02003060",4669,1425,757,668,2987,518,1402,421,616,365,522,253,235,34,516,298,218,29,29,257,104,153
"2021","Bristol 050","E02003061",2497,668,293,375,1644,151,597,190,268,139,346,139,174,33,526,357,169,24,24,185,81,104
"2021","Bristol 051","E02003062",2382,733,269,464,1449,148,500,137,230,133,335,126,179,30,449,308,141,17,17,200,89,111
"2021","Bristol 052","E02003063",2978,695,439,256,2126,445,1056,363,433,260,348,157,162,29,262,136,126,15,15,157,53,104
"2021","Bristol 053","E02003064",2982,935,317,618,1857,117,551,156,274,121,442,148,257,37,723,551,172,24,24,190,102,88
"2021","Bristol 054","E02006887",4563,2016,208,1808,1978,36,561,256,279,26,893,812,75,6,390,278,112,98,98,569,42,527
"2021","Bristol 055","E02006888",2882,981,195,786,1426,38,545,132,353,60,330,205,102,23,442,293,149,71,71,475,113,362
"2021","Bristol 056","E02006889",3067,1098,292,806,1566,41,621,120,438,63,256,146,96,14,599,449,150,49,49,403,127,276
"2021","Bristol 057","E02006890",3655,1076,249,827,1914,73,773,193,473,107,571,370,187,14,431,278,153,66,66,665,146,519
"2021","Bristol 058","E02006949",2804,850,208,642,1347,58,452,153,256,43,452,313,130,9,335,214,121,50,50,607,82,525
"2021","Bristol 059","E02006950",3293,1216,122,1094,1364,12,382,122,226,34,555,488,63,4,348,238,110,67,67,713,79,634
"2021","Bristol 060","E02006951",2936,1102,135,967,1004,38,366,204,146,16,462,425,36,1,99,66,33,39,39,830,28,802
"2021","Bristol 061","E02006952",2820,1214,175,1039,1136,88,370,221,129,20,522,483,35,4,100,61,39,56,56,470,15,455
"2021","North Somerset 001","E02003065",4604,1635,804,831,2775,528,1359,479,672,208,501,317,159,25,362,231,131,25,25,194,56,138
"2021","North Somerset 002","E02003066",2617,621,404,217,1906,523,1059,408,461,190,198,111,76,11,121,72,49,5,5,90,35,55
"2021","North Somerset 003","E02003067",3458,1035,556,479,2299,358,1245,378,717,150,375,193,160,22,313,215,98,8,8,124,60,64
"2021","North Somerset 004","E02003068",2728,723,384,339,1881,427,901,320,426,155,318,176,125,17,217,125,92,18,18,124,44,80
"2021","North Somerset 005","E02003069",2505,769,423,346,1663,436,878,343,405,130,220,141,72,7,124,64,60,5,5,73,23,50
"2021","North Somerset 006","E02003070",5420,1308,731,577,3905,769,2226,683,1277,266,553,308,218,27,341,218,123,16,16,207,74,133
"2021","North Somerset 007","E02003071",3715,1384,725,659,2196,429,1016,378,462,176,410,235,148,27,327,204,123,14,14,135,45,90
"2021","North Somerset 008","E02003072",4246,1417,897,520,2681,704,1214,441,529,244,403,221,153,29,347,186,161,13,13,148,62,86
"2021","North Somerset 009","E02003073",2659,627,403,224,1952,504,1056,363,486,207,198,113,74,11,187,108,79,7,7,80,36,44
"2021","North Somerset 010","E02003074",3452,1092,546,546,2238,387,1160,434,520,206,402,233,146,23,281,164,117,8,8,122,45,77
"2021","North Somerset 011","E02003075",2397,504,302,202,1776,376,1053,300,576,177,174,73,89,12,170,103,67,3,3,117,42,75
"2021","North Somerset 012","E02003076",4138,1067,603,464,2870,540,1516,536,698,282,479,291,168,20,323,208,115,12,12,201,70,131
"2021","North Somerset 013","E02003077",2615,643,374,269,1813,399,953,343,437,173,293,154,124,15,157,91,66,11,11,159,59,100
"2021","North Somerset 014","E02003078",3102,823,458,365,2086,487,1088,413,474,201,294,153,120,21,206,129,77,11,11,193,74,119
"2021","North Somerset 015","E02003079",3866,956,465,491,2745,418,1431,515,623,293,518,249,242,27,368,254,114,10,10,165,71,94
"2021","North Somerset 016","E02003080",4003,1365,885,480,2458,607,1006,415,377,214,405,186,188,31,423,242,181,17,17,180,78,102
"2021","North Somerset 017","E02003081",4143,1182,686,496,2768,707,1300,500,529,271,446,231,176,39,309,189,120,6,6,193,79,114
"2021","North Somerset 018","E02003082",4662,2185,737,1448,2222,445,850,464,249,137,541,390,129,22,353,208,145,33,33,255,69,186
"2021","North Somerset 020","E02003084",5185,2384,712,1672,2428,299,910,328,429,153,582,372,184,26,581,379,202,56,56,373,134,239
"2021","North Somerset 021","E02003085",3460,1225,489,736,2028,135,722,259,306,157,434,168,230,36,709,527,182,28,28,207,94,113
"2021","North Somerset 022","E02003086",2792,1096,451,645,1511,309,675,280,267,128,290,175,94,21,226,151,75,11,11,185,67,118
"2021","North Somerset 023","E02003087",4714,1235,720,515,3256,766,1560,654,654,252,534,302,211,21,388,256,132,8,8,223,82,141
"2021","North Somerset 024","E02003088",3759,1005,631,374,2538,676,1307,501,586,220,318,161,136,21,227,136,91,10,10,216,84,132
"2021","North Somerset 025","E02003089",2598,755,421,334,1693,376,721,296,301,124,245,104,110,31,343,223,120,8,8,150,45,105
"2021","North Somerset 026","E02006845",3936,1064,427,637,2686,293,1283,425,688,170,606,317,268,21,487,354,133,17,17,186,92,94
"2021","North Somerset 027","E02006846",3876,992,221,771,2655,103,1221,348,740,133,772,392,362,18,536,430,106,23,23,229,106,123
"2021","South Gloucestershire 001","E02003090",3759,936,500,436,2687,541,1352,415,720,217,480,273,190,17,305,201,104,9,9,136,59,77
"2021","South Gloucestershire 002","E02003091",2913,831,472,359,1963,396,961,333,437,191,308,169,105,34,285,172,113,13,13,119,40,79
"2021","South Gloucestershire 003","E02003092",3258,662,321,341,2427,398,1379,492,627,260,386,216,143,27,258,177,81,6,6,169,73,96
"2021","South Gloucestershire 004","E02003093",2789,680,427,253,1947,547,1025,392,428,205,225,123,88,14,145,76,69,5,5,162,63,99
"2021","South Gloucestershire 005","E02003094",3567,854,396,458,2474,448,1334,479,618,237,396,211,157,28,277,163,114,19,19,239,98,141
"2021","South Gloucestershire 006","E02003095",3444,761,285,476,2519,408,1321,473,584,264,487,282,183,22,290,185,105,13,13,164,69,95
"2021","South Gloucestershire 007","E02003096",2711,807,367,440,1792,252,806,278,327,201,414,217,173,24,299,193,106,21,21,112,49,63
"2021","South Gloucestershire 008","E02003097",2880,867,544,323,1892,513,864,321,369,174,288,160,110,18,220,124,96,7,7,121,45,76
"2021","South Gloucestershire 009","E02003098",4076,1023,266,757,2827,172,1649,496,897,256,638,428,183,27,351,236,115,17,17,226,91,135
"2021","South Gloucestershire 010","E02003099",3188,875,484,391,2149,394,1007,339,453,215,394,190,178,26,342,207,135,12,12,164,62,102
"2021","South Gloucestershire 012","E02003101",4343,1085,268,817,2995,233,1680,505,910,265,673,453,195,25,380,250,130,29,29,263,97,166
"2021","South Gloucestershire 013","E02003102",2828,569,349,220,2151,438,1155,351,584,220,254,127,111,16,293,185,108,11,11,108,35,73
"2021","South Gloucestershire 014","E02003103",2860,643,280,363,2059,235,972,283,480,209,467,230,209,28,372,231,141,13,13,158,56,102
"2021","South Gloucestershire 015","E02003104",3176,864,417,447,2137,310,1112,382,478,252,397,218,153,26,300,180,120,18,18,175,61,114
"2021","South Gloucestershire 016","E02003105",2603,675,438,237,1810,408,927,278,425,224,245,116,104,25,217,131,86,13,13,118,48,70
"2021","South Gloucestershire 018","E02003107",4589,1389,620,769,2434,359,1130,347,543,240,486,298,160,28,408,255,153,51,51,766,128,638
"2021","South Gloucestershire 019","E02003108",5038,1223,495,728,3516,541,1640,537,787,316,804,490,276,38,506,331,175,25,25,299,127,172
"2021","South Gloucestershire 020","E02003109",2441,530,349,181,1810,400,1062,272,581,209,211,96,100,15,131,70,61,6,6,101,34,67
"2021","South Gloucestershire 021","E02003110",4771,920,315,605,3609,385,2028,583,1150,295,703,405,265,33,478,350,128,15,15,242,110,132
"2021","South Gloucestershire 022","E02003111",2750,840,502,338,1765,324,991,271,519,201,301,187,96,18,139,67,72,10,10,145,43,102
"2021","South Gloucestershire 023","E02003112",2669,748,443,305,1775,252,802,232,391,179,350,156,163,31,344,205,139,27,27,146,44,102
"2021","South Gloucestershire 024","E02003113",4296,1047,603,444,3023,591,1683,651,699,333,455,261,157,37,282,165,117,12,12,226,90,136
"2021","South Gloucestershire 025","E02003114",3181,982,519,463,2032,344,935,322,422,191,427,216,179,32,307,173,134,19,19,167,47,120
"2021","South Gloucestershire 026","E02003115",4239,1343,489,854,2601,336,1126,371,533,222,621,356,232,33,482,295,187,36,36,295,87,208
"2021","South Gloucestershire 027","E02003116",3322,1069,516,553,2051,302,842,262,396,184,463,219,204,40,423,260,163,21,21,202,66,136
"2021","South Gloucestershire 028","E02003117",3927,1097,448,649,2556,346,1148,350,556,242,618,359,226,33,412,268,144,32,32,274,83,191
"2021","South Gloucestershire 029","E02003118",4201,1132,470,662,2881,346,1477,500,642,335,621,378,205,38,419,227,192,18,18,188,67,121
"2021","South Gloucestershire 030","E02003119",4206,1012,477,535,3009,426,1454,498,643,313,580,276,265,39,526,321,205,23,23,185,70,115
"2021","South Gloucestershire 031","E02003120",3842,1020,537,483,2644,544,1404,456,642,306,406,221,156,29,273,154,119,17,17,178,64,114
"2021","South Gloucestershire 032","E02003121",4410,1206,685,521,3021,670,1531,583,625,323,482,267,182,33,320,168,152,18,18,183,70,113
"2021","South Gloucestershire 033","E02007064",3333,980,472,508,2099,328,977,313,459,205,410,201,178,31,354,216,138,30,30,254,88,166
"2021","South Gloucestershire 034","E02007065",3189,781,194,587,2150,118,983,311,563,109,562,353,195,14,453,332,121,34,34,258,89,169
"2021","South Gloucestershire 035","E02007066",2645,731,193,538,1454,79,693,219,411,63,362,261,96,5,290,232,58,30,30,460,55,405
"2021","South Gloucestershire 036","E02007067",2656,569,238,331,1890,253,1070,338,576,156,325,219,96,10,217,151,66,25,25,197,60,137
"2021","Plymouth 001","E02003122",3152,802,498,304,2222,558,1150,510,447,193,298,163,120,15,204,119,85,12,12,128,53,75
"2021","Plymouth 002","E02003123",3735,1074,548,526,2516,335,1090,405,470,215,510,201,272,37,560,380,180,21,21,145,54,91
"2021","Plymouth 003","E02003124",3546,1076,449,627,2324,246,974,343,447,184,560,252,270,38,534,379,155,10,10,146,77,69
"2021","Plymouth 004","E02003125",2732,936,394,542,1677,243,695,297,246,152,376,177,164,35,350,219,131,13,13,119,46,73
"2021","Plymouth 005","E02003126",3469,975,494,481,2344,435,1099,426,467,206,426,220,186,20,374,254,120,10,10,150,54,96
"2021","Plymouth 006","E02003127",3078,851,424,427,2027,242,888,312,394,182,431,173,219,39,456,270,186,10,10,200,90,110
"2021","Plymouth 007","E02003128",4093,1344,616,728,2577,301,1053,412,458,183,611,306,272,33,587,370,217,25,25,172,75,97
"2021","Plymouth 008","E02003129",2814,839,480,359,1878,331,988,371,465,152,292,158,116,18,255,148,107,12,12,97,45,52
"2021","Plymouth 009","E02003130",4531,1337,591,746,2983,363,1308,545,512,251,621,291,278,52,660,433,227,31,31,211,78,133
"2021","Plymouth 010","E02003131",3181,922,478,444,2123,351,928,330,387,211,415,186,189,40,415,262,153,14,14,136,51,85
"2021","Plymouth 011","E02003132",3741,1050,477,573,2524,351,1226,449,576,201,467,222,213,32,461,277,184,19,19,167,67,100
"2021","Plymouth 012","E02003133",3055,795,426,369,2119,385,1012,415,392,205,364,174,158,32,350,209,141,8,8,141,60,81
"2021","Plymouth 013","E02003134",2880,764,298,466,1950,192,864,340,381,143,423,183,215,25,455,270,185,16,16,166,69,97
"2021","Plymouth 014","E02003135",2931,838,283,555,1909,139,705,285,294,126,471,211,226,34,564,385,179,30,30,184,70,114
"2021","Plymouth 015","E02003136",3331,919,597,322,2282,571,1122,434,446,242,311,170,116,25,274,155,119,4,4,130,51,79
"2021","Plymouth 016","E02003137",3165,823,456,367,2190,408,1212,406,588,218,363,197,144,22,201,122,79,6,6,152,71,81
"2021","Plymouth 017","E02003138",3220,935,345,590,2084,195,1092,394,544,154,496,314,159,23,288,180,108,13,13,201,67,134
"2021","Plymouth 018","E02003139",2737,583,225,358,2082,257,1093,405,507,181,456,248,186,22,270,190,80,6,6,72,35,37
"2021","Plymouth 019","E02003140",3246,831,475,356,2299,399,1203,423,574,206,395,188,185,22,286,167,119,16,16,116,48,68
"2021","Plymouth 020","E02003141",3780,1542,347,1195,1977,167,816,344,343,129,580,350,212,18,384,239,145,30,30,261,70,191
"2021","Plymouth 021","E02003142",4007,1228,523,705,2559,320,1044,387,444,213,599,318,247,34,571,352,219,25,25,220,92,128
"2021","Plymouth 022","E02003143",3281,1022,539,483,2150,377,1054,431,431,192,384,201,162,21,329,219,110,6,6,109,51,58
"2021","Plymouth 023","E02003144",3213,1224,229,995,1200,106,404,177,172,55,490,394,84,12,161,96,65,39,39,789,56,733
"2021","Plymouth 024","E02003145",2863,986,392,594,1633,209,747,298,326,123,347,214,121,12,309,202,107,21,21,244,69,175
"2021","Plymouth 025","E02003146",3512,1178,287,891,1758,129,726,253,367,106,576,351,206,19,290,200,90,37,37,576,75,501
"2021","Plymouth 026","E02003147",4349,1812,456,1356,2314,155,821,291,398,132,605,285,290,30,699,504,195,34,34,223,79,144
"2021","Plymouth 027","E02003148",4424,2231,543,1688,1616,160,458,233,184,41,572,432,126,14,386,267,119,40,40,577,54,523
"2021","Plymouth 028","E02003149",4324,1757,399,1358,1980,130,673,274,306,93,666,445,198,23,472,314,158,39,39,587,94,493
"2021","Plymouth 030","E02003151",3561,972,649,323,2457,661,1257,458,591,208,307,162,121,24,220,142,78,12,12,132,52,80
"2021","Plymouth 031","E02003152",4770,1256,689,567,3305,588,1685,620,790,275,590,305,252,33,432,248,184,10,10,209,83,126
"2021","Plymouth 032","E02003153",3335,1048,594,454,2188,430,1107,416,508,183,339,179,143,17,300,178,122,12,12,99,38,61
"2021","Plymouth 033","E02006989",2685,1298,289,1009,1118,81,424,169,198,57,305,204,92,9,282,185,97,26,26,269,50,219
"2021","Plymouth 034","E02006990",3826,2086,592,1494,1531,186,503,272,180,51,471,363,98,10,332,220,112,39,39,209,40,169
"2021","Torbay 001","E02003154",3043,879,531,348,1983,323,818,331,308,179,360,146,183,31,456,289,167,26,26,181,79,102
"2021","Torbay 002","E02003155",2722,1049,565,484,1520,330,664,277,264,123,247,128,105,14,259,141,118,20,20,153,59,94
"2021","Torbay 003","E02003156",4407,1103,523,580,3076,467,1476,527,723,226,607,306,268,33,513,337,176,13,13,228,91,137
"2021","Torbay 004","E02003157",3064,1117,378,739,1728,201,693,260,302,131,350,180,139,31,467,316,151,17,17,219,87,132
"2021","Torbay 005","E02003158",2618,1010,615,395,1435,284,573,220,231,122,272,141,104,27,288,185,103,18,18,173,73,100
"2021","Torbay 006","E02003159",2595,877,330,547,1523,146,625,225,277,123,349,182,146,21,386,256,130,17,17,195,81,114
"2021","Torbay 008","E02003161",3957,2007,581,1426,1662,188,576,290,200,86,476,312,142,22,382,273,109,40,40,288,99,189
"2021","Torbay 010","E02003163",4341,2017,1018,999,2165,673,895,545,211,139,357,255,91,11,217,122,95,23,23,159,29,130
"2021","Torbay 011","E02003164",3922,1168,749,419,2503,615,1179,453,475,251,371,197,151,23,323,180,143,15,15,251,98,153
"2021","Torbay 012","E02003165",3070,833,437,396,2053,371,966,390,407,169,387,176,189,22,316,179,137,13,13,184,77,107
"2021","Torbay 013","E02003166",5193,1353,639,714,3486,504,1549,547,699,303,708,294,371,43,704,446,258,21,21,354,184,170
"2021","Torbay 014","E02003167",5013,2451,1078,1373,2219,454,812,375,260,177,475,298,150,27,441,266,175,37,37,343,103,240
"2021","Torbay 015","E02003168",3291,1083,688,395,2028,479,963,459,328,176,319,156,138,25,257,153,104,10,10,180,65,115
"2021","Torbay 016","E02003169",3033,834,635,199,2061,726,935,454,305,176,215,118,76,21,175,85,90,10,10,138,38,100
"2021","Torbay 017","E02003170",4639,1676,987,689,2758,788,1178,616,337,225,390,227,139,24,388,221,167,14,14,205,74,131
"2021","Torbay 018","E02003171",3300,999,610,389,2136,493,998,478,328,192,314,160,125,29,326,179,147,5,5,165,60,105
"2021","Torbay 019","E02006840",4787,1428,723,705,3042,594,1381,508,614,259,530,255,240,35,523,347,176,14,14,317,126,191
"2021","Swindon 001","E02003212",3744,1131,651,480,2487,546,1224,466,504,254,383,215,135,33,317,177,140,17,17,126,49,77
"2021","Swindon 003","E02003214",2810,823,357,466,1849,142,654,222,308,124,393,109,254,30,638,487,151,22,22,138,78,60
"2021","Swindon 004","E02003215",3051,937,485,452,2002,477,1008,398,405,205,317,190,107,20,191,93,98,9,9,112,46,66
"2021","Swindon 005","E02003216",4278,1254,644,610,2802,485,1398,536,570,292,513,282,201,30,387,223,164,19,19,222,88,134
"2021","Swindon 006","E02003217",3020,920,432,488,1906,232,935,315,450,170,385,179,173,33,330,214,116,24,24,194,93,101
"2021","Swindon 007","E02003218",2553,679,329,350,1681,205,762,232,359,171,297,109,153,35,395,249,146,22,22,193,89,104
"2021","Swindon 008","E02003219",4943,924,328,596,3762,396,2140,719,1153,268,800,448,323,29,408,293,115,18,18,257,121,136
"2021","Swindon 009","E02003220",4453,1324,624,700,2925,537,1556,573,662,321,472,262,172,38,341,195,146,19,19,204,81,123
"2021","Swindon 010","E02003221",2883,913,338,575,1613,149,842,267,414,161,314,160,133,21,282,161,121,26,26,357,177,180
"2021","Swindon 011","E02003222",2516,656,187,469,1756,161,1037,372,473,192,331,193,122,16,208,133,75,19,19,104,44,60
"2021","Swindon 012","E02003223",4651,1474,391,1083,2812,257,1436,461,730,245,675,398,238,39,389,260,129,55,55,365,165,200
"2021","Swindon 013","E02003224",3816,1134,620,514,2517,535,1247,524,467,256,427,235,155,37,295,158,137,13,13,165,73,92
"2021","Swindon 014","E02003225",2838,866,216,650,1832,217,1018,383,461,174,354,222,119,13,226,152,74,17,17,140,56,84
"2021","Swindon 015","E02003226",3741,1189,271,918,1756,71,1069,262,636,171,269,171,86,12,291,170,121,56,56,796,489,307
"2021","Swindon 016","E02003227",2786,901,352,549,1671,100,712,173,392,147,286,111,150,25,547,382,165,26,26,214,104,110
"2021","Swindon 017","E02003228",2925,750,322,428,1859,239,1089,328,556,205,286,158,113,15,217,118,99,28,28,316,196,120
"2021","Swindon 018","E02003229",2361,598,182,416,1665,151,945,377,399,169,307,169,126,12,254,143,111,8,8,98,43,55
"2021","Swindon 019","E02003230",3905,1462,289,1173,1995,95,974,342,543,89,565,422,129,14,296,193,103,65,65,448,151,297
"2021","Swindon 020","E02003231",3267,834,388,446,2148,199,938,290,456,192,339,116,184,39,636,434,202,36,36,285,151,134
"2021","Swindon 021","E02003232",3597,1074,309,765,2280,234,1271,434,675,162,459,300,150,9,276,158,118,40,40,243,94,149
"2021","Swindon 022","E02003233",3744,1214,542,672,2308,305,1143,425,507,211,395,189,177,29,445,279,166,20,20,222,110,112
"2021","Swindon 023","E02003234",3568,1053,520,533,2294,402,1106,433,424,249,383,170,183,30,384,224,160,19,19,221,113,108
"2021","Swindon 024","E02003235",4114,1288,570,718,2621,435,1389,483,701,205,455,300,144,11,316,217,99,26,26,205,83,122
"2021","Swindon 025","E02003236",5312,1360,743,617,3704,701,1908,644,919,345,604,326,235,43,473,289,184,18,18,248,106,142
"2021","Swindon 026","E02006847",3662,749,138,611,2726,152,1580,384,1008,188,577,290,260,27,405,306,99,12,12,187,97,90
"2021","Swindon 027","E02006848",3414,937,119,818,2288,82,1174,291,774,109,578,328,231,19,423,338,85,31,31,189,90,99
"2021","Swindon 028","E02006849",3934,779,201,578,2949,272,1747,518,985,244,580,328,228,24,336,232,104,14,14,206,106,100
"2021","Cornwall 010","E02003892",3044,871,486,385,2017,478,986,500,307,179,296,181,96,19,241,125,116,16,16,156,64,92
"2021","Cornwall 012","E02003893",2891,751,406,345,1990,446,1018,517,309,192,308,167,120,21,207,102,105,11,11,150,61,89
"2021","Cornwall 013","E02003894",3717,1167,583,584,2355,466,1146,540,411,195,438,242,174,22,292,171,121,13,13,195,72,123
"2021","Cornwall 016","E02003895",4117,1165,599,566,2762,448,1289,554,530,205,576,301,248,27,435,272,163,14,14,190,70,120
"2021","Cornwall 017","E02003896",2788,1072,496,576,1596,301,677,301,243,133,302,152,134,16,307,192,115,9,9,120,47,73
"2021","Cornwall 022","E02003897",2302,519,280,239,1710,391,902,395,349,158,238,124,98,16,172,111,61,7,7,73,26,47
"2021","Cornwall 023","E02003898",2971,804,478,326,2008,492,1095,513,399,183,259,159,88,12,153,77,76,9,9,159,56,103
"2021","Cornwall 025","E02003899",2388,769,450,319,1542,344,682,282,270,130,257,124,110,23,251,160,91,8,8,77,36,41
"2021","Cornwall 026","E02003900",3166,1005,530,475,2003,405,934,380,395,159,313,162,130,21,339,224,115,12,12,158,67,91
"2021","Cornwall 028","E02003901",3706,1080,628,452,2412,630,1137,558,363,216,372,194,143,35,261,156,105,12,12,214,60,154
"2021","Cornwall 029","E02003902",2414,868,409,459,1446,256,673,271,266,136,252,126,112,14,254,152,102,11,11,100,40,60
"2021","Cornwall 034","E02003903",2880,905,506,399,1872,448,913,446,303,164,266,146,99,21,238,142,96,7,7,103,36,67
"2021","Cornwall 037","E02003904",2442,864,508,356,1466,400,680,362,188,130,234,149,63,22,143,79,64,9,9,112,37,75
"2021","Cornwall 032","E02003905",2916,713,348,365,2031,325,1032,400,457,175,372,206,148,18,296,187,109,6,6,172,74,98
"2021","Cornwall 033","E02003906",2679,744,402,342,1723,317,822,321,365,136,331,193,116,22,243,139,104,10,10,212,78,134
"2021","Cornwall 040","E02003907",3683,1148,605,543,2333,428,1171,426,585,160,451,257,174,20,271,149,122,12,12,202,78,124
"2021","Cornwall 042","E02003908",3702,1189,628,561,2305,416,1076,378,517,181,403,194,180,29,396,243,153,14,14,208,71,137
"2021","Cornwall 043","E02003909",4571,1345,646,699,2948,483,1314,507,576,231,612,349,232,31,514,320,194,25,25,278,70,208
"2021","Cornwall 044","E02003910",3363,1372,653,719,1792,285,777,317,360,100,399,264,118,17,313,204,109,18,18,199,52,147
"2021","Cornwall 047","E02003911",3960,1045,604,441,2707,670,1356,533,585,238,390,229,140,21,283,166,117,8,8,208,67,141
"2021","Cornwall 048","E02003912",3669,1121,687,434,2371,570,1145,500,431,214,362,226,120,16,270,154,116,24,24,177,53,124
"2021","Cornwall 056","E02003913",2678,756,469,287,1789,535,869,390,334,145,217,138,64,15,159,92,67,9,9,133,56,77
"2021","Cornwall 060","E02003914",3480,1053,401,652,1962,270,802,303,343,156,498,310,177,11,367,242,125,25,25,465,60,405
"2021","Cornwall 062","E02003915",3422,1110,515,595,1762,248,680,264,252,164,402,219,150,33,391,229,162,41,41,550,56,494
"2021","Cornwall 063","E02003916",2896,1007,528,479,1346,328,589,248,221,120,269,205,53,11,137,79,58,23,23,543,38,505
"2021","Cornwall 064","E02003917",3572,982,544,438,2359,423,1147,398,526,223,456,239,191,26,318,187,131,15,15,231,66,165
"2021","Cornwall 045","E02003918",3182,908,496,412,2087,412,988,443,388,157,407,220,165,22,268,144,124,12,12,187,73,114
"2021","Cornwall 046","E02003919",3423,1280,550,730,1966,247,847,365,338,144,454,229,206,19,401,272,129,17,17,177,67,110
"2021","Cornwall 049","E02003920",3641,1185,516,669,2229,346,1011,393,470,148,551,276,246,29,308,191,117,13,13,227,77,150
"2021","Cornwall 050","E02003921",2757,806,429,377,1809,334,868,396,313,159,338,172,146,20,262,165,97,7,7,142,46,96
"2021","Cornwall 051","E02003922",3864,1121,455,666,2508,365,1175,496,504,175,564,268,267,29,384,245,139,20,20,235,82,153
"2021","Cornwall 052","E02003923",4093,1245,464,781,2592,305,1060,426,465,169,646,311,310,25,562,376,186,19,19,256,92,164
"2021","Cornwall 053","E02003924",3352,1185,651,534,1952,407,847,364,301,182,353,169,158,26,330,200,130,15,15,215,75,140
"2021","Cornwall 055","E02003925",3083,886,455,431,2002,356,876,369,341,166,380,171,179,30,376,247,129,14,14,195,89,106
"2021","Cornwall 059","E02003926",3411,766,407,359,2415,444,1290,575,492,223,414,244,141,29,253,138,115,14,14,230,105,125
"2021","Cornwall 066","E02003927",4110,1101,640,461,2758,708,1327,572,560,195,455,245,186,24,250,150,100,18,18,251,101,150
"2021","Cornwall 071","E02003928",5212,1555,769,786,3464,549,1779,640,855,284,579,298,257,24,534,350,184,23,23,193,87,106
"2021","Cornwall 072","E02003929",3123,932,564,368,2029,495,956,462,329,165,327,201,110,16,241,138,103,10,10,162,57,105
"2021","Cornwall 073","E02003930",3808,1048,626,422,2538,639,1196,557,425,214,375,199,154,22,314,161,153,14,14,222,103,119
"2021","Cornwall 001","E02003931",4849,1630,932,698,2992,715,1249,528,511,210,527,285,219,23,486,333,153,15,15,227,71,156
"2021","Cornwall 002","E02003932",3079,717,426,291,2176,503,1123,544,399,180,344,157,173,14,191,109,82,15,15,186,89,97
"2021","Cornwall 003","E02003933",3188,990,558,432,2009,461,957,516,281,160,360,193,145,22,221,118,103,10,10,189,68,121
"2021","Cornwall 004","E02003934",3038,782,425,357,2068,455,998,478,348,172,330,160,152,18,277,171,106,8,8,188,86,102
"2021","Cornwall 005","E02003935",4438,1434,604,830,2788,399,1286,510,569,207,632,311,281,40,445,305,140,26,26,216,87,129
"2021","Cornwall 006","E02003936",3582,912,542,370,2481,623,1287,637,408,242,347,199,124,24,216,112,104,8,8,189,70,119
"2021","Cornwall 007","E02003937",2359,761,431,330,1487,363,715,319,268,128,233,112,106,15,167,96,71,9,9,111,47,64
"2021","Cornwall 008","E02003938",2869,772,436,336,1903,386,895,377,361,157,350,165,166,19,257,178,79,15,15,194,66,128
"2021","Cornwall 009","E02003939",3153,1110,617,493,1920,443,862,311,376,175,320,184,126,10,284,167,117,11,11,123,44,79
"2021","Cornwall 011","E02003940",2750,692,397,295,1868,447,953,471,312,170,254,154,79,21,202,112,90,12,12,190,72,118
"2021","Cornwall 014","E02003941",3738,1094,488,606,2392,395,1090,419,512,159,535,281,231,23,353,222,131,19,19,252,83,169
"2021","Cornwall 015","E02003942",3498,1136,509,627,2143,283,872,362,356,154,511,248,229,34,449,311,138,28,28,219,98,121
"2021","Cornwall 054","E02003943",3239,1144,631,513,1937,401,808,373,263,172,334,192,118,24,390,210,180,4,4,158,52,106
"2021","Cornwall 057","E02003944",4516,1401,753,648,2874,539,1252,496,521,235,538,253,246,39,529,315,214,16,16,241,86,155
"2021","Cornwall 058","E02003945",2688,818,483,335,1733,448,832,417,255,160,234,127,90,17,207,114,93,12,12,137,57,80
"2021","Cornwall 061","E02003946",4067,1155,676,479,2683,545,1296,539,520,237,472,240,199,33,353,205,148,17,17,229,84,145
"2021","Cornwall 065","E02003947",2886,858,491,367,1868,423,896,425,304,167,293,155,116,22,244,148,96,12,12,160,64,96
"2021","Cornwall 067","E02003948",3909,1421,671,750,2310,441,915,391,331,193,425,179,222,24,512,296,216,17,17,178,61,117
"2021","Cornwall 068","E02003949",3612,1846,848,998,1609,255,537,249,189,99,366,218,132,16,435,267,168,16,16,157,41,116
"2021","Cornwall 069","E02003950",2521,893,502,391,1519,324,755,352,263,140,238,121,99,18,194,123,71,8,8,109,35,74
"2021","Cornwall 070","E02003951",2850,1071,608,463,1662,432,663,302,219,142,264,147,100,17,291,170,121,12,12,117,35,82
"2021","Cornwall 018","E02003952",4097,1123,498,625,2724,407,1256,465,608,183,608,303,272,33,430,270,160,23,23,250,85,165
"2021","Cornwall 019","E02003953",4471,1156,527,629,3039,502,1450,559,610,281,606,301,265,40,457,278,179,24,24,276,107,169
"2021","Cornwall 020","E02003954",3559,1358,500,858,1923,290,850,351,339,160,483,300,155,28,284,185,99,16,16,278,56,222
"2021","Cornwall 021","E02003955",4459,1472,638,834,2689,458,1217,467,518,232,548,301,210,37,434,271,163,32,32,298,97,201
"2021","Cornwall 024","E02003956",3246,894,384,510,2131,330,1034,431,403,200,434,206,200,28,313,198,115,20,20,221,92,129
"2021","Cornwall 027","E02003957",4726,1316,637,679,3130,559,1419,614,544,261,692,346,313,33,429,280,149,31,31,280,111,169
"2021","Cornwall 030","E02003958",3463,930,467,463,2372,379,1154,489,441,224,452,217,210,25,376,241,135,11,11,161,71,90
"2021","Cornwall 031","E02003959",2968,850,429,421,1946,325,859,344,355,160,376,171,187,18,376,244,132,10,10,172,59,113
"2021","Cornwall 035","E02003960",2599,795,502,293,1672,440,768,366,249,153,250,151,85,14,204,127,77,10,10,132,49,83
"2021","Cornwall 036","E02003961",4235,1158,664,494,2906,635,1400,578,559,263,466,241,188,37,391,244,147,14,14,171,63,108
"2021","Cornwall 038","E02003962",3129,949,400,549,1994,333,925,368,404,153,392,218,152,22,326,207,119,18,18,186,70,116
"2021","Cornwall 039","E02003963",4581,1666,811,855,2680,439,1089,443,443,203,550,287,228,35,579,365,214,23,23,235,83,152
"2021","Cornwall 041","E02003964",3673,1118,671,447,2370,683,1123,504,396,223,321,193,109,19,233,132,101,10,10,185,49,136
"2021","Isles of Scilly 001","E02006781",942,307,162,145,563,132,275,147,110,18,101,77,21,3,53,32,21,2,2,72,20,52
"2021","Wiltshire 012","E02006634",3626,940,506,434,2529,539,1427,557,634,236,299,173,93,33,246,128,118,18,18,157,55,102
"2021","Wiltshire 019","E02006635",3680,1311,712,599,2233,471,1078,411,466,201,331,191,126,14,341,213,128,12,12,136,43,93
"2021","Wiltshire 024","E02006636",3218,1012,536,476,2067,445,1072,455,424,193,295,180,98,17,240,129,111,15,15,139,52,87
"2021","Wiltshire 025","E02006637",4838,1441,647,794,3204,548,1467,565,662,240,671,360,276,35,500,316,184,18,18,193,76,117
"2021","Wiltshire 026","E02006638",3222,1324,687,637,1781,423,787,358,259,170,286,160,112,14,263,166,97,22,22,117,42,75
"2021","Wiltshire 028","E02006639",3504,902,494,408,2454,597,1259,569,433,257,326,208,104,14,261,147,114,11,11,148,47,101
"2021","Wiltshire 029","E02006640",3094,755,400,355,2214,467,1261,492,556,213,276,172,87,17,200,123,77,10,10,125,40,85
"2021","Wiltshire 034","E02006641",3449,913,438,475,2415,465,1251,543,503,205,346,201,131,14,342,217,125,11,11,121,47,74
"2021","Wiltshire 038","E02006642",2441,622,321,301,1730,340,989,453,378,158,227,140,66,21,169,86,83,5,5,89,40,49
"2021","Wiltshire 001","E02006644",2938,778,457,321,2026,431,1110,442,471,197,267,137,97,33,212,111,101,6,6,134,49,85
"2021","Wiltshire 002","E02006645",3353,973,479,494,2218,357,1172,410,572,190,366,195,154,17,310,200,110,13,13,162,46,116
"2021","Wiltshire 003","E02006646",3232,701,350,351,2392,368,1359,465,664,230,406,199,182,25,251,161,90,8,8,139,56,83
"2021","Wiltshire 004","E02006647",2470,477,273,204,1857,445,1055,421,434,200,231,141,75,15,121,71,50,5,5,136,46,90
"2021","Wiltshire 005","E02006648",2631,682,382,300,1839,365,1105,413,530,162,224,124,85,15,140,82,58,5,5,110,39,71
"2021","Wiltshire 006","E02006649",3346,1037,469,568,2177,342,1085,394,479,212,381,207,145,29,357,211,146,12,12,132,61,71
"2021","Wiltshire 007","E02006650",4988,1215,579,636,3565,685,2050,781,949,320,470,277,168,25,341,212,129,19,19,208,88,120
"2021","Wiltshire 008","E02006651",2951,663,402,261,2146,418,1249,517,531,201,285,162,103,20,188,96,92,6,6,142,74,68
"2021","Wiltshire 009","E02006652",3937,978,386,592,2785,370,1509,502,716,291,506,280,195,31,382,240,142,18,18,174,84,90
"2021","Wiltshire 010","E02006653",4116,1047,480,567,2896,429,1532,524,701,307,507,271,200,36,403,244,159,25,25,173,61,112
"2021","Wiltshire 011","E02006654",4587,1806,755,1051,2567,415,1182,451,515,216,493,311,160,22,451,287,164,26,26,214,62,152
"2021","Wiltshire 013","E02006655",3352,717,389,328,2497,451,1397,613,555,229,434,274,134,26,209,114,95,6,6,138,52,86
"2021","Wiltshire 014","E02006656",2895,804,274,530,1986,211,1173,453,498,222,349,205,123,21,244,138,106,9,9,105,42,63
"2021","Wiltshire 015","E02006657",4509,1246,508,738,3057,366,1548,562,727,259,633,346,254,33,490,335,155,20,20,206,84,122
"2021","Wiltshire 016","E02006658",3634,1103,517,586,2430,442,1213,560,463,190,453,263,166,24,315,198,117,7,7,101,33,68
"2021","Wiltshire 017","E02006659",3384,817,412,405,2441,390,1359,449,727,183,399,223,159,17,285,171,114,8,8,126,51,75
"2021","Wiltshire 018","E02006660",5856,1740,890,850,3893,746,1943,692,946,305,594,335,226,33,583,371,212,27,27,223,80,143
"2021","Wiltshire 045","E02006661",3134,534,213,321,2458,191,1763,540,1074,149,315,189,115,11,180,111,69,9,9,142,81,61
"2021","Wiltshire 046","E02006662",2875,651,317,334,2083,303,1216,377,627,212,286,153,112,21,263,146,117,15,15,141,61,80
"2021","Wiltshire 048","E02006663",5339,1443,661,782,3590,430,1909,697,918,294,676,367,272,37,557,350,207,18,18,306,126,180
"2021","Wiltshire 049","E02006664",2708,631,387,244,1952,424,1115,466,449,200,239,139,84,16,169,91,78,5,5,125,40,85
"2021","Wiltshire 050","E02006665",3075,929,562,367,2029,567,933,453,312,168,319,184,110,25,206,112,94,4,4,117,39,78
"2021","Wiltshire 051","E02006666",2843,808,386,422,1910,272,1013,313,534,166,312,154,137,21,304,189,115,9,9,125,51,74
"2021","Wiltshire 052","E02006667",2996,701,272,429,2083,177,905,296,451,158,478,213,234,31,503,348,155,20,20,212,87,125
"2021","Wiltshire 053","E02006668",2551,742,427,315,1674,346,913,356,389,168,189,98,72,19,220,102,118,6,6,135,46,89
"2021","Wiltshire 054","E02006669",4749,1452,816,636,3105,688,1585,675,638,272,475,285,159,31,336,181,155,21,21,192,55,137
"2021","Wiltshire 055","E02006670",3263,1257,485,772,1783,247,842,336,387,119,422,281,120,21,245,145,100,27,27,223,53,170
"2021","Wiltshire 056","E02006671",2960,1195,529,666,1561,256,689,290,298,101,352,247,94,11,243,145,98,21,21,204,48,156
"2021","Wiltshire 057","E02006672",3799,951,417,534,2641,455,1376,423,751,202,428,219,195,14,372,260,112,10,10,207,71,136
"2021","Wiltshire 058","E02006673",2514,1052,597,455,1322,350,564,245,236,83,225,141,72,12,170,83,87,13,13,140,37,103
"2021","Wiltshire 059","E02006674",2554,802,412,390,1599,238,853,289,445,119,230,122,94,14,267,169,98,11,11,153,48,105
"2021","Wiltshire 060","E02006675",3360,757,450,307,2436,563,1381,546,577,258,304,200,86,18,180,97,83,8,8,167,64,103
"2021","Wiltshire 061","E02006676",2792,841,498,343,1847,451,958,450,330,178,243,143,87,13,188,112,76,7,7,104,28,76
"2021","Wiltshire 062","E02006677",3350,836,511,325,2367,573,1259,482,549,228,295,165,106,24,237,126,111,3,3,147,62,85
"2021","Wiltshire 020","E02006678",3317,908,429,479,2251,386,1031,374,449,208,430,209,188,33,388,261,127,16,16,158,69,89
"2021","Wiltshire 021","E02006679",5012,1120,576,544,3667,669,1939,702,892,345,613,322,251,40,431,273,158,15,15,225,91,134
"2021","Wiltshire 022","E02006680",3472,1255,647,608,2078,398,967,353,393,221,377,198,157,22,316,177,139,20,20,139,42,97
"2021","Wiltshire 023","E02006681",2584,725,466,259,1766,454,958,347,441,170,199,118,67,14,145,90,55,10,10,93,30,63
"2021","Wiltshire 027","E02006682",4771,1617,929,688,3006,688,1481,536,709,236,435,248,161,26,390,223,167,12,12,148,45,103
"2021","Wiltshire 030","E02006683",3312,828,365,463,2322,352,1276,482,582,212,376,193,152,31,309,201,108,9,9,162,60,102
"2021","Wiltshire 031","E02006684",3217,1241,426,815,1757,249,738,274,330,134,430,255,164,11,310,202,108,30,30,219,69,150
"2021","Wiltshire 032","E02006685",4239,1177,516,661,2857,446,1452,475,789,188,507,249,236,22,434,302,132,18,18,205,75,130
"2021","Wiltshire 033","E02006686",2188,553,292,261,1500,247,746,253,316,177,235,100,111,24,260,136,124,12,12,135,55,80
"2021","Wiltshire 035","E02006687",3456,978,361,617,2274,283,1088,402,499,187,490,259,202,29,403,265,138,10,10,204,79,125
"2021","Wiltshire 036","E02006688",2490,767,336,431,1586,236,724,296,294,134,326,201,100,25,280,148,132,20,20,137,43,94
"2021","Wiltshire 037","E02006689",2918,682,388,294,2088,483,1048,420,454,174,317,162,139,16,232,142,90,8,8,148,70,78
"2021","Wiltshire 039","E02006690",3065,840,474,366,2081,483,1053,458,403,192,345,198,132,15,191,105,86,9,9,144,50,94
"2021","Wiltshire 042","E02006692",2287,644,379,265,1542,277,811,292,395,124,232,115,105,12,211,126,85,11,11,101,50,51
"2021","Wiltshire 043","E02006693",2804,775,404,371,1888,306,928,356,385,187,354,175,152,27,291,146,145,9,9,141,48,93
"2021","Wiltshire 044","E02006694",2945,1142,581,561,1683,374,752,343,275,134,301,173,119,9,239,117,122,17,17,120,41,79
"2021","Wiltshire 047","E02006695",2812,752,446,306,1928,502,991,437,376,178,249,145,88,16,174,89,85,12,12,132,38,94
"2021","Wiltshire 063","E02007023",3112,726,313,413,2251,291,1093,390,509,194,489,225,232,32,369,232,137,9,9,135,53,82
"2021","Wiltshire 064","E02007024",3128,1085,430,655,1884,266,880,351,376,153,425,257,150,18,307,210,97,6,6,159,60,99
"2021","Wiltshire 065","E02007025",3142,735,275,460,2221,215,1258,405,717,136,375,199,159,17,358,267,91,15,15,186,78,108
"2021","Wiltshire 066","E02007026",2689,432,85,347,2085,47,1475,387,999,89,277,132,135,10,272,213,59,14,14,172,89,83
"2021","Bournemouth, Christchurch and Poole 003","E02003172",2757,805,461,344,1763,282,793,309,318,166,327,158,147,22,348,181,167,13,13,189,85,104
"2021","Bournemouth, Christchurch and Poole 005","E02003173",3070,926,543,383,1959,399,820,335,322,163,372,210,134,28,349,193,156,19,19,185,64,121
"2021","Bournemouth, Christchurch and Poole 006","E02003174",3609,1033,605,428,2342,446,1225,463,556,206,354,199,131,24,300,178,122,17,17,234,76,158
"2021","Bournemouth, Christchurch and Poole 007","E02003175",3833,1025,518,507,2590,296,1349,402,756,191,466,241,203,22,459,290,169,20,20,218,91,127
"2021","Bournemouth, Christchurch and Poole 010","E02003176",3047,929,398,531,1867,185,766,247,372,147,359,140,186,33,538,329,209,19,19,251,99,152
"2021","Bournemouth, Christchurch and Poole 009","E02003177",3287,740,371,369,2301,299,1334,400,724,210,356,179,147,30,297,195,102,15,15,246,84,162
"2021","Bournemouth, Christchurch and Poole 011","E02003178",3546,998,513,485,2155,282,1055,355,515,185,366,202,150,14,431,269,162,21,21,393,135,258
"2021","Bournemouth, Christchurch and Poole 012","E02003179",2766,910,482,428,1676,265,789,240,402,147,259,109,125,25,345,179,166,18,18,180,78,102
"2021","Bournemouth, Christchurch and Poole 015","E02003180",3823,989,320,669,1988,169,885,277,470,138,429,239,168,22,463,323,140,42,42,846,106,740
"2021","Bournemouth, Christchurch and Poole 017","E02003181",3438,838,376,462,2146,292,1177,349,656,172,360,203,133,24,297,192,105,20,20,454,119,335
"2021","Bournemouth, Christchurch and Poole 020","E02003182",2637,636,342,294,1817,309,1030,308,550,172,254,146,93,15,205,120,85,19,19,184,66,118
"2021","Bournemouth, Christchurch and Poole 028","E02003183",2866,755,311,444,1669,337,843,278,414,151,283,194,76,13,188,109,79,18,18,442,66,376
"2021","Bournemouth, Christchurch and Poole 027","E02003184",3245,983,264,719,1718,113,773,243,439,91,462,298,149,15,329,217,112,41,41,544,93,451
"2021","Bournemouth, Christchurch and Poole 026","E02003185",3096,788,378,410,2084,259,1092,322,595,175,378,204,151,23,343,197,146,12,12,224,79,145
"2021","Bournemouth, Christchurch and Poole 025","E02003186",3842,1101,268,833,2199,127,964,302,503,159,507,284,193,30,546,374,172,55,55,542,135,407
"2021","Bournemouth, Christchurch and Poole 035","E02003187",4138,1381,485,896,2317,255,1028,359,534,135,513,300,198,15,494,341,153,27,27,440,97,343
"2021","Bournemouth, Christchurch and Poole 038","E02003188",5758,2727,887,1840,2401,230,892,455,376,61,872,726,133,13,306,183,123,101,101,630,97,533
"2021","Bournemouth, Christchurch and Poole 036","E02003189",4076,1681,752,929,2118,357,971,362,453,156,427,301,108,18,342,204,138,21,21,277,57,220
"2021","Bournemouth, Christchurch and Poole 037","E02003190",5524,2777,570,2207,2361,114,864,387,399,78,753,550,192,11,559,402,157,71,71,386,86,300
"2021","Bournemouth, Christchurch and Poole 039","E02003191",3945,1340,830,510,2421,641,1126,442,494,190,365,243,113,9,277,149,128,12,12,184,51,133
"2021","Bournemouth, Christchurch and Poole 041","E02003192",5265,2320,660,1660,2386,334,885,406,409,70,686,534,142,10,386,258,128,95,95,559,84,475
"2021","Bournemouth, Christchurch and Poole 001","E02003194",2480,588,437,151,1788,543,924,322,406,196,178,99,69,10,141,70,71,2,2,104,34,70
"2021","Bournemouth, Christchurch and Poole 008","E02003195",2334,506,231,275,1671,246,852,300,385,167,332,182,133,17,231,129,102,10,10,157,75,82
"2021","Bournemouth, Christchurch and Poole 004","E02003196",4273,1028,754,274,3031,845,1708,594,743,371,261,138,92,31,206,94,112,11,11,214,82,132
"2021","Bournemouth, Christchurch and Poole 013","E02003197",2888,789,379,410,1944,311,1011,374,455,182,300,161,122,17,308,209,99,14,14,155,56,99
"2021","Bournemouth, Christchurch and Poole 016","E02003198",3056,754,342,412,2124,255,1065,367,500,198,434,212,195,27,355,211,144,15,15,178,76,102
"2021","Bournemouth, Christchurch and Poole 021","E02003199",4096,1140,627,513,2763,466,1315,517,552,246,560,294,228,38,398,224,174,24,24,193,72,121
"2021","Bournemouth, Christchurch and Poole 022","E02003200",4169,1061,579,482,2692,412,1154,422,508,224,534,253,246,35,558,340,218,34,34,416,140,276
"2021","Bournemouth, Christchurch and Poole 023","E02003201",4700,1396,634,762,2904,346,1366,495,610,261,601,341,227,33,553,348,205,38,38,400,152,248
"2021","Bournemouth, Christchurch and Poole 029","E02003202",2662,857,388,469,1594,259,771,307,338,126,308,181,114,13,237,138,99,19,19,211,68,143
"2021","Bournemouth, Christchurch and Poole 032","E02003203",3260,918,412,506,2104,239,1032,360,486,186,490,307,162,21,314,189,125,29,29,238,76,162
"2021","Bournemouth, Christchurch and Poole 030","E02003204",4043,1244,622,622,2515,395,1175,433,540,202,486,286,175,25,427,248,179,32,32,284,91,193
"2021","Bournemouth, Christchurch and Poole 034","E02003205",3414,841,516,325,2300,423,1266,416,582,268,330,182,126,22,262,140,122,19,19,273,108,165
"2021","Bournemouth, Christchurch and Poole 043","E02003206",4340,1265,501,764,2825,440,1466,496,791,179,516,334,166,16,375,238,137,28,28,250,72,178
"2021","Bournemouth, Christchurch and Poole 042","E02003207",2973,795,331,464,1973,272,921,330,437,154,395,193,169,33,369,231,138,16,16,205,94,111
"2021","Bournemouth, Christchurch and Poole 044","E02003208",5567,2350,1036,1314,2843,479,1099,460,479,160,590,374,201,15,633,421,212,42,42,374,100,274
"2021","Bournemouth, Christchurch and Poole 046","E02003209",2999,940,416,524,1869,327,837,328,332,177,381,202,148,31,307,198,109,17,17,190,68,122
"2021","Bournemouth, Christchurch and Poole 047","E02003210",4636,1711,901,810,2720,567,1356,516,656,184,454,306,136,12,326,219,107,17,17,205,55,150
"2021","Bournemouth, Christchurch and Poole 048","E02003211",4321,1691,1051,640,2452,954,1003,498,355,150,281,193,83,5,189,85,104,25,25,178,49,129
"2021","Bournemouth, Christchurch and Poole 002","E02004236",2689,721,448,273,1828,481,912,351,365,196,230,119,93,18,196,109,87,9,9,140,44,96
"2021","Bournemouth, Christchurch and Poole 014","E02004237",3290,882,584,298,2241,445,1198,366,594,238,273,111,140,22,315,178,137,10,10,167,77,90
"2021","Bournemouth, Christchurch and Poole 019","E02004238",3723,1381,1032,349,2193,873,909,395,341,173,228,130,79,19,173,91,82,10,10,149,51,98
"2021","Bournemouth, Christchurch and Poole 018","E02004239",2847,858,584,274,1888,584,876,337,380,159,246,141,81,24,179,98,81,3,3,101,40,61
"2021","Bournemouth, Christchurch and Poole 024","E02004240",2654,874,405,469,1637,169,720,239,326,155,311,135,140,36,417,262,155,20,20,143,57,86
"2021","Bournemouth, Christchurch and Poole 031","E02004241",4514,1761,1008,753,2565,505,1124,381,569,174,458,269,168,21,460,298,162,18,18,188,60,128
"2021","Bournemouth, Christchurch and Poole 033","E02004242",3113,1003,705,298,1988,705,886,406,310,170,213,126,72,15,174,94,80,10,10,122,39,83
"2021","Bournemouth, Christchurch and Poole 040","E02006883",3248,1639,648,991,1377,212,497,271,184,42,432,329,98,5,198,111,87,38,38,232,34,198
"2021","Bournemouth, Christchurch and Poole 045","E02006885",3971,1849,670,1179,1847,371,686,372,245,69,533,431,94,8,202,106,96,55,55,275,36,239
"2021","Dorset 007","E02004243",2694,615,356,259,1941,408,1064,455,422,187,253,144,92,17,211,126,85,5,5,138,61,77
"2021","Dorset 010","E02004244",3290,813,495,318,2341,565,1179,433,531,215,349,204,126,19,242,143,99,6,6,136,43,93
"2021","Dorset 012","E02004245",3097,704,444,260,2261,554,1070,394,479,197,368,212,126,30,262,160,102,7,7,132,54,78
"2021","Dorset 015","E02004246",3475,843,567,276,2426,871,1161,562,385,214,244,148,81,15,144,80,64,6,6,206,80,126
"2021","Dorset 013","E02004247",2477,496,293,203,1827,403,1028,438,375,215,219,127,73,19,169,87,82,8,8,154,60,94
"2021","Dorset 016","E02004248",3535,1095,807,288,2275,877,925,427,306,192,251,152,83,16,209,107,102,13,13,165,55,110
"2021","Dorset 017","E02004249",2512,562,352,210,1848,443,989,337,467,185,221,111,93,17,188,119,69,7,7,102,35,67
"2021","Dorset 018","E02004250",3673,1272,855,417,2221,724,920,387,333,200,255,157,91,7,308,165,143,14,14,180,68,112
"2021","Dorset 020","E02004251",2768,723,491,232,1921,493,932,366,382,184,280,162,100,18,208,104,104,8,8,124,46,78
"2021","Dorset 021","E02004252",3880,1559,851,708,2187,475,908,323,445,140,363,225,123,15,428,296,132,13,13,134,35,99
"2021","Dorset 024","E02004253",4289,1135,805,330,2939,975,1412,570,528,314,319,185,117,17,225,103,122,8,8,215,71,144
"2021","Dorset 025","E02004254",4296,1034,596,438,3045,633,1620,539,762,319,401,195,174,32,385,184,201,6,6,217,86,131
"2021","Dorset 001","E02004255",3456,1225,699,526,2111,508,954,407,369,178,330,173,141,16,301,190,111,18,18,120,42,78
"2021","Dorset 002","E02004256",3934,999,558,441,2748,632,1438,637,562,239,408,234,152,22,257,159,98,13,13,187,84,103
"2021","Dorset 003","E02004257",4133,1396,704,692,2598,471,1103,416,505,182,559,303,233,23,421,306,115,44,44,139,46,93
"2021","Dorset 005","E02004258",4741,1462,914,548,3053,845,1439,663,514,262,425,213,187,25,315,181,134,29,29,226,82,144
"2021","Dorset 006","E02004259",2865,712,451,261,2018,590,999,486,356,157,224,134,74,16,199,106,93,6,6,135,61,74
"2021","Dorset 009","E02004260",3265,749,404,345,2365,518,1257,517,557,183,358,210,127,21,222,128,94,10,10,151,71,80
"2021","Dorset 011","E02004261",4764,1698,841,857,2883,516,1377,583,574,220,550,295,232,23,424,280,144,16,16,183,68,115
"2021","Dorset 014","E02004262",3399,790,446,344,2447,586,1272,646,397,229,368,216,119,33,210,111,99,11,11,162,50,112
"2021","Dorset 027","E02004263",2504,673,412,261,1726,387,912,353,405,154,232,123,91,18,188,101,87,7,7,105,37,68
"2021","Dorset 028","E02004264",3697,975,545,430,2532,515,1216,475,503,238,443,229,188,26,347,216,131,11,11,190,71,119
"2021","Dorset 033","E02004265",3851,1220,737,483,2431,634,1100,434,429,237,351,164,158,29,339,190,149,7,7,200,56,144
"2021","Dorset 035","E02004266",3336,845,457,388,2325,482,1198,478,537,183,360,192,147,21,267,159,108,18,18,166,66,100
"2021","Dorset 039","E02004267",2242,612,401,211,1496,456,739,378,231,130,172,94,68,10,119,64,55,10,10,134,43,91
"2021","Dorset 042","E02004268",4511,1584,950,634,2733,783,1194,559,400,235,368,209,139,20,374,219,155,14,14,194,57,137
"2021","Dorset 004","E02004269",4694,1919,1190,729,2629,735,1023,432,415,176,406,234,160,12,452,302,150,13,13,146,50,96
"2021","Dorset 008","E02004270",3434,864,534,330,2446,690,1245,567,449,229,298,201,85,12,205,113,92,8,8,124,48,76
"2021","Dorset 019","E02004271",4585,1324,803,521,3059,851,1457,723,497,237,436,253,155,28,300,157,143,15,15,202,66,136
"2021","Dorset 022","E02004272",5340,1461,890,571,3629,834,1877,835,743,299,540,322,190,28,365,220,145,13,13,250,87,163
"2021","Dorset 023","E02004273",3428,1153,701,452,2138,730,920,468,278,174,250,139,97,14,235,139,96,3,3,137,49,88
"2021","Dorset 026","E02004274",3112,1153,686,467,1854,464,794,378,275,141,314,168,127,19,278,159,119,4,4,105,19,86
"2021","Dorset 029","E02004275",3497,983,619,364,2375,659,1141,584,350,207,318,170,133,15,244,115,129,13,13,139,48,91
"2021","Dorset 030","E02004276",2859,1158,666,492,1616,479,661,344,206,111,232,128,90,14,239,157,82,5,5,85,22,63
"2021","Dorset 034","E02004278",3966,1299,752,547,2533,512,1295,467,602,226,375,194,154,27,334,201,133,17,17,134,52,82
"2021","Dorset 036","E02004279",3516,913,579,334,2453,596,1264,558,473,233,354,210,125,19,234,130,104,5,5,150,55,95
"2021","Dorset 037","E02004280",3732,1084,625,459,2471,579,1180,536,434,210,407,213,163,31,297,158,139,8,8,177,66,111
"2021","Dorset 038","E02004281",3481,1149,484,665,2162,299,923,398,363,162,487,252,205,30,440,277,163,13,13,170,72,98
"2021","Dorset 040","E02004282",4109,1214,769,445,2720,936,1229,605,390,234,305,175,114,16,237,122,115,13,13,175,53,122
"2021","Dorset 041","E02004283",3843,1075,648,427,2562,544,1210,454,489,267,412,199,190,23,385,234,151,11,11,206,80,126
"2021","Dorset 044","E02004284",5063,2458,983,1475,2302,463,801,414,272,115,551,381,142,28,456,307,149,31,31,303,77,226
"2021","Dorset 043","E02004285",3530,1268,635,633,2034,314,912,366,356,190,445,253,173,19,348,181,167,15,15,228,88,140
"2021","Dorset 045","E02004286",2178,626,309,317,1439,296,676,297,247,132,244,117,95,32,218,140,78,5,5,113,37,76
"2021","Dorset 046","E02004287",2433,690,390,300,1622,332,709,287,264,158,333,153,157,23,236,145,91,12,12,121,55,66
"2021","Dorset 047","E02004288",2430,872,316,556,1435,206,616,307,206,103,279,152,111,16,316,224,92,18,18,123,37,86
"2021","Dorset 048","E02004289",3298,950,510,440,2194,448,989,467,337,185,402,198,178,26,338,207,131,17,17,154,57,97
"2021","Dorset 031","E02007006",3035,1428,773,655,1497,339,599,298,223,78,316,190,117,9,228,152,76,15,15,110,17,93
"2021","Dorset 032","E02007007",2994,912,422,490,1943,428,860,307,397,156,262,124,115,23,379,250,129,14,14,139,53,86
"2021","East Devon 001","E02004129",2513,612,339,273,1727,471,855,380,323,152,264,165,89,10,129,73,56,8,8,174,64,110
"2021","East Devon 002","E02004130",3027,1207,656,551,1685,424,642,283,259,100,343,198,130,15,265,147,118,11,11,135,38,97
"2021","East Devon 003","E02004131",2472,708,399,309,1677,380,783,338,308,137,299,172,113,14,207,123,84,8,8,87,31,56
"2021","East Devon 004","E02004132",3722,880,520,360,2671,577,1452,588,627,237,411,237,154,20,220,121,99,11,11,171,63,108
"2021","East Devon 005","E02004133",4406,1385,787,598,2820,650,1268,551,501,216,497,256,205,36,394,222,172,11,11,201,73,128
"2021","East Devon 007","E02004135",3742,1034,702,332,2564,779,1233,568,428,237,305,154,116,35,233,111,122,14,14,144,53,91
"2021","East Devon 008","E02004136",4011,1072,647,425,2759,680,1361,494,644,223,380,186,171,23,335,197,138,3,3,180,74,106
"2021","East Devon 009","E02004137",2417,679,441,238,1610,521,745,365,243,137,199,109,75,15,139,62,77,6,6,128,35,93
"2021","East Devon 010","E02004138",3873,1478,954,524,2278,836,864,444,271,149,309,191,103,15,262,143,119,7,7,117,32,85
"2021","East Devon 011","E02004139",3267,1065,688,377,2082,629,879,374,339,166,262,132,110,20,297,178,119,15,15,120,48,72
"2021","East Devon 012","E02004140",2705,1102,820,282,1495,652,572,296,184,92,156,103,43,10,111,53,58,4,4,108,24,84
"2021","East Devon 013","E02004141",2675,709,423,286,1851,458,902,377,358,167,296,166,112,18,190,106,84,5,5,115,41,74
"2021","East Devon 014","E02004142",2386,554,327,227,1693,456,870,343,397,130,224,136,78,10,137,78,59,6,6,139,54,85
"2021","East Devon 015","E02004143",2765,739,481,258,1915,470,1007,433,394,180,235,106,113,16,195,99,96,8,8,111,41,70
"2021","East Devon 016","E02004144",3033,855,575,280,2043,536,957,397,380,180,303,150,129,24,240,147,93,7,7,135,37,98
"2021","East Devon 017","E02004145",2958,1018,733,285,1850,722,751,344,258,149,206,113,81,12,171,97,74,0,0,90,33,57
"2021","East Devon 018","E02004146",3148,844,452,392,2122,346,1050,405,436,209,370,184,168,18,345,201,144,11,11,182,65,117
"2021","East Devon 019","E02004147",3370,1321,507,814,1819,270,711,301,301,109,454,295,132,27,353,212,141,31,31,230,59,171
"2021","East Devon 020","E02004148",3681,1393,899,494,2131,701,876,412,316,148,311,165,125,21,228,131,97,15,15,157,52,105
"2021","East Devon 021","E02007027",4336,988,461,527,3069,410,1612,561,804,247,638,386,233,19,389,284,105,20,20,279,104,175
"2021","East Devon 022","E02007028",2277,412,29,383,1755,42,822,215,561,46,583,340,231,12,292,231,61,16,16,110,49,61
"2021","Exeter 001","E02004149",2689,725,363,362,1695,417,841,340,375,126,244,166,71,7,167,82,85,26,26,269,44,225
"2021","Exeter 002","E02004150",2829,824,318,506,1598,161,726,258,342,126,341,165,156,20,344,220,124,26,26,407,57,350
"2021","Exeter 003","E02004151",4098,1022,516,506,2827,448,1405,464,697,244,530,292,208,30,434,270,164,10,10,249,76,173
"2021","Exeter 004","E02004152",3070,1022,273,749,999,104,421,170,207,44,311,248,56,7,117,76,41,46,46,1049,35,1014
"2021","Exeter 005","E02004153",3243,941,348,593,2089,241,899,357,376,166,497,263,209,25,434,294,140,18,18,213,71,142
"2021","Exeter 006","E02004154",3256,985,394,591,1690,172,822,249,457,116,403,276,112,15,263,155,108,30,30,581,50,531
"2021","Exeter 007","E02004155",3266,1045,524,521,2044,296,993,337,467,189,367,177,166,24,374,238,136,14,14,177,56,121
"2021","Exeter 008","E02004156",4861,2517,714,1803,1659,148,566,284,227,55,615,490,116,9,271,173,98,59,59,685,45,640
"2021","Exeter 009","E02004157",2930,1126,425,701,1579,202,801,278,446,77,361,273,77,11,205,113,92,10,10,225,25,200
"2021","Exeter 010","E02004158",3500,1131,464,667,2014,191,930,333,444,153,529,338,166,25,339,209,130,25,25,355,72,283
"2021","Exeter 011","E02004159",5231,1256,505,751,3629,534,1890,597,997,296,730,432,258,40,444,276,168,31,31,346,94,252
"2021","Exeter 012","E02004160",3084,875,496,379,2020,403,989,376,440,173,335,175,132,28,282,158,124,11,11,189,60,129
"2021","Exeter 013","E02004161",3529,1135,527,608,2129,274,982,337,452,193,432,210,175,47,410,248,162,31,31,265,74,191
"2021","Exeter 014","E02004162",3204,1128,480,648,1858,284,820,333,342,145,465,321,126,18,270,156,114,19,19,218,42,176
"2021","Exeter 015","E02004163",3775,1291,767,524,2302,498,1079,418,518,143,405,247,137,21,305,184,121,15,15,182,55,127
"2021","Mid Devon 001","E02004164",2902,729,419,310,2006,483,1074,505,397,172,270,144,110,16,169,92,77,10,10,167,60,107
"2021","Mid Devon 002","E02004165",3821,946,546,400,2685,619,1293,534,531,228,486,305,163,18,275,159,116,12,12,190,73,117
"2021","Mid Devon 003","E02004166",2850,769,431,338,1942,393,1017,390,449,178,308,154,130,24,221,137,84,3,3,139,61,78
"2021","Mid Devon 004","E02004167",3067,1034,469,565,1898,279,786,297,359,130,429,208,198,23,387,245,142,17,17,135,53,82
"2021","Mid Devon 005","E02004168",2946,1122,491,631,1689,262,719,305,313,101,329,170,140,19,364,235,129,15,15,135,48,87
"2021","Mid Devon 006","E02004169",3088,761,424,337,2160,393,1178,440,509,229,335,168,142,25,243,142,101,11,11,167,71,96
"2021","Mid Devon 007","E02004170",3800,1165,507,658,2447,361,1205,464,542,199,493,277,194,22,370,239,131,18,18,188,78,110
"2021","Mid Devon 008","E02004171",3610,953,491,462,2488,481,1289,506,580,203,423,230,172,21,290,182,108,5,5,169,67,102
"2021","Mid Devon 009","E02004172",2714,674,380,294,1884,404,1015,445,391,179,274,162,96,16,180,96,84,11,11,156,60,96
"2021","Mid Devon 010","E02004173",3124,804,434,370,2143,461,1138,467,488,183,326,170,139,17,210,110,100,8,8,177,84,93
"2021","Mid Devon 011","E02004174",3706,1282,626,656,2276,419,969,362,454,153,466,260,177,29,410,281,129,12,12,148,49,99
"2021","North Devon 001","E02004175",2448,1019,428,591,1304,209,535,240,209,86,295,154,122,19,242,154,88,23,23,125,48,77
"2021","North Devon 002","E02004176",2489,766,424,342,1576,416,764,406,235,123,228,131,82,15,162,94,68,6,6,147,64,83
"2021","North Devon 003","E02004177",2595,864,419,445,1594,296,685,285,266,134,297,148,124,25,306,187,119,10,10,137,56,81
"2021","North Devon 004","E02004178",2190,575,305,270,1489,383,792,287,365,140,189,102,73,14,119,60,59,6,6,126,37,89
"2021","North Devon 005","E02004179",3866,1150,648,502,2570,552,1266,451,633,182,405,206,184,15,334,203,131,13,13,146,56,90
"2021","North Devon 006","E02004180",2614,577,323,254,1881,411,994,403,416,175,286,163,105,18,184,104,80,6,6,156,78,78
"2021","North Devon 007","E02004181",2578,871,463,408,1595,283,721,268,326,127,304,172,111,21,269,159,110,18,18,112,38,74
"2021","North Devon 008","E02004182",3036,1313,537,776,1557,220,614,236,254,124,353,203,128,22,352,220,132,18,18,166,52,114
"2021","North Devon 009","E02004183",2699,900,479,421,1655,428,722,330,246,146,256,131,114,11,235,121,114,14,14,144,48,96
"2021","North Devon 010","E02004184",3650,1126,451,675,2360,303,1082,395,497,190,516,242,244,30,434,296,138,25,25,164,70,94
"2021","North Devon 011","E02004185",2956,768,504,264,2049,576,965,465,324,176,277,157,111,9,225,130,95,6,6,139,49,90
"2021","North Devon 012","E02004186",4360,1132,601,531,3026,543,1442,584,615,243,603,306,265,32,423,274,149,15,15,202,77,125
"2021","North Devon 013","E02004187",4617,1317,697,620,3055,646,1456,647,563,246,527,267,232,28,408,256,152,18,18,245,91,154
"2021","North Devon 014","E02004188",3102,881,547,334,2042,506,1022,482,344,196,340,203,117,20,168,98,70,6,6,179,73,106
"2021","South Hams 001","E02004189",2607,689,271,418,1795,288,964,416,381,167,323,201,110,12,216,135,81,4,4,123,48,75
"2021","South Hams 002","E02004190",3684,944,535,409,2522,513,1321,587,505,229,390,228,138,24,283,169,114,15,15,218,83,135
"2021","South Hams 003","E02004191",4339,1671,901,770,2419,430,1050,427,439,184,437,236,174,27,476,317,159,26,26,249,63,186
"2021","South Hams 004","E02004192",3406,885,559,326,2340,617,1208,564,438,206,308,189,96,23,196,105,91,11,11,181,64,117
"2021","South Hams 005","E02004193",4980,1272,680,592,3516,614,1839,648,855,336,579,301,246,32,468,284,184,16,16,192,78,114
"2021","South Hams 006","E02004194",3108,859,455,404,2058,383,1076,440,456,180,327,160,154,13,264,151,113,8,8,191,64,127
"2021","South Hams 007","E02004195",2515,940,514,426,1480,366,648,344,189,115,250,140,94,16,207,117,90,9,9,95,29,66
"2021","South Hams 008","E02004196",3482,935,557,378,2379,586,1224,521,520,183,324,178,129,17,238,145,93,7,7,168,71,97
"2021","South Hams 009","E02004197",3209,848,517,331,2218,628,1076,474,423,179,297,160,117,20,207,123,84,10,10,143,55,88
"2021","South Hams 010","E02004198",2929,1046,607,439,1760,378,799,339,334,126,312,172,126,14,263,150,113,8,8,123,35,88
"2021","South Hams 011","E02004199",2657,764,519,245,1770,576,818,415,279,124,229,129,85,15,144,73,71,3,3,123,42,81
"2021","South Hams 012","E02004200",2417,769,451,318,1540,470,693,333,234,126,216,124,81,11,154,73,81,7,7,108,35,73
"2021","Teignbridge 001","E02004201",2387,659,408,251,1586,427,818,367,311,140,233,144,74,15,107,49,58,1,1,142,49,93
"2021","Teignbridge 002","E02004202",3809,1123,572,551,2524,478,1260,493,595,172,481,284,177,20,294,172,122,11,11,162,59,103
"2021","Teignbridge 003","E02004203",2572,726,433,293,1717,434,868,443,294,131,250,149,85,16,156,74,82,9,9,129,52,77
"2021","Teignbridge 004","E02004204",4412,1350,776,574,2889,625,1423,583,619,221,468,268,177,23,358,213,145,15,15,173,66,107
"2021","Teignbridge 005","E02004205",3762,1079,573,506,2473,562,1158,527,412,219,384,192,164,28,358,241,117,11,11,210,82,128
"2021","Teignbridge 006","E02004206",3331,1326,756,570,1860,539,763,409,202,152,291,166,105,20,259,138,121,8,8,145,57,88
"2021","Teignbridge 007","E02004207",2963,824,479,345,2022,453,935,408,378,149,374,206,149,19,252,161,91,8,8,117,43,74
"2021","Teignbridge 008","E02004208",3718,1058,616,442,2486,659,1178,530,443,205,357,199,139,19,285,160,125,7,7,174,64,110
"2021","Teignbridge 009","E02004209",3978,1148,590,558,2633,472,1241,444,557,240,520,252,224,44,390,246,144,10,10,197,66,131
"2021","Teignbridge 010","E02004210",3253,1439,698,741,1658,269,654,301,220,133,347,191,137,19,380,238,142,8,8,156,42,114
"2021","Teignbridge 011","E02004211",2994,859,565,294,1997,622,940,451,339,150,252,153,76,23,178,92,86,5,5,138,39,99
"2021","Teignbridge 012","E02004212",2648,765,358,407,1761,287,868,327,358,183,323,154,144,25,274,164,110,9,9,122,41,81
"2021","Teignbridge 013","E02004213",3451,762,288,474,2523,346,1232,469,604,159,593,336,229,28,346,257,89,6,6,166,65,101
"2021","Teignbridge 014","E02004214",2964,1226,507,719,1587,181,605,230,275,100,411,244,143,24,369,234,135,21,21,151,46,105
"2021","Teignbridge 015","E02004215",2547,857,407,450,1544,258,710,272,302,136,294,152,118,24,269,170,99,13,13,146,51,95
"2021","Teignbridge 016","E02004216",2424,597,348,249,1692,381,781,357,250,174,284,160,103,21,233,125,108,13,13,135,54,81
"2021","Teignbridge 017","E02004217",3523,1208,644,564,2120,385,952,379,412,161,405,197,171,37,364,240,124,14,14,195,67,128
"2021","Teignbridge 018","E02004218",2698,757,465,292,1784,420,879,377,336,166,252,144,89,19,223,141,82,10,10,157,49,108
"2021","Teignbridge 019","E02004219",2404,642,401,241,1638,451,828,361,333,134,207,108,85,14,147,76,71,5,5,124,42,82
"2021","Torridge 001","E02004220",3006,1149,675,474,1765,447,790,381,262,147,294,179,103,12,225,122,103,9,9,92,29,63
"2021","Torridge 002","E02004221",3029,1011,586,425,1897,648,814,419,279,116,243,140,93,10,184,95,89,8,8,121,40,81
"2021","Torridge 003","E02004222",2783,1121,477,644,1530,271,672,293,250,129,309,165,130,14,267,178,89,11,11,132,34,98
"2021","Torridge 004","E02004223",5610,1674,772,902,3663,539,1619,658,681,280,780,379,350,51,709,495,214,16,16,273,109,164
"2021","Torridge 005","E02004224",2774,697,421,276,1896,490,949,473,295,181,306,178,109,19,144,71,73,7,7,181,73,108
"2021","Torridge 006","E02004225",2521,799,448,351,1604,302,705,281,292,132,326,160,144,22,263,178,85,8,8,118,50,68
"2021","Torridge 007","E02004226",3250,870,502,368,2185,570,1108,583,352,173,303,184,103,16,190,97,93,14,14,195,75,120
"2021","Torridge 008","E02004227",4372,1235,664,571,2890,644,1431,644,524,263,478,254,203,21,319,203,116,18,18,247,104,143
"2021","Torridge 009","E02004228",3105,777,426,351,2132,530,1109,568,347,194,309,175,118,16,173,80,93,11,11,196,75,121
"2021","West Devon 001","E02004229",4057,984,505,479,2789,531,1467,662,577,228,455,278,161,16,324,212,112,12,12,284,117,167
"2021","West Devon 002","E02004230",3518,1233,643,590,2147,427,953,359,437,157,390,202,162,26,359,201,158,18,18,138,49,89
"2021","West Devon 003","E02004231",2911,819,458,361,1933,445,938,444,323,171,338,199,117,22,206,114,92,6,6,159,59,100
"2021","West Devon 004","E02004232",2891,670,373,297,2041,467,1120,514,388,218,289,182,97,10,155,79,76,10,10,180,83,97
"2021","West Devon 005","E02004233",5829,2018,1129,889,3629,890,1702,730,679,293,535,307,203,25,489,324,165,13,13,182,56,126
"2021","West Devon 006","E02004234",2712,714,447,267,1866,465,968,499,309,160,253,136,104,13,173,90,83,7,7,132,46,86
"2021","West Devon 007","E02004235",2903,862,515,347,1894,492,945,435,345,165,244,133,95,16,202,107,95,11,11,147,57,90
"2021","Cheltenham 001","E02004600",2479,778,317,461,1570,238,762,285,327,150,322,199,103,20,237,139,98,11,11,131,48,83
"2021","Cheltenham 002","E02004601",2629,782,507,275,1770,445,921,363,423,135,258,163,79,16,137,73,64,9,9,77,24,53
"2021","Cheltenham 003","E02004602",2841,849,346,503,1815,203,737,264,375,98,453,234,185,34,400,259,141,22,22,177,57,120
"2021","Cheltenham 004","E02004603",3351,1156,316,840,1654,190,613,252,282,79,507,373,121,13,301,199,102,43,43,541,51,490
"2021","Cheltenham 005","E02004604",3515,1167,333,834,2146,146,847,263,414,170,479,185,257,37,642,446,196,32,32,202,80,122
"2021","Cheltenham 006","E02004605",2465,767,336,431,1558,164,693,235,341,117,324,147,145,32,344,218,126,33,33,140,56,84
"2021","Cheltenham 007","E02004606",4623,1546,473,1073,2682,244,1221,466,578,177,793,554,202,37,387,206,181,37,37,395,77,318
"2021","Cheltenham 008","E02004607",4986,2163,592,1571,2467,304,1100,497,484,119,731,592,131,8,288,159,129,44,44,356,39,317
"2021","Cheltenham 009","E02004608",5065,2624,670,1954,2156,329,851,403,350,98,690,632,53,5,257,154,103,29,29,285,24,261
"2021","Cheltenham 010","E02004609",3115,971,452,519,1983,372,1061,367,517,177,337,189,126,22,197,97,100,16,16,161,39,122
"2021","Cheltenham 011","E02004610",3607,1485,735,750,1978,452,914,374,424,116,391,297,85,9,205,121,84,16,16,144,26,118
"2021","Cheltenham 012","E02004611",4927,1325,648,677,3406,483,1988,548,1157,283,519,281,214,24,402,283,119,14,14,196,77,119
"2021","Cheltenham 013","E02004612",4180,1299,721,578,2771,511,1410,505,698,207,478,281,172,25,360,207,153,12,12,110,40,70
"2021","Cheltenham 014","E02004613",2766,796,460,336,1882,441,1042,327,542,173,236,139,85,12,154,96,58,9,9,88,33,55
"2021","Cheltenham 015","E02004614",2356,723,447,276,1567,320,928,296,533,99,190,122,62,6,126,75,51,3,3,66,22,44
"2021","Cotswold 001","E02004615",4011,1209,699,510,2668,734,1315,611,486,218,340,196,125,19,267,163,104,12,12,134,45,89
"2021","Cotswold 002","E02004616",4746,1612,893,719,2963,677,1403,632,562,209,533,343,169,21,339,189,150,11,11,171,47,124
"2021","Cotswold 003","E02004617",4129,1123,577,546,2828,554,1473,584,678,211,458,271,158,29,316,205,111,27,27,178,54,124
"2021","Cotswold 004","E02004618",3099,774,390,384,2194,469,1252,543,518,191,297,202,75,20,170,100,70,6,6,131,38,93
"2021","Cotswold 005","E02004619",3215,893,473,420,2207,488,1166,538,445,183,322,204,94,24,222,125,97,9,9,115,32,83
"2021","Cotswold 006","E02004620",3530,895,424,471,2504,445,1328,461,635,232,394,198,176,20,327,198,129,10,10,131,44,87
"2021","Cotswold 007","E02004621",3160,1525,774,751,1496,346,617,243,277,97,294,209,71,14,230,147,83,9,9,139,30,109
"2021","Cotswold 008","E02004622",3236,1001,475,526,2054,351,1018,363,473,182,383,224,138,21,285,174,111,17,17,181,37,144
"2021","Cotswold 009","E02004623",4080,1130,647,483,2829,619,1480,611,643,226,400,221,151,28,315,192,123,15,15,121,35,86
"2021","Cotswold 010","E02004624",2766,656,325,331,2004,412,1148,473,482,193,260,149,96,15,179,104,75,5,5,106,42,64
"2021","Cotswold 011","E02004625",4628,1445,731,714,3039,634,1549,651,661,237,508,323,164,21,325,201,124,23,23,144,49,95
"2021","Forest of Dean 001","E02004626",3800,919,522,397,2658,662,1407,599,541,267,346,190,134,22,223,119,104,20,20,223,92,131
"2021","Forest of Dean 002","E02004627",2831,902,471,431,1762,366,818,326,332,160,291,151,119,21,269,159,110,18,18,167,72,95
"2021","Forest of Dean 003","E02004628",3325,907,496,411,2246,405,1154,453,462,239,374,177,167,30,303,169,134,10,10,172,77,95
"2021","Forest of Dean 004","E02004629",5736,1783,847,936,3658,581,1692,730,653,309,749,381,319,49,608,374,234,28,28,295,114,181
"2021","Forest of Dean 005","E02004630",2747,753,402,351,1825,404,941,414,346,181,291,155,115,21,181,89,92,8,8,169,56,113
"2021","Forest of Dean 006","E02004631",2235,578,336,242,1538,351,799,406,254,139,234,146,71,17,148,77,71,6,6,119,53,66
"2021","Forest of Dean 007","E02004632",4868,1559,808,751,3126,604,1437,596,551,290,608,298,266,44,461,270,191,16,16,183,79,104
"2021","Forest of Dean 008","E02004633",3598,929,519,410,2529,536,1249,541,438,270,420,212,176,32,308,184,124,16,16,140,52,88
"2021","Forest of Dean 009","E02004634",5020,1509,746,763,3315,635,1417,573,555,289,683,350,288,45,559,338,221,21,21,196,73,123
"2021","Forest of Dean 010","E02004635",3060,742,456,286,2164,494,1122,452,493,177,321,189,117,15,216,121,95,11,11,154,67,87
"2021","Gloucester 001","E02004636",3294,861,450,411,2294,426,1238,461,532,245,385,213,147,25,231,130,101,14,14,139,49,90
"2021","Gloucester 002","E02004637",4135,1656,584,1072,2142,290,1038,384,470,184,435,276,135,24,338,212,126,41,41,337,73,264
"2021","Gloucester 003","E02004638",2370,586,314,272,1669,260,906,277,434,195,291,149,125,17,201,115,86,11,11,115,37,78
"2021","Gloucester 004","E02004639",5559,2560,618,1942,2525,245,970,419,412,139,764,549,193,22,477,326,151,69,69,474,108,366
"2021","Gloucester 005","E02004640",3239,954,277,677,1908,98,977,252,563,162,313,151,147,15,481,315,166,39,39,377,165,212
"2021","Gloucester 006","E02004641",3340,1011,630,381,2210,552,1078,401,459,218,308,185,105,18,256,115,141,16,16,119,53,66
"2021","Gloucester 007","E02004642",4780,1171,498,673,3332,410,1723,552,825,346,611,297,268,46,565,316,249,23,23,277,134,143
"2021","Gloucester 008","E02004643",3170,878,276,602,2016,118,858,248,429,181,465,191,219,55,553,346,207,22,22,276,111,165
"2021","Gloucester 009","E02004644",3773,1110,425,685,2386,240,1095,365,506,224,506,248,221,37,519,325,194,26,26,277,83,194
"2021","Gloucester 010","E02004645",3904,1039,453,586,2731,429,1468,572,639,257,501,299,180,22,326,194,132,7,7,134,44,90
"2021","Gloucester 011","E02004646",3979,1325,528,797,2454,273,1023,358,436,229,516,235,242,39,621,422,199,21,21,200,81,119
"2021","Gloucester 012","E02004647",2534,693,367,326,1710,295,807,324,299,184,292,135,137,20,309,182,127,7,7,131,58,73
"2021","Gloucester 013","E02004648",2559,785,459,326,1662,388,735,312,270,153,275,143,111,21,252,148,104,12,12,112,54,58
"2021","Gloucester 014","E02004649",3008,760,199,561,2132,181,1119,414,517,188,520,301,187,32,295,202,93,17,17,116,44,72
"2021","Gloucester 015","E02004650",5771,1367,370,997,4089,297,1997,640,1099,258,935,455,448,32,832,645,187,28,28,315,138,177
"2021","Stroud 001","E02004651",4519,1098,395,703,3190,409,1654,548,873,233,704,411,259,34,404,272,132,19,19,231,104,127
"2021","Stroud 002","E02004652",2919,798,516,282,1976,534,1075,446,447,182,202,124,65,13,157,83,74,8,8,145,47,98
"2021","Stroud 003","E02004653",3166,738,372,366,2265,410,1221,474,549,198,401,233,143,25,221,131,90,12,12,163,60,103
"2021","Stroud 004","E02004654",4971,1548,765,783,3228,577,1578,567,685,326,611,294,280,37,441,259,182,21,21,195,68,127
"2021","Stroud 005","E02004655",3435,1032,552,480,2229,335,1084,406,470,208,452,264,162,26,338,175,163,20,20,174,57,117
"2021","Stroud 006","E02004656",5360,2078,811,1267,2996,397,1305,511,556,238,685,395,253,37,580,364,216,29,29,286,97,189
"2021","Stroud 007","E02004657",2935,812,401,411,2013,358,1051,403,491,157,367,199,142,26,232,128,104,5,5,110,32,78
"2021","Stroud 008","E02004658",2709,699,357,342,1936,361,1065,402,494,169,289,175,103,11,215,123,92,6,6,74,27,47
"2021","Stroud 009","E02004659",3020,745,425,320,2133,490,1088,445,451,192,315,179,112,24,234,134,100,6,6,142,55,87
"2021","Stroud 010","E02004660",2912,844,555,289,1954,589,942,342,433,167,233,122,100,11,181,89,92,9,9,114,37,77
"2021","Stroud 011","E02004661",3821,1131,646,485,2561,545,1252,521,503,228,447,245,164,38,309,174,135,8,8,129,54,75
"2021","Stroud 012","E02004662",2799,766,403,363,1902,329,986,395,404,187,370,205,134,31,205,112,93,12,12,131,43,88
"2021","Stroud 013","E02004663",2875,916,469,447,1816,350,923,373,398,152,280,173,96,11,259,153,106,4,4,143,45,98
"2021","Stroud 014","E02004664",3248,1000,417,583,2132,304,1024,382,483,159,448,239,190,19,334,231,103,22,22,116,40,76
"2021","Stroud 015","E02004665",3676,1049,555,494,2487,519,1325,436,646,243,355,178,153,24,276,146,130,12,12,140,48,92
"2021","Tewkesbury 001","E02004666",5002,1258,535,723,3554,452,1837,681,869,287,746,403,307,36,500,294,206,19,19,190,84,106
"2021","Tewkesbury 002","E02004667",5083,1848,966,882,3048,627,1383,607,545,231,587,325,239,23,429,238,191,22,22,187,67,120
"2021","Tewkesbury 003","E02004668",4129,1186,697,489,2826,738,1422,624,557,241,362,201,141,20,302,188,114,2,2,117,44,73
"2021","Tewkesbury 004","E02004669",3108,706,380,326,2235,535,1219,490,549,180,311,182,112,17,164,100,64,6,6,167,70,97
"2021","Tewkesbury 006","E02004671",3011,733,334,399,2123,467,1083,424,481,178,366,222,127,17,198,123,75,9,9,155,61,94
"2021","Tewkesbury 007","E02004672",5314,1609,808,801,3524,614,1912,650,942,320,513,295,189,29,476,286,190,9,9,181,71,110
"2021","Tewkesbury 008","E02004673",3256,854,478,376,2267,377,1112,400,534,178,433,238,174,21,335,209,126,10,10,135,58,77
"2021","Tewkesbury 009","E02004674",5067,1308,525,783,3486,416,1661,607,811,243,785,458,285,42,599,390,209,25,25,273,104,169
"2021","Tewkesbury 010","E02007034",3439,956,345,611,2386,243,1205,344,708,153,549,334,199,16,378,284,94,11,11,97,45,52
"2021","Tewkesbury 011","E02007035",3525,1098,678,420,2332,538,1103,411,484,208,347,168,158,21,334,202,132,10,10,95,45,50
"2021","Mendip 001","E02006047",3733,938,498,440,2598,572,1315,552,552,211,414,223,165,26,289,171,118,8,8,197,77,120
"2021","Mendip 002","E02006048",2912,734,402,332,2069,408,1089,401,450,238,335,164,145,26,220,130,90,17,17,109,45,64
"2021","Mendip 003","E02006049",3188,857,502,355,2236,554,1060,414,440,206,361,195,140,26,253,159,94,8,8,95,33,62
"2021","Mendip 004","E02006050",3954,1447,589,858,2299,267,976,326,498,152,539,270,234,35,494,342,152,23,23,208,74,134
"2021","Mendip 005","E02006051",3518,956,558,398,2372,579,1184,478,506,200,345,180,143,22,254,147,107,10,10,190,78,112
"2021","Mendip 006","E02006052",3290,889,486,403,2239,457,1129,461,467,201,375,216,138,21,266,138,128,12,12,162,62,100
"2021","Mendip 007","E02006053",4686,1366,614,752,3101,392,1432,495,732,205,761,362,358,41,501,327,174,15,15,219,86,133
"2021","Mendip 008","E02006054",4143,1645,939,706,2349,543,1000,422,403,175,411,263,132,16,380,227,153,15,15,149,45,104
"2021","Mendip 009","E02006055",3966,1199,491,708,2594,332,1205,465,524,216,611,322,262,27,425,274,151,21,21,173,69,104
"2021","Mendip 010","E02006056",3262,829,434,395,2264,470,1161,482,450,229,382,192,158,32,241,140,101,10,10,169,58,111
"2021","Mendip 011","E02006057",3695,1443,640,803,2015,378,823,392,280,151,406,243,139,24,397,230,167,11,11,237,67,170
"2021","Mendip 012","E02006058",3283,763,430,333,2352,486,1214,483,514,217,358,171,158,29,280,152,128,14,14,168,71,97
"2021","Mendip 013","E02006059",2878,653,351,302,2034,477,1059,434,407,218,301,157,120,24,191,99,92,6,6,191,67,124
"2021","Mendip 014","E02006060",3788,1437,679,758,2174,306,974,348,458,168,472,263,184,25,402,263,139,20,20,177,60,117
"2021","Sedgemoor 001","E02006061",4061,1239,681,558,2660,580,1336,477,608,251,401,208,168,25,332,205,127,11,11,162,55,107
"2021","Sedgemoor 002","E02006062",4786,1249,747,502,3285,863,1648,754,571,323,438,238,169,31,322,187,135,14,14,252,89,163
"2021","Sedgemoor 003","E02006063",2863,628,400,228,2069,556,1086,462,436,188,263,122,116,25,159,103,56,5,5,166,67,99
"2021","Sedgemoor 004","E02006064",3760,1493,888,605,2095,562,853,411,274,168,358,205,134,19,303,169,134,19,19,172,56,116
"2021","Sedgemoor 005","E02006065",3952,1224,583,641,2538,474,1036,426,397,213,471,216,216,39,534,353,181,23,23,190,77,113
"2021","Sedgemoor 006","E02006066",3663,946,574,372,2524,570,1231,569,437,225,436,230,182,24,268,144,124,19,19,193,81,112
"2021","Sedgemoor 007","E02006067",3076,898,548,350,2013,493,1017,448,383,186,294,168,107,19,200,103,97,9,9,165,59,106
"2021","Sedgemoor 008","E02006068",3200,923,358,565,2050,239,806,298,351,157,499,204,255,40,484,323,161,22,22,227,102,125
"2021","Sedgemoor 009","E02006069",4873,1912,614,1298,2599,246,1018,391,458,169,696,377,279,40,564,371,193,75,75,362,129,233
"2021","Sedgemoor 010","E02006070",3806,1041,419,622,2593,351,1189,472,506,211,664,363,274,27,370,262,108,19,19,172,81,91
"2021","Sedgemoor 011","E02006071",3916,973,513,460,2730,515,1398,483,644,271,480,228,226,26,326,217,109,11,11,213,80,133
"2021","Sedgemoor 012","E02006072",4015,961,587,374,2836,728,1445,668,494,283,422,242,150,30,231,125,106,10,10,218,86,132
"2021","Sedgemoor 013","E02006073",3239,1045,411,634,1954,205,785,276,347,162,463,196,223,44,482,337,145,19,19,240,91,149
"2021","Sedgemoor 014","E02006074",4697,1089,498,591,3329,476,1692,641,783,268,688,360,289,39,457,302,155,16,16,279,122,157
"2021","South Somerset 001","E02006075",2216,655,351,304,1473,299,759,314,324,121,202,97,87,18,204,141,63,9,9,88,34,54
"2021","South Somerset 002","E02006076",4022,1162,679,483,2710,679,1356,593,496,267,368,204,131,33,289,174,115,18,18,150,39,111
"2021","South Somerset 003","E02006077",2811,878,533,345,1825,450,818,354,324,140,313,159,132,22,240,154,86,4,4,108,45,63
"2021","South Somerset 004","E02006078",2798,832,416,416,1830,457,875,392,318,165,289,155,116,18,203,112,91,6,6,136,56,80
"2021","South Somerset 005","E02006079",3725,1121,569,552,2454,468,1213,519,507,187,441,234,183,24,321,195,126,11,11,150,65,85
"2021","South Somerset 006","E02006080",2508,656,364,292,1735,352,945,393,409,143,247,112,114,21,181,92,89,10,10,117,47,70
"2021","South Somerset 007","E02006081",2484,636,392,244,1732,439,875,407,322,146,236,113,111,12,171,104,67,11,11,116,59,57
"2021","South Somerset 008","E02006082",3148,920,469,451,2118,487,987,429,366,192,366,172,171,23,267,177,90,11,11,110,43,67
"2021","South Somerset 009","E02006083",2582,807,459,348,1663,379,783,345,269,169,276,156,106,14,211,115,96,14,14,112,40,72
"2021","South Somerset 010","E02006084",3416,972,586,386,2315,632,1094,526,376,192,338,193,127,18,242,145,97,9,9,129,35,94
"2021","South Somerset 011","E02006085",3362,919,423,496,2294,357,1148,449,525,174,462,245,187,30,314,205,109,13,13,149,68,81
"2021","South Somerset 012","E02006086",3084,727,345,382,2207,373,1170,366,597,207,391,205,167,19,261,147,114,12,12,150,58,92
"2021","South Somerset 013","E02006087",2630,861,361,500,1647,202,682,249,309,124,386,198,173,15,364,247,117,13,13,122,56,66
"2021","South Somerset 014","E02006088",3328,1082,443,639,2036,252,898,300,412,186,428,172,218,38,443,315,128,15,15,210,81,129
"2021","South Somerset 015","E02006089",3412,1438,443,995,1711,142,739,285,345,109,421,253,149,19,369,260,109,40,40,263,74,189
"2021","South Somerset 016","E02006090",3086,878,360,518,2038,332,923,346,441,136,465,256,192,17,304,196,108,14,14,170,62,108
"2021","South Somerset 017","E02006091",4447,1247,743,504,3047,758,1504,683,559,262,451,244,174,33,327,193,134,7,7,153,55,98
"2021","South Somerset 018","E02006092",2907,857,428,429,1951,422,966,401,384,181,371,201,156,14,177,115,62,15,15,99,34,65
"2021","South Somerset 019","E02006093",4007,1307,790,517,2558,604,1190,516,462,212,427,239,163,25,321,195,126,16,16,142,50,92
"2021","South Somerset 020","E02006094",2450,718,437,281,1638,411,810,358,307,145,244,141,89,14,168,96,72,5,5,94,34,60
"2021","South Somerset 021","E02006095",3886,1295,679,616,2424,582,1057,464,412,181,454,251,179,24,320,190,130,11,11,167,58,109
"2021","South Somerset 022","E02006096",3224,965,495,470,2096,414,961,386,398,177,438,226,181,31,276,195,81,7,7,163,58,105
"2021","South Somerset 023","E02006097",3128,1092,573,519,1887,348,747,298,319,130,422,191,202,29,350,241,109,20,20,149,53,96
"2021","South Somerset 024","E02006098",3275,836,533,303,2250,656,1122,548,367,207,302,160,126,16,163,76,87,7,7,189,73,116
"2021","Somerset West and Taunton 006","E02006099",2957,725,386,339,2102,419,1068,379,498,191,354,193,143,18,256,152,104,5,5,130,57,73
"2021","Somerset West and Taunton 007","E02006100",3319,949,451,498,2194,384,1087,408,500,179,418,234,155,29,281,183,98,24,24,176,71,105
"2021","Somerset West and Taunton 013","E02006101",2526,733,419,314,1674,368,833,351,327,155,260,152,88,20,203,108,95,10,10,119,34,85
"2021","Somerset West and Taunton 010","E02006102",3043,1007,551,456,1898,276,836,313,336,187,351,160,163,28,421,252,169,14,14,138,61,77
"2021","Somerset West and Taunton 009","E02006103",3457,926,586,340,2360,615,1169,477,497,195,322,169,124,29,248,159,89,6,6,171,69,102
"2021","Somerset West and Taunton 008","E02006104",4516,1275,463,812,3048,390,1522,523,775,224,672,363,280,29,439,315,124,25,25,193,70,123
"2021","Somerset West and Taunton 011","E02006105",5422,2146,693,1453,2932,325,1245,487,602,156,795,509,264,22,494,341,153,73,73,344,73,271
"2021","Somerset West and Taunton 012","E02006106",4083,1124,479,645,2771,417,1379,507,686,186,557,302,219,36,403,265,138,15,15,188,80,108
"2021","Somerset West and Taunton 014","E02006107",3608,1175,485,690,2239,268,913,316,436,161,430,180,212,38,606,403,203,22,22,194,80,114
"2021","Somerset West and Taunton 015","E02006108",4464,2122,1032,1090,2139,468,950,381,446,123,384,274,98,12,307,201,106,30,30,203,49,154
"2021","Somerset West and Taunton 016","E02006109",3421,969,622,347,2308,575,1210,412,605,193,279,135,129,15,230,130,100,14,14,144,54,90
"2021","Somerset West and Taunton 018","E02006110",4620,1556,754,802,2848,394,1345,527,610,208,593,313,248,32,494,326,168,22,22,216,85,131
"2021","Somerset West and Taunton 017","E02006111",4632,1277,759,518,3162,801,1572,702,574,296,429,241,162,26,341,187,154,19,19,193,75,118
"2021","Somerset West and Taunton 019","E02006112",3458,890,492,398,2406,560,1294,561,479,254,347,222,108,17,196,93,103,9,9,162,62,100
"2021","Somerset West and Taunton 001","E02006113",3503,1365,800,565,1959,511,815,362,299,154,354,189,147,18,262,158,104,17,17,179,52,127
"2021","Somerset West and Taunton 002","E02006114",3012,1003,642,361,1910,637,746,419,214,113,290,161,111,18,226,124,102,11,11,99,30,69
"2021","Somerset West and Taunton 003","E02006115",3590,1235,742,493,2214,596,936,471,297,168,359,173,148,38,308,173,135,15,15,141,46,95
"2021","Somerset West and Taunton 004","E02006116",3640,1021,613,408,2436,724,1152,600,358,194,357,233,98,26,193,103,90,10,10,183,58,125
"2021","Somerset West and Taunton 005","E02006117",2703,901,531,370,1695,472,794,420,221,153,265,171,78,16,152,72,80,12,12,107,35,72
"2021","Isle of Anglesey 001","W02000001",3789,1226,592,634,2390,501,1056,504,333,219,422,169,217,36,400,263,137,11,11,173,77,96
"2021","Isle of Anglesey 002","W02000002",2925,900,560,340,1913,488,912,434,285,193,243,129,98,16,260,135,125,10,10,112,41,71
"2021","Isle of Anglesey 003","W02000003",4831,1822,718,1104,2842,335,1005,364,402,239,593,237,318,38,877,597,280,32,32,167,76,91
"2021","Isle of Anglesey 004","W02000004",3320,1013,572,441,2185,530,1004,459,340,205,318,143,159,16,325,168,157,8,8,122,55,67
"2021","Isle of Anglesey 005","W02000005",3794,1270,731,539,2391,663,1074,496,360,218,344,173,153,18,300,176,124,10,10,133,57,76
"2021","Isle of Anglesey 006","W02000006",3040,1010,541,469,1928,294,852,287,377,188,388,152,210,26,382,240,142,12,12,102,47,55
"2021","Isle of Anglesey 007","W02000007",2886,887,430,457,1850,305,859,330,334,195,354,150,181,23,319,186,133,13,13,149,68,81
"2021","Isle of Anglesey 008","W02000008",2765,1023,529,494,1655,357,773,281,331,161,273,151,112,10,245,114,131,7,7,87,26,61
"2021","Isle of Anglesey 009","W02000009",3475,1038,550,488,2285,428,1108,450,414,244,363,157,179,27,357,207,150,29,29,152,67,85
"2021","Gwynedd 001","W02000010",2689,986,312,674,1044,119,365,142,166,57,283,198,76,9,239,163,76,38,38,659,48,611
"2021","Gwynedd 002","W02000011",3388,955,423,532,2174,223,978,288,484,206,432,175,225,32,517,337,180,24,24,259,60,199
"2021","Gwynedd 003","W02000012",3559,1174,511,663,2217,288,984,352,421,211,496,236,231,29,434,274,160,15,15,168,69,99
"2021","Gwynedd 004","W02000013",2762,846,377,469,1802,282,800,276,365,159,408,197,187,24,305,181,124,7,7,114,39,75
"2021","Gwynedd 005","W02000014",2920,945,413,532,1809,238,786,270,308,208,419,203,192,24,353,197,156,13,13,166,51,115
"2021","Gwynedd 006","W02000015",3679,1223,497,726,2286,317,885,308,380,197,484,184,260,40,572,380,192,28,28,170,68,102
"2021","Gwynedd 007","W02000016",2731,891,423,468,1714,276,809,287,347,175,337,154,159,24,279,151,128,13,13,126,52,74
"2021","Gwynedd 008","W02000017",3286,1043,529,514,2122,365,912,370,334,208,463,210,232,21,362,224,138,20,20,121,57,64
"2021","Gwynedd 009","W02000018",2799,1100,484,616,1613,242,678,272,261,145,355,146,183,26,331,205,126,7,7,86,35,51
"2021","Gwynedd 010","W02000019",3063,1145,633,512,1784,397,747,337,244,166,359,164,175,20,266,142,124,15,15,134,49,85
"2021","Gwynedd 011","W02000020",2841,961,508,453,1768,398,829,338,304,187,301,135,144,22,230,126,104,10,10,112,56,56
"2021","Gwynedd 012","W02000021",3472,1243,595,648,2085,373,922,346,355,221,422,193,208,21,345,186,159,23,23,144,64,80
"2021","Gwynedd 013","W02000022",2673,999,563,436,1572,399,690,378,193,119,261,125,122,14,212,122,90,10,10,102,38,64
"2021","Gwynedd 014","W02000023",2334,779,433,346,1454,321,713,303,231,179,244,112,119,13,163,85,78,13,13,101,36,65
"2021","Gwynedd 015","W02000024",2550,894,454,440,1555,255,774,317,293,164,284,149,124,11,230,120,110,12,12,101,43,58
"2021","Gwynedd 016","W02000025",2879,1083,517,566,1691,356,731,353,239,139,315,158,136,21,274,180,94,15,15,105,37,68
"2021","Gwynedd 017","W02000026",3477,1395,799,596,1971,504,891,500,236,155,326,181,126,19,240,131,109,10,10,111,43,68
"2021","Conwy 001","W02000027",4227,1966,903,1063,2031,427,815,385,269,161,366,220,132,14,397,237,160,26,26,230,71,159
"2021","Conwy 002","W02000028",2987,995,572,423,1851,395,735,312,271,152,274,114,122,38,432,266,166,15,15,141,63,78
"2021","Conwy 003","W02000029",2738,862,540,322,1791,493,814,347,305,162,245,130,104,11,231,134,97,8,8,85,24,61
"2021","Conwy 004","W02000030",2956,1236,766,470,1628,471,697,303,261,133,204,112,87,5,250,147,103,6,6,92,40,52
"2021","Conwy 005","W02000031",3608,1088,597,491,2317,500,972,450,314,208,392,163,189,40,446,278,168,7,7,203,89,114
"2021","Conwy 006","W02000032",3875,1296,787,509,2440,572,1121,479,418,224,363,182,162,19,375,215,160,9,9,139,51,88
"2021","Conwy 007","W02000033",3138,1274,482,792,1695,252,639,232,273,134,324,154,145,25,453,310,143,27,27,169,69,100
"2021","Conwy 008","W02000034",3346,1083,517,566,2136,388,1049,431,419,199,365,170,171,24,327,194,133,7,7,127,64,63
"2021","Conwy 009","W02000035",3775,1114,519,595,2477,397,1072,405,453,214,420,189,203,28,564,362,202,24,24,184,81,103
"2021","Conwy 010","W02000036",5372,1915,1094,821,3278,873,1304,606,439,259,533,263,230,40,549,341,208,19,19,179,76,103
"2021","Conwy 011","W02000037",3179,959,449,510,2096,336,886,338,379,169,446,216,196,34,413,263,150,15,15,124,47,77
"2021","Conwy 012","W02000038",2845,915,488,427,1809,389,831,357,295,179,306,168,120,18,266,166,100,17,17,121,56,65
"2021","Conwy 013","W02000039",3672,1321,621,700,2207,365,960,412,350,198,420,230,163,27,450,301,149,12,12,144,60,84
"2021","Conwy 014","W02000040",2787,738,369,369,1920,386,1017,411,370,236,306,173,121,12,200,104,96,11,11,129,68,61
"2021","Conwy 015","W02000041",3718,1150,617,533,2398,428,1151,479,412,260,465,228,203,34,344,186,158,10,10,170,66,104
"2021","Denbighshire 001","W02000042",2715,926,553,373,1675,396,666,301,221,144,286,133,130,23,318,195,123,9,9,114,59,55
"2021","Denbighshire 002","W02000043",2286,741,388,353,1414,278,603,226,232,145,225,93,106,26,299,174,125,9,9,131,60,71
"2021","Denbighshire 003","W02000044",2493,874,498,376,1551,381,665,254,241,170,217,103,101,13,281,165,116,7,7,68,34,34
"2021","Denbighshire 004","W02000045",4320,1938,698,1240,2118,348,754,291,319,144,389,179,197,13,598,396,202,29,29,264,124,140
"2021","Denbighshire 006","W02000047",2167,637,281,356,1396,110,510,150,239,121,267,77,154,36,496,349,147,13,13,134,77,57
"2021","Denbighshire 008","W02000049",2842,785,402,383,1936,354,881,371,343,167,348,161,163,24,337,206,131,16,16,121,69,52
"2021","Denbighshire 009","W02000050",2865,896,455,441,1842,367,796,317,305,174,314,145,145,24,353,209,144,12,12,127,48,79
"2021","Denbighshire 010","W02000051",2359,757,404,353,1494,342,660,286,242,132,250,127,107,16,235,142,93,7,7,108,46,62
"2021","Denbighshire 011","W02000052",2241,831,316,515,1308,163,476,179,183,114,257,121,114,22,398,263,135,14,14,102,45,57
"2021","Denbighshire 012","W02000053",2708,791,421,370,1825,342,929,349,383,197,291,135,143,13,248,138,110,15,15,92,36,56
"2021","Denbighshire 013","W02000054",2608,701,380,321,1802,388,970,427,347,196,253,134,100,19,181,102,79,10,10,105,46,59
"2021","Denbighshire 014","W02000055",2630,992,501,491,1571,309,665,248,292,125,307,149,136,22,279,188,91,11,11,67,30,37
"2021","Denbighshire 015","W02000056",2210,640,337,303,1475,286,734,294,305,135,258,138,102,18,186,118,68,11,11,95,39,56
"2021","Denbighshire 016","W02000057",2890,1001,522,479,1786,378,818,385,289,144,299,173,106,20,275,173,102,16,16,103,30,73
"2021","Denbighshire 017","W02000419",5049,1595,824,771,3242,587,1367,550,541,276,628,272,300,56,639,417,222,21,21,212,96,116
"2021","Flintshire 001","W02000058",2336,737,411,326,1500,283,693,331,208,154,276,141,112,23,236,131,105,12,12,99,39,60
"2021","Flintshire 002","W02000059",2748,758,383,375,1892,310,952,393,350,209,322,139,162,21,296,166,130,12,12,98,44,54
"2021","Flintshire 003","W02000060",4634,1535,680,855,2897,347,1233,452,471,310,575,228,293,54,716,488,228,26,26,202,93,109
"2021","Flintshire 004","W02000061",3362,1173,539,634,2006,194,748,275,342,131,505,241,229,35,521,306,215,38,38,183,98,85
"2021","Flintshire 005","W02000062",2481,578,284,294,1798,309,920,325,361,234,295,140,130,25,263,165,98,11,11,105,48,57
"2021","Flintshire 006","W02000063",3528,945,562,383,2422,556,1223,506,449,268,359,198,135,26,267,117,150,17,17,161,72,89
"2021","Flintshire 007","W02000064",2650,826,365,461,1663,203,665,236,264,165,324,141,166,17,446,288,158,25,25,161,73,88
"2021","Flintshire 008","W02000065",3016,738,352,386,2111,324,1012,363,422,227,406,196,176,34,353,221,132,16,16,167,76,91
"2021","Flintshire 009","W02000066",4237,1365,591,774,2602,281,1076,342,490,244,558,308,218,32,639,411,228,48,48,270,125,145
"2021","Flintshire 010","W02000067",2731,572,320,252,2067,391,1086,361,500,225,312,156,139,17,272,146,126,6,6,92,38,54
"2021","Flintshire 011","W02000068",2398,853,400,453,1406,200,651,283,247,121,251,137,94,20,289,159,130,15,15,139,62,77
"2021","Flintshire 012","W02000069",2724,732,380,352,1896,385,952,358,405,189,310,160,127,23,239,145,94,10,10,96,40,56
"2021","Flintshire 013","W02000070",4479,1186,658,528,3148,591,1700,563,821,316,485,256,192,37,360,213,147,12,12,145,59,86
"2021","Flintshire 014","W02000071",3089,862,547,315,2126,488,1034,371,441,222,321,184,120,17,276,152,124,7,7,101,46,55
"2021","Flintshire 015","W02000072",5040,1401,607,794,3437,388,1601,582,691,328,776,437,305,34,641,402,239,31,31,202,84,118
"2021","Flintshire 016","W02000073",4566,1530,759,771,2901,509,1301,478,555,268,499,236,235,28,569,363,206,23,23,135,52,83
"2021","Flintshire 017","W02000074",4426,1453,625,828,2833,439,1243,444,551,248,597,305,258,34,527,328,199,27,27,140,70,70
"2021","Flintshire 018","W02000075",2670,634,307,327,1958,333,1054,378,505,171,344,162,168,14,215,141,74,12,12,78,42,36
"2021","Flintshire 019","W02000076",3202,868,487,381,2225,473,1066,409,415,242,351,210,118,23,321,188,133,14,14,109,47,62
"2021","Flintshire 020","W02000077",2587,730,382,348,1763,310,881,320,361,200,288,149,115,24,272,175,97,12,12,94,46,48
"2021","Wrexham 003","W02000080",3309,945,439,506,2236,316,1045,340,473,232,441,169,235,37,414,287,127,20,20,128,59,69
"2021","Wrexham 004","W02000081",2400,646,263,383,1675,192,790,300,334,156,344,149,173,22,332,237,95,17,17,79,39,40
"2021","Wrexham 005","W02000082",3294,981,382,599,2185,231,963,350,416,197,497,256,209,32,477,331,146,17,17,128,53,75
"2021","Wrexham 006","W02000083",3706,1109,453,656,2460,280,1088,365,501,222,561,282,251,28,516,341,175,15,15,137,54,83
"2021","Wrexham 008","W02000085",4065,1427,749,678,2459,498,1083,439,417,227,473,229,213,31,387,234,153,18,18,179,54,125
"2021","Wrexham 010","W02000087",2776,844,311,533,1761,119,557,161,259,137,366,109,226,31,686,501,185,33,33,171,100,71
"2021","Wrexham 011","W02000088",3867,1317,396,921,2290,254,973,347,442,184,550,319,209,22,454,294,160,59,59,260,90,170
"2021","Wrexham 012","W02000089",3931,1455,465,990,2221,198,879,302,395,182,492,263,206,23,601,438,163,51,51,255,117,138
"2021","Wrexham 013","W02000090",2387,638,311,327,1628,277,761,306,288,167,292,134,134,24,290,196,94,8,8,121,59,62
"2021","Wrexham 014","W02000091",2679,744,381,363,1869,309,889,347,334,208,350,141,184,25,312,195,117,9,9,66,34,32
"2021","Wrexham 015","W02000092",2998,1053,468,585,1832,206,755,286,281,188,393,161,204,28,460,326,134,18,18,113,50,63
"2021","Wrexham 016","W02000093",2863,843,376,467,1906,301,949,353,387,209,324,155,145,24,319,212,107,13,13,114,53,61
"2021","Wrexham 017","W02000094",3814,1156,572,584,2533,340,1024,376,411,237,532,186,306,40,612,423,189,25,25,125,59,66
"2021","Wrexham 018","W02000095",2758,723,416,307,1917,389,1016,449,374,193,262,145,103,14,237,131,106,13,13,118,56,62
"2021","Wrexham 019","W02000096",2825,878,445,433,1836,312,853,362,312,179,319,139,153,27,341,198,143,11,11,111,48,63
"2021","Wrexham 021","W02000424",2971,847,487,360,2031,501,1001,372,407,222,288,147,125,16,235,102,133,6,6,93,35,58
"2021","Wrexham 022","W02000425",2871,757,400,357,2002,370,1117,410,489,218,297,147,128,22,212,123,89,6,6,112,56,56
"2021","Wrexham 023","W02000426",4395,1296,725,571,2955,626,1311,489,522,300,476,210,225,41,525,320,205,17,17,144,60,84
"2021","Ceredigion 001","W02000116",3246,986,489,497,2110,399,982,400,371,211,413,225,169,19,308,186,122,8,8,150,45,105
"2021","Ceredigion 002","W02000117",2949,1208,372,836,1124,160,408,164,185,59,363,285,71,7,159,94,65,34,34,617,34,583
"2021","Ceredigion 003","W02000118",2713,944,401,543,1601,222,633,241,277,115,390,195,176,19,339,208,131,17,17,168,30,138
"2021","Ceredigion 005","W02000120",3233,1037,596,441,2022,504,938,433,319,186,295,153,114,28,269,136,133,16,16,174,64,110
"2021","Ceredigion 007","W02000122",2858,825,473,352,1870,483,936,471,285,180,262,147,100,15,176,92,84,13,13,163,61,102
"2021","Ceredigion 008","W02000123",3337,1067,552,515,2072,444,940,426,322,192,358,178,167,13,307,170,137,23,23,198,78,120
"2021","Ceredigion 009","W02000124",4178,1627,846,781,2377,575,976,464,353,159,365,170,175,20,436,270,166,25,25,174,57,117
"2021","Ceredigion 010","W02000125",3385,1064,580,484,2161,480,1007,490,309,208,372,203,153,16,288,155,133,14,14,160,62,98
"2021","Ceredigion 011","W02000421",4997,1444,793,651,3311,689,1654,697,611,346,561,307,221,33,394,214,180,13,13,242,88,154
"2021","Pembrokeshire 001","W02000126",3637,1100,608,492,2336,520,1084,469,395,220,375,203,145,27,332,200,132,25,25,201,88,113
"2021","Pembrokeshire 002","W02000127",4444,1561,839,722,2675,621,1117,508,376,233,447,226,197,24,474,286,188,16,16,208,92,116
"2021","Pembrokeshire 003","W02000128",3184,1030,594,436,2013,503,966,415,337,214,282,140,113,29,254,134,120,8,8,141,52,89
"2021","Pembrokeshire 004","W02000129",3044,800,422,378,2078,444,1059,439,414,206,303,166,120,17,263,148,115,9,9,166,84,82
"2021","Pembrokeshire 005","W02000130",3176,1312,459,853,1731,182,745,283,333,129,301,144,146,11,486,348,138,17,17,133,48,85
"2021","Pembrokeshire 006","W02000131",3170,1045,551,494,1992,314,867,337,359,171,372,173,175,24,421,278,143,18,18,133,55,78
"2021","Pembrokeshire 007","W02000132",3122,1019,539,480,1949,406,956,396,366,194,318,178,126,14,256,165,91,13,13,154,59,95
"2021","Pembrokeshire 008","W02000133",3539,1001,530,471,2371,541,1143,500,413,230,360,180,156,24,316,190,126,11,11,167,75,92
"2021","Pembrokeshire 009","W02000134",3667,1070,571,499,2448,530,1198,519,462,217,390,204,163,23,318,190,128,12,12,149,63,86
"2021","Pembrokeshire 010","W02000135",3418,1292,552,740,2029,340,845,376,315,154,409,173,222,14,419,295,124,16,16,97,44,53
"2021","Pembrokeshire 011","W02000136",3802,1221,715,506,2404,606,1147,553,362,232,347,190,133,24,286,169,117,18,18,177,68,109
"2021","Pembrokeshire 012","W02000137",3328,1133,525,608,2078,266,849,338,343,168,428,168,218,42,520,366,154,15,15,117,43,74
"2021","Pembrokeshire 013","W02000138",4432,1680,681,999,2574,380,1052,415,406,231,491,218,242,31,626,448,178,25,25,178,91,87
"2021","Pembrokeshire 014","W02000139",3446,1011,598,413,2301,617,1138,493,422,223,305,167,116,22,231,123,108,10,10,134,62,72
"2021","Pembrokeshire 015","W02000140",3291,1154,513,641,2023,332,859,360,325,174,342,151,169,22,468,327,141,22,22,114,55,59
"2021","Pembrokeshire 016","W02000141",2771,1077,592,485,1570,371,652,299,209,144,249,132,96,21,292,185,107,6,6,124,44,80
"2021","Carmarthenshire 001","W02000142",2416,725,395,330,1565,330,729,302,255,172,293,143,136,14,209,106,103,4,4,126,49,77
"2021","Carmarthenshire 002","W02000143",2444,780,431,349,1518,345,739,381,206,152,237,123,104,10,186,83,103,11,11,146,72,74
"2021","Carmarthenshire 003","W02000144",3318,989,537,452,2121,472,1067,486,361,220,303,182,104,17,264,130,134,15,15,208,79,129
"2021","Carmarthenshire 004","W02000145",3117,1009,538,471,1943,413,985,419,366,200,264,151,99,14,262,147,115,19,19,165,63,102
"2021","Carmarthenshire 005","W02000146",2786,728,408,320,1906,420,1009,424,363,222,274,153,102,19,189,69,120,14,14,152,59,93
"2021","Carmarthenshire 006","W02000147",3495,1020,449,571,2270,366,1090,382,523,185,401,217,165,19,391,242,149,22,22,205,85,120
"2021","Carmarthenshire 007","W02000148",2352,798,335,463,1466,209,599,243,256,100,311,133,156,22,334,221,113,13,13,88,32,56
"2021","Carmarthenshire 008","W02000149",3145,1322,640,682,1711,391,690,269,305,116,314,176,119,19,289,164,125,27,27,112,47,65
"2021","Carmarthenshire 010","W02000151",3239,1021,483,538,2065,346,946,389,348,209,378,163,182,33,372,231,141,23,23,153,63,90
"2021","Carmarthenshire 011","W02000152",3671,1054,578,476,2452,511,1166,430,508,228,350,154,172,24,407,260,147,18,18,165,81,84
"2021","Carmarthenshire 012","W02000153",3732,1033,579,454,2480,531,1260,551,470,239,386,202,158,26,290,133,157,13,13,219,105,114
"2021","Carmarthenshire 013","W02000154",3449,1169,558,611,2135,363,983,336,427,220,357,150,180,27,412,250,162,20,20,145,66,79
"2021","Carmarthenshire 015","W02000156",3545,931,441,490,2446,409,1180,455,474,251,416,185,200,31,425,243,182,16,16,168,67,101
"2021","Carmarthenshire 016","W02000157",4302,1195,612,583,2915,474,1471,586,598,287,516,233,258,25,437,251,186,17,17,192,79,113
"2021","Carmarthenshire 017","W02000158",2551,696,342,354,1752,264,898,382,358,158,316,140,156,20,260,169,91,14,14,103,39,64
"2021","Carmarthenshire 018","W02000159",2663,787,438,349,1733,320,800,339,282,179,265,95,146,24,330,208,122,18,18,143,56,87
"2021","Carmarthenshire 019","W02000160",3282,948,546,402,2215,487,1110,403,463,244,313,140,144,29,295,174,121,10,10,119,59,60
"2021","Carmarthenshire 020","W02000161",2205,720,356,364,1384,196,605,225,248,132,224,91,120,13,350,229,121,9,9,101,55,46
"2021","Carmarthenshire 021","W02000162",3712,1187,710,477,2368,523,1055,438,350,267,368,171,172,25,408,228,180,14,14,157,67,90
"2021","Carmarthenshire 022","W02000163",2337,800,347,453,1437,218,612,207,275,130,249,100,129,20,343,219,124,15,15,100,35,65
"2021","Carmarthenshire 023","W02000164",3309,1052,482,570,2123,369,966,372,391,203,408,226,167,15,371,215,156,9,9,134,48,86
"2021","Carmarthenshire 024","W02000165",2778,871,401,470,1773,234,796,261,322,213,312,134,157,21,412,278,134,19,19,134,67,67
"2021","Carmarthenshire 025","W02000166",3851,1100,479,621,2607,311,1172,410,512,250,533,229,258,46,578,390,188,13,13,144,78,66
"2021","Carmarthenshire 026","W02000167",4712,1818,658,1160,2652,293,1059,401,412,246,558,249,271,38,715,491,224,27,27,242,98,144
"2021","Carmarthenshire 027","W02000418",5328,1599,827,772,3451,725,1728,759,620,349,525,275,231,19,450,242,208,23,23,278,134,144
"2021","Swansea 001","W02000168",2831,944,410,534,1797,238,836,281,389,166,330,150,162,18,385,240,145,8,8,90,46,44
"2021","Swansea 002","W02000169",4020,1307,604,703,2551,458,1125,372,488,265,413,197,187,29,531,344,187,24,24,162,63,99
"2021","Swansea 003","W02000170",3810,1136,563,573,2518,471,1153,399,476,278,376,184,155,37,499,304,195,19,19,156,64,92
"2021","Swansea 004","W02000171",3536,958,415,543,2464,347,1323,395,659,269,419,219,177,23,368,227,141,7,7,114,44,70
"2021","Swansea 005","W02000172",4496,1564,698,866,2730,361,1236,407,570,259,506,234,230,42,603,356,247,24,24,202,98,104
"2021","Swansea 006","W02000173",3252,814,267,547,2317,276,1147,401,537,209,489,265,200,24,397,250,147,8,8,121,60,61
"2021","Swansea 007","W02000174",4220,1252,664,588,2823,509,1372,475,595,302,477,234,217,26,453,265,188,12,12,145,68,77
"2021","Swansea 008","W02000175",3419,1329,466,863,1922,222,814,302,307,205,387,199,166,22,475,302,173,24,24,168,51,117
"2021","Swansea 009","W02000176",3995,1273,635,638,2549,504,984,350,401,233,463,236,194,33,573,371,202,25,25,173,81,92
"2021","Swansea 010","W02000177",2991,846,350,496,2016,268,938,339,391,208,370,167,176,27,434,295,139,6,6,129,61,68
"2021","Swansea 011","W02000178",3668,1170,376,794,2336,157,842,250,427,165,398,130,232,36,906,677,229,33,33,162,90,72
"2021","Swansea 012","W02000179",2791,814,421,393,1869,355,919,313,384,222,269,131,113,25,312,174,138,14,14,108,46,62
"2021","Swansea 013","W02000180",3383,1053,480,573,2159,229,838,265,381,192,383,146,190,47,688,479,209,21,21,171,81,90
"2021","Swansea 014","W02000181",3328,1168,369,799,2016,232,760,271,297,192,426,225,178,23,583,371,212,15,15,144,66,78
"2021","Swansea 015","W02000182",3415,1160,441,719,2139,258,939,355,360,224,389,187,175,27,535,323,212,18,18,116,46,70
"2021","Swansea 016","W02000183",4495,1859,492,1367,2411,209,930,304,429,197,561,318,203,40,659,402,257,52,52,225,76,149
"2021","Swansea 017","W02000184",3121,1150,501,649,1855,256,848,288,364,196,328,159,142,27,398,234,164,25,25,116,51,65
"2021","Swansea 018","W02000185",2203,630,360,270,1486,334,760,285,292,183,194,95,91,8,193,100,93,5,5,87,39,48
"2021","Swansea 019","W02000186",3777,1199,417,782,2433,127,717,207,357,153,449,140,275,34,1101,835,266,39,39,145,67,78
"2021","Swansea 021","W02000188",3822,1446,456,990,2095,235,806,329,311,166,470,288,149,33,529,364,165,55,55,281,66,215
"2021","Swansea 022","W02000189",3851,1486,764,722,2217,395,1071,350,517,204,326,186,123,17,390,241,149,35,35,148,63,85
"2021","Swansea 024","W02000191",3667,1343,410,933,1731,239,815,288,377,150,356,253,92,11,275,155,120,46,46,593,54,539
"2021","Swansea 025","W02000192",4881,2875,669,2206,1561,170,561,309,187,65,478,402,71,5,276,165,111,76,76,445,51,394
"2021","Swansea 026","W02000193",3540,1416,446,970,1095,135,437,159,195,83,267,193,63,11,219,136,83,37,37,1029,64,965
"2021","Swansea 027","W02000194",2420,740,467,273,1576,400,835,287,392,156,190,98,77,15,129,69,60,22,22,104,20,84
"2021","Swansea 028","W02000195",2634,831,556,275,1739,477,918,329,416,173,144,71,59,14,197,103,94,3,3,64,28,36
"2021","Swansea 029","W02000196",3009,1153,652,501,1782,410,772,277,361,134,252,144,97,11,340,180,160,8,8,74,23,51
"2021","Swansea 030","W02000197",2590,731,486,245,1705,505,866,352,327,187,166,78,80,8,159,76,83,9,9,154,64,90
"2021","Swansea 031","W02000198",3385,1204,648,556,2055,565,1030,386,467,177,228,126,89,13,216,124,92,16,16,126,40,86
"2021","Swansea 032","W02000428",4426,1303,776,527,2992,671,1496,503,653,340,409,202,181,26,398,211,187,18,18,131,58,73
"2021","Neath Port Talbot 002","W02000200",2245,691,356,335,1462,242,691,264,266,161,215,90,108,17,304,167,137,10,10,92,38,54
"2021","Neath Port Talbot 003","W02000201",2349,738,362,376,1521,273,659,262,231,166,260,111,125,24,317,210,107,12,12,90,49,41
"2021","Neath Port Talbot 004","W02000202",5327,1562,747,815,3573,565,1678,605,673,400,629,297,288,44,673,425,248,28,28,192,78,114
"2021","Neath Port Talbot 006","W02000204",2960,882,510,372,2008,467,975,322,395,258,268,115,134,19,285,161,124,13,13,70,32,38
"2021","Neath Port Talbot 007","W02000205",2612,858,450,408,1673,335,744,283,276,185,237,118,98,21,338,196,142,19,19,81,36,45
"2021","Neath Port Talbot 008","W02000206",3340,1526,643,883,1703,264,635,263,241,131,314,152,137,25,465,288,177,25,25,111,42,69
"2021","Neath Port Talbot 009","W02000207",2285,610,321,289,1606,336,803,332,281,190,235,112,104,19,226,130,96,6,6,69,34,35
"2021","Neath Port Talbot 010","W02000208",4552,1366,504,862,2993,368,1405,455,644,306,594,289,261,44,606,387,219,20,20,193,92,101
"2021","Neath Port Talbot 012","W02000210",2679,801,280,521,1793,219,770,252,318,200,295,139,128,28,492,329,163,17,17,85,37,48
"2021","Neath Port Talbot 013","W02000211",3658,1403,510,893,2123,284,834,306,319,209,403,172,204,27,578,397,181,24,24,132,66,66
"2021","Neath Port Talbot 014","W02000212",3489,1124,515,609,2253,349,1046,416,406,224,377,175,165,37,471,291,180,10,10,112,54,58
"2021","Neath Port Talbot 015","W02000213",2955,848,428,420,1999,406,941,320,410,211,331,163,144,24,309,175,134,12,12,108,56,52
"2021","Neath Port Talbot 016","W02000214",4108,1301,651,650,2594,328,1044,389,396,259,401,142,213,46,791,484,307,30,30,213,105,108
"2021","Neath Port Talbot 017","W02000215",4398,1635,633,1002,2546,299,1045,406,406,233,439,199,209,31,718,466,252,45,45,217,95,122
"2021","Neath Port Talbot 018","W02000216",3203,1108,405,703,1946,274,884,324,342,218,379,190,166,23,388,246,142,21,21,149,78,71
"2021","Neath Port Talbot 019","W02000217",2764,845,347,498,1796,255,870,310,374,186,294,139,134,21,362,251,111,15,15,123,57,66
"2021","Neath Port Talbot 020","W02000417",4562,1518,667,851,2852,405,1277,483,508,286,528,231,254,43,619,373,246,23,23,192,97,95
"2021","Neath Port Talbot 021","W02000427",4886,1554,706,848,3104,469,1369,524,478,367,527,248,244,35,710,453,257,29,29,228,106,122
"2021","Bridgend 001","W02000218",2887,918,399,519,1841,247,717,279,246,192,390,140,215,35,473,319,154,14,14,128,58,70
"2021","Bridgend 002","W02000219",3256,1115,515,600,2026,301,927,382,314,231,331,126,181,24,451,284,167,16,16,115,51,64
"2021","Bridgend 003","W02000220",3459,1061,436,625,2263,320,946,371,348,227,468,190,235,43,510,348,162,19,19,135,59,76
"2021","Bridgend 004","W02000221",3252,943,386,557,2133,279,897,339,323,235,440,190,212,38,491,288,203,26,26,176,99,77
"2021","Bridgend 005","W02000222",2597,696,401,295,1780,363,826,305,313,208,255,111,120,24,327,186,141,9,9,121,60,61
"2021","Bridgend 006","W02000223",2645,809,334,475,1730,211,822,327,321,174,325,159,142,24,361,235,126,11,11,106,48,58
"2021","Bridgend 007","W02000224",2791,798,343,455,1847,228,833,293,338,202,364,193,154,17,398,240,158,24,24,146,64,82
"2021","Bridgend 008","W02000225",3796,1124,546,578,2480,336,1106,437,431,238,450,165,244,41,566,325,241,22,22,192,99,93
"2021","Bridgend 009","W02000226",4285,1154,600,554,2952,549,1427,523,612,292,468,243,197,28,491,288,203,17,17,179,92,87
"2021","Bridgend 010","W02000227",3178,941,404,537,2108,305,878,313,370,195,405,169,212,24,501,336,165,19,19,129,69,60
"2021","Bridgend 011","W02000228",4401,1060,379,681,3173,380,1533,484,837,212,851,509,307,35,392,254,138,17,17,168,76,92
"2021","Bridgend 012","W02000229",2728,914,420,494,1703,282,729,282,273,174,323,140,160,23,356,200,156,13,13,111,52,59
"2021","Bridgend 013","W02000230",2347,553,317,236,1717,374,908,336,372,200,257,142,95,20,166,99,67,12,12,77,27,50
"2021","Bridgend 014","W02000231",3906,1488,566,922,2241,310,898,329,380,189,462,250,179,33,543,326,217,28,28,177,69,108
"2021","Bridgend 015","W02000232",2466,676,274,402,1694,217,879,335,362,182,323,181,127,15,259,151,108,16,16,96,37,59
"2021","Bridgend 016","W02000233",2667,789,294,495,1768,233,795,303,330,162,318,160,137,21,401,269,132,21,21,110,47,63
"2021","Bridgend 017","W02000234",4295,1084,457,627,3041,393,1722,534,870,318,443,214,206,23,466,296,170,17,17,170,87,83
"2021","Bridgend 018","W02000235",4221,1461,881,580,2605,728,1217,481,427,309,324,167,140,17,320,169,151,16,16,155,62,93
"2021","Bridgend 019","W02000236",3205,1082,582,500,1972,452,924,391,334,199,293,143,116,34,288,156,132,15,15,151,51,100
"2021","Vale of Glamorgan 001","W02000237",2577,596,326,270,1898,394,1110,436,479,195,207,112,81,14,179,108,71,8,8,83,29,54
"2021","Vale of Glamorgan 002","W02000238",2883,858,567,291,1939,544,1018,355,484,179,177,84,84,9,193,121,72,7,7,86,39,47
"2021","Vale of Glamorgan 003","W02000239",3358,768,403,365,2462,532,1370,506,618,246,330,204,106,20,226,132,94,4,4,128,54,74
"2021","Vale of Glamorgan 004","W02000240",3726,1075,571,504,2458,358,1242,357,643,242,392,184,175,33,445,272,173,21,21,193,101,92
"2021","Vale of Glamorgan 005","W02000241",4757,1841,859,982,2740,432,1345,482,654,209,545,359,171,15,393,256,137,25,25,176,58,118
"2021","Vale of Glamorgan 006","W02000242",3603,1032,647,385,2442,489,1228,458,524,246,369,206,138,25,349,204,145,7,7,129,70,59
"2021","Vale of Glamorgan 007","W02000243",3914,1231,536,695,2477,263,968,314,438,216,468,168,255,45,757,530,227,21,21,206,114,92
"2021","Vale of Glamorgan 008","W02000244",4306,1229,742,487,2910,593,1513,474,746,293,373,182,162,29,415,266,149,16,16,167,82,85
"2021","Vale of Glamorgan 009","W02000245",3543,1059,405,654,2294,252,1070,393,439,238,418,174,212,32,527,358,169,27,27,190,91,99
"2021","Vale of Glamorgan 010","W02000246",2342,627,394,233,1615,428,839,334,313,192,173,83,79,11,169,81,88,6,6,100,41,59
"2021","Vale of Glamorgan 011","W02000247",3793,1195,660,535,2446,529,1177,464,470,243,368,161,169,38,360,202,158,12,12,152,62,90
"2021","Vale of Glamorgan 012","W02000248",4709,1618,530,1088,2813,239,1109,395,487,227,613,279,295,39,822,575,247,30,30,278,109,169
"2021","Vale of Glamorgan 013","W02000249",3870,1421,567,854,2283,242,949,337,422,190,498,216,251,31,577,380,197,17,17,166,67,99
"2021","Vale of Glamorgan 014","W02000250",4847,1356,565,791,3306,498,1646,633,710,303,622,303,279,40,528,355,173,12,12,185,83,102
"2021","Vale of Glamorgan 015","W02000251",5207,1934,718,1216,3053,354,1339,520,583,236,692,414,249,29,640,430,210,28,28,220,88,132
"2021","Cardiff 001","W02000367",2529,599,342,257,1837,414,1023,345,472,206,206,136,59,11,188,119,69,6,6,93,35,58
"2021","Cardiff 002","W02000368",2522,770,310,460,1677,217,909,314,423,172,310,194,100,16,231,154,77,10,10,75,30,45
"2021","Cardiff 003","W02000369",4028,990,202,788,2859,210,1515,445,824,246,618,409,192,17,465,348,117,51,51,179,81,98
"2021","Cardiff 004","W02000370",2935,934,637,297,1907,443,1053,355,506,192,196,101,78,17,208,103,105,7,7,94,27,67
"2021","Cardiff 005","W02000371",4094,1566,701,865,2349,318,1111,321,599,191,419,236,150,33,473,279,194,28,28,179,85,94
"2021","Cardiff 006","W02000372",3337,767,388,379,2465,434,1353,371,766,216,346,187,137,22,328,212,116,4,4,105,52,53
"2021","Cardiff 007","W02000373",2877,858,330,528,1833,182,722,228,320,174,289,113,141,35,620,460,160,20,20,186,100,86
"2021","Cardiff 008","W02000374",2298,527,368,159,1649,391,915,209,509,197,141,60,70,11,195,109,86,7,7,122,76,46
"2021","Cardiff 009","W02000375",2855,789,268,521,1872,192,726,194,406,126,317,133,166,18,621,431,190,16,16,194,97,97
"2021","Cardiff 010","W02000376",2973,1034,479,555,1822,241,931,296,465,170,306,157,130,19,335,212,123,9,9,117,42,75
"2021","Cardiff 011","W02000377",3194,913,285,628,2129,174,994,337,477,180,462,264,174,24,481,349,132,18,18,152,61,91
"2021","Cardiff 012","W02000378",3143,878,528,350,2132,386,1198,354,653,191,290,171,103,16,243,134,109,15,15,133,50,83
"2021","Cardiff 013","W02000379",2588,782,251,531,1686,104,566,150,294,122,292,118,141,33,698,533,165,26,26,120,69,51
"2021","Cardiff 014","W02000380",3243,709,359,350,2419,492,1288,418,597,273,362,198,134,30,268,181,87,9,9,115,42,73
"2021","Cardiff 015","W02000381",2812,864,398,466,1784,167,707,239,314,154,344,153,153,38,538,395,143,28,28,164,82,82
"2021","Cardiff 016","W02000382",2432,832,283,549,1446,141,502,129,225,148,236,103,108,25,533,374,159,34,34,154,90,64
"2021","Cardiff 017","W02000383",3114,1033,420,613,1926,230,763,180,401,182,308,110,157,41,614,421,193,11,11,155,81,74
"2021","Cardiff 018","W02000384",2311,537,290,247,1674,301,974,295,488,191,246,142,95,9,140,68,72,13,13,100,29,71
"2021","Cardiff 019","W02000385",2432,646,365,281,1671,306,1020,249,594,177,158,71,77,10,178,105,73,9,9,115,51,64
"2021","Cardiff 020","W02000386",3253,972,546,426,2169,431,1201,365,595,241,274,143,105,26,245,125,120,18,18,112,46,66
"2021","Cardiff 021","W02000387",2419,673,333,340,1630,285,842,266,424,152,270,160,94,16,218,122,96,15,15,116,42,74
"2021","Cardiff 022","W02000388",2398,640,341,299,1602,255,779,275,315,189,253,118,111,24,300,171,129,15,15,156,73,83
"2021","Cardiff 023","W02000389",3477,1039,434,605,2187,217,993,300,495,198,405,214,168,23,548,337,211,24,24,251,118,133
"2021","Cardiff 024","W02000390",2357,660,435,225,1576,358,859,237,437,185,182,119,59,4,177,86,91,0,0,121,52,69
"2021","Cardiff 025","W02000391",2511,652,176,476,1301,107,634,199,352,83,313,234,65,14,215,122,93,32,32,558,54,504
"2021","Cardiff 026","W02000392",3758,1266,666,600,2356,434,1272,394,621,257,386,246,130,10,253,137,116,11,11,136,43,93
"2021","Cardiff 027","W02000393",2965,1035,374,661,1788,144,687,200,317,170,373,200,151,22,564,430,134,20,20,142,70,72
"2021","Cardiff 028","W02000394",2912,654,139,515,843,51,320,108,164,48,293,237,52,4,111,69,42,68,68,1415,49,1366
"2021","Cardiff 029","W02000395",2916,992,327,665,1716,187,896,277,508,111,367,260,94,13,250,158,92,16,16,208,65,143
"2021","Cardiff 030","W02000396",2922,921,193,728,1291,61,516,160,283,73,476,380,88,8,195,111,84,43,43,710,89,621
"2021","Cardiff 031","W02000397",2912,1119,491,628,1667,203,756,253,332,171,294,161,113,20,403,232,171,11,11,126,61,65
"2021","Cardiff 032","W02000398",3258,1162,126,1036,802,37,280,128,124,28,284,266,18,0,87,50,37,114,114,1294,29,1265
"2021","Cardiff 033","W02000399",4801,2064,322,1742,1824,76,647,260,314,73,694,619,65,10,285,168,117,122,122,913,67,846
"2021","Cardiff 034","W02000400",3153,1327,320,1007,1567,129,733,289,360,84,516,421,81,14,171,101,70,18,18,259,37,222
"2021","Cardiff 035","W02000401",2689,946,371,575,1599,175,780,232,423,125,415,276,121,18,218,134,84,11,11,144,36,108
"2021","Cardiff 036","W02000402",4111,1642,287,1355,1869,40,769,213,471,85,510,384,113,13,464,311,153,86,86,600,124,476
"2021","Cardiff 037","W02000403",3250,1011,247,764,1976,90,739,242,364,133,440,219,192,29,658,483,175,49,49,263,92,171
"2021","Cardiff 038","W02000404",2866,1114,292,822,1464,70,534,189,234,111,408,271,119,18,405,277,128,47,47,288,77,211
"2021","Cardiff 039","W02000405",2990,798,307,491,2020,107,578,134,309,135,325,92,187,46,978,741,237,32,32,172,93,79
"2021","Cardiff 040","W02000406",4406,1507,335,1172,2529,175,1065,337,573,155,732,491,221,20,519,378,141,38,38,370,126,244
"2021","Cardiff 041","W02000407",2673,817,354,463,1708,157,606,205,270,131,276,107,141,28,641,476,165,28,28,148,73,75
"2021","Cardiff 042","W02000408",3018,1219,251,968,1461,42,672,167,422,83,334,252,74,8,367,249,118,46,46,338,132,206
"2021","Cardiff 043","W02000409",2591,750,369,381,1673,199,619,211,248,160,289,114,151,24,551,421,130,15,15,168,55,113
"2021","Cardiff 044","W02000410",3072,940,206,734,1740,90,849,210,510,129,356,243,98,15,406,269,137,39,39,392,167,225
"2021","Cardiff 045","W02000411",2739,863,290,573,1718,140,633,206,258,169,347,134,179,34,580,387,193,18,18,158,84,74
"2021","Cardiff 046","W02000412",2768,943,294,649,1575,105,698,185,385,128,342,208,116,18,409,259,150,21,21,250,101,149
"2021","Cardiff 048","W02000422",4218,1948,157,1791,1847,97,651,342,266,43,838,766,67,5,187,141,46,74,74,423,28,395
"2021","Cardiff 049","W02000423",4212,1764,341,1423,1981,85,710,250,384,76,703,609,79,15,400,225,175,83,83,467,106,361
"2021","Rhondda Cynon Taf 001","W02000252",3919,1120,550,570,2643,481,1065,438,366,261,446,148,241,57,627,422,205,24,24,156,91,65
"2021","Rhondda Cynon Taf 002","W02000253",3050,1031,407,624,1926,262,827,311,319,197,396,197,165,34,429,246,183,12,12,93,41,52
"2021","Rhondda Cynon Taf 003","W02000254",3523,1123,491,632,2287,378,1019,380,404,235,455,194,239,22,415,262,153,20,20,113,59,54
"2021","Rhondda Cynon Taf 004","W02000255",3061,942,414,528,2000,335,954,367,370,217,343,158,161,24,364,243,121,4,4,119,56,63
"2021","Rhondda Cynon Taf 005","W02000256",4494,1506,646,860,2802,360,1103,430,403,270,620,250,322,48,705,482,223,14,14,186,85,101
"2021","Rhondda Cynon Taf 006","W02000257",3304,1125,490,635,2068,297,845,334,299,212,414,191,192,31,495,325,170,17,17,111,56,55
"2021","Rhondda Cynon Taf 007","W02000258",2626,1018,442,576,1511,203,636,248,235,153,292,114,147,31,366,225,141,14,14,97,51,46
"2021","Rhondda Cynon Taf 008","W02000259",2429,729,280,449,1601,192,617,243,216,158,315,117,171,27,464,332,132,13,13,99,45,54
"2021","Rhondda Cynon Taf 009","W02000260",2598,929,447,482,1572,257,610,213,210,187,296,107,158,31,388,244,144,21,21,97,47,50
"2021","Rhondda Cynon Taf 010","W02000261",3386,1087,508,579,2161,335,917,363,329,225,428,197,196,35,465,301,164,16,16,138,68,70
"2021","Rhondda Cynon Taf 011","W02000262",2367,819,341,478,1481,223,602,234,229,139,310,122,163,25,340,230,110,6,6,67,31,36
"2021","Rhondda Cynon Taf 012","W02000263",2750,847,355,492,1799,218,731,264,269,198,356,133,190,33,487,317,170,7,7,104,59,45
"2021","Rhondda Cynon Taf 013","W02000264",2576,921,356,565,1539,178,566,239,174,153,331,120,180,31,449,314,135,15,15,116,71,45
"2021","Rhondda Cynon Taf 014","W02000265",4016,1243,533,710,2586,370,1013,379,376,258,510,204,257,49,658,458,200,35,35,187,83,104
"2021","Rhondda Cynon Taf 015","W02000266",3254,980,414,566,2145,256,950,369,335,246,390,142,209,39,501,347,154,48,48,129,69,60
"2021","Rhondda Cynon Taf 016","W02000267",2783,893,410,483,1788,237,691,249,258,184,392,153,202,37,443,312,131,25,25,102,47,55
"2021","Rhondda Cynon Taf 017","W02000268",4072,1442,620,822,2483,347,1067,423,350,294,525,219,266,40,525,352,173,19,19,147,58,89
"2021","Rhondda Cynon Taf 018","W02000269",3563,1169,537,632,2229,291,954,353,344,257,455,177,241,37,506,302,204,23,23,165,96,69
"2021","Rhondda Cynon Taf 019","W02000270",2959,962,382,580,1868,260,849,347,341,161,407,212,177,18,338,211,127,14,14,129,57,72
"2021","Rhondda Cynon Taf 020","W02000271",2476,863,354,509,1524,205,612,245,223,144,319,127,163,29,368,235,133,20,20,89,35,54
"2021","Rhondda Cynon Taf 021","W02000272",4432,1456,602,854,2787,402,1215,465,491,259,626,315,250,61,519,316,203,25,25,189,81,108
"2021","Rhondda Cynon Taf 022","W02000273",4039,1244,407,837,2205,233,821,276,359,186,504,255,215,34,591,389,202,56,56,590,102,488
"2021","Rhondda Cynon Taf 023","W02000274",4156,1075,488,587,2879,338,1370,468,587,315,569,250,265,54,582,357,225,20,20,202,112,90
"2021","Rhondda Cynon Taf 024","W02000275",2657,817,387,430,1736,280,739,265,284,190,326,144,154,28,369,231,138,22,22,104,55,49
"2021","Rhondda Cynon Taf 025","W02000276",2830,819,471,348,1922,413,824,245,397,182,359,155,186,18,319,198,121,7,7,89,36,53
"2021","Rhondda Cynon Taf 026","W02000277",3189,1124,458,666,1940,276,861,341,327,193,410,216,158,36,378,210,168,15,15,125,60,65
"2021","Rhondda Cynon Taf 027","W02000278",3634,834,406,428,2694,397,1503,487,737,279,471,239,198,34,317,187,130,6,6,106,44,62
"2021","Rhondda Cynon Taf 028","W02000279",3278,895,405,490,2239,287,1031,383,420,228,465,203,226,36,433,284,149,23,23,144,55,89
"2021","Rhondda Cynon Taf 029","W02000280",3881,933,373,560,2775,342,1426,466,720,240,606,312,264,30,396,261,135,5,5,173,93,80
"2021","Rhondda Cynon Taf 030","W02000281",3265,1006,500,506,2144,392,1079,377,488,214,354,182,152,20,304,187,117,15,15,115,46,69
"2021","Rhondda Cynon Taf 031","W02000282",4758,1224,577,647,3351,505,1761,529,935,297,586,318,240,28,478,322,156,21,21,183,84,99
"2021","Caerphilly 001","W02000290",3885,1300,576,724,2443,315,928,355,307,266,490,182,254,54,681,389,292,29,29,142,68,74
"2021","Caerphilly 002","W02000291",3110,1043,455,588,1914,256,786,298,265,223,394,122,237,35,461,296,165,17,17,153,72,81
"2021","Caerphilly 003","W02000292",2524,772,361,411,1657,228,658,246,253,159,328,127,172,29,429,287,142,14,14,95,50,45
"2021","Caerphilly 004","W02000293",2674,885,374,511,1683,210,665,266,223,176,327,114,181,32,471,309,162,10,10,106,45,61
"2021","Caerphilly 005","W02000294",2419,673,334,339,1634,307,753,302,264,187,290,135,132,23,274,179,95,10,10,112,42,70
"2021","Caerphilly 006","W02000295",3929,1005,468,537,2796,424,1355,464,579,312,508,221,247,40,498,318,180,11,11,128,63,65
"2021","Caerphilly 007","W02000296",3237,1026,502,524,2076,320,884,321,340,223,376,152,181,43,483,294,189,13,13,135,84,51
"2021","Caerphilly 008","W02000297",3248,946,422,524,2155,322,1024,397,375,252,388,157,206,25,402,259,143,19,19,147,74,73
"2021","Caerphilly 009","W02000298",3021,800,398,402,2115,338,953,309,424,220,422,193,204,25,388,233,155,14,14,106,51,55
"2021","Caerphilly 010","W02000299",2721,823,403,420,1798,320,798,306,314,178,325,138,163,24,342,202,140,13,13,100,53,47
"2021","Caerphilly 011","W02000300",3594,1038,532,506,2420,410,1072,388,435,249,480,205,221,54,446,283,163,12,12,136,66,70
"2021","Caerphilly 012","W02000301",3264,827,370,457,2298,266,1099,397,453,249,482,214,222,46,426,278,148,25,25,139,64,75
"2021","Caerphilly 013","W02000302",4317,1326,645,681,2826,466,1336,480,590,266,518,237,240,41,488,283,205,18,18,165,84,81
"2021","Caerphilly 014","W02000303",3123,958,388,570,2050,278,940,355,377,208,449,226,186,37,372,238,134,11,11,115,59,56
"2021","Caerphilly 015","W02000304",2424,794,359,435,1526,202,735,270,293,172,325,147,153,25,255,157,98,9,9,104,50,54
"2021","Caerphilly 016","W02000305",2742,878,378,500,1750,255,778,299,290,189,322,150,149,23,375,231,144,20,20,114,56,58
"2021","Caerphilly 017","W02000306",2364,856,397,459,1417,199,652,249,250,153,274,141,111,22,282,173,109,10,10,91,50,41
"2021","Caerphilly 018","W02000307",2775,867,319,548,1809,204,719,262,286,171,399,171,195,33,474,335,139,13,13,99,53,46
"2021","Caerphilly 019","W02000308",3780,1135,503,632,2477,335,1100,416,431,253,453,208,213,32,568,359,209,21,21,168,91,77
"2021","Caerphilly 020","W02000309",2902,868,440,428,1897,307,911,319,371,221,309,144,140,25,355,225,130,15,15,137,66,71
"2021","Caerphilly 021","W02000310",2246,614,261,353,1544,228,726,280,316,130,266,125,122,19,312,209,103,12,12,88,49,39
"2021","Caerphilly 022","W02000311",4358,1363,563,800,2845,445,1160,436,476,248,508,245,228,35,708,464,244,24,24,150,67,83
"2021","Caerphilly 023","W02000312",3135,923,510,413,2079,350,941,364,377,200,367,150,187,30,407,233,174,14,14,133,64,69
"2021","Caerphilly 024","W02000313",4465,1243,552,691,3072,438,1596,523,780,293,596,314,257,25,433,278,155,9,9,150,63,87
"2021","Blaenau Gwent 001","W02000314",2930,872,412,460,1932,330,811,335,273,203,338,137,177,24,440,275,165,13,13,126,66,60
"2021","Blaenau Gwent 002","W02000315",2424,916,357,559,1433,200,615,235,213,167,288,120,142,26,311,202,109,19,19,75,41,34
"2021","Blaenau Gwent 003","W02000316",2936,871,427,444,1954,285,837,325,296,216,351,116,191,44,460,262,198,21,21,111,47,64
"2021","Blaenau Gwent 004","W02000317",3442,1051,483,568,2256,318,939,349,316,274,448,185,230,33,535,326,209,16,16,135,71,64
"2021","Blaenau Gwent 005","W02000318",4028,1268,581,687,2632,360,1136,454,431,251,524,205,259,60,588,352,236,24,24,128,62,66
"2021","Blaenau Gwent 006","W02000319",3813,1428,558,870,2275,296,936,354,356,226,492,223,235,34,527,342,185,24,24,110,53,57
"2021","Blaenau Gwent 007","W02000320",3704,1269,512,757,2307,287,958,369,342,247,536,239,245,52,506,339,167,20,20,128,64,64
"2021","Blaenau Gwent 008","W02000321",3912,1361,589,772,2414,292,1086,402,396,288,471,200,225,46,545,341,204,20,20,137,74,63
"2021","Blaenau Gwent 009","W02000322",3153,1139,442,697,1913,243,765,307,266,192,423,217,175,31,460,276,184,22,22,101,41,60
"2021","Torfaen 001","W02000323",2692,919,405,514,1691,226,691,254,295,142,389,183,190,16,377,264,113,8,8,82,40,42
"2021","Torfaen 002","W02000324",2976,847,416,431,1979,247,829,313,321,195,432,176,218,38,457,298,159,14,14,150,70,80
"2021","Torfaen 003","W02000325",3063,884,360,524,2053,232,809,295,317,197,440,162,238,40,548,388,160,24,24,126,61,65
"2021","Torfaen 004","W02000326",3993,1382,576,806,2431,368,1029,382,399,248,500,232,229,39,517,342,175,17,17,180,84,96
"2021","Torfaen 005","W02000327",2689,785,465,320,1825,469,831,324,320,187,260,133,96,31,258,153,105,7,7,79,40,39
"2021","Torfaen 006","W02000328",3258,964,422,542,2197,359,1064,390,444,230,402,215,162,25,357,219,138,15,15,97,50,47
"2021","Torfaen 007","W02000329",3531,1091,471,620,2276,283,1024,365,419,240,464,241,189,34,485,311,174,20,20,164,68,96
"2021","Torfaen 008","W02000330",3247,1089,645,444,2042,388,926,361,353,212,348,162,166,20,366,221,145,14,14,116,49,67
"2021","Torfaen 009","W02000331",2653,750,305,445,1777,175,687,245,280,162,383,140,206,37,509,346,163,23,23,126,61,65
"2021","Torfaen 010","W02000332",3480,1312,561,751,2022,235,834,305,349,180,438,201,210,27,489,327,162,26,26,146,61,85
"2021","Torfaen 011","W02000333",2620,705,308,397,1805,279,858,316,343,199,308,136,144,28,348,229,119,12,12,110,54,56
"2021","Torfaen 012","W02000334",2810,716,338,378,1984,352,1023,418,386,219,301,137,145,19,303,183,120,5,5,110,54,56
"2021","Torfaen 013","W02000335",3216,876,427,449,2196,390,1118,414,450,254,394,193,174,27,287,172,115,7,7,144,58,86
"2021","Monmouthshire 001","W02000336",4003,1429,751,678,2395,595,1138,490,427,221,350,206,122,22,295,170,125,17,17,179,64,115
"2021","Monmouthshire 002","W02000337",3518,1275,676,599,2121,340,884,323,386,175,357,156,170,31,528,354,174,12,12,122,49,73
"2021","Monmouthshire 003","W02000338",3709,1032,594,438,2549,570,1252,508,495,249,394,192,171,31,318,194,124,15,15,128,46,82
"2021","Monmouthshire 004","W02000339",5012,1771,963,808,3081,642,1432,526,623,283,474,246,206,22,512,328,184,21,21,160,68,92
"2021","Monmouthshire 005","W02000340",3030,732,447,285,2146,536,1135,489,398,248,259,155,91,13,200,106,94,16,16,152,71,81
"2021","Monmouthshire 006","W02000341",3556,1012,623,389,2390,608,1242,530,441,271,311,187,109,15,222,122,100,7,7,154,62,92
"2021","Monmouthshire 007","W02000342",3927,918,523,395,2838,662,1573,652,646,275,358,195,144,19,240,132,108,5,5,171,72,99
"2021","Monmouthshire 008","W02000343",3837,1421,575,846,2255,303,975,391,388,196,467,276,168,23,490,306,184,20,20,161,74,87
"2021","Monmouthshire 009","W02000344",3570,845,455,390,2575,545,1404,549,597,258,383,229,133,21,231,118,113,12,12,150,65,85
"2021","Monmouthshire 010","W02000345",3514,1056,548,508,2302,421,996,367,402,227,403,182,190,31,462,290,172,20,20,156,69,87
"2021","Monmouthshire 011","W02000346",3248,798,381,417,2341,360,1327,483,575,269,370,212,148,10,276,162,114,8,8,109,52,57
"2021","Newport 001","W02000347",3524,1076,582,494,2329,454,1176,419,512,245,330,185,114,31,355,225,130,14,14,119,52,67
"2021","Newport 002","W02000348",3283,923,506,417,2215,440,962,337,390,235,369,157,175,37,423,238,185,21,21,145,78,67
"2021","Newport 003","W02000349",3453,1060,462,598,2185,250,771,241,320,210,436,158,242,36,690,460,230,38,38,208,121,87
"2021","Newport 004","W02000350",4022,891,399,492,2922,417,1577,612,693,272,550,316,209,25,349,216,133,29,29,209,84,125
"2021","Newport 005","W02000351",2697,889,419,470,1696,240,732,228,345,159,332,140,167,25,380,253,127,12,12,112,54,58
"2021","Newport 006","W02000352",2964,1016,372,644,1804,149,748,293,314,141,373,202,149,22,508,338,170,26,26,144,65,79
"2021","Newport 007","W02000353",3099,971,350,621,1933,203,892,291,407,194,418,222,178,18,406,262,144,14,14,195,81,114
"2021","Newport 008","W02000354",2577,868,512,356,1585,256,747,261,304,182,269,141,106,22,312,168,144,1,1,124,55,69
"2021","Newport 009","W02000355",4017,871,487,384,3002,465,1677,494,869,314,505,255,226,24,343,221,122,12,12,144,77,67
"2021","Newport 010","W02000356",2119,673,318,355,1295,119,513,159,236,118,253,80,140,33,393,265,128,17,17,151,96,55
"2021","Newport 011","W02000357",3329,1062,387,675,2002,182,931,276,427,228,503,290,166,47,358,243,115,28,28,265,146,119
"2021","Newport 012","W02000358",2678,727,393,334,1800,354,965,332,467,166,285,161,105,19,181,92,89,15,15,151,49,102
"2021","Newport 013","W02000359",4619,1399,295,1104,2816,169,1191,374,634,183,690,364,287,39,693,454,239,73,73,404,255,149
"2021","Newport 014","W02000360",3143,1444,509,935,1439,120,643,261,284,98,389,254,112,23,252,162,90,35,35,260,91,169
"2021","Newport 015","W02000361",4706,1230,478,752,3161,384,1238,433,531,274,638,276,272,90,842,581,261,59,59,315,167,148
"2021","Newport 016","W02000362",3016,888,451,437,2026,303,1056,322,537,197,348,203,133,12,306,199,107,13,13,102,56,46
"2021","Newport 017","W02000363",2603,943,485,458,1561,257,677,257,269,151,325,126,154,45,296,165,131,6,6,99,43,56
"2021","Newport 018","W02000364",3419,1202,357,845,1910,85,942,267,547,128,351,193,135,23,497,320,177,35,35,307,177,130
"2021","Newport 019","W02000365",3452,1044,417,627,2239,184,970,320,458,192,461,203,229,29,604,423,181,20,20,169,94,75
"2021","Newport 020","W02000366",3326,820,314,506,2336,296,1396,433,720,243,368,221,129,18,265,161,104,11,11,170,88,82
"2021","Powys 001","W02000097",4054,1195,701,494,2656,607,1302,572,476,254,443,223,186,34,292,164,128,12,12,203,86,117
"2021","Powys 002","W02000098",2735,759,451,308,1868,407,966,399,380,187,307,168,115,24,178,95,83,10,10,108,35,73
"2021","Powys 003","W02000099",3045,1150,531,619,1737,286,667,273,241,153,410,192,194,24,354,230,124,20,20,158,54,104
"2021","Powys 004","W02000100",2809,911,469,442,1781,380,844,363,310,171,341,167,153,21,206,106,100,10,10,117,34,83
"2021","Powys 005","W02000101",2465,727,404,323,1635,390,786,346,299,141,288,155,118,15,159,95,64,12,12,103,35,68
"2021","Powys 006","W02000102",2687,763,408,355,1814,401,915,384,353,178,302,163,120,19,184,91,93,12,12,110,34,76
"2021","Powys 007","W02000103",2471,651,391,260,1710,388,888,391,322,175,292,146,132,14,135,70,65,7,7,110,43,67
"2021","Powys 008","W02000104",3006,1223,518,705,1669,325,733,306,280,147,344,179,150,15,249,156,93,18,18,114,37,77
"2021","Powys 009","W02000105",2147,696,248,448,1354,129,527,184,252,91,307,111,175,21,376,240,136,15,15,97,49,48
"2021","Powys 010","W02000106",3005,1046,556,490,1829,408,875,410,283,182,339,180,146,13,197,114,83,10,10,130,58,72
"2021","Powys 011","W02000107",4508,1446,833,613,2871,757,1317,619,443,255,460,243,189,28,310,149,161,27,27,191,69,122
"2021","Powys 012","W02000108",3310,1066,633,433,2095,551,950,464,312,174,346,174,152,20,236,134,102,12,12,149,68,81
"2021","Powys 013","W02000109",2797,1211,557,654,1501,319,621,294,229,98,311,170,125,16,239,154,85,11,11,85,28,57
"2021","Powys 014","W02000110",3148,1045,547,498,1987,445,952,435,345,172,331,177,128,26,245,142,103,14,14,116,43,73
"2021","Powys 015","W02000111",3956,1380,777,603,2428,539,1083,478,402,203,451,239,185,27,341,180,161,14,14,148,44,104
"2021","Powys 017","W02000113",3717,1413,720,693,2163,412,946,368,392,186,399,203,172,24,391,257,134,15,15,141,47,94
"2021","Powys 018","W02000114",3075,873,538,335,2072,548,1045,443,385,217,253,138,99,16,213,100,113,13,13,130,64,66
"2021","Powys 020","W02000414",2616,701,362,339,1786,393,973,460,315,198,247,136,96,15,163,71,92,10,10,129,62,67
"2021","Powys 021","W02000416",4631,1583,824,759,2882,538,1362,537,497,328,474,208,225,41,490,295,195,18,18,166,67,99
"2021","Merthyr Tydfil 002","W02000284",4232,1377,571,806,2694,339,1092,416,390,286,542,223,268,51,668,456,212,53,53,161,81,80
"2021","Merthyr Tydfil 003","W02000285",3525,1006,462,544,2374,387,1199,433,494,272,372,177,171,24,389,242,147,27,27,145,79,66
"2021","Merthyr Tydfil 004","W02000286",3267,1397,489,908,1764,200,716,259,302,155,318,142,146,30,498,357,141,32,32,106,52,54
"2021","Merthyr Tydfil 005","W02000287",3652,1182,520,662,2334,309,1092,379,441,272,449,185,234,30,460,294,166,24,24,136,71,65
"2021","Merthyr Tydfil 006","W02000288",3603,1245,548,697,2221,299,900,339,291,270,492,206,252,34,500,306,194,30,30,137,79,58
"2021","Merthyr Tydfil 007","W02000289",3703,1009,447,562,2542,349,1213,487,456,270,495,214,241,40,467,294,173,18,18,152,77,75
"2021","Merthyr Tydfil 008","W02000415",3805,1042,427,615,2554,257,941,323,356,262,415,109,260,46,868,598,270,73,73,209,121,88
