"date","geography","geography code","Household composition: Total; measures: Value","Household composition: One person household; measures: Value","Household composition: One person household: Aged 66 years and over; measures: Value","Household composition: One person household: Other; measures: Value","Household composition: Single family household; measures: Value","Household composition: Single family household: All aged 66 years and over; measures: Value","Household composition: Single family household: Married or civil partnership couple; measures: Value","Household composition: Single family household: Married or civil partnership couple: No children; measures: Value","Household composition: Single family household: Married or civil partnership couple: Dependent children; measures: Value","Household composition: Single family household: Married or civil partnership couple: All children non-dependent; measures: Value","Household composition: Single family household: Cohabiting couple family; measures: Value","Household composition: Single family household: Cohabiting couple family: No children; measures: Value","Household composition: Single family household: Cohabiting couple family: With dependent children; measures: Value","Household composition: Single family household: Cohabiting couple family: All children non-dependent; measures: Value","Household composition: Single family household: Lone parent family; measures: Value","Household composition: Single family household: Lone parent family: With dependent children; measures: Value","Household composition: Single family household: Lone parent family: All children non-dependent; measures: Value","Household composition: Single family household: Other single family household; measures: Value","Household composition: Single family household: Other single family household: Other family composition; measures: Value","Household composition: Other household types; measures: Value","Household composition: Other household types: With dependent children; measures: Value","Household composition: Other household types: Other, including all full-time students and all aged 66 years and over; measures: Value"
"2021","Hartlepool","E06000001",40930,13616,5647,7969,25845,3669,11290,4501,4275,2514,5067,2236,2432,399,5628,3886,1742,191,191,1469,687,782
"2021","Middlesbrough","E06000002",60261,19964,7739,12225,36756,4496,15641,5343,7052,3246,6837,3073,3197,567,9166,6236,2930,616,616,3541,1549,1992
"2021","Redcar and Cleveland","E06000003",61640,20663,9739,10924,39003,6861,16823,6862,6252,3709,7239,3224,3403,612,7803,5170,2633,277,277,1974,965,1009
"2021","Stockton-on-Tees","E06000004",83756,25980,10812,15168,54449,7855,25861,9359,11570,4932,10203,4959,4570,674,10107,6697,3410,423,423,3327,1656,1671
"2021","Darlington","E06000005",48915,16714,6851,9863,30395,4604,13879,5643,5802,2434,5907,3092,2451,364,5757,3901,1856,248,248,1806,790,1016
"2021","County Durham","E06000047",234761,79529,34150,45379,146599,23721,66560,27844,25415,13301,27230,13657,11701,1872,27992,18904,9088,1096,1096,8633,3168,5465
"2021","Northumberland","E06000057",146922,48149,22951,25198,94740,18716,45170,19891,16759,8520,15437,8041,6377,1019,14850,9513,5337,567,567,4033,1763,2270
"2021","Newcastle upon Tyne","E08000021",122798,42031,14915,27116,69671,8122,31769,10514,15536,5719,14384,8660,4887,837,14226,9142,5084,1170,1170,11096,2426,8670
"2021","North Tyneside","E08000022",96233,33554,14272,19282,59785,8832,27784,10478,12261,5045,11577,6343,4550,684,11144,7366,3778,448,448,2894,1250,1644
"2021","South Tyneside","E08000023",68285,24550,10484,14066,41694,5980,18102,6876,7191,4035,7594,3648,3331,615,9660,6370,3290,358,358,2041,935,1106
"2021","Sunderland","E08000024",122178,40369,17539,22830,77376,11435,34151,13131,13205,7815,14832,6902,6666,1264,16240,10431,5809,718,718,4433,2158,2275
"2021","Gateshead","E08000037",88998,30807,12734,18073,54804,8105,24298,9065,10307,4926,10993,6217,3975,801,10842,6697,4145,566,566,3387,1340,2047
"2021","Halton","E06000006",55949,17702,7155,10547,35989,4776,15944,5777,6560,3607,7049,3266,3223,560,7863,5147,2716,357,357,2258,1083,1175
"2021","Warrington","E06000007",90538,27364,11444,15920,59467,8742,29538,10366,13494,5678,11000,5695,4612,693,9677,6154,3523,510,510,3707,1523,2184
"2021","Blackburn with Darwen","E06000008",58767,17578,6674,10904,37055,3943,18688,5252,9908,3528,6149,2666,2987,496,7826,5137,2689,449,449,4134,2548,1586
"2021","Blackpool","E06000009",64789,24588,9798,14790,36337,4969,14102,5915,5266,2921,7876,3805,3485,586,8885,5799,3086,505,505,3864,1523,2341
"2021","Cheshire East","E06000049",174857,53137,24817,28320,115112,20739,57228,21429,25816,9983,20642,11492,8079,1071,15655,9708,5947,848,848,6608,2553,4055
"2021","Cheshire West and Chester","E06000050",155156,46889,21284,25605,101371,16807,49139,18200,21615,9324,18970,10308,7489,1173,15643,9590,6053,812,812,6896,2324,4572
"2021","Allerdale","E07000026",43969,14674,6886,7788,27982,5397,13330,5684,4991,2655,4835,2477,2047,311,4258,2705,1553,162,162,1313,571,742
"2021","Barrow-in-Furness","E07000027",31259,11308,4687,6621,19003,3089,8490,3428,3300,1762,3809,1775,1801,233,3485,2177,1308,130,130,948,412,536
"2021","Carlisle","E07000028",50663,17780,7388,10392,31099,5177,14647,6095,5870,2682,6049,3246,2492,311,5008,3228,1780,218,218,1784,634,1150
"2021","Copeland","E07000029",30789,10565,4600,5965,19287,3433,9324,4051,3384,1889,3273,1635,1441,197,3132,1957,1175,125,125,937,419,518
"2021","Eden","E07000030",24615,7618,3863,3755,16043,3414,8187,3645,2961,1581,2651,1516,989,146,1694,932,762,97,97,954,391,563
"2021","South Lakeland","E07000031",47656,15487,8267,7220,30283,6978,14915,6713,5519,2683,4986,2937,1785,264,3246,1879,1367,158,158,1886,548,1338
"2021","Burnley","E07000117",39868,13125,5221,7904,24408,3279,10779,3893,4870,2016,4765,2167,2227,371,5282,3574,1708,303,303,2335,1152,1183
"2021","Chorley","E07000118",50132,14660,6285,8375,33664,5608,16383,5911,7503,2969,6357,3321,2643,393,5144,3288,1856,172,172,1808,776,1032
"2021","Fylde","E07000119",37601,12863,6552,6311,23342,5055,11123,4817,4279,2027,3791,2127,1447,217,3248,1972,1276,125,125,1396,550,846
"2021","Hyndburn","E07000120",34789,11432,4691,6741,21614,2952,9523,3465,4178,1880,4377,1993,2038,346,4508,3056,1452,254,254,1743,918,825
"2021","Lancaster","E07000121",59980,19526,8913,10613,36440,6200,17083,6914,7197,2972,6972,3781,2765,426,5883,3806,2077,302,302,4014,1057,2957
"2021","Pendle","E07000122",38068,11824,5139,6685,23610,3379,11592,4052,5643,1897,4303,2067,1890,346,4103,2660,1443,233,233,2634,1599,1035
"2021","Preston","E07000123",59610,19400,6671,12729,36018,3968,17502,5608,8712,3182,6778,3529,2852,397,7188,4797,2391,582,582,4192,1688,2504
"2021","Ribble Valley","E07000124",26746,7807,4001,3806,18046,3497,9436,3696,3979,1761,2927,1556,1165,206,2076,1245,831,110,110,893,378,515
"2021","Rossendale","E07000125",30561,9708,4091,5617,19525,2701,9147,3447,4007,1693,4138,1967,1904,267,3399,2225,1174,140,140,1328,677,651
"2021","South Ribble","E07000126",48587,14496,6865,7631,32324,5444,15605,5907,6631,3067,5975,3033,2590,352,5091,3131,1960,209,209,1767,792,975
"2021","West Lancashire","E07000127",48531,13989,6858,7131,31844,5695,15235,5521,6307,3407,5369,2577,2422,370,5248,3138,2110,297,297,2698,959,1739
"2021","Wyre","E07000128",50767,16346,8831,7515,32393,7138,14733,6334,5536,2863,5260,2622,2288,350,5059,3087,1972,203,203,2028,833,1195
"2021","Bolton","E08000001",118790,36521,15389,21132,75404,10058,36432,11114,18079,7239,13121,5927,6194,1000,14984,9492,5492,809,809,6865,3988,2877
"2021","Bury","E08000002",80697,24880,10646,14234,51769,7288,24861,7946,12192,4723,9493,4803,4001,689,9626,6057,3569,501,501,4048,1997,2051
"2021","Manchester","E08000003",214734,71577,18712,52865,115845,6339,48691,13055,28116,7520,26033,16569,8075,1389,30969,20225,10744,3813,3813,27312,8270,19042
"2021","Oldham","E08000004",93140,27397,11748,15649,59577,7361,28091,8251,14386,5454,10048,4296,4885,867,13381,8716,4665,696,696,6166,3856,2310
"2021","Rochdale","E08000005",90223,27641,11285,16356,57288,6855,26169,8169,12797,5203,10481,4677,4932,872,13052,8761,4291,731,731,5294,3119,2175
"2021","Salford","E08000006",115116,39141,12380,26761,66173,6293,26973,8749,13197,5027,16726,10038,5711,977,14717,9794,4923,1464,1464,9802,2732,7070
"2021","Stockport","E08000007",126648,39439,17805,21634,81576,12336,39505,12472,19338,7695,15111,8102,6071,938,13922,8684,5238,702,702,5633,2526,3107
"2021","Tameside","E08000008",99527,32374,13013,19361,62359,7645,26957,9321,11912,5724,13323,6215,6055,1053,13782,9030,4752,652,652,4794,2496,2298
"2021","Trafford","E08000009",96269,28369,12764,15605,63004,8205,33446,8869,18808,5769,10308,5722,3939,647,10459,6339,4120,586,586,4896,2248,2648
"2021","Wigan","E08000010",143102,43950,18692,25258,93548,13595,42255,15164,18150,8941,19897,9350,9126,1421,17050,10503,6547,751,751,5604,2688,2916
"2021","Knowsley","E08000011",66072,20645,8184,12461,42190,4424,17070,5553,6815,4702,8421,3657,3955,809,11704,7307,4397,571,571,3237,1710,1527
"2021","Liverpool","E08000012",207491,76340,25627,50713,115071,11377,46296,14138,21030,11128,23527,12968,8775,1784,31304,18917,12387,2567,2567,16080,4903,11177
"2021","St. Helens","E08000013",81010,25561,11243,14318,52331,7909,23101,8283,9523,5295,10316,5073,4438,805,10491,6478,4013,514,514,3118,1457,1661
"2021","Sefton","E08000014",123072,41520,19873,21647,75742,12775,34010,11612,13935,8463,12900,6130,5748,1022,15301,8700,6601,756,756,5810,2556,3254
"2021","Wirral","E08000015",143255,49689,22478,27211,87738,13828,38951,13475,16789,8687,14998,7323,6603,1072,19152,12082,7070,809,809,5828,2635,3193
"2021","Kingston upon Hull, City of","E06000010",115472,39446,13982,25464,69264,7294,27650,10551,11915,5184,17924,8421,8224,1279,15491,10460,5031,905,905,6762,2529,4233
"2021","East Riding of Yorkshire","E06000011",152063,45678,24320,21358,101052,21531,48983,21298,19102,8583,17249,9152,7073,1024,12765,7934,4831,524,524,5333,2292,3041
"2021","North East Lincolnshire","E06000012",69826,22718,10030,12688,44064,6979,18959,8112,7128,3719,9080,4129,4326,625,8638,6016,2622,408,408,3044,1342,1702
"2021","North Lincolnshire","E06000013",73173,21366,10309,11057,48217,8263,22583,9650,8756,4177,9530,4569,4296,665,7438,4758,2680,403,403,3590,1602,1988
"2021","York","E06000014",85458,26640,11607,15033,52338,8619,25219,9659,11646,3914,10650,6786,3355,509,7340,4538,2802,510,510,6480,1115,5365
"2021","Craven","E07000163",26064,8440,4401,4039,16801,3698,8419,3701,3280,1438,2778,1620,1008,150,1820,1062,758,86,86,823,321,502
"2021","Hambleton","E07000164",40802,12176,6577,5599,27265,6094,13845,6101,5273,2471,4151,2385,1508,258,3034,1871,1163,141,141,1361,504,857
"2021","Harrogate","E07000165",71169,21845,10459,11386,46766,8825,24387,9538,11074,3775,7344,4433,2546,365,5904,3593,2311,306,306,2558,896,1662
"2021","Richmondshire","E07000166",20945,6108,3105,3003,14145,2771,7607,3341,3050,1216,2004,1163,730,111,1704,1103,601,59,59,692,290,402
"2021","Ryedale","E07000167",24713,7550,4056,3494,16269,3557,8059,3729,2953,1377,2757,1564,1043,150,1799,1051,748,97,97,894,287,607
"2021","Scarborough","E07000168",51123,18216,8971,9245,30852,6593,13602,6453,4716,2433,5550,2893,2308,349,4875,3100,1775,232,232,2055,790,1265
"2021","Selby","E07000169",39561,10556,4831,5725,27573,4433,14283,5843,6063,2377,5273,2983,2027,263,3422,2278,1144,162,162,1432,631,801
"2021","Barnsley","E08000016",108054,33289,14170,19119,70441,10252,31194,12838,12076,6280,15721,7631,6999,1091,12693,8400,4293,581,581,4324,2037,2287
"2021","Doncaster","E08000017",133478,41667,18042,23625,85499,12699,38226,15233,15393,7600,17656,8365,8103,1188,16043,10512,5531,875,875,6312,2896,3416
"2021","Rotherham","E08000018",113925,34225,15175,19050,75069,11604,34018,12960,14150,6908,15449,7078,7151,1220,13408,8613,4795,590,590,4631,2401,2230
"2021","Sheffield","E08000019",231951,75759,29871,45888,140739,19630,64582,22418,30742,11422,29242,16643,10756,1843,25650,16618,9032,1635,1635,15453,4662,10791
"2021","Bradford","E08000032",209865,64596,24902,39694,130426,15224,64874,19782,34178,10914,21288,10575,9253,1460,27395,18865,8530,1645,1645,14843,9231,5612
"2021","Calderdale","E08000033",90475,30308,12289,18019,56148,8020,25747,9765,11404,4578,11203,5805,4645,753,10771,7481,3290,407,407,4019,2033,1986
"2021","Kirklees","E08000034",177992,55177,22474,32703,113432,15946,55340,18867,26692,9781,20825,10555,8871,1399,20306,13445,6861,1015,1015,9383,4931,4452
"2021","Leeds","E08000035",341467,111381,40266,71115,204885,25549,93636,31454,46677,15505,44061,26072,15685,2304,38748,25870,12878,2891,2891,25201,7717,17484
"2021","Wakefield","E08000036",153075,46419,19886,26533,100085,14196,46026,18050,19325,8651,21794,10886,9426,1482,17209,11120,6089,860,860,6571,3051,3520
"2021","Derby","E06000015",105653,33054,13019,20035,64890,8427,30480,9917,14882,5681,12472,6544,5148,780,12460,7850,4610,1051,1051,7709,3435,4274
"2021","Leicester","E06000016",127388,35173,11871,23302,75604,6093,39969,9143,22376,8450,11372,5707,4753,912,16447,9828,6619,1723,1723,16611,8446,8165
"2021","Rutland","E06000017",16696,4786,2589,2197,11320,2654,5854,2350,2585,919,1600,950,560,90,1169,712,457,43,43,590,223,367
"2021","Nottingham","E06000018",124745,41971,13512,28459,68295,6104,28615,9457,14308,4850,14906,8448,5502,956,17045,11449,5596,1625,1625,14479,3997,10482
"2021","North Northamptonshire","E06000061",148922,40715,17680,23035,99038,14343,47182,17220,21671,8291,20219,10068,8901,1250,16303,10468,5835,991,991,9169,4114,5055
"2021","West Northamptonshire","E06000062",172643,46474,19511,26963,113940,15948,57154,19721,27652,9781,21857,11652,8876,1329,17572,11313,6259,1409,1409,12229,5272,6957
"2021","Amber Valley","E07000032",56276,17166,7956,9210,37184,6528,17549,7184,7017,3348,7475,4137,2869,469,5404,3425,1979,228,228,1926,781,1145
"2021","Bolsover","E07000033",35262,10539,4803,5736,23302,3471,10748,4545,4141,2062,5342,2709,2317,316,3558,2188,1370,183,183,1421,591,830
"2021","Chesterfield","E07000034",48056,17066,6972,10094,29429,4823,13150,5389,5252,2509,6275,3316,2586,373,4989,3206,1783,192,192,1561,613,948
"2021","Derbyshire Dales","E07000035",32284,9890,5357,4533,21391,4856,10745,4789,4050,1906,3367,1840,1303,224,2320,1333,987,103,103,1003,402,601
"2021","Erewash","E07000036",50331,15549,6916,8633,32905,5306,14957,5864,6182,2911,7221,3830,2908,483,5206,3196,2010,215,215,1877,751,1126
"2021","High Peak","E07000037",40773,12944,5889,7055,26400,4309,12718,5205,5166,2347,5150,2717,2109,324,4070,2486,1584,153,153,1429,562,867
"2021","North East Derbyshire","E07000038",45990,14305,7017,7288,30258,5998,14219,5781,5655,2783,5613,2941,2300,372,4279,2604,1675,149,149,1427,626,801
"2021","South Derbyshire","E07000039",45239,12249,5141,7108,31331,4619,15719,5983,6992,2744,6516,3626,2538,352,4338,2854,1484,139,139,1659,802,857
"2021","Blaby","E07000129",42577,11095,5640,5455,29403,4929,14587,4938,6757,2892,5616,2775,2457,384,4087,2508,1579,184,184,2079,963,1116
"2021","Charnwood","E07000130",73782,20860,9305,11555,47865,7701,24143,8451,10986,4706,8713,4682,3515,516,6900,4187,2713,408,408,5057,1550,3507
"2021","Harborough","E07000131",40414,10514,5335,5179,28119,5153,14836,5264,6956,2616,4664,2645,1750,269,3314,2066,1248,152,152,1781,772,1009
"2021","Hinckley and Bosworth","E07000132",49446,13972,6583,7389,33470,6110,16121,6305,6967,2849,6507,3517,2598,392,4538,2803,1735,194,194,2004,809,1195
"2021","Melton","E07000133",22599,6363,3152,3211,15365,2909,7650,3221,3055,1374,2689,1449,1100,140,2018,1251,767,99,99,871,332,539
"2021","North West Leicestershire","E07000134",44971,12497,5640,6857,30552,4877,14931,5805,6433,2693,6364,3399,2550,415,4196,2613,1583,184,184,1922,724,1198
"2021","Oadby and Wigston","E07000135",22615,6347,3406,2941,14839,2577,7670,2225,3631,1814,2111,963,972,176,2380,1374,1006,101,101,1429,758,671
"2021","Boston","E07000136",29403,8088,4035,4053,18942,3117,8442,3475,3454,1513,3941,1905,1770,266,3198,2183,1015,244,244,2373,1104,1269
"2021","East Lindsey","E07000137",64754,19800,10971,8829,42022,10234,18859,9554,6048,3257,7154,3865,2871,418,5500,3387,2113,275,275,2932,1177,1755
"2021","Lincoln","E07000138",42507,14137,4897,9240,24269,2872,9981,3990,4283,1708,6159,3601,2265,293,4853,3245,1608,404,404,4101,918,3183
"2021","North Kesteven","E07000139",50989,13989,7247,6742,35208,6852,17927,7438,7566,2923,6065,3368,2394,303,4189,2756,1433,175,175,1792,709,1083
"2021","South Holland","E07000140",40706,11051,5914,5137,26930,5250,12638,5531,4851,2256,5246,2695,2232,319,3558,2236,1322,238,238,2725,1191,1534
"2021","South Kesteven","E07000141",62846,18226,8835,9391,42122,7912,20518,8426,8712,3380,7534,4031,3058,445,5903,3882,2021,255,255,2498,973,1525
"2021","West Lindsey","E07000142",42345,12680,6255,6425,28116,5701,13487,6036,5201,2250,4964,2655,2024,285,3826,2502,1324,138,138,1549,665,884
"2021","Ashfield","E07000170",54508,16048,7056,8992,36131,5457,16163,6503,6444,3216,7925,3810,3548,567,6288,4065,2223,298,298,2329,1067,1262
"2021","Bassetlaw","E07000171",51460,15492,7262,8230,34003,5946,15968,6729,6269,2970,6695,3413,2825,457,5159,3386,1773,235,235,1965,882,1083
"2021","Broxtowe","E07000172",48361,14581,6843,7738,31251,5520,15001,5743,6469,2789,6045,3545,2133,367,4417,2710,1707,268,268,2529,745,1784
"2021","Gedling","E07000173",51554,15514,7173,8341,33909,5669,15629,5841,6827,2961,6837,3571,2817,449,5551,3409,2142,223,223,2131,886,1245
"2021","Mansfield","E07000174",48032,14471,6264,8207,31084,4568,14309,5797,5768,2744,6625,3244,2937,444,5282,3373,1909,300,300,2477,1094,1383
"2021","Newark and Sherwood","E07000175",53333,15746,7700,8046,35322,6368,16741,6876,6849,3016,6912,3603,2881,428,5073,3135,1938,228,228,2265,925,1340
"2021","Rushcliffe","E07000176",49883,13822,6881,6941,33754,6184,17841,6016,9077,2748,5636,3381,1988,267,3890,2455,1435,203,203,2307,687,1620
"2021","Herefordshire, County of","E06000019",82824,25434,12919,12515,53433,11052,25781,10769,10250,4762,8902,4850,3478,574,7318,4361,2957,380,380,3957,1531,2426
"2021","Telford and Wrekin","E06000020",76510,21205,9048,12157,50746,6968,23741,8824,10524,4393,10409,5164,4572,673,9136,5973,3163,492,492,4559,1910,2649
"2021","Stoke-on-Trent","E06000021",110400,36179,14225,21954,68454,8647,29954,11087,13363,5504,14757,7144,6717,896,14209,9522,4687,887,887,5767,2475,3292
"2021","Shropshire","E06000051",139576,41428,21475,19953,91505,18946,44065,18297,17242,8526,16266,8844,6302,1120,11675,6880,4795,553,553,6643,2845,3798
"2021","Cannock Chase","E07000192",43458,12570,5456,7114,29118,4346,13484,5185,5409,2890,6496,3193,2900,403,4578,2822,1756,214,214,1770,817,953
"2021","East Staffordshire","E07000193",51293,14760,6565,8195,33756,5004,16854,6211,7626,3017,6471,3417,2687,367,5075,3230,1845,352,352,2777,1319,1458
"2021","Lichfield","E07000194",45630,12662,6426,6236,31246,6297,15245,5546,6679,3020,5431,2868,2211,352,4092,2397,1695,181,181,1722,780,942
"2021","Newcastle-under-Lyme","E07000195",53420,16588,7694,8894,34306,5946,16014,6363,6407,3244,6798,3397,2908,493,5309,3297,2012,239,239,2526,913,1613
"2021","South Staffordshire","E07000196",46122,12558,7241,5317,31836,6564,16052,6101,6284,3667,5057,2480,2184,393,4007,2289,1718,156,156,1728,775,953
"2021","Stafford","E07000197",60048,17754,8334,9420,40064,7478,19498,7819,8286,3393,7471,4214,2833,424,5378,3369,2009,239,239,2230,897,1333
"2021","Staffordshire Moorlands","E07000198",42355,12536,6603,5933,28334,5997,13789,5687,5278,2824,4935,2520,2057,358,3480,2010,1470,133,133,1485,680,805
"2021","Tamworth","E07000199",32892,8787,4102,4685,22519,3221,10603,3907,4424,2272,4578,2180,2111,287,3926,2511,1415,191,191,1586,710,876
"2021","North Warwickshire","E07000218",27580,7642,3651,3991,18597,3122,8796,3382,3442,1972,3700,1798,1608,294,2892,1749,1143,87,87,1341,609,732
"2021","Nuneaton and Bedworth","E07000219",56587,16345,7190,9155,37244,5473,17459,6200,7481,3778,7164,3422,3271,471,6795,4442,2353,353,353,2998,1477,1521
"2021","Rugby","E07000220",47016,12774,5687,7087,31457,4700,15980,5340,7969,2671,5806,3258,2257,291,4650,2981,1669,321,321,2785,1164,1621
"2021","Stratford-on-Avon","E07000221",59464,17306,8930,8376,39649,8097,20051,7824,8823,3404,6435,3879,2227,329,4818,2889,1929,248,248,2509,879,1630
"2021","Warwick","E07000222",62619,18999,8103,10896,39354,6060,20488,6781,10378,3329,7182,4565,2287,330,5238,3177,2061,386,386,4266,1067,3199
"2021","Bromsgrove","E07000234",41265,11293,5948,5345,28401,5263,14651,4941,6879,2831,4467,2351,1817,299,3898,2421,1477,122,122,1571,735,836
"2021","Malvern Hills","E07000235",34886,10303,5635,4668,23108,5201,11274,4777,4444,2053,3661,1969,1451,241,2841,1648,1193,131,131,1475,542,933
"2021","Redditch","E07000236",36374,10100,4405,5695,24220,3459,11502,4047,5203,2252,4829,2473,2059,297,4226,2696,1530,204,204,2054,908,1146
"2021","Worcester","E07000237",44722,14157,5557,8600,27673,3762,13003,4672,6044,2287,6091,3576,2156,359,4508,2856,1652,309,309,2892,915,1977
"2021","Wychavon","E07000238",57356,15847,8292,7555,38958,8079,19177,7696,8073,3408,6582,3623,2546,413,4909,3019,1890,211,211,2551,1009,1542
"2021","Wyre Forest","E07000239",45320,14377,7253,7124,29069,5852,12840,5063,5141,2636,5543,2853,2303,387,4638,2785,1853,196,196,1874,782,1092
"2021","Birmingham","E08000025",423456,133224,47070,86154,248201,23052,118572,29197,66750,22625,37183,19429,14908,2846,64230,40869,23361,5164,5164,42031,21367,20664
"2021","Coventry","E08000026",134138,40777,15600,25177,80627,9155,38495,10998,19947,7550,13784,6810,5986,988,17587,11101,6486,1606,1606,12734,4906,7828
"2021","Dudley","E08000027",137069,41709,19079,22630,89286,14221,41300,13850,18029,9421,16416,7777,7451,1188,16622,10327,6295,727,727,6074,3227,2847
"2021","Sandwell","E08000028",130246,38042,15025,23017,81336,8223,38838,10429,19633,8776,13598,5596,6851,1151,19456,12228,7228,1221,1221,10868,6759,4109
"2021","Solihull","E08000029",89486,25855,13023,12832,59409,10110,30058,8860,14699,6499,8468,4124,3658,686,10383,6438,3945,390,390,4222,2110,2112
"2021","Walsall","E08000030",112228,32129,14516,17613,73084,9546,34024,10121,16197,7706,12898,5352,6456,1090,15698,10026,5672,918,918,7015,4211,2804
"2021","Wolverhampton","E08000031",105141,32468,13054,19414,64872,7375,29818,8531,14347,6940,11048,4631,5517,900,15637,9728,5909,994,994,7801,4384,3417
"2021","Peterborough","E06000031",84533,23516,8919,14597,53359,6002,25488,8246,13337,3905,10319,5192,4533,594,10672,7368,3304,878,878,7658,4025,3633
"2021","Luton","E06000032",78940,21068,7300,13768,48499,4158,25979,5948,15322,4709,6663,3258,2873,532,10511,6490,4021,1188,1188,9373,5428,3945
"2021","Southend-on-Sea","E06000033",78344,26102,10922,15180,48025,6716,21735,6981,10543,4211,9644,4988,3978,678,9456,5901,3555,474,474,4217,1712,2505
"2021","Thurrock","E06000034",66375,16180,6801,9379,44594,4556,22046,5863,11604,4579,8421,3405,4270,746,8991,5906,3085,580,580,5601,3067,2534
"2021","Bedford","E06000055",74948,21448,8608,12840,48493,6416,24275,7533,12476,4266,8741,4766,3479,496,8463,5279,3184,598,598,5007,2365,2642
"2021","Central Bedfordshire","E06000056",120756,31172,13916,17256,83756,12089,43040,14526,20897,7617,16101,8471,6645,985,11891,7306,4585,635,635,5828,2536,3292
"2021","Cambridge","E07000008",52472,16659,5258,11401,28935,2998,14651,4952,7813,1886,6513,4668,1656,189,4247,2649,1598,526,526,6878,1285,5593
"2021","East Cambridgeshire","E07000009",37200,10290,4760,5530,25263,4280,13255,4741,6439,2075,4488,2606,1624,258,3094,1970,1124,146,146,1647,601,1046
"2021","Fenland","E07000010",44083,12787,6360,6427,28550,5215,12693,5503,4820,2370,5942,2967,2571,404,4446,2850,1596,254,254,2746,1236,1510
"2021","Huntingdonshire","E07000011",76880,21565,9557,12008,51734,8606,26421,9958,12125,4338,9457,5305,3650,502,6876,4229,2647,374,374,3581,1359,2222
"2021","South Cambridgeshire","E07000012",66996,17574,8211,9363,46261,7625,25641,8328,13541,3772,7254,4214,2645,395,5464,3402,2062,277,277,3161,1026,2135
"2021","Basildon","E07000066",76364,21474,9440,12034,50450,6565,24233,7245,11951,5037,9598,4440,4447,711,9617,6068,3549,437,437,4440,2168,2272
"2021","Braintree","E07000067",64985,17774,8599,9175,44233,7127,21889,7705,9972,4212,8538,4369,3608,561,6417,3864,2553,262,262,2978,1188,1790
"2021","Brentwood","E07000068",32342,9402,4417,4985,21487,3385,11030,3160,5615,2255,3667,2070,1361,236,3225,1904,1321,180,180,1453,629,824
"2021","Castle Point","E07000069",37392,10222,6145,4077,25276,5293,11935,3902,5035,2998,4164,1925,1861,378,3737,2083,1654,147,147,1894,909,985
"2021","Chelmsford","E07000070",75400,21153,9576,11577,50550,8062,25959,7986,13240,4733,8866,5110,3202,554,7239,4303,2936,424,424,3697,1366,2331
"2021","Colchester","E07000071",79710,23077,9826,13251,51588,7548,25099,8488,12372,4239,9883,5458,3915,510,8522,5583,2939,536,536,5045,1635,3410
"2021","Epping Forest","E07000072",54557,14827,7334,7493,36345,5361,18418,5400,9016,4002,6164,3070,2585,509,6072,3406,2666,330,330,3385,1611,1774
"2021","Harlow","E07000073",37857,10918,4411,6507,24364,2464,11165,3266,5717,2182,4901,2167,2325,409,5512,3622,1890,322,322,2575,1186,1389
"2021","Maldon","E07000074",27900,7418,4205,3213,19114,3867,9629,3601,3988,2040,3167,1667,1242,258,2372,1361,1011,79,79,1368,583,785
"2021","Rochford","E07000075",35555,9359,5463,3896,24629,4715,12656,4108,5681,2867,3927,1866,1737,324,3214,1862,1352,117,117,1567,680,887
"2021","Tendring","E07000076",67451,23073,12950,10123,41118,9782,17464,7392,6397,3675,6891,3356,2994,541,6676,3991,2685,305,305,3260,1368,1892
"2021","Uttlesford","E07000077",36960,9228,4689,4539,26017,4203,14231,4590,7158,2483,4260,2210,1786,264,3202,1948,1254,121,121,1715,677,1038
"2021","Broxbourne","E07000095",39849,10971,5069,5902,26372,3542,12856,3318,6429,3109,4210,1890,1940,380,5441,3326,2115,323,323,2506,1285,1221
"2021","Dacorum","E07000096",63409,17851,7947,9904,42258,5548,21814,6477,11388,3949,7427,3924,3022,481,7126,4435,2691,343,343,3300,1346,1954
"2021","Hertsmere","E07000098",42683,11527,5498,6029,28219,3882,15518,3974,8450,3094,3485,1810,1381,294,5022,3000,2022,312,312,2937,1308,1629
"2021","North Hertfordshire","E07000099",56731,16903,7505,9398,37395,5610,19238,6173,9742,3323,6934,4022,2526,386,5357,3317,2040,256,256,2433,950,1483
"2021","Three Rivers","E07000102",36857,9696,4785,4911,24923,3427,14217,3599,7758,2860,3336,1649,1434,253,3747,2119,1628,196,196,2238,1073,1165
"2021","Watford","E07000103",39628,11146,3741,7405,24796,2175,13753,3470,7945,2338,4070,2379,1440,251,4394,2630,1764,404,404,3686,1773,1913
"2021","Breckland","E07000143",60360,16550,8704,7846,40499,8353,18948,8093,7382,3473,7652,4055,3134,463,5252,3250,2002,294,294,3311,1362,1949
"2021","Broadland","E07000144",57759,16238,8742,7496,39376,8355,19192,7723,8075,3394,6930,3833,2654,443,4715,2823,1892,184,184,2145,809,1336
"2021","Great Yarmouth","E07000145",44542,14488,6862,7626,27765,5079,11433,4884,4191,2358,5649,2659,2539,451,5355,3528,1827,249,249,2289,977,1312
"2021","King's Lynn and West Norfolk","E07000146",67464,19829,10626,9203,44122,9315,20318,8825,7762,3731,8251,4186,3501,564,5920,3584,2336,318,318,3513,1459,2054
"2021","North Norfolk","E07000147",48375,16319,9314,7005,30201,8230,13151,6605,4247,2299,5002,2727,1961,314,3643,2095,1548,175,175,1855,649,1206
"2021","Norwich","E07000148",64459,25098,8214,16884,33322,3830,13100,5011,6216,1873,9117,5646,3044,427,6727,4528,2199,548,548,6039,988,5051
"2021","South Norfolk","E07000149",61379,16990,8789,8201,41897,8387,20635,8263,9012,3360,7573,4296,2872,405,5070,3154,1916,232,232,2492,970,1522
"2021","Babergh","E07000200",40200,11382,6284,5098,27234,5954,13224,5419,5307,2498,4624,2429,1883,312,3320,1946,1374,112,112,1584,610,974
"2021","Ipswich","E07000202",59506,19270,7235,12035,36656,4615,16597,5666,8082,2849,7963,4064,3440,459,7042,4593,2449,439,439,3580,1491,2089
"2021","Mid Suffolk","E07000203",44343,11983,6325,5658,30583,6357,15281,6474,6093,2714,5375,3060,1978,337,3417,2015,1402,153,153,1777,720,1057
"2021","St Albans","E07000240",58990,15528,7076,8452,40737,5571,23585,5894,14146,3545,5996,3642,2064,290,5315,3221,2094,270,270,2725,1068,1657
"2021","Welwyn Hatfield","E07000241",46209,12928,5653,7275,29416,3790,15242,4415,7999,2828,4946,2533,2059,354,5036,3130,1906,402,402,3865,1275,2590
"2021","East Hertfordshire","E07000242",62021,16952,7543,9409,42207,6119,22464,6784,11622,4058,7652,4440,2792,420,5654,3535,2119,318,318,2862,987,1875
"2021","Stevenage","E07000243",36510,10568,4208,6360,23592,2564,11675,3611,5775,2289,4606,2276,1999,331,4488,2748,1740,259,259,2350,961,1389
"2021","East Suffolk","E07000244",110747,35817,19053,16764,70664,16183,32410,13666,12637,6107,12032,6124,5102,806,9667,5970,3697,372,372,4266,1668,2598
"2021","West Suffolk","E07000245",78746,25490,10485,15005,49592,8592,24660,9605,11206,3849,9153,5115,3504,534,6810,4356,2454,377,377,3664,1308,2356
"2021","City of London","E09000001",4916,2506,494,2012,1983,201,846,523,253,70,665,598,57,10,175,90,85,96,96,427,31,396
"2021","Barking and Dagenham","E09000002",73904,17503,5991,11512,46471,2268,22869,4224,14417,4228,6016,2005,3401,610,14116,9427,4689,1202,1202,9930,6330,3600
"2021","Barnet","E09000003",148919,41658,15208,26450,91234,9264,50725,11929,29036,9760,10924,6717,3565,642,18103,10476,7627,2218,2218,16027,6468,9559
"2021","Bexley","E09000004",95300,24753,11968,12785,62904,7730,31802,8115,16368,7319,9899,4450,4564,885,12681,7665,5016,792,792,7643,3929,3714
"2021","Brent","E09000005",118612,31985,9712,22273,66305,4302,33864,7464,18539,7861,8055,5092,2446,517,17678,9830,7848,2406,2406,20322,9295,11027
"2021","Bromley","E09000006",135828,38668,17443,21225,88907,11684,46328,12702,24997,8629,14462,8081,5431,950,15447,9298,6149,986,986,8253,3548,4705
"2021","Camden","E09000007",92758,35931,9718,26213,45716,3004,20511,6724,11082,2705,9986,7897,1767,322,10559,5945,4614,1656,1656,11111,2273,8838
"2021","Croydon","E09000008",152947,43091,14652,28439,94644,8471,44664,11821,23600,9243,14817,8027,5690,1100,24543,15169,9374,2149,2149,15212,7250,7962
"2021","Ealing","E09000009",133659,35662,11837,23825,78735,5423,42798,9773,24366,8659,10978,7037,3322,619,17248,9558,7690,2288,2288,19262,8420,10842
"2021","Enfield","E09000010",120929,31159,12251,18908,76894,6921,37245,8001,20268,8976,8662,3937,3937,788,22424,14274,8150,1642,1642,12876,6924,5952
"2021","Greenwich","E09000011",114052,34048,9581,24467,67236,4097,30668,9347,16178,5143,13634,8547,4387,700,17095,10898,6197,1742,1742,12768,5377,7391
"2021","Hackney","E09000012",106080,34928,7489,27439,54971,1785,21060,5852,12287,2921,13669,10182,3046,441,16400,9944,6456,2057,2057,16181,3519,12662
"2021","Hammersmith and Fulham","E09000013",81244,29324,7351,21973,40567,2033,18050,5919,9731,2400,8869,7151,1406,312,9683,5354,4329,1932,1932,11353,2042,9311
"2021","Haringey","E09000014",105092,32293,8958,23335,58393,3139,25443,6838,14343,4262,11772,7874,3326,572,15855,9079,6776,2184,2184,14406,4536,9870
"2021","Harrow","E09000015",89642,19852,9050,10802,57026,6491,35202,7406,19162,8634,4341,2499,1444,398,9738,4883,4855,1254,1254,12764,6834,5930
"2021","Havering","E09000016",101277,26129,12838,13291,67212,9063,33811,8799,16837,8175,10398,4585,4791,1022,13138,7821,5317,802,802,7936,4268,3668
"2021","Hillingdon","E09000017",109227,26634,11143,15491,69899,6521,39538,9193,22168,8177,8650,4481,3390,779,13863,7944,5919,1327,1327,12694,6664,6030
"2021","Hounslow","E09000018",102961,26209,9176,17033,61825,4381,34354,7844,19741,6769,8242,4685,3013,544,13347,7598,5749,1501,1501,14927,7389,7538
"2021","Islington","E09000019",96497,34795,7636,27159,48738,2168,18118,6689,8898,2531,13546,10707,2430,409,13071,7823,5248,1835,1835,12964,2067,10897
"2021","Kensington and Chelsea","E09000020",66885,29233,7750,21483,30872,2390,15104,5416,7276,2412,5316,4253,878,185,6674,3407,3267,1388,1388,6780,2063,4717
"2021","Kingston upon Thames","E09000021",65626,17716,6894,10822,41929,4274,23700,5954,13632,4114,6904,4415,2155,334,6336,3747,2589,715,715,5981,2094,3887
"2021","Lambeth","E09000022",134686,43154,9531,33623,67458,2524,24606,8158,12677,3771,17736,13667,3411,658,19228,11320,7908,3364,3364,24074,4434,19640
"2021","Lewisham","E09000023",122390,37147,9365,27782,70358,3280,28896,8506,15646,4744,16225,10765,4627,833,19920,12195,7725,2037,2037,14885,4912,9973
"2021","Merton","E09000024",81729,20464,7507,12957,50849,4087,27505,7001,15684,4820,8927,5895,2586,446,9146,5064,4082,1184,1184,10416,4094,6322
"2021","Newham","E09000025",115507,27037,6377,20660,65603,2022,33238,7091,20395,5752,10384,6662,3095,627,16971,9866,7105,2988,2988,22867,11006,11861
"2021","Redbridge","E09000026",103714,23886,9669,14217,65084,5306,39537,7279,23701,8557,6445,3341,2557,547,12487,7155,5332,1309,1309,14744,8666,6078
"2021","Richmond upon Thames","E09000027",80704,23871,10039,13832,51666,5744,29730,8002,17536,4192,8539,5597,2572,370,7078,4224,2854,575,575,5167,1884,3283
"2021","Southwark","E09000028",130818,43348,9507,33841,67691,2526,24878,8406,12877,3595,17301,12924,3718,659,19847,12110,7737,3139,3139,19779,4232,15547
"2021","Sutton","E09000029",82349,22200,9497,12703,54170,5613,29782,7343,16864,5575,8309,4390,3300,619,9796,5900,3896,670,670,5979,2959,3020
"2021","Tower Hamlets","E09000030",120538,38530,5786,32744,61312,1340,28878,8674,17254,2950,15199,12355,2499,345,12853,7961,4892,3042,3042,20696,4952,15744
"2021","Waltham Forest","E09000031",102899,26696,8254,18442,62016,3547,29167,7372,16400,5395,12875,7893,4341,641,14705,8536,6169,1722,1722,14187,6385,7802
"2021","Wandsworth","E09000032",137393,41132,10880,30252,74344,3838,34574,10696,19467,4411,19118,15627,3079,412,14041,8277,5764,2773,2773,21917,3437,18480
"2021","Westminster","E09000033",94817,40443,9498,30945,43262,2772,19673,7479,9419,2775,8563,7003,1258,302,9698,5015,4683,2556,2556,11112,2388,8724
"2021","Medway","E06000035",111459,30462,13132,17330,73294,9113,35051,10985,16923,7143,14489,6699,6655,1135,13930,8657,5273,711,711,7703,3721,3982
"2021","Bracknell Forest","E06000036",50244,13462,5195,8267,33651,3877,18084,5814,9251,3019,6482,3713,2440,329,4932,3062,1870,276,276,3131,1258,1873
"2021","West Berkshire","E06000037",66658,18008,8321,9687,45249,7183,24582,8439,11836,4307,7436,4261,2804,371,5720,3498,2222,328,328,3401,1232,2169
"2021","Reading","E06000038",67683,19262,6230,13032,40381,3643,20242,6024,11045,3173,8297,5371,2501,425,7361,4624,2737,838,838,8040,2570,5470
"2021","Slough","E06000039",52421,11948,3838,8110,33308,1819,19807,3775,12606,3426,3885,1752,1823,310,7156,4429,2727,641,641,7165,4298,2867
"2021","Windsor and Maidenhead","E06000040",60933,16715,7610,9105,40088,5821,22591,6670,12012,3909,5963,3552,2034,377,5345,3057,2288,368,368,4130,1723,2407
"2021","Wokingham","E06000041",69164,16265,7644,8621,49188,7081,28973,8144,16326,4503,7246,4320,2543,383,5551,3385,2166,337,337,3711,1549,2162
"2021","Milton Keynes","E06000042",113102,29795,10980,18815,74485,7842,38321,11704,20448,6169,13250,7059,5382,809,14109,9519,4590,963,963,8822,4026,4796
"2021","Brighton and Hove","E06000043",121401,42101,13875,28226,65648,6247,29009,10309,14204,4496,17509,11692,5088,729,11637,7229,4408,1246,1246,13652,2166,11486
"2021","Portsmouth","E06000044",86155,27607,10673,16934,50067,5437,22594,7893,10731,3970,11115,6218,4241,656,10030,6513,3517,891,891,8481,2221,6260
"2021","Southampton","E06000045",102291,33711,11453,22258,58597,6180,26737,9179,13259,4299,13337,8068,4604,665,11270,7366,3904,1073,1073,9983,2661,7322
"2021","Isle of Wight","E06000046",64778,22484,11669,10815,39086,8925,17032,7790,6012,3230,6702,3543,2703,456,6227,3893,2334,200,200,3208,1240,1968
"2021","Buckinghamshire","E06000060",220329,57889,27090,30799,149363,22853,82484,24980,43427,14077,22824,12793,8692,1339,19904,11950,7954,1298,1298,13077,5821,7256
"2021","Eastbourne","E07000061",45610,16205,8127,8078,26614,5032,11349,4224,5074,2051,5039,2689,2024,326,4897,3084,1813,297,297,2791,930,1861
"2021","Hastings","E07000062",40453,14441,6030,8411,23261,3229,9812,3886,4110,1816,5135,2627,2172,336,4857,3129,1728,228,228,2751,1101,1650
"2021","Lewes","E07000063",43694,13539,7827,5712,27750,5713,12959,4938,5666,2355,4635,2393,1928,314,4292,2643,1649,151,151,2405,850,1555
"2021","Rother","E07000064",42100,13713,8384,5329,26159,6864,11457,5109,4137,2211,3938,2092,1535,311,3757,2195,1562,143,143,2228,902,1326
"2021","Wealden","E07000065",68267,18745,10936,7809,46219,9985,23298,9063,9884,4351,7010,3834,2729,447,5682,3292,2390,244,244,3303,1301,2002
"2021","Basingstoke and Deane","E07000084",76642,20406,8299,12107,51816,7241,27355,9437,13269,4649,9737,5612,3613,512,7033,4315,2718,450,450,4420,1680,2740
"2021","East Hampshire","E07000085",52721,13910,7245,6665,36445,6869,19571,7175,9023,3373,5518,3158,2033,327,4262,2498,1764,225,225,2366,861,1505
"2021","Eastleigh","E07000086",56924,15107,7163,7944,39042,6085,20010,6881,9785,3344,7271,4069,2827,375,5431,3443,1988,245,245,2775,1019,1756
"2021","Fareham","E07000087",48641,13009,7340,5669,33437,6690,17578,6617,7726,3235,5116,2902,1890,324,3903,2238,1665,150,150,2195,797,1398
"2021","Gosport","E07000088",35923,11443,5464,5979,22641,3733,10587,4279,4419,1889,4155,2142,1766,247,3974,2543,1431,192,192,1839,739,1100
"2021","Hart","E07000089",39963,9835,4946,4889,28362,4788,15948,4903,8383,2662,4217,2411,1564,242,3256,1948,1308,153,153,1766,693,1073
"2021","Havant","E07000090",53591,15957,8743,7214,34736,6646,16101,6503,6350,3248,6144,3095,2576,473,5620,3431,2189,225,225,2898,1212,1686
"2021","New Forest","E07000091",77566,22737,13461,9276,51185,12396,24579,10099,9839,4641,7570,4159,2888,523,6346,3636,2710,294,294,3644,1385,2259
"2021","Rushmoor","E07000092",39304,10502,3956,6546,25517,2756,13626,4142,6813,2671,4708,2633,1818,257,4176,2493,1683,251,251,3285,1408,1877
"2021","Test Valley","E07000093",54706,14464,7138,7326,37528,6539,19855,7326,9232,3297,6307,3605,2384,318,4591,2838,1753,236,236,2714,1026,1688
"2021","Winchester","E07000094",51716,14331,7280,7051,34375,6138,18843,6701,9293,2849,5311,3220,1842,249,3858,2406,1452,225,225,3010,742,2268
"2021","Ashford","E07000105",53586,13862,6618,7244,36313,5794,18078,6149,8564,3365,6548,3249,2859,440,5629,3664,1965,264,264,3411,1476,1935
"2021","Canterbury","E07000106",63794,19047,9700,9347,38832,7453,18021,6638,7992,3391,6820,3871,2523,426,6117,3781,2336,421,421,5915,1497,4418
"2021","Dartford","E07000107",45697,11827,4421,7406,30938,3176,15817,4253,8793,2771,6176,2988,2747,441,5422,3464,1958,347,347,2932,1523,1409
"2021","Dover","E07000108",50548,15658,7947,7711,32172,5961,14627,6041,5761,2825,6008,2966,2587,455,5342,3350,1992,234,234,2718,1115,1603
"2021","Gravesham","E07000109",41722,11212,5162,6050,27208,3687,13456,3843,6668,2945,4656,2035,2255,366,5106,3192,1914,303,303,3302,1847,1455
"2021","Maidstone","E07000110",71207,18800,8450,10350,47930,7529,23989,7857,11776,4356,8885,4707,3653,525,7087,4425,2662,440,440,4477,1921,2556
"2021","Sevenoaks","E07000111",49014,12990,7054,5936,33655,5774,17858,5416,9174,3268,5160,2654,2155,351,4663,2736,1927,200,200,2369,1073,1296
"2021","Folkestone and Hythe","E07000112",48336,15728,7917,7811,29877,5920,13373,5463,5402,2508,5527,2867,2264,396,4834,2930,1904,223,223,2731,1131,1600
"2021","Swale","E07000113",60495,15957,7860,8097,40535,6117,18844,6822,8312,3710,8397,3873,3849,675,6880,4312,2568,297,297,4003,1979,2024
"2021","Thanet","E07000114",62199,20839,10225,10614,37575,6720,15802,6288,6560,2954,7362,3509,3324,529,7381,4668,2713,310,310,3785,1599,2186
"2021","Tonbridge and Malling","E07000115",53573,13698,6831,6867,37377,5775,19425,6060,9897,3468,6496,3290,2771,435,5458,3356,2102,223,223,2498,1054,1444
"2021","Tunbridge Wells","E07000116",48223,14198,6399,7799,31900,4933,16942,5219,9022,2701,5344,3063,1985,296,4433,2747,1686,248,248,2125,813,1312
"2021","Cherwell","E07000177",65893,17339,7476,9863,44170,6046,22894,8016,11109,3769,8659,5035,3157,467,6085,3725,2360,486,486,4384,1671,2713
"2021","Oxford","E07000178",55238,16096,5955,10141,30517,3121,15223,4744,8173,2306,5939,3869,1757,313,5519,3350,2169,715,715,8625,2036,6589
"2021","South Oxfordshire","E07000179",61495,16105,8038,8067,42221,7035,22675,7633,11296,3746,7204,4261,2562,381,5024,2947,2077,283,283,3169,1046,2123
"2021","Vale of White Horse","E07000180",57498,15437,6997,8440,39110,6411,20993,7327,10382,3284,6738,3989,2427,322,4725,2976,1749,243,243,2951,925,2026
"2021","West Oxfordshire","E07000181",47984,13206,6586,6620,32546,5711,16938,6155,7818,2965,5551,3147,2098,306,4106,2511,1595,240,240,2232,735,1497
"2021","Elmbridge","E07000207",55593,14972,7304,7668,37881,5123,22303,5750,13296,3257,5308,3136,1919,253,4845,2981,1864,302,302,2740,1120,1620
"2021","Epsom and Ewell","E07000208",31321,7625,3958,3667,21523,3062,12356,3125,6959,2272,2967,1551,1206,210,2958,1651,1307,180,180,2173,871,1302
"2021","Guildford","E07000209",55760,14840,6768,8072,36202,5595,20116,6373,10494,3249,5812,3639,1875,298,4338,2535,1803,341,341,4718,1053,3665
"2021","Mole Valley","E07000210",37139,11053,5836,5217,24368,4650,13254,4333,6469,2452,3507,2063,1228,216,2830,1576,1254,127,127,1718,669,1049
"2021","Reigate and Banstead","E07000211",59845,15797,7344,8453,40598,5519,22447,6398,12260,3789,6642,3658,2573,411,5656,3505,2151,334,334,3450,1378,2072
"2021","Runnymede","E07000212",34841,9939,4462,5477,21981,3015,11562,3522,6041,1999,3906,2301,1360,245,3277,1902,1375,221,221,2921,827,2094
"2021","Spelthorne","E07000213",41805,11665,5363,6302,27130,3706,14282,4127,7314,2841,4439,2338,1799,302,4392,2596,1796,311,311,3010,1290,1720
"2021","Surrey Heath","E07000214",36009,9067,4408,4659,24721,3987,13844,4230,7083,2531,3647,2069,1355,223,3081,1811,1270,162,162,2221,928,1293
"2021","Tandridge","E07000215",35621,9702,5000,4702,24026,3981,12623,3859,6374,2390,3813,1956,1604,253,3430,2141,1289,179,179,1893,806,1087
"2021","Waverley","E07000216",52448,14642,7589,7053,35360,6446,19582,6023,10473,3086,5021,3053,1713,255,4104,2373,1731,207,207,2446,821,1625
"2021","Woking","E07000217",41437,11124,4847,6277,27415,3510,15510,4397,8600,2513,4450,2805,1415,230,3651,2138,1513,294,294,2898,1287,1611
"2021","Adur","E07000223",27679,8414,4714,3700,17581,3196,8126,2738,3811,1577,3357,1635,1478,244,2772,1587,1185,130,130,1684,617,1067
"2021","Arun","E07000224",72661,22768,13293,9475,45720,10743,20320,8074,8318,3928,7805,4176,3084,545,6473,3791,2682,379,379,4173,1545,2628
"2021","Chichester","E07000225",54118,16840,9478,7362,34352,7662,16503,6731,6977,2795,5327,2984,2020,323,4585,2667,1918,275,275,2926,818,2108
"2021","Crawley","E07000226",45504,11517,4579,6938,29475,2787,15054,4285,7960,2809,5520,2821,2355,344,5654,3540,2114,460,460,4512,1869,2643
"2021","Horsham","E07000227",62371,17535,8900,8635,42097,7847,22245,7997,10484,3764,6969,4117,2509,343,4816,2870,1946,220,220,2739,909,1830
"2021","Mid Sussex","E07000228",63348,17421,8599,8822,42947,7165,22974,7206,12004,3764,7272,4157,2729,386,5271,3125,2146,265,265,2980,1102,1878
"2021","Worthing","E07000229",49539,16763,7844,8919,29963,5105,13896,4895,6603,2398,5872,3309,2279,284,4789,2925,1864,301,301,2813,1013,1800
"2021","Bath and North East Somerset","E06000022",79250,23077,10781,12296,49584,8279,24740,8502,11872,4366,9278,5599,3214,465,6763,4088,2675,524,524,6589,1231,5358
"2021","Bristol, City of","E06000023",191638,57862,19697,38165,110132,10952,48404,15274,25372,7758,28890,19251,8445,1194,19819,12683,7136,2067,2067,23644,4608,19036
"2021","North Somerset","E06000024",94648,29089,14451,14638,61026,11995,29709,10802,13892,5015,10513,5770,4162,581,8426,5468,2958,383,383,4533,1727,2806
"2021","South Gloucestershire","E06000025",118101,30747,14375,16372,80156,12635,40524,13233,19480,7811,15239,8633,5712,894,11102,6955,4147,656,656,7198,2368,4830
"2021","Plymouth","E06000026",114560,37337,15083,22254,69889,9997,31422,12129,13830,5463,15119,8234,6043,842,12706,8153,4553,645,645,7334,2059,5275
"2021","Torbay","E06000027",62997,21884,11086,10798,37376,7636,16284,6956,6270,3058,6725,3531,2757,437,6417,3971,2446,314,314,3737,1426,2311
"2021","Swindon","E06000030",95861,27218,10546,16672,62195,7777,32304,10851,15932,5521,11736,6378,4679,679,9700,6273,3427,678,678,6448,3089,3359
"2021","Cornwall","E06000052",250534,76862,39567,37295,158979,31464,73914,31653,29102,13159,29226,15581,11940,1705,23276,14263,9013,1099,1099,14693,4938,9755
"2021","Isles of Scilly","E06000053",942,307,162,145,563,132,275,147,110,18,101,77,21,3,53,32,21,2,2,72,20,52
"2021","Wiltshire","E06000054",215081,60574,29804,30770,144557,25704,75587,28617,34340,12630,23637,13168,9077,1392,18794,11460,7334,835,835,9950,3682,6268
"2021","Bournemouth, Christchurch and Poole","E06000058",173842,56531,26581,29950,103961,18113,48783,17892,22724,8167,19512,11692,6834,986,16306,9964,6342,1247,1247,13350,3754,9596
"2021","Dorset","E06000059",169261,51741,29714,22027,109832,27077,51800,22359,20023,9418,16641,9235,6412,994,13734,8173,5561,580,580,7688,2721,4967
"2021","East Devon","E07000040",66791,20056,11841,8215,43615,11007,20208,8465,8333,3410,7048,3940,2713,395,5135,3015,2120,217,217,3120,1075,2045
"2021","Exeter","E07000041",52554,17021,7114,9907,30126,4371,14163,5129,6788,2246,6563,4068,2168,327,4661,2852,1809,368,368,5407,856,4551
"2021","Mid Devon","E07000042",35635,10238,5218,5020,23626,4555,11686,4716,5015,1955,4141,2251,1661,229,3123,1921,1202,121,121,1771,703,1068
"2021","North Devon","E07000043",43198,13257,6825,6432,27755,5775,13057,5477,5290,2290,4879,2586,2014,279,3862,2357,1505,182,182,2186,836,1350
"2021","South Hams","E07000044",39335,11621,6564,5057,25800,5847,12720,5508,5055,2157,3994,2219,1550,225,3113,1841,1272,126,126,1914,667,1247
"2021","Teignbridge","E07000045",59838,18406,9885,8521,38493,8248,18093,7726,7239,3128,6724,3699,2589,436,5244,3195,2049,184,184,2939,1036,1903
"2021","Torridge","E07000046",30454,9330,4968,4362,19567,4440,9201,4301,3285,1615,3348,1814,1353,181,2474,1517,957,104,104,1557,589,968
"2021","West Devon","E07000047",24819,7300,4070,3230,16296,3717,8097,3643,3061,1393,2503,1437,938,128,1902,1127,775,77,77,1223,469,754
"2021","Cheltenham","E07000078",52902,18432,7352,11080,31401,4841,15088,5445,7447,2196,6710,4387,2023,300,4432,2730,1702,330,330,3069,694,2375
"2021","Cotswold","E07000079",40598,12263,6408,5855,26784,5728,13745,5709,5860,2176,4188,2537,1419,232,2976,1799,1177,147,147,1551,452,1099
"2021","Forest of Dean","E07000080",37217,10579,5603,4976,24817,5037,12033,5090,4626,2317,4315,2248,1770,297,3276,1900,1376,156,156,1821,735,1086
"2021","Gloucester","E07000081",55407,16754,6448,10306,35258,4503,17030,5975,7889,3166,7121,3829,2868,424,6255,3993,2262,349,349,3395,1227,2168
"2021","Stroud","E07000082",52379,15257,7641,7616,34832,6508,17579,6653,7885,3041,6166,3440,2358,368,4384,2572,1812,195,195,2290,812,1478
"2021","Tewkesbury","E07000083",40934,11554,5745,5809,27781,5007,13937,5238,6480,2219,4998,2824,1931,243,3717,2315,1402,122,122,1599,652,947
"2021","Mendip","E07000187",50294,15152,7610,7542,32702,6222,15621,6156,6680,2785,6069,3219,2476,374,4600,2801,1799,190,190,2440,891,1549
"2021","Sedgemoor","E07000188",53906,15620,7822,7798,35276,6858,16542,6777,6691,3074,6575,3359,2788,428,5030,3198,1832,271,271,3010,1174,1836
"2021","South Somerset","E07000189",75933,22859,11869,10990,49632,10492,23619,9921,9548,4150,8734,4577,3632,525,6490,4084,2406,297,297,3442,1280,2162
"2021","Somerset West and Taunton","E07000246",69988,22397,11499,10898,44312,9202,20871,8617,8762,3492,7819,4379,2975,465,6065,3752,2313,355,355,3279,1141,2138
"2021","Isle of Anglesey","W06000001",30823,10189,5223,4966,19438,3901,8642,3604,3175,1863,3296,1460,1627,209,3466,2087,1379,133,133,1196,512,684
"2021","Gwynedd","W06000002",51107,17664,8472,9192,30661,5354,13494,5437,5162,2895,6192,2922,2900,370,5348,3202,2146,273,273,2782,846,1936
"2021","Conwy","W06000003",52237,17909,9318,8591,32089,6674,14067,5945,5231,2891,5433,2715,2348,370,5698,3504,2194,217,217,2239,927,1312
"2021","Denbighshire","W06000004",42389,14107,6982,7125,26437,5027,11500,4627,4486,2387,4586,2136,2104,346,5124,3235,1889,200,200,1845,840,1005
"2021","Flintshire","W06000005",66911,19471,9639,9832,44660,7314,21092,7771,8850,4471,8158,4126,3494,538,7718,4706,3012,378,378,2780,1256,1524
"2021","Wrexham","W06000006",57914,17662,8042,9620,37799,5723,17048,6354,7039,3655,7265,3343,3431,491,7405,4887,2518,358,358,2453,1075,1378
"2021","Ceredigion","W06000008",30895,10202,5102,5100,18649,3956,8475,3784,3034,1657,3381,1864,1346,171,2674,1525,1149,163,163,2044,519,1525
"2021","Pembrokeshire","W06000009",55488,18507,9289,9218,34588,6977,15683,6703,5839,3141,5720,2815,2536,369,5966,3855,2111,242,242,2393,1022,1371
"2021","Carmarthenshire","W06000010",81763,25350,12569,12781,52512,9525,24720,9851,9692,5177,8874,4218,4088,568,8986,5374,3612,407,407,3901,1684,2217
"2021","Swansea","W06000011",104961,36154,15259,20895,62927,10017,28088,9823,12309,5956,10904,5656,4540,708,13217,8371,4846,701,701,5880,1731,4149
"2021","Neath Port Talbot","W06000012",62374,20368,9034,11334,39549,6145,17666,6516,6960,4190,6731,3084,3116,531,8651,5429,3222,356,356,2457,1151,1306
"2021","Bridgend","W06000013",62360,18664,8535,10129,41059,6504,18986,7043,7800,4143,7487,3586,3378,523,7754,4766,2988,328,328,2637,1206,1431
"2021","Vale of Glamorgan","W06000014",57450,17841,8491,9350,37148,6151,17926,6460,8012,3454,6247,3129,2708,410,6582,4270,2312,242,242,2461,1090,1371
"2021","Cardiff","W06000015",147334,47463,16526,30937,86631,9890,39597,12263,20101,7233,17536,10999,5615,922,18168,12157,6011,1440,1440,13240,3363,9877
"2021","Rhondda Cynon Taff","W06000016",103340,32170,14049,18121,66700,9551,29263,10733,11799,6731,13273,5869,6349,1055,14028,9103,4925,585,585,4470,1971,2499
"2021","Caerphilly","W06000018",76258,22966,10510,12456,50282,7422,22569,8302,9070,5197,9592,4213,4602,777,10333,6513,3820,366,366,3010,1479,1531
"2021","Blaenau Gwent","W06000019",30341,10175,4361,5814,19113,2612,8082,3130,2888,2064,3868,1642,1875,351,4372,2715,1657,179,179,1053,518,535
"2021","Torfaen","W06000020",40241,12316,5694,6622,26294,4003,11734,4384,4683,2667,5057,2311,2366,380,5307,3456,1851,193,193,1631,750,881
"2021","Monmouthshire","W06000021",40922,12287,6534,5753,26996,5583,13363,5309,5379,2675,4126,2235,1654,237,3771,2281,1490,153,153,1639,689,950
"2021","Newport","W06000022",66054,19997,8495,11502,42263,5325,19807,6611,9265,3931,8198,4147,3433,618,8455,5447,3008,478,478,3794,1930,1864
"2021","Powys","W06000023",60182,19841,10468,9373,37836,8223,17750,7725,6516,3509,6644,3373,2857,414,4962,2843,2119,257,257,2505,958,1547
"2021","Merthyr Tydfil","W06000024",25781,8258,3464,4794,16477,2138,7150,2635,2730,1785,3082,1257,1572,253,3851,2548,1303,256,256,1046,560,486
