"date","geography","geography code","Residence type: Total; measures: Value","Residence type: Lives in a household; measures: Value","Residence type: Lives in a communal establishment; measures: Value"
"2021","Hartlepool 001","E02002483",10239,10239,0
"2021","Hartlepool 002","E02002484",10278,10100,178
"2021","Hartlepool 003","E02002485",8001,7954,47
"2021","Hartlepool 007","E02002489",7125,6934,191
"2021","Hartlepool 008","E02002490",5805,5777,28
"2021","Hartlepool 009","E02002491",6473,6422,51
"2021","Hartlepool 010","E02002492",6774,6676,98
"2021","Hartlepool 011","E02002493",6751,6642,109
"2021","Hartlepool 012","E02002494",7673,7622,51
"2021","Hartlepool 014","E02006909",12688,12615,73
"2021","Hartlepool 015","E02007059",10532,10490,42
"2021","Middlesbrough 001","E02002496",11864,10685,1179
"2021","Middlesbrough 002","E02002497",6112,6076,36
"2021","Middlesbrough 003","E02002498",8505,8439,66
"2021","Middlesbrough 004","E02002499",7680,7589,91
"2021","Middlesbrough 005","E02002500",5907,5800,107
"2021","Middlesbrough 006","E02002501",6266,6165,101
"2021","Middlesbrough 007","E02002502",9792,9753,39
"2021","Middlesbrough 008","E02002503",6835,6835,0
"2021","Middlesbrough 009","E02002504",9756,9655,101
"2021","Middlesbrough 010","E02002505",6386,6385,1
"2021","Middlesbrough 011","E02002506",5600,5297,303
"2021","Middlesbrough 012","E02002507",6236,6214,22
"2021","Middlesbrough 013","E02002508",5429,5421,8
"2021","Middlesbrough 014","E02002509",5143,5100,43
"2021","Middlesbrough 015","E02002510",7092,7092,0
"2021","Middlesbrough 017","E02002512",5337,5325,12
"2021","Middlesbrough 018","E02002513",10236,10040,196
"2021","Middlesbrough 019","E02002514",8340,8202,138
"2021","Middlesbrough 020","E02006811",11410,11347,63
"2021","Redcar and Cleveland 001","E02002515",6473,6129,344
"2021","Redcar and Cleveland 002","E02002516",5870,5863,7
"2021","Redcar and Cleveland 003","E02002517",5315,5315,0
"2021","Redcar and Cleveland 004","E02002518",10877,10876,1
"2021","Redcar and Cleveland 005","E02002519",7473,7384,89
"2021","Redcar and Cleveland 006","E02002520",13088,13054,34
"2021","Redcar and Cleveland 007","E02002521",5874,5643,231
"2021","Redcar and Cleveland 009","E02002523",6388,6387,1
"2021","Redcar and Cleveland 010","E02002524",5398,5376,22
"2021","Redcar and Cleveland 011","E02002525",7971,7871,100
"2021","Redcar and Cleveland 012","E02002526",7707,7696,11
"2021","Redcar and Cleveland 013","E02002527",5086,5034,52
"2021","Redcar and Cleveland 015","E02002529",5740,5731,9
"2021","Redcar and Cleveland 016","E02002530",6180,6176,4
"2021","Redcar and Cleveland 018","E02002532",6735,6618,117
"2021","Redcar and Cleveland 019","E02002533",6565,6510,55
"2021","Redcar and Cleveland 020","E02002534",5574,5498,76
"2021","Redcar and Cleveland 021","E02006812",7603,7597,6
"2021","Redcar and Cleveland 022","E02006910",10612,10539,73
"2021","Stockton-on-Tees 001","E02002535",9165,9110,55
"2021","Stockton-on-Tees 002","E02002536",9328,9309,19
"2021","Stockton-on-Tees 003","E02002537",8365,8305,60
"2021","Stockton-on-Tees 004","E02002538",5637,5538,99
"2021","Stockton-on-Tees 005","E02002539",10538,10453,85
"2021","Stockton-on-Tees 006","E02002540",6066,6066,0
"2021","Stockton-on-Tees 007","E02002541",6014,5970,44
"2021","Stockton-on-Tees 008","E02002542",8024,7961,63
"2021","Stockton-on-Tees 009","E02002543",9246,9199,47
"2021","Stockton-on-Tees 010","E02002544",8919,7672,1247
"2021","Stockton-on-Tees 011","E02002545",5032,5021,11
"2021","Stockton-on-Tees 012","E02002546",7453,7350,103
"2021","Stockton-on-Tees 013","E02002547",6090,6078,12
"2021","Stockton-on-Tees 015","E02002549",7454,7402,52
"2021","Stockton-on-Tees 016","E02002550",6046,5974,72
"2021","Stockton-on-Tees 017","E02002551",5364,5258,106
"2021","Stockton-on-Tees 018","E02002552",7147,7147,0
"2021","Stockton-on-Tees 019","E02002553",5798,5756,42
"2021","Stockton-on-Tees 020","E02002554",5042,4954,88
"2021","Stockton-on-Tees 021","E02002555",10308,10255,53
"2021","Stockton-on-Tees 022","E02002556",7267,7265,2
"2021","Stockton-on-Tees 024","E02002558",11015,10793,222
"2021","Stockton-on-Tees 025","E02007060",6102,6010,92
"2021","Stockton-on-Tees 026","E02007061",8369,8236,133
"2021","Stockton-on-Tees 027","E02007062",7670,7562,108
"2021","Stockton-on-Tees 028","E02007063",9135,9135,0
"2021","Darlington 001","E02002559",9657,9656,1
"2021","Darlington 002","E02002560",6240,6217,23
"2021","Darlington 003","E02002561",5422,5414,8
"2021","Darlington 004","E02002562",5619,5529,90
"2021","Darlington 005","E02002563",5549,5408,141
"2021","Darlington 006","E02002564",9733,9729,4
"2021","Darlington 009","E02002567",9403,9344,59
"2021","Darlington 010","E02002568",6033,5936,97
"2021","Darlington 011","E02002569",9145,9071,74
"2021","Darlington 012","E02002570",7506,7306,200
"2021","Darlington 013","E02002571",6354,6283,71
"2021","Darlington 014","E02002572",6286,6279,7
"2021","Darlington 015","E02002573",9369,9220,149
"2021","Darlington 016","E02007058",11484,11427,57
"2021","County Durham 002","E02004290",5722,5677,45
"2021","County Durham 005","E02004291",7120,7108,12
"2021","County Durham 007","E02004292",7960,7894,66
"2021","County Durham 011","E02004293",9614,9506,108
"2021","County Durham 013","E02004294",7899,7836,63
"2021","County Durham 015","E02004295",7274,7242,32
"2021","County Durham 019","E02004296",8425,8360,65
"2021","County Durham 001","E02004297",7937,7843,94
"2021","County Durham 003","E02004298",9956,9859,97
"2021","County Durham 004","E02004299",8191,8092,99
"2021","County Durham 006","E02004300",7683,7683,0
"2021","County Durham 008","E02004301",9599,9507,92
"2021","County Durham 009","E02004302",7827,7799,28
"2021","County Durham 010","E02004303",11018,10927,91
"2021","County Durham 012","E02004304",9004,8880,124
"2021","County Durham 014","E02004305",10187,10157,30
"2021","County Durham 020","E02004306",5993,5987,6
"2021","County Durham 024","E02004307",6454,6365,89
"2021","County Durham 022","E02004308",7722,6670,1052
"2021","County Durham 023","E02004309",6194,6166,28
"2021","County Durham 026","E02004310",7826,7790,36
"2021","County Durham 027","E02004311",9129,9093,36
"2021","County Durham 028","E02004312",7425,7394,31
"2021","County Durham 029","E02004313",6746,6581,165
"2021","County Durham 030","E02004314",12666,6351,6315
"2021","County Durham 033","E02004315",13300,11944,1356
"2021","County Durham 031","E02004316",6479,6479,0
"2021","County Durham 038","E02004317",7318,7235,83
"2021","County Durham 041","E02004318",6584,6482,102
"2021","County Durham 044","E02004319",7962,7942,20
"2021","County Durham 016","E02004320",8557,8525,32
"2021","County Durham 017","E02004321",8166,7938,228
"2021","County Durham 018","E02004322",8659,8602,57
"2021","County Durham 021","E02004323",7383,7290,93
"2021","County Durham 025","E02004324",5762,5747,15
"2021","County Durham 032","E02004325",9012,8821,191
"2021","County Durham 034","E02004326",6766,6713,53
"2021","County Durham 036","E02004327",5549,5490,59
"2021","County Durham 035","E02004328",7228,7172,56
"2021","County Durham 037","E02004329",6456,6373,83
"2021","County Durham 039","E02004330",5944,5823,121
"2021","County Durham 040","E02004331",7186,7112,74
"2021","County Durham 043","E02004332",7362,7329,33
"2021","County Durham 047","E02004333",6690,6689,1
"2021","County Durham 048","E02004334",7001,6978,23
"2021","County Durham 049","E02004335",7886,7847,39
"2021","County Durham 050","E02004336",6713,6668,45
"2021","County Durham 052","E02004337",10501,10450,51
"2021","County Durham 053","E02004338",7323,7282,41
"2021","County Durham 054","E02004339",7029,6994,35
"2021","County Durham 059","E02004340",10420,10328,92
"2021","County Durham 060","E02004341",8715,8647,68
"2021","County Durham 061","E02004342",5606,5501,105
"2021","County Durham 062","E02004343",5536,5451,85
"2021","County Durham 063","E02004344",6972,6931,41
"2021","County Durham 064","E02004345",12569,12521,48
"2021","County Durham 042","E02004348",7828,7798,30
"2021","County Durham 045","E02004349",9361,9321,40
"2021","County Durham 046","E02004350",9778,9664,114
"2021","County Durham 051","E02004351",7235,7099,136
"2021","County Durham 055","E02004352",8180,8077,103
"2021","County Durham 056","E02004353",7205,7084,121
"2021","County Durham 057","E02004354",9086,9012,74
"2021","County Durham 058","E02004355",7039,6999,40
"2021","County Durham 067","E02007022",12145,11634,511
"2021","Northumberland 004","E02005702",6694,6458,236
"2021","Northumberland 005","E02005703",6804,6716,88
"2021","Northumberland 006","E02005704",12641,12599,42
"2021","Northumberland 007","E02005705",7598,7564,34
"2021","Northumberland 001","E02005706",9194,8993,201
"2021","Northumberland 002","E02005707",7032,6964,68
"2021","Northumberland 003","E02005708",10021,9972,49
"2021","Northumberland 022","E02005709",6850,6636,214
"2021","Northumberland 023","E02005710",9379,9123,256
"2021","Northumberland 024","E02005711",7822,7818,4
"2021","Northumberland 025","E02005712",9406,9396,10
"2021","Northumberland 026","E02005713",6272,6272,0
"2021","Northumberland 029","E02005715",9260,9073,187
"2021","Northumberland 030","E02005717",7374,7342,32
"2021","Northumberland 031","E02005718",6268,6268,0
"2021","Northumberland 032","E02005719",8155,8155,0
"2021","Northumberland 008","E02005720",12139,10837,1302
"2021","Northumberland 011","E02005721",5447,5356,91
"2021","Northumberland 015","E02005722",9474,9384,90
"2021","Northumberland 016","E02005723",6030,5987,43
"2021","Northumberland 018","E02005724",6633,6594,39
"2021","Northumberland 033","E02005725",7021,6910,111
"2021","Northumberland 034","E02005726",7923,7669,254
"2021","Northumberland 019","E02005727",6065,6050,15
"2021","Northumberland 037","E02005728",6718,6710,8
"2021","Northumberland 036","E02005729",5578,5479,99
"2021","Northumberland 035","E02005730",12643,12458,185
"2021","Northumberland 038","E02005731",10735,10669,66
"2021","Northumberland 040","E02005733",8278,8201,77
"2021","Northumberland 009","E02005734",5950,5862,88
"2021","Northumberland 010","E02005735",7142,7142,0
"2021","Northumberland 013","E02005736",8709,8666,43
"2021","Northumberland 017","E02005739",9005,8980,25
"2021","Northumberland 020","E02005740",10092,9977,115
"2021","Northumberland 021","E02005741",8477,8344,133
"2021","Northumberland 041","E02007105",12429,12349,80
"2021","Northumberland 042","E02007106",14549,14499,50
"2021","Northumberland 043","E02007107",8759,8630,129
"2021","Newcastle upon Tyne 002","E02001709",10345,10256,89
"2021","Newcastle upon Tyne 003","E02001710",10103,9974,129
"2021","Newcastle upon Tyne 004","E02001711",9892,9737,155
"2021","Newcastle upon Tyne 005","E02001712",9336,9043,293
"2021","Newcastle upon Tyne 006","E02001713",10047,9934,113
"2021","Newcastle upon Tyne 007","E02001714",9695,9631,64
"2021","Newcastle upon Tyne 008","E02001715",11802,11722,80
"2021","Newcastle upon Tyne 011","E02001718",6621,6585,36
"2021","Newcastle upon Tyne 012","E02001719",8577,8573,4
"2021","Newcastle upon Tyne 013","E02001720",9505,9447,58
"2021","Newcastle upon Tyne 014","E02001721",10746,10662,84
"2021","Newcastle upon Tyne 015","E02001722",9480,9451,29
"2021","Newcastle upon Tyne 016","E02001723",7173,7120,53
"2021","Newcastle upon Tyne 017","E02001724",8972,8662,310
"2021","Newcastle upon Tyne 018","E02001725",9175,9100,75
"2021","Newcastle upon Tyne 019","E02001726",11810,11766,44
"2021","Newcastle upon Tyne 020","E02001727",8745,8739,6
"2021","Newcastle upon Tyne 021","E02001728",9451,9411,40
"2021","Newcastle upon Tyne 022","E02001729",12297,11299,998
"2021","Newcastle upon Tyne 025","E02001732",5688,5644,44
"2021","Newcastle upon Tyne 027","E02001734",8173,8028,145
"2021","Newcastle upon Tyne 028","E02001735",6620,6548,72
"2021","Newcastle upon Tyne 030","E02001737",6187,6111,76
"2021","Newcastle upon Tyne 031","E02006893",10853,10824,29
"2021","Newcastle upon Tyne 032","E02007095",9934,9863,71
"2021","Newcastle upon Tyne 033","E02007096",5929,5891,38
"2021","Newcastle upon Tyne 034","E02007097",8666,6443,2223
"2021","Newcastle upon Tyne 035","E02007098",6507,6400,107
"2021","Newcastle upon Tyne 036","E02007099",10250,5751,4499
"2021","Newcastle upon Tyne 037","E02007100",8418,3578,4840
"2021","Newcastle upon Tyne 038","E02007101",9609,9454,155
"2021","Newcastle upon Tyne 039","E02007102",7531,5638,1893
"2021","Newcastle upon Tyne 040","E02007103",6458,6251,207
"2021","Newcastle upon Tyne 041","E02007104",5536,5347,189
"2021","North Tyneside 001","E02001738",6164,6164,0
"2021","North Tyneside 002","E02001739",7266,7207,59
"2021","North Tyneside 003","E02001740",5913,5873,40
"2021","North Tyneside 004","E02001741",7724,7723,1
"2021","North Tyneside 005","E02001742",5773,5724,49
"2021","North Tyneside 006","E02001743",7574,7365,209
"2021","North Tyneside 007","E02001744",8172,8137,35
"2021","North Tyneside 008","E02001745",6694,6693,1
"2021","North Tyneside 009","E02001746",8186,8168,18
"2021","North Tyneside 010","E02001747",6232,6222,10
"2021","North Tyneside 011","E02001748",8661,8661,0
"2021","North Tyneside 012","E02001749",6367,6321,46
"2021","North Tyneside 013","E02001750",6791,6721,70
"2021","North Tyneside 014","E02001751",6664,6617,47
"2021","North Tyneside 015","E02001752",6404,6404,0
"2021","North Tyneside 016","E02001753",6153,6152,1
"2021","North Tyneside 017","E02001754",5782,5731,51
"2021","North Tyneside 018","E02001755",9896,9787,109
"2021","North Tyneside 019","E02001756",9306,9266,40
"2021","North Tyneside 020","E02001757",5839,5839,0
"2021","North Tyneside 021","E02001758",5603,5603,0
"2021","North Tyneside 022","E02001759",6137,6073,64
"2021","North Tyneside 023","E02001760",7745,7706,39
"2021","North Tyneside 024","E02001761",5514,5464,50
"2021","North Tyneside 025","E02001762",6753,6753,0
"2021","North Tyneside 026","E02001763",6408,6378,30
"2021","North Tyneside 027","E02001764",7563,7475,88
"2021","North Tyneside 028","E02001765",7643,7549,94
"2021","North Tyneside 029","E02001766",7175,7157,18
"2021","North Tyneside 030","E02001767",6864,6784,80
"2021","South Tyneside 001","E02001768",8078,7939,139
"2021","South Tyneside 002","E02001769",7419,7363,56
"2021","South Tyneside 003","E02001770",5951,5778,173
"2021","South Tyneside 004","E02001771",6194,6120,74
"2021","South Tyneside 005","E02001772",5025,4997,28
"2021","South Tyneside 006","E02001773",5244,5244,0
"2021","South Tyneside 007","E02001774",5237,5130,107
"2021","South Tyneside 008","E02001775",5435,5417,18
"2021","South Tyneside 009","E02001776",9055,8973,82
"2021","South Tyneside 010","E02001777",6753,6606,147
"2021","South Tyneside 011","E02001778",5617,5514,103
"2021","South Tyneside 012","E02001779",5348,5266,82
"2021","South Tyneside 013","E02001780",6042,6042,0
"2021","South Tyneside 014","E02001781",5391,5391,0
"2021","South Tyneside 015","E02001782",10190,10134,56
"2021","South Tyneside 016","E02001783",7202,7201,1
"2021","South Tyneside 017","E02001784",6569,6547,22
"2021","South Tyneside 018","E02001785",7590,7590,0
"2021","South Tyneside 019","E02001786",6610,6606,4
"2021","South Tyneside 020","E02001787",5361,5317,44
"2021","South Tyneside 021","E02001788",5778,5737,41
"2021","South Tyneside 022","E02001789",5792,5792,0
"2021","South Tyneside 023","E02001790",5896,5896,0
"2021","Sunderland 001","E02001791",5480,5480,0
"2021","Sunderland 002","E02001792",6824,6668,156
"2021","Sunderland 003","E02001793",8274,8268,6
"2021","Sunderland 004","E02001794",8840,8665,175
"2021","Sunderland 005","E02001795",7274,7212,62
"2021","Sunderland 006","E02001796",8568,8402,166
"2021","Sunderland 007","E02001797",5876,5830,46
"2021","Sunderland 008","E02001798",8213,8101,112
"2021","Sunderland 009","E02001799",9356,9303,53
"2021","Sunderland 010","E02001800",6693,6693,0
"2021","Sunderland 011","E02001801",5838,5357,481
"2021","Sunderland 012","E02001802",7354,7350,4
"2021","Sunderland 013","E02001803",8544,7379,1165
"2021","Sunderland 014","E02001804",6215,6100,115
"2021","Sunderland 015","E02001805",5501,5409,92
"2021","Sunderland 016","E02001806",7655,7551,104
"2021","Sunderland 017","E02001807",8653,8563,90
"2021","Sunderland 018","E02001808",5590,5590,0
"2021","Sunderland 019","E02001809",6491,6484,7
"2021","Sunderland 020","E02001810",8224,8222,2
"2021","Sunderland 021","E02001811",8699,8698,1
"2021","Sunderland 022","E02001812",9978,9832,146
"2021","Sunderland 023","E02001813",9686,9641,45
"2021","Sunderland 024","E02001814",6172,6057,115
"2021","Sunderland 025","E02001815",9787,9747,40
"2021","Sunderland 026","E02001816",6796,6759,37
"2021","Sunderland 027","E02001817",6689,6644,45
"2021","Sunderland 028","E02001818",9496,9419,77
"2021","Sunderland 029","E02001819",6883,6883,0
"2021","Sunderland 030","E02001820",9690,9653,37
"2021","Sunderland 031","E02001821",5604,5604,0
"2021","Sunderland 032","E02001822",7665,7509,156
"2021","Sunderland 033","E02001823",8045,8005,40
"2021","Sunderland 034","E02001824",8539,8498,41
"2021","Sunderland 035","E02001825",7609,7443,166
"2021","Sunderland 036","E02001826",7371,7371,0
"2021","Gateshead 001","E02001682",8529,8484,45
"2021","Gateshead 002","E02001683",9348,9239,109
"2021","Gateshead 003","E02001684",6667,6621,46
"2021","Gateshead 004","E02001685",8037,8028,9
"2021","Gateshead 005","E02001686",6710,6618,92
"2021","Gateshead 007","E02001688",7606,7571,35
"2021","Gateshead 008","E02001689",7507,7286,221
"2021","Gateshead 009","E02001690",7021,6890,131
"2021","Gateshead 010","E02001691",8490,8436,54
"2021","Gateshead 011","E02001692",6313,6310,3
"2021","Gateshead 012","E02001693",5233,5231,2
"2021","Gateshead 013","E02001694",6220,6220,0
"2021","Gateshead 014","E02001695",5777,5775,2
"2021","Gateshead 015","E02001696",9146,9057,89
"2021","Gateshead 016","E02001697",7408,7333,75
"2021","Gateshead 017","E02001698",6964,6926,38
"2021","Gateshead 018","E02001699",6549,6545,4
"2021","Gateshead 019","E02001700",10255,10243,12
"2021","Gateshead 020","E02001701",6236,6077,159
"2021","Gateshead 021","E02001702",7869,7820,49
"2021","Gateshead 022","E02001703",5569,5568,1
"2021","Gateshead 023","E02001704",6791,6765,26
"2021","Gateshead 025","E02001706",7924,7869,55
"2021","Gateshead 026","E02001707",8274,8096,178
"2021","Gateshead 027","E02006841",7691,6715,976
"2021","Gateshead 028","E02006842",5126,5040,86
"2021","Gateshead 029","E02007094",6891,6833,58
"2021","Halton 001","E02002574",8699,8659,40
"2021","Halton 002","E02002575",9453,9438,15
"2021","Halton 003","E02002576",7447,7278,169
"2021","Halton 004","E02002577",7312,7268,44
"2021","Halton 005","E02002578",8405,8405,0
"2021","Halton 006","E02002579",7890,7808,82
"2021","Halton 007","E02002580",7878,7827,51
"2021","Halton 008","E02002581",7107,7041,66
"2021","Halton 009","E02002582",9317,9166,151
"2021","Halton 010","E02002583",7670,7670,0
"2021","Halton 011","E02002584",7325,7269,56
"2021","Halton 012","E02002585",10654,10631,23
"2021","Halton 013","E02002586",9514,9440,74
"2021","Halton 014","E02002587",6452,6450,2
"2021","Halton 015","E02002588",7101,7002,99
"2021","Halton 016","E02002589",6251,6245,6
"2021","Warrington 001","E02002590",7304,6329,975
"2021","Warrington 002","E02002591",6483,6451,32
"2021","Warrington 003","E02002592",6220,5985,235
"2021","Warrington 004","E02002593",5090,5076,14
"2021","Warrington 005","E02002594",5520,5520,0
"2021","Warrington 006","E02002595",8070,8070,0
"2021","Warrington 007","E02002596",8046,7928,118
"2021","Warrington 008","E02002597",9211,9172,39
"2021","Warrington 009","E02002598",11238,11130,108
"2021","Warrington 010","E02002599",11068,10914,154
"2021","Warrington 011","E02002600",9210,9129,81
"2021","Warrington 012","E02002601",9033,9012,21
"2021","Warrington 013","E02002602",8193,8172,21
"2021","Warrington 014","E02002603",6937,6894,43
"2021","Warrington 015","E02002604",7748,7683,65
"2021","Warrington 016","E02002605",8930,8921,9
"2021","Warrington 017","E02002606",11285,11063,222
"2021","Warrington 018","E02002607",11239,11158,81
"2021","Warrington 019","E02002608",8226,8099,127
"2021","Warrington 020","E02002609",9664,9573,91
"2021","Warrington 021","E02002610",12661,12559,102
"2021","Warrington 022","E02002611",7785,7705,80
"2021","Warrington 023","E02002612",9149,9020,129
"2021","Warrington 024","E02002613",6846,6471,375
"2021","Warrington 025","E02002614",5815,5815,0
"2021","Blackburn with Darwen 001","E02002615",10822,10786,36
"2021","Blackburn with Darwen 002","E02002616",9598,9534,64
"2021","Blackburn with Darwen 003","E02002617",9637,9597,40
"2021","Blackburn with Darwen 004","E02002618",8020,7945,75
"2021","Blackburn with Darwen 005","E02002619",9407,9180,227
"2021","Blackburn with Darwen 006","E02002620",9071,8814,257
"2021","Blackburn with Darwen 007","E02002621",8576,8574,2
"2021","Blackburn with Darwen 008","E02002622",11082,10802,280
"2021","Blackburn with Darwen 009","E02002623",10490,10428,62
"2021","Blackburn with Darwen 010","E02002624",8739,8672,67
"2021","Blackburn with Darwen 011","E02002625",10069,10020,49
"2021","Blackburn with Darwen 012","E02002626",7278,7233,45
"2021","Blackburn with Darwen 013","E02002627",7511,7493,18
"2021","Blackburn with Darwen 014","E02002628",6848,6717,131
"2021","Blackburn with Darwen 015","E02002629",5971,5971,0
"2021","Blackburn with Darwen 016","E02002630",6342,6233,109
"2021","Blackburn with Darwen 017","E02002631",8962,8934,28
"2021","Blackburn with Darwen 018","E02002632",6317,6315,2
"2021","Blackpool 001","E02002633",7621,7505,116
"2021","Blackpool 002","E02002634",8005,7974,31
"2021","Blackpool 003","E02002635",7796,7637,159
"2021","Blackpool 004","E02002636",8001,8001,0
"2021","Blackpool 005","E02002637",6252,6220,32
"2021","Blackpool 006","E02002638",6489,5788,701
"2021","Blackpool 007","E02002639",6079,6065,14
"2021","Blackpool 008","E02002640",7101,7038,63
"2021","Blackpool 009","E02002641",7987,7869,118
"2021","Blackpool 010","E02002642",7071,6606,465
"2021","Blackpool 011","E02002643",7787,7753,34
"2021","Blackpool 012","E02002644",7857,7770,87
"2021","Blackpool 013","E02002645",6314,5716,598
"2021","Blackpool 014","E02002646",7074,7034,40
"2021","Blackpool 015","E02002647",7997,7941,56
"2021","Blackpool 016","E02002648",7095,7084,11
"2021","Blackpool 017","E02002649",8352,8054,298
"2021","Blackpool 018","E02002650",8307,8264,43
"2021","Blackpool 019","E02002651",7853,7700,153
"2021","Cheshire East 022","E02003811",7608,7570,38
"2021","Cheshire East 023","E02003812",6669,6591,78
"2021","Cheshire East 024","E02003813",6049,5964,85
"2021","Cheshire East 025","E02003814",8376,8373,3
"2021","Cheshire East 026","E02003815",7589,7514,75
"2021","Cheshire East 027","E02003816",7516,7440,76
"2021","Cheshire East 028","E02003817",7681,7624,57
"2021","Cheshire East 029","E02003818",5698,5628,70
"2021","Cheshire East 030","E02003819",6567,6486,81
"2021","Cheshire East 031","E02003820",9768,9727,41
"2021","Cheshire East 032","E02003821",5590,5590,0
"2021","Cheshire East 033","E02003822",11541,11492,49
"2021","Cheshire East 040","E02003823",6880,6844,36
"2021","Cheshire East 042","E02003824",6507,6470,37
"2021","Cheshire East 034","E02003825",6332,6332,0
"2021","Cheshire East 035","E02003826",8851,8709,142
"2021","Cheshire East 036","E02003827",9494,9404,90
"2021","Cheshire East 037","E02003828",6559,6525,34
"2021","Cheshire East 038","E02003829",5567,5265,302
"2021","Cheshire East 039","E02003830",7983,7895,88
"2021","Cheshire East 041","E02003831",10148,10051,97
"2021","Cheshire East 043","E02003832",6586,6577,9
"2021","Cheshire East 044","E02003833",6355,6352,3
"2021","Cheshire East 045","E02003834",7066,6964,102
"2021","Cheshire East 046","E02003835",8313,8293,20
"2021","Cheshire East 047","E02003836",6968,6864,104
"2021","Cheshire East 048","E02003838",8222,8221,1
"2021","Cheshire East 050","E02003839",7084,6993,91
"2021","Cheshire East 051","E02003840",10834,10743,91
"2021","Cheshire East 001","E02003853",6145,6064,81
"2021","Cheshire East 002","E02003854",6436,6430,6
"2021","Cheshire East 003","E02003855",6429,6325,104
"2021","Cheshire East 004","E02003856",11452,11411,41
"2021","Cheshire East 005","E02003857",6781,6781,0
"2021","Cheshire East 006","E02003858",6863,6839,24
"2021","Cheshire East 007","E02003859",12546,11901,645
"2021","Cheshire East 008","E02003860",7289,7289,0
"2021","Cheshire East 009","E02003861",6427,6382,45
"2021","Cheshire East 011","E02003862",5267,5111,156
"2021","Cheshire East 010","E02003863",6829,6829,0
"2021","Cheshire East 012","E02003864",8578,8398,180
"2021","Cheshire East 013","E02003865",7941,7892,49
"2021","Cheshire East 014","E02003866",6253,6253,0
"2021","Cheshire East 015","E02003867",7667,7581,86
"2021","Cheshire East 016","E02003868",8421,8421,0
"2021","Cheshire East 017","E02003869",7325,7109,216
"2021","Cheshire East 018","E02003870",10422,10331,91
"2021","Cheshire East 019","E02003871",6865,6865,0
"2021","Cheshire East 020","E02003872",10191,10164,27
"2021","Cheshire East 021","E02003873",6212,6124,88
"2021","Cheshire East 052","E02007030",7406,6779,627
"2021","Cheshire East 053","E02007031",8635,8592,43
"2021","Cheshire West and Chester 022","E02003794",8658,8532,126
"2021","Cheshire West and Chester 025","E02003795",6360,5605,755
"2021","Cheshire West and Chester 027","E02003796",7306,7304,2
"2021","Cheshire West and Chester 028","E02003797",10001,9731,270
"2021","Cheshire West and Chester 029","E02003798",6243,6176,67
"2021","Cheshire West and Chester 031","E02003799",7341,7309,32
"2021","Cheshire West and Chester 030","E02003800",7125,7087,38
"2021","Cheshire West and Chester 032","E02003801",7117,7061,56
"2021","Cheshire West and Chester 033","E02003802",8568,7991,577
"2021","Cheshire West and Chester 034","E02003803",10245,8678,1567
"2021","Cheshire West and Chester 036","E02003804",6915,6913,2
"2021","Cheshire West and Chester 039","E02003805",6345,6272,73
"2021","Cheshire West and Chester 041","E02003806",8299,8229,70
"2021","Cheshire West and Chester 043","E02003807",8816,8771,45
"2021","Cheshire West and Chester 044","E02003808",6517,6517,0
"2021","Cheshire West and Chester 046","E02003809",8189,8094,95
"2021","Cheshire West and Chester 047","E02003810",9774,9720,54
"2021","Cheshire West and Chester 001","E02003841",7912,7879,33
"2021","Cheshire West and Chester 004","E02003842",5626,5587,39
"2021","Cheshire West and Chester 005","E02003843",6435,6400,35
"2021","Cheshire West and Chester 006","E02003844",6636,6635,1
"2021","Cheshire West and Chester 007","E02003845",11017,10945,72
"2021","Cheshire West and Chester 008","E02003846",6869,6845,24
"2021","Cheshire West and Chester 009","E02003847",9808,9799,9
"2021","Cheshire West and Chester 010","E02003848",5299,5254,45
"2021","Cheshire West and Chester 011","E02003849",8560,8531,29
"2021","Cheshire West and Chester 013","E02003850",5090,5083,7
"2021","Cheshire West and Chester 014","E02003851",5797,5741,56
"2021","Cheshire West and Chester 016","E02003852",6478,6451,27
"2021","Cheshire West and Chester 002","E02003874",9179,9104,75
"2021","Cheshire West and Chester 003","E02003875",6447,6445,2
"2021","Cheshire West and Chester 012","E02003876",5701,5692,9
"2021","Cheshire West and Chester 015","E02003877",9598,9487,111
"2021","Cheshire West and Chester 017","E02003878",9261,9032,229
"2021","Cheshire West and Chester 018","E02003879",9159,9109,50
"2021","Cheshire West and Chester 019","E02003880",6582,6553,29
"2021","Cheshire West and Chester 020","E02003881",5845,5845,0
"2021","Cheshire West and Chester 021","E02003882",9474,9474,0
"2021","Cheshire West and Chester 023","E02003883",11195,11189,6
"2021","Cheshire West and Chester 024","E02003884",8930,8876,54
"2021","Cheshire West and Chester 026","E02003885",6448,6398,50
"2021","Cheshire West and Chester 035","E02003886",6559,6462,97
"2021","Cheshire West and Chester 037","E02003887",6931,6929,2
"2021","Cheshire West and Chester 038","E02003888",6487,6374,113
"2021","Cheshire West and Chester 040","E02003889",6516,6499,17
"2021","Cheshire West and Chester 042","E02003890",7058,7047,11
"2021","Cheshire West and Chester 045","E02003891",6434,6433,1
"2021","Allerdale 001","E02003965",10979,10853,126
"2021","Allerdale 002","E02003966",7000,6975,25
"2021","Allerdale 003","E02003967",8108,8097,11
"2021","Allerdale 004","E02003968",8825,8742,83
"2021","Allerdale 005","E02003969",6548,6485,63
"2021","Allerdale 006","E02003970",8197,8128,69
"2021","Allerdale 007","E02003971",7732,7645,87
"2021","Allerdale 008","E02003972",8969,8952,17
"2021","Allerdale 009","E02003973",8611,8554,57
"2021","Allerdale 010","E02003974",7668,7571,97
"2021","Allerdale 011","E02003975",7237,7086,151
"2021","Allerdale 012","E02003976",6279,6084,195
"2021","Barrow-in-Furness 001","E02003977",6181,6151,30
"2021","Barrow-in-Furness 002","E02003978",5731,5688,43
"2021","Barrow-in-Furness 003","E02003979",7770,7619,151
"2021","Barrow-in-Furness 004","E02003980",6755,6752,3
"2021","Barrow-in-Furness 005","E02003981",6468,6397,71
"2021","Barrow-in-Furness 006","E02003982",8101,8012,89
"2021","Barrow-in-Furness 007","E02003983",7259,7227,32
"2021","Barrow-in-Furness 008","E02003984",6408,6314,94
"2021","Barrow-in-Furness 009","E02003985",6685,6669,16
"2021","Barrow-in-Furness 010","E02003986",6047,6047,0
"2021","Carlisle 001","E02003987",6007,5969,38
"2021","Carlisle 002","E02003988",6485,6422,63
"2021","Carlisle 003","E02003989",7491,7491,0
"2021","Carlisle 004","E02003990",10998,10852,146
"2021","Carlisle 005","E02003991",7559,7483,76
"2021","Carlisle 006","E02003992",8023,7781,242
"2021","Carlisle 007","E02003993",8799,8780,19
"2021","Carlisle 008","E02003994",7213,7106,107
"2021","Carlisle 009","E02003995",10164,10093,71
"2021","Carlisle 010","E02003996",9334,9091,243
"2021","Carlisle 011","E02003997",9528,9468,60
"2021","Carlisle 012","E02003998",6544,6520,24
"2021","Carlisle 013","E02003999",11878,11785,93
"2021","Copeland 001","E02004000",5190,5135,55
"2021","Copeland 002","E02004001",5186,5159,27
"2021","Copeland 003","E02004002",9510,9444,66
"2021","Copeland 004","E02004003",11579,11519,60
"2021","Copeland 005","E02004004",9823,9754,69
"2021","Copeland 006","E02004005",7663,7654,9
"2021","Copeland 007","E02004006",8373,8307,66
"2021","Copeland 008","E02004007",9753,9402,351
"2021","Eden 001","E02004008",6437,6418,19
"2021","Eden 002","E02004009",6252,6170,82
"2021","Eden 003","E02004010",7730,7688,42
"2021","Eden 004","E02004011",10876,10806,70
"2021","Eden 005","E02004012",5500,5442,58
"2021","Eden 006","E02004013",10218,10198,20
"2021","Eden 007","E02004014",7724,7693,31
"2021","South Lakeland 001","E02004015",6127,5522,605
"2021","South Lakeland 002","E02004016",8022,7839,183
"2021","South Lakeland 003","E02004017",8878,8843,35
"2021","South Lakeland 004","E02004018",8320,8206,114
"2021","South Lakeland 005","E02004019",7649,7616,33
"2021","South Lakeland 006","E02004020",8934,8725,209
"2021","South Lakeland 007","E02004021",5269,5196,73
"2021","South Lakeland 008","E02004022",5552,5532,20
"2021","South Lakeland 009","E02004023",6329,5643,686
"2021","South Lakeland 010","E02004024",7436,7392,44
"2021","South Lakeland 011","E02004025",7970,7735,235
"2021","South Lakeland 012","E02004026",8107,8047,60
"2021","South Lakeland 013","E02004027",7942,7708,234
"2021","South Lakeland 014","E02004028",7917,7838,79
"2021","Burnley 001","E02005176",9113,9081,32
"2021","Burnley 002","E02005177",6703,6533,170
"2021","Burnley 003","E02005178",11817,11782,35
"2021","Burnley 004","E02005179",9325,9269,56
"2021","Burnley 005","E02005180",7076,6970,106
"2021","Burnley 006","E02005181",6646,6608,38
"2021","Burnley 007","E02005182",6308,6237,71
"2021","Burnley 008","E02005183",6028,6022,6
"2021","Burnley 009","E02005184",5075,5055,20
"2021","Burnley 010","E02005185",9618,9475,143
"2021","Burnley 011","E02005186",6191,6141,50
"2021","Burnley 014","E02006881",10746,10574,172
"2021","Chorley 001","E02005189",5329,5199,130
"2021","Chorley 002","E02005190",5969,5969,0
"2021","Chorley 003","E02005191",9736,9699,37
"2021","Chorley 004","E02005192",8847,8809,38
"2021","Chorley 005","E02005193",8715,8654,61
"2021","Chorley 006","E02005194",7986,7893,93
"2021","Chorley 007","E02005195",7883,6019,1864
"2021","Chorley 008","E02005196",11326,11187,139
"2021","Chorley 009","E02005197",7242,7216,26
"2021","Chorley 010","E02005198",9678,9651,27
"2021","Chorley 011","E02005199",7562,7559,3
"2021","Chorley 012","E02005200",9135,9046,89
"2021","Chorley 013","E02005201",8300,8190,110
"2021","Chorley 014","E02005202",10025,9941,84
"2021","Fylde 001","E02005203",8512,8385,127
"2021","Fylde 002","E02005204",12576,12441,135
"2021","Fylde 003","E02005205",6671,6189,482
"2021","Fylde 004","E02005206",7572,7525,47
"2021","Fylde 005","E02005207",8526,8468,58
"2021","Fylde 006","E02005208",10050,9674,376
"2021","Fylde 007","E02005209",8767,8712,55
"2021","Fylde 008","E02005210",10215,10011,204
"2021","Fylde 009","E02005211",8485,8376,109
"2021","Hyndburn 001","E02005212",11016,10978,38
"2021","Hyndburn 002","E02005213",11481,11308,173
"2021","Hyndburn 003","E02005214",6656,6630,26
"2021","Hyndburn 004","E02005215",12511,12376,135
"2021","Hyndburn 005","E02005216",5342,5311,31
"2021","Hyndburn 006","E02005217",13414,13279,135
"2021","Hyndburn 007","E02005218",7289,7155,134
"2021","Hyndburn 008","E02005219",8637,8585,52
"2021","Hyndburn 009","E02005220",5891,5857,34
"2021","Lancaster 001","E02005221",9943,9808,135
"2021","Lancaster 002","E02005222",5995,5943,52
"2021","Lancaster 003","E02005223",7244,7189,55
"2021","Lancaster 004","E02005224",5158,4963,195
"2021","Lancaster 005","E02005225",6024,6015,9
"2021","Lancaster 006","E02005226",7467,7253,214
"2021","Lancaster 008","E02005228",5775,5685,90
"2021","Lancaster 009","E02005229",5744,5603,141
"2021","Lancaster 010","E02005230",6590,6590,0
"2021","Lancaster 011","E02005231",8283,8281,2
"2021","Lancaster 013","E02005233",8041,7542,499
"2021","Lancaster 014","E02005234",9086,7497,1589
"2021","Lancaster 015","E02005235",5106,4971,135
"2021","Lancaster 016","E02005236",13421,13369,52
"2021","Lancaster 017","E02005237",10343,9929,414
"2021","Lancaster 018","E02005238",5620,5606,14
"2021","Lancaster 019","E02005239",10904,6324,4580
"2021","Lancaster 020","E02006871",12192,12136,56
"2021","Pendle 001","E02005240",5558,5546,12
"2021","Pendle 002","E02005241",5611,5572,39
"2021","Pendle 003","E02005242",6193,6193,0
"2021","Pendle 006","E02005245",6932,6910,22
"2021","Pendle 007","E02005246",5423,5359,64
"2021","Pendle 008","E02005247",9877,9871,6
"2021","Pendle 009","E02005248",7707,7673,34
"2021","Pendle 010","E02005249",10466,10415,51
"2021","Pendle 011","E02005250",9518,9518,0
"2021","Pendle 012","E02005251",7310,7209,101
"2021","Pendle 013","E02005252",10395,10321,74
"2021","Pendle 014","E02007003",10767,10631,136
"2021","Preston 001","E02005253",7167,6925,242
"2021","Preston 002","E02005254",9749,9638,111
"2021","Preston 003","E02005255",9549,9511,38
"2021","Preston 004","E02005256",6859,6605,254
"2021","Preston 005","E02005257",5775,5661,114
"2021","Preston 006","E02005258",8368,8187,181
"2021","Preston 007","E02005259",10544,10309,235
"2021","Preston 008","E02005260",6677,6614,63
"2021","Preston 009","E02005261",10272,10220,52
"2021","Preston 010","E02005262",7375,7335,40
"2021","Preston 011","E02005263",7155,7031,124
"2021","Preston 012","E02005264",12439,10539,1900
"2021","Preston 013","E02005265",10809,10724,85
"2021","Preston 014","E02005266",8984,8531,453
"2021","Preston 015","E02005267",6374,5085,1289
"2021","Preston 016","E02005268",9351,9292,59
"2021","Preston 017","E02005269",10382,9565,817
"2021","Ribble Valley 001","E02005270",7412,7071,341
"2021","Ribble Valley 002","E02005271",8160,8029,131
"2021","Ribble Valley 003","E02005272",8978,8867,111
"2021","Ribble Valley 004","E02005273",5917,5864,53
"2021","Ribble Valley 005","E02005274",7808,7774,34
"2021","Ribble Valley 006","E02005275",5741,5682,59
"2021","Ribble Valley 007","E02005276",8814,8730,84
"2021","Ribble Valley 008","E02005277",8727,8545,182
"2021","Rossendale 001","E02005278",7882,7774,108
"2021","Rossendale 002","E02005279",10342,10239,103
"2021","Rossendale 003","E02005280",11135,11066,69
"2021","Rossendale 004","E02005281",8951,8902,49
"2021","Rossendale 007","E02005284",6093,5973,120
"2021","Rossendale 008","E02005285",6294,6200,94
"2021","Rossendale 009","E02005286",7798,7712,86
"2021","Rossendale 010","E02006884",12375,12234,141
"2021","South Ribble 001","E02005287",5337,5311,26
"2021","South Ribble 002","E02005288",5961,5876,85
"2021","South Ribble 003","E02005289",5889,5882,7
"2021","South Ribble 004","E02005290",7129,7072,57
"2021","South Ribble 005","E02005291",5681,5680,1
"2021","South Ribble 006","E02005292",5657,5612,45
"2021","South Ribble 007","E02005293",5457,5333,124
"2021","South Ribble 008","E02005294",7053,6998,55
"2021","South Ribble 009","E02005295",7531,7460,71
"2021","South Ribble 010","E02005296",6116,6088,28
"2021","South Ribble 011","E02005297",8315,8266,49
"2021","South Ribble 012","E02005298",8367,8347,20
"2021","South Ribble 013","E02005299",7358,7342,16
"2021","South Ribble 014","E02005300",5051,4997,54
"2021","South Ribble 015","E02005301",6123,6070,53
"2021","South Ribble 016","E02005302",7675,7674,1
"2021","South Ribble 017","E02005303",6336,6245,91
"2021","West Lancashire 001","E02005304",9020,8994,26
"2021","West Lancashire 002","E02005305",7972,7853,119
"2021","West Lancashire 003","E02005306",7506,7413,93
"2021","West Lancashire 004","E02005307",9620,9523,97
"2021","West Lancashire 005","E02005308",6505,6406,99
"2021","West Lancashire 006","E02005309",8815,8783,32
"2021","West Lancashire 007","E02005310",10140,7699,2441
"2021","West Lancashire 008","E02005311",6797,5510,1287
"2021","West Lancashire 009","E02005312",6273,6270,3
"2021","West Lancashire 010","E02005313",8876,8769,107
"2021","West Lancashire 011","E02005314",6413,6335,78
"2021","West Lancashire 012","E02005315",8036,7906,130
"2021","West Lancashire 013","E02005316",6583,6543,40
"2021","West Lancashire 014","E02005317",7306,7305,1
"2021","West Lancashire 015","E02005318",7570,7509,61
"2021","Wyre 001","E02005319",8171,8112,59
"2021","Wyre 002","E02005320",5872,5742,130
"2021","Wyre 003","E02005321",6120,5766,354
"2021","Wyre 004","E02005322",10297,10144,153
"2021","Wyre 005","E02005323",7532,7511,21
"2021","Wyre 006","E02005324",7271,6759,512
"2021","Wyre 007","E02005325",9366,9323,43
"2021","Wyre 008","E02005326",8277,8202,75
"2021","Wyre 009","E02005327",6709,6675,34
"2021","Wyre 010","E02005328",7572,7538,34
"2021","Wyre 011","E02005329",9344,9274,70
"2021","Wyre 012","E02005330",8795,8779,16
"2021","Wyre 013","E02005331",8317,8172,145
"2021","Wyre 014","E02005332",8298,8298,0
"2021","Bolton 001","E02000984",7678,7677,1
"2021","Bolton 002","E02000985",7417,7417,0
"2021","Bolton 003","E02000986",8397,8358,39
"2021","Bolton 004","E02000987",7300,7193,107
"2021","Bolton 005","E02000988",9045,8940,105
"2021","Bolton 006","E02000989",8350,8350,0
"2021","Bolton 007","E02000990",8352,8345,7
"2021","Bolton 008","E02000991",7811,7794,17
"2021","Bolton 009","E02000992",6303,6264,39
"2021","Bolton 010","E02000993",8434,8434,0
"2021","Bolton 011","E02000994",9047,9047,0
"2021","Bolton 012","E02000995",8347,8281,66
"2021","Bolton 013","E02000996",8575,8427,148
"2021","Bolton 014","E02000997",6478,6367,111
"2021","Bolton 015","E02000998",10433,10367,66
"2021","Bolton 016","E02000999",8530,8031,499
"2021","Bolton 017","E02001000",9178,8989,189
"2021","Bolton 018","E02001001",8860,8662,198
"2021","Bolton 019","E02001002",9728,9728,0
"2021","Bolton 020","E02001003",7352,7319,33
"2021","Bolton 021","E02001004",9343,9342,1
"2021","Bolton 022","E02001005",9845,9665,180
"2021","Bolton 023","E02001006",8470,8435,35
"2021","Bolton 024","E02001007",10065,10050,15
"2021","Bolton 025","E02001008",9156,9079,77
"2021","Bolton 026","E02001009",7481,7477,4
"2021","Bolton 027","E02001010",6524,6468,56
"2021","Bolton 028","E02001011",9747,9747,0
"2021","Bolton 029","E02001012",9802,9798,4
"2021","Bolton 030","E02001013",6106,6067,39
"2021","Bolton 031","E02001014",8465,8425,40
"2021","Bolton 032","E02001015",8204,8027,177
"2021","Bolton 033","E02001016",8706,8705,1
"2021","Bolton 034","E02001017",10773,10767,6
"2021","Bolton 035","E02001018",7662,7662,0
"2021","Bury 001","E02001019",9040,8857,183
"2021","Bury 002","E02001020",5917,5892,25
"2021","Bury 003","E02001021",7506,7352,154
"2021","Bury 004","E02001022",8071,7905,166
"2021","Bury 005","E02001023",5695,5682,13
"2021","Bury 006","E02001024",8058,8005,53
"2021","Bury 007","E02001025",8152,8073,79
"2021","Bury 008","E02001026",11350,11269,81
"2021","Bury 009","E02001027",7282,7112,170
"2021","Bury 010","E02001028",7333,7295,38
"2021","Bury 011","E02001029",7779,7709,70
"2021","Bury 012","E02001030",6180,6156,24
"2021","Bury 013","E02001031",6877,6875,2
"2021","Bury 014","E02001032",7675,7588,87
"2021","Bury 015","E02001033",6180,6176,4
"2021","Bury 016","E02001034",8617,8542,75
"2021","Bury 017","E02001035",7218,7218,0
"2021","Bury 018","E02001036",7484,7482,2
"2021","Bury 019","E02001037",7215,7111,104
"2021","Bury 020","E02001038",5679,5666,13
"2021","Bury 021","E02001039",8602,8602,0
"2021","Bury 022","E02001040",6405,6193,212
"2021","Bury 023","E02001041",7731,7661,70
"2021","Bury 024","E02001042",6560,6538,22
"2021","Bury 025","E02001043",5686,5551,135
"2021","Bury 026","E02001044",9566,9533,33
"2021","Manchester 001","E02001045",8434,8419,15
"2021","Manchester 002","E02001046",11213,11155,58
"2021","Manchester 003","E02001047",10475,10389,86
"2021","Manchester 004","E02001048",9446,9389,57
"2021","Manchester 005","E02001049",10496,10397,99
"2021","Manchester 006","E02001050",8429,8268,161
"2021","Manchester 007","E02001051",9269,9218,51
"2021","Manchester 008","E02001052",15014,14885,129
"2021","Manchester 009","E02001053",11908,11852,56
"2021","Manchester 011","E02001055",9688,9434,254
"2021","Manchester 012","E02001056",8935,8868,67
"2021","Manchester 015","E02001059",11851,11741,110
"2021","Manchester 017","E02001061",10961,10933,28
"2021","Manchester 018","E02001062",10138,9241,897
"2021","Manchester 019","E02001063",11072,7690,3382
"2021","Manchester 020","E02001064",10779,10635,144
"2021","Manchester 021","E02001065",9528,9467,61
"2021","Manchester 022","E02001066",11567,9943,1624
"2021","Manchester 023","E02001067",11550,11548,2
"2021","Manchester 024","E02001068",11888,11878,10
"2021","Manchester 025","E02001069",12493,11944,549
"2021","Manchester 026","E02001070",11994,9130,2864
"2021","Manchester 028","E02001072",8939,8809,130
"2021","Manchester 029","E02001073",9363,9229,134
"2021","Manchester 030","E02001074",11798,11528,270
"2021","Manchester 031","E02001075",9135,9110,25
"2021","Manchester 032","E02001076",11275,8951,2324
"2021","Manchester 033","E02001077",7427,7426,1
"2021","Manchester 034","E02001078",10689,10662,27
"2021","Manchester 035","E02001079",9461,9434,27
"2021","Manchester 036","E02001080",9729,9715,14
"2021","Manchester 037","E02001081",6306,6306,0
"2021","Manchester 038","E02001082",6673,6601,72
"2021","Manchester 039","E02001083",8242,8168,74
"2021","Manchester 040","E02001084",8604,8571,33
"2021","Manchester 041","E02001085",8970,8970,0
"2021","Manchester 042","E02001086",6882,6677,205
"2021","Manchester 043","E02001087",9281,9247,34
"2021","Manchester 044","E02001088",9124,9037,87
"2021","Manchester 045","E02001089",8042,8030,12
"2021","Manchester 046","E02001090",6981,6960,21
"2021","Manchester 047","E02001091",8384,8378,6
"2021","Manchester 048","E02001092",9230,9227,3
"2021","Manchester 049","E02001093",9896,9711,185
"2021","Manchester 050","E02001094",9989,9987,2
"2021","Manchester 051","E02001095",9033,9003,30
"2021","Manchester 052","E02001096",8022,8021,1
"2021","Manchester 053","E02001097",8566,8499,67
"2021","Manchester 054","E02006902",7882,7472,410
"2021","Manchester 055","E02006912",10129,8230,1899
"2021","Manchester 056","E02006913",7803,7755,48
"2021","Manchester 057","E02006914",7859,3902,3957
"2021","Manchester 058","E02006915",9362,8701,661
"2021","Manchester 059","E02006916",6983,6976,7
"2021","Manchester 060","E02006917",6428,6184,244
"2021","Manchester 061","E02006983",7041,7026,15
"2021","Manchester 062","E02006984",5653,5591,62
"2021","Manchester 063","E02006985",9280,9263,17
"2021","Manchester 064","E02006986",6356,6356,0
"2021","Oldham 001","E02001098",5940,5938,2
"2021","Oldham 002","E02001099",5678,5676,2
"2021","Oldham 003","E02001100",6038,5903,135
"2021","Oldham 004","E02001101",5674,5674,0
"2021","Oldham 005","E02001102",6030,6030,0
"2021","Oldham 006","E02001103",5502,5497,5
"2021","Oldham 007","E02001104",7312,7243,69
"2021","Oldham 008","E02001105",5953,5933,20
"2021","Oldham 009","E02001106",6028,5952,76
"2021","Oldham 010","E02001107",6923,6919,4
"2021","Oldham 011","E02001108",5952,5880,72
"2021","Oldham 012","E02001109",7750,7667,83
"2021","Oldham 013","E02001110",6476,6421,55
"2021","Oldham 014","E02001111",9134,9074,60
"2021","Oldham 015","E02001112",5994,5992,2
"2021","Oldham 016","E02001113",9434,9412,22
"2021","Oldham 017","E02001114",8847,8762,85
"2021","Oldham 018","E02001115",5990,5928,62
"2021","Oldham 019","E02001116",7912,7872,40
"2021","Oldham 020","E02001117",6000,5995,5
"2021","Oldham 021","E02001118",6064,6046,18
"2021","Oldham 022","E02001119",12317,12102,215
"2021","Oldham 024","E02001121",8679,8644,35
"2021","Oldham 026","E02001123",7059,7039,20
"2021","Oldham 027","E02001124",6876,6876,0
"2021","Oldham 028","E02001125",7918,7880,38
"2021","Oldham 029","E02001126",9165,9125,40
"2021","Oldham 030","E02001127",7755,7753,2
"2021","Oldham 031","E02001128",7458,7448,10
"2021","Oldham 032","E02001129",6787,6693,94
"2021","Oldham 033","E02001130",5803,5784,19
"2021","Oldham 034","E02001131",5458,5458,0
"2021","Oldham 036","E02007000",7692,7599,93
"2021","Oldham 037","E02007001",8486,8438,48
"2021","Rochdale 001","E02001132",6628,6565,63
"2021","Rochdale 002","E02001133",6605,6593,12
"2021","Rochdale 003","E02001134",6325,6211,114
"2021","Rochdale 004","E02001135",8403,8335,68
"2021","Rochdale 005","E02001136",9545,9083,462
"2021","Rochdale 006","E02001137",6201,6195,6
"2021","Rochdale 007","E02001138",8647,8554,93
"2021","Rochdale 008","E02001139",10362,10348,14
"2021","Rochdale 009","E02001140",8149,8063,86
"2021","Rochdale 010","E02001141",12014,11945,69
"2021","Rochdale 011","E02001142",6016,5946,70
"2021","Rochdale 012","E02001143",11640,11583,57
"2021","Rochdale 013","E02001144",6338,6294,44
"2021","Rochdale 014","E02001145",7040,7022,18
"2021","Rochdale 015","E02001146",10296,10178,118
"2021","Rochdale 016","E02001147",10402,10349,53
"2021","Rochdale 017","E02001148",10458,10307,151
"2021","Rochdale 018","E02001149",10321,10321,0
"2021","Rochdale 019","E02001150",8981,8897,84
"2021","Rochdale 020","E02001151",10103,10004,99
"2021","Rochdale 021","E02001152",9776,9737,39
"2021","Rochdale 022","E02001153",12281,12244,37
"2021","Rochdale 023","E02001154",10132,10085,47
"2021","Rochdale 024","E02001155",7210,7126,84
"2021","Rochdale 025","E02001156",9903,9903,0
"2021","Salford 001","E02001157",8704,8659,45
"2021","Salford 002","E02001158",6061,6035,26
"2021","Salford 003","E02001159",7494,7494,0
"2021","Salford 004","E02001160",7272,7264,8
"2021","Salford 005","E02001161",5844,5843,1
"2021","Salford 006","E02001162",5820,5800,20
"2021","Salford 007","E02001163",9918,9883,35
"2021","Salford 008","E02001164",7676,6777,899
"2021","Salford 009","E02001165",6171,6168,3
"2021","Salford 010","E02001166",8245,8171,74
"2021","Salford 011","E02001167",6969,6902,67
"2021","Salford 012","E02001168",9894,9802,92
"2021","Salford 013","E02001169",10908,10865,43
"2021","Salford 014","E02001170",9853,9806,47
"2021","Salford 015","E02001171",6159,6140,19
"2021","Salford 017","E02001173",9504,8711,793
"2021","Salford 018","E02001174",5722,5625,97
"2021","Salford 019","E02001175",7502,7498,4
"2021","Salford 020","E02001176",11752,11613,139
"2021","Salford 021","E02001177",13344,13173,171
"2021","Salford 023","E02001179",7017,6975,42
"2021","Salford 024","E02001180",5686,5191,495
"2021","Salford 025","E02001181",5976,5958,18
"2021","Salford 026","E02001182",7353,7257,96
"2021","Salford 027","E02001183",7329,7267,62
"2021","Salford 029","E02001185",9698,9650,48
"2021","Salford 030","E02001186",10557,10557,0
"2021","Salford 031","E02006957",8279,8221,58
"2021","Salford 032","E02006958",8074,7938,136
"2021","Salford 033","E02006959",8024,7901,123
"2021","Salford 034","E02006960",9327,7481,1846
"2021","Salford 035","E02006961",6666,6487,179
"2021","Salford 036","E02006962",5123,5123,0
"2021","Salford 037","E02006963",6006,6004,2
"2021","Stockport 001","E02001187",7004,7000,4
"2021","Stockport 002","E02001188",8650,8647,3
"2021","Stockport 003","E02001189",8298,8275,23
"2021","Stockport 004","E02001190",7960,7780,180
"2021","Stockport 005","E02001191",5741,5710,31
"2021","Stockport 006","E02001192",6557,6455,102
"2021","Stockport 007","E02001193",6410,6377,33
"2021","Stockport 008","E02001194",6376,6340,36
"2021","Stockport 009","E02001195",7553,7473,80
"2021","Stockport 010","E02001196",7831,7751,80
"2021","Stockport 011","E02001197",6278,6273,5
"2021","Stockport 012","E02001198",7522,7405,117
"2021","Stockport 013","E02001199",7905,7901,4
"2021","Stockport 014","E02001200",7889,7798,91
"2021","Stockport 015","E02001201",5787,5773,14
"2021","Stockport 016","E02001202",6456,6419,37
"2021","Stockport 017","E02001203",5861,5848,13
"2021","Stockport 018","E02001204",8923,8856,67
"2021","Stockport 019","E02001205",8430,8416,14
"2021","Stockport 020","E02001206",7269,7161,108
"2021","Stockport 021","E02001207",6849,6827,22
"2021","Stockport 022","E02001208",7570,7499,71
"2021","Stockport 023","E02001209",7769,7708,61
"2021","Stockport 024","E02001210",7438,7385,53
"2021","Stockport 025","E02001211",6667,6593,74
"2021","Stockport 026","E02001212",6989,6926,63
"2021","Stockport 027","E02001213",9918,9783,135
"2021","Stockport 028","E02001214",8020,7999,21
"2021","Stockport 029","E02001215",5973,5903,70
"2021","Stockport 030","E02001216",7841,7841,0
"2021","Stockport 031","E02001217",6756,6704,52
"2021","Stockport 032","E02001218",6022,5949,73
"2021","Stockport 033","E02001219",5284,5278,6
"2021","Stockport 034","E02001220",5675,5675,0
"2021","Stockport 035","E02001221",5866,5813,53
"2021","Stockport 036","E02001222",6478,6401,77
"2021","Stockport 037","E02001223",6667,6596,71
"2021","Stockport 038","E02001224",5785,5697,88
"2021","Stockport 039","E02001225",7377,7373,4
"2021","Stockport 040","E02001226",7180,7108,72
"2021","Stockport 041","E02001227",5690,5674,16
"2021","Stockport 042","E02001228",6260,6167,93
"2021","Tameside 001","E02001229",10311,10241,70
"2021","Tameside 002","E02001230",5871,5871,0
"2021","Tameside 003","E02001231",7101,7101,0
"2021","Tameside 004","E02001232",8694,8621,73
"2021","Tameside 005","E02001233",7992,7887,105
"2021","Tameside 006","E02001234",7944,7852,92
"2021","Tameside 007","E02001235",7215,7159,56
"2021","Tameside 008","E02001236",6113,6022,91
"2021","Tameside 009","E02001237",7218,7146,72
"2021","Tameside 010","E02001238",7993,7986,7
"2021","Tameside 011","E02001239",9538,9504,34
"2021","Tameside 012","E02001240",6383,6383,0
"2021","Tameside 013","E02001241",11205,11174,31
"2021","Tameside 014","E02001242",7055,7002,53
"2021","Tameside 015","E02001243",8236,8224,12
"2021","Tameside 016","E02001244",5409,5409,0
"2021","Tameside 017","E02001245",8042,7951,91
"2021","Tameside 018","E02001246",7438,7310,128
"2021","Tameside 019","E02001247",7419,7369,50
"2021","Tameside 020","E02001248",11983,11981,2
"2021","Tameside 021","E02001249",6371,6371,0
"2021","Tameside 022","E02001250",6478,6433,45
"2021","Tameside 023","E02001251",6095,6066,29
"2021","Tameside 024","E02001252",7540,7540,0
"2021","Tameside 025","E02001253",5015,4982,33
"2021","Tameside 026","E02001254",5634,5621,13
"2021","Tameside 027","E02001255",7681,7679,2
"2021","Tameside 028","E02001256",10543,10359,184
"2021","Tameside 029","E02001257",9119,9068,51
"2021","Tameside 030","E02001258",7437,7374,63
"2021","Trafford 001","E02001259",11723,11656,67
"2021","Trafford 002","E02001260",7581,7569,12
"2021","Trafford 003","E02001261",8878,8874,4
"2021","Trafford 004","E02001262",8672,8649,23
"2021","Trafford 005","E02001263",8393,8282,111
"2021","Trafford 006","E02001264",8655,8655,0
"2021","Trafford 007","E02001265",8193,8146,47
"2021","Trafford 008","E02001266",6924,6907,17
"2021","Trafford 009","E02001267",7247,7122,125
"2021","Trafford 010","E02001268",7040,6954,86
"2021","Trafford 011","E02001269",8356,8346,10
"2021","Trafford 012","E02001270",8550,8454,96
"2021","Trafford 013","E02001271",6644,6644,0
"2021","Trafford 014","E02001272",8024,7992,32
"2021","Trafford 015","E02001273",9535,9453,82
"2021","Trafford 016","E02001274",8058,7937,121
"2021","Trafford 017","E02001275",8189,8116,73
"2021","Trafford 018","E02001276",8116,8105,11
"2021","Trafford 019","E02001277",9350,9341,9
"2021","Trafford 020","E02001278",8694,8625,69
"2021","Trafford 021","E02001279",8286,8253,33
"2021","Trafford 022","E02001280",8401,8341,60
"2021","Trafford 023","E02001281",7738,7737,1
"2021","Trafford 024","E02001282",10105,10060,45
"2021","Trafford 025","E02001283",9514,9441,73
"2021","Trafford 026","E02001284",8153,8153,0
"2021","Trafford 027","E02001285",7756,7644,112
"2021","Trafford 028","E02001286",8278,8214,64
"2021","Wigan 001","E02001287",6630,6630,0
"2021","Wigan 002","E02001288",8334,8285,49
"2021","Wigan 003","E02001289",10174,10174,0
"2021","Wigan 004","E02001290",6129,6078,51
"2021","Wigan 005","E02001291",7815,7809,6
"2021","Wigan 006","E02001292",8030,7994,36
"2021","Wigan 007","E02001293",6257,6214,43
"2021","Wigan 008","E02001294",7998,7913,85
"2021","Wigan 009","E02001295",7232,7128,104
"2021","Wigan 010","E02001296",9049,8964,85
"2021","Wigan 011","E02001297",6605,6552,53
"2021","Wigan 012","E02001298",8122,8087,35
"2021","Wigan 013","E02001299",8690,8611,79
"2021","Wigan 014","E02001300",7888,7793,95
"2021","Wigan 015","E02001301",9029,8885,144
"2021","Wigan 016","E02001302",7986,7895,91
"2021","Wigan 017","E02001303",9028,8974,54
"2021","Wigan 018","E02001304",12764,12763,1
"2021","Wigan 019","E02001305",8521,8492,29
"2021","Wigan 020","E02001306",7149,7149,0
"2021","Wigan 021","E02001307",11653,11653,0
"2021","Wigan 022","E02001308",5970,5912,58
"2021","Wigan 023","E02001309",8354,8261,93
"2021","Wigan 024","E02001310",9227,9151,76
"2021","Wigan 025","E02001311",8192,8192,0
"2021","Wigan 026","E02001312",8687,8184,503
"2021","Wigan 027","E02001313",8167,8090,77
"2021","Wigan 028","E02001314",8008,8008,0
"2021","Wigan 029","E02001315",9440,9440,0
"2021","Wigan 030","E02001316",7358,7321,37
"2021","Wigan 031","E02001317",9005,8806,199
"2021","Wigan 032","E02001318",7830,7830,0
"2021","Wigan 033","E02001319",8321,8200,121
"2021","Wigan 034","E02001320",7386,7362,24
"2021","Wigan 035","E02001321",8005,7955,50
"2021","Wigan 036","E02001322",7206,7086,120
"2021","Wigan 037","E02001323",7705,7705,0
"2021","Wigan 038","E02001324",8267,8234,33
"2021","Wigan 039","E02001325",8956,8907,49
"2021","Wigan 040","E02001326",8163,8163,0
"2021","Knowsley 001","E02001327",9422,9422,0
"2021","Knowsley 002","E02001328",10527,10525,2
"2021","Knowsley 003","E02001329",7472,7430,42
"2021","Knowsley 004","E02001330",9082,9054,28
"2021","Knowsley 005","E02001331",10130,10128,2
"2021","Knowsley 006","E02001332",7566,7541,25
"2021","Knowsley 007","E02001333",9467,9380,87
"2021","Knowsley 008","E02001334",6595,6595,0
"2021","Knowsley 009","E02001335",8232,8161,71
"2021","Knowsley 010","E02001336",7001,6922,79
"2021","Knowsley 011","E02001337",5848,5806,42
"2021","Knowsley 012","E02001338",6133,6100,33
"2021","Knowsley 013","E02001339",6404,6402,2
"2021","Knowsley 014","E02001340",9740,9719,21
"2021","Knowsley 015","E02001341",7499,7422,77
"2021","Knowsley 016","E02001342",7838,7653,185
"2021","Knowsley 017","E02001343",7214,7211,3
"2021","Knowsley 018","E02001344",5492,5362,130
"2021","Knowsley 019","E02001345",5402,5402,0
"2021","Knowsley 020","E02001346",7451,7451,0
"2021","Liverpool 001","E02001347",8039,7994,45
"2021","Liverpool 002","E02001348",6662,6644,18
"2021","Liverpool 003","E02001349",8042,7422,620
"2021","Liverpool 004","E02001350",8065,7902,163
"2021","Liverpool 005","E02001351",8996,8298,698
"2021","Liverpool 006","E02001352",6451,6438,13
"2021","Liverpool 007","E02001353",7250,7226,24
"2021","Liverpool 008","E02001354",7916,7915,1
"2021","Liverpool 009","E02001355",6344,6344,0
"2021","Liverpool 010","E02001356",9178,9174,4
"2021","Liverpool 011","E02001357",7232,7157,75
"2021","Liverpool 012","E02001358",6976,6936,40
"2021","Liverpool 013","E02001359",5512,5512,0
"2021","Liverpool 014","E02001360",8800,8780,20
"2021","Liverpool 015","E02001361",7276,7276,0
"2021","Liverpool 016","E02001362",7582,7548,34
"2021","Liverpool 017","E02001363",7895,7892,3
"2021","Liverpool 018","E02001364",6286,6134,152
"2021","Liverpool 019","E02001365",9288,9176,112
"2021","Liverpool 020","E02001366",8802,8741,61
"2021","Liverpool 021","E02001367",9689,9637,52
"2021","Liverpool 022","E02001368",7163,7112,51
"2021","Liverpool 023","E02001369",8070,7601,469
"2021","Liverpool 024","E02001370",7115,7057,58
"2021","Liverpool 025","E02001371",7638,7490,148
"2021","Liverpool 026","E02001372",6065,5898,167
"2021","Liverpool 027","E02001373",8911,8855,56
"2021","Liverpool 028","E02001374",8621,8498,123
"2021","Liverpool 029","E02001375",6903,6851,52
"2021","Liverpool 030","E02001376",9323,9294,29
"2021","Liverpool 031","E02001377",12385,8743,3642
"2021","Liverpool 032","E02001378",7374,7272,102
"2021","Liverpool 034","E02001380",7551,7546,5
"2021","Liverpool 035","E02001381",9837,9832,5
"2021","Liverpool 036","E02001382",6902,6902,0
"2021","Liverpool 037","E02001383",9557,7656,1901
"2021","Liverpool 038","E02001384",10802,10800,2
"2021","Liverpool 039","E02001385",9078,9007,71
"2021","Liverpool 040","E02001386",8178,8177,1
"2021","Liverpool 041","E02001387",7872,7737,135
"2021","Liverpool 042","E02001388",8282,7010,1272
"2021","Liverpool 043","E02001389",6592,6511,81
"2021","Liverpool 044","E02001390",9713,9592,121
"2021","Liverpool 045","E02001391",5991,5885,106
"2021","Liverpool 046","E02001392",6326,6326,0
"2021","Liverpool 047","E02001393",7488,7101,387
"2021","Liverpool 048","E02001394",8644,8370,274
"2021","Liverpool 049","E02001395",5944,5944,0
"2021","Liverpool 050","E02001396",7667,7615,52
"2021","Liverpool 051","E02001397",7186,7148,38
"2021","Liverpool 052","E02001398",7453,7059,394
"2021","Liverpool 053","E02001399",7021,7021,0
"2021","Liverpool 054","E02001400",6898,6788,110
"2021","Liverpool 055","E02001401",7989,7989,0
"2021","Liverpool 056","E02001402",9037,8919,118
"2021","Liverpool 057","E02001403",6459,6440,19
"2021","Liverpool 058","E02001404",7829,7827,2
"2021","Liverpool 059","E02001405",9909,9861,48
"2021","Liverpool 060","E02006932",14133,5809,8324
"2021","Liverpool 061","E02006933",7232,6821,411
"2021","Liverpool 062","E02006934",6673,5366,1307
"2021","St. Helens 001","E02001406",7846,7807,39
"2021","St. Helens 002","E02001407",5835,5795,40
"2021","St. Helens 003","E02001408",5448,5439,9
"2021","St. Helens 004","E02001409",10272,10272,0
"2021","St. Helens 005","E02001410",5765,5728,37
"2021","St. Helens 006","E02001411",5798,5719,79
"2021","St. Helens 007","E02001412",9077,8999,78
"2021","St. Helens 008","E02001413",9259,9250,9
"2021","St. Helens 009","E02001414",5541,5541,0
"2021","St. Helens 010","E02001415",6914,6889,25
"2021","St. Helens 011","E02001416",6429,6374,55
"2021","St. Helens 012","E02001417",7319,7216,103
"2021","St. Helens 013","E02001418",6564,6563,1
"2021","St. Helens 014","E02001419",7675,7553,122
"2021","St. Helens 015","E02001420",11883,11806,77
"2021","St. Helens 016","E02001421",10506,10484,22
"2021","St. Helens 017","E02001422",6710,6626,84
"2021","St. Helens 018","E02001423",6574,6549,25
"2021","St. Helens 020","E02001425",10689,10611,78
"2021","St. Helens 021","E02001426",5443,5348,95
"2021","St. Helens 022","E02001427",10854,10850,4
"2021","St. Helens 023","E02001428",5576,5469,107
"2021","St. Helens 024","E02006935",7477,7385,92
"2021","St. Helens 025","E02006936",7796,7754,42
"2021","Sefton 001","E02001429",6681,6681,0
"2021","Sefton 002","E02001430",6850,6774,76
"2021","Sefton 003","E02001431",7527,7049,478
"2021","Sefton 004","E02001432",9524,8932,592
"2021","Sefton 005","E02001433",7449,7449,0
"2021","Sefton 006","E02001434",7371,7253,118
"2021","Sefton 007","E02001435",8839,8742,97
"2021","Sefton 008","E02001436",9672,9571,101
"2021","Sefton 009","E02001437",9277,8848,429
"2021","Sefton 010","E02001438",7192,7189,3
"2021","Sefton 011","E02001439",6581,6557,24
"2021","Sefton 012","E02001440",6020,6020,0
"2021","Sefton 013","E02001441",6331,6189,142
"2021","Sefton 014","E02001442",6057,5960,97
"2021","Sefton 015","E02001443",5644,5595,49
"2021","Sefton 016","E02001444",5594,5553,41
"2021","Sefton 017","E02001445",6833,6805,28
"2021","Sefton 018","E02001446",7326,7114,212
"2021","Sefton 019","E02001447",6070,5974,96
"2021","Sefton 020","E02001448",6748,6706,42
"2021","Sefton 021","E02001449",9283,9233,50
"2021","Sefton 022","E02001450",8365,8274,91
"2021","Sefton 023","E02001451",5978,5881,97
"2021","Sefton 024","E02001452",6279,6234,45
"2021","Sefton 025","E02001453",8812,8756,56
"2021","Sefton 026","E02001454",7283,7283,0
"2021","Sefton 027","E02001455",7109,7109,0
"2021","Sefton 028","E02001456",7416,7363,53
"2021","Sefton 029","E02001457",6818,6814,4
"2021","Sefton 030","E02001458",7689,7685,4
"2021","Sefton 031","E02001459",6857,6857,0
"2021","Sefton 032","E02001460",7909,7742,167
"2021","Sefton 033","E02001461",6903,6902,1
"2021","Sefton 034","E02001462",7671,7663,8
"2021","Sefton 035","E02001463",7474,7413,61
"2021","Sefton 036","E02001464",7071,7019,52
"2021","Sefton 037","E02001465",7691,7539,152
"2021","Sefton 038","E02001466",9038,8974,64
"2021","Wirral 001","E02001467",7595,7473,122
"2021","Wirral 002","E02001468",7605,7327,278
"2021","Wirral 003","E02001469",7614,7597,17
"2021","Wirral 004","E02001470",8298,8285,13
"2021","Wirral 005","E02001471",7338,7216,122
"2021","Wirral 006","E02001472",7046,7036,10
"2021","Wirral 007","E02001473",7618,7565,53
"2021","Wirral 008","E02001474",6954,6938,16
"2021","Wirral 009","E02001475",6391,6391,0
"2021","Wirral 010","E02001476",7929,7911,18
"2021","Wirral 011","E02001477",7697,7642,55
"2021","Wirral 012","E02001478",8156,8099,57
"2021","Wirral 013","E02001479",6045,6045,0
"2021","Wirral 014","E02001480",7584,7294,290
"2021","Wirral 015","E02001481",8084,7955,129
"2021","Wirral 016","E02001482",8042,7943,99
"2021","Wirral 017","E02001483",7201,7201,0
"2021","Wirral 018","E02001484",8071,7982,89
"2021","Wirral 019","E02001485",6901,6847,54
"2021","Wirral 020","E02001486",7945,7633,312
"2021","Wirral 021","E02001487",9377,9372,5
"2021","Wirral 022","E02001488",8396,8344,52
"2021","Wirral 023","E02001489",8076,8076,0
"2021","Wirral 024","E02001490",8208,8206,2
"2021","Wirral 025","E02001491",6730,6659,71
"2021","Wirral 026","E02001492",7580,7523,57
"2021","Wirral 027","E02001493",8938,8797,141
"2021","Wirral 028","E02001494",7027,7009,18
"2021","Wirral 029","E02001495",7986,7888,98
"2021","Wirral 030","E02001496",6059,6014,45
"2021","Wirral 031","E02001497",8156,8120,36
"2021","Wirral 032","E02001498",7243,7243,0
"2021","Wirral 033","E02001499",6605,6557,48
"2021","Wirral 034","E02001500",7334,7334,0
"2021","Wirral 035","E02001501",7727,7688,39
"2021","Wirral 036","E02001502",9715,9526,189
"2021","Wirral 037","E02001503",7521,7426,95
"2021","Wirral 038","E02001504",6982,6861,121
"2021","Wirral 039","E02001505",6484,6472,12
"2021","Wirral 040","E02001506",8839,8815,24
"2021","Wirral 041","E02001507",6973,6962,11
"2021","Wirral 042","E02001508",8129,8129,0
"2021","Kingston upon Hull 002","E02002653",8129,8102,27
"2021","Kingston upon Hull 003","E02002654",8228,8228,0
"2021","Kingston upon Hull 004","E02002655",8753,8624,129
"2021","Kingston upon Hull 005","E02002656",5097,5066,31
"2021","Kingston upon Hull 006","E02002657",7468,7463,5
"2021","Kingston upon Hull 007","E02002658",6547,6454,93
"2021","Kingston upon Hull 008","E02002659",11407,11388,19
"2021","Kingston upon Hull 009","E02002660",7006,6974,32
"2021","Kingston upon Hull 010","E02002661",8476,8254,222
"2021","Kingston upon Hull 011","E02002662",7386,7323,63
"2021","Kingston upon Hull 012","E02002663",8110,6526,1584
"2021","Kingston upon Hull 013","E02002664",7195,7191,4
"2021","Kingston upon Hull 014","E02002665",7969,7910,59
"2021","Kingston upon Hull 015","E02002666",8154,8011,143
"2021","Kingston upon Hull 016","E02002667",7298,7273,25
"2021","Kingston upon Hull 017","E02002668",8400,8399,1
"2021","Kingston upon Hull 018","E02002669",7992,7930,62
"2021","Kingston upon Hull 019","E02002670",7899,7881,18
"2021","Kingston upon Hull 020","E02002671",8977,8137,840
"2021","Kingston upon Hull 021","E02002672",7336,7253,83
"2021","Kingston upon Hull 022","E02002673",7521,7401,120
"2021","Kingston upon Hull 023","E02002674",6586,6584,2
"2021","Kingston upon Hull 024","E02002675",8549,8441,108
"2021","Kingston upon Hull 025","E02002676",7262,7224,38
"2021","Kingston upon Hull 026","E02002677",8267,8214,53
"2021","Kingston upon Hull 027","E02002678",8475,8416,59
"2021","Kingston upon Hull 028","E02002679",7745,7709,36
"2021","Kingston upon Hull 029","E02002680",9685,9304,381
"2021","Kingston upon Hull 030","E02002681",9208,9005,203
"2021","Kingston upon Hull 031","E02002682",10739,10732,7
"2021","Kingston upon Hull 033","E02006813",8221,8188,33
"2021","Kingston upon Hull 034","E02007079",8370,8274,96
"2021","Kingston upon Hull 035","E02007080",8554,8545,9
"2021","East Riding of Yorkshire 001","E02002684",10170,10086,84
"2021","East Riding of Yorkshire 002","E02002685",7833,7800,33
"2021","East Riding of Yorkshire 003","E02002686",7790,7617,173
"2021","East Riding of Yorkshire 004","E02002687",5906,5636,270
"2021","East Riding of Yorkshire 005","E02002688",5395,5242,153
"2021","East Riding of Yorkshire 006","E02002689",5716,5638,78
"2021","East Riding of Yorkshire 008","E02002691",8317,8266,51
"2021","East Riding of Yorkshire 009","E02002692",9684,8959,725
"2021","East Riding of Yorkshire 010","E02002693",7055,7027,28
"2021","East Riding of Yorkshire 011","E02002694",12792,12641,151
"2021","East Riding of Yorkshire 012","E02002695",8198,7968,230
"2021","East Riding of Yorkshire 013","E02002696",6259,5716,543
"2021","East Riding of Yorkshire 014","E02002697",7536,7533,3
"2021","East Riding of Yorkshire 015","E02002698",8577,8524,53
"2021","East Riding of Yorkshire 016","E02002699",9851,9796,55
"2021","East Riding of Yorkshire 017","E02002700",6043,5992,51
"2021","East Riding of Yorkshire 018","E02002701",8697,8685,12
"2021","East Riding of Yorkshire 019","E02002702",9742,9605,137
"2021","East Riding of Yorkshire 020","E02002703",9277,8945,332
"2021","East Riding of Yorkshire 021","E02002704",7142,7137,5
"2021","East Riding of Yorkshire 022","E02002705",7059,6982,77
"2021","East Riding of Yorkshire 023","E02002706",7276,7163,113
"2021","East Riding of Yorkshire 024","E02002707",6736,6680,56
"2021","East Riding of Yorkshire 025","E02002708",5795,5687,108
"2021","East Riding of Yorkshire 026","E02002709",8322,7474,848
"2021","East Riding of Yorkshire 027","E02002710",7195,7129,66
"2021","East Riding of Yorkshire 028","E02002711",7874,7789,85
"2021","East Riding of Yorkshire 029","E02002712",7350,7115,235
"2021","East Riding of Yorkshire 031","E02002714",7873,7843,30
"2021","East Riding of Yorkshire 032","E02002715",13521,13442,79
"2021","East Riding of Yorkshire 033","E02002716",8434,8404,30
"2021","East Riding of Yorkshire 034","E02002717",7949,7912,37
"2021","East Riding of Yorkshire 035","E02002718",8077,8004,73
"2021","East Riding of Yorkshire 036","E02002719",6762,6468,294
"2021","East Riding of Yorkshire 037","E02002720",7582,7465,117
"2021","East Riding of Yorkshire 038","E02002721",6654,6584,70
"2021","East Riding of Yorkshire 039","E02002722",8459,8279,180
"2021","East Riding of Yorkshire 040","E02002723",8485,8340,145
"2021","East Riding of Yorkshire 041","E02002724",9594,9537,57
"2021","East Riding of Yorkshire 042","E02002725",6889,6789,100
"2021","East Riding of Yorkshire 043","E02006814",8035,8034,1
"2021","East Riding of Yorkshire 044","E02006891",8108,8035,73
"2021","East Riding of Yorkshire 045","E02006892",6208,6074,134
"2021","North East Lincolnshire 001","E02002726",10360,10253,107
"2021","North East Lincolnshire 002","E02002727",5034,4955,79
"2021","North East Lincolnshire 003","E02002728",7543,7540,3
"2021","North East Lincolnshire 004","E02002729",5601,5601,0
"2021","North East Lincolnshire 005","E02002730",7152,7152,0
"2021","North East Lincolnshire 006","E02002731",5635,5635,0
"2021","North East Lincolnshire 007","E02002732",7957,7867,90
"2021","North East Lincolnshire 008","E02002733",5758,5722,36
"2021","North East Lincolnshire 009","E02002734",5533,5443,90
"2021","North East Lincolnshire 011","E02002736",5607,5601,6
"2021","North East Lincolnshire 012","E02002737",7066,6938,128
"2021","North East Lincolnshire 013","E02002738",6893,6893,0
"2021","North East Lincolnshire 014","E02002739",5758,5749,9
"2021","North East Lincolnshire 015","E02002740",5452,5401,51
"2021","North East Lincolnshire 016","E02002741",8922,8593,329
"2021","North East Lincolnshire 018","E02002743",5408,5343,65
"2021","North East Lincolnshire 019","E02002744",6975,6927,48
"2021","North East Lincolnshire 020","E02002745",7162,7062,100
"2021","North East Lincolnshire 021","E02002746",9829,9771,58
"2021","North East Lincolnshire 022","E02002747",9206,9182,24
"2021","North East Lincolnshire 023","E02002748",7968,7770,198
"2021","North East Lincolnshire 024","E02007081",10143,10063,80
"2021","North Lincolnshire 001","E02002749",11921,11798,123
"2021","North Lincolnshire 002","E02002750",6363,6276,87
"2021","North Lincolnshire 003","E02002751",6353,6310,43
"2021","North Lincolnshire 004","E02002752",7104,7098,6
"2021","North Lincolnshire 005","E02002753",8478,8347,131
"2021","North Lincolnshire 006","E02002754",8249,8200,49
"2021","North Lincolnshire 007","E02002755",7492,7290,202
"2021","North Lincolnshire 008","E02002756",8993,8886,107
"2021","North Lincolnshire 009","E02002757",6291,6284,7
"2021","North Lincolnshire 010","E02002758",6437,6437,0
"2021","North Lincolnshire 011","E02002759",9586,9384,202
"2021","North Lincolnshire 012","E02002760",5792,5667,125
"2021","North Lincolnshire 013","E02002761",6439,6326,113
"2021","North Lincolnshire 014","E02002762",6399,6287,112
"2021","North Lincolnshire 015","E02002763",8825,8712,113
"2021","North Lincolnshire 016","E02002764",5997,5994,3
"2021","North Lincolnshire 017","E02002765",6148,6082,66
"2021","North Lincolnshire 018","E02002766",8955,8912,43
"2021","North Lincolnshire 019","E02002767",6621,6621,0
"2021","North Lincolnshire 020","E02002768",7493,7493,0
"2021","North Lincolnshire 021","E02002769",5634,5631,3
"2021","North Lincolnshire 022","E02002770",7038,6966,72
"2021","North Lincolnshire 023","E02002771",7071,7002,69
"2021","York 001","E02002772",6946,6854,92
"2021","York 002","E02002773",5693,5665,28
"2021","York 003","E02002774",6081,5987,94
"2021","York 004","E02002775",5760,5624,136
"2021","York 005","E02002776",6659,6659,0
"2021","York 006","E02002777",8961,8918,43
"2021","York 007","E02002778",7875,7674,201
"2021","York 008","E02002779",9566,9314,252
"2021","York 009","E02002780",8082,7941,141
"2021","York 010","E02002781",10108,9164,944
"2021","York 011","E02002782",6442,6075,367
"2021","York 012","E02002783",10291,10194,97
"2021","York 013","E02002784",11347,9763,1584
"2021","York 014","E02002785",8108,7995,113
"2021","York 015","E02002786",10185,10165,20
"2021","York 016","E02002787",8931,8895,36
"2021","York 017","E02002788",8303,8211,92
"2021","York 018","E02002789",9279,9232,47
"2021","York 019","E02002790",11774,10349,1425
"2021","York 020","E02002791",6579,6454,125
"2021","York 021","E02002792",7759,7645,114
"2021","York 022","E02002793",9269,9267,2
"2021","York 023","E02002794",10540,5251,5289
"2021","York 024","E02002795",8284,8276,8
"2021","Craven 001","E02005742",7422,7330,92
"2021","Craven 003","E02005744",7879,7693,186
"2021","Craven 005","E02005746",6676,6676,0
"2021","Craven 006","E02005747",6911,6868,43
"2021","Craven 007","E02005748",7847,7782,65
"2021","Craven 008","E02005749",10032,9860,172
"2021","Craven 009","E02007041",10159,10012,147
"2021","Hambleton 001","E02005750",7678,7675,3
"2021","Hambleton 002","E02005751",8579,8566,13
"2021","Hambleton 003","E02005752",6920,6913,7
"2021","Hambleton 005","E02005754",7438,7384,54
"2021","Hambleton 006","E02005755",6761,6686,75
"2021","Hambleton 007","E02005756",6329,5897,432
"2021","Hambleton 008","E02005757",8627,8562,65
"2021","Hambleton 009","E02005758",9529,9342,187
"2021","Hambleton 010","E02005759",9305,9280,25
"2021","Hambleton 011","E02005760",6183,6064,119
"2021","Hambleton 012","E02007042",7040,6985,55
"2021","Hambleton 013","E02007043",6302,6230,72
"2021","Harrogate 001","E02005761",5494,5432,62
"2021","Harrogate 002","E02005762",6254,5728,526
"2021","Harrogate 003","E02005763",6496,6388,108
"2021","Harrogate 004","E02005764",10336,10146,190
"2021","Harrogate 005","E02005765",7142,7067,75
"2021","Harrogate 006","E02005766",6013,6010,3
"2021","Harrogate 007","E02005767",7392,7329,63
"2021","Harrogate 008","E02005768",8026,6741,1285
"2021","Harrogate 009","E02005769",6996,6925,71
"2021","Harrogate 010","E02005770",9030,9023,7
"2021","Harrogate 011","E02005771",7669,7665,4
"2021","Harrogate 012","E02005772",5890,5818,72
"2021","Harrogate 013","E02005773",8986,8828,158
"2021","Harrogate 014","E02005774",9390,9203,187
"2021","Harrogate 015","E02005775",9212,8893,319
"2021","Harrogate 016","E02005776",9371,8549,822
"2021","Harrogate 017","E02005777",8293,8184,109
"2021","Harrogate 018","E02005778",6133,6133,0
"2021","Harrogate 019","E02005779",7374,7271,103
"2021","Harrogate 020","E02005780",11054,10837,217
"2021","Harrogate 021","E02005781",6114,5971,143
"2021","Richmondshire 001","E02005782",7497,7480,17
"2021","Richmondshire 002","E02005783",8078,8000,78
"2021","Richmondshire 003","E02005784",5818,5395,423
"2021","Richmondshire 004","E02005785",14085,11962,2123
"2021","Richmondshire 005","E02005786",5747,5686,61
"2021","Richmondshire 006","E02005787",8554,8413,141
"2021","Ryedale 001","E02005788",6349,6322,27
"2021","Ryedale 002","E02005789",10614,10479,135
"2021","Ryedale 003","E02005790",7097,6681,416
"2021","Ryedale 004","E02005791",6846,6843,3
"2021","Ryedale 007","E02005794",9296,9277,19
"2021","Ryedale 009","E02007044",7798,7710,88
"2021","Ryedale 010","E02007045",6707,6651,56
"2021","Scarborough 001","E02005795",6903,6697,206
"2021","Scarborough 002","E02005796",6525,6509,16
"2021","Scarborough 003","E02005797",6226,6168,58
"2021","Scarborough 004","E02005798",8191,8107,84
"2021","Scarborough 005","E02005799",9362,9264,98
"2021","Scarborough 006","E02005800",7407,7311,96
"2021","Scarborough 007","E02005801",5563,5447,116
"2021","Scarborough 008","E02005802",7766,7669,97
"2021","Scarborough 009","E02005803",9199,9084,115
"2021","Scarborough 010","E02005804",7621,7226,395
"2021","Scarborough 011","E02005805",7683,7682,1
"2021","Scarborough 012","E02005806",8206,8201,5
"2021","Scarborough 013","E02005807",6529,6482,47
"2021","Scarborough 014","E02005808",11551,11420,131
"2021","Selby 001","E02005809",7513,7512,1
"2021","Selby 002","E02005810",9408,9398,10
"2021","Selby 003","E02005811",9867,9694,173
"2021","Selby 004","E02005812",11363,11313,50
"2021","Selby 005","E02005813",13298,13153,145
"2021","Selby 006","E02005814",7008,6929,79
"2021","Selby 007","E02005815",8642,8642,0
"2021","Selby 008","E02005816",8646,8599,47
"2021","Selby 009","E02005817",7411,7396,15
"2021","Selby 010","E02005818",8833,8742,91
"2021","Barnsley 001","E02001509",6958,6902,56
"2021","Barnsley 002","E02001510",5923,5923,0
"2021","Barnsley 003","E02001511",6120,6077,43
"2021","Barnsley 004","E02001512",8538,8371,167
"2021","Barnsley 005","E02001513",7574,7549,25
"2021","Barnsley 006","E02001514",7780,7671,109
"2021","Barnsley 007","E02001515",9665,9637,28
"2021","Barnsley 008","E02001516",6293,6222,71
"2021","Barnsley 009","E02001517",7979,7938,41
"2021","Barnsley 010","E02001518",10209,10140,69
"2021","Barnsley 011","E02001519",7974,7878,96
"2021","Barnsley 012","E02001520",11663,11635,28
"2021","Barnsley 013","E02001521",12091,12057,34
"2021","Barnsley 014","E02001522",9517,9430,87
"2021","Barnsley 015","E02001523",6766,6712,54
"2021","Barnsley 016","E02001524",6087,6078,9
"2021","Barnsley 017","E02001525",6774,6644,130
"2021","Barnsley 018","E02001526",6231,6202,29
"2021","Barnsley 019","E02001527",5976,5910,66
"2021","Barnsley 020","E02001528",10691,10566,125
"2021","Barnsley 021","E02001529",9434,9282,152
"2021","Barnsley 022","E02001530",7171,7171,0
"2021","Barnsley 023","E02001531",7733,7686,47
"2021","Barnsley 024","E02001532",10541,10501,40
"2021","Barnsley 025","E02001533",7762,7701,61
"2021","Barnsley 026","E02001534",9590,9572,18
"2021","Barnsley 027","E02001535",6494,6490,4
"2021","Barnsley 028","E02001536",8672,8592,80
"2021","Barnsley 029","E02001537",8452,8442,10
"2021","Barnsley 030","E02001538",7913,7896,17
"2021","Doncaster 001","E02001539",6710,6710,0
"2021","Doncaster 002","E02001540",11974,11933,41
"2021","Doncaster 003","E02001541",11386,11270,116
"2021","Doncaster 004","E02001542",7471,7438,33
"2021","Doncaster 005","E02001543",7823,7784,39
"2021","Doncaster 006","E02001544",8310,8257,53
"2021","Doncaster 007","E02001545",8445,8445,0
"2021","Doncaster 008","E02001546",8839,6703,2136
"2021","Doncaster 009","E02001547",10862,10762,100
"2021","Doncaster 010","E02001548",7998,7974,24
"2021","Doncaster 011","E02001549",6253,6253,0
"2021","Doncaster 012","E02001550",7748,7727,21
"2021","Doncaster 013","E02001551",5899,5882,17
"2021","Doncaster 014","E02001552",7655,7558,97
"2021","Doncaster 015","E02001553",10211,10208,3
"2021","Doncaster 016","E02001554",6003,6003,0
"2021","Doncaster 017","E02001555",5227,5191,36
"2021","Doncaster 018","E02001556",9147,9123,24
"2021","Doncaster 019","E02001557",10034,9836,198
"2021","Doncaster 020","E02001558",5989,5988,1
"2021","Doncaster 021","E02001559",7548,7434,114
"2021","Doncaster 022","E02001560",11789,10816,973
"2021","Doncaster 023","E02001561",6296,6278,18
"2021","Doncaster 024","E02001562",5821,5784,37
"2021","Doncaster 025","E02001563",8091,7989,102
"2021","Doncaster 026","E02001564",8196,8188,8
"2021","Doncaster 027","E02001565",7824,7766,58
"2021","Doncaster 028","E02001566",8617,8602,15
"2021","Doncaster 029","E02001567",8693,8639,54
"2021","Doncaster 030","E02001568",6872,6872,0
"2021","Doncaster 031","E02001569",8684,8557,127
"2021","Doncaster 032","E02001570",6996,6896,100
"2021","Doncaster 033","E02001571",5917,5886,31
"2021","Doncaster 034","E02001572",7785,7700,85
"2021","Doncaster 035","E02001573",7673,7639,34
"2021","Doncaster 036","E02001574",6010,6007,3
"2021","Doncaster 037","E02001575",7900,7780,120
"2021","Doncaster 038","E02001576",6967,6965,2
"2021","Doncaster 039","E02001577",6448,6330,118
"2021","Rotherham 001","E02001578",11669,11578,91
"2021","Rotherham 002","E02001579",9966,9837,129
"2021","Rotherham 003","E02001580",8546,8482,64
"2021","Rotherham 004","E02001581",6228,6222,6
"2021","Rotherham 005","E02001582",7690,7661,29
"2021","Rotherham 006","E02001583",5571,5568,3
"2021","Rotherham 007","E02001584",6666,6650,16
"2021","Rotherham 008","E02001585",6317,6192,125
"2021","Rotherham 009","E02001586",7782,7727,55
"2021","Rotherham 010","E02001587",5809,5761,48
"2021","Rotherham 011","E02001588",7207,7158,49
"2021","Rotherham 012","E02001589",7994,7981,13
"2021","Rotherham 013","E02001590",7503,7463,40
"2021","Rotherham 014","E02001591",8252,8192,60
"2021","Rotherham 015","E02001592",8580,8549,31
"2021","Rotherham 016","E02001593",7207,7120,87
"2021","Rotherham 017","E02001594",7452,7194,258
"2021","Rotherham 018","E02001595",8295,8200,95
"2021","Rotherham 019","E02001596",8292,8236,56
"2021","Rotherham 020","E02001597",9512,9470,42
"2021","Rotherham 021","E02001598",9643,9573,70
"2021","Rotherham 023","E02001600",11094,11002,92
"2021","Rotherham 025","E02001602",9048,9048,0
"2021","Rotherham 026","E02001603",7489,7465,24
"2021","Rotherham 027","E02001604",11791,11696,95
"2021","Rotherham 028","E02001605",7501,7425,76
"2021","Rotherham 029","E02001606",8030,7938,92
"2021","Rotherham 030","E02001607",8928,8910,18
"2021","Rotherham 031","E02001608",7061,7061,0
"2021","Rotherham 032","E02001609",8514,8473,41
"2021","Rotherham 033","E02001610",8649,8617,32
"2021","Rotherham 034","E02007002",11524,11507,17
"2021","Sheffield 001","E02001611",7683,7583,100
"2021","Sheffield 002","E02001612",5618,5594,24
"2021","Sheffield 003","E02001613",10217,10193,24
"2021","Sheffield 004","E02001614",10998,10893,105
"2021","Sheffield 005","E02001615",7138,7094,44
"2021","Sheffield 006","E02001616",7280,7274,6
"2021","Sheffield 007","E02001617",5916,5867,49
"2021","Sheffield 008","E02001618",9782,9693,89
"2021","Sheffield 009","E02001619",10170,10132,38
"2021","Sheffield 010","E02001620",6996,6984,12
"2021","Sheffield 011","E02001621",6056,6028,28
"2021","Sheffield 012","E02001622",9032,8907,125
"2021","Sheffield 013","E02001623",8164,8069,95
"2021","Sheffield 014","E02001624",9334,9272,62
"2021","Sheffield 015","E02001625",7910,7801,109
"2021","Sheffield 016","E02001626",5820,5820,0
"2021","Sheffield 017","E02001627",6016,6010,6
"2021","Sheffield 018","E02001628",6506,6503,3
"2021","Sheffield 019","E02001629",6532,6439,93
"2021","Sheffield 020","E02001630",9253,9003,250
"2021","Sheffield 021","E02001631",7567,7555,12
"2021","Sheffield 022","E02001632",12364,12260,104
"2021","Sheffield 023","E02001633",7618,7596,22
"2021","Sheffield 024","E02001634",9025,9021,4
"2021","Sheffield 025","E02001635",6043,6043,0
"2021","Sheffield 026","E02001636",9372,8590,782
"2021","Sheffield 027","E02001637",8571,8571,0
"2021","Sheffield 028","E02001638",5695,5645,50
"2021","Sheffield 029","E02001639",5976,5916,60
"2021","Sheffield 030","E02001640",8326,8145,181
"2021","Sheffield 032","E02001642",10316,10250,66
"2021","Sheffield 033","E02001643",6220,6218,2
"2021","Sheffield 036","E02001646",7657,6300,1357
"2021","Sheffield 037","E02001647",6281,6222,59
"2021","Sheffield 038","E02001648",8238,5545,2693
"2021","Sheffield 039","E02001649",10975,10974,1
"2021","Sheffield 040","E02001650",9579,7740,1839
"2021","Sheffield 041","E02001651",8080,8080,0
"2021","Sheffield 042","E02001652",12869,9143,3726
"2021","Sheffield 043","E02001653",7460,7173,287
"2021","Sheffield 044","E02001654",6301,6207,94
"2021","Sheffield 045","E02001655",7674,7623,51
"2021","Sheffield 046","E02001656",7774,7724,50
"2021","Sheffield 047","E02001657",9114,9113,1
"2021","Sheffield 048","E02001658",5259,5257,2
"2021","Sheffield 049","E02001659",5823,5768,55
"2021","Sheffield 050","E02001660",9869,9735,134
"2021","Sheffield 051","E02001661",7682,7571,111
"2021","Sheffield 052","E02001662",7424,7281,143
"2021","Sheffield 053","E02001663",7362,7279,83
"2021","Sheffield 054","E02001664",6288,6280,8
"2021","Sheffield 055","E02001665",9805,9805,0
"2021","Sheffield 056","E02001666",5913,5913,0
"2021","Sheffield 059","E02001669",7769,7690,79
"2021","Sheffield 060","E02001670",6015,5986,29
"2021","Sheffield 061","E02001671",5606,5606,0
"2021","Sheffield 062","E02001672",5979,5923,56
"2021","Sheffield 063","E02001673",5205,5147,58
"2021","Sheffield 064","E02001674",9092,9004,88
"2021","Sheffield 065","E02001675",8418,8391,27
"2021","Sheffield 066","E02001676",5873,5826,47
"2021","Sheffield 068","E02001678",10484,10406,78
"2021","Sheffield 069","E02001679",6323,6322,1
"2021","Sheffield 070","E02001680",6268,6244,24
"2021","Sheffield 071","E02001681",7623,7560,63
"2021","Sheffield 072","E02006803",9271,9271,0
"2021","Sheffield 073","E02006843",10601,6662,3939
"2021","Sheffield 074","E02006844",7849,5885,1964
"2021","Sheffield 075","E02006868",12075,11233,842
"2021","Sheffield 076","E02006869",11129,11032,97
"2021","Bradford 001","E02002183",5701,5637,64
"2021","Bradford 002","E02002184",13119,12957,162
"2021","Bradford 003","E02002185",5860,5821,39
"2021","Bradford 005","E02002187",6195,6187,8
"2021","Bradford 006","E02002188",7788,7769,19
"2021","Bradford 007","E02002189",7186,7015,171
"2021","Bradford 008","E02002190",11883,11863,20
"2021","Bradford 009","E02002191",9643,9623,20
"2021","Bradford 010","E02002192",9137,9046,91
"2021","Bradford 011","E02002193",6475,6475,0
"2021","Bradford 012","E02002194",7479,7474,5
"2021","Bradford 013","E02002195",6363,6315,48
"2021","Bradford 014","E02002196",6409,6407,2
"2021","Bradford 015","E02002197",8696,8605,91
"2021","Bradford 016","E02002198",8418,8371,47
"2021","Bradford 017","E02002199",7242,7226,16
"2021","Bradford 018","E02002200",9094,8931,163
"2021","Bradford 019","E02002201",12241,12113,128
"2021","Bradford 020","E02002202",7493,7452,41
"2021","Bradford 021","E02002203",7738,7725,13
"2021","Bradford 022","E02002204",11428,11397,31
"2021","Bradford 023","E02002205",9779,9704,75
"2021","Bradford 024","E02002206",8842,8842,0
"2021","Bradford 025","E02002207",7501,7445,56
"2021","Bradford 026","E02002208",8133,8133,0
"2021","Bradford 027","E02002209",7007,6999,8
"2021","Bradford 028","E02002210",7693,7652,41
"2021","Bradford 029","E02002211",7709,7441,268
"2021","Bradford 030","E02002212",9588,9476,112
"2021","Bradford 031","E02002213",7675,7675,0
"2021","Bradford 032","E02002214",6598,6598,0
"2021","Bradford 033","E02002215",10788,10788,0
"2021","Bradford 034","E02002216",10158,9881,277
"2021","Bradford 035","E02002217",10388,10306,82
"2021","Bradford 036","E02002218",10285,10283,2
"2021","Bradford 037","E02002219",8291,8211,80
"2021","Bradford 038","E02002220",9674,9674,0
"2021","Bradford 040","E02002222",9234,9120,114
"2021","Bradford 041","E02002223",7845,7844,1
"2021","Bradford 042","E02002224",10842,10722,120
"2021","Bradford 043","E02002225",8531,8403,128
"2021","Bradford 044","E02002226",14127,12736,1391
"2021","Bradford 045","E02002227",6211,6211,0
"2021","Bradford 046","E02002228",7646,7449,197
"2021","Bradford 047","E02002229",8285,7661,624
"2021","Bradford 048","E02002230",8633,8558,75
"2021","Bradford 049","E02002231",13334,13260,74
"2021","Bradford 050","E02002232",7318,7268,50
"2021","Bradford 051","E02002233",9776,9764,12
"2021","Bradford 052","E02002234",7599,7599,0
"2021","Bradford 053","E02002235",7073,7073,0
"2021","Bradford 054","E02002236",6591,6591,0
"2021","Bradford 055","E02002237",8836,8758,78
"2021","Bradford 056","E02002238",6453,6452,1
"2021","Bradford 057","E02002239",10866,10759,107
"2021","Bradford 058","E02002240",11568,11543,25
"2021","Bradford 059","E02002241",12219,12127,92
"2021","Bradford 060","E02002242",7885,7855,30
"2021","Bradford 061","E02002243",9627,9616,11
"2021","Bradford 062","E02006945",8694,8529,165
"2021","Bradford 063","E02006946",5223,5157,66
"2021","Bradford 064","E02006947",9854,9723,131
"2021","Bradford 065","E02006948",6447,6251,196
"2021","Calderdale 001","E02002244",6073,6052,21
"2021","Calderdale 002","E02002245",5398,5398,0
"2021","Calderdale 003","E02002246",9565,9547,18
"2021","Calderdale 004","E02002247",8938,8916,22
"2021","Calderdale 005","E02002248",7780,7773,7
"2021","Calderdale 006","E02002249",5612,5534,78
"2021","Calderdale 007","E02002250",8218,8217,1
"2021","Calderdale 008","E02002251",7942,7790,152
"2021","Calderdale 009","E02002252",6781,6750,31
"2021","Calderdale 010","E02002253",8604,8516,88
"2021","Calderdale 011","E02002254",6217,6155,62
"2021","Calderdale 012","E02002255",7719,7680,39
"2021","Calderdale 013","E02002256",9456,9296,160
"2021","Calderdale 014","E02002257",6544,6544,0
"2021","Calderdale 015","E02002258",8884,8882,2
"2021","Calderdale 016","E02002259",7138,7058,80
"2021","Calderdale 017","E02002260",9059,9058,1
"2021","Calderdale 018","E02002261",7931,7930,1
"2021","Calderdale 019","E02002262",7670,7613,57
"2021","Calderdale 020","E02002263",6497,6474,23
"2021","Calderdale 021","E02002264",7065,7004,61
"2021","Calderdale 022","E02002265",5610,5553,57
"2021","Calderdale 023","E02002266",5737,5657,80
"2021","Calderdale 024","E02002267",7986,7917,69
"2021","Calderdale 025","E02002268",10303,10245,58
"2021","Calderdale 026","E02002269",9388,9296,92
"2021","Calderdale 027","E02002270",8516,8460,56
"2021","Kirklees 001","E02002271",7552,7487,65
"2021","Kirklees 002","E02002272",9671,9629,42
"2021","Kirklees 003","E02002273",6580,6544,36
"2021","Kirklees 004","E02002274",6862,6827,35
"2021","Kirklees 005","E02002275",8564,8500,64
"2021","Kirklees 006","E02002276",7793,7777,16
"2021","Kirklees 007","E02002277",6912,6854,58
"2021","Kirklees 008","E02002278",6722,6677,45
"2021","Kirklees 009","E02002279",6272,6231,41
"2021","Kirklees 010","E02002280",6864,6836,28
"2021","Kirklees 011","E02002281",11657,11593,64
"2021","Kirklees 012","E02002282",7446,7436,10
"2021","Kirklees 013","E02002283",7176,7168,8
"2021","Kirklees 014","E02002284",6250,6250,0
"2021","Kirklees 015","E02002285",7978,7888,90
"2021","Kirklees 016","E02002286",6328,6289,39
"2021","Kirklees 017","E02002287",7261,7164,97
"2021","Kirklees 018","E02002288",10151,10014,137
"2021","Kirklees 019","E02002289",7039,7007,32
"2021","Kirklees 020","E02002290",6292,6292,0
"2021","Kirklees 021","E02002291",6549,6483,66
"2021","Kirklees 022","E02002292",5601,5578,23
"2021","Kirklees 023","E02002293",8852,8837,15
"2021","Kirklees 024","E02002294",11136,10910,226
"2021","Kirklees 025","E02002295",7324,7280,44
"2021","Kirklees 026","E02002296",6930,6873,57
"2021","Kirklees 027","E02002297",6997,6997,0
"2021","Kirklees 028","E02002298",6655,6607,48
"2021","Kirklees 029","E02002299",7223,6816,407
"2021","Kirklees 030","E02002300",8595,8557,38
"2021","Kirklees 031","E02002301",8267,8247,20
"2021","Kirklees 032","E02002302",6170,6120,50
"2021","Kirklees 033","E02002303",6638,6503,135
"2021","Kirklees 034","E02002304",6535,6373,162
"2021","Kirklees 035","E02002305",6184,6184,0
"2021","Kirklees 036","E02002306",6210,6200,10
"2021","Kirklees 037","E02002307",5923,5894,29
"2021","Kirklees 038","E02002308",6781,6750,31
"2021","Kirklees 039","E02002309",6826,6685,141
"2021","Kirklees 040","E02002310",5773,5681,92
"2021","Kirklees 041","E02002311",6547,6426,121
"2021","Kirklees 042","E02002312",8124,6569,1555
"2021","Kirklees 043","E02002313",7790,7718,72
"2021","Kirklees 044","E02002314",5883,5818,65
"2021","Kirklees 045","E02002315",6687,6686,1
"2021","Kirklees 046","E02002316",6674,6672,2
"2021","Kirklees 047","E02002317",7484,7482,2
"2021","Kirklees 048","E02002318",6163,6056,107
"2021","Kirklees 049","E02002319",6967,6926,41
"2021","Kirklees 050","E02002320",6001,6000,1
"2021","Kirklees 051","E02002321",6784,6115,669
"2021","Kirklees 052","E02002322",6381,6381,0
"2021","Kirklees 053","E02002323",8221,8214,7
"2021","Kirklees 054","E02002324",6569,6536,33
"2021","Kirklees 055","E02002325",9105,8944,161
"2021","Kirklees 056","E02002326",6012,6012,0
"2021","Kirklees 057","E02002327",10065,9915,150
"2021","Kirklees 058","E02002328",7018,6942,76
"2021","Kirklees 059","E02002329",12199,12199,0
"2021","Leeds 001","E02002330",6989,6987,2
"2021","Leeds 002","E02002331",7368,6400,968
"2021","Leeds 003","E02002332",6529,6529,0
"2021","Leeds 004","E02002333",7829,7757,72
"2021","Leeds 005","E02002334",7621,7596,25
"2021","Leeds 006","E02002335",7525,7525,0
"2021","Leeds 007","E02002336",6996,6984,12
"2021","Leeds 008","E02002337",7725,7689,36
"2021","Leeds 009","E02002338",7281,7216,65
"2021","Leeds 010","E02002339",5649,5649,0
"2021","Leeds 011","E02002340",5862,5861,1
"2021","Leeds 012","E02002341",7434,7431,3
"2021","Leeds 013","E02002342",6078,6078,0
"2021","Leeds 014","E02002343",5941,5936,5
"2021","Leeds 015","E02002344",7805,7804,1
"2021","Leeds 016","E02002345",6178,6055,123
"2021","Leeds 017","E02002346",6153,6153,0
"2021","Leeds 018","E02002347",6572,6526,46
"2021","Leeds 019","E02002348",6519,6466,53
"2021","Leeds 020","E02002349",5866,5839,27
"2021","Leeds 021","E02002350",6662,6112,550
"2021","Leeds 022","E02002351",5630,5611,19
"2021","Leeds 023","E02002352",7811,7768,43
"2021","Leeds 024","E02002353",6019,6001,18
"2021","Leeds 025","E02002354",8208,8178,30
"2021","Leeds 027","E02002356",9314,9204,110
"2021","Leeds 028","E02002357",8333,8276,57
"2021","Leeds 029","E02002358",8638,8607,31
"2021","Leeds 030","E02002359",6481,6479,2
"2021","Leeds 031","E02002360",6867,6840,27
"2021","Leeds 032","E02002361",6069,6022,47
"2021","Leeds 033","E02002362",8043,7986,57
"2021","Leeds 034","E02002363",7035,6980,55
"2021","Leeds 035","E02002364",5973,5845,128
"2021","Leeds 037","E02002366",8399,8276,123
"2021","Leeds 038","E02002367",6423,6366,57
"2021","Leeds 039","E02002368",8651,8591,60
"2021","Leeds 040","E02002369",7977,7954,23
"2021","Leeds 041","E02002370",7267,7255,12
"2021","Leeds 042","E02002371",10558,10423,135
"2021","Leeds 044","E02002373",8507,8425,82
"2021","Leeds 045","E02002374",6892,6708,184
"2021","Leeds 046","E02002375",6592,6116,476
"2021","Leeds 047","E02002376",7815,7787,28
"2021","Leeds 048","E02002377",7511,7483,28
"2021","Leeds 050","E02002379",5995,5992,3
"2021","Leeds 051","E02002380",5504,5482,22
"2021","Leeds 052","E02002381",6286,6286,0
"2021","Leeds 053","E02002382",7200,7142,58
"2021","Leeds 054","E02002383",8131,8011,120
"2021","Leeds 055","E02002384",12480,9959,2521
"2021","Leeds 056","E02002385",8464,8343,121
"2021","Leeds 057","E02002386",9148,9134,14
"2021","Leeds 058","E02002387",6022,6021,1
"2021","Leeds 059","E02002388",8148,8093,55
"2021","Leeds 060","E02002389",7700,7597,103
"2021","Leeds 061","E02002390",7074,7055,19
"2021","Leeds 062","E02002391",7921,7870,51
"2021","Leeds 063","E02002392",9987,5797,4190
"2021","Leeds 064","E02002393",8938,8880,58
"2021","Leeds 065","E02002394",7647,7640,7
"2021","Leeds 066","E02002395",7388,7332,56
"2021","Leeds 067","E02002396",9052,8918,134
"2021","Leeds 068","E02002397",7687,7679,8
"2021","Leeds 069","E02002398",7466,7466,0
"2021","Leeds 070","E02002399",6449,6448,1
"2021","Leeds 071","E02002400",9817,9204,613
"2021","Leeds 072","E02002401",6628,6628,0
"2021","Leeds 073","E02002402",5780,5715,65
"2021","Leeds 074","E02002403",6299,6126,173
"2021","Leeds 075","E02002404",10987,10474,513
"2021","Leeds 076","E02002405",9168,9068,100
"2021","Leeds 077","E02002406",7266,7257,9
"2021","Leeds 078","E02002407",6471,6398,73
"2021","Leeds 079","E02002408",7535,7442,93
"2021","Leeds 080","E02002409",6096,6060,36
"2021","Leeds 081","E02002410",6919,6822,97
"2021","Leeds 082","E02002411",9059,8958,101
"2021","Leeds 083","E02002412",7233,7227,6
"2021","Leeds 085","E02002414",6738,6680,58
"2021","Leeds 086","E02002415",7876,7874,2
"2021","Leeds 087","E02002416",6961,6873,88
"2021","Leeds 088","E02002417",7321,7280,41
"2021","Leeds 089","E02002418",7078,7078,0
"2021","Leeds 090","E02002419",8188,8184,4
"2021","Leeds 091","E02002420",8370,8369,1
"2021","Leeds 092","E02002421",6364,6322,42
"2021","Leeds 093","E02002422",6448,6380,68
"2021","Leeds 094","E02002423",5796,5753,43
"2021","Leeds 095","E02002424",7637,7584,53
"2021","Leeds 096","E02002425",8668,8597,71
"2021","Leeds 097","E02002426",7776,7654,122
"2021","Leeds 098","E02002427",6708,6692,16
"2021","Leeds 099","E02002428",8039,8031,8
"2021","Leeds 100","E02002429",8521,8469,52
"2021","Leeds 101","E02002430",8205,8176,29
"2021","Leeds 102","E02002431",8824,8800,24
"2021","Leeds 103","E02002432",7652,7536,116
"2021","Leeds 104","E02002433",6774,6741,33
"2021","Leeds 105","E02002434",10189,10101,88
"2021","Leeds 106","E02002435",8309,8293,16
"2021","Leeds 107","E02002436",6909,6868,41
"2021","Leeds 108","E02002437",6175,6175,0
"2021","Leeds 109","E02006852",11848,11210,638
"2021","Leeds 110","E02006861",13634,11596,2038
"2021","Leeds 111","E02006875",9531,5591,3940
"2021","Leeds 112","E02006876",7886,7310,576
"2021","Wakefield 001","E02002438",8951,8878,73
"2021","Wakefield 002","E02002439",8669,8546,123
"2021","Wakefield 003","E02002440",7901,7888,13
"2021","Wakefield 004","E02002441",9755,9649,106
"2021","Wakefield 005","E02002442",7269,7229,40
"2021","Wakefield 006","E02002443",6146,6053,93
"2021","Wakefield 007","E02002444",6929,6914,15
"2021","Wakefield 008","E02002445",8500,8374,126
"2021","Wakefield 009","E02002446",5927,5877,50
"2021","Wakefield 010","E02002447",6162,6084,78
"2021","Wakefield 011","E02002448",8089,8053,36
"2021","Wakefield 012","E02002449",9813,9682,131
"2021","Wakefield 013","E02002450",7910,7856,54
"2021","Wakefield 014","E02002451",7954,7836,118
"2021","Wakefield 015","E02002452",9207,9112,95
"2021","Wakefield 016","E02002453",9665,9589,76
"2021","Wakefield 017","E02002454",9191,9060,131
"2021","Wakefield 018","E02002455",6485,6483,2
"2021","Wakefield 019","E02002456",8067,7286,781
"2021","Wakefield 020","E02002457",7945,7891,54
"2021","Wakefield 021","E02002458",9081,9033,48
"2021","Wakefield 022","E02002459",10050,9973,77
"2021","Wakefield 023","E02002460",7471,7441,30
"2021","Wakefield 024","E02002461",11902,11745,157
"2021","Wakefield 025","E02002462",7441,7420,21
"2021","Wakefield 026","E02002463",10380,10353,27
"2021","Wakefield 027","E02002464",9039,9016,23
"2021","Wakefield 028","E02002465",6091,6090,1
"2021","Wakefield 029","E02002466",9050,9050,0
"2021","Wakefield 030","E02002467",8990,8942,48
"2021","Wakefield 031","E02002468",6147,6080,67
"2021","Wakefield 032","E02002469",6524,6524,0
"2021","Wakefield 033","E02002470",6032,6005,27
"2021","Wakefield 034","E02002471",11478,11397,81
"2021","Wakefield 035","E02002472",5750,5526,224
"2021","Wakefield 036","E02002473",6716,6611,105
"2021","Wakefield 037","E02002474",6971,6960,11
"2021","Wakefield 038","E02002475",6278,6226,52
"2021","Wakefield 039","E02002476",6688,6606,82
"2021","Wakefield 040","E02002477",6297,6268,29
"2021","Wakefield 041","E02002478",6248,6247,1
"2021","Wakefield 042","E02002479",8147,8104,43
"2021","Wakefield 043","E02002480",5499,5489,10
"2021","Wakefield 044","E02002481",7385,7260,125
"2021","Wakefield 045","E02002482",7186,7124,62
"2021","Derby 001","E02002796",6182,6182,0
"2021","Derby 002","E02002797",7361,7321,40
"2021","Derby 003","E02002798",10399,10381,18
"2021","Derby 004","E02002799",6320,6320,0
"2021","Derby 005","E02002800",7013,6866,147
"2021","Derby 006","E02002801",7421,7415,6
"2021","Derby 007","E02002802",7966,7870,96
"2021","Derby 008","E02002803",8244,6738,1506
"2021","Derby 009","E02002804",9098,9096,2
"2021","Derby 010","E02002805",5597,5597,0
"2021","Derby 011","E02002806",6401,6060,341
"2021","Derby 012","E02002807",9030,8994,36
"2021","Derby 013","E02002808",12267,11442,825
"2021","Derby 014","E02002809",7054,6931,123
"2021","Derby 015","E02002810",9163,9135,28
"2021","Derby 016","E02002811",10930,10881,49
"2021","Derby 017","E02002812",7818,7525,293
"2021","Derby 018","E02002813",11564,11470,94
"2021","Derby 019","E02002814",7182,7134,48
"2021","Derby 020","E02002815",8956,8935,21
"2021","Derby 021","E02002816",9418,9341,77
"2021","Derby 022","E02002817",6311,6283,28
"2021","Derby 023","E02002818",8533,8427,106
"2021","Derby 024","E02002819",7562,7403,159
"2021","Derby 025","E02002820",9941,9916,25
"2021","Derby 026","E02002821",12441,12338,103
"2021","Derby 027","E02002822",6940,6924,16
"2021","Derby 028","E02002823",7678,7633,45
"2021","Derby 029","E02002824",10803,10770,33
"2021","Derby 030","E02002825",8675,8538,137
"2021","Derby 031","E02002826",7093,7092,1
"2021","Leicester 001","E02002827",6892,6848,44
"2021","Leicester 002","E02002828",8228,8204,24
"2021","Leicester 003","E02002829",11778,11650,128
"2021","Leicester 004","E02002830",11021,10945,76
"2021","Leicester 005","E02002831",7238,7157,81
"2021","Leicester 006","E02002832",10317,10152,165
"2021","Leicester 007","E02002833",8999,8999,0
"2021","Leicester 008","E02002834",11926,11704,222
"2021","Leicester 010","E02002836",11228,11228,0
"2021","Leicester 011","E02002837",9981,9951,30
"2021","Leicester 012","E02002838",8619,8578,41
"2021","Leicester 013","E02002839",8516,8475,41
"2021","Leicester 016","E02002842",8750,8497,253
"2021","Leicester 017","E02002843",15836,15803,33
"2021","Leicester 018","E02002844",12361,12347,14
"2021","Leicester 019","E02002845",11176,11057,119
"2021","Leicester 020","E02002846",7558,7460,98
"2021","Leicester 021","E02002847",10608,10576,32
"2021","Leicester 022","E02002848",11123,11076,47
"2021","Leicester 023","E02002849",13815,12131,1684
"2021","Leicester 025","E02002851",8720,8646,74
"2021","Leicester 026","E02002852",7388,7384,4
"2021","Leicester 027","E02002853",13443,13302,141
"2021","Leicester 028","E02002854",8456,8327,129
"2021","Leicester 029","E02002855",8146,7733,413
"2021","Leicester 030","E02002856",11333,11063,270
"2021","Leicester 031","E02002857",7256,7164,92
"2021","Leicester 032","E02002858",7324,7219,105
"2021","Leicester 034","E02002860",8344,8128,216
"2021","Leicester 035","E02002861",8276,8238,38
"2021","Leicester 036","E02002862",8651,8602,49
"2021","Leicester 037","E02006815",11793,11623,170
"2021","Leicester 038","E02006817",9230,8504,726
"2021","Leicester 039","E02006819",8819,8745,74
"2021","Leicester 040","E02006850",10114,6194,3920
"2021","Leicester 041","E02006851",10053,6520,3533
"2021","Leicester 042","E02006964",6783,6783,0
"2021","Leicester 043","E02006965",8472,8340,132
"2021","Rutland 001","E02002863",8950,6844,2106
"2021","Rutland 002","E02002864",8281,8209,72
"2021","Rutland 003","E02002865",7870,7410,460
"2021","Rutland 004","E02002866",7479,7334,145
"2021","Rutland 005","E02002867",8471,7642,829
"2021","Nottingham 001","E02002868",6016,6016,0
"2021","Nottingham 002","E02002869",7522,7481,41
"2021","Nottingham 004","E02002871",7981,7864,117
"2021","Nottingham 005","E02002872",8695,8654,41
"2021","Nottingham 006","E02002873",9433,9361,72
"2021","Nottingham 007","E02002874",8058,7445,613
"2021","Nottingham 008","E02002875",8436,8405,31
"2021","Nottingham 009","E02002876",7932,7679,253
"2021","Nottingham 010","E02002877",7714,7610,104
"2021","Nottingham 011","E02002878",9282,9272,10
"2021","Nottingham 012","E02002879",10013,9735,278
"2021","Nottingham 013","E02002880",8744,8744,0
"2021","Nottingham 014","E02002881",6865,6781,84
"2021","Nottingham 015","E02002882",8745,8142,603
"2021","Nottingham 016","E02002883",7704,7647,57
"2021","Nottingham 017","E02002884",7430,7275,155
"2021","Nottingham 018","E02002885",8642,8625,17
"2021","Nottingham 019","E02002886",10276,10276,0
"2021","Nottingham 020","E02002887",6687,6577,110
"2021","Nottingham 021","E02002888",7859,7858,1
"2021","Nottingham 022","E02002889",11302,6991,4311
"2021","Nottingham 023","E02002890",11560,8572,2988
"2021","Nottingham 024","E02002891",8459,8435,24
"2021","Nottingham 025","E02002892",6186,6176,10
"2021","Nottingham 026","E02002893",13952,10568,3384
"2021","Nottingham 028","E02002895",9671,8895,776
"2021","Nottingham 029","E02002896",10080,10048,32
"2021","Nottingham 030","E02002897",7939,7939,0
"2021","Nottingham 031","E02002898",10990,10520,470
"2021","Nottingham 034","E02002901",6129,6054,75
"2021","Nottingham 035","E02002902",9386,8071,1315
"2021","Nottingham 036","E02002903",5894,5894,0
"2021","Nottingham 037","E02002904",6376,6333,43
"2021","Nottingham 038","E02006834",7632,7592,40
"2021","Nottingham 039","E02006904",9213,7729,1484
"2021","Nottingham 040","E02006905",7908,7902,6
"2021","Nottingham 041","E02007082",16920,11897,5023
"2021","North Northamptonshire 002","E02005612",7321,7195,126
"2021","North Northamptonshire 003","E02005613",9333,9293,40
"2021","North Northamptonshire 006","E02005614",13797,13731,66
"2021","North Northamptonshire 004","E02005615",9400,9395,5
"2021","North Northamptonshire 005","E02005616",5862,5858,4
"2021","North Northamptonshire 007","E02005617",11189,11187,2
"2021","North Northamptonshire 001","E02005629",6480,6430,50
"2021","North Northamptonshire 010","E02005630",10585,9636,949
"2021","North Northamptonshire 011","E02005631",11120,11091,29
"2021","North Northamptonshire 024","E02005632",6523,6410,113
"2021","North Northamptonshire 025","E02005633",9875,9763,112
"2021","North Northamptonshire 027","E02005634",9311,9247,64
"2021","North Northamptonshire 035","E02005635",9446,9379,67
"2021","North Northamptonshire 034","E02005636",12347,12228,119
"2021","North Northamptonshire 037","E02005637",9357,9281,76
"2021","North Northamptonshire 039","E02005638",9984,9936,48
"2021","North Northamptonshire 012","E02005639",5609,5552,57
"2021","North Northamptonshire 013","E02005640",11900,11779,121
"2021","North Northamptonshire 014","E02005641",8621,8619,2
"2021","North Northamptonshire 015","E02005642",8442,8331,111
"2021","North Northamptonshire 016","E02005643",8742,8742,0
"2021","North Northamptonshire 017","E02005644",9201,9120,81
"2021","North Northamptonshire 018","E02005645",12629,12249,380
"2021","North Northamptonshire 019","E02005646",6500,6500,0
"2021","North Northamptonshire 022","E02005647",7623,7545,78
"2021","North Northamptonshire 021","E02005648",9708,9661,47
"2021","North Northamptonshire 026","E02005692",6983,6983,0
"2021","North Northamptonshire 028","E02005693",8712,8705,7
"2021","North Northamptonshire 029","E02005694",7555,7543,12
"2021","North Northamptonshire 030","E02005695",10074,9987,87
"2021","North Northamptonshire 031","E02005696",6420,6375,45
"2021","North Northamptonshire 032","E02005697",7294,7060,234
"2021","North Northamptonshire 033","E02005698",6044,5985,59
"2021","North Northamptonshire 036","E02005699",8615,8611,4
"2021","North Northamptonshire 038","E02005700",10210,10201,9
"2021","North Northamptonshire 040","E02005701",11194,11081,113
"2021","North Northamptonshire 009","E02006862",6653,6641,12
"2021","North Northamptonshire 008","E02006863",12016,11976,40
"2021","North Northamptonshire 020","E02007070",6407,6390,17
"2021","North Northamptonshire 023","E02007071",10443,10404,39
"2021","West Northamptonshire 001","E02005619",6330,6225,105
"2021","West Northamptonshire 002","E02005620",8655,8447,208
"2021","West Northamptonshire 004","E02005621",9060,7728,1332
"2021","West Northamptonshire 005","E02005622",9890,9886,4
"2021","West Northamptonshire 003","E02005623",11574,11344,230
"2021","West Northamptonshire 010","E02005624",11521,11521,0
"2021","West Northamptonshire 016","E02005625",9425,9306,119
"2021","West Northamptonshire 022","E02005626",7180,7179,1
"2021","West Northamptonshire 027","E02005627",7649,7639,10
"2021","West Northamptonshire 042","E02005628",8497,8425,72
"2021","West Northamptonshire 006","E02005650",6970,6471,499
"2021","West Northamptonshire 007","E02005651",6391,6368,23
"2021","West Northamptonshire 008","E02005652",6754,6681,73
"2021","West Northamptonshire 011","E02005653",8985,8953,32
"2021","West Northamptonshire 009","E02005654",8717,8717,0
"2021","West Northamptonshire 012","E02005655",6386,6346,40
"2021","West Northamptonshire 014","E02005656",6671,6670,1
"2021","West Northamptonshire 013","E02005657",6604,6556,48
"2021","West Northamptonshire 015","E02005658",6966,6933,33
"2021","West Northamptonshire 018","E02005659",6016,5981,35
"2021","West Northamptonshire 026","E02005660",6645,6594,51
"2021","West Northamptonshire 017","E02005661",6983,6933,50
"2021","West Northamptonshire 019","E02005662",6800,6759,41
"2021","West Northamptonshire 023","E02005663",5541,5541,0
"2021","West Northamptonshire 025","E02005664",6194,5888,306
"2021","West Northamptonshire 024","E02005665",8519,8506,13
"2021","West Northamptonshire 021","E02005666",9143,9143,0
"2021","West Northamptonshire 020","E02005667",6778,6701,77
"2021","West Northamptonshire 028","E02005668",6569,6497,72
"2021","West Northamptonshire 029","E02005669",6057,6017,40
"2021","West Northamptonshire 032","E02005670",9655,9649,6
"2021","West Northamptonshire 030","E02005671",7900,7835,65
"2021","West Northamptonshire 031","E02005672",8570,8546,24
"2021","West Northamptonshire 033","E02005673",7761,7634,127
"2021","West Northamptonshire 034","E02005674",9284,8367,917
"2021","West Northamptonshire 036","E02005675",6431,6431,0
"2021","West Northamptonshire 038","E02005676",6247,6241,6
"2021","West Northamptonshire 037","E02005677",9980,9185,795
"2021","West Northamptonshire 041","E02005679",9051,9047,4
"2021","West Northamptonshire 044","E02005680",8734,8626,108
"2021","West Northamptonshire 040","E02005681",8609,8576,33
"2021","West Northamptonshire 043","E02005682",7561,7553,8
"2021","West Northamptonshire 046","E02005683",15036,14897,139
"2021","West Northamptonshire 045","E02005684",8685,8619,66
"2021","West Northamptonshire 047","E02005685",10048,10024,24
"2021","West Northamptonshire 048","E02005686",8012,7913,99
"2021","West Northamptonshire 049","E02005687",6670,6646,24
"2021","West Northamptonshire 050","E02005688",9744,9744,0
"2021","West Northamptonshire 051","E02005689",10686,10600,86
"2021","West Northamptonshire 053","E02005690",5502,5453,49
"2021","West Northamptonshire 052","E02005691",6737,6437,300
"2021","West Northamptonshire 035","E02007072",7657,7556,101
"2021","West Northamptonshire 039","E02007073",7695,7695,0
"2021","Amber Valley 001","E02004029",7346,7282,64
"2021","Amber Valley 002","E02004030",6033,5984,49
"2021","Amber Valley 003","E02004031",7475,7369,106
"2021","Amber Valley 004","E02004032",8441,8418,23
"2021","Amber Valley 005","E02004033",8927,8768,159
"2021","Amber Valley 006","E02004034",6826,6770,56
"2021","Amber Valley 007","E02004035",6414,6367,47
"2021","Amber Valley 008","E02004036",10309,10281,28
"2021","Amber Valley 009","E02004037",7877,7877,0
"2021","Amber Valley 010","E02004038",7523,7381,142
"2021","Amber Valley 011","E02004039",7742,7681,61
"2021","Amber Valley 012","E02004040",9482,9426,56
"2021","Amber Valley 013","E02004041",7365,7279,86
"2021","Amber Valley 015","E02004043",7324,7276,48
"2021","Amber Valley 016","E02004044",9119,9051,68
"2021","Amber Valley 017","E02006827",8006,7988,18
"2021","Bolsover 001","E02004045",9752,9683,69
"2021","Bolsover 002","E02004046",6186,6160,26
"2021","Bolsover 003","E02004047",6165,6063,102
"2021","Bolsover 004","E02004048",7045,7024,21
"2021","Bolsover 005","E02004049",7899,7816,83
"2021","Bolsover 006","E02004050",7803,7759,44
"2021","Bolsover 007","E02004051",9681,9572,109
"2021","Bolsover 008","E02004052",8749,8691,58
"2021","Bolsover 009","E02004053",7842,7806,36
"2021","Bolsover 010","E02004054",9154,9056,98
"2021","Chesterfield 001","E02004055",6915,6830,85
"2021","Chesterfield 002","E02004056",8046,7958,88
"2021","Chesterfield 003","E02004057",7761,7712,49
"2021","Chesterfield 004","E02004058",8004,7973,31
"2021","Chesterfield 005","E02004059",7207,7078,129
"2021","Chesterfield 006","E02004060",7512,7449,63
"2021","Chesterfield 007","E02004061",7388,7333,55
"2021","Chesterfield 008","E02004062",7585,7564,21
"2021","Chesterfield 009","E02004063",7741,7658,83
"2021","Chesterfield 010","E02004064",9584,9492,92
"2021","Chesterfield 011","E02004065",8107,8059,48
"2021","Chesterfield 012","E02004066",11420,11241,179
"2021","Chesterfield 013","E02004067",6298,6298,0
"2021","Derbyshire Dales 001","E02004068",7260,7224,36
"2021","Derbyshire Dales 002","E02004069",6315,6250,65
"2021","Derbyshire Dales 005","E02004072",9391,9252,139
"2021","Derbyshire Dales 006","E02004073",8803,8713,90
"2021","Derbyshire Dales 007","E02004074",5795,5784,11
"2021","Derbyshire Dales 008","E02004075",7129,7103,26
"2021","Derbyshire Dales 009","E02004076",7528,7455,73
"2021","Derbyshire Dales 010","E02004077",8264,7712,552
"2021","Derbyshire Dales 011","E02007029",11054,10936,118
"2021","Erewash 001","E02004078",7027,7012,15
"2021","Erewash 003","E02004080",9737,9632,105
"2021","Erewash 004","E02004081",5806,5780,26
"2021","Erewash 005","E02004082",6069,5947,122
"2021","Erewash 006","E02004083",8241,8228,13
"2021","Erewash 007","E02004084",5966,5937,29
"2021","Erewash 008","E02004085",8903,8789,114
"2021","Erewash 009","E02004086",7167,7121,46
"2021","Erewash 010","E02004087",7764,7732,32
"2021","Erewash 011","E02004088",7621,7488,133
"2021","Erewash 012","E02004089",6851,6819,32
"2021","Erewash 013","E02004090",5946,5922,24
"2021","Erewash 014","E02004091",9312,9268,44
"2021","Erewash 015","E02004092",9388,9388,0
"2021","Erewash 016","E02006828",7105,7067,38
"2021","High Peak 001","E02004093",6370,6323,47
"2021","High Peak 002","E02004094",7028,6969,59
"2021","High Peak 003","E02004095",10153,10116,37
"2021","High Peak 004","E02004096",9789,9725,64
"2021","High Peak 005","E02004097",7475,7449,26
"2021","High Peak 006","E02004098",7353,7308,45
"2021","High Peak 008","E02004100",8157,8100,57
"2021","High Peak 010","E02004102",7606,7379,227
"2021","High Peak 011","E02004103",6871,6828,43
"2021","High Peak 012","E02004104",7242,7225,17
"2021","High Peak 013","E02006872",12894,12855,39
"2021","North East Derbyshire 001","E02004105",9259,9198,61
"2021","North East Derbyshire 002","E02004106",6762,6762,0
"2021","North East Derbyshire 004","E02004108",7555,7456,99
"2021","North East Derbyshire 005","E02004109",6790,6749,41
"2021","North East Derbyshire 006","E02004110",7378,7378,0
"2021","North East Derbyshire 007","E02004111",5549,5519,30
"2021","North East Derbyshire 008","E02004112",6272,6226,46
"2021","North East Derbyshire 009","E02004113",10219,10130,89
"2021","North East Derbyshire 010","E02004114",8471,8429,42
"2021","North East Derbyshire 011","E02004115",8811,8750,61
"2021","North East Derbyshire 012","E02004116",8546,8487,59
"2021","North East Derbyshire 013","E02004117",8081,8024,57
"2021","North East Derbyshire 014","E02006804",8309,8183,126
"2021","South Derbyshire 001","E02004118",7714,7462,252
"2021","South Derbyshire 002","E02004119",11895,11830,65
"2021","South Derbyshire 003","E02004120",10939,10927,12
"2021","South Derbyshire 004","E02004121",9288,9241,47
"2021","South Derbyshire 005","E02004122",6916,6374,542
"2021","South Derbyshire 006","E02004123",6769,6728,41
"2021","South Derbyshire 007","E02004124",7560,7556,4
"2021","South Derbyshire 008","E02004125",8687,8654,33
"2021","South Derbyshire 009","E02004126",7449,7384,65
"2021","South Derbyshire 011","E02004128",11474,11295,179
"2021","South Derbyshire 012","E02006919",10440,10389,51
"2021","South Derbyshire 013","E02006920",8076,8039,37
"2021","Blaby 002","E02005334",6065,6024,41
"2021","Blaby 003","E02005335",7551,7435,116
"2021","Blaby 004","E02005336",7278,7276,2
"2021","Blaby 005","E02005337",9984,9970,14
"2021","Blaby 006","E02005338",11380,11363,17
"2021","Blaby 007","E02005339",8680,8657,23
"2021","Blaby 008","E02005340",8898,8871,27
"2021","Blaby 009","E02005341",7620,7575,45
"2021","Blaby 010","E02005342",7429,7411,18
"2021","Blaby 011","E02005343",7966,7940,26
"2021","Blaby 012","E02005344",9249,9185,64
"2021","Blaby 013","E02006820",10820,10799,21
"2021","Charnwood 001","E02005345",6415,6414,1
"2021","Charnwood 002","E02005346",12655,12272,383
"2021","Charnwood 003","E02005347",11233,9944,1289
"2021","Charnwood 004","E02005348",5520,5403,117
"2021","Charnwood 005","E02005349",7922,7864,58
"2021","Charnwood 006","E02005350",6945,6714,231
"2021","Charnwood 007","E02005351",11274,6224,5050
"2021","Charnwood 008","E02005352",6285,6167,118
"2021","Charnwood 009","E02005353",10686,10254,432
"2021","Charnwood 010","E02005354",10203,9929,274
"2021","Charnwood 011","E02005355",7358,7327,31
"2021","Charnwood 012","E02005356",7259,7162,97
"2021","Charnwood 013","E02005357",8418,8377,41
"2021","Charnwood 014","E02005358",12258,12201,57
"2021","Charnwood 015","E02005359",7720,7664,56
"2021","Charnwood 016","E02005360",6372,6158,214
"2021","Charnwood 017","E02005361",6327,6245,82
"2021","Charnwood 018","E02005362",7292,7234,58
"2021","Charnwood 019","E02005363",9059,8976,83
"2021","Charnwood 020","E02005364",5259,5259,0
"2021","Charnwood 021","E02005365",9816,9763,53
"2021","Charnwood 022","E02005366",7697,7687,10
"2021","Harborough 002","E02005368",6405,6365,40
"2021","Harborough 003","E02005369",12763,12704,59
"2021","Harborough 004","E02005370",9651,9610,41
"2021","Harborough 005","E02005371",10789,10723,66
"2021","Harborough 006","E02005372",10232,10145,87
"2021","Harborough 007","E02005373",12174,11550,624
"2021","Harborough 008","E02005374",6552,6356,196
"2021","Harborough 009","E02005375",9381,9218,163
"2021","Harborough 010","E02005376",10830,10804,26
"2021","Harborough 011","E02006816",8848,8820,28
"2021","Hinckley and Bosworth 001","E02005377",9064,9040,24
"2021","Hinckley and Bosworth 002","E02005378",5324,5321,3
"2021","Hinckley and Bosworth 003","E02005379",6062,6056,6
"2021","Hinckley and Bosworth 004","E02005380",8677,8624,53
"2021","Hinckley and Bosworth 005","E02005381",8874,8765,109
"2021","Hinckley and Bosworth 006","E02005382",10630,10539,91
"2021","Hinckley and Bosworth 007","E02005383",9152,9078,74
"2021","Hinckley and Bosworth 008","E02005384",7406,7241,165
"2021","Hinckley and Bosworth 009","E02005385",6640,6640,0
"2021","Hinckley and Bosworth 010","E02005386",9117,8962,155
"2021","Hinckley and Bosworth 011","E02005387",9957,9953,4
"2021","Hinckley and Bosworth 012","E02005388",6229,6229,0
"2021","Hinckley and Bosworth 013","E02005389",6049,5950,99
"2021","Hinckley and Bosworth 014","E02005390",10459,10457,2
"2021","Melton 001","E02005391",9720,9714,6
"2021","Melton 002","E02005392",9283,9252,31
"2021","Melton 003","E02005393",7434,7371,63
"2021","Melton 004","E02005394",9626,9537,89
"2021","Melton 005","E02005395",8823,8740,83
"2021","Melton 006","E02005396",6871,6758,113
"2021","North West Leicestershire 001","E02005397",9258,9215,43
"2021","North West Leicestershire 002","E02005398",6865,6860,5
"2021","North West Leicestershire 003","E02005399",8321,8317,4
"2021","North West Leicestershire 004","E02005400",5834,5791,43
"2021","North West Leicestershire 005","E02005401",6467,6467,0
"2021","North West Leicestershire 006","E02005402",6801,6687,114
"2021","North West Leicestershire 007","E02005403",6557,6526,31
"2021","North West Leicestershire 008","E02005404",8722,8697,25
"2021","North West Leicestershire 009","E02005405",7200,7141,59
"2021","North West Leicestershire 010","E02005406",7902,7799,103
"2021","North West Leicestershire 011","E02005407",10934,10934,0
"2021","North West Leicestershire 012","E02005408",7841,7839,2
"2021","North West Leicestershire 013","E02005409",12003,11979,24
"2021","Oadby and Wigston 003","E02005412",8823,8706,117
"2021","Oadby and Wigston 005","E02005414",8230,8014,216
"2021","Oadby and Wigston 006","E02005415",8115,8052,63
"2021","Oadby and Wigston 007","E02005416",8967,8966,1
"2021","Oadby and Wigston 008","E02006818",8404,8384,20
"2021","Oadby and Wigston 010","E02006966",7443,6023,1420
"2021","Oadby and Wigston 011","E02006967",7765,7765,0
"2021","Boston 001","E02005417",7560,7212,348
"2021","Boston 002","E02005418",11012,10975,37
"2021","Boston 003","E02005419",8732,8685,47
"2021","Boston 004","E02005420",8858,8826,32
"2021","Boston 006","E02005422",6690,6690,0
"2021","Boston 007","E02005423",10451,10356,95
"2021","Boston 008","E02006864",8846,8770,76
"2021","Boston 009","E02006865",8350,8213,137
"2021","East Lindsey 001","E02005424",10199,10072,127
"2021","East Lindsey 002","E02005425",6516,6516,0
"2021","East Lindsey 003","E02005426",10479,10311,168
"2021","East Lindsey 004","E02005427",6897,6790,107
"2021","East Lindsey 005","E02005428",8452,8287,165
"2021","East Lindsey 006","E02005429",6244,6149,95
"2021","East Lindsey 007","E02005430",7057,7021,36
"2021","East Lindsey 008","E02005431",8841,8716,125
"2021","East Lindsey 009","E02005432",7771,7685,86
"2021","East Lindsey 010","E02005433",7006,6855,151
"2021","East Lindsey 011","E02005434",7554,7470,84
"2021","East Lindsey 012","E02005435",7858,7813,45
"2021","East Lindsey 013","E02005436",8174,8044,130
"2021","East Lindsey 014","E02005437",6244,6033,211
"2021","East Lindsey 015","E02005438",7026,6994,32
"2021","East Lindsey 016","E02005439",11947,11216,731
"2021","East Lindsey 017","E02005440",5556,5516,40
"2021","East Lindsey 018","E02005441",8477,8438,39
"2021","Lincoln 001","E02005442",6642,6593,49
"2021","Lincoln 002","E02005443",7502,7413,89
"2021","Lincoln 003","E02005444",13625,12787,838
"2021","Lincoln 004","E02005445",12718,12160,558
"2021","Lincoln 005","E02005446",10448,7056,3392
"2021","Lincoln 006","E02005447",8314,8144,170
"2021","Lincoln 007","E02005448",7321,7321,0
"2021","Lincoln 008","E02005449",9411,7423,1988
"2021","Lincoln 009","E02005450",8433,8351,82
"2021","Lincoln 010","E02005451",8054,8006,48
"2021","Lincoln 011","E02005452",11351,11308,43
"2021","North Kesteven 001","E02005453",10720,10702,18
"2021","North Kesteven 003","E02005455",14465,14207,258
"2021","North Kesteven 004","E02005456",10937,10463,474
"2021","North Kesteven 005","E02005457",8739,8657,82
"2021","North Kesteven 006","E02005458",6738,6604,134
"2021","North Kesteven 007","E02005459",8496,8409,87
"2021","North Kesteven 008","E02005460",6380,5752,628
"2021","North Kesteven 009","E02005461",6343,6294,49
"2021","North Kesteven 010","E02005462",9835,9770,65
"2021","North Kesteven 011","E02005463",9974,9921,53
"2021","North Kesteven 012","E02005464",8602,8537,65
"2021","North Kesteven 013","E02006866",8698,8619,79
"2021","North Kesteven 014","E02006867",8148,8114,34
"2021","South Holland 001","E02005465",8806,8701,105
"2021","South Holland 002","E02005466",6768,6720,48
"2021","South Holland 003","E02005467",7742,7698,44
"2021","South Holland 004","E02005468",7637,7608,29
"2021","South Holland 005","E02005469",7984,7963,21
"2021","South Holland 006","E02005470",12931,12862,69
"2021","South Holland 007","E02005471",9123,9087,36
"2021","South Holland 008","E02005472",9986,9875,111
"2021","South Holland 009","E02005473",9802,9605,197
"2021","South Holland 010","E02005474",7166,7063,103
"2021","South Holland 011","E02005475",7177,7157,20
"2021","South Kesteven 001","E02005476",7194,7182,12
"2021","South Kesteven 002","E02005477",9067,9025,42
"2021","South Kesteven 003","E02005478",10026,9952,74
"2021","South Kesteven 004","E02005479",9862,9721,141
"2021","South Kesteven 005","E02005480",7441,7440,1
"2021","South Kesteven 006","E02005481",12267,12109,158
"2021","South Kesteven 007","E02005482",9600,9579,21
"2021","South Kesteven 008","E02005483",7884,7809,75
"2021","South Kesteven 009","E02005484",7178,7171,7
"2021","South Kesteven 010","E02005485",8425,8351,74
"2021","South Kesteven 011","E02005486",9560,9444,116
"2021","South Kesteven 012","E02005487",9788,9692,96
"2021","South Kesteven 013","E02005488",7104,7019,85
"2021","South Kesteven 014","E02005489",7255,7208,47
"2021","South Kesteven 015","E02005490",9242,9167,75
"2021","South Kesteven 016","E02005491",11507,11316,191
"2021","West Lindsey 001","E02005492",9840,9740,100
"2021","West Lindsey 002","E02005493",10139,9978,161
"2021","West Lindsey 003","E02005494",9727,9618,109
"2021","West Lindsey 004","E02005495",10500,10368,132
"2021","West Lindsey 005","E02005496",6283,6263,20
"2021","West Lindsey 006","E02005497",7477,7376,101
"2021","West Lindsey 007","E02005498",7416,7288,128
"2021","West Lindsey 008","E02005499",8554,8484,70
"2021","West Lindsey 009","E02005500",7336,7171,165
"2021","West Lindsey 010","E02005501",8110,8083,27
"2021","West Lindsey 011","E02005502",9769,9660,109
"2021","Ashfield 001","E02005819",6311,6303,8
"2021","Ashfield 002","E02005820",5528,5528,0
"2021","Ashfield 003","E02005821",6696,6679,17
"2021","Ashfield 004","E02005822",10279,10084,195
"2021","Ashfield 005","E02005823",7730,7458,272
"2021","Ashfield 006","E02005824",9780,9709,71
"2021","Ashfield 007","E02005825",7796,7745,51
"2021","Ashfield 008","E02005826",6164,6117,47
"2021","Ashfield 009","E02005827",9430,9416,14
"2021","Ashfield 010","E02005828",7697,7673,24
"2021","Ashfield 011","E02005829",6583,6494,89
"2021","Ashfield 012","E02005830",5876,5876,0
"2021","Ashfield 013","E02005831",10626,10515,111
"2021","Ashfield 014","E02005832",9301,9180,121
"2021","Ashfield 015","E02005833",7633,7613,20
"2021","Ashfield 016","E02005834",8873,8795,78
"2021","Bassetlaw 001","E02005835",11186,11113,73
"2021","Bassetlaw 002","E02005836",9230,9183,47
"2021","Bassetlaw 003","E02005837",7817,6853,964
"2021","Bassetlaw 004","E02005838",8265,8264,1
"2021","Bassetlaw 005","E02005839",6351,6299,52
"2021","Bassetlaw 006","E02005840",9682,9640,42
"2021","Bassetlaw 008","E02005842",8821,8669,152
"2021","Bassetlaw 009","E02005843",7057,6995,62
"2021","Bassetlaw 010","E02005844",8795,8749,46
"2021","Bassetlaw 012","E02005846",6752,6616,136
"2021","Bassetlaw 013","E02005847",6951,6888,63
"2021","Bassetlaw 014","E02005848",6410,6267,143
"2021","Bassetlaw 015","E02005849",9393,9081,312
"2021","Bassetlaw 016","E02006903",11093,10935,158
"2021","Broxtowe 001","E02005850",6679,6562,117
"2021","Broxtowe 002","E02005851",6221,6174,47
"2021","Broxtowe 003","E02005852",8274,8248,26
"2021","Broxtowe 004","E02005853",9160,9128,32
"2021","Broxtowe 007","E02005856",7244,7195,49
"2021","Broxtowe 008","E02005857",6193,6193,0
"2021","Broxtowe 009","E02005858",8112,7426,686
"2021","Broxtowe 010","E02005859",9260,9254,6
"2021","Broxtowe 011","E02005860",9079,8559,520
"2021","Broxtowe 012","E02005861",5376,5324,52
"2021","Broxtowe 013","E02005862",7591,7525,66
"2021","Broxtowe 014","E02005863",7438,7246,192
"2021","Broxtowe 015","E02005864",8064,7930,134
"2021","Broxtowe 016","E02006906",12248,12158,90
"2021","Gedling 001","E02005865",8605,8575,30
"2021","Gedling 002","E02005866",9228,9194,34
"2021","Gedling 004","E02005868",7300,7280,20
"2021","Gedling 005","E02005869",5876,5823,53
"2021","Gedling 006","E02005870",6679,6618,61
"2021","Gedling 007","E02005871",7059,7046,13
"2021","Gedling 008","E02005872",6594,6542,52
"2021","Gedling 009","E02005873",10025,9914,111
"2021","Gedling 010","E02005874",8427,8398,29
"2021","Gedling 011","E02005875",8186,8132,54
"2021","Gedling 012","E02005876",8827,8793,34
"2021","Gedling 013","E02005877",7386,7372,14
"2021","Gedling 014","E02005878",9659,9609,50
"2021","Gedling 015","E02005879",7324,7324,0
"2021","Gedling 016","E02006835",6093,6036,57
"2021","Mansfield 001","E02005880",6411,6411,0
"2021","Mansfield 002","E02005881",6233,6154,79
"2021","Mansfield 003","E02005882",7832,7820,12
"2021","Mansfield 004","E02005883",8316,8295,21
"2021","Mansfield 005","E02005884",6090,6058,32
"2021","Mansfield 006","E02005885",8906,8787,119
"2021","Mansfield 007","E02005886",11428,11380,48
"2021","Mansfield 008","E02005887",10179,9962,217
"2021","Mansfield 009","E02005888",8435,8340,95
"2021","Mansfield 010","E02005889",10684,10622,62
"2021","Mansfield 011","E02005890",6567,6541,26
"2021","Mansfield 012","E02005891",6352,6317,35
"2021","Mansfield 013","E02005892",13048,13010,38
"2021","Newark and Sherwood 001","E02005893",11272,11179,93
"2021","Newark and Sherwood 002","E02005894",11768,11625,143
"2021","Newark and Sherwood 003","E02005895",8061,8048,13
"2021","Newark and Sherwood 004","E02005896",7580,7518,62
"2021","Newark and Sherwood 005","E02005897",9284,9225,59
"2021","Newark and Sherwood 006","E02005898",11365,11211,154
"2021","Newark and Sherwood 007","E02005899",11686,11624,62
"2021","Newark and Sherwood 008","E02005900",7558,7026,532
"2021","Newark and Sherwood 009","E02005901",9662,9572,90
"2021","Newark and Sherwood 010","E02005902",8217,8133,84
"2021","Newark and Sherwood 011","E02005903",10348,10293,55
"2021","Newark and Sherwood 012","E02005904",9449,9341,108
"2021","Newark and Sherwood 013","E02005905",6707,5812,895
"2021","Rushcliffe 001","E02005906",7275,6448,827
"2021","Rushcliffe 002","E02005907",10110,10076,34
"2021","Rushcliffe 003","E02005908",9252,9137,115
"2021","Rushcliffe 004","E02005909",8337,8288,49
"2021","Rushcliffe 005","E02005910",8957,8867,90
"2021","Rushcliffe 006","E02005911",8511,8426,85
"2021","Rushcliffe 007","E02005912",9336,9222,114
"2021","Rushcliffe 008","E02005913",8586,8511,75
"2021","Rushcliffe 009","E02005914",8206,8113,93
"2021","Rushcliffe 010","E02005915",5711,5671,40
"2021","Rushcliffe 011","E02005916",7674,7555,119
"2021","Rushcliffe 012","E02005917",5938,5891,47
"2021","Rushcliffe 013","E02005918",5082,5081,1
"2021","Rushcliffe 014","E02005919",7313,6546,767
"2021","Rushcliffe 015","E02005920",8790,8701,89
"2021","Herefordshire 001","E02002905",6263,6228,35
"2021","Herefordshire 002","E02002906",5665,5621,44
"2021","Herefordshire 003","E02002907",6290,6153,137
"2021","Herefordshire 004","E02002908",8834,8776,58
"2021","Herefordshire 005","E02002909",10681,10544,137
"2021","Herefordshire 006","E02002910",7850,7732,118
"2021","Herefordshire 007","E02002911",9584,9291,293
"2021","Herefordshire 008","E02002912",7582,7538,44
"2021","Herefordshire 009","E02002913",5799,5553,246
"2021","Herefordshire 010","E02002914",8936,8876,60
"2021","Herefordshire 011","E02002915",7929,7696,233
"2021","Herefordshire 012","E02002916",9767,9644,123
"2021","Herefordshire 013","E02002917",6856,6782,74
"2021","Herefordshire 014","E02002918",5797,5740,57
"2021","Herefordshire 015","E02002919",9081,9007,74
"2021","Herefordshire 016","E02002920",6559,6524,35
"2021","Herefordshire 017","E02002921",7862,7862,0
"2021","Herefordshire 018","E02002922",6600,6488,112
"2021","Herefordshire 019","E02002923",9439,9333,106
"2021","Herefordshire 020","E02002924",6060,6028,32
"2021","Herefordshire 021","E02002925",10857,10773,84
"2021","Herefordshire 022","E02002926",10990,10868,122
"2021","Herefordshire 023","E02002927",11761,11594,167
"2021","Telford and Wrekin 001","E02002928",6064,6005,59
"2021","Telford and Wrekin 002","E02002929",6665,5950,715
"2021","Telford and Wrekin 003","E02002930",6994,6870,124
"2021","Telford and Wrekin 004","E02002931",6565,6551,14
"2021","Telford and Wrekin 005","E02002932",8958,8885,73
"2021","Telford and Wrekin 006","E02002933",8004,7913,91
"2021","Telford and Wrekin 007","E02002934",6174,6172,2
"2021","Telford and Wrekin 008","E02002935",6779,6779,0
"2021","Telford and Wrekin 009","E02002936",11158,11145,13
"2021","Telford and Wrekin 010","E02002937",10745,10586,159
"2021","Telford and Wrekin 011","E02002938",7322,7229,93
"2021","Telford and Wrekin 012","E02002939",7569,7489,80
"2021","Telford and Wrekin 013","E02002940",5855,5824,31
"2021","Telford and Wrekin 014","E02002941",10465,10455,10
"2021","Telford and Wrekin 015","E02002942",8045,7895,150
"2021","Telford and Wrekin 017","E02002944",8336,8334,2
"2021","Telford and Wrekin 018","E02002945",9442,9421,21
"2021","Telford and Wrekin 019","E02002946",7581,7577,4
"2021","Telford and Wrekin 020","E02002947",7130,7060,70
"2021","Telford and Wrekin 021","E02002948",7597,7560,37
"2021","Telford and Wrekin 022","E02002949",5322,5271,51
"2021","Telford and Wrekin 023","E02002950",5853,5853,0
"2021","Telford and Wrekin 024","E02007050",8359,8352,7
"2021","Telford and Wrekin 025","E02007051",8558,8457,101
"2021","Stoke-on-Trent 001","E02002951",7845,7755,90
"2021","Stoke-on-Trent 002","E02002952",7555,7409,146
"2021","Stoke-on-Trent 003","E02002953",7347,7309,38
"2021","Stoke-on-Trent 004","E02002954",8311,8282,29
"2021","Stoke-on-Trent 005","E02002955",7457,7429,28
"2021","Stoke-on-Trent 006","E02002956",9232,9080,152
"2021","Stoke-on-Trent 007","E02002957",9571,9506,65
"2021","Stoke-on-Trent 008","E02002958",8461,8422,39
"2021","Stoke-on-Trent 009","E02002959",9042,8917,125
"2021","Stoke-on-Trent 010","E02002960",5723,5716,7
"2021","Stoke-on-Trent 011","E02002961",7296,7257,39
"2021","Stoke-on-Trent 012","E02002962",7878,7862,16
"2021","Stoke-on-Trent 013","E02002963",7091,7089,2
"2021","Stoke-on-Trent 014","E02002964",8647,8602,45
"2021","Stoke-on-Trent 015","E02002965",8340,7682,658
"2021","Stoke-on-Trent 016","E02002966",10329,9679,650
"2021","Stoke-on-Trent 017","E02002967",10449,10313,136
"2021","Stoke-on-Trent 018","E02002968",9493,9225,268
"2021","Stoke-on-Trent 019","E02002969",9443,9112,331
"2021","Stoke-on-Trent 020","E02002970",7955,7899,56
"2021","Stoke-on-Trent 023","E02002973",8113,8112,1
"2021","Stoke-on-Trent 024","E02002974",6145,6026,119
"2021","Stoke-on-Trent 025","E02002975",7147,7145,2
"2021","Stoke-on-Trent 026","E02002976",5970,5950,20
"2021","Stoke-on-Trent 027","E02002977",5566,5486,80
"2021","Stoke-on-Trent 028","E02002978",6775,6754,21
"2021","Stoke-on-Trent 029","E02002979",6117,6053,64
"2021","Stoke-on-Trent 030","E02002980",6007,5930,77
"2021","Stoke-on-Trent 031","E02002981",8594,8589,5
"2021","Stoke-on-Trent 032","E02002982",8703,8703,0
"2021","Stoke-on-Trent 033","E02002983",5313,5313,0
"2021","Stoke-on-Trent 034","E02002984",5470,5268,202
"2021","Stoke-on-Trent 035","E02006974",10980,10964,16
"2021","Shropshire 025","E02006008",10459,10417,42
"2021","Shropshire 027","E02006009",7933,6315,1618
"2021","Shropshire 029","E02006010",11877,11799,78
"2021","Shropshire 031","E02006011",5658,5613,45
"2021","Shropshire 033","E02006012",6194,6064,130
"2021","Shropshire 034","E02006013",7876,7707,169
"2021","Shropshire 035","E02006014",9910,9833,77
"2021","Shropshire 001","E02006015",10142,10000,142
"2021","Shropshire 002","E02006016",8149,8081,68
"2021","Shropshire 004","E02006017",8069,7860,209
"2021","Shropshire 005","E02006018",12588,12542,46
"2021","Shropshire 008","E02006019",6283,6182,101
"2021","Shropshire 009","E02006020",7743,6554,1189
"2021","Shropshire 010","E02006021",8767,8703,64
"2021","Shropshire 013","E02006022",6063,5887,176
"2021","Shropshire 003","E02006023",10041,9665,376
"2021","Shropshire 006","E02006024",9918,9814,104
"2021","Shropshire 007","E02006025",9568,9417,151
"2021","Shropshire 011","E02006026",7374,7297,77
"2021","Shropshire 012","E02006027",5452,5421,31
"2021","Shropshire 014","E02006028",9810,9568,242
"2021","Shropshire 015","E02006029",8183,8182,1
"2021","Shropshire 016","E02006030",9094,9020,74
"2021","Shropshire 017","E02006031",7956,7818,138
"2021","Shropshire 018","E02006032",8654,8648,6
"2021","Shropshire 019","E02006033",8485,8207,278
"2021","Shropshire 020","E02006034",10662,10581,81
"2021","Shropshire 021","E02006035",5862,5824,38
"2021","Shropshire 022","E02006036",6574,6534,40
"2021","Shropshire 023","E02006037",9970,9348,622
"2021","Shropshire 024","E02006038",8422,8344,78
"2021","Shropshire 026","E02006039",8234,8135,99
"2021","Shropshire 028","E02006040",7781,7531,250
"2021","Shropshire 030","E02006041",5650,5581,69
"2021","Shropshire 032","E02006042",5752,5637,115
"2021","Shropshire 036","E02006043",6716,6699,17
"2021","Shropshire 037","E02006044",6106,6061,45
"2021","Shropshire 038","E02006045",10714,10525,189
"2021","Shropshire 039","E02006046",8917,8863,54
"2021","Cannock Chase 001","E02006118",7406,7363,43
"2021","Cannock Chase 002","E02006119",8188,8087,101
"2021","Cannock Chase 003","E02006120",9287,9262,25
"2021","Cannock Chase 004","E02006121",5869,5869,0
"2021","Cannock Chase 005","E02006122",8053,8050,3
"2021","Cannock Chase 006","E02006123",6459,6420,39
"2021","Cannock Chase 007","E02006124",7345,7331,14
"2021","Cannock Chase 008","E02006125",7308,7305,3
"2021","Cannock Chase 009","E02006126",8378,8262,116
"2021","Cannock Chase 010","E02006127",7133,7062,71
"2021","Cannock Chase 011","E02006128",8472,8445,27
"2021","Cannock Chase 012","E02006129",8301,8241,60
"2021","Cannock Chase 013","E02006130",8321,8321,0
"2021","East Staffordshire 001","E02006131",7745,7485,260
"2021","East Staffordshire 002","E02006132",7083,7039,44
"2021","East Staffordshire 003","E02006133",6937,6803,134
"2021","East Staffordshire 004","E02006134",10440,10420,20
"2021","East Staffordshire 005","E02006135",7762,7761,1
"2021","East Staffordshire 006","E02006136",9027,7937,1090
"2021","East Staffordshire 007","E02006137",9159,9057,102
"2021","East Staffordshire 008","E02006138",8057,8034,23
"2021","East Staffordshire 009","E02006139",8470,8434,36
"2021","East Staffordshire 010","E02006140",8387,8314,73
"2021","East Staffordshire 011","E02006141",12153,12107,46
"2021","East Staffordshire 012","E02006142",5264,5216,48
"2021","East Staffordshire 013","E02006143",9379,9363,16
"2021","East Staffordshire 014","E02006144",8193,8114,79
"2021","East Staffordshire 015","E02006145",5964,5964,0
"2021","Lichfield 001","E02006146",8791,8716,75
"2021","Lichfield 002","E02006147",8410,8367,43
"2021","Lichfield 003","E02006148",7154,7146,8
"2021","Lichfield 004","E02006149",10724,10670,54
"2021","Lichfield 005","E02006150",11451,11320,131
"2021","Lichfield 006","E02006151",9774,9707,67
"2021","Lichfield 007","E02006152",10403,10370,33
"2021","Lichfield 008","E02006153",9163,9014,149
"2021","Lichfield 009","E02006154",9639,9543,96
"2021","Lichfield 010","E02006155",5728,5710,18
"2021","Lichfield 011","E02006156",7962,7830,132
"2021","Lichfield 012","E02006157",7234,6647,587
"2021","Newcastle-under-Lyme 001","E02006158",8095,8087,8
"2021","Newcastle-under-Lyme 002","E02006159",5709,5615,94
"2021","Newcastle-under-Lyme 003","E02006160",8638,8632,6
"2021","Newcastle-under-Lyme 004","E02006161",6575,6546,29
"2021","Newcastle-under-Lyme 005","E02006162",8326,8258,68
"2021","Newcastle-under-Lyme 006","E02006163",7867,7761,106
"2021","Newcastle-under-Lyme 007","E02006164",7230,7125,105
"2021","Newcastle-under-Lyme 008","E02006165",7413,7359,54
"2021","Newcastle-under-Lyme 009","E02006166",6980,6922,58
"2021","Newcastle-under-Lyme 010","E02006167",10005,9906,99
"2021","Newcastle-under-Lyme 011","E02006168",8348,7814,534
"2021","Newcastle-under-Lyme 012","E02006169",7569,5537,2032
"2021","Newcastle-under-Lyme 013","E02006170",5168,5150,18
"2021","Newcastle-under-Lyme 014","E02006171",9029,9024,5
"2021","Newcastle-under-Lyme 015","E02006172",9415,9413,2
"2021","Newcastle-under-Lyme 016","E02006173",6933,6933,0
"2021","South Staffordshire 001","E02006174",10921,10906,15
"2021","South Staffordshire 002","E02006175",6847,6826,21
"2021","South Staffordshire 003","E02006176",7328,7289,39
"2021","South Staffordshire 004","E02006177",9784,9784,0
"2021","South Staffordshire 005","E02006178",7508,7496,12
"2021","South Staffordshire 006","E02006179",9538,6466,3072
"2021","South Staffordshire 007","E02006180",6950,6755,195
"2021","South Staffordshire 008","E02006181",5560,5539,21
"2021","South Staffordshire 009","E02006182",7142,7013,129
"2021","South Staffordshire 012","E02006185",7121,7091,30
"2021","South Staffordshire 013","E02006186",12492,12329,163
"2021","South Staffordshire 014","E02006187",7103,7024,79
"2021","South Staffordshire 015","E02006982",12175,12125,50
"2021","Stafford 001","E02006188",5976,5909,67
"2021","Stafford 002","E02006189",7173,7017,156
"2021","Stafford 003","E02006190",11081,10930,151
"2021","Stafford 004","E02006191",8118,8064,54
"2021","Stafford 005","E02006192",9194,8955,239
"2021","Stafford 006","E02006193",7486,7486,0
"2021","Stafford 007","E02006194",8383,8293,90
"2021","Stafford 008","E02006195",8750,8685,65
"2021","Stafford 009","E02006196",7255,6540,715
"2021","Stafford 010","E02006197",9443,9346,97
"2021","Stafford 011","E02006198",8949,8579,370
"2021","Stafford 012","E02006199",8321,8151,170
"2021","Stafford 013","E02006200",7733,7733,0
"2021","Stafford 014","E02006201",12118,12118,0
"2021","Stafford 015","E02006202",9206,9172,34
"2021","Stafford 016","E02006203",7685,7681,4
"2021","Staffordshire Moorlands 001","E02006204",7482,7375,107
"2021","Staffordshire Moorlands 002","E02006205",7241,7196,45
"2021","Staffordshire Moorlands 003","E02006206",7993,7920,73
"2021","Staffordshire Moorlands 004","E02006207",6239,6193,46
"2021","Staffordshire Moorlands 005","E02006208",7992,7890,102
"2021","Staffordshire Moorlands 006","E02006209",10619,10476,143
"2021","Staffordshire Moorlands 007","E02006210",5218,5209,9
"2021","Staffordshire Moorlands 008","E02006211",6351,6288,63
"2021","Staffordshire Moorlands 009","E02006212",7738,7600,138
"2021","Staffordshire Moorlands 010","E02006213",6525,6483,42
"2021","Staffordshire Moorlands 011","E02006214",6186,6127,59
"2021","Staffordshire Moorlands 012","E02006215",7849,7811,38
"2021","Staffordshire Moorlands 013","E02006216",8410,8361,49
"2021","Tamworth 001","E02006217",10207,10076,131
"2021","Tamworth 002","E02006218",8447,8405,42
"2021","Tamworth 003","E02006219",8319,8295,24
"2021","Tamworth 004","E02006220",7337,7337,0
"2021","Tamworth 005","E02006221",5814,5813,1
"2021","Tamworth 006","E02006222",6902,6825,77
"2021","Tamworth 007","E02006223",6861,6851,10
"2021","Tamworth 008","E02006224",7487,7483,4
"2021","Tamworth 009","E02006225",7339,7325,14
"2021","Tamworth 010","E02006226",9933,9907,26
"2021","North Warwickshire 001","E02006468",10956,10869,87
"2021","North Warwickshire 002","E02006469",8778,8747,31
"2021","North Warwickshire 003","E02006470",11740,11632,108
"2021","North Warwickshire 004","E02006471",6973,6963,10
"2021","North Warwickshire 005","E02006472",9826,9682,144
"2021","North Warwickshire 006","E02006473",10378,10216,162
"2021","North Warwickshire 007","E02006474",6390,6260,130
"2021","Nuneaton and Bedworth 001","E02006475",9584,9583,1
"2021","Nuneaton and Bedworth 002","E02006476",9599,9551,48
"2021","Nuneaton and Bedworth 003","E02006477",8738,8669,69
"2021","Nuneaton and Bedworth 004","E02006478",8405,8404,1
"2021","Nuneaton and Bedworth 005","E02006479",9145,9078,67
"2021","Nuneaton and Bedworth 006","E02006480",7491,7491,0
"2021","Nuneaton and Bedworth 007","E02006481",7317,7301,16
"2021","Nuneaton and Bedworth 008","E02006482",7256,7217,39
"2021","Nuneaton and Bedworth 009","E02006483",7960,7821,139
"2021","Nuneaton and Bedworth 010","E02006484",7648,7577,71
"2021","Nuneaton and Bedworth 011","E02006485",6588,6585,3
"2021","Nuneaton and Bedworth 012","E02006486",7080,7063,17
"2021","Nuneaton and Bedworth 013","E02006487",6947,6875,72
"2021","Nuneaton and Bedworth 014","E02006488",6080,6073,7
"2021","Nuneaton and Bedworth 015","E02006489",8058,8058,0
"2021","Nuneaton and Bedworth 016","E02006490",7744,7715,29
"2021","Nuneaton and Bedworth 018","E02006806",8559,8413,146
"2021","Rugby 002","E02006493",10693,10693,0
"2021","Rugby 003","E02006494",7273,7178,95
"2021","Rugby 004","E02006495",7771,7732,39
"2021","Rugby 005","E02006496",7141,7101,40
"2021","Rugby 006","E02006497",8089,8056,33
"2021","Rugby 007","E02006498",13861,13860,1
"2021","Rugby 008","E02006499",6436,6436,0
"2021","Rugby 009","E02006500",6103,5387,716
"2021","Rugby 010","E02006501",10214,10184,30
"2021","Rugby 011","E02006502",11053,10824,229
"2021","Rugby 012","E02006503",10172,10065,107
"2021","Rugby 013","E02007048",7525,7176,349
"2021","Rugby 014","E02007049",8031,7975,56
"2021","Stratford-on-Avon 001","E02006504",5878,5819,59
"2021","Stratford-on-Avon 002","E02006505",6962,6944,18
"2021","Stratford-on-Avon 003","E02006506",6036,5956,80
"2021","Stratford-on-Avon 004","E02006507",11031,10935,96
"2021","Stratford-on-Avon 005","E02006508",11153,11126,27
"2021","Stratford-on-Avon 006","E02006509",5869,5827,42
"2021","Stratford-on-Avon 007","E02006510",6850,6746,104
"2021","Stratford-on-Avon 008","E02006511",10656,10529,127
"2021","Stratford-on-Avon 009","E02006512",12299,12166,133
"2021","Stratford-on-Avon 010","E02006513",8337,8307,30
"2021","Stratford-on-Avon 011","E02006514",8865,8734,131
"2021","Stratford-on-Avon 012","E02006515",11180,11093,87
"2021","Stratford-on-Avon 013","E02006516",9593,9510,83
"2021","Stratford-on-Avon 014","E02006517",9820,9785,35
"2021","Stratford-on-Avon 015","E02006518",10194,10112,82
"2021","Warwick 001","E02006519",7993,7948,45
"2021","Warwick 002","E02006520",8441,8374,67
"2021","Warwick 003","E02006521",7304,7246,58
"2021","Warwick 004","E02006522",5806,5802,4
"2021","Warwick 005","E02006523",12902,10297,2605
"2021","Warwick 006","E02006524",5525,5477,48
"2021","Warwick 007","E02006525",13033,12843,190
"2021","Warwick 008","E02006526",8655,8591,64
"2021","Warwick 009","E02006527",9357,9127,230
"2021","Warwick 010","E02006528",11244,11139,105
"2021","Warwick 011","E02006529",12697,12529,168
"2021","Warwick 012","E02006530",13236,13118,118
"2021","Warwick 013","E02006531",10330,10223,107
"2021","Warwick 014","E02006532",11643,11643,0
"2021","Warwick 015","E02006533",10289,10217,72
"2021","Bromsgrove 001","E02006696",7314,7249,65
"2021","Bromsgrove 002","E02006697",7417,7258,159
"2021","Bromsgrove 003","E02006698",6420,6382,38
"2021","Bromsgrove 004","E02006699",5920,5911,9
"2021","Bromsgrove 005","E02006700",6356,6151,205
"2021","Bromsgrove 006","E02006701",7351,7298,53
"2021","Bromsgrove 007","E02006702",5958,5914,44
"2021","Bromsgrove 008","E02006703",8036,7897,139
"2021","Bromsgrove 009","E02006704",6932,6796,136
"2021","Bromsgrove 010","E02006705",7378,7310,68
"2021","Bromsgrove 011","E02006706",6948,6460,488
"2021","Bromsgrove 012","E02006707",6819,6819,0
"2021","Bromsgrove 013","E02006708",8024,8024,0
"2021","Bromsgrove 014","E02006709",8310,7737,573
"2021","Malvern Hills 001","E02006710",8420,8378,42
"2021","Malvern Hills 002","E02006711",8524,8362,162
"2021","Malvern Hills 003","E02006712",7666,7555,111
"2021","Malvern Hills 004","E02006713",6301,6176,125
"2021","Malvern Hills 005","E02006714",5854,5741,113
"2021","Malvern Hills 006","E02006715",8694,8657,37
"2021","Malvern Hills 007","E02006716",6454,6422,32
"2021","Malvern Hills 008","E02006717",6929,6842,87
"2021","Malvern Hills 009","E02006718",5989,5709,280
"2021","Malvern Hills 010","E02006719",7405,6761,644
"2021","Malvern Hills 011","E02006720",7250,7072,178
"2021","Redditch 001","E02006721",6639,6639,0
"2021","Redditch 002","E02006722",5449,5425,24
"2021","Redditch 003","E02006723",9340,9232,108
"2021","Redditch 004","E02006724",7018,7001,17
"2021","Redditch 005","E02006725",5526,5517,9
"2021","Redditch 006","E02006726",6368,6340,28
"2021","Redditch 007","E02006727",5940,5940,0
"2021","Redditch 008","E02006728",7751,7647,104
"2021","Redditch 009","E02006729",7636,7636,0
"2021","Redditch 010","E02006730",6783,6783,0
"2021","Redditch 011","E02006731",5568,5568,0
"2021","Redditch 012","E02006732",6969,6962,7
"2021","Redditch 013","E02006733",6050,6020,30
"2021","Worcester 001","E02006734",8219,8133,86
"2021","Worcester 002","E02006735",5530,5530,0
"2021","Worcester 003","E02006736",6498,6498,0
"2021","Worcester 004","E02006737",8302,8292,10
"2021","Worcester 005","E02006738",9218,9215,3
"2021","Worcester 006","E02006739",5737,4916,821
"2021","Worcester 007","E02006740",7335,7085,250
"2021","Worcester 008","E02006741",6281,6174,107
"2021","Worcester 009","E02006742",8982,8954,28
"2021","Worcester 010","E02006743",6937,6924,13
"2021","Worcester 011","E02006744",7459,7254,205
"2021","Worcester 012","E02006745",8737,8610,127
"2021","Worcester 013","E02006746",8991,8827,164
"2021","Worcester 014","E02006747",5648,5648,0
"2021","Wychavon 001","E02006748",8794,8725,69
"2021","Wychavon 002","E02006749",5409,5406,3
"2021","Wychavon 003","E02006750",5428,5375,53
"2021","Wychavon 004","E02006751",5869,5772,97
"2021","Wychavon 005","E02006752",8335,8297,38
"2021","Wychavon 006","E02006753",7385,7340,45
"2021","Wychavon 007","E02006754",5805,5785,20
"2021","Wychavon 008","E02006755",5864,5835,29
"2021","Wychavon 009","E02006756",6705,6640,65
"2021","Wychavon 010","E02006757",7196,7053,143
"2021","Wychavon 011","E02006758",6470,5960,510
"2021","Wychavon 012","E02006759",8401,8355,46
"2021","Wychavon 013","E02006760",9019,8888,131
"2021","Wychavon 014","E02006761",6278,6274,4
"2021","Wychavon 015","E02006762",7120,7094,26
"2021","Wychavon 016","E02006763",8495,8411,84
"2021","Wychavon 017","E02006764",5791,5715,76
"2021","Wychavon 018","E02006765",6314,6276,38
"2021","Wychavon 019","E02006766",7816,7813,3
"2021","Wyre Forest 001","E02006767",9581,9304,277
"2021","Wyre Forest 002","E02006768",7000,6951,49
"2021","Wyre Forest 003","E02006769",7069,6981,88
"2021","Wyre Forest 004","E02006770",8382,8333,49
"2021","Wyre Forest 005","E02006771",6757,6715,42
"2021","Wyre Forest 006","E02006772",6680,6576,104
"2021","Wyre Forest 007","E02006773",8224,8108,116
"2021","Wyre Forest 008","E02006774",7564,7563,1
"2021","Wyre Forest 009","E02006775",6098,6078,20
"2021","Wyre Forest 010","E02006776",6394,6351,43
"2021","Wyre Forest 011","E02006777",7206,7125,81
"2021","Wyre Forest 012","E02006778",7178,7078,100
"2021","Wyre Forest 013","E02006779",7574,7570,4
"2021","Wyre Forest 014","E02006780",5903,5876,27
"2021","Birmingham 001","E02001827",6451,6408,43
"2021","Birmingham 002","E02001828",7142,7104,38
"2021","Birmingham 003","E02001829",9160,9160,0
"2021","Birmingham 004","E02001830",9686,9589,97
"2021","Birmingham 005","E02001831",10683,10647,36
"2021","Birmingham 006","E02001832",7931,7922,9
"2021","Birmingham 007","E02001833",5936,5936,0
"2021","Birmingham 008","E02001834",6110,6110,0
"2021","Birmingham 009","E02001835",8473,8219,254
"2021","Birmingham 010","E02001836",9102,9026,76
"2021","Birmingham 011","E02001837",10667,10642,25
"2021","Birmingham 012","E02001838",7570,7497,73
"2021","Birmingham 013","E02001839",6439,6409,30
"2021","Birmingham 014","E02001840",9603,9514,89
"2021","Birmingham 015","E02001841",5963,5852,111
"2021","Birmingham 016","E02001842",8069,8068,1
"2021","Birmingham 017","E02001843",6638,6630,8
"2021","Birmingham 018","E02001844",9715,9362,353
"2021","Birmingham 019","E02001845",6662,6662,0
"2021","Birmingham 020","E02001846",8159,8117,42
"2021","Birmingham 021","E02001847",5596,5586,10
"2021","Birmingham 022","E02001848",7320,7181,139
"2021","Birmingham 023","E02001849",8792,8774,18
"2021","Birmingham 024","E02001850",8605,8587,18
"2021","Birmingham 025","E02001851",9083,9001,82
"2021","Birmingham 026","E02001852",7030,7000,30
"2021","Birmingham 029","E02001855",9935,9812,123
"2021","Birmingham 030","E02001856",9638,9585,53
"2021","Birmingham 031","E02001857",13854,13440,414
"2021","Birmingham 032","E02001858",9148,8329,819
"2021","Birmingham 033","E02001859",10398,10296,102
"2021","Birmingham 034","E02001860",8471,8468,3
"2021","Birmingham 035","E02001861",11204,11160,44
"2021","Birmingham 036","E02001862",9877,9791,86
"2021","Birmingham 037","E02001863",8404,8315,89
"2021","Birmingham 039","E02001865",11402,11396,6
"2021","Birmingham 040","E02001866",9451,9359,92
"2021","Birmingham 041","E02001867",8671,8639,32
"2021","Birmingham 042","E02001868",9818,9816,2
"2021","Birmingham 043","E02001869",7010,7007,3
"2021","Birmingham 044","E02001870",12993,12880,113
"2021","Birmingham 045","E02001871",8341,8285,56
"2021","Birmingham 046","E02001872",7423,7377,46
"2021","Birmingham 047","E02001873",11386,11228,158
"2021","Birmingham 048","E02001874",9962,9935,27
"2021","Birmingham 049","E02001875",8961,8937,24
"2021","Birmingham 050","E02001876",16085,8823,7262
"2021","Birmingham 051","E02001877",12396,12296,100
"2021","Birmingham 052","E02001878",9522,9459,63
"2021","Birmingham 053","E02001879",10025,9396,629
"2021","Birmingham 054","E02001880",10037,10030,7
"2021","Birmingham 055","E02001881",10495,10455,40
"2021","Birmingham 056","E02001882",8913,8835,78
"2021","Birmingham 057","E02001883",8517,8517,0
"2021","Birmingham 058","E02001884",10188,10151,37
"2021","Birmingham 060","E02001886",9892,9614,278
"2021","Birmingham 062","E02001888",7181,7110,71
"2021","Birmingham 063","E02001889",9053,8838,215
"2021","Birmingham 064","E02001890",9976,9350,626
"2021","Birmingham 066","E02001892",11587,11564,23
"2021","Birmingham 067","E02001893",8822,8750,72
"2021","Birmingham 069","E02001895",8955,8839,116
"2021","Birmingham 070","E02001896",10160,10160,0
"2021","Birmingham 071","E02001897",8624,8428,196
"2021","Birmingham 072","E02001898",6558,6557,1
"2021","Birmingham 073","E02001899",8534,8483,51
"2021","Birmingham 074","E02001900",6710,6437,273
"2021","Birmingham 075","E02001901",8142,8054,88
"2021","Birmingham 076","E02001902",6255,6248,7
"2021","Birmingham 077","E02001903",8076,8069,7
"2021","Birmingham 078","E02001904",7725,7618,107
"2021","Birmingham 079","E02001905",10274,6185,4089
"2021","Birmingham 080","E02001906",9569,9563,6
"2021","Birmingham 081","E02001907",10413,10380,33
"2021","Birmingham 082","E02001908",8953,8941,12
"2021","Birmingham 083","E02001909",8290,8253,37
"2021","Birmingham 084","E02001910",7232,7229,3
"2021","Birmingham 085","E02001911",8738,8731,7
"2021","Birmingham 087","E02001913",7442,7151,291
"2021","Birmingham 088","E02001914",7060,6879,181
"2021","Birmingham 089","E02001915",11959,11796,163
"2021","Birmingham 090","E02001916",9897,9786,111
"2021","Birmingham 092","E02001918",8651,8334,317
"2021","Birmingham 093","E02001919",6940,6802,138
"2021","Birmingham 094","E02001920",7654,7645,9
"2021","Birmingham 095","E02001921",7739,7732,7
"2021","Birmingham 096","E02001922",15987,13523,2464
"2021","Birmingham 097","E02001923",11118,11025,93
"2021","Birmingham 098","E02001924",7077,7068,9
"2021","Birmingham 099","E02001925",6736,6615,121
"2021","Birmingham 100","E02001926",7828,7477,351
"2021","Birmingham 101","E02001927",7669,7549,120
"2021","Birmingham 102","E02001928",6818,6752,66
"2021","Birmingham 103","E02001929",10507,10446,61
"2021","Birmingham 104","E02001930",7703,7703,0
"2021","Birmingham 105","E02001931",8591,8591,0
"2021","Birmingham 106","E02001932",7425,7315,110
"2021","Birmingham 107","E02001933",7719,7651,68
"2021","Birmingham 108","E02001934",7144,7115,29
"2021","Birmingham 109","E02001935",8080,8045,35
"2021","Birmingham 110","E02001936",6387,6342,45
"2021","Birmingham 111","E02001937",8384,8337,47
"2021","Birmingham 112","E02001938",7870,7768,102
"2021","Birmingham 113","E02001939",6294,6210,84
"2021","Birmingham 115","E02001941",6550,6451,99
"2021","Birmingham 116","E02001942",6780,6693,87
"2021","Birmingham 117","E02001943",6475,6438,37
"2021","Birmingham 118","E02001944",8068,7996,72
"2021","Birmingham 119","E02001945",7894,7883,11
"2021","Birmingham 120","E02001946",7583,7500,83
"2021","Birmingham 121","E02001947",6240,6188,52
"2021","Birmingham 122","E02001948",7346,7270,76
"2021","Birmingham 123","E02001949",6161,6089,72
"2021","Birmingham 124","E02001950",8569,8541,28
"2021","Birmingham 125","E02001951",9433,9394,39
"2021","Birmingham 126","E02001952",9128,9117,11
"2021","Birmingham 127","E02001953",7112,6973,139
"2021","Birmingham 128","E02001954",7581,7563,18
"2021","Birmingham 129","E02001955",8096,8007,89
"2021","Birmingham 130","E02001956",6848,6779,69
"2021","Birmingham 131","E02001957",7880,7815,65
"2021","Birmingham 132","E02006807",8210,8190,20
"2021","Birmingham 133","E02006809",10153,10029,124
"2021","Birmingham 134","E02006895",9361,8391,970
"2021","Birmingham 135","E02006896",6124,5605,519
"2021","Birmingham 136","E02006897",8455,7710,745
"2021","Birmingham 137","E02006898",7904,7902,2
"2021","Birmingham 138","E02006899",6145,6128,17
"2021","Birmingham 139","E02006900",15720,15639,81
"2021","Birmingham 141","E02007038",13692,13628,64
"2021","Birmingham 142","E02007039",8307,8300,7
"2021","Birmingham 143","E02007040",7599,7557,42
"2021","Coventry 001","E02001958",8072,8053,19
"2021","Coventry 002","E02001959",6929,6902,27
"2021","Coventry 004","E02001961",7966,7964,2
"2021","Coventry 005","E02001962",7211,7170,41
"2021","Coventry 006","E02001963",6141,6138,3
"2021","Coventry 007","E02001964",11009,10981,28
"2021","Coventry 008","E02001965",8080,8055,25
"2021","Coventry 009","E02001966",7355,7331,24
"2021","Coventry 010","E02001967",6962,6823,139
"2021","Coventry 011","E02001968",7959,7959,0
"2021","Coventry 012","E02001969",6775,6665,110
"2021","Coventry 013","E02001970",5758,5732,26
"2021","Coventry 014","E02001971",6289,6289,0
"2021","Coventry 015","E02001972",11719,11643,76
"2021","Coventry 016","E02001973",8535,8535,0
"2021","Coventry 017","E02001974",9461,9432,29
"2021","Coventry 018","E02001975",7637,7634,3
"2021","Coventry 019","E02001976",7499,7407,92
"2021","Coventry 020","E02001977",10015,9807,208
"2021","Coventry 021","E02001978",6810,6790,20
"2021","Coventry 022","E02001979",5604,5564,40
"2021","Coventry 023","E02001980",5792,5768,24
"2021","Coventry 024","E02001981",13439,11877,1562
"2021","Coventry 025","E02001982",8407,8317,90
"2021","Coventry 026","E02001983",7611,7529,82
"2021","Coventry 027","E02001984",10467,10373,94
"2021","Coventry 028","E02001985",9241,8232,1009
"2021","Coventry 029","E02001986",7981,7883,98
"2021","Coventry 030","E02001987",5911,5910,1
"2021","Coventry 031","E02001988",11152,6417,4735
"2021","Coventry 032","E02001989",6294,6216,78
"2021","Coventry 033","E02001990",9185,9090,95
"2021","Coventry 034","E02001991",8476,8316,160
"2021","Coventry 035","E02001992",10784,10754,30
"2021","Coventry 036","E02001993",8985,8595,390
"2021","Coventry 037","E02001994",7960,7954,6
"2021","Coventry 038","E02001995",9426,9327,99
"2021","Coventry 039","E02001996",7688,7667,21
"2021","Coventry 040","E02001997",8511,8511,0
"2021","Coventry 041","E02001998",6036,6036,0
"2021","Coventry 042","E02001999",9105,5904,3201
"2021","Coventry 043","E02006805",9083,9055,28
"2021","Dudley 001","E02002000",8550,8517,33
"2021","Dudley 002","E02002001",6064,6064,0
"2021","Dudley 003","E02002002",6901,6845,56
"2021","Dudley 004","E02002003",9020,8949,71
"2021","Dudley 005","E02002004",7578,7549,29
"2021","Dudley 006","E02002005",9889,9833,56
"2021","Dudley 007","E02002006",6481,6481,0
"2021","Dudley 008","E02002007",9028,9021,7
"2021","Dudley 009","E02002008",8164,8054,110
"2021","Dudley 010","E02002009",7117,7117,0
"2021","Dudley 011","E02002010",8373,8253,120
"2021","Dudley 012","E02002011",5904,5859,45
"2021","Dudley 013","E02002012",8413,8275,138
"2021","Dudley 014","E02002013",6571,6464,107
"2021","Dudley 015","E02002014",8312,8262,50
"2021","Dudley 016","E02002015",7059,7034,25
"2021","Dudley 017","E02002016",8047,7982,65
"2021","Dudley 018","E02002017",8071,8001,70
"2021","Dudley 019","E02002018",8931,8874,57
"2021","Dudley 020","E02002019",7798,7798,0
"2021","Dudley 021","E02002020",9485,9400,85
"2021","Dudley 022","E02002021",7712,7632,80
"2021","Dudley 023","E02002022",8881,8830,51
"2021","Dudley 024","E02002023",5358,5358,0
"2021","Dudley 025","E02002024",8738,8708,30
"2021","Dudley 026","E02002025",8896,8872,24
"2021","Dudley 027","E02002026",6783,6783,0
"2021","Dudley 028","E02002027",5379,5377,2
"2021","Dudley 029","E02002028",5732,5694,38
"2021","Dudley 030","E02002029",6224,6181,43
"2021","Dudley 031","E02002030",6814,6781,33
"2021","Dudley 032","E02002031",6261,6242,19
"2021","Dudley 033","E02002032",10213,10186,27
"2021","Dudley 034","E02002033",7815,7805,10
"2021","Dudley 035","E02002034",8168,8147,21
"2021","Dudley 036","E02002035",6115,6064,51
"2021","Dudley 037","E02002036",6670,6670,0
"2021","Dudley 038","E02002037",5923,5923,0
"2021","Dudley 039","E02002038",9617,9579,38
"2021","Dudley 040","E02002039",6207,5909,298
"2021","Dudley 041","E02002040",5933,5907,26
"2021","Dudley 042","E02002041",6272,6231,41
"2021","Dudley 043","E02002042",8028,7994,34
"2021","Sandwell 001","E02002043",8757,8603,154
"2021","Sandwell 002","E02002044",8052,8052,0
"2021","Sandwell 003","E02002045",7812,7812,0
"2021","Sandwell 004","E02002046",5714,5714,0
"2021","Sandwell 005","E02002047",7553,7388,165
"2021","Sandwell 006","E02002048",6829,6827,2
"2021","Sandwell 007","E02002049",6309,6309,0
"2021","Sandwell 009","E02002051",6169,6139,30
"2021","Sandwell 010","E02002052",11365,11201,164
"2021","Sandwell 011","E02002053",6327,6316,11
"2021","Sandwell 012","E02002054",5818,5809,9
"2021","Sandwell 013","E02002055",11126,11120,6
"2021","Sandwell 014","E02002056",9881,9826,55
"2021","Sandwell 015","E02002057",10722,10645,77
"2021","Sandwell 016","E02002058",13570,13417,153
"2021","Sandwell 017","E02002059",11792,11684,108
"2021","Sandwell 018","E02002060",7356,7319,37
"2021","Sandwell 019","E02002061",7059,6993,66
"2021","Sandwell 020","E02002062",8958,8834,124
"2021","Sandwell 021","E02002063",10330,10290,40
"2021","Sandwell 022","E02002064",12496,12425,71
"2021","Sandwell 023","E02002065",14169,14068,101
"2021","Sandwell 024","E02002066",8258,8229,29
"2021","Sandwell 025","E02002067",6321,6288,33
"2021","Sandwell 027","E02002069",7244,7244,0
"2021","Sandwell 028","E02002070",10338,10192,146
"2021","Sandwell 029","E02002071",6717,6717,0
"2021","Sandwell 030","E02002072",8921,8860,61
"2021","Sandwell 031","E02002073",8411,8353,58
"2021","Sandwell 032","E02002074",8206,8159,47
"2021","Sandwell 033","E02002075",8736,8655,81
"2021","Sandwell 034","E02002076",10670,10653,17
"2021","Sandwell 035","E02002077",10884,10829,55
"2021","Sandwell 036","E02002078",6570,6566,4
"2021","Sandwell 037","E02002079",8659,8654,5
"2021","Sandwell 038","E02002080",7378,7319,59
"2021","Sandwell 039","E02006810",10690,10667,23
"2021","Sandwell 040","E02006943",7596,7545,51
"2021","Sandwell 041","E02006944",8075,8075,0
"2021","Solihull 001","E02002081",5434,5413,21
"2021","Solihull 002","E02002082",5840,5837,3
"2021","Solihull 003","E02002083",6029,6026,3
"2021","Solihull 004","E02002084",6746,6725,21
"2021","Solihull 005","E02002085",6659,6659,0
"2021","Solihull 006","E02002086",5923,5862,61
"2021","Solihull 007","E02002087",6297,6296,1
"2021","Solihull 008","E02002088",9583,9517,66
"2021","Solihull 009","E02002089",8066,7901,165
"2021","Solihull 010","E02002090",5962,5962,0
"2021","Solihull 011","E02002091",7654,7654,0
"2021","Solihull 012","E02002092",7268,7223,45
"2021","Solihull 013","E02002093",6691,6584,107
"2021","Solihull 014","E02002094",5980,5911,69
"2021","Solihull 015","E02002095",8625,8589,36
"2021","Solihull 016","E02002096",10375,10254,121
"2021","Solihull 017","E02002097",7343,7308,35
"2021","Solihull 018","E02002098",9737,9720,17
"2021","Solihull 019","E02002099",6900,6841,59
"2021","Solihull 021","E02002101",6307,6290,17
"2021","Solihull 022","E02002102",8776,8663,113
"2021","Solihull 023","E02002103",6082,6025,57
"2021","Solihull 024","E02002104",5847,5805,42
"2021","Solihull 025","E02002105",8265,8214,51
"2021","Solihull 026","E02002106",9730,9603,127
"2021","Solihull 027","E02002107",5413,5400,13
"2021","Solihull 028","E02002108",9846,9831,15
"2021","Solihull 029","E02002109",12134,12126,8
"2021","Solihull 030","E02006808",6732,6732,0
"2021","Walsall 001","E02002110",7024,6977,47
"2021","Walsall 002","E02002111",6417,6377,40
"2021","Walsall 003","E02002112",5270,5261,9
"2021","Walsall 004","E02002113",6402,6349,53
"2021","Walsall 005","E02002114",6082,6046,36
"2021","Walsall 006","E02002115",6823,6799,24
"2021","Walsall 007","E02002116",6755,6719,36
"2021","Walsall 008","E02002117",6254,6227,27
"2021","Walsall 009","E02002118",7420,7420,0
"2021","Walsall 010","E02002119",5983,5983,0
"2021","Walsall 011","E02002120",6110,6110,0
"2021","Walsall 012","E02002121",6663,6513,150
"2021","Walsall 013","E02002122",7155,7142,13
"2021","Walsall 014","E02002123",6602,6568,34
"2021","Walsall 015","E02002124",6920,6806,114
"2021","Walsall 016","E02002125",6450,6396,54
"2021","Walsall 017","E02002126",6679,6679,0
"2021","Walsall 018","E02002127",9792,9688,104
"2021","Walsall 019","E02002128",5625,5571,54
"2021","Walsall 020","E02002129",6032,6027,5
"2021","Walsall 021","E02002130",6863,6852,11
"2021","Walsall 022","E02002131",7778,7778,0
"2021","Walsall 023","E02002132",6441,6402,39
"2021","Walsall 024","E02002133",6901,6855,46
"2021","Walsall 025","E02002134",9235,9148,87
"2021","Walsall 026","E02002135",7981,7956,25
"2021","Walsall 027","E02002136",8004,7997,7
"2021","Walsall 028","E02002137",6115,6088,27
"2021","Walsall 029","E02002138",6358,6356,2
"2021","Walsall 030","E02002139",10861,10443,418
"2021","Walsall 031","E02002140",8555,8453,102
"2021","Walsall 032","E02002141",6459,6459,0
"2021","Walsall 033","E02002142",7550,7485,65
"2021","Walsall 034","E02002143",10264,10245,19
"2021","Walsall 035","E02002144",6845,6836,9
"2021","Walsall 036","E02002145",8492,8490,2
"2021","Walsall 037","E02002146",6425,6388,37
"2021","Walsall 038","E02002147",9109,9074,35
"2021","Walsall 039","E02002148",11431,11431,0
"2021","Wolverhampton 001","E02002149",10087,10052,35
"2021","Wolverhampton 002","E02002150",5791,5733,58
"2021","Wolverhampton 003","E02002151",5556,5556,0
"2021","Wolverhampton 004","E02002152",6273,6161,112
"2021","Wolverhampton 005","E02002153",7483,7480,3
"2021","Wolverhampton 006","E02002154",7412,7387,25
"2021","Wolverhampton 007","E02002155",6515,6485,30
"2021","Wolverhampton 008","E02002156",8302,8292,10
"2021","Wolverhampton 009","E02002157",7825,7799,26
"2021","Wolverhampton 010","E02002158",7523,7463,60
"2021","Wolverhampton 011","E02002159",6178,6176,2
"2021","Wolverhampton 012","E02002160",7579,7511,68
"2021","Wolverhampton 013","E02002161",7124,7124,0
"2021","Wolverhampton 014","E02002162",7773,7589,184
"2021","Wolverhampton 015","E02002163",11875,11818,57
"2021","Wolverhampton 016","E02002164",6743,6123,620
"2021","Wolverhampton 017","E02002165",7893,7734,159
"2021","Wolverhampton 018","E02002166",9408,9365,43
"2021","Wolverhampton 019","E02002167",6642,6642,0
"2021","Wolverhampton 020","E02002168",11532,10639,893
"2021","Wolverhampton 021","E02002169",8808,8676,132
"2021","Wolverhampton 022","E02002170",6313,6313,0
"2021","Wolverhampton 023","E02002171",7725,7724,1
"2021","Wolverhampton 026","E02002174",7643,7539,104
"2021","Wolverhampton 027","E02002175",7793,7724,69
"2021","Wolverhampton 028","E02002176",7841,7841,0
"2021","Wolverhampton 029","E02002177",11505,11427,78
"2021","Wolverhampton 030","E02002178",8141,7929,212
"2021","Wolverhampton 031","E02002179",6568,6512,56
"2021","Wolverhampton 032","E02002180",6488,6460,28
"2021","Wolverhampton 033","E02002181",8435,8435,0
"2021","Wolverhampton 034","E02002182",6586,6458,128
"2021","Wolverhampton 035","E02006894",14363,14152,211
"2021","Peterborough 001","E02003237",6156,6107,49
"2021","Peterborough 002","E02003238",5737,5737,0
"2021","Peterborough 003","E02003239",8326,8282,44
"2021","Peterborough 004","E02003240",6871,6618,253
"2021","Peterborough 005","E02003241",7180,7174,6
"2021","Peterborough 006","E02003242",8444,8378,66
"2021","Peterborough 007","E02003243",12169,12157,12
"2021","Peterborough 008","E02003244",10035,10022,13
"2021","Peterborough 009","E02003245",8244,8241,3
"2021","Peterborough 010","E02003246",10032,9343,689
"2021","Peterborough 011","E02003247",8849,8681,168
"2021","Peterborough 012","E02003248",11574,11423,151
"2021","Peterborough 013","E02003249",12822,12772,50
"2021","Peterborough 014","E02003250",12049,11893,156
"2021","Peterborough 015","E02003251",7922,7760,162
"2021","Peterborough 016","E02003252",12527,12435,92
"2021","Peterborough 017","E02003253",10266,10208,58
"2021","Peterborough 018","E02003254",9238,9234,4
"2021","Peterborough 019","E02003255",13724,13723,1
"2021","Peterborough 021","E02003257",9619,9611,8
"2021","Peterborough 022","E02006877",10901,10786,115
"2021","Peterborough 023","E02006878",12981,12879,102
"2021","Luton 001","E02003258",8610,8590,20
"2021","Luton 002","E02003259",6798,6798,0
"2021","Luton 003","E02003260",8949,8944,5
"2021","Luton 004","E02003261",6443,6324,119
"2021","Luton 005","E02003262",11189,11124,65
"2021","Luton 006","E02003263",12974,12800,174
"2021","Luton 007","E02003264",9851,9812,39
"2021","Luton 008","E02003265",8232,8232,0
"2021","Luton 009","E02003266",10113,10097,16
"2021","Luton 010","E02003267",14641,14629,12
"2021","Luton 011","E02003268",12950,12845,105
"2021","Luton 012","E02003269",10774,10772,2
"2021","Luton 013","E02003270",8806,8727,79
"2021","Luton 014","E02003271",10215,10206,9
"2021","Luton 015","E02003272",11353,11316,37
"2021","Luton 016","E02003273",12031,12027,4
"2021","Luton 017","E02003274",11539,11294,245
"2021","Luton 019","E02003276",9149,9086,63
"2021","Luton 020","E02003277",11613,11604,9
"2021","Luton 021","E02003278",13277,12619,658
"2021","Luton 022","E02006937",9371,9304,67
"2021","Luton 023","E02006938",6383,5811,572
"2021","Southend-on-Sea 001","E02003279",9451,9391,60
"2021","Southend-on-Sea 002","E02003280",10581,10576,5
"2021","Southend-on-Sea 003","E02003281",9442,9397,45
"2021","Southend-on-Sea 004","E02003282",10687,10631,56
"2021","Southend-on-Sea 005","E02003283",10994,10912,82
"2021","Southend-on-Sea 006","E02003284",11208,11190,18
"2021","Southend-on-Sea 007","E02003285",11284,11227,57
"2021","Southend-on-Sea 008","E02003286",9369,9350,19
"2021","Southend-on-Sea 009","E02003287",10151,10058,93
"2021","Southend-on-Sea 010","E02003288",13008,12884,124
"2021","Southend-on-Sea 011","E02003289",9891,9841,50
"2021","Southend-on-Sea 012","E02003290",9926,9381,545
"2021","Southend-on-Sea 013","E02003291",11676,11671,5
"2021","Southend-on-Sea 014","E02003292",12092,11904,188
"2021","Southend-on-Sea 015","E02003293",11692,11157,535
"2021","Southend-on-Sea 016","E02003294",9116,9073,43
"2021","Southend-on-Sea 017","E02003295",10119,10005,114
"2021","Thurrock 001","E02003296",7085,7083,2
"2021","Thurrock 002","E02003297",7315,7292,23
"2021","Thurrock 003","E02003298",7097,7060,37
"2021","Thurrock 004","E02003299",6416,6355,61
"2021","Thurrock 005","E02003300",8946,8945,1
"2021","Thurrock 006","E02003301",12030,12004,26
"2021","Thurrock 007","E02003302",10408,10350,58
"2021","Thurrock 008","E02003303",9517,9508,9
"2021","Thurrock 009","E02003304",9648,9628,20
"2021","Thurrock 010","E02003305",7079,7063,16
"2021","Thurrock 012","E02003307",10621,10512,109
"2021","Thurrock 013","E02003308",7713,7687,26
"2021","Thurrock 014","E02003309",7770,7770,0
"2021","Thurrock 016","E02003311",9304,9107,197
"2021","Thurrock 017","E02003312",9424,9422,2
"2021","Thurrock 018","E02003313",14821,14768,53
"2021","Thurrock 019","E02006859",7691,7691,0
"2021","Thurrock 020","E02006926",8008,7993,15
"2021","Thurrock 021","E02007004",6690,6672,18
"2021","Thurrock 022","E02007005",8416,8414,2
"2021","Bedford 001","E02003616",5673,5599,74
"2021","Bedford 002","E02003617",9035,8967,68
"2021","Bedford 003","E02003618",8758,8701,57
"2021","Bedford 004","E02003619",11853,11733,120
"2021","Bedford 005","E02003620",8161,8119,42
"2021","Bedford 006","E02003621",8061,8037,24
"2021","Bedford 007","E02003622",9210,9209,1
"2021","Bedford 008","E02003623",12828,12813,15
"2021","Bedford 009","E02003624",5935,5074,861
"2021","Bedford 010","E02003625",8870,8248,622
"2021","Bedford 011","E02003626",5610,5600,10
"2021","Bedford 012","E02003627",10648,10443,205
"2021","Bedford 013","E02003628",9778,9748,30
"2021","Bedford 014","E02003629",10684,10630,54
"2021","Bedford 015","E02003630",11371,11364,7
"2021","Bedford 016","E02003631",5507,5435,72
"2021","Bedford 017","E02003632",6207,6185,22
"2021","Bedford 018","E02003633",10562,10527,35
"2021","Bedford 020","E02003635",10346,10342,4
"2021","Bedford 021","E02007010",8533,8529,4
"2021","Bedford 022","E02007011",7597,7564,33
"2021","Central Bedfordshire 001","E02003599",5749,5749,0
"2021","Central Bedfordshire 002","E02003600",6428,6337,91
"2021","Central Bedfordshire 003","E02003601",8156,8148,8
"2021","Central Bedfordshire 004","E02003602",6563,6509,54
"2021","Central Bedfordshire 005","E02003603",11314,11287,27
"2021","Central Bedfordshire 006","E02003604",11227,11153,74
"2021","Central Bedfordshire 007","E02003605",10293,9544,749
"2021","Central Bedfordshire 008","E02003606",9325,9325,0
"2021","Central Bedfordshire 009","E02003607",11206,11195,11
"2021","Central Bedfordshire 010","E02003608",12185,12107,78
"2021","Central Bedfordshire 011","E02003609",11846,11451,395
"2021","Central Bedfordshire 012","E02003610",8972,8971,1
"2021","Central Bedfordshire 013","E02003611",9889,9735,154
"2021","Central Bedfordshire 014","E02003612",12420,12411,9
"2021","Central Bedfordshire 015","E02003613",5714,5663,51
"2021","Central Bedfordshire 016","E02003614",8141,8134,7
"2021","Central Bedfordshire 017","E02003615",10507,10440,67
"2021","Central Bedfordshire 018","E02003636",7282,7265,17
"2021","Central Bedfordshire 019","E02003637",10698,10667,31
"2021","Central Bedfordshire 020","E02003638",7688,7594,94
"2021","Central Bedfordshire 021","E02003639",9584,9501,83
"2021","Central Bedfordshire 022","E02003640",6045,5984,61
"2021","Central Bedfordshire 023","E02003641",5358,5358,0
"2021","Central Bedfordshire 025","E02003642",9606,9601,5
"2021","Central Bedfordshire 024","E02003643",13726,13726,0
"2021","Central Bedfordshire 026","E02003644",10056,9962,94
"2021","Central Bedfordshire 027","E02003645",6984,6924,60
"2021","Central Bedfordshire 028","E02003646",10668,10654,14
"2021","Central Bedfordshire 029","E02003647",10506,10374,132
"2021","Central Bedfordshire 030","E02003648",5521,5501,20
"2021","Central Bedfordshire 031","E02003649",6605,6592,13
"2021","Central Bedfordshire 032","E02003650",6996,6980,16
"2021","Central Bedfordshire 033","E02003651",6993,6943,50
"2021","Cambridge 001","E02003719",10313,10152,161
"2021","Cambridge 002","E02003720",9720,9544,176
"2021","Cambridge 003","E02003721",9714,9507,207
"2021","Cambridge 004","E02003722",8485,8205,280
"2021","Cambridge 005","E02003723",12981,6354,6627
"2021","Cambridge 006","E02003724",10340,10199,141
"2021","Cambridge 007","E02003725",16246,8081,8165
"2021","Cambridge 008","E02003726",8230,7423,807
"2021","Cambridge 009","E02003727",10189,9835,354
"2021","Cambridge 010","E02003728",10823,10418,405
"2021","Cambridge 011","E02003729",9343,9341,2
"2021","Cambridge 013","E02003731",11927,11288,639
"2021","Cambridge 015","E02007086",11133,11128,5
"2021","Cambridge 014","E02007087",6228,4907,1321
"2021","East Cambridgeshire 001","E02003732",9910,9821,89
"2021","East Cambridgeshire 002","E02003733",8472,8451,21
"2021","East Cambridgeshire 003","E02003734",11960,11848,112
"2021","East Cambridgeshire 004","E02003735",8613,8384,229
"2021","East Cambridgeshire 005","E02003736",10279,10258,21
"2021","East Cambridgeshire 006","E02003737",13242,13160,82
"2021","East Cambridgeshire 007","E02003738",6399,6397,2
"2021","East Cambridgeshire 008","E02003739",6407,6387,20
"2021","East Cambridgeshire 009","E02003740",6279,6094,185
"2021","East Cambridgeshire 011","E02006825",6200,6200,0
"2021","Fenland 001","E02003742",6808,6784,24
"2021","Fenland 002","E02003743",11079,10892,187
"2021","Fenland 003","E02003744",13717,13489,228
"2021","Fenland 004","E02003745",10362,10354,8
"2021","Fenland 005","E02003746",7815,7326,489
"2021","Fenland 006","E02003747",12680,12547,133
"2021","Fenland 007","E02003748",7659,7644,15
"2021","Fenland 008","E02003749",6124,6080,44
"2021","Fenland 009","E02003750",7488,7369,119
"2021","Fenland 010","E02003751",7544,7455,89
"2021","Fenland 011","E02003752",11187,11118,69
"2021","Huntingdonshire 001","E02003753",11199,11174,25
"2021","Huntingdonshire 002","E02003754",5662,5662,0
"2021","Huntingdonshire 003","E02003755",8597,8580,17
"2021","Huntingdonshire 004","E02003756",7085,7060,25
"2021","Huntingdonshire 005","E02003757",6950,6897,53
"2021","Huntingdonshire 006","E02003758",9682,9362,320
"2021","Huntingdonshire 007","E02003759",5894,5862,32
"2021","Huntingdonshire 008","E02003760",9057,9055,2
"2021","Huntingdonshire 009","E02003761",5974,5855,119
"2021","Huntingdonshire 010","E02003762",11548,11429,119
"2021","Huntingdonshire 011","E02003763",9600,9600,0
"2021","Huntingdonshire 012","E02003764",10399,10251,148
"2021","Huntingdonshire 013","E02003765",7219,7177,42
"2021","Huntingdonshire 014","E02003766",7889,7884,5
"2021","Huntingdonshire 015","E02003767",6374,6310,64
"2021","Huntingdonshire 016","E02003768",10037,9980,57
"2021","Huntingdonshire 017","E02003769",7462,6315,1147
"2021","Huntingdonshire 018","E02003770",10935,10857,78
"2021","Huntingdonshire 019","E02003771",6284,6251,33
"2021","Huntingdonshire 020","E02003772",6715,6679,36
"2021","Huntingdonshire 021","E02003773",10541,10526,15
"2021","Huntingdonshire 022","E02003774",5727,5610,117
"2021","South Cambridgeshire 001","E02003775",7239,7230,9
"2021","South Cambridgeshire 002","E02003776",6779,6689,90
"2021","South Cambridgeshire 003","E02003777",9937,9893,44
"2021","South Cambridgeshire 004","E02003778",6525,6374,151
"2021","South Cambridgeshire 006","E02003780",11428,11296,132
"2021","South Cambridgeshire 007","E02003781",6092,6076,16
"2021","South Cambridgeshire 010","E02003784",8889,8830,59
"2021","South Cambridgeshire 011","E02003785",8952,8869,83
"2021","South Cambridgeshire 012","E02003786",6535,6468,67
"2021","South Cambridgeshire 013","E02003787",7658,7638,20
"2021","South Cambridgeshire 014","E02003788",8121,8121,0
"2021","South Cambridgeshire 015","E02003789",7271,7232,39
"2021","South Cambridgeshire 016","E02003790",9304,9243,61
"2021","South Cambridgeshire 017","E02003791",8268,8267,1
"2021","South Cambridgeshire 018","E02003792",9874,9760,114
"2021","South Cambridgeshire 019","E02003793",7239,7117,122
"2021","South Cambridgeshire 020","E02006873",9888,9886,2
"2021","South Cambridgeshire 021","E02006874",10233,10233,0
"2021","South Cambridgeshire 022","E02007085",11885,11571,314
"2021","Basildon 001","E02004424",7115,7105,10
"2021","Basildon 002","E02004425",7343,7343,0
"2021","Basildon 003","E02004426",8101,8049,52
"2021","Basildon 004","E02004427",8064,8057,7
"2021","Basildon 005","E02004428",6964,6851,113
"2021","Basildon 006","E02004429",7576,7571,5
"2021","Basildon 007","E02004430",8436,8430,6
"2021","Basildon 008","E02004431",9722,9719,3
"2021","Basildon 009","E02004432",6443,6443,0
"2021","Basildon 010","E02004433",8735,8637,98
"2021","Basildon 011","E02004434",8546,8469,77
"2021","Basildon 012","E02004435",9790,9789,1
"2021","Basildon 013","E02004436",7908,7856,52
"2021","Basildon 014","E02004437",10068,10043,25
"2021","Basildon 015","E02004438",9610,9473,137
"2021","Basildon 016","E02004439",9883,9880,3
"2021","Basildon 017","E02004440",9163,9162,1
"2021","Basildon 018","E02004441",7829,7811,18
"2021","Basildon 019","E02004442",8617,8612,5
"2021","Basildon 020","E02004443",10314,10247,67
"2021","Basildon 021","E02004444",9044,8980,64
"2021","Basildon 022","E02004445",8298,8256,42
"2021","Braintree 001","E02004446",7021,7017,4
"2021","Braintree 002","E02004447",5971,5971,0
"2021","Braintree 003","E02004448",7817,7738,79
"2021","Braintree 004","E02004449",8883,8758,125
"2021","Braintree 005","E02004450",6279,6262,17
"2021","Braintree 006","E02004451",9494,9393,101
"2021","Braintree 007","E02004452",9340,9104,236
"2021","Braintree 008","E02004453",7451,7416,35
"2021","Braintree 009","E02004454",9441,9335,106
"2021","Braintree 010","E02004455",7948,7932,16
"2021","Braintree 011","E02004456",9832,9795,37
"2021","Braintree 012","E02004457",10611,10500,111
"2021","Braintree 013","E02004458",9536,9503,33
"2021","Braintree 014","E02004459",10409,10330,79
"2021","Braintree 015","E02004460",9767,9737,30
"2021","Braintree 016","E02004461",5742,5742,0
"2021","Braintree 017","E02004462",11584,11473,111
"2021","Braintree 018","E02004463",8139,8029,110
"2021","Brentwood 001","E02004464",9866,9767,99
"2021","Brentwood 002","E02004465",6364,6340,24
"2021","Brentwood 003","E02004466",8231,8196,35
"2021","Brentwood 004","E02004467",8238,8186,52
"2021","Brentwood 005","E02004468",10618,10542,76
"2021","Brentwood 006","E02004469",7264,7264,0
"2021","Brentwood 007","E02004470",11765,11616,149
"2021","Brentwood 008","E02004471",8518,8363,155
"2021","Brentwood 009","E02004472",6183,6147,36
"2021","Castle Point 001","E02004473",7823,7823,0
"2021","Castle Point 002","E02004474",7952,7877,75
"2021","Castle Point 003","E02004475",6626,6626,0
"2021","Castle Point 004","E02004476",8079,8056,23
"2021","Castle Point 005","E02004477",6045,6044,1
"2021","Castle Point 006","E02004478",6687,6602,85
"2021","Castle Point 007","E02004479",8049,7945,104
"2021","Castle Point 008","E02004480",6975,6975,0
"2021","Castle Point 009","E02004481",6647,6647,0
"2021","Castle Point 010","E02004482",8342,8269,73
"2021","Castle Point 011","E02004483",8000,7964,36
"2021","Castle Point 012","E02004484",8365,8329,36
"2021","Chelmsford 001","E02004485",9861,9841,20
"2021","Chelmsford 002","E02004486",8630,8483,147
"2021","Chelmsford 003","E02004487",7626,7611,15
"2021","Chelmsford 004","E02004488",9998,9950,48
"2021","Chelmsford 005","E02004489",9498,9275,223
"2021","Chelmsford 006","E02004490",7910,7846,64
"2021","Chelmsford 007","E02004491",7477,7477,0
"2021","Chelmsford 008","E02004492",9348,9348,0
"2021","Chelmsford 009","E02004493",10349,10253,96
"2021","Chelmsford 011","E02004495",8309,8082,227
"2021","Chelmsford 012","E02004496",8224,8112,112
"2021","Chelmsford 013","E02004497",7825,7777,48
"2021","Chelmsford 014","E02004498",9891,9884,7
"2021","Chelmsford 015","E02004499",6837,6837,0
"2021","Chelmsford 016","E02004500",9245,9203,42
"2021","Chelmsford 017","E02004501",7049,7047,2
"2021","Chelmsford 018","E02004502",7231,6830,401
"2021","Chelmsford 019","E02004503",8017,8010,7
"2021","Chelmsford 020","E02004504",8009,7955,54
"2021","Chelmsford 021","E02004505",6508,6412,96
"2021","Chelmsford 022","E02006978",7257,6501,756
"2021","Chelmsford 023","E02006979",6427,6356,71
"2021","Colchester 001","E02004506",7148,7056,92
"2021","Colchester 002","E02004507",9689,9630,59
"2021","Colchester 003","E02004508",6566,6536,30
"2021","Colchester 007","E02004512",11314,11112,202
"2021","Colchester 008","E02004513",11349,10141,1208
"2021","Colchester 009","E02004514",5824,5782,42
"2021","Colchester 010","E02004515",9710,9646,64
"2021","Colchester 011","E02004516",13379,12576,803
"2021","Colchester 012","E02004517",9612,9477,135
"2021","Colchester 013","E02004518",8081,8050,31
"2021","Colchester 014","E02004519",7498,7447,51
"2021","Colchester 015","E02004520",9700,9376,324
"2021","Colchester 016","E02004521",9445,9391,54
"2021","Colchester 017","E02004522",8984,7588,1396
"2021","Colchester 018","E02004523",10502,10385,117
"2021","Colchester 019","E02004524",8300,8202,98
"2021","Colchester 020","E02004525",8088,8064,24
"2021","Colchester 021","E02004526",7221,7208,13
"2021","Colchester 022","E02006922",14114,13874,240
"2021","Colchester 023","E02007056",8666,8621,45
"2021","Colchester 024","E02007057",7526,7456,70
"2021","Epping Forest 001","E02004527",9281,9235,46
"2021","Epping Forest 002","E02004528",8817,8816,1
"2021","Epping Forest 003","E02004529",7373,7325,48
"2021","Epping Forest 004","E02004530",7138,7138,0
"2021","Epping Forest 005","E02004531",7161,7098,63
"2021","Epping Forest 006","E02004532",6415,6404,11
"2021","Epping Forest 007","E02004533",7714,7565,149
"2021","Epping Forest 008","E02004534",9073,9021,52
"2021","Epping Forest 009","E02004535",6071,5953,118
"2021","Epping Forest 010","E02004536",6237,6143,94
"2021","Epping Forest 011","E02004537",9526,9526,0
"2021","Epping Forest 012","E02004538",9863,9726,137
"2021","Epping Forest 013","E02004539",7923,7923,0
"2021","Epping Forest 014","E02004540",6034,6034,0
"2021","Epping Forest 015","E02004541",11752,11680,72
"2021","Epping Forest 016","E02004542",6999,6846,153
"2021","Epping Forest 017","E02004543",7602,7526,76
"2021","Harlow 001","E02004544",11183,11181,2
"2021","Harlow 002","E02004545",7971,7921,50
"2021","Harlow 003","E02004546",8412,8401,11
"2021","Harlow 004","E02004547",10060,9916,144
"2021","Harlow 005","E02004548",8941,8930,11
"2021","Harlow 006","E02004549",8158,8111,47
"2021","Harlow 007","E02004550",8822,8766,56
"2021","Harlow 008","E02004551",7609,7588,21
"2021","Harlow 009","E02004552",6592,6590,2
"2021","Harlow 010","E02004553",7846,7845,1
"2021","Harlow 011","E02004554",7733,7722,11
"2021","Maldon 001","E02004555",6485,6374,111
"2021","Maldon 002","E02004556",7552,7510,42
"2021","Maldon 003","E02004557",8908,8809,99
"2021","Maldon 004","E02004558",6909,6846,63
"2021","Maldon 005","E02004559",8030,7988,42
"2021","Maldon 006","E02004560",9084,8976,108
"2021","Maldon 007","E02004561",10388,10368,20
"2021","Maldon 008","E02004562",8850,8848,2
"2021","Rochford 001","E02004563",6593,6593,0
"2021","Rochford 002","E02004564",7915,7907,8
"2021","Rochford 004","E02004566",5654,5585,69
"2021","Rochford 005","E02004567",8125,8047,78
"2021","Rochford 006","E02004568",8861,8851,10
"2021","Rochford 007","E02004569",8650,8613,37
"2021","Rochford 008","E02004570",8691,8640,51
"2021","Rochford 009","E02004571",7816,7808,8
"2021","Rochford 010","E02004572",7930,7900,30
"2021","Rochford 011","E02006980",7507,7507,0
"2021","Rochford 012","E02006981",7919,7918,1
"2021","Tendring 001","E02004573",6418,6351,67
"2021","Tendring 002","E02004574",7863,7860,3
"2021","Tendring 003","E02004575",12089,11931,158
"2021","Tendring 004","E02004576",9139,9084,55
"2021","Tendring 005","E02004577",6108,6034,74
"2021","Tendring 006","E02004578",7627,7456,171
"2021","Tendring 007","E02004579",7913,7877,36
"2021","Tendring 008","E02004580",12285,12162,123
"2021","Tendring 009","E02004581",8507,8388,119
"2021","Tendring 010","E02004582",6972,6955,17
"2021","Tendring 011","E02004583",8908,8841,67
"2021","Tendring 012","E02004584",6581,6520,61
"2021","Tendring 013","E02004585",9038,9012,26
"2021","Tendring 014","E02004586",8246,8110,136
"2021","Tendring 015","E02004587",7736,7736,0
"2021","Tendring 016","E02004588",7209,6855,354
"2021","Tendring 017","E02004589",7413,7275,138
"2021","Tendring 018","E02004590",8238,8191,47
"2021","Uttlesford 001","E02004591",7626,7578,48
"2021","Uttlesford 002","E02004592",13129,13035,94
"2021","Uttlesford 003","E02004593",8966,8931,35
"2021","Uttlesford 004","E02004594",8312,8207,105
"2021","Uttlesford 005","E02004595",14839,14714,125
"2021","Uttlesford 006","E02004596",10620,10565,55
"2021","Uttlesford 007","E02004597",9024,8999,25
"2021","Uttlesford 008","E02004598",11036,10687,349
"2021","Uttlesford 009","E02004599",7793,7757,36
"2021","Broxbourne 001","E02004843",7231,7163,68
"2021","Broxbourne 002","E02004844",7458,7454,4
"2021","Broxbourne 003","E02004845",7896,7877,19
"2021","Broxbourne 004","E02004846",6400,6357,43
"2021","Broxbourne 005","E02004847",10355,10352,3
"2021","Broxbourne 006","E02004848",7718,7718,0
"2021","Broxbourne 007","E02004849",6851,6850,1
"2021","Broxbourne 008","E02004850",7448,7448,0
"2021","Broxbourne 009","E02004851",5936,5932,4
"2021","Broxbourne 010","E02004852",8069,8042,27
"2021","Broxbourne 011","E02004853",6991,6956,35
"2021","Broxbourne 012","E02004854",8074,8063,11
"2021","Broxbourne 013","E02004855",8579,8565,14
"2021","Dacorum 001","E02004856",5800,5718,82
"2021","Dacorum 002","E02004857",6043,5803,240
"2021","Dacorum 003","E02004858",5026,5022,4
"2021","Dacorum 004","E02004859",5317,5265,52
"2021","Dacorum 005","E02004860",5832,5832,0
"2021","Dacorum 006","E02004861",5532,5509,23
"2021","Dacorum 007","E02004862",7780,7760,20
"2021","Dacorum 008","E02004863",7934,7808,126
"2021","Dacorum 009","E02004864",6371,6371,0
"2021","Dacorum 010","E02004865",5514,5513,1
"2021","Dacorum 011","E02004866",6771,6717,54
"2021","Dacorum 012","E02004867",6537,6507,30
"2021","Dacorum 013","E02004868",7797,7687,110
"2021","Dacorum 014","E02004869",5873,5750,123
"2021","Dacorum 015","E02004870",11615,11459,156
"2021","Dacorum 016","E02004871",5024,5024,0
"2021","Dacorum 017","E02004872",7425,7415,10
"2021","Dacorum 018","E02004873",11665,11662,3
"2021","Dacorum 019","E02004874",6001,5963,38
"2021","Dacorum 020","E02004875",10441,10369,72
"2021","Dacorum 021","E02004876",9497,8469,1028
"2021","Dacorum 022","E02004877",5288,5228,60
"2021","Hertsmere 001","E02004896",7980,7864,116
"2021","Hertsmere 002","E02004897",6812,6799,13
"2021","Hertsmere 003","E02004898",7752,7651,101
"2021","Hertsmere 004","E02004899",5391,5296,95
"2021","Hertsmere 005","E02004900",8185,8166,19
"2021","Hertsmere 006","E02004901",10214,10137,77
"2021","Hertsmere 007","E02004902",8128,8128,0
"2021","Hertsmere 008","E02004903",7513,7472,41
"2021","Hertsmere 009","E02004904",6869,6822,47
"2021","Hertsmere 010","E02004905",6541,6339,202
"2021","Hertsmere 011","E02004906",11113,10955,158
"2021","Hertsmere 012","E02004907",10776,10692,84
"2021","Hertsmere 013","E02004908",10552,10491,61
"2021","North Hertfordshire 001","E02004909",5813,5776,37
"2021","North Hertfordshire 002","E02004910",11630,11614,16
"2021","North Hertfordshire 003","E02004911",6808,6806,2
"2021","North Hertfordshire 004","E02004912",10617,10452,165
"2021","North Hertfordshire 006","E02004914",8074,8020,54
"2021","North Hertfordshire 007","E02004915",5632,5632,0
"2021","North Hertfordshire 008","E02004916",7416,7335,81
"2021","North Hertfordshire 009","E02004917",6393,6313,80
"2021","North Hertfordshire 010","E02004918",8160,8141,19
"2021","North Hertfordshire 011","E02004919",7707,7707,0
"2021","North Hertfordshire 012","E02004920",11485,11250,235
"2021","North Hertfordshire 013","E02004921",7868,7809,59
"2021","North Hertfordshire 014","E02004922",10132,10047,85
"2021","North Hertfordshire 015","E02004923",10386,10299,87
"2021","North Hertfordshire 016","E02007088",7684,7628,56
"2021","North Hertfordshire 017","E02007089",7405,7319,86
"2021","Three Rivers 001","E02004956",9036,9035,1
"2021","Three Rivers 002","E02004957",10815,10782,33
"2021","Three Rivers 003","E02004958",7858,7833,25
"2021","Three Rivers 004","E02004959",6182,5955,227
"2021","Three Rivers 005","E02004960",5710,5705,5
"2021","Three Rivers 006","E02004961",9709,9708,1
"2021","Three Rivers 007","E02004962",9025,8988,37
"2021","Three Rivers 008","E02004963",7565,7565,0
"2021","Three Rivers 009","E02004964",5746,5734,12
"2021","Three Rivers 010","E02004965",6948,6948,0
"2021","Three Rivers 011","E02004966",7301,7004,297
"2021","Three Rivers 012","E02004967",7878,7826,52
"2021","Watford 001","E02004968",7704,7647,57
"2021","Watford 002","E02004969",7254,7254,0
"2021","Watford 003","E02004970",8399,8399,0
"2021","Watford 004","E02004971",8665,8621,44
"2021","Watford 005","E02004972",6173,6173,0
"2021","Watford 006","E02004973",8704,8704,0
"2021","Watford 007","E02004974",9072,8846,226
"2021","Watford 008","E02004975",8228,8199,29
"2021","Watford 009","E02004976",11413,11257,156
"2021","Watford 010","E02004977",9160,9141,19
"2021","Watford 011","E02004978",10296,10125,171
"2021","Watford 012","E02004979",7179,7169,10
"2021","Breckland 001","E02005503",7482,7272,210
"2021","Breckland 002","E02005504",9247,9173,74
"2021","Breckland 003","E02005505",7654,7462,192
"2021","Breckland 004","E02005506",7013,6971,42
"2021","Breckland 005","E02005507",11605,11554,51
"2021","Breckland 006","E02005508",7250,7189,61
"2021","Breckland 007","E02005509",8565,8379,186
"2021","Breckland 008","E02005510",7326,7260,66
"2021","Breckland 009","E02005511",8967,8840,127
"2021","Breckland 010","E02005512",10106,9153,953
"2021","Breckland 011","E02005513",10591,10442,149
"2021","Breckland 012","E02005514",6878,6843,35
"2021","Breckland 013","E02005515",6472,6384,88
"2021","Breckland 014","E02005516",7064,7029,35
"2021","Breckland 015","E02005517",5933,5933,0
"2021","Breckland 016","E02005518",10691,10560,131
"2021","Breckland 017","E02005519",8634,8626,8
"2021","Broadland 001","E02005520",8938,8872,66
"2021","Broadland 002","E02005521",8651,8625,26
"2021","Broadland 003","E02005522",5497,5428,69
"2021","Broadland 004","E02005523",8609,8530,79
"2021","Broadland 005","E02005524",5331,5326,5
"2021","Broadland 006","E02005525",9837,9640,197
"2021","Broadland 007","E02005526",5390,5275,115
"2021","Broadland 008","E02005527",9159,9038,121
"2021","Broadland 009","E02005528",8496,8485,11
"2021","Broadland 010","E02005529",5680,5609,71
"2021","Broadland 011","E02005530",5442,5401,41
"2021","Broadland 012","E02005531",5346,5307,39
"2021","Broadland 013","E02005532",9529,9505,24
"2021","Broadland 014","E02005533",9051,8966,85
"2021","Broadland 015","E02005534",7366,7359,7
"2021","Broadland 016","E02005535",7161,6977,184
"2021","Broadland 017","E02005536",6213,6102,111
"2021","Broadland 018","E02005537",6025,5961,64
"2021","Great Yarmouth 001","E02005538",9683,9531,152
"2021","Great Yarmouth 002","E02005539",8014,7950,64
"2021","Great Yarmouth 003","E02005540",8802,8768,34
"2021","Great Yarmouth 004","E02005541",5900,5820,80
"2021","Great Yarmouth 005","E02005542",7212,7126,86
"2021","Great Yarmouth 006","E02005543",9342,9160,182
"2021","Great Yarmouth 007","E02005544",7155,7132,23
"2021","Great Yarmouth 008","E02005545",6477,6446,31
"2021","Great Yarmouth 009","E02005546",7925,7877,48
"2021","Great Yarmouth 010","E02005547",8506,8434,72
"2021","Great Yarmouth 011","E02005548",7418,7336,82
"2021","Great Yarmouth 012","E02005549",5588,5530,58
"2021","Great Yarmouth 013","E02005550",7727,7683,44
"2021","King's Lynn and West Norfolk 001","E02005551",5230,5082,148
"2021","King's Lynn and West Norfolk 002","E02005552",6541,6476,65
"2021","King's Lynn and West Norfolk 003","E02005553",8720,8597,123
"2021","King's Lynn and West Norfolk 004","E02005554",7047,7026,21
"2021","King's Lynn and West Norfolk 005","E02005555",6835,6724,111
"2021","King's Lynn and West Norfolk 006","E02005556",7772,7692,80
"2021","King's Lynn and West Norfolk 007","E02005557",6877,6827,50
"2021","King's Lynn and West Norfolk 008","E02005558",7357,7299,58
"2021","King's Lynn and West Norfolk 009","E02005559",7359,7248,111
"2021","King's Lynn and West Norfolk 010","E02005560",9089,9076,13
"2021","King's Lynn and West Norfolk 011","E02005561",10886,10824,62
"2021","King's Lynn and West Norfolk 012","E02005562",7459,7427,32
"2021","King's Lynn and West Norfolk 013","E02005563",8056,7984,72
"2021","King's Lynn and West Norfolk 014","E02005564",9647,9069,578
"2021","King's Lynn and West Norfolk 015","E02005565",7351,7321,30
"2021","King's Lynn and West Norfolk 016","E02005566",10416,10396,20
"2021","King's Lynn and West Norfolk 017","E02005567",11348,11205,143
"2021","King's Lynn and West Norfolk 018","E02005568",7595,7591,4
"2021","King's Lynn and West Norfolk 019","E02005569",8740,8694,46
"2021","North Norfolk 001","E02005570",7088,6932,156
"2021","North Norfolk 002","E02005571",5834,5733,101
"2021","North Norfolk 003","E02005572",7543,7354,189
"2021","North Norfolk 004","E02005573",5750,5506,244
"2021","North Norfolk 005","E02005574",6954,6892,62
"2021","North Norfolk 006","E02005575",6981,6941,40
"2021","North Norfolk 007","E02005576",6663,6603,60
"2021","North Norfolk 008","E02005577",5976,5915,61
"2021","North Norfolk 009","E02005578",5917,5890,27
"2021","North Norfolk 011","E02005580",8015,7910,105
"2021","North Norfolk 012","E02005581",7846,7193,653
"2021","North Norfolk 013","E02005582",6803,6737,66
"2021","North Norfolk 014","E02005583",8604,8504,100
"2021","North Norfolk 015","E02007032",6816,6730,86
"2021","North Norfolk 016","E02007033",6194,6029,165
"2021","Norwich 001","E02005584",11177,11034,143
"2021","Norwich 002","E02005585",11202,11180,22
"2021","Norwich 003","E02005586",10352,10265,87
"2021","Norwich 004","E02005587",10333,9786,547
"2021","Norwich 005","E02005588",13033,12851,182
"2021","Norwich 006","E02005589",12265,12198,67
"2021","Norwich 009","E02005592",9184,9128,56
"2021","Norwich 010","E02005593",10868,7505,3363
"2021","Norwich 011","E02005594",10939,10806,133
"2021","Norwich 012","E02005595",9378,9316,62
"2021","Norwich 013","E02005596",9972,9930,42
"2021","Norwich 014","E02006907",7113,6920,193
"2021","Norwich 015","E02006908",5562,5505,57
"2021","Norwich 016","E02007052",6464,6380,84
"2021","Norwich 017","E02007053",6081,4684,1397
"2021","South Norfolk 002","E02005598",9955,9815,140
"2021","South Norfolk 003","E02005599",7201,7140,61
"2021","South Norfolk 004","E02005600",6407,5770,637
"2021","South Norfolk 005","E02005601",5463,5424,39
"2021","South Norfolk 006","E02005602",12708,12657,51
"2021","South Norfolk 007","E02005603",12818,12731,87
"2021","South Norfolk 008","E02005604",8851,8703,148
"2021","South Norfolk 009","E02005605",10688,10564,124
"2021","South Norfolk 010","E02005606",5839,5817,22
"2021","South Norfolk 011","E02005607",11555,11461,94
"2021","South Norfolk 012","E02005608",7627,7501,126
"2021","South Norfolk 013","E02005609",7548,7529,19
"2021","South Norfolk 014","E02005610",8090,7962,128
"2021","South Norfolk 015","E02005611",10921,10824,97
"2021","South Norfolk 016","E02007054",8745,8745,0
"2021","South Norfolk 017","E02007055",7535,7524,11
"2021","Babergh 001","E02006227",6430,6354,76
"2021","Babergh 002","E02006228",6159,6121,38
"2021","Babergh 003","E02006229",6180,6130,50
"2021","Babergh 004","E02006230",11012,10870,142
"2021","Babergh 005","E02006231",8630,8572,58
"2021","Babergh 006","E02006232",6121,6106,15
"2021","Babergh 007","E02006233",11622,11384,238
"2021","Babergh 008","E02006234",9950,9863,87
"2021","Babergh 009","E02006235",8200,8144,56
"2021","Babergh 010","E02006236",10440,10390,50
"2021","Babergh 011","E02006237",7595,7229,366
"2021","Ipswich 001","E02006245",8286,8241,45
"2021","Ipswich 002","E02006246",7432,7386,46
"2021","Ipswich 003","E02006247",9104,9098,6
"2021","Ipswich 004","E02006248",8482,8418,64
"2021","Ipswich 005","E02006249",8388,8240,148
"2021","Ipswich 006","E02006250",10199,10084,115
"2021","Ipswich 007","E02006251",10692,10472,220
"2021","Ipswich 008","E02006252",9700,9598,102
"2021","Ipswich 009","E02006253",7446,7405,41
"2021","Ipswich 010","E02006254",9397,9233,164
"2021","Ipswich 011","E02006255",8120,7731,389
"2021","Ipswich 012","E02006256",9841,9679,162
"2021","Ipswich 013","E02006257",6776,6776,0
"2021","Ipswich 014","E02006258",9651,9564,87
"2021","Ipswich 015","E02006259",7279,7203,76
"2021","Ipswich 016","E02006260",8847,8847,0
"2021","Mid Suffolk 001","E02006261",7957,7801,156
"2021","Mid Suffolk 002","E02006262",8990,8943,47
"2021","Mid Suffolk 003","E02006263",7534,7526,8
"2021","Mid Suffolk 004","E02006264",8870,8836,34
"2021","Mid Suffolk 005","E02006265",7378,7378,0
"2021","Mid Suffolk 006","E02006266",9435,9435,0
"2021","Mid Suffolk 007","E02006267",8348,8348,0
"2021","Mid Suffolk 008","E02006268",6159,6138,21
"2021","Mid Suffolk 009","E02006269",7738,7532,206
"2021","Mid Suffolk 010","E02006270",12792,12708,84
"2021","Mid Suffolk 011","E02006271",9845,9246,599
"2021","Mid Suffolk 012","E02006272",7653,7571,82
"2021","St Albans 001","E02004924",7730,7730,0
"2021","St Albans 002","E02004925",7878,7716,162
"2021","St Albans 003","E02004926",8100,8037,63
"2021","St Albans 004","E02004927",6716,6702,14
"2021","St Albans 005","E02004928",6871,6871,0
"2021","St Albans 006","E02004929",6403,6348,55
"2021","St Albans 007","E02004930",7004,6933,71
"2021","St Albans 008","E02004931",6972,6972,0
"2021","St Albans 009","E02004932",7744,7691,53
"2021","St Albans 010","E02004933",6943,6924,19
"2021","St Albans 011","E02004934",7802,7713,89
"2021","St Albans 012","E02004935",9051,8948,103
"2021","St Albans 013","E02004936",6540,6519,21
"2021","St Albans 014","E02004937",7292,7160,132
"2021","St Albans 016","E02004939",6687,6641,46
"2021","St Albans 017","E02004940",7710,7648,62
"2021","St Albans 018","E02004941",9804,9782,22
"2021","St Albans 019","E02004942",6433,6352,81
"2021","St Albans 020","E02004943",8220,8128,92
"2021","St Albans 021","E02007090",6266,6138,128
"2021","Welwyn Hatfield 001","E02004980",6202,6107,95
"2021","Welwyn Hatfield 002","E02004981",8138,8111,27
"2021","Welwyn Hatfield 003","E02004982",5971,5963,8
"2021","Welwyn Hatfield 004","E02004983",6119,6119,0
"2021","Welwyn Hatfield 005","E02004984",6288,6187,101
"2021","Welwyn Hatfield 006","E02004985",6932,6895,37
"2021","Welwyn Hatfield 007","E02004986",8787,8784,3
"2021","Welwyn Hatfield 008","E02004987",7797,7749,48
"2021","Welwyn Hatfield 009","E02004988",7850,7848,2
"2021","Welwyn Hatfield 010","E02004989",12556,10691,1865
"2021","Welwyn Hatfield 011","E02004990",7285,7159,126
"2021","Welwyn Hatfield 012","E02004991",8230,8112,118
"2021","Welwyn Hatfield 013","E02004992",10404,8034,2370
"2021","Welwyn Hatfield 015","E02004994",6152,6008,144
"2021","Welwyn Hatfield 016","E02004995",5642,5642,0
"2021","Welwyn Hatfield 017","E02007092",5487,5301,186
"2021","East Hertfordshire 001","E02004878",9319,9277,42
"2021","East Hertfordshire 003","E02004880",10830,10721,109
"2021","East Hertfordshire 004","E02004881",6867,6808,59
"2021","East Hertfordshire 005","E02004882",8461,8182,279
"2021","East Hertfordshire 006","E02004883",6245,6181,64
"2021","East Hertfordshire 007","E02004884",10373,10331,42
"2021","East Hertfordshire 008","E02004885",8581,8540,41
"2021","East Hertfordshire 009","E02004886",6662,6476,186
"2021","East Hertfordshire 010","E02004887",7529,7524,5
"2021","East Hertfordshire 011","E02004888",8744,8703,41
"2021","East Hertfordshire 012","E02004889",11238,10996,242
"2021","East Hertfordshire 013","E02004890",8388,8364,24
"2021","East Hertfordshire 014","E02004891",7898,7852,46
"2021","East Hertfordshire 015","E02004892",5913,5908,5
"2021","East Hertfordshire 016","E02004893",5976,5976,0
"2021","East Hertfordshire 017","E02004894",9632,9570,62
"2021","East Hertfordshire 018","E02004895",9387,8747,640
"2021","East Hertfordshire 019","E02007093",8115,8067,48
"2021","Stevenage 001","E02004944",8141,8135,6
"2021","Stevenage 002","E02004945",12232,11990,242
"2021","Stevenage 003","E02004946",6423,6316,107
"2021","Stevenage 005","E02004948",6076,6051,25
"2021","Stevenage 006","E02004949",8797,8668,129
"2021","Stevenage 007","E02004950",6826,6818,8
"2021","Stevenage 008","E02004951",8055,8029,26
"2021","Stevenage 009","E02004952",6885,6834,51
"2021","Stevenage 010","E02004953",6474,6474,0
"2021","Stevenage 011","E02004954",7130,7080,50
"2021","Stevenage 012","E02004955",6020,5998,22
"2021","Stevenage 013","E02007091",6435,6435,0
"2021","East Suffolk 016","E02006287",6259,6182,77
"2021","East Suffolk 017","E02006288",10053,9712,341
"2021","East Suffolk 018","E02006289",9699,9635,64
"2021","East Suffolk 019","E02006290",8106,7956,150
"2021","East Suffolk 020","E02006291",7670,7668,2
"2021","East Suffolk 021","E02006292",6783,6731,52
"2021","East Suffolk 023","E02006293",11157,10131,1026
"2021","East Suffolk 022","E02006294",7880,7731,149
"2021","East Suffolk 024","E02006295",9325,9298,27
"2021","East Suffolk 025","E02006296",13090,13046,44
"2021","East Suffolk 026","E02006297",8046,7952,94
"2021","East Suffolk 027","E02006298",9142,9093,49
"2021","East Suffolk 028","E02006299",8235,8146,89
"2021","East Suffolk 029","E02006300",7938,7925,13
"2021","East Suffolk 030","E02006301",6306,6091,215
"2021","East Suffolk 001","E02006302",6638,6562,76
"2021","East Suffolk 002","E02006303",7982,7932,50
"2021","East Suffolk 003","E02006304",8148,8099,49
"2021","East Suffolk 004","E02006305",9734,9631,103
"2021","East Suffolk 005","E02006306",7289,7245,44
"2021","East Suffolk 007","E02006307",7323,7202,121
"2021","East Suffolk 006","E02006308",7630,7413,217
"2021","East Suffolk 009","E02006309",6742,6606,136
"2021","East Suffolk 008","E02006310",8078,8007,71
"2021","East Suffolk 010","E02006311",8213,8134,79
"2021","East Suffolk 011","E02006312",8486,8486,0
"2021","East Suffolk 012","E02006313",9931,9901,30
"2021","East Suffolk 013","E02006314",7261,7146,115
"2021","East Suffolk 014","E02006315",5842,5745,97
"2021","East Suffolk 015","E02006316",7073,6998,75
"2021","West Suffolk 002","E02006238",9690,9632,58
"2021","West Suffolk 001","E02006239",8724,7945,779
"2021","West Suffolk 003","E02006240",10228,9784,444
"2021","West Suffolk 004","E02006241",8842,8761,81
"2021","West Suffolk 007","E02006242",10641,10578,63
"2021","West Suffolk 008","E02006243",9331,9307,24
"2021","West Suffolk 005","E02006273",6839,6813,26
"2021","West Suffolk 006","E02006274",6599,6043,556
"2021","West Suffolk 009","E02006275",6999,6998,1
"2021","West Suffolk 016","E02006276",8230,8063,167
"2021","West Suffolk 012","E02006277",7688,7675,13
"2021","West Suffolk 011","E02006278",8377,8236,141
"2021","West Suffolk 014","E02006279",8747,8699,48
"2021","West Suffolk 010","E02006280",9731,9503,228
"2021","West Suffolk 013","E02006281",8321,8140,181
"2021","West Suffolk 017","E02006282",6520,6468,52
"2021","West Suffolk 018","E02006283",8253,6912,1341
"2021","West Suffolk 019","E02006284",7730,7712,18
"2021","West Suffolk 021","E02006285",7549,7488,61
"2021","West Suffolk 020","E02006286",11154,11077,77
"2021","West Suffolk 015","E02006826",9751,9666,85
"2021","City of London 001","E02000001",8583,8373,210
"2021","Barking and Dagenham 001","E02000002",8281,8235,46
"2021","Barking and Dagenham 002","E02000003",11542,11520,22
"2021","Barking and Dagenham 003","E02000004",6640,6469,171
"2021","Barking and Dagenham 004","E02000005",11082,11081,1
"2021","Barking and Dagenham 006","E02000007",10162,10052,110
"2021","Barking and Dagenham 007","E02000008",13250,13240,10
"2021","Barking and Dagenham 008","E02000009",12863,12862,1
"2021","Barking and Dagenham 009","E02000010",9485,9484,1
"2021","Barking and Dagenham 010","E02000011",7030,6927,103
"2021","Barking and Dagenham 011","E02000012",11513,11506,7
"2021","Barking and Dagenham 012","E02000013",9398,9398,0
"2021","Barking and Dagenham 013","E02000014",9865,9818,47
"2021","Barking and Dagenham 014","E02000015",8228,8227,1
"2021","Barking and Dagenham 015","E02000016",10568,10560,8
"2021","Barking and Dagenham 016","E02000017",9133,9088,45
"2021","Barking and Dagenham 017","E02000018",9552,9549,3
"2021","Barking and Dagenham 018","E02000019",9663,9604,59
"2021","Barking and Dagenham 019","E02000020",14055,14046,9
"2021","Barking and Dagenham 020","E02000021",8759,8658,101
"2021","Barking and Dagenham 021","E02000022",7741,7713,28
"2021","Barking and Dagenham 022","E02000023",8019,7932,87
"2021","Barking and Dagenham 023","E02006799",12041,11980,61
"2021","Barnet 001","E02000024",10841,10737,104
"2021","Barnet 002","E02000025",8582,8578,4
"2021","Barnet 003","E02000026",6458,6429,29
"2021","Barnet 004","E02000027",9646,9545,101
"2021","Barnet 005","E02000028",6533,6517,16
"2021","Barnet 006","E02000029",9677,9677,0
"2021","Barnet 007","E02000030",9457,9361,96
"2021","Barnet 008","E02000031",8331,8167,164
"2021","Barnet 009","E02000032",7939,7929,10
"2021","Barnet 010","E02000033",8891,8846,45
"2021","Barnet 011","E02000034",9089,9046,43
"2021","Barnet 012","E02000035",8530,8214,316
"2021","Barnet 013","E02000036",11244,11186,58
"2021","Barnet 014","E02000037",10835,10834,1
"2021","Barnet 015","E02000038",10719,10466,253
"2021","Barnet 016","E02000039",7168,7166,2
"2021","Barnet 017","E02000040",9139,8859,280
"2021","Barnet 018","E02000041",9455,9413,42
"2021","Barnet 019","E02000042",11560,11354,206
"2021","Barnet 020","E02000043",7570,7495,75
"2021","Barnet 021","E02000044",8844,8844,0
"2021","Barnet 022","E02000045",10524,10484,40
"2021","Barnet 023","E02000046",6962,6962,0
"2021","Barnet 024","E02000047",12397,12335,62
"2021","Barnet 025","E02000048",10283,10282,1
"2021","Barnet 026","E02000049",10532,10531,1
"2021","Barnet 027","E02000050",10380,10354,26
"2021","Barnet 028","E02000051",9160,9114,46
"2021","Barnet 029","E02000052",9849,9849,0
"2021","Barnet 031","E02000054",7631,7594,37
"2021","Barnet 032","E02000055",11723,11616,107
"2021","Barnet 033","E02000056",9132,9053,79
"2021","Barnet 034","E02000057",8013,7966,47
"2021","Barnet 035","E02000058",10227,10222,5
"2021","Barnet 036","E02000059",11626,11621,5
"2021","Barnet 037","E02000060",11557,11418,139
"2021","Barnet 038","E02000061",8345,8227,118
"2021","Barnet 039","E02000062",6958,6937,21
"2021","Barnet 040","E02000063",7584,7510,74
"2021","Barnet 041","E02000064",6674,6592,82
"2021","Barnet 042","E02006953",9169,8559,610
"2021","Barnet 043","E02006954",10113,10067,46
"2021","Bexley 001","E02000065",8062,8013,49
"2021","Bexley 002","E02000066",9430,9386,44
"2021","Bexley 003","E02000067",10231,10224,7
"2021","Bexley 004","E02000068",8176,8165,11
"2021","Bexley 005","E02000069",7212,7184,28
"2021","Bexley 006","E02000070",8111,8111,0
"2021","Bexley 007","E02000071",7672,7665,7
"2021","Bexley 008","E02000072",12924,12920,4
"2021","Bexley 009","E02000073",10726,10726,0
"2021","Bexley 010","E02000074",8861,8833,28
"2021","Bexley 011","E02000075",7986,7986,0
"2021","Bexley 013","E02000077",8140,8067,73
"2021","Bexley 014","E02000078",7933,7880,53
"2021","Bexley 015","E02000079",8770,8582,188
"2021","Bexley 016","E02000080",10065,10065,0
"2021","Bexley 017","E02000081",8306,8257,49
"2021","Bexley 018","E02000082",9336,9336,0
"2021","Bexley 019","E02000083",11271,11248,23
"2021","Bexley 020","E02000084",11115,11115,0
"2021","Bexley 021","E02000085",7961,7960,1
"2021","Bexley 022","E02000086",7178,7174,4
"2021","Bexley 023","E02000087",8209,8199,10
"2021","Bexley 024","E02000088",7750,7750,0
"2021","Bexley 025","E02000089",7869,7742,127
"2021","Bexley 026","E02000090",9639,9259,380
"2021","Bexley 027","E02000091",10164,10093,71
"2021","Bexley 028","E02000092",6753,6703,50
"2021","Bexley 029","E02006785",6624,6624,0
"2021","Brent 001","E02000093",11877,11823,54
"2021","Brent 002","E02000094",10460,10393,67
"2021","Brent 003","E02000095",10461,10461,0
"2021","Brent 004","E02000096",7632,7585,47
"2021","Brent 005","E02000097",9532,9532,0
"2021","Brent 006","E02000098",8742,8619,123
"2021","Brent 007","E02000099",9560,9555,5
"2021","Brent 008","E02000100",8319,7937,382
"2021","Brent 009","E02000101",9937,9746,191
"2021","Brent 010","E02000102",8328,8319,9
"2021","Brent 011","E02000103",9973,9806,167
"2021","Brent 012","E02000104",7505,7392,113
"2021","Brent 013","E02000105",9844,9798,46
"2021","Brent 014","E02000106",10353,10341,12
"2021","Brent 015","E02000107",10939,10924,15
"2021","Brent 016","E02000108",7259,7230,29
"2021","Brent 018","E02000110",8175,8164,11
"2021","Brent 019","E02000111",11284,11158,126
"2021","Brent 020","E02000112",11749,11660,89
"2021","Brent 021","E02000113",9630,9629,1
"2021","Brent 022","E02000114",8996,8995,1
"2021","Brent 023","E02000115",8622,8502,120
"2021","Brent 024","E02000116",8549,8514,35
"2021","Brent 025","E02000117",12733,12684,49
"2021","Brent 026","E02000118",11293,11291,2
"2021","Brent 027","E02000119",10625,10435,190
"2021","Brent 028","E02000120",9014,9014,0
"2021","Brent 029","E02000121",12239,12237,2
"2021","Brent 030","E02000122",8177,8164,13
"2021","Brent 031","E02000123",13578,13566,12
"2021","Brent 032","E02000124",9954,9939,15
"2021","Brent 033","E02000125",9940,9940,0
"2021","Brent 034","E02000126",8195,8149,46
"2021","Brent 035","E02006955",7509,6410,1099
"2021","Brent 036","E02006956",8830,7890,940
"2021","Bromley 001","E02000127",9330,9302,28
"2021","Bromley 002","E02000128",7789,7594,195
"2021","Bromley 004","E02000130",8426,8418,8
"2021","Bromley 005","E02000131",10485,10485,0
"2021","Bromley 006","E02000132",9834,9790,44
"2021","Bromley 007","E02000133",10755,10650,105
"2021","Bromley 008","E02000134",11751,11669,82
"2021","Bromley 009","E02000135",9871,9715,156
"2021","Bromley 010","E02000136",5745,5595,150
"2021","Bromley 011","E02000137",8400,8272,128
"2021","Bromley 012","E02000138",8502,8495,7
"2021","Bromley 013","E02000139",7714,7636,78
"2021","Bromley 014","E02000140",8679,8661,18
"2021","Bromley 015","E02000141",7232,7204,28
"2021","Bromley 016","E02000142",8818,8682,136
"2021","Bromley 018","E02000144",10063,10027,36
"2021","Bromley 019","E02000145",8824,8820,4
"2021","Bromley 020","E02000146",9702,9539,163
"2021","Bromley 021","E02000147",8190,8190,0
"2021","Bromley 022","E02000148",6723,6721,2
"2021","Bromley 023","E02000149",8166,8166,0
"2021","Bromley 024","E02000150",8516,8419,97
"2021","Bromley 025","E02000151",7543,7543,0
"2021","Bromley 026","E02000152",7964,7954,10
"2021","Bromley 027","E02000153",8106,8106,0
"2021","Bromley 028","E02000154",8529,8526,3
"2021","Bromley 029","E02000155",7156,7156,0
"2021","Bromley 030","E02000156",12292,12236,56
"2021","Bromley 031","E02000157",8367,8367,0
"2021","Bromley 032","E02000158",7788,7788,0
"2021","Bromley 033","E02000159",7117,7117,0
"2021","Bromley 034","E02000160",8108,8031,77
"2021","Bromley 035","E02000161",8702,8652,50
"2021","Bromley 036","E02000162",7121,7045,76
"2021","Bromley 037","E02000163",7716,7716,0
"2021","Bromley 039","E02000165",7172,7172,0
"2021","Bromley 040","E02006782",8126,8082,44
"2021","Bromley 041","E02006787",7896,7895,1
"2021","Bromley 042","E02006789",6782,6769,13
"2021","Camden 001","E02000166",7745,7709,36
"2021","Camden 002","E02000167",7198,7188,10
"2021","Camden 003","E02000168",7813,7733,80
"2021","Camden 004","E02000169",7177,7165,12
"2021","Camden 005","E02000170",7916,7884,32
"2021","Camden 006","E02000171",7393,7360,33
"2021","Camden 007","E02000172",9997,9576,421
"2021","Camden 008","E02000173",7493,7439,54
"2021","Camden 009","E02000174",8086,8059,27
"2021","Camden 010","E02000175",9082,8917,165
"2021","Camden 011","E02000176",5914,5855,59
"2021","Camden 012","E02000177",8488,8399,89
"2021","Camden 013","E02000178",8903,8842,61
"2021","Camden 014","E02000179",5748,5717,31
"2021","Camden 015","E02000180",7879,7833,46
"2021","Camden 016","E02000181",8076,8066,10
"2021","Camden 017","E02000182",7120,7093,27
"2021","Camden 018","E02000183",7591,7568,23
"2021","Camden 019","E02000184",8908,8213,695
"2021","Camden 020","E02000185",8882,8880,2
"2021","Camden 021","E02000186",6223,6055,168
"2021","Camden 022","E02000187",9783,9238,545
"2021","Camden 023","E02000188",7180,6834,346
"2021","Camden 026","E02000191",5337,3791,1546
"2021","Camden 027","E02000192",6659,6563,96
"2021","Camden 028","E02000193",5961,5512,449
"2021","Camden 029","E02007115",11588,9217,2371
"2021","Croydon 001","E02000194",9211,9053,158
"2021","Croydon 002","E02000195",9649,9612,37
"2021","Croydon 003","E02000196",7914,7826,88
"2021","Croydon 004","E02000197",9025,9004,21
"2021","Croydon 005","E02000198",8888,8845,43
"2021","Croydon 006","E02000199",8414,8402,12
"2021","Croydon 007","E02000200",9049,8921,128
"2021","Croydon 008","E02000201",8692,8678,14
"2021","Croydon 009","E02000202",8929,8843,86
"2021","Croydon 010","E02000203",7965,7852,113
"2021","Croydon 011","E02000204",9656,9600,56
"2021","Croydon 013","E02000206",10818,10676,142
"2021","Croydon 014","E02000207",8902,8890,12
"2021","Croydon 015","E02000208",10863,10747,116
"2021","Croydon 016","E02000209",9067,9061,6
"2021","Croydon 017","E02000210",8713,8702,11
"2021","Croydon 018","E02000211",8273,8269,4
"2021","Croydon 019","E02000212",9461,9392,69
"2021","Croydon 020","E02000213",12798,12698,100
"2021","Croydon 021","E02000214",6236,6236,0
"2021","Croydon 022","E02000215",11826,11712,114
"2021","Croydon 023","E02000216",7162,7078,84
"2021","Croydon 024","E02000217",11925,11921,4
"2021","Croydon 025","E02000218",6671,6669,2
"2021","Croydon 026","E02000219",7631,7541,90
"2021","Croydon 028","E02000221",10857,10654,203
"2021","Croydon 029","E02000222",8350,8278,72
"2021","Croydon 030","E02000223",8530,8530,0
"2021","Croydon 031","E02000224",8053,7988,65
"2021","Croydon 032","E02000225",7499,7498,1
"2021","Croydon 033","E02000226",7615,7440,175
"2021","Croydon 034","E02000227",11680,11680,0
"2021","Croydon 035","E02000228",7956,7864,92
"2021","Croydon 036","E02000229",6235,6163,72
"2021","Croydon 037","E02000230",10502,10234,268
"2021","Croydon 038","E02000231",7930,7709,221
"2021","Croydon 039","E02000232",6198,6182,16
"2021","Croydon 040","E02000233",6364,6239,125
"2021","Croydon 041","E02000234",9452,9342,110
"2021","Croydon 042","E02000235",6890,6802,88
"2021","Croydon 043","E02000236",9130,9102,28
"2021","Croydon 044","E02000237",7600,7588,12
"2021","Croydon 045","E02006788",7611,7611,0
"2021","Croydon 046","E02006987",7373,7264,109
"2021","Croydon 047","E02006988",7161,6983,178
"2021","Ealing 001","E02000238",10707,10707,0
"2021","Ealing 002","E02000239",9042,9042,0
"2021","Ealing 003","E02000240",11209,11186,23
"2021","Ealing 004","E02000241",7395,7395,0
"2021","Ealing 005","E02000242",6885,6885,0
"2021","Ealing 006","E02000243",8722,8659,63
"2021","Ealing 007","E02000244",7889,7885,4
"2021","Ealing 008","E02000245",9306,9297,9
"2021","Ealing 009","E02000246",9461,9449,12
"2021","Ealing 010","E02000247",11155,10974,181
"2021","Ealing 011","E02000248",7717,7717,0
"2021","Ealing 012","E02000249",8376,8317,59
"2021","Ealing 013","E02000250",6483,6414,69
"2021","Ealing 014","E02000251",8313,8303,10
"2021","Ealing 015","E02000252",12238,10281,1957
"2021","Ealing 016","E02000253",10344,10260,84
"2021","Ealing 017","E02000254",9209,9120,89
"2021","Ealing 018","E02000255",9863,9733,130
"2021","Ealing 019","E02000256",9183,9125,58
"2021","Ealing 021","E02000258",6901,6847,54
"2021","Ealing 022","E02000259",6584,6584,0
"2021","Ealing 023","E02000260",9835,9657,178
"2021","Ealing 024","E02000261",12653,12634,19
"2021","Ealing 025","E02000262",9348,9245,103
"2021","Ealing 026","E02000263",13706,13694,12
"2021","Ealing 027","E02000264",8494,8366,128
"2021","Ealing 028","E02000265",11232,11106,126
"2021","Ealing 029","E02000266",13114,12867,247
"2021","Ealing 030","E02000267",8151,8134,17
"2021","Ealing 031","E02000268",9250,9145,105
"2021","Ealing 032","E02000269",8167,8117,50
"2021","Ealing 033","E02000270",9607,9602,5
"2021","Ealing 034","E02000271",6950,6941,9
"2021","Ealing 035","E02000272",6713,6655,58
"2021","Ealing 038","E02000275",8170,8082,88
"2021","Ealing 039","E02000276",6761,6758,3
"2021","Ealing 040","E02006791",7566,7564,2
"2021","Ealing 041","E02006968",8351,8292,59
"2021","Ealing 042","E02006969",6426,6253,173
"2021","Ealing 043","E02006970",7343,7318,25
"2021","Ealing 044","E02006971",8295,8295,0
"2021","Enfield 001","E02000277",7524,7473,51
"2021","Enfield 002","E02000278",9430,9350,80
"2021","Enfield 003","E02000279",12320,12308,12
"2021","Enfield 004","E02000280",8634,8585,49
"2021","Enfield 005","E02000281",9653,9573,80
"2021","Enfield 006","E02000282",9951,9887,64
"2021","Enfield 007","E02000283",8538,8507,31
"2021","Enfield 008","E02000284",8741,8714,27
"2021","Enfield 009","E02000285",6643,6643,0
"2021","Enfield 010","E02000286",8688,8637,51
"2021","Enfield 011","E02000287",7355,7276,79
"2021","Enfield 012","E02000288",12784,12772,12
"2021","Enfield 013","E02000289",6774,6774,0
"2021","Enfield 014","E02000290",6682,6673,9
"2021","Enfield 015","E02000291",10162,9978,184
"2021","Enfield 016","E02000292",9837,9821,16
"2021","Enfield 017","E02000293",6396,6379,17
"2021","Enfield 018","E02000294",9369,9311,58
"2021","Enfield 019","E02000295",8691,8609,82
"2021","Enfield 020","E02000296",10343,10170,173
"2021","Enfield 021","E02000297",9398,9335,63
"2021","Enfield 022","E02000298",8253,8162,91
"2021","Enfield 023","E02000299",9495,9444,51
"2021","Enfield 024","E02000300",8855,8786,69
"2021","Enfield 025","E02000301",10221,10201,20
"2021","Enfield 026","E02000302",8668,8652,16
"2021","Enfield 027","E02000303",8366,8346,20
"2021","Enfield 028","E02000304",8041,7946,95
"2021","Enfield 029","E02000305",8878,8719,159
"2021","Enfield 030","E02000306",9134,9116,18
"2021","Enfield 031","E02000307",10112,10104,8
"2021","Enfield 032","E02000308",8759,8743,16
"2021","Enfield 033","E02000309",11794,11745,49
"2021","Enfield 035","E02000311",10544,10535,9
"2021","Enfield 036","E02000312",11303,11262,41
"2021","Enfield 037","E02006793",9645,9570,75
"2021","Greenwich 001","E02000313",6489,6479,10
"2021","Greenwich 002","E02000314",14106,12715,1391
"2021","Greenwich 003","E02000315",9871,9827,44
"2021","Greenwich 005","E02000317",7561,7485,76
"2021","Greenwich 006","E02000318",11064,11050,14
"2021","Greenwich 007","E02000319",10618,10550,68
"2021","Greenwich 008","E02000320",7041,6951,90
"2021","Greenwich 009","E02000321",7721,7665,56
"2021","Greenwich 011","E02000323",12861,12776,85
"2021","Greenwich 012","E02000324",7865,7799,66
"2021","Greenwich 014","E02000326",7798,7790,8
"2021","Greenwich 015","E02000327",6625,6518,107
"2021","Greenwich 016","E02000328",6512,6471,41
"2021","Greenwich 017","E02000329",6332,6326,6
"2021","Greenwich 019","E02000331",8238,8175,63
"2021","Greenwich 020","E02000332",7451,7410,41
"2021","Greenwich 021","E02000333",6242,6173,69
"2021","Greenwich 022","E02000334",6639,6629,10
"2021","Greenwich 023","E02000335",6675,6675,0
"2021","Greenwich 025","E02000337",8471,8471,0
"2021","Greenwich 027","E02000339",6291,6286,5
"2021","Greenwich 028","E02000340",6865,6863,2
"2021","Greenwich 029","E02000341",7995,7956,39
"2021","Greenwich 030","E02000342",6348,5755,593
"2021","Greenwich 031","E02000343",7046,7045,1
"2021","Greenwich 032","E02000344",6430,6354,76
"2021","Greenwich 033","E02006786",7557,7541,16
"2021","Greenwich 034","E02006927",12367,12282,85
"2021","Greenwich 035","E02006928",12093,11132,961
"2021","Greenwich 037","E02006930",9846,9834,12
"2021","Greenwich 038","E02006931",9462,9301,161
"2021","Greenwich 039","E02006991",6319,6317,2
"2021","Greenwich 040","E02006992",8229,8202,27
"2021","Greenwich 041","E02006993",8401,8210,191
"2021","Greenwich 042","E02006994",7641,7639,2
"2021","Hackney 001","E02000345",8199,8197,2
"2021","Hackney 002","E02000346",9398,9280,118
"2021","Hackney 003","E02000347",8151,8055,96
"2021","Hackney 004","E02000348",8106,8105,1
"2021","Hackney 006","E02000350",10241,10241,0
"2021","Hackney 007","E02000351",9286,9247,39
"2021","Hackney 008","E02000352",6749,6699,50
"2021","Hackney 009","E02000353",7763,7763,0
"2021","Hackney 010","E02000354",9610,9588,22
"2021","Hackney 011","E02000355",8194,8102,92
"2021","Hackney 012","E02000356",7034,7034,0
"2021","Hackney 013","E02000357",6845,6845,0
"2021","Hackney 014","E02000358",11090,11065,25
"2021","Hackney 015","E02000359",6697,6683,14
"2021","Hackney 016","E02000360",11512,11510,2
"2021","Hackney 017","E02000361",8061,8054,7
"2021","Hackney 018","E02000362",6961,6756,205
"2021","Hackney 019","E02000363",11882,11168,714
"2021","Hackney 020","E02000364",9217,9210,7
"2021","Hackney 022","E02000366",8328,8229,99
"2021","Hackney 023","E02000367",10418,10271,147
"2021","Hackney 024","E02000368",9922,9903,19
"2021","Hackney 025","E02000369",13458,13418,40
"2021","Hackney 026","E02000370",8862,8828,34
"2021","Hackney 028","E02006918",8398,8398,0
"2021","Hackney 029","E02006921",7926,7926,0
"2021","Hackney 030","E02007108",5941,5864,77
"2021","Hackney 031","E02007109",7614,7598,16
"2021","Hackney 032","E02007110",7332,6990,342
"2021","Hackney 033","E02007111",5949,5604,345
"2021","Hammersmith and Fulham 001","E02000372",9984,9048,936
"2021","Hammersmith and Fulham 002","E02000373",7034,7033,1
"2021","Hammersmith and Fulham 003","E02000374",6914,6697,217
"2021","Hammersmith and Fulham 004","E02000375",7485,7445,40
"2021","Hammersmith and Fulham 005","E02000376",6701,6696,5
"2021","Hammersmith and Fulham 006","E02000377",7795,7576,219
"2021","Hammersmith and Fulham 007","E02000378",6433,6418,15
"2021","Hammersmith and Fulham 008","E02000379",7388,7264,124
"2021","Hammersmith and Fulham 009","E02000380",5508,5497,11
"2021","Hammersmith and Fulham 010","E02000381",7628,7580,48
"2021","Hammersmith and Fulham 011","E02000382",6189,5921,268
"2021","Hammersmith and Fulham 012","E02000383",8462,8332,130
"2021","Hammersmith and Fulham 013","E02000384",8267,8059,208
"2021","Hammersmith and Fulham 014","E02000385",5614,5594,20
"2021","Hammersmith and Fulham 015","E02000386",7582,7562,20
"2021","Hammersmith and Fulham 016","E02000387",6024,5898,126
"2021","Hammersmith and Fulham 017","E02000388",8657,8618,39
"2021","Hammersmith and Fulham 018","E02000389",8645,8633,12
"2021","Hammersmith and Fulham 019","E02000390",6195,6194,1
"2021","Hammersmith and Fulham 020","E02000391",7587,7547,40
"2021","Hammersmith and Fulham 021","E02000392",9229,9209,20
"2021","Hammersmith and Fulham 022","E02000393",5975,5975,0
"2021","Hammersmith and Fulham 023","E02000394",9281,9222,59
"2021","Hammersmith and Fulham 024","E02000395",5680,5680,0
"2021","Hammersmith and Fulham 025","E02000396",6898,6890,8
"2021","Haringey 001","E02000397",7907,7905,2
"2021","Haringey 002","E02000398",7518,7495,23
"2021","Haringey 004","E02000400",7988,7977,11
"2021","Haringey 005","E02000401",6864,6862,2
"2021","Haringey 006","E02000402",6472,6470,2
"2021","Haringey 007","E02000403",7513,7499,14
"2021","Haringey 008","E02000404",7111,7103,8
"2021","Haringey 009","E02000405",6474,6474,0
"2021","Haringey 010","E02000406",6736,6735,1
"2021","Haringey 011","E02000407",7605,7562,43
"2021","Haringey 012","E02000408",8253,8166,87
"2021","Haringey 013","E02000409",6061,6043,18
"2021","Haringey 014","E02000410",6418,6240,178
"2021","Haringey 015","E02000411",11429,10551,878
"2021","Haringey 016","E02000412",7322,7248,74
"2021","Haringey 017","E02000413",7763,7683,80
"2021","Haringey 018","E02000414",7081,7077,4
"2021","Haringey 019","E02000415",7242,7236,6
"2021","Haringey 020","E02000416",8453,8453,0
"2021","Haringey 021","E02000417",6558,6471,87
"2021","Haringey 022","E02000418",5431,5431,0
"2021","Haringey 023","E02000419",8736,8735,1
"2021","Haringey 024","E02000420",7988,7975,13
"2021","Haringey 025","E02000421",8511,8247,264
"2021","Haringey 026","E02000422",7458,7399,59
"2021","Haringey 027","E02000423",6904,6871,33
"2021","Haringey 028","E02000424",6754,6692,62
"2021","Haringey 029","E02000425",8169,8169,0
"2021","Haringey 030","E02000426",6492,6455,37
"2021","Haringey 031","E02000427",6627,6612,15
"2021","Haringey 032","E02000428",8434,8387,47
"2021","Haringey 033","E02000429",6793,6793,0
"2021","Haringey 034","E02000430",6922,6911,11
"2021","Haringey 035","E02000431",5848,5847,1
"2021","Haringey 036","E02000432",6120,6086,34
"2021","Haringey 037","E02006794",8286,8213,73
"2021","Harrow 001","E02000433",8600,8485,115
"2021","Harrow 002","E02000434",9848,9778,70
"2021","Harrow 003","E02000435",8191,8118,73
"2021","Harrow 004","E02000436",5758,5747,11
"2021","Harrow 005","E02000437",8760,8625,135
"2021","Harrow 006","E02000438",8548,8451,97
"2021","Harrow 007","E02000439",9264,9264,0
"2021","Harrow 008","E02000440",9605,9600,5
"2021","Harrow 009","E02000441",7481,7435,46
"2021","Harrow 010","E02000442",9585,9579,6
"2021","Harrow 011","E02000443",10747,10682,65
"2021","Harrow 012","E02000444",8714,8695,19
"2021","Harrow 013","E02000445",11773,11624,149
"2021","Harrow 015","E02000447",8192,8192,0
"2021","Harrow 016","E02000448",7070,7058,12
"2021","Harrow 017","E02000449",8295,8281,14
"2021","Harrow 019","E02000451",6711,6681,30
"2021","Harrow 020","E02000452",9503,9386,117
"2021","Harrow 021","E02000453",8386,8376,10
"2021","Harrow 022","E02000454",7339,7339,0
"2021","Harrow 023","E02000455",11669,11515,154
"2021","Harrow 024","E02000456",7823,7822,1
"2021","Harrow 025","E02000457",7059,7050,9
"2021","Harrow 027","E02000459",9326,9318,8
"2021","Harrow 028","E02000460",7311,7286,25
"2021","Harrow 029","E02000461",7290,6375,915
"2021","Harrow 030","E02000462",6983,6981,2
"2021","Harrow 031","E02000463",8706,8694,12
"2021","Harrow 032","E02006795",8269,8266,3
"2021","Harrow 033","E02006882",14394,14302,92
"2021","Havering 001","E02000464",7756,7664,92
"2021","Havering 002","E02000465",9346,9345,1
"2021","Havering 003","E02000466",9069,8902,167
"2021","Havering 004","E02000467",11457,11446,11
"2021","Havering 005","E02000468",8651,8581,70
"2021","Havering 006","E02000469",7283,7214,69
"2021","Havering 007","E02000470",9782,9721,61
"2021","Havering 008","E02000471",7820,7817,3
"2021","Havering 009","E02000472",9472,9442,30
"2021","Havering 010","E02000473",10493,10449,44
"2021","Havering 011","E02000474",9185,9136,49
"2021","Havering 012","E02000475",9613,9486,127
"2021","Havering 013","E02000476",9363,9270,93
"2021","Havering 014","E02000477",9535,9525,10
"2021","Havering 015","E02000478",5989,5930,59
"2021","Havering 016","E02000479",9450,9379,71
"2021","Havering 017","E02000480",13842,13675,167
"2021","Havering 018","E02000481",8234,8172,62
"2021","Havering 019","E02000482",6588,6568,20
"2021","Havering 020","E02000483",8001,7973,28
"2021","Havering 021","E02000484",8492,8481,11
"2021","Havering 022","E02000485",8476,8476,0
"2021","Havering 023","E02000486",7355,7300,55
"2021","Havering 024","E02000487",7913,7820,93
"2021","Havering 025","E02000488",7579,7545,34
"2021","Havering 026","E02000489",8634,8634,0
"2021","Havering 027","E02000490",8469,8469,0
"2021","Havering 028","E02000491",10640,10596,44
"2021","Havering 029","E02000492",6830,6802,28
"2021","Havering 030","E02000493",6737,6736,1
"2021","Hillingdon 001","E02000494",7958,7833,125
"2021","Hillingdon 002","E02000495",10417,10372,45
"2021","Hillingdon 003","E02000496",7801,7654,147
"2021","Hillingdon 004","E02000497",9521,9443,78
"2021","Hillingdon 005","E02000498",6377,6377,0
"2021","Hillingdon 006","E02000499",7727,7727,0
"2021","Hillingdon 007","E02000500",8279,8237,42
"2021","Hillingdon 008","E02000501",8475,8421,54
"2021","Hillingdon 009","E02000502",8929,8874,55
"2021","Hillingdon 010","E02000503",8688,8688,0
"2021","Hillingdon 011","E02000504",7643,7643,0
"2021","Hillingdon 013","E02000506",7961,7895,66
"2021","Hillingdon 014","E02000507",8243,8194,49
"2021","Hillingdon 015","E02000508",11949,10470,1479
"2021","Hillingdon 016","E02000509",10555,8480,2075
"2021","Hillingdon 017","E02000510",9115,8919,196
"2021","Hillingdon 018","E02000511",9933,9861,72
"2021","Hillingdon 019","E02000512",8823,8800,23
"2021","Hillingdon 020","E02000513",9760,9760,0
"2021","Hillingdon 021","E02000514",10674,10665,9
"2021","Hillingdon 022","E02000515",13293,13291,2
"2021","Hillingdon 023","E02000516",8646,8629,17
"2021","Hillingdon 024","E02000517",10470,10332,138
"2021","Hillingdon 025","E02000518",9632,9626,6
"2021","Hillingdon 026","E02000519",9554,9550,4
"2021","Hillingdon 027","E02000520",14062,13962,100
"2021","Hillingdon 028","E02000521",13190,13093,97
"2021","Hillingdon 029","E02000522",9576,9469,107
"2021","Hillingdon 030","E02000523",11368,11350,18
"2021","Hillingdon 031","E02000524",7535,7335,200
"2021","Hillingdon 032","E02000525",10062,10045,17
"2021","Hillingdon 033","E02006796",9695,9425,270
"2021","Hounslow 001","E02000526",8640,8456,184
"2021","Hounslow 004","E02000529",9716,9714,2
"2021","Hounslow 005","E02000530",8117,8111,6
"2021","Hounslow 006","E02000531",11583,11512,71
"2021","Hounslow 007","E02000532",8976,8975,1
"2021","Hounslow 008","E02000533",8402,8402,0
"2021","Hounslow 009","E02000534",8558,8460,98
"2021","Hounslow 010","E02000535",10052,10042,10
"2021","Hounslow 011","E02000536",10841,10709,132
"2021","Hounslow 012","E02000537",9845,9805,40
"2021","Hounslow 013","E02000538",10109,10101,8
"2021","Hounslow 014","E02000539",12224,12142,82
"2021","Hounslow 015","E02000540",12122,12101,21
"2021","Hounslow 016","E02000541",10620,10581,39
"2021","Hounslow 017","E02000542",12304,12154,150
"2021","Hounslow 018","E02000543",14001,13967,34
"2021","Hounslow 019","E02000544",8557,8557,0
"2021","Hounslow 020","E02000545",9237,9184,53
"2021","Hounslow 021","E02000546",10427,10269,158
"2021","Hounslow 022","E02000547",11001,10998,3
"2021","Hounslow 023","E02000548",10576,10524,52
"2021","Hounslow 024","E02000549",12535,12222,313
"2021","Hounslow 025","E02000550",10713,10710,3
"2021","Hounslow 026","E02000551",9752,9726,26
"2021","Hounslow 027","E02000552",9258,9012,246
"2021","Hounslow 028","E02000553",7115,7107,8
"2021","Hounslow 029","E02006792",8999,8953,46
"2021","Hounslow 030","E02006972",5413,5398,15
"2021","Hounslow 031","E02006973",8494,8492,2
"2021","Islington 001","E02000554",9356,9302,54
"2021","Islington 002","E02000555",9571,9495,76
"2021","Islington 003","E02000556",11396,11047,349
"2021","Islington 004","E02000557",8782,8709,73
"2021","Islington 005","E02000558",9434,9301,133
"2021","Islington 006","E02000559",9582,9576,6
"2021","Islington 007","E02000560",7354,7239,115
"2021","Islington 008","E02000561",7387,7184,203
"2021","Islington 009","E02000562",7865,7732,133
"2021","Islington 010","E02000563",8682,8576,106
"2021","Islington 011","E02000564",12420,11972,448
"2021","Islington 012","E02000565",8542,8340,202
"2021","Islington 013","E02000566",8556,8547,9
"2021","Islington 014","E02000567",10438,10420,18
"2021","Islington 015","E02000568",11342,10427,915
"2021","Islington 016","E02000569",9939,9925,14
"2021","Islington 017","E02000570",8283,8271,12
"2021","Islington 018","E02000571",8922,8886,36
"2021","Islington 019","E02000572",8603,8600,3
"2021","Islington 020","E02000573",10313,10093,220
"2021","Islington 021","E02000574",7833,7097,736
"2021","Islington 022","E02000575",11313,10307,1006
"2021","Islington 023","E02000576",10673,10287,386
"2021","Kensington and Chelsea 001","E02000577",7711,7455,256
"2021","Kensington and Chelsea 002","E02000578",6004,5823,181
"2021","Kensington and Chelsea 003","E02000579",8993,8954,39
"2021","Kensington and Chelsea 004","E02000580",7894,7892,2
"2021","Kensington and Chelsea 005","E02000581",7392,7388,4
"2021","Kensington and Chelsea 006","E02000582",6543,6226,317
"2021","Kensington and Chelsea 007","E02000583",6428,6426,2
"2021","Kensington and Chelsea 008","E02000584",7175,7159,16
"2021","Kensington and Chelsea 009","E02000585",8088,8015,73
"2021","Kensington and Chelsea 010","E02000586",6474,6397,77
"2021","Kensington and Chelsea 011","E02000587",6496,6469,27
"2021","Kensington and Chelsea 012","E02000588",5983,5982,1
"2021","Kensington and Chelsea 013","E02000589",7250,6975,275
"2021","Kensington and Chelsea 014","E02000590",5974,5929,45
"2021","Kensington and Chelsea 015","E02000591",6212,6084,128
"2021","Kensington and Chelsea 016","E02000592",5764,5606,158
"2021","Kensington and Chelsea 017","E02000593",7393,7289,104
"2021","Kensington and Chelsea 018","E02000594",6482,6200,282
"2021","Kensington and Chelsea 019","E02000595",6164,6061,103
"2021","Kensington and Chelsea 020","E02000596",6617,6400,217
"2021","Kensington and Chelsea 021","E02000597",6336,6336,0
"2021","Kingston upon Thames 001","E02000598",8093,8093,0
"2021","Kingston upon Thames 002","E02000599",7008,6692,316
"2021","Kingston upon Thames 003","E02000600",8360,8296,64
"2021","Kingston upon Thames 004","E02000601",11904,11902,2
"2021","Kingston upon Thames 005","E02000602",10313,9660,653
"2021","Kingston upon Thames 006","E02000603",8636,8379,257
"2021","Kingston upon Thames 007","E02000604",9242,9217,25
"2021","Kingston upon Thames 008","E02000605",8489,8310,179
"2021","Kingston upon Thames 009","E02000606",10561,10119,442
"2021","Kingston upon Thames 010","E02000607",6793,6375,418
"2021","Kingston upon Thames 011","E02000608",7199,6693,506
"2021","Kingston upon Thames 012","E02000609",7627,7568,59
"2021","Kingston upon Thames 013","E02000610",7954,7797,157
"2021","Kingston upon Thames 014","E02000611",7440,7440,0
"2021","Kingston upon Thames 015","E02000612",8252,8165,87
"2021","Kingston upon Thames 016","E02000613",8093,7942,151
"2021","Kingston upon Thames 017","E02000614",9294,9292,2
"2021","Kingston upon Thames 018","E02000615",7881,7881,0
"2021","Kingston upon Thames 019","E02000616",6061,6061,0
"2021","Kingston upon Thames 020","E02000617",8863,8807,56
"2021","Lambeth 002","E02000619",9099,9046,53
"2021","Lambeth 003","E02000620",9846,9709,137
"2021","Lambeth 004","E02000621",12520,11961,559
"2021","Lambeth 005","E02000622",8406,8313,93
"2021","Lambeth 006","E02000623",7859,7834,25
"2021","Lambeth 007","E02000624",9631,9577,54
"2021","Lambeth 008","E02000625",9304,9260,44
"2021","Lambeth 009","E02000626",8362,8308,54
"2021","Lambeth 010","E02000627",9553,9314,239
"2021","Lambeth 011","E02000628",10785,10724,61
"2021","Lambeth 012","E02000629",9117,9116,1
"2021","Lambeth 013","E02000630",7538,7475,63
"2021","Lambeth 014","E02000631",9525,9447,78
"2021","Lambeth 015","E02000632",9586,9547,39
"2021","Lambeth 016","E02000633",9160,9134,26
"2021","Lambeth 017","E02000634",6774,6720,54
"2021","Lambeth 018","E02000635",9812,9772,40
"2021","Lambeth 019","E02000636",7714,7679,35
"2021","Lambeth 020","E02000637",8402,8390,12
"2021","Lambeth 021","E02000638",10254,9544,710
"2021","Lambeth 022","E02000639",8321,8318,3
"2021","Lambeth 023","E02000640",9293,9293,0
"2021","Lambeth 024","E02000641",8630,8534,96
"2021","Lambeth 025","E02000642",9809,9796,13
"2021","Lambeth 026","E02000643",9378,9321,57
"2021","Lambeth 027","E02000644",8521,8521,0
"2021","Lambeth 028","E02000645",9533,9522,11
"2021","Lambeth 029","E02000646",9499,9385,114
"2021","Lambeth 030","E02000647",8592,8443,149
"2021","Lambeth 031","E02000648",7825,7761,64
"2021","Lambeth 032","E02000649",12477,12268,209
"2021","Lambeth 033","E02000650",7665,7659,6
"2021","Lambeth 034","E02000651",8738,8629,109
"2021","Lambeth 035","E02000652",7559,7513,46
"2021","Lambeth 036","E02006801",8567,7429,1138
"2021","Lewisham 001","E02000653",12606,12604,2
"2021","Lewisham 002","E02000654",8789,8781,8
"2021","Lewisham 003","E02000655",10281,10009,272
"2021","Lewisham 005","E02000657",9906,9419,487
"2021","Lewisham 006","E02000658",8620,8602,18
"2021","Lewisham 007","E02000659",8063,7999,64
"2021","Lewisham 008","E02000660",8204,8058,146
"2021","Lewisham 009","E02000661",6491,6470,21
"2021","Lewisham 010","E02000662",8295,8295,0
"2021","Lewisham 011","E02000663",6796,6773,23
"2021","Lewisham 013","E02000665",8155,8155,0
"2021","Lewisham 014","E02000666",7189,7118,71
"2021","Lewisham 015","E02000667",6687,6681,6
"2021","Lewisham 016","E02000668",6861,6858,3
"2021","Lewisham 017","E02000669",7972,7848,124
"2021","Lewisham 018","E02000670",6706,6697,9
"2021","Lewisham 019","E02000671",8740,8740,0
"2021","Lewisham 020","E02000672",10272,10120,152
"2021","Lewisham 021","E02000673",8139,8135,4
"2021","Lewisham 022","E02000674",8454,8284,170
"2021","Lewisham 023","E02000675",8527,8455,72
"2021","Lewisham 024","E02000676",7816,7772,44
"2021","Lewisham 025","E02000677",7211,7114,97
"2021","Lewisham 026","E02000678",6961,6960,1
"2021","Lewisham 027","E02000679",8134,8109,25
"2021","Lewisham 028","E02000680",7035,6988,47
"2021","Lewisham 029","E02000681",8473,8463,10
"2021","Lewisham 030","E02000682",8932,8907,25
"2021","Lewisham 031","E02000683",6768,6761,7
"2021","Lewisham 033","E02000685",8131,8063,68
"2021","Lewisham 034","E02000686",7536,7528,8
"2021","Lewisham 035","E02000687",8267,8159,108
"2021","Lewisham 037","E02006783",7771,7765,6
"2021","Lewisham 038","E02006784",7968,7967,1
"2021","Lewisham 039","E02006798",8888,8754,134
"2021","Lewisham 040","E02007008",5766,5495,271
"2021","Lewisham 041","E02007009",9142,8969,173
"2021","Merton 001","E02000689",9054,9052,2
"2021","Merton 002","E02000690",5524,5421,103
"2021","Merton 003","E02000691",7355,7254,101
"2021","Merton 004","E02000692",7655,7598,57
"2021","Merton 005","E02000693",9854,9690,164
"2021","Merton 006","E02000694",9103,9086,17
"2021","Merton 007","E02000695",8641,8626,15
"2021","Merton 008","E02000696",8627,8625,2
"2021","Merton 009","E02000697",8728,8719,9
"2021","Merton 010","E02000698",8235,8168,67
"2021","Merton 011","E02000699",8214,8214,0
"2021","Merton 012","E02000700",8661,8657,4
"2021","Merton 013","E02000701",9009,9009,0
"2021","Merton 014","E02000702",9323,9308,15
"2021","Merton 015","E02000703",7964,7964,0
"2021","Merton 016","E02000704",8599,8513,86
"2021","Merton 017","E02000705",9329,9246,83
"2021","Merton 018","E02000706",10035,10035,0
"2021","Merton 019","E02000707",8306,8289,17
"2021","Merton 020","E02000708",8886,8864,22
"2021","Merton 021","E02000709",7977,7977,0
"2021","Merton 022","E02000710",9186,8982,204
"2021","Merton 023","E02000711",9446,9415,31
"2021","Merton 024","E02000712",9666,9644,22
"2021","Merton 025","E02000713",7805,7751,54
"2021","Newham 001","E02000714",7711,7709,2
"2021","Newham 002","E02000715",7297,7255,42
"2021","Newham 003","E02000716",7350,7291,59
"2021","Newham 004","E02000717",8357,8349,8
"2021","Newham 005","E02000718",7406,7406,0
"2021","Newham 006","E02000719",8076,8034,42
"2021","Newham 007","E02000720",7489,7486,3
"2021","Newham 008","E02000721",9544,9510,34
"2021","Newham 009","E02000722",8140,8037,103
"2021","Newham 010","E02000723",11195,11183,12
"2021","Newham 011","E02000724",10027,10010,17
"2021","Newham 012","E02000725",9987,9937,50
"2021","Newham 014","E02000727",8518,8512,6
"2021","Newham 015","E02000728",8527,8526,1
"2021","Newham 016","E02000729",7327,7327,0
"2021","Newham 017","E02000730",9930,9908,22
"2021","Newham 018","E02000731",9962,9962,0
"2021","Newham 019","E02000732",8900,8899,1
"2021","Newham 020","E02000733",10095,10056,39
"2021","Newham 021","E02000734",7302,7299,3
"2021","Newham 022","E02000735",8610,8608,2
"2021","Newham 023","E02000736",9204,9154,50
"2021","Newham 024","E02000737",10379,10379,0
"2021","Newham 025","E02000738",9577,9577,0
"2021","Newham 026","E02000739",7724,7724,0
"2021","Newham 027","E02000740",6767,6754,13
"2021","Newham 028","E02000741",8246,8239,7
"2021","Newham 029","E02000742",8705,8641,64
"2021","Newham 030","E02000743",10282,10171,111
"2021","Newham 031","E02000744",9173,9171,2
"2021","Newham 032","E02000745",8598,8598,0
"2021","Newham 033","E02000746",9426,8968,458
"2021","Newham 034","E02000747",13097,13072,25
"2021","Newham 035","E02000748",6275,6105,170
"2021","Newham 036","E02000749",9552,9475,77
"2021","Newham 038","E02006995",8638,8182,456
"2021","Newham 039","E02006996",8426,7703,723
"2021","Newham 040","E02006997",6888,6887,1
"2021","Newham 041","E02006998",7086,7062,24
"2021","Newham 042","E02006999",11244,11244,0
"2021","Redbridge 001","E02000751",11159,11065,94
"2021","Redbridge 002","E02000752",8782,8780,2
"2021","Redbridge 003","E02000753",6920,6865,55
"2021","Redbridge 004","E02000754",6768,6766,2
"2021","Redbridge 005","E02000755",5483,5473,10
"2021","Redbridge 006","E02000756",14594,14585,9
"2021","Redbridge 007","E02000757",12393,12341,52
"2021","Redbridge 008","E02000758",6885,6885,0
"2021","Redbridge 009","E02000759",13088,13028,60
"2021","Redbridge 010","E02000760",7534,7490,44
"2021","Redbridge 012","E02000762",6621,6617,4
"2021","Redbridge 013","E02000763",8015,8015,0
"2021","Redbridge 014","E02000764",12306,12165,141
"2021","Redbridge 015","E02000765",7526,7526,0
"2021","Redbridge 017","E02000767",8625,8488,137
"2021","Redbridge 018","E02000768",5788,5788,0
"2021","Redbridge 020","E02000770",8123,8092,31
"2021","Redbridge 022","E02000772",8383,8247,136
"2021","Redbridge 023","E02000773",10733,10623,110
"2021","Redbridge 024","E02000774",8108,8078,30
"2021","Redbridge 026","E02000776",7039,6991,48
"2021","Redbridge 027","E02000777",6003,5991,12
"2021","Redbridge 029","E02000779",8416,8288,128
"2021","Redbridge 031","E02000781",16292,16246,46
"2021","Redbridge 032","E02000782",11487,11371,116
"2021","Redbridge 033","E02000783",7395,7395,0
"2021","Redbridge 034","E02006800",14681,14588,93
"2021","Redbridge 035","E02006924",13602,13461,141
"2021","Redbridge 036","E02006925",14420,14401,19
"2021","Redbridge 037","E02007017",8814,8738,76
"2021","Redbridge 038","E02007018",7270,7222,48
"2021","Redbridge 039","E02007019",7162,7078,84
"2021","Redbridge 040","E02007020",9840,9805,35
"2021","Richmond upon Thames 001","E02000784",10130,10010,120
"2021","Richmond upon Thames 002","E02000785",9714,9619,95
"2021","Richmond upon Thames 003","E02000786",11372,11355,17
"2021","Richmond upon Thames 004","E02000787",12086,12083,3
"2021","Richmond upon Thames 005","E02000788",9095,9083,12
"2021","Richmond upon Thames 006","E02000789",6301,6232,69
"2021","Richmond upon Thames 007","E02000790",6585,6585,0
"2021","Richmond upon Thames 008","E02000791",6472,6404,68
"2021","Richmond upon Thames 009","E02000792",7147,7020,127
"2021","Richmond upon Thames 010","E02000793",8107,8030,77
"2021","Richmond upon Thames 011","E02000794",7015,6998,17
"2021","Richmond upon Thames 012","E02000795",6926,6875,51
"2021","Richmond upon Thames 013","E02000796",11087,11053,34
"2021","Richmond upon Thames 014","E02000797",7868,7810,58
"2021","Richmond upon Thames 015","E02000798",11308,11270,38
"2021","Richmond upon Thames 016","E02000799",6603,5890,713
"2021","Richmond upon Thames 017","E02000800",5410,5409,1
"2021","Richmond upon Thames 018","E02000801",7110,7103,7
"2021","Richmond upon Thames 019","E02000802",7022,6924,98
"2021","Richmond upon Thames 020","E02000803",9716,9704,12
"2021","Richmond upon Thames 021","E02000804",7149,7088,61
"2021","Richmond upon Thames 022","E02000805",10755,10659,96
"2021","Richmond upon Thames 023","E02000806",10299,10213,86
"2021","Southwark 001","E02000807",8227,8227,0
"2021","Southwark 002","E02000808",10168,8910,1258
"2021","Southwark 004","E02000810",11896,11886,10
"2021","Southwark 006","E02000812",10788,10295,493
"2021","Southwark 007","E02000813",10223,10135,88
"2021","Southwark 008","E02000814",10291,10228,63
"2021","Southwark 009","E02000815",7613,7016,597
"2021","Southwark 010","E02000816",9610,9608,2
"2021","Southwark 011","E02000817",6823,6733,90
"2021","Southwark 012","E02000818",9791,9783,8
"2021","Southwark 013","E02000819",8499,8490,9
"2021","Southwark 014","E02000820",9245,8933,312
"2021","Southwark 015","E02000821",9358,9358,0
"2021","Southwark 016","E02000822",6719,6702,17
"2021","Southwark 017","E02000823",8685,8665,20
"2021","Southwark 018","E02000824",9903,9903,0
"2021","Southwark 019","E02000825",10225,9992,233
"2021","Southwark 020","E02000826",9882,9637,245
"2021","Southwark 021","E02000827",11311,11257,54
"2021","Southwark 022","E02000828",8813,8811,2
"2021","Southwark 023","E02000829",10925,10798,127
"2021","Southwark 024","E02000830",8884,8751,133
"2021","Southwark 025","E02000831",9353,9335,18
"2021","Southwark 026","E02000832",9688,9647,41
"2021","Southwark 027","E02000833",7487,7484,3
"2021","Southwark 028","E02000834",9388,9385,3
"2021","Southwark 029","E02000835",7680,7673,7
"2021","Southwark 030","E02000836",8296,8272,24
"2021","Southwark 031","E02000837",8559,8527,32
"2021","Southwark 032","E02000838",9497,9407,90
"2021","Southwark 033","E02000839",8480,8310,170
"2021","Southwark 034","E02006802",9276,8412,864
"2021","Southwark 035","E02006941",5312,5187,125
"2021","Southwark 036","E02006942",6746,6744,2
"2021","Sutton 001","E02000840",9321,9313,8
"2021","Sutton 002","E02000841",9188,9146,42
"2021","Sutton 003","E02000842",8279,8224,55
"2021","Sutton 004","E02000843",9473,9473,0
"2021","Sutton 005","E02000844",8657,8655,2
"2021","Sutton 006","E02000845",9420,9413,7
"2021","Sutton 007","E02000846",7615,7531,84
"2021","Sutton 008","E02000847",9421,9393,28
"2021","Sutton 009","E02000848",8139,8139,0
"2021","Sutton 010","E02000849",8177,8138,39
"2021","Sutton 011","E02000850",10836,10830,6
"2021","Sutton 012","E02000851",11581,11576,5
"2021","Sutton 013","E02000852",8146,8109,37
"2021","Sutton 014","E02000853",8171,8163,8
"2021","Sutton 015","E02000854",7611,7589,22
"2021","Sutton 016","E02000855",8204,8198,6
"2021","Sutton 017","E02000856",9330,9310,20
"2021","Sutton 018","E02000857",8995,8749,246
"2021","Sutton 019","E02000858",8568,8563,5
"2021","Sutton 020","E02000859",8488,8345,143
"2021","Sutton 021","E02000860",8786,8655,131
"2021","Sutton 022","E02000861",7776,7667,109
"2021","Sutton 024","E02000863",6738,6715,23
"2021","Sutton 025","E02006836",8722,8531,191
"2021","Tower Hamlets 001","E02000864",11263,11262,1
"2021","Tower Hamlets 002","E02000865",7961,7601,360
"2021","Tower Hamlets 003","E02000866",10646,10637,9
"2021","Tower Hamlets 004","E02000867",11328,11325,3
"2021","Tower Hamlets 005","E02000868",7196,6955,241
"2021","Tower Hamlets 006","E02000869",5931,5906,25
"2021","Tower Hamlets 007","E02000870",6371,6338,33
"2021","Tower Hamlets 008","E02000871",11514,11514,0
"2021","Tower Hamlets 009","E02000872",8145,7989,156
"2021","Tower Hamlets 010","E02000873",9850,8156,1694
"2021","Tower Hamlets 011","E02000874",7496,7083,413
"2021","Tower Hamlets 012","E02000875",13571,13550,21
"2021","Tower Hamlets 013","E02000876",7274,6869,405
"2021","Tower Hamlets 014","E02000877",13809,13773,36
"2021","Tower Hamlets 015","E02000878",10433,9506,927
"2021","Tower Hamlets 016","E02000879",8343,8305,38
"2021","Tower Hamlets 017","E02000880",6514,6228,286
"2021","Tower Hamlets 018","E02000881",10831,10823,8
"2021","Tower Hamlets 019","E02000882",11501,11349,152
"2021","Tower Hamlets 020","E02000883",9287,9180,107
"2021","Tower Hamlets 021","E02000884",12769,12123,646
"2021","Tower Hamlets 022","E02000885",7054,6651,403
"2021","Tower Hamlets 023","E02000886",9590,9541,49
"2021","Tower Hamlets 024","E02000887",10801,10706,95
"2021","Tower Hamlets 025","E02000888",8620,8529,91
"2021","Tower Hamlets 026","E02000889",8965,8552,413
"2021","Tower Hamlets 027","E02000890",5815,5815,0
"2021","Tower Hamlets 030","E02000893",7412,7409,3
"2021","Tower Hamlets 031","E02000894",11007,11006,1
"2021","Tower Hamlets 032","E02006853",11015,11014,1
"2021","Tower Hamlets 033","E02006854",7076,7065,11
"2021","Tower Hamlets 034","E02007112",5893,5893,0
"2021","Tower Hamlets 035","E02007113",7461,7461,0
"2021","Tower Hamlets 036","E02007114",7565,7565,0
"2021","Waltham Forest 001","E02000895",8369,8341,28
"2021","Waltham Forest 002","E02000896",9328,9241,87
"2021","Waltham Forest 003","E02000897",8567,8489,78
"2021","Waltham Forest 004","E02000898",8011,7982,29
"2021","Waltham Forest 005","E02000899",8811,8778,33
"2021","Waltham Forest 006","E02000900",8973,8946,27
"2021","Waltham Forest 007","E02000901",10493,10438,55
"2021","Waltham Forest 008","E02000902",9960,9958,2
"2021","Waltham Forest 009","E02000903",10275,10274,1
"2021","Waltham Forest 010","E02000904",8424,8414,10
"2021","Waltham Forest 011","E02000905",10473,10469,4
"2021","Waltham Forest 012","E02000906",9653,9653,0
"2021","Waltham Forest 013","E02000907",10580,10403,177
"2021","Waltham Forest 014","E02000908",12903,12563,340
"2021","Waltham Forest 015","E02000909",9247,9206,41
"2021","Waltham Forest 016","E02000910",11429,11368,61
"2021","Waltham Forest 017","E02000911",12963,12915,48
"2021","Waltham Forest 018","E02000912",9742,9678,64
"2021","Waltham Forest 019","E02000913",9642,9624,18
"2021","Waltham Forest 020","E02000914",11798,11511,287
"2021","Waltham Forest 021","E02000915",8112,8011,101
"2021","Waltham Forest 022","E02000916",10563,10560,3
"2021","Waltham Forest 023","E02000917",9588,9547,41
"2021","Waltham Forest 024","E02000918",9323,9238,85
"2021","Waltham Forest 025","E02000919",9239,9224,15
"2021","Waltham Forest 026","E02000920",10299,10273,26
"2021","Waltham Forest 027","E02000921",11200,11163,37
"2021","Waltham Forest 028","E02000922",10461,10421,40
"2021","Wandsworth 001","E02000923",7526,7387,139
"2021","Wandsworth 003","E02000925",7900,7865,35
"2021","Wandsworth 004","E02000926",11640,11574,66
"2021","Wandsworth 005","E02000927",7100,7098,2
"2021","Wandsworth 006","E02000928",8356,8343,13
"2021","Wandsworth 007","E02000929",8104,8101,3
"2021","Wandsworth 008","E02000930",10081,9727,354
"2021","Wandsworth 009","E02000931",8815,8815,0
"2021","Wandsworth 010","E02000932",12843,12842,1
"2021","Wandsworth 011","E02000933",8867,8864,3
"2021","Wandsworth 012","E02000934",8916,8879,37
"2021","Wandsworth 013","E02000935",7375,6240,1135
"2021","Wandsworth 014","E02000936",9366,9325,41
"2021","Wandsworth 015","E02000937",8161,8160,1
"2021","Wandsworth 016","E02000938",10767,10644,123
"2021","Wandsworth 017","E02000939",7819,7675,144
"2021","Wandsworth 018","E02000940",9324,9323,1
"2021","Wandsworth 019","E02000941",10174,10159,15
"2021","Wandsworth 020","E02000942",9686,9677,9
"2021","Wandsworth 021","E02000943",8721,8721,0
"2021","Wandsworth 022","E02000944",7638,7349,289
"2021","Wandsworth 023","E02000945",7842,7542,300
"2021","Wandsworth 024","E02000946",8435,7659,776
"2021","Wandsworth 025","E02000947",9341,9339,2
"2021","Wandsworth 026","E02000948",10027,9938,89
"2021","Wandsworth 027","E02000949",10003,9870,133
"2021","Wandsworth 028","E02000950",7585,7553,32
"2021","Wandsworth 029","E02000951",6431,6364,67
"2021","Wandsworth 030","E02000952",6145,6141,4
"2021","Wandsworth 031","E02000953",7505,7144,361
"2021","Wandsworth 032","E02000954",6100,6100,0
"2021","Wandsworth 033","E02000955",6889,6889,0
"2021","Wandsworth 034","E02000956",7420,7412,8
"2021","Wandsworth 035","E02000957",10861,10829,32
"2021","Wandsworth 036","E02000958",8276,8021,255
"2021","Wandsworth 037","E02000959",7866,7838,28
"2021","Wandsworth 038","E02007083",7711,7711,0
"2021","Wandsworth 039","E02007084",9890,9881,9
"2021","Westminster 001","E02000960",6155,6149,6
"2021","Westminster 002","E02000961",9814,9814,0
"2021","Westminster 003","E02000962",7703,7703,0
"2021","Westminster 004","E02000963",10522,10517,5
"2021","Westminster 005","E02000964",12142,12140,2
"2021","Westminster 006","E02000965",7876,7854,22
"2021","Westminster 007","E02000966",9252,9245,7
"2021","Westminster 008","E02000967",6056,5942,114
"2021","Westminster 009","E02000968",14478,14400,78
"2021","Westminster 010","E02000969",9607,9347,260
"2021","Westminster 011","E02000970",6837,6828,9
"2021","Westminster 012","E02000971",7473,7271,202
"2021","Westminster 013","E02000972",7879,7588,291
"2021","Westminster 014","E02000973",9955,9892,63
"2021","Westminster 015","E02000974",8705,8355,350
"2021","Westminster 016","E02000975",7417,7162,255
"2021","Westminster 017","E02000976",8432,8182,250
"2021","Westminster 018","E02000977",6388,5758,630
"2021","Westminster 019","E02000978",7129,6167,962
"2021","Westminster 020","E02000979",8085,7485,600
"2021","Westminster 021","E02000980",8724,8694,30
"2021","Westminster 022","E02000981",8271,8162,109
"2021","Westminster 023","E02000982",7638,7626,12
"2021","Westminster 024","E02000983",7695,7663,32
"2021","Medway 001","E02003314",6774,6727,47
"2021","Medway 002","E02003315",5724,5724,0
"2021","Medway 003","E02003316",12142,12142,0
"2021","Medway 004","E02003317",7079,7004,75
"2021","Medway 005","E02003318",5968,5957,11
"2021","Medway 006","E02003319",8241,8085,156
"2021","Medway 007","E02003320",9402,8822,580
"2021","Medway 008","E02003321",6492,6489,3
"2021","Medway 009","E02003322",8036,7330,706
"2021","Medway 010","E02003323",7385,7347,38
"2021","Medway 011","E02003324",10077,10068,9
"2021","Medway 012","E02003325",7360,7280,80
"2021","Medway 013","E02003326",7766,7699,67
"2021","Medway 014","E02003327",7458,7371,87
"2021","Medway 015","E02003328",9919,9610,309
"2021","Medway 016","E02003329",6878,6838,40
"2021","Medway 017","E02003330",6782,6752,30
"2021","Medway 018","E02003331",8857,8857,0
"2021","Medway 019","E02003332",6284,6093,191
"2021","Medway 020","E02003333",6804,6758,46
"2021","Medway 021","E02003334",6217,6167,50
"2021","Medway 022","E02003335",7427,7416,11
"2021","Medway 023","E02003336",6354,6354,0
"2021","Medway 024","E02003337",7419,6654,765
"2021","Medway 025","E02003338",7300,7296,4
"2021","Medway 026","E02003339",6441,6316,125
"2021","Medway 027","E02003340",8090,8025,65
"2021","Medway 028","E02003341",6602,6602,0
"2021","Medway 029","E02003342",6422,6363,59
"2021","Medway 030","E02003343",5972,5964,8
"2021","Medway 031","E02003344",6802,6801,1
"2021","Medway 032","E02003345",6254,6253,1
"2021","Medway 033","E02003346",7086,7041,45
"2021","Medway 034","E02003347",6097,6097,0
"2021","Medway 035","E02003348",8093,8011,82
"2021","Medway 036","E02003349",7390,7347,43
"2021","Medway 037","E02003350",6459,6447,12
"2021","Medway 038","E02003351",7916,7914,2
"2021","Bracknell Forest 001","E02003352",5774,5755,19
"2021","Bracknell Forest 002","E02003353",12093,11936,157
"2021","Bracknell Forest 003","E02003354",10265,10238,27
"2021","Bracknell Forest 004","E02003355",6957,6957,0
"2021","Bracknell Forest 005","E02003356",7161,6914,247
"2021","Bracknell Forest 006","E02003357",10193,10182,11
"2021","Bracknell Forest 007","E02003358",11871,11795,76
"2021","Bracknell Forest 008","E02003359",6323,6323,0
"2021","Bracknell Forest 009","E02003360",11623,11622,1
"2021","Bracknell Forest 010","E02003361",7439,7438,1
"2021","Bracknell Forest 011","E02003362",6722,6690,32
"2021","Bracknell Forest 012","E02003363",7099,6087,1012
"2021","Bracknell Forest 013","E02003364",7015,6847,168
"2021","Bracknell Forest 014","E02003365",6939,6882,57
"2021","Bracknell Forest 015","E02003366",7132,6439,693
"2021","West Berkshire 001","E02003367",6532,6277,255
"2021","West Berkshire 002","E02003368",5695,5694,1
"2021","West Berkshire 003","E02003369",6399,6173,226
"2021","West Berkshire 004","E02003370",6730,6662,68
"2021","West Berkshire 005","E02003371",5945,5926,19
"2021","West Berkshire 006","E02003372",7848,7846,2
"2021","West Berkshire 007","E02003373",8653,7975,678
"2021","West Berkshire 008","E02003374",5863,5852,11
"2021","West Berkshire 009","E02003375",6193,6173,20
"2021","West Berkshire 010","E02003376",5866,5794,72
"2021","West Berkshire 011","E02003377",10412,9523,889
"2021","West Berkshire 012","E02003378",8009,7928,81
"2021","West Berkshire 013","E02003379",6978,6859,119
"2021","West Berkshire 014","E02003380",8145,8144,1
"2021","West Berkshire 015","E02003381",6114,6056,58
"2021","West Berkshire 016","E02003382",7542,7487,55
"2021","West Berkshire 017","E02003383",6919,6916,3
"2021","West Berkshire 018","E02003384",6479,6404,75
"2021","West Berkshire 019","E02003385",11181,11132,49
"2021","West Berkshire 020","E02003386",8307,8283,24
"2021","West Berkshire 021","E02003387",9589,9493,96
"2021","West Berkshire 022","E02003388",6040,5987,53
"2021","Reading 001","E02003389",7997,7983,14
"2021","Reading 002","E02003390",7752,7736,16
"2021","Reading 003","E02003391",8588,8383,205
"2021","Reading 004","E02003392",8701,8684,17
"2021","Reading 005","E02003393",8161,8120,41
"2021","Reading 006","E02003394",8657,8578,79
"2021","Reading 007","E02003395",11274,11251,23
"2021","Reading 008","E02003396",9836,9806,30
"2021","Reading 009","E02003397",8224,8211,13
"2021","Reading 010","E02003398",11531,11455,76
"2021","Reading 012","E02003400",8973,8666,307
"2021","Reading 013","E02003401",9172,8893,279
"2021","Reading 014","E02003402",10708,10071,637
"2021","Reading 015","E02003403",9382,9368,14
"2021","Reading 016","E02003404",8641,6299,2342
"2021","Reading 017","E02003405",13071,13060,11
"2021","Reading 018","E02003406",8245,8244,1
"2021","Reading 019","E02006939",7076,6925,151
"2021","Reading 020","E02006940",8240,7430,810
"2021","Slough 001","E02003407",10910,10903,7
"2021","Slough 002","E02003408",11292,11292,0
"2021","Slough 003","E02003409",10444,10406,38
"2021","Slough 004","E02003410",12243,12232,11
"2021","Slough 005","E02003411",12503,12431,72
"2021","Slough 006","E02003412",10406,10390,16
"2021","Slough 008","E02003414",13753,13753,0
"2021","Slough 009","E02003415",13508,13280,228
"2021","Slough 010","E02003416",9809,9809,0
"2021","Slough 011","E02003417",12806,12753,53
"2021","Slough 012","E02003418",10321,10286,35
"2021","Slough 013","E02003419",8983,8980,3
"2021","Slough 014","E02003420",6418,6418,0
"2021","Slough 015","E02007068",7017,6982,35
"2021","Slough 016","E02007069",8081,8009,72
"2021","Windsor and Maidenhead 001","E02003421",5673,5669,4
"2021","Windsor and Maidenhead 002","E02003422",11849,11707,142
"2021","Windsor and Maidenhead 003","E02003423",6586,6568,18
"2021","Windsor and Maidenhead 004","E02003424",9312,9158,154
"2021","Windsor and Maidenhead 005","E02003425",13066,13057,9
"2021","Windsor and Maidenhead 006","E02003426",9803,9685,118
"2021","Windsor and Maidenhead 007","E02003427",8184,8184,0
"2021","Windsor and Maidenhead 008","E02003428",9163,9161,2
"2021","Windsor and Maidenhead 009","E02003429",7742,7483,259
"2021","Windsor and Maidenhead 010","E02003430",7522,5512,2010
"2021","Windsor and Maidenhead 011","E02003431",7006,6965,41
"2021","Windsor and Maidenhead 012","E02003432",7095,6915,180
"2021","Windsor and Maidenhead 013","E02003433",6471,6471,0
"2021","Windsor and Maidenhead 014","E02003434",9191,9042,149
"2021","Windsor and Maidenhead 015","E02003435",7142,7139,3
"2021","Windsor and Maidenhead 016","E02003436",9037,8949,88
"2021","Windsor and Maidenhead 017","E02003437",7422,7144,278
"2021","Windsor and Maidenhead 018","E02003438",11232,10608,624
"2021","Wokingham 001","E02003439",5527,5463,64
"2021","Wokingham 002","E02003440",9273,9238,35
"2021","Wokingham 003","E02003441",7670,7604,66
"2021","Wokingham 004","E02003442",8489,8489,0
"2021","Wokingham 005","E02003443",6987,6987,0
"2021","Wokingham 006","E02003444",9376,9376,0
"2021","Wokingham 007","E02003445",8774,8765,9
"2021","Wokingham 008","E02003446",9805,8267,1538
"2021","Wokingham 009","E02003447",10716,10588,128
"2021","Wokingham 010","E02003448",8120,8070,50
"2021","Wokingham 011","E02003449",7488,7488,0
"2021","Wokingham 012","E02003450",13192,13075,117
"2021","Wokingham 013","E02003451",9718,9606,112
"2021","Wokingham 014","E02003452",9494,9472,22
"2021","Wokingham 015","E02003453",6980,6980,0
"2021","Wokingham 016","E02003454",8753,8568,185
"2021","Wokingham 017","E02003455",10645,10588,57
"2021","Wokingham 018","E02003456",8270,8157,113
"2021","Wokingham 019","E02003457",9802,9769,33
"2021","Wokingham 020","E02003458",8423,8127,296
"2021","Milton Keynes 001","E02003459",9007,8954,53
"2021","Milton Keynes 002","E02003460",11676,11615,61
"2021","Milton Keynes 003","E02003461",7478,7357,121
"2021","Milton Keynes 004","E02003462",8108,8071,37
"2021","Milton Keynes 005","E02003463",6813,6748,65
"2021","Milton Keynes 006","E02003464",7066,7063,3
"2021","Milton Keynes 007","E02003465",6071,6063,8
"2021","Milton Keynes 008","E02003466",7787,7785,2
"2021","Milton Keynes 009","E02003467",6588,6445,143
"2021","Milton Keynes 010","E02003468",8621,8605,16
"2021","Milton Keynes 011","E02003469",5729,5729,0
"2021","Milton Keynes 012","E02003470",6194,6194,0
"2021","Milton Keynes 013","E02003471",6628,6628,0
"2021","Milton Keynes 014","E02003472",10202,10119,83
"2021","Milton Keynes 015","E02003473",5608,5608,0
"2021","Milton Keynes 016","E02003474",9015,9005,10
"2021","Milton Keynes 018","E02003476",8782,8547,235
"2021","Milton Keynes 020","E02003478",6838,6751,87
"2021","Milton Keynes 021","E02003479",7682,7665,17
"2021","Milton Keynes 022","E02003480",8152,8130,22
"2021","Milton Keynes 023","E02003481",8373,8364,9
"2021","Milton Keynes 024","E02003482",8744,8662,82
"2021","Milton Keynes 025","E02003483",11215,11205,10
"2021","Milton Keynes 026","E02003484",7153,7121,32
"2021","Milton Keynes 027","E02003485",8263,8234,29
"2021","Milton Keynes 028","E02003486",10188,10174,14
"2021","Milton Keynes 029","E02003487",7388,7386,2
"2021","Milton Keynes 030","E02003488",8468,8452,16
"2021","Milton Keynes 031","E02003489",7638,7548,90
"2021","Milton Keynes 032","E02003490",11202,11135,67
"2021","Milton Keynes 033","E02007012",8278,8272,6
"2021","Milton Keynes 034","E02007013",10111,10111,0
"2021","Milton Keynes 035","E02007014",7123,6958,165
"2021","Milton Keynes 036","E02007015",9658,9588,70
"2021","Milton Keynes 037","E02007016",9212,8702,510
"2021","Brighton and Hove 001","E02003491",7790,7740,50
"2021","Brighton and Hove 002","E02003492",10115,5812,4303
"2021","Brighton and Hove 003","E02003493",8062,7962,100
"2021","Brighton and Hove 004","E02003494",6640,6640,0
"2021","Brighton and Hove 005","E02003495",7155,7155,0
"2021","Brighton and Hove 006","E02003496",7751,7751,0
"2021","Brighton and Hove 007","E02003497",7584,7501,83
"2021","Brighton and Hove 008","E02003498",8547,8204,343
"2021","Brighton and Hove 009","E02003499",7849,7752,97
"2021","Brighton and Hove 010","E02003500",8071,8034,37
"2021","Brighton and Hove 011","E02003501",8385,8316,69
"2021","Brighton and Hove 012","E02003502",7780,7726,54
"2021","Brighton and Hove 013","E02003503",9080,9025,55
"2021","Brighton and Hove 014","E02003504",8556,8440,116
"2021","Brighton and Hove 015","E02003505",8967,8902,65
"2021","Brighton and Hove 016","E02003506",7163,7108,55
"2021","Brighton and Hove 017","E02003507",9773,9677,96
"2021","Brighton and Hove 018","E02003508",8705,8644,61
"2021","Brighton and Hove 019","E02003509",8890,8783,107
"2021","Brighton and Hove 020","E02003510",8651,8477,174
"2021","Brighton and Hove 021","E02003511",8646,8604,42
"2021","Brighton and Hove 022","E02003512",8956,8660,296
"2021","Brighton and Hove 023","E02003513",6488,6284,204
"2021","Brighton and Hove 024","E02003514",8466,8404,62
"2021","Brighton and Hove 025","E02003515",9089,9035,54
"2021","Brighton and Hove 026","E02003516",8181,8151,30
"2021","Brighton and Hove 027","E02003517",10738,10391,347
"2021","Brighton and Hove 028","E02003518",7576,7302,274
"2021","Brighton and Hove 029","E02003519",8238,8151,87
"2021","Brighton and Hove 030","E02003520",9172,8796,376
"2021","Brighton and Hove 031","E02003521",8078,7610,468
"2021","Brighton and Hove 032","E02003522",7806,7510,296
"2021","Brighton and Hove 033","E02003523",10159,10051,108
"2021","Portsmouth 001","E02003524",8115,8115,0
"2021","Portsmouth 002","E02003525",6440,6433,7
"2021","Portsmouth 003","E02003526",6831,6719,112
"2021","Portsmouth 004","E02003527",6380,6380,0
"2021","Portsmouth 006","E02003529",8328,8296,32
"2021","Portsmouth 007","E02003530",7865,7851,14
"2021","Portsmouth 008","E02003531",7722,7722,0
"2021","Portsmouth 009","E02003532",7873,7842,31
"2021","Portsmouth 010","E02003533",5785,5777,8
"2021","Portsmouth 011","E02003534",8894,8891,3
"2021","Portsmouth 012","E02003535",9664,9624,40
"2021","Portsmouth 013","E02003536",8012,7900,112
"2021","Portsmouth 014","E02003537",10262,10220,42
"2021","Portsmouth 015","E02003538",10355,10283,72
"2021","Portsmouth 017","E02003540",9434,9328,106
"2021","Portsmouth 018","E02003541",10937,10497,440
"2021","Portsmouth 019","E02003542",8831,8829,2
"2021","Portsmouth 020","E02003543",8785,8752,33
"2021","Portsmouth 021","E02003544",6319,6318,1
"2021","Portsmouth 022","E02003545",6748,6524,224
"2021","Portsmouth 023","E02003546",7927,7891,36
"2021","Portsmouth 024","E02003547",8087,7783,304
"2021","Portsmouth 025","E02003548",6165,6007,158
"2021","Portsmouth 026","E02006821",6660,6626,34
"2021","Portsmouth 027","E02006975",10275,5446,4829
"2021","Portsmouth 028","E02006976",5312,5311,1
"2021","Southampton 001","E02003549",8494,6697,1797
"2021","Southampton 002","E02003550",7887,7872,15
"2021","Southampton 003","E02003551",6488,5011,1477
"2021","Southampton 004","E02003552",6135,6132,3
"2021","Southampton 005","E02003553",7275,6956,319
"2021","Southampton 006","E02003554",6070,5922,148
"2021","Southampton 007","E02003555",8703,8703,0
"2021","Southampton 008","E02003556",5751,5751,0
"2021","Southampton 009","E02003557",6799,6774,25
"2021","Southampton 010","E02003558",7249,7219,30
"2021","Southampton 011","E02003559",7837,7806,31
"2021","Southampton 012","E02003560",7468,7468,0
"2021","Southampton 013","E02003561",7923,7380,543
"2021","Southampton 014","E02003562",8318,8285,33
"2021","Southampton 015","E02003563",8018,7987,31
"2021","Southampton 016","E02003564",8086,8052,34
"2021","Southampton 017","E02003565",6759,6597,162
"2021","Southampton 018","E02003566",6402,6402,0
"2021","Southampton 019","E02003567",8063,8021,42
"2021","Southampton 020","E02003568",8266,7980,286
"2021","Southampton 021","E02003569",7816,7796,20
"2021","Southampton 022","E02003570",11609,10736,873
"2021","Southampton 023","E02003571",8966,7153,1813
"2021","Southampton 024","E02003572",6179,6093,86
"2021","Southampton 025","E02003573",7876,7851,25
"2021","Southampton 026","E02003574",7660,7660,0
"2021","Southampton 027","E02003575",6534,6528,6
"2021","Southampton 028","E02003576",8126,8104,22
"2021","Southampton 030","E02003578",6337,6310,27
"2021","Southampton 031","E02003579",9585,9382,203
"2021","Southampton 032","E02003580",6201,6181,20
"2021","Southampton 033","E02007074",8742,6659,2083
"2021","Southampton 034","E02007075",5301,5297,4
"2021","Isle of Wight 001","E02003581",7800,7712,88
"2021","Isle of Wight 002","E02003582",8583,8562,21
"2021","Isle of Wight 003","E02003583",7707,7629,78
"2021","Isle of Wight 004","E02003584",6127,5850,277
"2021","Isle of Wight 005","E02003585",6598,6529,69
"2021","Isle of Wight 006","E02003586",7693,7513,180
"2021","Isle of Wight 007","E02003587",8573,8480,93
"2021","Isle of Wight 008","E02003588",9266,8313,953
"2021","Isle of Wight 009","E02003589",7411,7391,20
"2021","Isle of Wight 010","E02003590",7326,7268,58
"2021","Isle of Wight 011","E02003591",9416,9303,113
"2021","Isle of Wight 012","E02003592",9693,9445,248
"2021","Isle of Wight 013","E02003593",5258,5237,21
"2021","Isle of Wight 014","E02003594",9301,9061,240
"2021","Isle of Wight 015","E02003595",8022,8001,21
"2021","Isle of Wight 016","E02003596",8712,8354,358
"2021","Isle of Wight 017","E02003597",5700,5689,11
"2021","Isle of Wight 018","E02003598",7275,7179,96
"2021","Buckinghamshire 001","E02003652",10556,9771,785
"2021","Buckinghamshire 002","E02003653",6752,6605,147
"2021","Buckinghamshire 003","E02003654",5789,5780,9
"2021","Buckinghamshire 004","E02003655",10362,10328,34
"2021","Buckinghamshire 005","E02003656",6640,6589,51
"2021","Buckinghamshire 006","E02003657",7468,7392,76
"2021","Buckinghamshire 007","E02003658",10012,9930,82
"2021","Buckinghamshire 009","E02003659",9788,9741,47
"2021","Buckinghamshire 008","E02003660",10802,10797,5
"2021","Buckinghamshire 010","E02003661",5891,5479,412
"2021","Buckinghamshire 012","E02003662",6213,6174,39
"2021","Buckinghamshire 011","E02003663",14108,14042,66
"2021","Buckinghamshire 013","E02003664",8121,7998,123
"2021","Buckinghamshire 014","E02003665",6183,5918,265
"2021","Buckinghamshire 015","E02003666",7598,7573,25
"2021","Buckinghamshire 016","E02003667",9391,9372,19
"2021","Buckinghamshire 018","E02003668",8768,8728,40
"2021","Buckinghamshire 017","E02003669",7416,7406,10
"2021","Buckinghamshire 019","E02003670",9161,9078,83
"2021","Buckinghamshire 020","E02003671",5965,5965,0
"2021","Buckinghamshire 021","E02003672",12461,12289,172
"2021","Buckinghamshire 022","E02003673",9449,9338,111
"2021","Buckinghamshire 023","E02003674",5558,5558,0
"2021","Buckinghamshire 024","E02003675",9653,8964,689
"2021","Buckinghamshire 029","E02003676",8145,8096,49
"2021","Buckinghamshire 027","E02003677",10408,10385,23
"2021","Buckinghamshire 028","E02003678",5819,5746,73
"2021","Buckinghamshire 030","E02003679",6868,6803,65
"2021","Buckinghamshire 031","E02003680",9825,9790,35
"2021","Buckinghamshire 032","E02003681",10564,10475,89
"2021","Buckinghamshire 034","E02003682",7573,7570,3
"2021","Buckinghamshire 035","E02003683",7164,7163,1
"2021","Buckinghamshire 047","E02003685",8006,7997,9
"2021","Buckinghamshire 050","E02003686",7560,7380,180
"2021","Buckinghamshire 054","E02003687",5819,5766,53
"2021","Buckinghamshire 053","E02003688",12235,12128,107
"2021","Buckinghamshire 058","E02003689",9261,9145,116
"2021","Buckinghamshire 059","E02003690",7474,7411,63
"2021","Buckinghamshire 063","E02003691",7294,7118,176
"2021","Buckinghamshire 064","E02003692",8890,8773,117
"2021","Buckinghamshire 065","E02003693",7217,7176,41
"2021","Buckinghamshire 066","E02003694",8444,8377,67
"2021","Buckinghamshire 067","E02003695",10807,10785,22
"2021","Buckinghamshire 026","E02003696",8548,8507,41
"2021","Buckinghamshire 025","E02003697",6310,6289,21
"2021","Buckinghamshire 033","E02003698",8270,8270,0
"2021","Buckinghamshire 037","E02003699",5852,5770,82
"2021","Buckinghamshire 038","E02003701",12302,11853,449
"2021","Buckinghamshire 040","E02003702",8186,7898,288
"2021","Buckinghamshire 041","E02003703",8965,8815,150
"2021","Buckinghamshire 045","E02003704",5811,5805,6
"2021","Buckinghamshire 042","E02003705",7107,7107,0
"2021","Buckinghamshire 043","E02003706",6768,6759,9
"2021","Buckinghamshire 044","E02003707",6750,6735,15
"2021","Buckinghamshire 046","E02003708",9775,9775,0
"2021","Buckinghamshire 048","E02003709",5761,5761,0
"2021","Buckinghamshire 049","E02003710",12920,11901,1019
"2021","Buckinghamshire 051","E02003711",9746,9638,108
"2021","Buckinghamshire 052","E02003712",8135,7983,152
"2021","Buckinghamshire 055","E02003713",5902,5895,7
"2021","Buckinghamshire 056","E02003714",6750,6727,23
"2021","Buckinghamshire 057","E02003715",6571,6571,0
"2021","Buckinghamshire 060","E02003716",5930,5900,30
"2021","Buckinghamshire 062","E02003717",9111,9067,44
"2021","Buckinghamshire 061","E02003718",5662,5598,64
"2021","Buckinghamshire 039","E02006823",8935,8792,143
"2021","Buckinghamshire 036","E02006824",9534,9482,52
"2021","Eastbourne 001","E02004356",7392,7343,49
"2021","Eastbourne 002","E02004357",7686,7681,5
"2021","Eastbourne 003","E02004358",8041,7984,57
"2021","Eastbourne 004","E02004359",7751,7640,111
"2021","Eastbourne 006","E02004361",8190,8083,107
"2021","Eastbourne 007","E02004362",8823,8789,34
"2021","Eastbourne 008","E02004363",6961,6581,380
"2021","Eastbourne 009","E02004364",8200,8090,110
"2021","Eastbourne 010","E02004365",8424,8351,73
"2021","Eastbourne 011","E02004366",7643,7079,564
"2021","Eastbourne 012","E02004367",6747,6253,494
"2021","Eastbourne 013","E02006857",8995,8964,31
"2021","Eastbourne 014","E02006858",6832,6832,0
"2021","Hastings 001","E02004368",8292,8223,69
"2021","Hastings 002","E02004369",10050,9851,199
"2021","Hastings 003","E02004370",8106,8099,7
"2021","Hastings 004","E02004371",7137,7109,28
"2021","Hastings 005","E02004372",7149,7146,3
"2021","Hastings 006","E02004373",8796,8718,78
"2021","Hastings 007","E02004374",7293,7211,82
"2021","Hastings 008","E02004375",8364,8194,170
"2021","Hastings 009","E02004376",6877,6829,48
"2021","Hastings 010","E02004377",10709,10206,503
"2021","Hastings 011","E02004378",8221,8050,171
"2021","Lewes 001","E02004379",7650,7599,51
"2021","Lewes 002","E02004380",9644,9265,379
"2021","Lewes 003","E02004381",9375,9332,43
"2021","Lewes 004","E02004382",6513,6441,72
"2021","Lewes 005","E02004383",7339,6954,385
"2021","Lewes 006","E02004384",7393,7293,100
"2021","Lewes 007","E02004385",7659,7659,0
"2021","Lewes 008","E02004386",6621,6585,36
"2021","Lewes 009","E02004387",6070,6040,30
"2021","Lewes 010","E02004388",7776,7756,20
"2021","Lewes 011","E02004389",9342,9096,246
"2021","Lewes 012","E02004390",8034,8027,7
"2021","Lewes 013","E02004391",6488,6356,132
"2021","Rother 001","E02004392",9283,8998,285
"2021","Rother 002","E02004393",6349,6296,53
"2021","Rother 003","E02004394",7909,7765,144
"2021","Rother 004","E02004395",7623,7602,21
"2021","Rother 005","E02004396",9238,8991,247
"2021","Rother 006","E02004397",8136,7983,153
"2021","Rother 007","E02004398",9321,9233,88
"2021","Rother 008","E02004399",8047,7827,220
"2021","Rother 009","E02004400",10532,10310,222
"2021","Rother 010","E02004401",7711,7606,105
"2021","Rother 011","E02004402",8960,8699,261
"2021","Wealden 001","E02004403",6434,6427,7
"2021","Wealden 002","E02004404",6405,6380,25
"2021","Wealden 003","E02004405",6029,6029,0
"2021","Wealden 004","E02004406",7286,7055,231
"2021","Wealden 005","E02004407",8102,7899,203
"2021","Wealden 006","E02004408",8375,8023,352
"2021","Wealden 007","E02004409",5323,5140,183
"2021","Wealden 008","E02004410",7990,7908,82
"2021","Wealden 009","E02004411",8510,8481,29
"2021","Wealden 010","E02004412",8080,8019,61
"2021","Wealden 011","E02004413",7323,7195,128
"2021","Wealden 012","E02004414",6526,6479,47
"2021","Wealden 013","E02004415",6700,6572,128
"2021","Wealden 014","E02004416",6475,6457,18
"2021","Wealden 015","E02004417",6517,6422,95
"2021","Wealden 016","E02004418",5791,5706,85
"2021","Wealden 017","E02004419",6332,6268,64
"2021","Wealden 018","E02004420",13951,13554,397
"2021","Wealden 019","E02004421",9339,9196,143
"2021","Wealden 020","E02004422",11106,11075,31
"2021","Wealden 021","E02004423",7558,7536,22
"2021","Basingstoke and Deane 001","E02004675",7725,7667,58
"2021","Basingstoke and Deane 002","E02004676",7989,7960,29
"2021","Basingstoke and Deane 003","E02004677",7570,7440,130
"2021","Basingstoke and Deane 004","E02004678",7578,7542,36
"2021","Basingstoke and Deane 005","E02004679",11111,10932,179
"2021","Basingstoke and Deane 006","E02004680",7848,7848,0
"2021","Basingstoke and Deane 007","E02004681",14930,14871,59
"2021","Basingstoke and Deane 008","E02004682",8338,8331,7
"2021","Basingstoke and Deane 009","E02004683",8159,8047,112
"2021","Basingstoke and Deane 010","E02004684",11374,11294,80
"2021","Basingstoke and Deane 011","E02004685",7887,7777,110
"2021","Basingstoke and Deane 012","E02004686",8832,8771,61
"2021","Basingstoke and Deane 013","E02004687",7692,7662,30
"2021","Basingstoke and Deane 014","E02004688",7845,7837,8
"2021","Basingstoke and Deane 015","E02004689",5690,5631,59
"2021","Basingstoke and Deane 016","E02004690",8123,8044,79
"2021","Basingstoke and Deane 017","E02004691",7951,7819,132
"2021","Basingstoke and Deane 018","E02004692",7232,7224,8
"2021","Basingstoke and Deane 019","E02004693",7446,7446,0
"2021","Basingstoke and Deane 020","E02004694",7540,7470,70
"2021","Basingstoke and Deane 021","E02004695",8753,8753,0
"2021","Basingstoke and Deane 022","E02004696",7544,7514,30
"2021","East Hampshire 001","E02004697",6836,6562,274
"2021","East Hampshire 002","E02004698",6605,6534,71
"2021","East Hampshire 003","E02004699",10712,10643,69
"2021","East Hampshire 004","E02004700",6904,6883,21
"2021","East Hampshire 006","E02004702",8019,7967,52
"2021","East Hampshire 007","E02004703",12611,12513,98
"2021","East Hampshire 008","E02004704",6206,6200,6
"2021","East Hampshire 009","E02004705",9771,9673,98
"2021","East Hampshire 010","E02004706",7617,7339,278
"2021","East Hampshire 011","E02004707",11210,10800,410
"2021","East Hampshire 012","E02004708",9622,9619,3
"2021","East Hampshire 013","E02004709",8743,8732,11
"2021","East Hampshire 014","E02004710",6554,6548,6
"2021","East Hampshire 016","E02006829",7396,7222,174
"2021","East Hampshire 017","E02006838",6940,6876,64
"2021","Eastleigh 001","E02004712",8769,8685,84
"2021","Eastleigh 002","E02004713",8033,7989,44
"2021","Eastleigh 003","E02004714",7514,7467,47
"2021","Eastleigh 004","E02004715",9045,9018,27
"2021","Eastleigh 005","E02004716",8750,8729,21
"2021","Eastleigh 006","E02004717",12988,12932,56
"2021","Eastleigh 007","E02004718",8692,8662,30
"2021","Eastleigh 008","E02004719",11531,11423,108
"2021","Eastleigh 009","E02004720",11321,11144,177
"2021","Eastleigh 010","E02004721",11784,11751,33
"2021","Eastleigh 011","E02004722",7011,6951,60
"2021","Eastleigh 012","E02004723",9858,9722,136
"2021","Eastleigh 013","E02004724",9670,9648,22
"2021","Eastleigh 014","E02004725",5443,5317,126
"2021","Eastleigh 015","E02004726",6036,6021,15
"2021","Fareham 001","E02004727",10255,10164,91
"2021","Fareham 002","E02004728",9098,8974,124
"2021","Fareham 003","E02004729",7247,7200,47
"2021","Fareham 004","E02004730",8673,8433,240
"2021","Fareham 005","E02004731",7579,7560,19
"2021","Fareham 006","E02004732",8843,8806,37
"2021","Fareham 007","E02004733",8018,7908,110
"2021","Fareham 008","E02004734",10113,9955,158
"2021","Fareham 009","E02004735",7482,7419,63
"2021","Fareham 010","E02004736",8111,8085,26
"2021","Fareham 011","E02004737",7572,7481,91
"2021","Fareham 012","E02004738",7208,7208,0
"2021","Fareham 013","E02004739",7224,6474,750
"2021","Fareham 014","E02004740",7094,7040,54
"2021","Gosport 001","E02004741",7497,7495,2
"2021","Gosport 002","E02004742",7053,7032,21
"2021","Gosport 003","E02004743",7313,7313,0
"2021","Gosport 004","E02004744",9818,9792,26
"2021","Gosport 005","E02004745",8511,8421,90
"2021","Gosport 006","E02004746",11111,11014,97
"2021","Gosport 007","E02004747",6247,6144,103
"2021","Gosport 008","E02004748",9392,9339,53
"2021","Gosport 009","E02004749",7174,6989,185
"2021","Gosport 010","E02004750",7836,7297,539
"2021","Hart 001","E02004751",8436,8411,25
"2021","Hart 002","E02004752",7953,7942,11
"2021","Hart 003","E02004753",11516,10780,736
"2021","Hart 004","E02004754",7164,7163,1
"2021","Hart 005","E02004755",12166,12114,52
"2021","Hart 006","E02004756",9658,9622,36
"2021","Hart 007","E02004757",7891,7868,23
"2021","Hart 008","E02004758",9154,9056,98
"2021","Hart 009","E02004759",8227,8153,74
"2021","Hart 010","E02004760",10724,10591,133
"2021","Hart 011","E02004761",6519,5944,575
"2021","Havant 003","E02004764",8174,8137,37
"2021","Havant 004","E02004765",6043,6036,7
"2021","Havant 005","E02004766",7113,6928,185
"2021","Havant 006","E02004767",5819,5792,27
"2021","Havant 007","E02004768",5376,5350,26
"2021","Havant 008","E02004769",6384,6370,14
"2021","Havant 009","E02004770",6852,6846,6
"2021","Havant 010","E02004771",8967,8957,10
"2021","Havant 011","E02004772",9340,9295,45
"2021","Havant 013","E02004774",10269,10076,193
"2021","Havant 014","E02004775",10315,10212,103
"2021","Havant 015","E02004776",5948,5845,103
"2021","Havant 016","E02004777",5258,5167,91
"2021","Havant 017","E02004778",6184,6086,98
"2021","Havant 018","E02006822",9308,9165,143
"2021","Havant 019","E02006830",6670,6656,14
"2021","Havant 020","E02006831",6187,6183,4
"2021","New Forest 001","E02004779",10923,10764,159
"2021","New Forest 002","E02004780",5875,5861,14
"2021","New Forest 003","E02004781",8007,7918,89
"2021","New Forest 004","E02004782",7736,7713,23
"2021","New Forest 005","E02004783",7035,7035,0
"2021","New Forest 006","E02004784",5644,5403,241
"2021","New Forest 007","E02004785",5491,5347,144
"2021","New Forest 008","E02004786",8245,8212,33
"2021","New Forest 009","E02004787",7276,7245,31
"2021","New Forest 010","E02004788",7223,7078,145
"2021","New Forest 011","E02004789",10434,10364,70
"2021","New Forest 012","E02004790",8107,8048,59
"2021","New Forest 013","E02004791",5556,5547,9
"2021","New Forest 014","E02004792",8457,8407,50
"2021","New Forest 015","E02004793",7390,7108,282
"2021","New Forest 016","E02004794",6891,6775,116
"2021","New Forest 017","E02004795",8514,8307,207
"2021","New Forest 018","E02004796",9630,9596,34
"2021","New Forest 019","E02004797",8124,8120,4
"2021","New Forest 020","E02004798",6144,6107,37
"2021","New Forest 021","E02004799",7944,7754,190
"2021","New Forest 022","E02004800",7404,7099,305
"2021","New Forest 023","E02004801",7731,7578,153
"2021","Rushmoor 001","E02004802",6750,6680,70
"2021","Rushmoor 002","E02004803",7489,7481,8
"2021","Rushmoor 003","E02004804",7155,7155,0
"2021","Rushmoor 004","E02004805",8569,8491,78
"2021","Rushmoor 005","E02004806",8034,8034,0
"2021","Rushmoor 006","E02004807",9461,9450,11
"2021","Rushmoor 007","E02004808",12122,11477,645
"2021","Rushmoor 008","E02004809",10914,10483,431
"2021","Rushmoor 009","E02004810",8086,8079,7
"2021","Rushmoor 010","E02004811",7972,7889,83
"2021","Rushmoor 011","E02004812",6741,6682,59
"2021","Rushmoor 012","E02004813",6464,6405,59
"2021","Test Valley 001","E02004814",7041,7029,12
"2021","Test Valley 002","E02004815",7373,7366,7
"2021","Test Valley 004","E02004817",7491,7439,52
"2021","Test Valley 005","E02004818",10242,9810,432
"2021","Test Valley 006","E02004819",7796,7643,153
"2021","Test Valley 007","E02004820",7286,7112,174
"2021","Test Valley 008","E02004821",5226,5090,136
"2021","Test Valley 009","E02004822",8025,7986,39
"2021","Test Valley 010","E02004823",8660,8618,42
"2021","Test Valley 011","E02004824",5857,5762,95
"2021","Test Valley 012","E02004825",10903,10789,114
"2021","Test Valley 013","E02004826",9764,9602,162
"2021","Test Valley 014","E02004827",7362,7344,18
"2021","Test Valley 015","E02004828",7250,7179,71
"2021","Test Valley 016","E02007076",7668,7611,57
"2021","Test Valley 017","E02007077",7476,7432,44
"2021","Test Valley 018","E02007078",5075,5053,22
"2021","Winchester 001","E02004829",5918,5891,27
"2021","Winchester 002","E02004830",6944,6683,261
"2021","Winchester 003","E02004831",10490,9668,822
"2021","Winchester 004","E02004832",8476,8340,136
"2021","Winchester 005","E02004833",10079,8976,1103
"2021","Winchester 006","E02004834",7643,7272,371
"2021","Winchester 007","E02004835",10700,9198,1502
"2021","Winchester 008","E02004836",6764,6054,710
"2021","Winchester 009","E02004837",8232,8174,58
"2021","Winchester 010","E02004838",9750,9673,77
"2021","Winchester 011","E02004839",8962,8962,0
"2021","Winchester 012","E02004840",10203,10157,46
"2021","Winchester 013","E02004841",11746,11561,185
"2021","Winchester 014","E02004842",11537,11195,342
"2021","Ashford 001","E02004996",8427,8397,30
"2021","Ashford 002","E02004997",8191,8115,76
"2021","Ashford 003","E02004998",6800,6742,58
"2021","Ashford 005","E02005000",12105,11962,143
"2021","Ashford 006","E02005001",9563,9473,90
"2021","Ashford 007","E02005002",10040,10005,35
"2021","Ashford 008","E02005003",9245,9206,39
"2021","Ashford 009","E02005004",11801,11736,65
"2021","Ashford 010","E02005005",10396,10341,55
"2021","Ashford 011","E02005006",6208,6113,95
"2021","Ashford 012","E02005007",9365,9249,116
"2021","Ashford 013","E02005008",8769,8711,58
"2021","Ashford 014","E02005009",5961,5947,14
"2021","Ashford 015","E02007046",7029,6940,89
"2021","Ashford 016","E02007047",8844,8844,0
"2021","Canterbury 001","E02005010",7592,7330,262
"2021","Canterbury 002","E02005011",7484,7381,103
"2021","Canterbury 003","E02005012",8960,8862,98
"2021","Canterbury 004","E02005013",8215,8178,37
"2021","Canterbury 005","E02005014",8437,8411,26
"2021","Canterbury 006","E02005015",9648,9555,93
"2021","Canterbury 007","E02005016",7808,7764,44
"2021","Canterbury 008","E02005017",6637,6533,104
"2021","Canterbury 009","E02005018",8732,8638,94
"2021","Canterbury 010","E02005019",6525,6272,253
"2021","Canterbury 011","E02005020",7522,7445,77
"2021","Canterbury 012","E02005021",11032,6478,4554
"2021","Canterbury 013","E02005022",8062,8035,27
"2021","Canterbury 014","E02005023",9728,8591,1137
"2021","Canterbury 016","E02005025",9894,8334,1560
"2021","Canterbury 017","E02005026",8079,8078,1
"2021","Canterbury 018","E02005027",5517,5349,168
"2021","Canterbury 019","E02006855",6417,6259,158
"2021","Canterbury 020","E02006856",11142,10702,440
"2021","Dartford 001","E02005028",14368,14338,30
"2021","Dartford 002","E02005029",14925,14859,66
"2021","Dartford 003","E02005030",12203,12183,20
"2021","Dartford 004","E02005031",8138,8106,32
"2021","Dartford 005","E02005032",9727,9663,64
"2021","Dartford 006","E02005033",7605,7583,22
"2021","Dartford 007","E02005034",7727,7708,19
"2021","Dartford 008","E02005035",8539,8367,172
"2021","Dartford 009","E02005036",6733,6733,0
"2021","Dartford 010","E02005037",7087,7041,46
"2021","Dartford 011","E02005038",5999,5896,103
"2021","Dartford 012","E02005039",6873,6811,62
"2021","Dartford 013","E02005040",6830,6735,95
"2021","Dover 001","E02005041",7246,7199,47
"2021","Dover 002","E02005042",8921,8851,70
"2021","Dover 003","E02005043",7127,6985,142
"2021","Dover 004","E02005044",6054,5985,69
"2021","Dover 005","E02005045",9352,9315,37
"2021","Dover 006","E02005046",8964,8727,237
"2021","Dover 007","E02005047",7716,7598,118
"2021","Dover 008","E02005048",6594,6463,131
"2021","Dover 009","E02005049",6932,6834,98
"2021","Dover 010","E02005050",9704,9460,244
"2021","Dover 011","E02005051",13604,13558,46
"2021","Dover 012","E02005052",8352,7759,593
"2021","Dover 013","E02005053",9157,8981,176
"2021","Dover 014","E02005054",6689,6671,18
"2021","Gravesham 001","E02005055",8395,8386,9
"2021","Gravesham 002","E02005056",10162,10069,93
"2021","Gravesham 003","E02005057",11586,11532,54
"2021","Gravesham 004","E02005058",8007,7925,82
"2021","Gravesham 005","E02005059",9645,9603,42
"2021","Gravesham 006","E02005060",8644,8544,100
"2021","Gravesham 007","E02005061",7496,7495,1
"2021","Gravesham 008","E02005062",7085,7085,0
"2021","Gravesham 009","E02005063",7327,7280,47
"2021","Gravesham 010","E02005064",6563,6512,51
"2021","Gravesham 011","E02005065",8311,8311,0
"2021","Gravesham 012","E02005066",7747,7714,33
"2021","Gravesham 013","E02005067",5932,5930,2
"2021","Maidstone 001","E02005068",7177,7171,6
"2021","Maidstone 002","E02005069",9085,8994,91
"2021","Maidstone 003","E02005070",9752,9669,83
"2021","Maidstone 004","E02005071",12292,11399,893
"2021","Maidstone 005","E02005072",8041,7995,46
"2021","Maidstone 006","E02005073",12367,12109,258
"2021","Maidstone 007","E02005074",8032,7960,72
"2021","Maidstone 008","E02005075",11061,10959,102
"2021","Maidstone 009","E02005076",10011,9885,126
"2021","Maidstone 010","E02005077",8100,8085,15
"2021","Maidstone 011","E02005078",9764,9705,59
"2021","Maidstone 012","E02005079",9052,8982,70
"2021","Maidstone 013","E02005080",12180,12104,76
"2021","Maidstone 014","E02005081",6970,6969,1
"2021","Maidstone 015","E02005082",11970,11906,64
"2021","Maidstone 016","E02005083",7849,7832,17
"2021","Maidstone 017","E02005084",7505,7310,195
"2021","Maidstone 018","E02005085",7880,7879,1
"2021","Maidstone 019","E02005086",6693,6542,151
"2021","Sevenoaks 001","E02005087",7140,7070,70
"2021","Sevenoaks 002","E02005088",9913,9906,7
"2021","Sevenoaks 003","E02005089",6856,6856,0
"2021","Sevenoaks 004","E02005090",5931,5809,122
"2021","Sevenoaks 005","E02005091",6771,6715,56
"2021","Sevenoaks 007","E02005093",6024,6023,1
"2021","Sevenoaks 008","E02005094",9727,9694,33
"2021","Sevenoaks 009","E02005095",7566,7565,1
"2021","Sevenoaks 010","E02005096",9853,9764,89
"2021","Sevenoaks 011","E02005097",9640,9546,94
"2021","Sevenoaks 012","E02005098",10106,9553,553
"2021","Sevenoaks 013","E02005099",7963,7931,32
"2021","Sevenoaks 014","E02005100",9881,9849,32
"2021","Sevenoaks 015","E02005101",7072,7051,21
"2021","Sevenoaks 016","E02006832",6069,6069,0
"2021","Folkestone and Hythe 001","E02005102",6089,6069,20
"2021","Folkestone and Hythe 002","E02005103",10089,9970,119
"2021","Folkestone and Hythe 003","E02005104",7997,7996,1
"2021","Folkestone and Hythe 004","E02005105",7656,7650,6
"2021","Folkestone and Hythe 005","E02005106",10008,9994,14
"2021","Folkestone and Hythe 006","E02005107",13099,12515,584
"2021","Folkestone and Hythe 008","E02005109",6692,6458,234
"2021","Folkestone and Hythe 009","E02005110",7107,7059,48
"2021","Folkestone and Hythe 010","E02005111",7185,7111,74
"2021","Folkestone and Hythe 011","E02005112",7056,6966,90
"2021","Folkestone and Hythe 012","E02005113",7252,7067,185
"2021","Folkestone and Hythe 013","E02005114",6340,6294,46
"2021","Folkestone and Hythe 014","E02006879",6544,6421,123
"2021","Folkestone and Hythe 015","E02006880",6651,6295,356
"2021","Swale 001","E02005115",6707,6676,31
"2021","Swale 002","E02005116",6544,6535,9
"2021","Swale 003","E02005117",6585,6517,68
"2021","Swale 004","E02005118",10856,10774,82
"2021","Swale 005","E02005119",6574,6565,9
"2021","Swale 006","E02005120",9633,7405,2228
"2021","Swale 007","E02005121",14037,14001,36
"2021","Swale 008","E02005122",7811,7742,69
"2021","Swale 009","E02005123",12756,12595,161
"2021","Swale 010","E02005124",8821,8818,3
"2021","Swale 011","E02005125",8549,8549,0
"2021","Swale 012","E02005126",8164,8065,99
"2021","Swale 013","E02005127",8887,8845,42
"2021","Swale 014","E02005128",8973,8933,40
"2021","Swale 015","E02005129",11463,11397,66
"2021","Swale 016","E02005130",9523,9472,51
"2021","Swale 017","E02005131",5798,5788,10
"2021","Thanet 001","E02005132",10633,10331,302
"2021","Thanet 002","E02005133",8636,8527,109
"2021","Thanet 003","E02005134",7994,7835,159
"2021","Thanet 004","E02005135",7882,7757,125
"2021","Thanet 005","E02005136",8046,7967,79
"2021","Thanet 006","E02005137",7721,7720,1
"2021","Thanet 007","E02005138",9047,8819,228
"2021","Thanet 008","E02005139",8864,8754,110
"2021","Thanet 009","E02005140",7557,7458,99
"2021","Thanet 010","E02005141",7064,6893,171
"2021","Thanet 011","E02005142",7295,7281,14
"2021","Thanet 012","E02005143",8206,8203,3
"2021","Thanet 013","E02005144",8925,8905,20
"2021","Thanet 014","E02005145",8055,8025,30
"2021","Thanet 015","E02005146",8139,7968,171
"2021","Thanet 016","E02005147",8706,8649,57
"2021","Thanet 017","E02005148",7814,7767,47
"2021","Tonbridge and Malling 001","E02005149",12104,12009,95
"2021","Tonbridge and Malling 002","E02005150",11829,11767,62
"2021","Tonbridge and Malling 003","E02005151",12716,12713,3
"2021","Tonbridge and Malling 005","E02005153",9442,9418,24
"2021","Tonbridge and Malling 006","E02005154",11752,11681,71
"2021","Tonbridge and Malling 007","E02005155",12559,12559,0
"2021","Tonbridge and Malling 008","E02005156",7213,7065,148
"2021","Tonbridge and Malling 009","E02005157",6730,6710,20
"2021","Tonbridge and Malling 010","E02005158",6614,6512,102
"2021","Tonbridge and Malling 011","E02005159",7729,7729,0
"2021","Tonbridge and Malling 012","E02005160",12509,12032,477
"2021","Tonbridge and Malling 013","E02005161",8602,8544,58
"2021","Tonbridge and Malling 014","E02006833",12405,12345,60
"2021","Tunbridge Wells 001","E02005162",10512,10486,26
"2021","Tunbridge Wells 002","E02005163",8078,8007,71
"2021","Tunbridge Wells 003","E02005164",8925,8892,33
"2021","Tunbridge Wells 004","E02005165",7517,7378,139
"2021","Tunbridge Wells 005","E02005166",6913,6858,55
"2021","Tunbridge Wells 006","E02005167",7662,7532,130
"2021","Tunbridge Wells 007","E02005168",7572,7426,146
"2021","Tunbridge Wells 008","E02005169",9097,9060,37
"2021","Tunbridge Wells 009","E02005170",9847,9634,213
"2021","Tunbridge Wells 010","E02005171",6200,6162,38
"2021","Tunbridge Wells 011","E02005172",8262,8167,95
"2021","Tunbridge Wells 012","E02005173",8430,8358,72
"2021","Tunbridge Wells 013","E02005174",7576,7276,300
"2021","Tunbridge Wells 014","E02005175",8719,8145,574
"2021","Cherwell 001","E02005921",6900,6842,58
"2021","Cherwell 002","E02005922",8840,8839,1
"2021","Cherwell 003","E02005923",6015,6000,15
"2021","Cherwell 004","E02005924",12600,12474,126
"2021","Cherwell 005","E02005925",8884,8835,49
"2021","Cherwell 006","E02005926",9024,8663,361
"2021","Cherwell 007","E02005927",5648,5646,2
"2021","Cherwell 008","E02005928",11104,10849,255
"2021","Cherwell 009","E02005929",7343,7297,46
"2021","Cherwell 010","E02005930",9463,9410,53
"2021","Cherwell 011","E02005931",11255,10953,302
"2021","Cherwell 012","E02005932",6726,6726,0
"2021","Cherwell 013","E02005933",7715,7708,7
"2021","Cherwell 014","E02005934",8847,8847,0
"2021","Cherwell 015","E02005935",8578,8521,57
"2021","Cherwell 016","E02005936",13065,12307,758
"2021","Cherwell 017","E02005937",6541,6486,55
"2021","Cherwell 018","E02005938",5683,5682,1
"2021","Cherwell 019","E02005939",6782,6738,44
"2021","Oxford 001","E02005940",6154,6132,22
"2021","Oxford 002","E02005941",7084,6246,838
"2021","Oxford 003","E02005942",6248,5180,1068
"2021","Oxford 004","E02005943",7332,7291,41
"2021","Oxford 005","E02005944",8393,8351,42
"2021","Oxford 006","E02005945",11115,9548,1567
"2021","Oxford 007","E02005946",8468,8436,32
"2021","Oxford 008","E02005947",18475,5026,13449
"2021","Oxford 009","E02005948",6618,6105,513
"2021","Oxford 010","E02005949",7621,6494,1127
"2021","Oxford 011","E02005950",11137,10379,758
"2021","Oxford 012","E02005951",5578,5560,18
"2021","Oxford 014","E02005953",6017,6013,4
"2021","Oxford 015","E02005954",10482,10277,205
"2021","Oxford 016","E02005955",11233,11177,56
"2021","Oxford 017","E02005956",6557,6514,43
"2021","Oxford 018","E02005957",6910,6857,53
"2021","Oxford 020","E02007021",8441,7411,1030
"2021","Oxford 019","E02007116",8178,7821,357
"2021","South Oxfordshire 001","E02005958",5380,5379,1
"2021","South Oxfordshire 002","E02005959",5896,5746,150
"2021","South Oxfordshire 003","E02005960",7889,7828,61
"2021","South Oxfordshire 004","E02005961",6738,6693,45
"2021","South Oxfordshire 005","E02005962",10167,10137,30
"2021","South Oxfordshire 006","E02005963",8033,7864,169
"2021","South Oxfordshire 007","E02005964",7300,7294,6
"2021","South Oxfordshire 008","E02005965",5519,5469,50
"2021","South Oxfordshire 009","E02005966",8115,8111,4
"2021","South Oxfordshire 010","E02005967",9536,9343,193
"2021","South Oxfordshire 011","E02005968",8011,7170,841
"2021","South Oxfordshire 012","E02005969",9698,9608,90
"2021","South Oxfordshire 013","E02005970",5513,5512,1
"2021","South Oxfordshire 014","E02005971",6358,6343,15
"2021","South Oxfordshire 015","E02005972",12012,11960,52
"2021","South Oxfordshire 016","E02005973",5913,5872,41
"2021","South Oxfordshire 017","E02005974",6273,6186,87
"2021","South Oxfordshire 018","E02005975",8234,8010,224
"2021","South Oxfordshire 019","E02005976",6340,6151,189
"2021","South Oxfordshire 020","E02005977",6160,6068,92
"2021","Vale of White Horse 001","E02005978",7599,7433,166
"2021","Vale of White Horse 002","E02005979",10275,9852,423
"2021","Vale of White Horse 003","E02005980",11764,10267,1497
"2021","Vale of White Horse 004","E02005981",8552,8551,1
"2021","Vale of White Horse 005","E02005982",5740,5725,15
"2021","Vale of White Horse 006","E02005983",10981,10674,307
"2021","Vale of White Horse 007","E02005984",9152,9117,35
"2021","Vale of White Horse 008","E02005985",7904,7904,0
"2021","Vale of White Horse 009","E02005986",9690,9614,76
"2021","Vale of White Horse 010","E02005987",10298,10293,5
"2021","Vale of White Horse 011","E02005988",9126,9126,0
"2021","Vale of White Horse 014","E02005991",10067,9980,87
"2021","Vale of White Horse 015","E02005992",13914,13847,67
"2021","Vale of White Horse 016","E02006886",13853,13568,285
"2021","West Oxfordshire 001","E02005993",7250,7142,108
"2021","West Oxfordshire 002","E02005994",6269,5971,298
"2021","West Oxfordshire 003","E02005995",6372,6278,94
"2021","West Oxfordshire 004","E02005996",8933,8893,40
"2021","West Oxfordshire 005","E02005997",5955,5954,1
"2021","West Oxfordshire 006","E02005998",7029,6929,100
"2021","West Oxfordshire 007","E02005999",6543,6488,55
"2021","West Oxfordshire 008","E02006000",11773,11641,132
"2021","West Oxfordshire 009","E02006001",7087,7055,32
"2021","West Oxfordshire 010","E02006002",10769,10702,67
"2021","West Oxfordshire 011","E02006003",5930,5921,9
"2021","West Oxfordshire 012","E02006004",7336,5945,1391
"2021","West Oxfordshire 013","E02006005",10032,9988,44
"2021","West Oxfordshire 014","E02006006",5650,5650,0
"2021","West Oxfordshire 015","E02006007",7308,7226,82
"2021","Elmbridge 001","E02006317",6352,6304,48
"2021","Elmbridge 002","E02006318",6965,6921,44
"2021","Elmbridge 003","E02006319",7216,7155,61
"2021","Elmbridge 004","E02006320",7251,7251,0
"2021","Elmbridge 005","E02006321",6608,6464,144
"2021","Elmbridge 006","E02006322",6489,6443,46
"2021","Elmbridge 007","E02006323",7526,7526,0
"2021","Elmbridge 008","E02006324",7915,7832,83
"2021","Elmbridge 009","E02006325",9173,9154,19
"2021","Elmbridge 010","E02006326",7532,7479,53
"2021","Elmbridge 011","E02006327",6697,6681,16
"2021","Elmbridge 012","E02006328",9598,9515,83
"2021","Elmbridge 013","E02006329",7098,7016,82
"2021","Elmbridge 014","E02006330",9928,9847,81
"2021","Elmbridge 015","E02006331",7263,7203,60
"2021","Elmbridge 016","E02006332",6651,6418,233
"2021","Elmbridge 017","E02006333",9944,9556,388
"2021","Elmbridge 018","E02006334",8549,8486,63
"2021","Epsom and Ewell 001","E02006335",7913,7909,4
"2021","Epsom and Ewell 002","E02006336",7167,7167,0
"2021","Epsom and Ewell 003","E02006337",8871,8869,2
"2021","Epsom and Ewell 004","E02006338",6787,6773,14
"2021","Epsom and Ewell 005","E02006339",10913,10821,92
"2021","Epsom and Ewell 007","E02006341",10249,10194,55
"2021","Epsom and Ewell 008","E02006342",8199,7934,265
"2021","Epsom and Ewell 009","E02006343",9056,8712,344
"2021","Epsom and Ewell 010","E02006837",11786,11668,118
"2021","Guildford 001","E02006344",8520,8327,193
"2021","Guildford 002","E02006345",7676,6136,1540
"2021","Guildford 003","E02006346",9923,9807,116
"2021","Guildford 004","E02006347",7127,7069,58
"2021","Guildford 005","E02006348",8462,8341,121
"2021","Guildford 006","E02006349",8003,7630,373
"2021","Guildford 007","E02006350",6377,6376,1
"2021","Guildford 008","E02006351",8371,8371,0
"2021","Guildford 009","E02006352",6146,6146,0
"2021","Guildford 010","E02006353",6114,6105,9
"2021","Guildford 011","E02006354",9619,9589,30
"2021","Guildford 012","E02006355",9757,6593,3164
"2021","Guildford 013","E02006356",11456,11356,100
"2021","Guildford 014","E02006357",7211,7206,5
"2021","Guildford 015","E02006358",8974,6726,2248
"2021","Guildford 016","E02006359",6129,6057,72
"2021","Guildford 017","E02006360",8127,7809,318
"2021","Guildford 018","E02006361",5659,5628,31
"2021","Mole Valley 001","E02006362",6903,6854,49
"2021","Mole Valley 002","E02006363",6054,5946,108
"2021","Mole Valley 003","E02006364",7703,7599,104
"2021","Mole Valley 004","E02006365",6260,6106,154
"2021","Mole Valley 005","E02006366",8022,7938,84
"2021","Mole Valley 006","E02006367",5969,5960,9
"2021","Mole Valley 007","E02006368",5679,5599,80
"2021","Mole Valley 008","E02006369",6258,6180,78
"2021","Mole Valley 009","E02006370",6339,6152,187
"2021","Mole Valley 010","E02006371",7323,7171,152
"2021","Mole Valley 011","E02006372",6411,6370,41
"2021","Mole Valley 012","E02006373",7512,7383,129
"2021","Mole Valley 013","E02006374",6951,6856,95
"2021","Reigate and Banstead 001","E02006375",6773,6701,72
"2021","Reigate and Banstead 002","E02006376",9227,7782,1445
"2021","Reigate and Banstead 003","E02006377",6168,6086,82
"2021","Reigate and Banstead 004","E02006378",8849,8774,75
"2021","Reigate and Banstead 005","E02006379",6969,6969,0
"2021","Reigate and Banstead 006","E02006380",7095,6978,117
"2021","Reigate and Banstead 007","E02006381",7255,7159,96
"2021","Reigate and Banstead 008","E02006382",6864,6831,33
"2021","Reigate and Banstead 009","E02006383",10115,9411,704
"2021","Reigate and Banstead 010","E02006384",10919,10847,72
"2021","Reigate and Banstead 011","E02006385",11324,11201,123
"2021","Reigate and Banstead 012","E02006386",8378,8302,76
"2021","Reigate and Banstead 013","E02006387",6788,6772,16
"2021","Reigate and Banstead 014","E02006388",9327,9276,51
"2021","Reigate and Banstead 015","E02006389",7370,7335,35
"2021","Reigate and Banstead 016","E02006390",10508,10440,68
"2021","Reigate and Banstead 017","E02006391",7749,7734,15
"2021","Reigate and Banstead 018","E02006392",9169,8947,222
"2021","Runnymede 001","E02006393",6944,6921,23
"2021","Runnymede 002","E02006394",11826,8640,3186
"2021","Runnymede 003","E02006395",9753,9734,19
"2021","Runnymede 004","E02006396",5964,5742,222
"2021","Runnymede 005","E02006397",6334,6231,103
"2021","Runnymede 006","E02006398",8654,8650,4
"2021","Runnymede 007","E02006399",12270,12192,78
"2021","Runnymede 008","E02006400",5685,5564,121
"2021","Runnymede 009","E02006401",10711,10626,85
"2021","Runnymede 010","E02006402",9937,9914,23
"2021","Spelthorne 001","E02006403",6738,6687,51
"2021","Spelthorne 002","E02006404",7759,7700,59
"2021","Spelthorne 003","E02006405",11430,11148,282
"2021","Spelthorne 004","E02006406",8954,8928,26
"2021","Spelthorne 005","E02006407",9310,9296,14
"2021","Spelthorne 006","E02006408",8851,8850,1
"2021","Spelthorne 007","E02006409",6778,6766,12
"2021","Spelthorne 008","E02006410",8513,8438,75
"2021","Spelthorne 009","E02006411",7190,7173,17
"2021","Spelthorne 010","E02006412",7742,7739,3
"2021","Spelthorne 011","E02006413",6471,6345,126
"2021","Spelthorne 012","E02006414",6236,6175,61
"2021","Spelthorne 013","E02006415",6986,6941,45
"2021","Surrey Heath 001","E02006416",8383,8355,28
"2021","Surrey Heath 002","E02006417",6083,6009,74
"2021","Surrey Heath 003","E02006418",6536,6482,54
"2021","Surrey Heath 004","E02006419",8250,8166,84
"2021","Surrey Heath 005","E02006420",7745,7624,121
"2021","Surrey Heath 006","E02006421",10337,9433,904
"2021","Surrey Heath 007","E02006422",6205,6201,4
"2021","Surrey Heath 008","E02006423",11208,11130,78
"2021","Surrey Heath 009","E02006424",6495,6480,15
"2021","Surrey Heath 010","E02006425",6442,6382,60
"2021","Surrey Heath 011","E02006426",5542,5540,2
"2021","Surrey Heath 012","E02006427",7229,7100,129
"2021","Tandridge 002","E02006429",8212,8201,11
"2021","Tandridge 003","E02006430",9517,9394,123
"2021","Tandridge 004","E02006431",11571,10850,721
"2021","Tandridge 005","E02006432",5671,5575,96
"2021","Tandridge 006","E02006433",9491,9347,144
"2021","Tandridge 007","E02006434",6630,6503,127
"2021","Tandridge 008","E02006435",6115,6008,107
"2021","Tandridge 009","E02006436",6213,6163,50
"2021","Tandridge 010","E02006437",8388,8105,283
"2021","Tandridge 011","E02006438",8351,8244,107
"2021","Tandridge 012","E02006790",7717,7681,36
"2021","Waverley 001","E02006439",6237,6234,3
"2021","Waverley 002","E02006440",7195,7185,10
"2021","Waverley 003","E02006441",8428,8080,348
"2021","Waverley 004","E02006442",6415,6306,109
"2021","Waverley 005","E02006443",7502,7454,48
"2021","Waverley 006","E02006444",7178,7134,44
"2021","Waverley 007","E02006445",8435,7619,816
"2021","Waverley 008","E02006446",6978,6795,183
"2021","Waverley 009","E02006447",6748,6543,205
"2021","Waverley 010","E02006448",7387,7240,147
"2021","Waverley 011","E02006449",6954,6946,8
"2021","Waverley 012","E02006450",7164,6895,269
"2021","Waverley 013","E02006451",11792,11226,566
"2021","Waverley 015","E02006453",8388,7991,397
"2021","Waverley 016","E02006454",6763,6740,23
"2021","Waverley 017","E02006455",6143,5779,364
"2021","Waverley 018","E02006839",8519,8187,332
"2021","Woking 001","E02006456",8022,7953,69
"2021","Woking 002","E02006457",9332,9193,139
"2021","Woking 003","E02006458",9225,9075,150
"2021","Woking 004","E02006459",10655,10645,10
"2021","Woking 005","E02006460",9321,9321,0
"2021","Woking 006","E02006461",6788,6659,129
"2021","Woking 007","E02006462",8342,8288,54
"2021","Woking 008","E02006463",10661,10611,50
"2021","Woking 009","E02006464",6810,6810,0
"2021","Woking 010","E02006465",6215,6161,54
"2021","Woking 011","E02006466",11307,11263,44
"2021","Woking 012","E02006467",7265,7252,13
"2021","Adur 001","E02006534",9095,9056,39
"2021","Adur 002","E02006535",7362,7305,57
"2021","Adur 003","E02006536",7500,7194,306
"2021","Adur 004","E02006537",10534,10414,120
"2021","Adur 005","E02006538",9261,9225,36
"2021","Adur 006","E02006539",7294,7243,51
"2021","Adur 007","E02006540",5724,5711,13
"2021","Adur 008","E02006541",7774,7704,70
"2021","Arun 001","E02006542",5736,5624,112
"2021","Arun 002","E02006543",5598,5573,25
"2021","Arun 003","E02006544",11615,11310,305
"2021","Arun 004","E02006545",12166,12140,26
"2021","Arun 005","E02006546",10968,10885,83
"2021","Arun 006","E02006547",6911,6433,478
"2021","Arun 007","E02006548",9755,9693,62
"2021","Arun 008","E02006549",6248,6164,84
"2021","Arun 009","E02006550",9610,9489,121
"2021","Arun 010","E02006551",7955,7787,168
"2021","Arun 011","E02006552",7382,7118,264
"2021","Arun 012","E02006553",9663,9639,24
"2021","Arun 013","E02006554",6618,6584,34
"2021","Arun 014","E02006555",7695,7568,127
"2021","Arun 015","E02006556",10593,10514,79
"2021","Arun 016","E02006557",7768,7623,145
"2021","Arun 017","E02006558",10725,9781,944
"2021","Arun 018","E02006559",8181,8087,94
"2021","Arun 019","E02006560",9705,9423,282
"2021","Chichester 001","E02006561",6705,6454,251
"2021","Chichester 002","E02006562",6160,6160,0
"2021","Chichester 003","E02006563",5752,5685,67
"2021","Chichester 004","E02006564",7990,7957,33
"2021","Chichester 005","E02006565",8162,7798,364
"2021","Chichester 006","E02006566",8233,8132,101
"2021","Chichester 007","E02006567",7684,7652,32
"2021","Chichester 008","E02006568",12300,11766,534
"2021","Chichester 009","E02006569",9625,8494,1131
"2021","Chichester 010","E02006570",8907,8370,537
"2021","Chichester 011","E02006571",8515,8290,225
"2021","Chichester 012","E02006572",11486,11144,342
"2021","Chichester 013","E02006573",11628,11498,130
"2021","Chichester 014","E02006574",10923,10754,169
"2021","Crawley 001","E02006575",8946,8834,112
"2021","Crawley 002","E02006576",10713,10703,10
"2021","Crawley 003","E02006577",9091,8995,96
"2021","Crawley 004","E02006578",12582,12508,74
"2021","Crawley 005","E02006579",8352,8344,8
"2021","Crawley 006","E02006580",8396,8310,86
"2021","Crawley 007","E02006581",10355,10242,113
"2021","Crawley 008","E02006582",7848,7841,7
"2021","Crawley 009","E02006583",9481,9435,46
"2021","Crawley 010","E02006584",7840,7838,2
"2021","Crawley 011","E02006585",8314,8314,0
"2021","Crawley 012","E02006586",8037,8031,6
"2021","Crawley 013","E02006587",8533,8533,0
"2021","Horsham 001","E02006588",10410,10263,147
"2021","Horsham 002","E02006589",11343,11264,79
"2021","Horsham 003","E02006590",8783,8667,116
"2021","Horsham 004","E02006591",8272,8204,68
"2021","Horsham 005","E02006592",6678,6335,343
"2021","Horsham 006","E02006593",11286,11054,232
"2021","Horsham 007","E02006594",10941,10941,0
"2021","Horsham 008","E02006595",8958,8110,848
"2021","Horsham 009","E02006596",9363,9363,0
"2021","Horsham 010","E02006597",12394,12368,26
"2021","Horsham 011","E02006598",5454,5351,103
"2021","Horsham 012","E02006599",6890,6890,0
"2021","Horsham 013","E02006600",9866,9774,92
"2021","Horsham 014","E02006601",8956,8751,205
"2021","Horsham 015","E02006602",8716,8529,187
"2021","Horsham 016","E02006603",8468,8394,74
"2021","Mid Sussex 001","E02006604",13280,13165,115
"2021","Mid Sussex 002","E02006605",6365,6302,63
"2021","Mid Sussex 003","E02006606",8350,8236,114
"2021","Mid Sussex 004","E02006607",7960,7859,101
"2021","Mid Sussex 005","E02006608",6334,6310,24
"2021","Mid Sussex 006","E02006609",6889,6580,309
"2021","Mid Sussex 007","E02006610",7869,7665,204
"2021","Mid Sussex 008","E02006611",11479,11386,93
"2021","Mid Sussex 009","E02006612",11827,11590,237
"2021","Mid Sussex 010","E02006613",7751,7751,0
"2021","Mid Sussex 011","E02006614",12852,12851,1
"2021","Mid Sussex 012","E02006615",7061,7007,54
"2021","Mid Sussex 013","E02006616",9842,9812,30
"2021","Mid Sussex 014","E02006617",9134,9081,53
"2021","Mid Sussex 015","E02006618",6456,6296,160
"2021","Mid Sussex 016","E02006619",9079,8722,357
"2021","Mid Sussex 017","E02006620",10039,10005,34
"2021","Worthing 001","E02006621",7693,7563,130
"2021","Worthing 002","E02006622",7889,7832,57
"2021","Worthing 003","E02006623",8088,8055,33
"2021","Worthing 004","E02006624",7331,7307,24
"2021","Worthing 005","E02006625",8051,8050,1
"2021","Worthing 006","E02006626",10187,10187,0
"2021","Worthing 007","E02006627",9605,9586,19
"2021","Worthing 008","E02006628",8942,8892,50
"2021","Worthing 009","E02006629",7811,7627,184
"2021","Worthing 010","E02006630",8906,8219,687
"2021","Worthing 011","E02006631",10186,9858,328
"2021","Worthing 012","E02006632",8245,8128,117
"2021","Worthing 013","E02006633",8406,8355,51
"2021","Bath and North East Somerset 001","E02002985",6789,6665,124
"2021","Bath and North East Somerset 002","E02002986",7036,7015,21
"2021","Bath and North East Somerset 003","E02002987",5771,5745,26
"2021","Bath and North East Somerset 004","E02002988",5575,5509,66
"2021","Bath and North East Somerset 005","E02002989",5548,5527,21
"2021","Bath and North East Somerset 006","E02002990",5857,5842,15
"2021","Bath and North East Somerset 007","E02002991",10998,10475,523
"2021","Bath and North East Somerset 008","E02002992",5731,5672,59
"2021","Bath and North East Somerset 009","E02002993",6032,5275,757
"2021","Bath and North East Somerset 010","E02002994",10557,10264,293
"2021","Bath and North East Somerset 011","E02002995",5787,5546,241
"2021","Bath and North East Somerset 012","E02002996",11773,8524,3249
"2021","Bath and North East Somerset 013","E02002997",8330,7644,686
"2021","Bath and North East Somerset 014","E02002998",5979,5908,71
"2021","Bath and North East Somerset 015","E02002999",5641,5641,0
"2021","Bath and North East Somerset 016","E02003000",9572,9461,111
"2021","Bath and North East Somerset 017","E02003001",5543,5441,102
"2021","Bath and North East Somerset 018","E02003002",6328,6271,57
"2021","Bath and North East Somerset 019","E02003003",5923,5855,68
"2021","Bath and North East Somerset 020","E02003004",7384,7294,90
"2021","Bath and North East Somerset 021","E02003005",6772,6767,5
"2021","Bath and North East Somerset 022","E02003006",10003,8809,1194
"2021","Bath and North East Somerset 023","E02003007",9594,9527,67
"2021","Bath and North East Somerset 024","E02003008",6149,6123,26
"2021","Bath and North East Somerset 025","E02003009",6216,6197,19
"2021","Bath and North East Somerset 026","E02003010",6543,6501,42
"2021","Bath and North East Somerset 027","E02003011",5980,5940,40
"2021","Bristol 001","E02003012",12095,12027,68
"2021","Bristol 002","E02003013",12667,12582,85
"2021","Bristol 003","E02003014",8507,8500,7
"2021","Bristol 004","E02003015",6865,6853,12
"2021","Bristol 005","E02003016",8046,8005,41
"2021","Bristol 006","E02003017",6309,6167,142
"2021","Bristol 007","E02003018",6221,6221,0
"2021","Bristol 008","E02003019",10248,10137,111
"2021","Bristol 009","E02003020",6479,6142,337
"2021","Bristol 010","E02003021",7488,7389,99
"2021","Bristol 011","E02003022",6247,6234,13
"2021","Bristol 012","E02003023",6678,6184,494
"2021","Bristol 013","E02003024",10014,9773,241
"2021","Bristol 014","E02003025",7721,7615,106
"2021","Bristol 015","E02003026",10256,7725,2531
"2021","Bristol 016","E02003027",13214,12936,278
"2021","Bristol 017","E02003028",8769,8631,138
"2021","Bristol 018","E02003029",6690,6666,24
"2021","Bristol 019","E02003030",7929,7880,49
"2021","Bristol 020","E02003031",10477,10331,146
"2021","Bristol 021","E02003032",8446,8427,19
"2021","Bristol 022","E02003033",8785,8743,42
"2021","Bristol 025","E02003036",8681,7707,974
"2021","Bristol 026","E02003037",9140,8949,191
"2021","Bristol 027","E02003038",6940,6922,18
"2021","Bristol 028","E02003039",8796,8703,93
"2021","Bristol 029","E02003040",9861,9736,125
"2021","Bristol 030","E02003041",6209,5877,332
"2021","Bristol 033","E02003044",6135,6117,18
"2021","Bristol 034","E02003045",6924,5971,953
"2021","Bristol 035","E02003046",9994,9972,22
"2021","Bristol 036","E02003047",11125,11048,77
"2021","Bristol 037","E02003048",6831,6830,1
"2021","Bristol 038","E02003049",7922,7853,69
"2021","Bristol 039","E02003050",10185,10073,112
"2021","Bristol 040","E02003051",7584,7584,0
"2021","Bristol 041","E02003052",7223,7222,1
"2021","Bristol 042","E02003053",8640,8605,35
"2021","Bristol 043","E02003054",6904,6750,154
"2021","Bristol 044","E02003055",9130,9128,2
"2021","Bristol 045","E02003056",7690,7689,1
"2021","Bristol 046","E02003057",6218,6179,39
"2021","Bristol 047","E02003058",9862,9784,78
"2021","Bristol 048","E02003059",6734,6734,0
"2021","Bristol 049","E02003060",11085,10988,97
"2021","Bristol 050","E02003061",6266,6255,11
"2021","Bristol 051","E02003062",5966,5920,46
"2021","Bristol 052","E02003063",7280,7280,0
"2021","Bristol 053","E02003064",7408,7397,11
"2021","Bristol 054","E02006887",10108,8634,1474
"2021","Bristol 055","E02006888",7278,7269,9
"2021","Bristol 056","E02006889",8230,8226,4
"2021","Bristol 057","E02006890",9168,9162,6
"2021","Bristol 058","E02006949",6689,6684,5
"2021","Bristol 059","E02006950",7548,7361,187
"2021","Bristol 060","E02006951",8536,6658,1878
"2021","Bristol 061","E02006952",8021,5416,2605
"2021","North Somerset 001","E02003065",9782,9754,28
"2021","North Somerset 002","E02003066",6141,6107,34
"2021","North Somerset 003","E02003067",8183,8137,46
"2021","North Somerset 004","E02003068",6386,6356,30
"2021","North Somerset 005","E02003069",5678,5483,195
"2021","North Somerset 006","E02003070",13360,13275,85
"2021","North Somerset 007","E02003071",8032,7910,122
"2021","North Somerset 008","E02003072",9249,9194,55
"2021","North Somerset 009","E02003073",6291,6281,10
"2021","North Somerset 010","E02003074",7693,7673,20
"2021","North Somerset 011","E02003075",6198,6180,18
"2021","North Somerset 012","E02003076",9845,9804,41
"2021","North Somerset 013","E02003077",6328,6322,6
"2021","North Somerset 014","E02003078",7362,7326,36
"2021","North Somerset 015","E02003079",9287,9287,0
"2021","North Somerset 016","E02003080",8660,8648,12
"2021","North Somerset 017","E02003081",9391,9391,0
"2021","North Somerset 018","E02003082",9038,8534,504
"2021","North Somerset 020","E02003084",10670,10247,423
"2021","North Somerset 021","E02003085",7866,7846,20
"2021","North Somerset 022","E02003086",6127,5767,360
"2021","North Somerset 023","E02003087",10810,10804,6
"2021","North Somerset 024","E02003088",9045,8854,191
"2021","North Somerset 025","E02003089",5962,5920,42
"2021","North Somerset 026","E02006845",9636,9488,148
"2021","North Somerset 027","E02006846",9709,9709,0
"2021","South Gloucestershire 001","E02003090",9440,9051,389
"2021","South Gloucestershire 002","E02003091",6721,6692,29
"2021","South Gloucestershire 003","E02003092",8755,8228,527
"2021","South Gloucestershire 004","E02003093",6679,6603,76
"2021","South Gloucestershire 005","E02003094",8899,8840,59
"2021","South Gloucestershire 006","E02003095",8612,8522,90
"2021","South Gloucestershire 007","E02003096",6302,6251,51
"2021","South Gloucestershire 008","E02003097",6504,6477,27
"2021","South Gloucestershire 009","E02003098",10030,10030,0
"2021","South Gloucestershire 010","E02003099",7629,7591,38
"2021","South Gloucestershire 012","E02003101",10662,10656,6
"2021","South Gloucestershire 013","E02003102",7163,7139,24
"2021","South Gloucestershire 014","E02003103",7183,7183,0
"2021","South Gloucestershire 015","E02003104",7531,7531,0
"2021","South Gloucestershire 016","E02003105",6406,6301,105
"2021","South Gloucestershire 018","E02003107",11295,11271,24
"2021","South Gloucestershire 019","E02003108",12709,12267,442
"2021","South Gloucestershire 020","E02003109",6219,6219,0
"2021","South Gloucestershire 021","E02003110",12403,12348,55
"2021","South Gloucestershire 022","E02003111",6680,6507,173
"2021","South Gloucestershire 023","E02003112",6541,6532,9
"2021","South Gloucestershire 024","E02003113",10478,10437,41
"2021","South Gloucestershire 025","E02003114",7245,7214,31
"2021","South Gloucestershire 026","E02003115",9713,9594,119
"2021","South Gloucestershire 027","E02003116",7769,7647,122
"2021","South Gloucestershire 028","E02003117",9414,9319,95
"2021","South Gloucestershire 029","E02003118",9901,9824,77
"2021","South Gloucestershire 030","E02003119",10345,10283,62
"2021","South Gloucestershire 031","E02003120",9201,9195,6
"2021","South Gloucestershire 032","E02003121",10118,10117,1
"2021","South Gloucestershire 033","E02007064",7920,7891,29
"2021","South Gloucestershire 034","E02007065",7860,7845,15
"2021","South Gloucestershire 035","E02007066",9163,6654,2509
"2021","South Gloucestershire 036","E02007067",6935,6770,165
"2021","Plymouth 001","E02003122",7305,7225,80
"2021","Plymouth 002","E02003123",8727,8727,0
"2021","Plymouth 003","E02003124",8304,8254,50
"2021","Plymouth 004","E02003125",6029,5991,38
"2021","Plymouth 005","E02003126",8417,7934,483
"2021","Plymouth 006","E02003127",7532,7479,53
"2021","Plymouth 007","E02003128",9179,9097,82
"2021","Plymouth 008","E02003129",6411,6411,0
"2021","Plymouth 009","E02003130",10530,10530,0
"2021","Plymouth 010","E02003131",7287,7287,0
"2021","Plymouth 011","E02003132",8870,8838,32
"2021","Plymouth 012","E02003133",7129,7101,28
"2021","Plymouth 013","E02003134",6937,6937,0
"2021","Plymouth 014","E02003135",7076,6888,188
"2021","Plymouth 015","E02003136",7730,7528,202
"2021","Plymouth 016","E02003137",7865,7588,277
"2021","Plymouth 017","E02003138",7541,7526,15
"2021","Plymouth 018","E02003139",6692,6689,3
"2021","Plymouth 019","E02003140",7813,7724,89
"2021","Plymouth 020","E02003141",7958,7779,179
"2021","Plymouth 021","E02003142",9206,9204,2
"2021","Plymouth 022","E02003143",7324,7324,0
"2021","Plymouth 023","E02003144",8492,7462,1030
"2021","Plymouth 024","E02003145",6674,6278,396
"2021","Plymouth 025","E02003146",8603,8233,370
"2021","Plymouth 026","E02003147",9182,9131,51
"2021","Plymouth 027","E02003148",11316,8334,2982
"2021","Plymouth 028","E02003149",9331,9295,36
"2021","Plymouth 030","E02003151",8365,8224,141
"2021","Plymouth 031","E02003152",11334,11255,79
"2021","Plymouth 032","E02003153",7440,7390,50
"2021","Plymouth 033","E02006989",5350,5290,60
"2021","Plymouth 034","E02006990",6746,6541,205
"2021","Torbay 001","E02003154",7279,7255,24
"2021","Torbay 002","E02003155",5877,5708,169
"2021","Torbay 003","E02003156",10631,10629,2
"2021","Torbay 004","E02003157",6846,6788,58
"2021","Torbay 005","E02003158",5758,5624,134
"2021","Torbay 006","E02003159",6025,5979,46
"2021","Torbay 008","E02003161",7758,7575,183
"2021","Torbay 010","E02003163",8122,7661,461
"2021","Torbay 011","E02003164",9028,8857,171
"2021","Torbay 012","E02003165",7322,7226,96
"2021","Torbay 013","E02003166",12958,12956,2
"2021","Torbay 014","E02003167",9852,9498,354
"2021","Torbay 015","E02003168",7147,7105,42
"2021","Torbay 016","E02003169",6601,6534,67
"2021","Torbay 017","E02003170",9473,9397,76
"2021","Torbay 018","E02003171",7358,7279,79
"2021","Torbay 019","E02006840",11286,11215,71
"2021","Swindon 001","E02003212",8368,8336,32
"2021","Swindon 003","E02003214",6859,6855,4
"2021","Swindon 004","E02003215",6696,6639,57
"2021","Swindon 005","E02003216",9926,9908,18
"2021","Swindon 006","E02003217",7386,7366,20
"2021","Swindon 007","E02003218",6565,6531,34
"2021","Swindon 008","E02003219",13043,12931,112
"2021","Swindon 009","E02003220",10269,10147,122
"2021","Swindon 010","E02003221",7295,7294,1
"2021","Swindon 011","E02003222",6017,6017,0
"2021","Swindon 012","E02003223",10893,10893,0
"2021","Swindon 013","E02003224",8530,8530,0
"2021","Swindon 014","E02003225",6434,6428,6
"2021","Swindon 015","E02003226",10665,10637,28
"2021","Swindon 016","E02003227",7011,7005,6
"2021","Swindon 017","E02003228",7778,7778,0
"2021","Swindon 018","E02003229",5664,5652,12
"2021","Swindon 019","E02003230",8728,8544,184
"2021","Swindon 020","E02003231",8546,8504,42
"2021","Swindon 021","E02003232",8572,8417,155
"2021","Swindon 022","E02003233",8738,8737,1
"2021","Swindon 023","E02003234",8462,8407,55
"2021","Swindon 024","E02003235",9358,9310,48
"2021","Swindon 025","E02003236",12793,12682,111
"2021","Swindon 026","E02006847",9908,9841,67
"2021","Swindon 027","E02006848",8569,8568,1
"2021","Swindon 028","E02006849",10334,10275,59
"2021","Cornwall 010","E02003892",6647,6637,10
"2021","Cornwall 012","E02003893",6607,6564,43
"2021","Cornwall 013","E02003894",8268,8199,69
"2021","Cornwall 016","E02003895",9518,9444,74
"2021","Cornwall 017","E02003896",5941,5837,104
"2021","Cornwall 022","E02003897",5387,5357,30
"2021","Cornwall 023","E02003898",6723,6697,26
"2021","Cornwall 025","E02003899",5281,5222,59
"2021","Cornwall 026","E02003900",7094,7037,57
"2021","Cornwall 028","E02003901",8286,8150,136
"2021","Cornwall 029","E02003902",5284,5197,87
"2021","Cornwall 034","E02003903",6192,6160,32
"2021","Cornwall 037","E02003904",5005,4930,75
"2021","Cornwall 032","E02003905",7157,7093,64
"2021","Cornwall 033","E02003906",6402,6291,111
"2021","Cornwall 040","E02003907",8469,8443,26
"2021","Cornwall 042","E02003908",8458,8378,80
"2021","Cornwall 043","E02003909",10739,10322,417
"2021","Cornwall 044","E02003910",6968,6815,153
"2021","Cornwall 047","E02003911",9116,9105,11
"2021","Cornwall 048","E02003912",8174,8090,84
"2021","Cornwall 056","E02003913",5938,5925,13
"2021","Cornwall 060","E02003914",8476,8071,405
"2021","Cornwall 062","E02003915",8286,7965,321
"2021","Cornwall 063","E02003916",7064,6539,525
"2021","Cornwall 064","E02003917",8347,8347,0
"2021","Cornwall 045","E02003918",7217,7191,26
"2021","Cornwall 046","E02003919",7370,7327,43
"2021","Cornwall 049","E02003920",8260,8197,63
"2021","Cornwall 050","E02003921",6286,6243,43
"2021","Cornwall 051","E02003922",9036,9025,11
"2021","Cornwall 052","E02003923",9524,9414,110
"2021","Cornwall 053","E02003924",7367,7267,100
"2021","Cornwall 055","E02003925",7270,7246,24
"2021","Cornwall 059","E02003926",8332,8298,34
"2021","Cornwall 066","E02003927",10745,9483,1262
"2021","Cornwall 071","E02003928",12172,12102,70
"2021","Cornwall 072","E02003929",6903,6875,28
"2021","Cornwall 073","E02003930",8910,8718,192
"2021","Cornwall 001","E02003931",10596,10492,104
"2021","Cornwall 002","E02003932",7505,7417,88
"2021","Cornwall 003","E02003933",7003,6972,31
"2021","Cornwall 004","E02003934",7199,7164,35
"2021","Cornwall 005","E02003935",10248,10064,184
"2021","Cornwall 006","E02003936",8329,8105,224
"2021","Cornwall 007","E02003937",5274,5215,59
"2021","Cornwall 008","E02003938",6776,6735,41
"2021","Cornwall 009","E02003939",6811,6764,47
"2021","Cornwall 011","E02003940",6376,6315,61
"2021","Cornwall 014","E02003941",8921,8759,162
"2021","Cornwall 015","E02003942",7987,7961,26
"2021","Cornwall 054","E02003943",6882,6814,68
"2021","Cornwall 057","E02003944",10298,10176,122
"2021","Cornwall 058","E02003945",5899,5815,84
"2021","Cornwall 061","E02003946",9470,9381,89
"2021","Cornwall 065","E02003947",6533,6406,127
"2021","Cornwall 067","E02003948",8359,8306,53
"2021","Cornwall 068","E02003949",6562,6488,74
"2021","Cornwall 069","E02003950",5395,5363,32
"2021","Cornwall 070","E02003951",5813,5773,40
"2021","Cornwall 018","E02003952",9735,9636,99
"2021","Cornwall 019","E02003953",10828,10742,86
"2021","Cornwall 020","E02003954",7632,7411,221
"2021","Cornwall 021","E02003955",10077,9979,98
"2021","Cornwall 024","E02003956",7746,7721,25
"2021","Cornwall 027","E02003957",11098,11010,88
"2021","Cornwall 030","E02003958",8203,8194,9
"2021","Cornwall 031","E02003959",6932,6877,55
"2021","Cornwall 035","E02003960",5687,5602,85
"2021","Cornwall 036","E02003961",9603,9595,8
"2021","Cornwall 038","E02003962",7259,7195,64
"2021","Cornwall 039","E02003963",10040,9856,184
"2021","Cornwall 041","E02003964",8015,7940,75
"2021","Isles of Scilly 001","E02006781",2053,2028,25
"2021","Wiltshire 012","E02006634",8569,8498,71
"2021","Wiltshire 019","E02006635",9128,7872,1256
"2021","Wiltshire 024","E02006636",7094,7043,51
"2021","Wiltshire 025","E02006637",11023,10982,41
"2021","Wiltshire 026","E02006638",6368,6356,12
"2021","Wiltshire 028","E02006639",8418,7929,489
"2021","Wiltshire 029","E02006640",7317,7308,9
"2021","Wiltshire 034","E02006641",8242,7877,365
"2021","Wiltshire 038","E02006642",5669,5585,84
"2021","Wiltshire 001","E02006644",6814,6809,5
"2021","Wiltshire 002","E02006645",7879,7808,71
"2021","Wiltshire 003","E02006646",8238,8111,127
"2021","Wiltshire 004","E02006647",6105,6076,29
"2021","Wiltshire 005","E02006648",6285,6234,51
"2021","Wiltshire 006","E02006649",7668,7591,77
"2021","Wiltshire 007","E02006650",13999,11904,2095
"2021","Wiltshire 008","E02006651",7282,7109,173
"2021","Wiltshire 009","E02006652",9709,9615,94
"2021","Wiltshire 010","E02006653",9851,9837,14
"2021","Wiltshire 011","E02006654",9585,9440,145
"2021","Wiltshire 013","E02006655",8178,8003,175
"2021","Wiltshire 014","E02006656",6706,6704,2
"2021","Wiltshire 015","E02006657",11116,10751,365
"2021","Wiltshire 016","E02006658",7954,7920,34
"2021","Wiltshire 017","E02006659",8364,8206,158
"2021","Wiltshire 018","E02006660",13531,13267,264
"2021","Wiltshire 045","E02006661",9964,8621,1343
"2021","Wiltshire 046","E02006662",7302,7302,0
"2021","Wiltshire 048","E02006663",12997,12818,179
"2021","Wiltshire 049","E02006664",6392,6387,5
"2021","Wiltshire 050","E02006665",6750,6679,71
"2021","Wiltshire 051","E02006666",6868,6809,59
"2021","Wiltshire 052","E02006667",7623,7623,0
"2021","Wiltshire 053","E02006668",5889,5830,59
"2021","Wiltshire 054","E02006669",10388,10384,4
"2021","Wiltshire 055","E02006670",6905,6789,116
"2021","Wiltshire 056","E02006671",6156,5886,270
"2021","Wiltshire 057","E02006672",9500,9268,232
"2021","Wiltshire 058","E02006673",5038,4960,78
"2021","Wiltshire 059","E02006674",6048,5864,184
"2021","Wiltshire 060","E02006675",8044,8038,6
"2021","Wiltshire 061","E02006676",6163,6065,98
"2021","Wiltshire 062","E02006677",7944,7866,78
"2021","Wiltshire 020","E02006678",7814,7810,4
"2021","Wiltshire 021","E02006679",12444,12266,178
"2021","Wiltshire 022","E02006680",7603,7474,129
"2021","Wiltshire 023","E02006681",5945,5904,41
"2021","Wiltshire 027","E02006682",10406,10309,97
"2021","Wiltshire 030","E02006683",8044,7981,63
"2021","Wiltshire 031","E02006684",6865,6795,70
"2021","Wiltshire 032","E02006685",10155,10064,91
"2021","Wiltshire 033","E02006686",5427,5344,83
"2021","Wiltshire 035","E02006687",8118,8118,0
"2021","Wiltshire 036","E02006688",5551,5525,26
"2021","Wiltshire 037","E02006689",7016,7005,11
"2021","Wiltshire 039","E02006690",6997,6985,12
"2021","Wiltshire 042","E02006692",5588,5348,240
"2021","Wiltshire 043","E02006693",6471,6467,4
"2021","Wiltshire 044","E02006694",6117,5895,222
"2021","Wiltshire 047","E02006695",6434,6307,127
"2021","Wiltshire 063","E02007023",7841,7772,69
"2021","Wiltshire 064","E02007024",6955,6830,125
"2021","Wiltshire 065","E02007025",8617,8142,475
"2021","Wiltshire 066","E02007026",8867,7775,1092
"2021","Bournemouth, Christchurch and Poole 003","E02003172",6499,6496,3
"2021","Bournemouth, Christchurch and Poole 005","E02003173",6836,6769,67
"2021","Bournemouth, Christchurch and Poole 006","E02003174",8328,8317,11
"2021","Bournemouth, Christchurch and Poole 007","E02003175",9431,9368,63
"2021","Bournemouth, Christchurch and Poole 010","E02003176",7494,7478,16
"2021","Bournemouth, Christchurch and Poole 009","E02003177",8452,8444,8
"2021","Bournemouth, Christchurch and Poole 011","E02003178",8755,8714,41
"2021","Bournemouth, Christchurch and Poole 012","E02003179",6451,6428,23
"2021","Bournemouth, Christchurch and Poole 015","E02003180",10118,10004,114
"2021","Bournemouth, Christchurch and Poole 017","E02003181",8839,8764,75
"2021","Bournemouth, Christchurch and Poole 020","E02003182",6575,6522,53
"2021","Bournemouth, Christchurch and Poole 028","E02003183",7347,7157,190
"2021","Bournemouth, Christchurch and Poole 027","E02003184",8098,7957,141
"2021","Bournemouth, Christchurch and Poole 026","E02003185",7600,7574,26
"2021","Bournemouth, Christchurch and Poole 025","E02003186",9436,9403,33
"2021","Bournemouth, Christchurch and Poole 035","E02003187",9518,9421,97
"2021","Bournemouth, Christchurch and Poole 038","E02003188",13199,10552,2647
"2021","Bournemouth, Christchurch and Poole 036","E02003189",8501,8248,253
"2021","Bournemouth, Christchurch and Poole 037","E02003190",10376,10052,324
"2021","Bournemouth, Christchurch and Poole 039","E02003191",8370,8269,101
"2021","Bournemouth, Christchurch and Poole 041","E02003192",13187,10124,3063
"2021","Bournemouth, Christchurch and Poole 001","E02003194",6332,5825,507
"2021","Bournemouth, Christchurch and Poole 008","E02003195",5924,5877,47
"2021","Bournemouth, Christchurch and Poole 004","E02003196",10289,10153,136
"2021","Bournemouth, Christchurch and Poole 013","E02003197",6837,6836,1
"2021","Bournemouth, Christchurch and Poole 016","E02003198",7550,7488,62
"2021","Bournemouth, Christchurch and Poole 021","E02003199",9471,9409,62
"2021","Bournemouth, Christchurch and Poole 022","E02003200",10404,10354,50
"2021","Bournemouth, Christchurch and Poole 023","E02003201",11161,11146,15
"2021","Bournemouth, Christchurch and Poole 029","E02003202",6116,5924,192
"2021","Bournemouth, Christchurch and Poole 032","E02003203",7603,7599,4
"2021","Bournemouth, Christchurch and Poole 030","E02003204",9291,9165,126
"2021","Bournemouth, Christchurch and Poole 034","E02003205",8459,8458,1
"2021","Bournemouth, Christchurch and Poole 043","E02003206",10044,9980,64
"2021","Bournemouth, Christchurch and Poole 042","E02003207",7432,7311,121
"2021","Bournemouth, Christchurch and Poole 044","E02003208",11430,11093,337
"2021","Bournemouth, Christchurch and Poole 046","E02003209",6781,6731,50
"2021","Bournemouth, Christchurch and Poole 047","E02003210",9807,9718,89
"2021","Bournemouth, Christchurch and Poole 048","E02003211",8540,8243,297
"2021","Bournemouth, Christchurch and Poole 002","E02004236",6223,6154,69
"2021","Bournemouth, Christchurch and Poole 014","E02004237",8143,8015,128
"2021","Bournemouth, Christchurch and Poole 019","E02004238",7483,7420,63
"2021","Bournemouth, Christchurch and Poole 018","E02004239",6240,6192,48
"2021","Bournemouth, Christchurch and Poole 024","E02004240",6109,6109,0
"2021","Bournemouth, Christchurch and Poole 031","E02004241",9470,9390,80
"2021","Bournemouth, Christchurch and Poole 033","E02004242",6467,6417,50
"2021","Bournemouth, Christchurch and Poole 040","E02006883",5721,5581,140
"2021","Bournemouth, Christchurch and Poole 045","E02006885",7458,7015,443
"2021","Dorset 007","E02004243",6448,6425,23
"2021","Dorset 010","E02004244",7689,7667,22
"2021","Dorset 012","E02004245",7487,7416,71
"2021","Dorset 015","E02004246",7902,7770,132
"2021","Dorset 013","E02004247",6080,6054,26
"2021","Dorset 016","E02004248",7403,7306,97
"2021","Dorset 017","E02004249",6027,6026,1
"2021","Dorset 018","E02004250",7792,7707,85
"2021","Dorset 020","E02004251",6326,6295,31
"2021","Dorset 021","E02004252",7987,7898,89
"2021","Dorset 024","E02004253",9801,9624,177
"2021","Dorset 025","E02004254",10374,10374,0
"2021","Dorset 001","E02004255",7315,7241,74
"2021","Dorset 002","E02004256",9186,9099,87
"2021","Dorset 003","E02004257",9158,9057,101
"2021","Dorset 005","E02004258",10439,10319,120
"2021","Dorset 006","E02004259",7156,6371,785
"2021","Dorset 009","E02004260",9024,7740,1284
"2021","Dorset 011","E02004261",10359,10245,114
"2021","Dorset 014","E02004262",7889,7696,193
"2021","Dorset 027","E02004263",5834,5815,19
"2021","Dorset 028","E02004264",8649,8616,33
"2021","Dorset 033","E02004265",8498,8425,73
"2021","Dorset 035","E02004266",8330,8009,321
"2021","Dorset 039","E02004267",5057,4954,103
"2021","Dorset 042","E02004268",9426,9245,181
"2021","Dorset 004","E02004269",10361,9264,1097
"2021","Dorset 008","E02004270",7796,7718,78
"2021","Dorset 019","E02004271",10043,10007,36
"2021","Dorset 022","E02004272",12206,12035,171
"2021","Dorset 023","E02004273",7173,7047,126
"2021","Dorset 026","E02004274",6415,6377,38
"2021","Dorset 029","E02004275",7665,7644,21
"2021","Dorset 030","E02004276",5553,5484,69
"2021","Dorset 034","E02004278",8817,8813,4
"2021","Dorset 036","E02004279",8023,7979,44
"2021","Dorset 037","E02004280",8375,8302,73
"2021","Dorset 038","E02004281",7666,7650,16
"2021","Dorset 040","E02004282",8848,8704,144
"2021","Dorset 041","E02004283",9066,8982,84
"2021","Dorset 044","E02004284",9524,9385,139
"2021","Dorset 043","E02004285",7705,7625,80
"2021","Dorset 045","E02004286",5032,4959,73
"2021","Dorset 046","E02004287",5574,5560,14
"2021","Dorset 047","E02004288",6196,5211,985
"2021","Dorset 048","E02004289",7361,7361,0
"2021","Dorset 031","E02007006",5756,5550,206
"2021","Dorset 032","E02007007",6786,6685,101
"2021","East Devon 001","E02004129",6081,5976,105
"2021","East Devon 002","E02004130",6171,6125,46
"2021","East Devon 003","E02004131",5491,5436,55
"2021","East Devon 004","E02004132",8894,8874,20
"2021","East Devon 005","E02004133",9813,9704,109
"2021","East Devon 007","E02004135",8360,8239,121
"2021","East Devon 008","E02004136",9495,9429,66
"2021","East Devon 009","E02004137",5325,5306,19
"2021","East Devon 010","E02004138",7688,7451,237
"2021","East Devon 011","E02004139",7004,6983,21
"2021","East Devon 012","E02004140",5272,5145,127
"2021","East Devon 013","E02004141",6259,6104,155
"2021","East Devon 014","E02004142",6390,5638,752
"2021","East Devon 015","E02004143",6344,6296,48
"2021","East Devon 016","E02004144",6864,6817,47
"2021","East Devon 017","E02004145",6106,6030,76
"2021","East Devon 018","E02004146",7541,7535,6
"2021","East Devon 019","E02004147",6974,6930,44
"2021","East Devon 020","E02004148",7776,7434,342
"2021","East Devon 021","E02007027",10871,10807,64
"2021","East Devon 022","E02007028",6110,6110,0
"2021","Exeter 001","E02004149",11065,6300,4765
"2021","Exeter 002","E02004150",7096,7077,19
"2021","Exeter 003","E02004151",10072,9989,83
"2021","Exeter 004","E02004152",9733,8428,1305
"2021","Exeter 005","E02004153",7487,7485,2
"2021","Exeter 006","E02004154",8295,7940,355
"2021","Exeter 007","E02004155",7459,7455,4
"2021","Exeter 008","E02004156",11622,8974,2648
"2021","Exeter 009","E02004157",6349,6189,160
"2021","Exeter 010","E02004158",8064,8033,31
"2021","Exeter 011","E02004159",12769,12722,47
"2021","Exeter 012","E02004160",7213,7104,109
"2021","Exeter 013","E02004161",8300,8251,49
"2021","Exeter 014","E02004162",6937,6761,176
"2021","Exeter 015","E02004163",8251,8232,19
"2021","Mid Devon 001","E02004164",6803,6743,60
"2021","Mid Devon 002","E02004165",8876,8812,64
"2021","Mid Devon 003","E02004166",6780,6762,18
"2021","Mid Devon 004","E02004167",7164,6956,208
"2021","Mid Devon 005","E02004168",6252,6235,17
"2021","Mid Devon 006","E02004169",7579,7551,28
"2021","Mid Devon 007","E02004170",8808,8706,102
"2021","Mid Devon 008","E02004171",8523,8501,22
"2021","Mid Devon 009","E02004172",6500,6466,34
"2021","Mid Devon 010","E02004173",7492,7414,78
"2021","Mid Devon 011","E02004174",8077,8038,39
"2021","North Devon 001","E02004175",5146,5004,142
"2021","North Devon 002","E02004176",5566,5421,145
"2021","North Devon 003","E02004177",5891,5814,77
"2021","North Devon 004","E02004178",5255,5184,71
"2021","North Devon 005","E02004179",9207,8827,380
"2021","North Devon 006","E02004180",6513,6416,97
"2021","North Devon 007","E02004181",5728,5674,54
"2021","North Devon 008","E02004182",6272,6245,27
"2021","North Devon 009","E02004183",5847,5781,66
"2021","North Devon 010","E02004184",8562,8479,83
"2021","North Devon 011","E02004185",6699,6639,60
"2021","North Devon 012","E02004186",10159,10157,2
"2021","North Devon 013","E02004187",10753,10507,246
"2021","North Devon 014","E02004188",7016,6969,47
"2021","South Hams 001","E02004189",6132,6013,119
"2021","South Hams 002","E02004190",8707,8604,103
"2021","South Hams 003","E02004191",9030,8980,50
"2021","South Hams 004","E02004192",7705,7690,15
"2021","South Hams 005","E02004193",11904,11798,106
"2021","South Hams 006","E02004194",7382,7296,86
"2021","South Hams 007","E02004195",5260,5049,211
"2021","South Hams 008","E02004196",8103,8053,50
"2021","South Hams 009","E02004197",7233,7202,31
"2021","South Hams 010","E02004198",6285,6197,88
"2021","South Hams 011","E02004199",5762,5732,30
"2021","South Hams 012","E02004200",5122,5103,19
"2021","Teignbridge 001","E02004201",5487,5425,62
"2021","Teignbridge 002","E02004202",8695,8638,57
"2021","Teignbridge 003","E02004203",5743,5661,82
"2021","Teignbridge 004","E02004204",9823,9799,24
"2021","Teignbridge 005","E02004205",8591,8471,120
"2021","Teignbridge 006","E02004206",6673,6518,155
"2021","Teignbridge 007","E02004207",6721,6719,2
"2021","Teignbridge 008","E02004208",8331,8245,86
"2021","Teignbridge 009","E02004209",9234,9183,51
"2021","Teignbridge 010","E02004210",6602,6443,159
"2021","Teignbridge 011","E02004211",6597,6483,114
"2021","Teignbridge 012","E02004212",6170,6118,52
"2021","Teignbridge 013","E02004213",9156,8382,774
"2021","Teignbridge 014","E02004214",6084,6044,40
"2021","Teignbridge 015","E02004215",5827,5668,159
"2021","Teignbridge 016","E02004216",5556,5555,1
"2021","Teignbridge 017","E02004217",7790,7723,67
"2021","Teignbridge 018","E02004218",6125,6111,14
"2021","Teignbridge 019","E02004219",5590,5512,78
"2021","Torridge 001","E02004220",5981,5942,39
"2021","Torridge 002","E02004221",6370,6191,179
"2021","Torridge 003","E02004222",5738,5661,77
"2021","Torridge 004","E02004223",13021,12956,65
"2021","Torridge 005","E02004224",6447,6378,69
"2021","Torridge 006","E02004225",5801,5706,95
"2021","Torridge 007","E02004226",7305,7278,27
"2021","Torridge 008","E02004227",10184,10070,114
"2021","Torridge 009","E02004228",7269,7142,127
"2021","West Devon 001","E02004229",9954,9808,146
"2021","West Devon 002","E02004230",7710,7651,59
"2021","West Devon 003","E02004231",7087,6505,582
"2021","West Devon 004","E02004232",6904,6810,94
"2021","West Devon 005","E02004233",12672,12320,352
"2021","West Devon 006","E02004234",6224,6084,140
"2021","West Devon 007","E02004235",6543,6470,73
"2021","Cheltenham 001","E02004600",5561,5553,8
"2021","Cheltenham 002","E02004601",6147,5771,376
"2021","Cheltenham 003","E02004602",6733,6614,119
"2021","Cheltenham 004","E02004603",8096,7551,545
"2021","Cheltenham 005","E02004604",8314,8236,78
"2021","Cheltenham 006","E02004605",5869,5866,3
"2021","Cheltenham 007","E02004606",10439,10295,144
"2021","Cheltenham 008","E02004607",9545,9416,129
"2021","Cheltenham 009","E02004608",9913,8638,1275
"2021","Cheltenham 010","E02004609",7153,7088,65
"2021","Cheltenham 011","E02004610",7577,7045,532
"2021","Cheltenham 012","E02004611",12197,12107,90
"2021","Cheltenham 013","E02004612",9340,9340,0
"2021","Cheltenham 014","E02004613",6387,6333,54
"2021","Cheltenham 015","E02004614",5566,5432,134
"2021","Cotswold 001","E02004615",8698,8651,47
"2021","Cotswold 002","E02004616",10008,9945,63
"2021","Cotswold 003","E02004617",9511,9468,43
"2021","Cotswold 004","E02004618",7269,7138,131
"2021","Cotswold 005","E02004619",7192,7147,45
"2021","Cotswold 006","E02004620",8409,8409,0
"2021","Cotswold 007","E02004621",6129,5817,312
"2021","Cotswold 008","E02004622",7509,7297,212
"2021","Cotswold 009","E02004623",9264,9223,41
"2021","Cotswold 010","E02004624",6583,6541,42
"2021","Cotswold 011","E02004625",10261,10132,129
"2021","Forest of Dean 001","E02004626",9967,8929,1038
"2021","Forest of Dean 002","E02004627",6376,6356,20
"2021","Forest of Dean 003","E02004628",7908,7845,63
"2021","Forest of Dean 004","E02004629",12961,12923,38
"2021","Forest of Dean 005","E02004630",6587,6356,231
"2021","Forest of Dean 006","E02004631",5103,5057,46
"2021","Forest of Dean 007","E02004632",10854,10809,45
"2021","Forest of Dean 008","E02004633",8325,8313,12
"2021","Forest of Dean 009","E02004634",11303,11258,45
"2021","Forest of Dean 010","E02004635",7621,7244,377
"2021","Gloucester 001","E02004636",7865,7694,171
"2021","Gloucester 002","E02004637",9329,8804,525
"2021","Gloucester 003","E02004638",5905,5817,88
"2021","Gloucester 004","E02004639",11551,11087,464
"2021","Gloucester 005","E02004640",8614,8607,7
"2021","Gloucester 006","E02004641",7382,7361,21
"2021","Gloucester 007","E02004642",12101,12060,41
"2021","Gloucester 008","E02004643",8243,8181,62
"2021","Gloucester 009","E02004644",9145,9104,41
"2021","Gloucester 010","E02004645",9063,9038,25
"2021","Gloucester 011","E02004646",9220,9108,112
"2021","Gloucester 012","E02004647",6173,6066,107
"2021","Gloucester 013","E02004648",5681,5668,13
"2021","Gloucester 014","E02004649",7314,7226,88
"2021","Gloucester 015","E02004650",14831,14800,31
"2021","Stroud 001","E02004651",11162,11147,15
"2021","Stroud 002","E02004652",6674,6588,86
"2021","Stroud 003","E02004653",7799,7607,192
"2021","Stroud 004","E02004654",11501,11362,139
"2021","Stroud 005","E02004655",8069,7845,224
"2021","Stroud 006","E02004656",11348,11268,80
"2021","Stroud 007","E02004657",6731,6729,2
"2021","Stroud 008","E02004658",6284,6277,7
"2021","Stroud 009","E02004659",7127,7097,30
"2021","Stroud 010","E02004660",6675,6546,129
"2021","Stroud 011","E02004661",8521,8521,0
"2021","Stroud 012","E02004662",6567,6498,69
"2021","Stroud 013","E02004663",6496,6385,111
"2021","Stroud 014","E02004664",7463,7388,75
"2021","Stroud 015","E02004665",8690,8629,61
"2021","Tewkesbury 001","E02004666",12084,11981,103
"2021","Tewkesbury 002","E02004667",10664,10619,45
"2021","Tewkesbury 003","E02004668",9107,9092,15
"2021","Tewkesbury 004","E02004669",7498,7448,50
"2021","Tewkesbury 006","E02004671",7132,7116,16
"2021","Tewkesbury 007","E02004672",12351,12201,150
"2021","Tewkesbury 008","E02004673",7768,7683,85
"2021","Tewkesbury 009","E02004674",12252,12124,128
"2021","Tewkesbury 010","E02007034",8215,8197,18
"2021","Tewkesbury 011","E02007035",7820,7815,5
"2021","Mendip 001","E02006047",8758,8722,36
"2021","Mendip 002","E02006048",7182,6988,194
"2021","Mendip 003","E02006049",7214,7158,56
"2021","Mendip 004","E02006050",8795,8688,107
"2021","Mendip 005","E02006051",8473,8170,303
"2021","Mendip 006","E02006052",7747,7570,177
"2021","Mendip 007","E02006053",11148,11102,46
"2021","Mendip 008","E02006054",8317,8291,26
"2021","Mendip 009","E02006055",9085,9032,53
"2021","Mendip 010","E02006056",7790,7720,70
"2021","Mendip 011","E02006057",7640,7435,205
"2021","Mendip 012","E02006058",8792,7902,890
"2021","Mendip 013","E02006059",6933,6890,43
"2021","Mendip 014","E02006060",8215,8149,66
"2021","Sedgemoor 001","E02006061",9365,9215,150
"2021","Sedgemoor 002","E02006062",11059,10896,163
"2021","Sedgemoor 003","E02006063",6910,6910,0
"2021","Sedgemoor 004","E02006064",7780,7505,275
"2021","Sedgemoor 005","E02006065",8877,8859,18
"2021","Sedgemoor 006","E02006066",8514,8514,0
"2021","Sedgemoor 007","E02006067",7133,6870,263
"2021","Sedgemoor 008","E02006068",7869,7833,36
"2021","Sedgemoor 009","E02006069",10576,10443,133
"2021","Sedgemoor 010","E02006070",8826,8771,55
"2021","Sedgemoor 011","E02006071",9577,9481,96
"2021","Sedgemoor 012","E02006072",9364,9340,24
"2021","Sedgemoor 013","E02006073",7827,7722,105
"2021","Sedgemoor 014","E02006074",11665,11574,91
"2021","South Somerset 001","E02006075",5344,5028,316
"2021","South Somerset 002","E02006076",9088,8924,164
"2021","South Somerset 003","E02006077",6237,6187,50
"2021","South Somerset 004","E02006078",6277,6177,100
"2021","South Somerset 005","E02006079",8366,8297,69
"2021","South Somerset 006","E02006080",6923,5935,988
"2021","South Somerset 007","E02006081",5766,5764,2
"2021","South Somerset 008","E02006082",7085,7083,2
"2021","South Somerset 009","E02006083",5602,5563,39
"2021","South Somerset 010","E02006084",7463,7428,35
"2021","South Somerset 011","E02006085",7744,7744,0
"2021","South Somerset 012","E02006086",7726,7624,102
"2021","South Somerset 013","E02006087",6012,5939,73
"2021","South Somerset 014","E02006088",7865,7851,14
"2021","South Somerset 015","E02006089",7215,7072,143
"2021","South Somerset 016","E02006090",7200,7071,129
"2021","South Somerset 017","E02006091",9965,9908,57
"2021","South Somerset 018","E02006092",6478,6461,17
"2021","South Somerset 019","E02006093",8765,8656,109
"2021","South Somerset 020","E02006094",5415,5394,21
"2021","South Somerset 021","E02006095",8370,8313,57
"2021","South Somerset 022","E02006096",7349,7302,47
"2021","South Somerset 023","E02006097",6940,6872,68
"2021","South Somerset 024","E02006098",7470,7431,39
"2021","Somerset West and Taunton 006","E02006099",7167,7095,72
"2021","Somerset West and Taunton 007","E02006100",8220,7659,561
"2021","Somerset West and Taunton 013","E02006101",5756,5697,59
"2021","Somerset West and Taunton 010","E02006102",6901,6896,5
"2021","Somerset West and Taunton 009","E02006103",7988,7988,0
"2021","Somerset West and Taunton 008","E02006104",10737,10567,170
"2021","Somerset West and Taunton 011","E02006105",11305,11241,64
"2021","Somerset West and Taunton 012","E02006106",9929,9631,298
"2021","Somerset West and Taunton 014","E02006107",8396,8339,57
"2021","Somerset West and Taunton 015","E02006108",8667,8358,309
"2021","Somerset West and Taunton 016","E02006109",7973,7959,14
"2021","Somerset West and Taunton 018","E02006110",10520,10359,161
"2021","Somerset West and Taunton 017","E02006111",10655,10288,367
"2021","Somerset West and Taunton 019","E02006112",8289,7888,401
"2021","Somerset West and Taunton 001","E02006113",7437,7195,242
"2021","Somerset West and Taunton 002","E02006114",6384,6113,271
"2021","Somerset West and Taunton 003","E02006115",7552,7544,8
"2021","Somerset West and Taunton 004","E02006116",7971,7878,93
"2021","Somerset West and Taunton 005","E02006117",5595,5561,34
"2021","Isle of Anglesey 001","W02000001",8404,8358,46
"2021","Isle of Anglesey 002","W02000002",6364,6330,34
"2021","Isle of Anglesey 003","W02000003",10630,10585,45
"2021","Isle of Anglesey 004","W02000004",7399,7339,60
"2021","Isle of Anglesey 005","W02000005",8161,8028,133
"2021","Isle of Anglesey 006","W02000006",7039,7022,17
"2021","Isle of Anglesey 007","W02000007",6894,6746,148
"2021","Isle of Anglesey 008","W02000008",5952,5828,124
"2021","Isle of Anglesey 009","W02000009",8032,7944,88
"2021","Gwynedd 001","W02000010",8615,6354,2261
"2021","Gwynedd 002","W02000011",8377,8277,100
"2021","Gwynedd 003","W02000012",8209,8116,93
"2021","Gwynedd 004","W02000013",6425,6365,60
"2021","Gwynedd 005","W02000014",6742,6664,78
"2021","Gwynedd 006","W02000015",8515,8395,120
"2021","Gwynedd 007","W02000016",6359,6226,133
"2021","Gwynedd 008","W02000017",7576,7534,42
"2021","Gwynedd 009","W02000018",6081,6034,47
"2021","Gwynedd 010","W02000019",6660,6494,166
"2021","Gwynedd 011","W02000020",6483,6328,155
"2021","Gwynedd 012","W02000021",7753,7665,88
"2021","Gwynedd 013","W02000022",5551,5494,57
"2021","Gwynedd 014","W02000023",5284,5257,27
"2021","Gwynedd 015","W02000024",5679,5636,43
"2021","Gwynedd 016","W02000025",6128,5989,139
"2021","Gwynedd 017","W02000026",6956,6854,102
"2021","Conwy 001","W02000027",8420,8045,375
"2021","Conwy 002","W02000028",6708,6620,88
"2021","Conwy 003","W02000029",6000,5787,213
"2021","Conwy 004","W02000030",5882,5797,85
"2021","Conwy 005","W02000031",8172,8099,73
"2021","Conwy 006","W02000032",8387,8284,103
"2021","Conwy 007","W02000033",6957,6697,260
"2021","Conwy 008","W02000034",7667,7461,206
"2021","Conwy 009","W02000035",8896,8816,80
"2021","Conwy 010","W02000036",11288,11171,117
"2021","Conwy 011","W02000037",7196,7194,2
"2021","Conwy 012","W02000038",6209,6185,24
"2021","Conwy 013","W02000039",7841,7763,78
"2021","Conwy 014","W02000040",6596,6559,37
"2021","Conwy 015","W02000041",8521,8442,79
"2021","Denbighshire 001","W02000042",5862,5834,28
"2021","Denbighshire 002","W02000043",5246,5187,59
"2021","Denbighshire 003","W02000044",5302,5279,23
"2021","Denbighshire 004","W02000045",9568,9066,502
"2021","Denbighshire 006","W02000047",5566,5564,2
"2021","Denbighshire 008","W02000049",6658,6616,42
"2021","Denbighshire 009","W02000050",6378,6275,103
"2021","Denbighshire 010","W02000051",5301,5126,175
"2021","Denbighshire 011","W02000052",5004,4852,152
"2021","Denbighshire 012","W02000053",6319,6248,71
"2021","Denbighshire 013","W02000054",6132,6018,114
"2021","Denbighshire 014","W02000055",5699,5544,155
"2021","Denbighshire 015","W02000056",5186,5175,11
"2021","Denbighshire 016","W02000057",6237,6075,162
"2021","Denbighshire 017","W02000419",11361,11322,39
"2021","Flintshire 001","W02000058",5131,5108,23
"2021","Flintshire 002","W02000059",6577,6535,42
"2021","Flintshire 003","W02000060",10752,10606,146
"2021","Flintshire 004","W02000061",7630,7578,52
"2021","Flintshire 005","W02000062",6106,5994,112
"2021","Flintshire 006","W02000063",8104,8082,22
"2021","Flintshire 007","W02000064",6120,6106,14
"2021","Flintshire 008","W02000065",7275,7248,27
"2021","Flintshire 009","W02000066",9845,9800,45
"2021","Flintshire 010","W02000067",6829,6739,90
"2021","Flintshire 011","W02000068",5193,5146,47
"2021","Flintshire 012","W02000069",6261,6241,20
"2021","Flintshire 013","W02000070",10627,10591,36
"2021","Flintshire 014","W02000071",7039,6973,66
"2021","Flintshire 015","W02000072",11669,11666,3
"2021","Flintshire 016","W02000073",10148,10075,73
"2021","Flintshire 017","W02000074",9853,9775,78
"2021","Flintshire 018","W02000075",6439,6420,19
"2021","Flintshire 019","W02000076",7322,7320,2
"2021","Flintshire 020","W02000077",6043,5944,99
"2021","Wrexham 003","W02000080",7875,7875,0
"2021","Wrexham 004","W02000081",5957,5725,232
"2021","Wrexham 005","W02000082",7674,7652,22
"2021","Wrexham 006","W02000083",8689,8580,109
"2021","Wrexham 008","W02000085",8923,8640,283
"2021","Wrexham 010","W02000087",6861,6803,58
"2021","Wrexham 011","W02000088",8678,8486,192
"2021","Wrexham 012","W02000089",8612,8530,82
"2021","Wrexham 013","W02000090",5704,5702,2
"2021","Wrexham 014","W02000091",6200,6179,21
"2021","Wrexham 015","W02000092",6726,6633,93
"2021","Wrexham 016","W02000093",6553,6547,6
"2021","Wrexham 017","W02000094",8899,8825,74
"2021","Wrexham 018","W02000095",6387,6376,11
"2021","Wrexham 019","W02000096",6460,6361,99
"2021","Wrexham 021","W02000424",6682,6601,81
"2021","Wrexham 022","W02000425",8345,6786,1559
"2021","Wrexham 023","W02000426",9895,9884,11
"2021","Ceredigion 001","W02000116",7362,7280,82
"2021","Ceredigion 002","W02000117",8971,6469,2502
"2021","Ceredigion 003","W02000118",6459,5946,513
"2021","Ceredigion 005","W02000120",7075,7030,45
"2021","Ceredigion 007","W02000122",6330,6313,17
"2021","Ceredigion 008","W02000123",7674,7458,216
"2021","Ceredigion 009","W02000124",8672,8620,52
"2021","Ceredigion 010","W02000125",7446,7367,79
"2021","Ceredigion 011","W02000421",11486,11362,124
"2021","Pembrokeshire 001","W02000126",8222,8200,22
"2021","Pembrokeshire 002","W02000127",9628,9540,88
"2021","Pembrokeshire 003","W02000128",7238,6985,253
"2021","Pembrokeshire 004","W02000129",7227,7161,66
"2021","Pembrokeshire 005","W02000130",6707,6700,7
"2021","Pembrokeshire 006","W02000131",7205,7134,71
"2021","Pembrokeshire 007","W02000132",6979,6842,137
"2021","Pembrokeshire 008","W02000133",8277,8019,258
"2021","Pembrokeshire 009","W02000134",8332,8261,71
"2021","Pembrokeshire 010","W02000135",7350,7317,33
"2021","Pembrokeshire 011","W02000136",8303,8139,164
"2021","Pembrokeshire 012","W02000137",7448,7409,39
"2021","Pembrokeshire 013","W02000138",9657,9572,85
"2021","Pembrokeshire 014","W02000139",7722,7663,59
"2021","Pembrokeshire 015","W02000140",7280,7222,58
"2021","Pembrokeshire 016","W02000141",5786,5618,168
"2021","Carmarthenshire 001","W02000142",5568,5504,64
"2021","Carmarthenshire 002","W02000143",5579,5380,199
"2021","Carmarthenshire 003","W02000144",7607,7487,120
"2021","Carmarthenshire 004","W02000145",7087,6902,185
"2021","Carmarthenshire 005","W02000146",6525,6507,18
"2021","Carmarthenshire 006","W02000147",8469,8260,209
"2021","Carmarthenshire 007","W02000148",5288,5269,19
"2021","Carmarthenshire 008","W02000149",6451,6310,141
"2021","Carmarthenshire 010","W02000151",7409,7384,25
"2021","Carmarthenshire 011","W02000152",8653,8449,204
"2021","Carmarthenshire 012","W02000153",8670,8612,58
"2021","Carmarthenshire 013","W02000154",7837,7778,59
"2021","Carmarthenshire 015","W02000156",8420,8344,76
"2021","Carmarthenshire 016","W02000157",10109,10007,102
"2021","Carmarthenshire 017","W02000158",5888,5873,15
"2021","Carmarthenshire 018","W02000159",6192,6152,40
"2021","Carmarthenshire 019","W02000160",7653,7590,63
"2021","Carmarthenshire 020","W02000161",5195,5061,134
"2021","Carmarthenshire 021","W02000162",8212,8171,41
"2021","Carmarthenshire 022","W02000163",5336,5260,76
"2021","Carmarthenshire 023","W02000164",7435,7319,116
"2021","Carmarthenshire 024","W02000165",6587,6505,82
"2021","Carmarthenshire 025","W02000166",9164,9111,53
"2021","Carmarthenshire 026","W02000167",10309,10224,85
"2021","Carmarthenshire 027","W02000418",12255,12136,119
"2021","Swansea 001","W02000168",6514,6441,73
"2021","Swansea 002","W02000169",9133,9073,60
"2021","Swansea 003","W02000170",8679,8625,54
"2021","Swansea 004","W02000171",8447,8417,30
"2021","Swansea 005","W02000172",10251,10163,88
"2021","Swansea 006","W02000173",7898,7851,47
"2021","Swansea 007","W02000174",9638,9638,0
"2021","Swansea 008","W02000175",7351,7237,114
"2021","Swansea 009","W02000176",8947,8897,50
"2021","Swansea 010","W02000177",6997,6964,33
"2021","Swansea 011","W02000178",8914,8903,11
"2021","Swansea 012","W02000179",6479,6370,109
"2021","Swansea 013","W02000180",8012,8001,11
"2021","Swansea 014","W02000181",7407,7215,192
"2021","Swansea 015","W02000182",7526,7487,39
"2021","Swansea 016","W02000183",10216,9406,810
"2021","Swansea 017","W02000184",6773,6720,53
"2021","Swansea 018","W02000185",5028,5012,16
"2021","Swansea 019","W02000186",8836,8836,0
"2021","Swansea 021","W02000188",8076,8068,8
"2021","Swansea 022","W02000189",8243,8136,107
"2021","Swansea 024","W02000191",8780,8604,176
"2021","Swansea 025","W02000192",9124,8135,989
"2021","Swansea 026","W02000193",8817,8637,180
"2021","Swansea 027","W02000194",6537,5457,1080
"2021","Swansea 028","W02000195",5788,5752,36
"2021","Swansea 029","W02000196",6278,6207,71
"2021","Swansea 030","W02000197",6045,5938,107
"2021","Swansea 031","W02000198",7256,7136,120
"2021","Swansea 032","W02000428",10502,9996,506
"2021","Neath Port Talbot 002","W02000200",5127,5113,14
"2021","Neath Port Talbot 003","W02000201",5284,5259,25
"2021","Neath Port Talbot 004","W02000202",12453,12256,197
"2021","Neath Port Talbot 006","W02000204",6602,6560,42
"2021","Neath Port Talbot 007","W02000205",5730,5650,80
"2021","Neath Port Talbot 008","W02000206",6604,6504,100
"2021","Neath Port Talbot 009","W02000207",5249,5189,60
"2021","Neath Port Talbot 010","W02000208",12714,10596,2118
"2021","Neath Port Talbot 012","W02000210",6182,6160,22
"2021","Neath Port Talbot 013","W02000211",7821,7803,18
"2021","Neath Port Talbot 014","W02000212",7738,7727,11
"2021","Neath Port Talbot 015","W02000213",6751,6724,27
"2021","Neath Port Talbot 016","W02000214",9657,9498,159
"2021","Neath Port Talbot 017","W02000215",9464,9454,10
"2021","Neath Port Talbot 018","W02000216",7192,7076,116
"2021","Neath Port Talbot 019","W02000217",6397,6381,16
"2021","Neath Port Talbot 020","W02000417",10178,10132,46
"2021","Neath Port Talbot 021","W02000427",11145,11031,114
"2021","Bridgend 001","W02000218",6665,6658,7
"2021","Bridgend 002","W02000219",7174,7166,8
"2021","Bridgend 003","W02000220",7981,7909,72
"2021","Bridgend 004","W02000221",7688,7688,0
"2021","Bridgend 005","W02000222",6174,6128,46
"2021","Bridgend 006","W02000223",6005,5923,82
"2021","Bridgend 007","W02000224",6499,6499,0
"2021","Bridgend 008","W02000225",8880,8861,19
"2021","Bridgend 009","W02000226",10011,9980,31
"2021","Bridgend 010","W02000227",7400,7395,5
"2021","Bridgend 011","W02000228",12163,10539,1624
"2021","Bridgend 012","W02000229",6127,6099,28
"2021","Bridgend 013","W02000230",5678,5546,132
"2021","Bridgend 014","W02000231",8318,8273,45
"2021","Bridgend 015","W02000232",5748,5693,55
"2021","Bridgend 016","W02000233",6207,6166,41
"2021","Bridgend 017","W02000234",10640,10588,52
"2021","Bridgend 018","W02000235",9174,8885,289
"2021","Bridgend 019","W02000236",6958,6867,91
"2021","Vale of Glamorgan 001","W02000237",6138,6138,0
"2021","Vale of Glamorgan 002","W02000238",6556,6505,51
"2021","Vale of Glamorgan 003","W02000239",8010,7985,25
"2021","Vale of Glamorgan 004","W02000240",8997,8922,75
"2021","Vale of Glamorgan 005","W02000241",10174,9927,247
"2021","Vale of Glamorgan 006","W02000242",8216,8184,32
"2021","Vale of Glamorgan 007","W02000243",9352,9251,101
"2021","Vale of Glamorgan 008","W02000244",10162,10059,103
"2021","Vale of Glamorgan 009","W02000245",8278,8236,42
"2021","Vale of Glamorgan 010","W02000246",5301,5301,0
"2021","Vale of Glamorgan 011","W02000247",8679,8404,275
"2021","Vale of Glamorgan 012","W02000248",10633,10591,42
"2021","Vale of Glamorgan 013","W02000249",8766,8498,268
"2021","Vale of Glamorgan 014","W02000250",11638,11278,360
"2021","Vale of Glamorgan 015","W02000251",11039,11002,37
"2021","Cardiff 001","W02000367",6096,5989,107
"2021","Cardiff 002","W02000368",5700,5700,0
"2021","Cardiff 003","W02000369",9795,9790,5
"2021","Cardiff 004","W02000370",6549,6549,0
"2021","Cardiff 005","W02000371",9102,9058,44
"2021","Cardiff 006","W02000372",8286,8239,47
"2021","Cardiff 007","W02000373",6996,6968,28
"2021","Cardiff 008","W02000374",5892,5892,0
"2021","Cardiff 009","W02000375",7315,7220,95
"2021","Cardiff 010","W02000376",6658,6629,29
"2021","Cardiff 011","W02000377",7784,7622,162
"2021","Cardiff 012","W02000378",7489,7482,7
"2021","Cardiff 013","W02000379",6468,6468,0
"2021","Cardiff 014","W02000380",7901,7832,69
"2021","Cardiff 015","W02000381",6530,6530,0
"2021","Cardiff 016","W02000382",5972,5851,121
"2021","Cardiff 017","W02000383",7499,7496,3
"2021","Cardiff 018","W02000384",5697,5680,17
"2021","Cardiff 019","W02000385",6883,6230,653
"2021","Cardiff 020","W02000386",7587,7535,52
"2021","Cardiff 021","W02000387",5906,5648,258
"2021","Cardiff 022","W02000388",5799,5769,30
"2021","Cardiff 023","W02000389",8425,8425,0
"2021","Cardiff 024","W02000390",6238,5673,565
"2021","Cardiff 025","W02000391",9415,6392,3023
"2021","Cardiff 026","W02000392",8776,8348,428
"2021","Cardiff 027","W02000393",6641,6620,21
"2021","Cardiff 028","W02000394",9568,8994,574
"2021","Cardiff 029","W02000395",6673,6638,35
"2021","Cardiff 030","W02000396",7516,7355,161
"2021","Cardiff 031","W02000397",6425,6379,46
"2021","Cardiff 032","W02000398",12253,9120,3133
"2021","Cardiff 033","W02000399",10761,9820,941
"2021","Cardiff 034","W02000400",6295,6246,49
"2021","Cardiff 035","W02000401",5937,5928,9
"2021","Cardiff 036","W02000402",11609,9173,2436
"2021","Cardiff 037","W02000403",7790,7788,2
"2021","Cardiff 038","W02000404",6352,6230,122
"2021","Cardiff 039","W02000405",7810,7801,9
"2021","Cardiff 040","W02000406",10201,10064,137
"2021","Cardiff 041","W02000407",6643,6557,86
"2021","Cardiff 042","W02000408",7459,7360,99
"2021","Cardiff 043","W02000409",6074,6074,0
"2021","Cardiff 044","W02000410",8652,8281,371
"2021","Cardiff 045","W02000411",6599,6524,75
"2021","Cardiff 046","W02000412",6874,6772,102
"2021","Cardiff 048","W02000422",7388,7385,3
"2021","Cardiff 049","W02000423",10031,8768,1263
"2021","Rhondda Cynon Taf 001","W02000252",9177,9160,17
"2021","Rhondda Cynon Taf 002","W02000253",6765,6632,133
"2021","Rhondda Cynon Taf 003","W02000254",7949,7867,82
"2021","Rhondda Cynon Taf 004","W02000255",6909,6893,16
"2021","Rhondda Cynon Taf 005","W02000256",10012,9952,60
"2021","Rhondda Cynon Taf 006","W02000257",7249,7222,27
"2021","Rhondda Cynon Taf 007","W02000258",5705,5677,28
"2021","Rhondda Cynon Taf 008","W02000259",5751,5650,101
"2021","Rhondda Cynon Taf 009","W02000260",5695,5681,14
"2021","Rhondda Cynon Taf 010","W02000261",7648,7582,66
"2021","Rhondda Cynon Taf 011","W02000262",5300,5282,18
"2021","Rhondda Cynon Taf 012","W02000263",6375,6373,2
"2021","Rhondda Cynon Taf 013","W02000264",5728,5726,2
"2021","Rhondda Cynon Taf 014","W02000265",9192,9108,84
"2021","Rhondda Cynon Taf 015","W02000266",7495,7484,11
"2021","Rhondda Cynon Taf 016","W02000267",6337,6291,46
"2021","Rhondda Cynon Taf 017","W02000268",8921,8827,94
"2021","Rhondda Cynon Taf 018","W02000269",8197,8141,56
"2021","Rhondda Cynon Taf 019","W02000270",6592,6522,70
"2021","Rhondda Cynon Taf 020","W02000271",5450,5450,0
"2021","Rhondda Cynon Taf 021","W02000272",9919,9793,126
"2021","Rhondda Cynon Taf 022","W02000273",10431,9785,646
"2021","Rhondda Cynon Taf 023","W02000274",10173,10082,91
"2021","Rhondda Cynon Taf 024","W02000275",6053,6048,5
"2021","Rhondda Cynon Taf 025","W02000276",6506,6488,18
"2021","Rhondda Cynon Taf 026","W02000277",6942,6866,76
"2021","Rhondda Cynon Taf 027","W02000278",8945,8912,33
"2021","Rhondda Cynon Taf 028","W02000279",7738,7701,37
"2021","Rhondda Cynon Taf 029","W02000280",9575,9566,9
"2021","Rhondda Cynon Taf 030","W02000281",7462,7363,99
"2021","Rhondda Cynon Taf 031","W02000282",11459,11458,1
"2021","Caerphilly 001","W02000290",8545,8486,59
"2021","Caerphilly 002","W02000291",7087,7035,52
"2021","Caerphilly 003","W02000292",5823,5788,35
"2021","Caerphilly 004","W02000293",6040,5980,60
"2021","Caerphilly 005","W02000294",5601,5528,73
"2021","Caerphilly 006","W02000295",9520,9450,70
"2021","Caerphilly 007","W02000296",7393,7356,37
"2021","Caerphilly 008","W02000297",7488,7474,14
"2021","Caerphilly 009","W02000298",7145,7109,36
"2021","Caerphilly 010","W02000299",6237,6216,21
"2021","Caerphilly 011","W02000300",8381,8320,61
"2021","Caerphilly 012","W02000301",7931,7911,20
"2021","Caerphilly 013","W02000302",9958,9883,75
"2021","Caerphilly 014","W02000303",7111,7098,13
"2021","Caerphilly 015","W02000304",5499,5452,47
"2021","Caerphilly 016","W02000305",6143,6143,0
"2021","Caerphilly 017","W02000306",5085,5058,27
"2021","Caerphilly 018","W02000307",6508,6498,10
"2021","Caerphilly 019","W02000308",8772,8755,17
"2021","Caerphilly 020","W02000309",6767,6734,33
"2021","Caerphilly 021","W02000310",5289,5287,2
"2021","Caerphilly 022","W02000311",9773,9773,0
"2021","Caerphilly 023","W02000312",7231,7231,0
"2021","Caerphilly 024","W02000313",10624,10489,135
"2021","Blaenau Gwent 001","W02000314",6622,6565,57
"2021","Blaenau Gwent 002","W02000315",5248,5177,71
"2021","Blaenau Gwent 003","W02000316",6660,6659,1
"2021","Blaenau Gwent 004","W02000317",7786,7757,29
"2021","Blaenau Gwent 005","W02000318",9097,9057,40
"2021","Blaenau Gwent 006","W02000319",8078,8050,28
"2021","Blaenau Gwent 007","W02000320",8131,8074,57
"2021","Blaenau Gwent 008","W02000321",8611,8553,58
"2021","Blaenau Gwent 009","W02000322",6665,6660,5
"2021","Torfaen 001","W02000323",6019,5994,25
"2021","Torfaen 002","W02000324",7042,7012,30
"2021","Torfaen 003","W02000325",7342,7302,40
"2021","Torfaen 004","W02000326",8870,8776,94
"2021","Torfaen 005","W02000327",5895,5895,0
"2021","Torfaen 006","W02000328",7482,7397,85
"2021","Torfaen 007","W02000329",8067,8016,51
"2021","Torfaen 008","W02000330",7079,7079,0
"2021","Torfaen 009","W02000331",6474,6449,25
"2021","Torfaen 010","W02000332",7649,7566,83
"2021","Torfaen 011","W02000333",6241,6205,36
"2021","Torfaen 012","W02000334",6585,6585,0
"2021","Torfaen 013","W02000335",7534,7449,85
"2021","Monmouthshire 001","W02000336",8480,8296,184
"2021","Monmouthshire 002","W02000337",7641,7633,8
"2021","Monmouthshire 003","W02000338",8520,8365,155
"2021","Monmouthshire 004","W02000339",11049,10821,228
"2021","Monmouthshire 005","W02000340",7140,7016,124
"2021","Monmouthshire 006","W02000341",8313,7843,470
"2021","Monmouthshire 007","W02000342",9360,9247,113
"2021","Monmouthshire 008","W02000343",8172,8115,57
"2021","Monmouthshire 009","W02000344",8510,8460,50
"2021","Monmouthshire 010","W02000345",8035,7996,39
"2021","Monmouthshire 011","W02000346",7738,7724,14
"2021","Newport 001","W02000347",7971,7866,105
"2021","Newport 002","W02000348",7605,7547,58
"2021","Newport 003","W02000349",8295,8255,40
"2021","Newport 004","W02000350",9960,9912,48
"2021","Newport 005","W02000351",6271,6268,3
"2021","Newport 006","W02000352",6794,6722,72
"2021","Newport 007","W02000353",7218,7218,0
"2021","Newport 008","W02000354",5794,5734,60
"2021","Newport 009","W02000355",10238,10142,96
"2021","Newport 010","W02000356",5269,5269,0
"2021","Newport 011","W02000357",8282,8216,66
"2021","Newport 012","W02000358",6485,6439,46
"2021","Newport 013","W02000359",11804,11795,9
"2021","Newport 014","W02000360",6784,6671,113
"2021","Newport 015","W02000361",11763,11741,22
"2021","Newport 016","W02000362",6982,6975,7
"2021","Newport 017","W02000363",5781,5744,37
"2021","Newport 018","W02000364",9290,8801,489
"2021","Newport 019","W02000365",8574,8574,0
"2021","Newport 020","W02000366",8433,8315,118
"2021","Powys 001","W02000097",9309,9255,54
"2021","Powys 002","W02000098",6261,6258,3
"2021","Powys 003","W02000099",6637,6477,160
"2021","Powys 004","W02000100",6210,6181,29
"2021","Powys 005","W02000101",5534,5524,10
"2021","Powys 006","W02000102",6151,6148,3
"2021","Powys 007","W02000103",5790,5722,68
"2021","Powys 008","W02000104",6197,6156,41
"2021","Powys 009","W02000105",5166,5082,84
"2021","Powys 010","W02000106",6491,6473,18
"2021","Powys 011","W02000107",9778,9758,20
"2021","Powys 012","W02000108",7212,7164,48
"2021","Powys 013","W02000109",5598,5523,75
"2021","Powys 014","W02000110",6840,6790,50
"2021","Powys 015","W02000111",8461,8404,57
"2021","Powys 017","W02000113",8256,7808,448
"2021","Powys 018","W02000114",6942,6893,49
"2021","Powys 020","W02000414",5987,5942,45
"2021","Powys 021","W02000416",10349,10179,170
"2021","Merthyr Tydfil 002","W02000284",9358,9352,6
"2021","Merthyr Tydfil 003","W02000285",8331,8175,156
"2021","Merthyr Tydfil 004","W02000286",6737,6693,44
"2021","Merthyr Tydfil 005","W02000287",8293,8293,0
"2021","Merthyr Tydfil 006","W02000288",8083,7973,110
"2021","Merthyr Tydfil 007","W02000289",8681,8610,71
"2021","Merthyr Tydfil 008","W02000415",9358,9295,63
